num_ligne;Session;Code académie;Académie;Sexe;Statut du candidat;Voie;Série;Diplôme spécialité;Nombre d'inscrits;Nombre de présents;Nombre d'admis au 1er groupe;Nombre de refusés au 1er groupe;Nombre d'ajournés, passant les épreuves du 2nd groupe;Nombre d'admis à l'issue du 2nd groupe;Nombre de refusés à l'issue du 2nd groupe;Nombre d'admis totaux;Nombre d'admis avec mention TB avec les félicitations du jury;Nombre d'admis avec mention TB sans les félicitations du jury;Nombre d'admis avec mention B;Nombre d'admis avec mention AB;Nombre d'admis sans mention;Nombre de refusés totaux
10007.0;2022;27;CORSE;MASCULIN;SCOLAIRE;BAC PROFESSIONNEL;BAC PRO PROD;BAC PRO 25514 SYST.NUM.OPT.B AUD.RES.EQUIP.DOM.;8;8;6;1;1;1;0;7;0;0;0;2;5;1
10012.0;2022;27;CORSE;MASCULIN;SCOLAIRE;BAC PROFESSIONNEL;BAC PRO PROD;BAC PRO AG 21405 AMENAGEMENTS PAYSAGERS;6;5;5;0;0;0;0;5;0;0;0;1;4;0
10014.0;2022;27;CORSE;MASCULIN;SCOLAIRE;BAC PROFESSIONNEL;BAC PRO SERV;BAC PRO 31106 LOGISTIQUE;10;10;9;1;0;0;0;9;0;1;2;5;1;1
10017.0;2022;27;CORSE;MASCULIN;SCOLAIRE;BAC PROFESSIONNEL;BAC PRO SERV;BAC PRO 31213 MET.COM.VEN.OP.A ANI.GES.ESP.COM.;17;17;15;1;1;1;0;16;0;0;3;4;9;1
10022.0;2022;27;CORSE;MASCULIN;SCOLAIRE;BAC TECHNOLOGIQUE;BAC ST2S;BAC ST2S SCIENCES & TECHNO. SANTE & SOCIAL;19;19;13;1;5;4;1;17;0;1;1;7;8;2
10027.0;2022;27;CORSE;MASCULIN;SCOLAIRE;BAC TECHNOLOGIQUE;BAC STI2D;BAC STI2D INNOVATION TECHNO.  ET ECO CONCEPTION;8;8;6;0;2;1;1;7;0;0;0;2;5;1
10031.0;2022;27;CORSE;MASCULIN;SCOLAIRE;BAC TECHNOLOGIQUE;BAC STMG;BAC STMG MERCATIQUE (MARKETING);75;75;56;2;17;11;6;67;0;0;5;29;33;8
10037.0;2022;24;CRETEIL;FEMININ;APPRENTISSAGE;BAC PROFESSIONNEL;BAC PRO PROD;BAC PRO 24303 MET. DU CUIR: SELLERIE GARNISSAGE;9;8;8;0;0;0;0;8;0;5;3;0;0;0
10041.0;2022;24;CRETEIL;FEMININ;APPRENTISSAGE;BAC PROFESSIONNEL;BAC PRO PROD;BAC PRO 25408 REPARATION DES CARROSSERIES;1;1;1;0;0;0;0;1;0;0;0;1;0;0
10044.0;2022;24;CRETEIL;FEMININ;APPRENTISSAGE;BAC PROFESSIONNEL;BAC PRO PROD;BAC PRO AG 21405 AMENAGEMENTS PAYSAGERS;2;2;2;0;0;0;0;2;0;0;0;0;2;0
10048.0;2022;24;CRETEIL;FEMININ;APPRENTISSAGE;BAC PROFESSIONNEL;BAC PRO SERV;BAC PRO 31214 MET.COM.VEN.OP.B PR.CL.VA.OF.COM.;4;4;4;0;0;0;0;4;0;0;1;2;1;0
10058.0;2022;24;CRETEIL;FEMININ;ENSEIGNEMENT A DISTANCE;BAC PROFESSIONNEL;BAC PRO SERV;BAC PRO 31213 MET.COM.VEN.OP.A ANI.GES.ESP.COM.;5;4;1;3;0;0;0;1;0;0;0;1;0;3
10060.0;2022;24;CRETEIL;FEMININ;ENSEIGNEMENT A DISTANCE;BAC PROFESSIONNEL;BAC PRO SERV;BAC PRO 33004 ACC.SOINS-S.PERS. OPT.EN STRUCTUR;9;5;3;1;1;0;1;3;0;0;0;2;1;2
10065.0;2022;24;CRETEIL;FEMININ;FORMATION CONTINUE;BAC PROFESSIONNEL;BAC PRO PROD;BAC PRO 24301 METIERS DU CUIR : CHAUSSURES;1;1;1;0;0;0;0;1;0;0;1;0;0;0
10067.0;2022;24;CRETEIL;FEMININ;FORMATION CONTINUE;BAC PROFESSIONNEL;BAC PRO PROD;BAC PRO 24303 MET. DU CUIR: SELLERIE GARNISSAGE;5;5;5;0;0;0;0;5;0;0;3;2;0;0
10072.0;2022;24;CRETEIL;FEMININ;FORMATION CONTINUE;BAC PROFESSIONNEL;BAC PRO SERV;BAC PRO 33102 PROTHESE DENTAIRE;1;1;1;0;0;0;0;1;0;0;0;0;1;0
10075.0;2022;24;CRETEIL;FEMININ;INDIVIDUEL;BAC PROFESSIONNEL;BAC PRO PROD;BAC PRO 23203 TECHNICIEN BAT. : ORG.REAL.GROS O;1;1;0;0;1;0;1;0;0;0;0;0;0;1
10076.0;2022;24;CRETEIL;FEMININ;INDIVIDUEL;BAC PROFESSIONNEL;BAC PRO PROD;BAC PRO 24203 METIERS DE LA MODE - VÊTEMENT;1;0;0;0;0;0;0;0;0;0;0;0;0;0
10077.0;2022;24;CRETEIL;FEMININ;INDIVIDUEL;BAC PROFESSIONNEL;BAC PRO PROD;BAC PRO AG 21004 CGEA;1;1;1;0;0;0;0;1;0;0;0;0;1;0
10083.0;2022;24;CRETEIL;FEMININ;INDIVIDUEL;BAC PROFESSIONNEL;BAC PRO SERV;BAC PRO 31213 MET.COM.VEN.OP.A ANI.GES.ESP.COM.;5;5;5;0;0;0;0;5;0;0;0;1;4;0
10085.0;2022;24;CRETEIL;FEMININ;INDIVIDUEL;BAC PROFESSIONNEL;BAC PRO SERV;BAC PRO 33003 ACC.SOINS-S.PERS. OPT.A DOMICILE;4;1;0;1;0;0;0;0;0;0;0;0;0;1
10095.0;2022;24;CRETEIL;FEMININ;INDIVIDUEL;BAC TECHNOLOGIQUE;BAC STMG;BAC STMG GESTION ET FINANCE;13;4;0;2;2;2;0;2;0;0;0;0;2;2
10103.0;2022;24;CRETEIL;FEMININ;SCOLAIRE;BAC PROFESSIONNEL;BAC PRO PROD;BAC PRO 23003 ARTIS. & M.ART:MARCHANDISAGE VIS.;23;23;19;2;2;1;1;20;0;3;6;4;7;3
10110.0;2022;24;CRETEIL;FEMININ;SCOLAIRE;BAC PROFESSIONNEL;BAC PRO PROD;BAC PRO 23407 TECHNIC.FAB.BOIS ET MATERX ASSOC;1;1;0;1;0;0;0;0;0;0;0;0;0;1
10115.0;2022;24;CRETEIL;FEMININ;SCOLAIRE;BAC PROFESSIONNEL;BAC PRO PROD;BAC PRO 25007 MAINTENANCE EQUIPEMENTS INDUST.;1;1;1;0;0;0;0;1;0;0;0;0;1;0
10140.0;2022;24;CRETEIL;FEMININ;SCOLAIRE;BAC PROFESSIONNEL;BAC PRO SERV;BAC PRO 32206 FACONNAGE PRODTS IMPRIMES ROUTAGE;1;1;1;0;0;0;0;1;0;1;0;0;0;0
10146.0;2022;24;CRETEIL;FEMININ;SCOLAIRE;BAC PROFESSIONNEL;BAC PRO SERV;BAC PRO 33004 ACC.SOINS-S.PERS. OPT.EN STRUCTUR;1445;1439;1190;183;66;41;25;1231;0;40;266;512;413;208
10147.0;2022;24;CRETEIL;FEMININ;SCOLAIRE;BAC PROFESSIONNEL;BAC PRO SERV;BAC PRO 33101 OPTIQUE LUNETTERIE;30;30;29;1;0;0;0;29;0;2;4;5;18;1
10148.0;2022;24;CRETEIL;FEMININ;SCOLAIRE;BAC PROFESSIONNEL;BAC PRO SERV;BAC PRO 33102 PROTHESE DENTAIRE;2;2;2;0;0;0;0;2;0;0;0;0;2;0
10149.0;2022;24;CRETEIL;FEMININ;SCOLAIRE;BAC PROFESSIONNEL;BAC PRO SERV;BAC PRO 33403 COMMERC. SERVICES EN RESTAURATION;43;43;35;6;2;2;0;37;0;4;8;10;15;6
10152.0;2022;24;CRETEIL;FEMININ;SCOLAIRE;BAC PROFESSIONNEL;BAC PRO SERV;BAC PRO 34403 METIERS DE LA SECURITE;42;42;38;3;1;0;1;38;0;7;14;11;6;4
10155.0;2022;24;CRETEIL;FEMININ;SCOLAIRE;BAC TECHNOLOGIQUE;BAC STAV;BAC STAV AGRONOMIE ALIM ENV TERRITOI;34;34;34;0;0;0;0;34;0;0;1;14;19;0
10157.0;2022;24;CRETEIL;FEMININ;SCOLAIRE;BAC TECHNOLOGIQUE;BAC STHR;BAC STHR SC.&TEC. HOTELLERIE-RESTAURATION;35;35;29;1;5;4;1;33;0;0;3;17;13;2
10158.0;2022;24;CRETEIL;FEMININ;SCOLAIRE;BAC TECHNOLOGIQUE;BAC STI2D;BAC STI2D ARCHITECTURE ET CONSTRUCTION;54;54;45;0;9;5;4;50;0;1;3;19;27;4
10159.0;2022;24;CRETEIL;FEMININ;SCOLAIRE;BAC TECHNOLOGIQUE;BAC STI2D;BAC STI2D ENERGIES  ET ENVIRONNEMENT;29;29;25;1;3;2;1;27;0;0;8;10;9;2
10161.0;2022;24;CRETEIL;FEMININ;SCOLAIRE;BAC TECHNOLOGIQUE;BAC STI2D;BAC STI2D SYSTÈME D'INFORMATION  ET NUMERIQUE;45;45;36;2;7;6;1;42;1;1;8;13;19;3
10165.0;2022;24;CRETEIL;FEMININ;SCOLAIRE;BAC TECHNOLOGIQUE;BAC STMG;BAC STMG MERCATIQUE (MARKETING);1769;1769;1512;63;194;154;40;1666;0;33;222;591;820;103
10170.0;2022;24;CRETEIL;MASCULIN;APPRENTISSAGE;BAC PROFESSIONNEL;BAC PRO PROD;BAC PRO 22703 TECHN.INSTALL.SYST.ENERG.CLIMATI;53;46;22;14;10;3;7;25;0;2;2;8;13;21
10171.0;2022;24;CRETEIL;MASCULIN;APPRENTISSAGE;BAC PROFESSIONNEL;BAC PRO PROD;BAC PRO 22704 TECHN. MAINT. SYST.ENERG.CLIMATI;35;33;16;16;1;1;0;17;0;2;4;5;6;16
10172.0;2022;24;CRETEIL;MASCULIN;APPRENTISSAGE;BAC PROFESSIONNEL;BAC PRO PROD;BAC PRO 23203 TECHNICIEN BAT. : ORG.REAL.GROS O;32;30;26;4;0;0;0;26;0;2;4;15;5;4
10181.0;2022;24;CRETEIL;MASCULIN;APPRENTISSAGE;BAC PROFESSIONNEL;BAC PRO PROD;BAC PRO 25220 MAINT.MATERIELS OPT.B TP MANUT.;4;4;3;1;0;0;0;3;0;0;1;0;2;1
10184.0;2022;24;CRETEIL;MASCULIN;APPRENTISSAGE;BAC PROFESSIONNEL;BAC PRO PROD;BAC PRO 25410 CONSTRUCTION DES CARROSSERIES;2;2;2;0;0;0;0;2;0;0;1;0;1;0
10185.0;2022;24;CRETEIL;MASCULIN;APPRENTISSAGE;BAC PROFESSIONNEL;BAC PRO PROD;BAC PRO 25411 TECH.CHAUDRONNERIE INDUSTRIELLE;19;16;12;3;1;0;1;12;0;0;1;3;8;4
10192.0;2022;24;CRETEIL;MASCULIN;APPRENTISSAGE;BAC PROFESSIONNEL;BAC PRO SERV;BAC PRO 31106 LOGISTIQUE;54;54;33;18;3;1;2;34;0;2;3;8;21;20
10193.0;2022;24;CRETEIL;MASCULIN;APPRENTISSAGE;BAC PROFESSIONNEL;BAC PRO SERV;BAC PRO 31212 METIERS DE L'ACCUEIL;12;12;10;1;1;1;0;11;0;1;4;3;3;1
10198.0;2022;24;CRETEIL;MASCULIN;APPRENTISSAGE;BAC PROFESSIONNEL;BAC PRO SERV;BAC PRO 33403 COMMERC. SERVICES EN RESTAURATION;29;28;25;3;0;0;0;25;0;2;6;9;8;3
10204.0;2022;24;CRETEIL;MASCULIN;ENSEIGNEMENT A DISTANCE;BAC PROFESSIONNEL;BAC PRO SERV;BAC PRO 30001 GESTION-ADMINISTRATION;2;2;0;2;0;0;0;0;0;0;0;0;0;2
10205.0;2022;24;CRETEIL;MASCULIN;ENSEIGNEMENT A DISTANCE;BAC PROFESSIONNEL;BAC PRO SERV;BAC PRO 31213 MET.COM.VEN.OP.A ANI.GES.ESP.COM.;2;2;0;2;0;0;0;0;0;0;0;0;0;2
10210.0;2022;24;CRETEIL;MASCULIN;ENSEIGNEMENT A DISTANCE;BAC TECHNOLOGIQUE;BAC STMG;BAC STMG RESSOURCES HUMAINES ET COMMUNICATION;2;2;0;1;1;1;0;1;0;0;0;0;1;1
10211.0;2022;24;CRETEIL;MASCULIN;FORMATION CONTINUE;BAC PROFESSIONNEL;BAC PRO PROD;BAC PRO 22704 TECHN. MAINT. SYST.ENERG.CLIMATI;13;12;12;0;0;0;0;12;0;3;6;3;0;0
10215.0;2022;24;CRETEIL;MASCULIN;FORMATION CONTINUE;BAC PROFESSIONNEL;BAC PRO PROD;BAC PRO 25220 MAINT.MATERIELS OPT.B TP MANUT.;1;1;1;0;0;0;0;1;0;1;0;0;0;0
10220.0;2022;24;CRETEIL;MASCULIN;FORMATION CONTINUE;BAC PROFESSIONNEL;BAC PRO SERV;BAC PRO 30001 GESTION-ADMINISTRATION;1;1;1;0;0;0;0;1;0;1;0;0;0;0
10229.0;2022;24;CRETEIL;MASCULIN;INDIVIDUEL;BAC PROFESSIONNEL;BAC PRO PROD;BAC PRO 25007 MAINTENANCE EQUIPEMENTS INDUST.;5;5;1;4;0;0;0;1;0;0;0;1;0;4
10231.0;2022;24;CRETEIL;MASCULIN;INDIVIDUEL;BAC PROFESSIONNEL;BAC PRO PROD;BAC PRO 25215 MAINT.VEHIC.OPTB VEHIC.TRANS.ROUT;1;0;0;0;0;0;0;0;0;0;0;0;0;0
10238.0;2022;24;CRETEIL;MASCULIN;INDIVIDUEL;BAC PROFESSIONNEL;BAC PRO PROD;BAC PRO 25513 SYST.NUM.OPT.A SURETE SECURITE;2;2;0;2;0;0;0;0;0;0;0;0;0;2
10240.0;2022;24;CRETEIL;MASCULIN;INDIVIDUEL;BAC PROFESSIONNEL;BAC PRO PROD;BAC PRO AG 21004 CGEA;5;2;2;0;0;0;0;2;0;0;0;0;2;0
10241.0;2022;24;CRETEIL;MASCULIN;INDIVIDUEL;BAC PROFESSIONNEL;BAC PRO PROD;BAC PRO AG 21113 CGEVV;1;1;1;0;0;0;0;1;0;0;0;0;1;0
10242.0;2022;24;CRETEIL;MASCULIN;INDIVIDUEL;BAC PROFESSIONNEL;BAC PRO PROD;BAC PRO AG 21114 CONDUITE PRODUCTIONS HORTICOLES;3;2;1;1;0;0;0;1;0;0;0;0;1;1
10248.0;2022;24;CRETEIL;MASCULIN;INDIVIDUEL;BAC PROFESSIONNEL;BAC PRO SERV;BAC PRO 31213 MET.COM.VEN.OP.A ANI.GES.ESP.COM.;12;6;4;2;0;0;0;4;0;0;0;0;4;2
10254.0;2022;24;CRETEIL;MASCULIN;INDIVIDUEL;BAC TECHNOLOGIQUE;BAC ST2S;BAC ST2S SCIENCES & TECHNO. SANTE & SOCIAL;4;2;1;1;0;0;0;1;0;0;0;0;1;1
10255.0;2022;24;CRETEIL;MASCULIN;INDIVIDUEL;BAC TECHNOLOGIQUE;BAC STD2A;BAC STD2A SCIENCES & TECHNO. DESIGN-ARTS APPLIQUES;1;0;0;0;0;0;0;0;0;0;0;0;0;0
10260.0;2022;24;CRETEIL;MASCULIN;INDIVIDUEL;BAC TECHNOLOGIQUE;BAC STMG;BAC STMG MERCATIQUE (MARKETING);34;22;9;9;4;3;1;12;0;0;0;3;9;10
10262.0;2022;24;CRETEIL;MASCULIN;INDIVIDUEL;BAC TECHNOLOGIQUE;BAC STMG;BAC STMG SYSTEMES D'INFORMATION DE GESTION;1;1;1;0;0;0;0;1;0;1;0;0;0;0
10269.0;2022;24;CRETEIL;MASCULIN;SCOLAIRE;BAC PROFESSIONNEL;BAC PRO PROD;BAC PRO 22704 TECHN. MAINT. SYST.ENERG.CLIMATI;85;85;50;31;4;3;1;53;0;0;3;18;32;32
10274.0;2022;24;CRETEIL;MASCULIN;SCOLAIRE;BAC PROFESSIONNEL;BAC PRO PROD;BACPRO 23103 TECHNICIEN GEOMETRE-TOPOGRAPHE;15;15;11;4;0;0;0;11;0;1;1;5;4;4
10275.0;2022;24;CRETEIL;MASCULIN;SCOLAIRE;BAC PROFESSIONNEL;BAC PRO PROD;BAC PRO 23203 TECHNICIEN BAT. : ORG.REAL.GROS O;58;57;48;7;2;2;0;50;0;6;15;12;17;7
10278.0;2022;24;CRETEIL;MASCULIN;SCOLAIRE;BAC PROFESSIONNEL;BAC PRO PROD;BAC PRO 23404 TECHNICIEN CONSTRUCTEUR BOIS;9;9;7;2;0;0;0;7;0;0;0;3;4;2
10285.0;2022;24;CRETEIL;MASCULIN;SCOLAIRE;BAC PROFESSIONNEL;BAC PRO PROD;BAC PRO 25006 MICROTECHNIQUES;87;87;65;15;7;6;1;71;0;0;10;28;33;16
10286.0;2022;24;CRETEIL;MASCULIN;SCOLAIRE;BAC PROFESSIONNEL;BAC PRO PROD;BAC PRO 25007 MAINTENANCE EQUIPEMENTS INDUST.;291;289;172;109;8;6;2;178;0;7;24;58;89;111
10289.0;2022;24;CRETEIL;MASCULIN;SCOLAIRE;BAC PROFESSIONNEL;BAC PRO PROD;BAC PRO 25214 MAINT.VEHIC.OPTA VOIT.PARTICUL.;155;153;120;30;3;3;0;123;0;6;16;44;57;30
10291.0;2022;24;CRETEIL;MASCULIN;SCOLAIRE;BAC PROFESSIONNEL;BAC PRO PROD;BAC PRO 25216 MAINT.VEHIC.OPTC MOTOCYCLES;63;63;41;21;1;1;0;42;0;2;5;13;22;21
10293.0;2022;24;CRETEIL;MASCULIN;SCOLAIRE;BAC PROFESSIONNEL;BAC PRO PROD;BAC PRO 25220 MAINT.MATERIELS OPT.B TP MANUT.;16;16;11;5;0;0;0;11;0;0;1;2;8;5
10295.0;2022;24;CRETEIL;MASCULIN;SCOLAIRE;BAC PROFESSIONNEL;BAC PRO PROD;BAC PRO 25302 AERONAUTIQUE OPTION AVIONIQUE;11;11;10;1;0;0;0;10;0;0;5;4;1;1
10298.0;2022;24;CRETEIL;MASCULIN;SCOLAIRE;BAC PROFESSIONNEL;BAC PRO PROD;BAC PRO 25406 OUVRAGES DU BATIMENT METALLERIE;28;28;18;7;3;2;1;20;0;0;5;9;6;8
10301.0;2022;24;CRETEIL;MASCULIN;SCOLAIRE;BAC PROFESSIONNEL;BAC PRO PROD;BAC PRO 25411 TECH.CHAUDRONNERIE INDUSTRIELLE;74;73;60;10;3;3;0;63;0;6;17;17;23;10
10314.0;2022;24;CRETEIL;MASCULIN;SCOLAIRE;BAC PROFESSIONNEL;BAC PRO SERV;BAC PRO 31106 LOGISTIQUE;129;128;91;29;8;6;2;97;0;6;15;28;48;31
10319.0;2022;24;CRETEIL;MASCULIN;SCOLAIRE;BAC PROFESSIONNEL;BAC PRO SERV;BAC PRO 31214 MET.COM.VEN.OP.B PR.CL.VA.OF.COM.;595;595;448;110;37;28;9;476;0;9;70;198;199;119
10330.0;2022;24;CRETEIL;MASCULIN;SCOLAIRE;BAC PROFESSIONNEL;BAC PRO SERV;BAC PRO 33603 ESTHETIQUE COSMETIQUE PARFUMERIE;1;1;1;0;0;0;0;1;0;0;0;1;0;0
10335.0;2022;24;CRETEIL;MASCULIN;SCOLAIRE;BAC TECHNOLOGIQUE;BAC ST2S;BAC ST2S SCIENCES & TECHNO. SANTE & SOCIAL;217;217;176;12;29;25;4;201;0;3;13;57;128;16
10353.0;2022;07;DIJON;FEMININ;APPRENTISSAGE;BAC PROFESSIONNEL;BAC PRO PROD;BACPRO 23103 TECHNICIEN GEOMETRE-TOPOGRAPHE;1;1;1;0;0;0;0;1;0;0;1;0;0;0
10363.0;2022;07;DIJON;FEMININ;APPRENTISSAGE;BAC PROFESSIONNEL;BAC PRO PROD;BAC PRO AG 21210 COND GEST ENTR CANIN ET FELIN;10;10;9;1;0;0;0;9;0;0;0;9;0;1
10364.0;2022;07;DIJON;FEMININ;APPRENTISSAGE;BAC PROFESSIONNEL;BAC PRO PROD;BAC PRO AG 21211 COND GEST ENTR HIPPIQUE;11;9;8;1;0;0;0;8;0;0;0;1;7;1
10367.0;2022;07;DIJON;FEMININ;APPRENTISSAGE;BAC PROFESSIONNEL;BAC PRO SERV;BAC PRO 30001 GESTION-ADMINISTRATION;5;5;5;0;0;0;0;5;0;0;2;2;1;0
10368.0;2022;07;DIJON;FEMININ;APPRENTISSAGE;BAC PROFESSIONNEL;BAC PRO SERV;BAC PRO 31106 LOGISTIQUE;1;1;1;0;0;0;0;1;0;0;0;0;1;0
10378.0;2022;07;DIJON;FEMININ;ENSEIGNEMENT A DISTANCE;BAC PROFESSIONNEL;BAC PRO SERV;BAC PRO 31213 MET.COM.VEN.OP.A ANI.GES.ESP.COM.;1;1;0;1;0;0;0;0;0;0;0;0;0;1
10385.0;2022;07;DIJON;FEMININ;FORMATION CONTINUE;BAC PROFESSIONNEL;BAC PRO SERV;BAC PRO 31212 METIERS DE L'ACCUEIL;2;2;1;1;0;0;0;1;0;0;0;0;1;1
10386.0;2022;07;DIJON;FEMININ;FORMATION CONTINUE;BAC PROFESSIONNEL;BAC PRO SERV;BAC PRO 33403 COMMERC. SERVICES EN RESTAURATION;1;1;1;0;0;0;0;1;0;0;1;0;0;0
10391.0;2022;07;DIJON;FEMININ;INDIVIDUEL;BAC PROFESSIONNEL;BAC PRO SERV;BAC PRO 31212 METIERS DE L'ACCUEIL;1;1;0;1;0;0;0;0;0;0;0;0;0;1
10394.0;2022;07;DIJON;FEMININ;INDIVIDUEL;BAC PROFESSIONNEL;BAC PRO SERV;BAC PRO 33102 PROTHESE DENTAIRE;1;1;1;0;0;0;0;1;0;0;0;1;0;0
10397.0;2022;07;DIJON;FEMININ;INDIVIDUEL;BAC TECHNOLOGIQUE;BAC STMG;BAC STMG MERCATIQUE (MARKETING);7;5;2;3;0;0;0;2;0;0;0;1;1;3
10402.0;2022;07;DIJON;FEMININ;SCOLAIRE;BAC PROFESSIONNEL;BAC PRO PROD;BAC PRO 22105 BOULANGER-PÂTISSIER;27;27;26;1;0;0;0;26;0;2;11;10;3;1
10413.0;2022;07;DIJON;FEMININ;SCOLAIRE;BAC PROFESSIONNEL;BAC PRO PROD;BAC PRO 24202 ARTIS.& MET.ART : TAPIS.D'AMEUBL;4;4;3;1;0;0;0;3;0;0;0;2;1;1
10418.0;2022;07;DIJON;FEMININ;SCOLAIRE;BAC PROFESSIONNEL;BAC PRO PROD;BAC PRO 25108 TECHNICIEN MODELEUR;6;6;4;2;0;0;0;4;0;0;1;2;1;2
10420.0;2022;07;DIJON;FEMININ;SCOLAIRE;BAC PROFESSIONNEL;BAC PRO PROD;BAC PRO 25303 AERONAUTIQUE OPTION SYSTEMES;1;1;1;0;0;0;0;1;0;0;0;1;0;0
10422.0;2022;07;DIJON;FEMININ;SCOLAIRE;BAC PROFESSIONNEL;BAC PRO PROD;BAC PRO 25510 METIERS ELECT. ENVIRON. CONNECTES;4;4;3;1;0;0;0;3;0;0;0;2;1;1
10423.0;2022;07;DIJON;FEMININ;SCOLAIRE;BAC PROFESSIONNEL;BAC PRO PROD;BAC PRO 25515 SYST.NUM.OPT.C RES.INF.SYST.COMM.;2;2;2;0;0;0;0;2;0;0;0;1;1;0
10424.0;2022;07;DIJON;FEMININ;SCOLAIRE;BAC PROFESSIONNEL;BAC PRO PROD;BAC PRO AG 21004 CGEA;34;33;26;7;0;0;0;26;0;0;4;6;16;7
10428.0;2022;07;DIJON;FEMININ;SCOLAIRE;BAC PROFESSIONNEL;BAC PRO PROD;BAC PRO AG 21210 COND GEST ENTR CANIN ET FELIN;16;15;11;4;0;0;0;11;0;0;0;2;9;4
10430.0;2022;07;DIJON;FEMININ;SCOLAIRE;BAC PROFESSIONNEL;BAC PRO PROD;BAC PRO AG 21302 GEST MILIEUX NATURELS FAUNE;5;5;5;0;0;0;0;5;0;0;0;3;2;0
10438.0;2022;07;DIJON;FEMININ;SCOLAIRE;BAC PROFESSIONNEL;BAC PRO SERV;BAC PRO 31213 MET.COM.VEN.OP.A ANI.GES.ESP.COM.;246;245;203;30;12;11;1;214;0;9;45;82;78;31
10448.0;2022;07;DIJON;FEMININ;SCOLAIRE;BAC PROFESSIONNEL;BAC PRO SERV;BAC PRO 33403 COMMERC. SERVICES EN RESTAURATION;37;37;29;7;1;1;0;30;0;2;11;13;4;7
10450.0;2022;07;DIJON;FEMININ;SCOLAIRE;BAC PROFESSIONNEL;BAC PRO SERV;BAC PRO 34304 HYGIENE PROPRETE STERILISATION;9;9;7;2;0;0;0;7;0;0;1;4;2;2
10452.0;2022;07;DIJON;FEMININ;SCOLAIRE;BAC PROFESSIONNEL;BAC PRO SERV;BAC PRO 34403 METIERS DE LA SECURITE;26;26;26;0;0;0;0;26;0;6;12;4;4;0
10453.0;2022;07;DIJON;FEMININ;SCOLAIRE;BAC PROFESSIONNEL;BAC PRO SERV;BAC PRO AG 33002 SERV PERS TERRIT;190;183;166;17;0;0;0;166;0;2;25;63;76;17
10459.0;2022;07;DIJON;FEMININ;SCOLAIRE;BAC TECHNOLOGIQUE;BAC STHR;BAC STHR SC.&TEC. HOTELLERIE-RESTAURATION;28;28;28;0;0;0;0;28;1;1;6;13;7;0
10460.0;2022;07;DIJON;FEMININ;SCOLAIRE;BAC TECHNOLOGIQUE;BAC STI2D;BAC STI2D ARCHITECTURE ET CONSTRUCTION;13;13;11;0;2;2;0;13;0;1;2;1;9;0
10461.0;2022;07;DIJON;FEMININ;SCOLAIRE;BAC TECHNOLOGIQUE;BAC STI2D;BAC STI2D ENERGIES  ET ENVIRONNEMENT;10;10;7;0;3;3;0;10;0;0;1;0;9;0
10466.0;2022;07;DIJON;FEMININ;SCOLAIRE;BAC TECHNOLOGIQUE;BAC STMG;BAC STMG GESTION ET FINANCE;113;113;100;1;12;9;3;109;1;2;21;43;42;4
10467.0;2022;07;DIJON;FEMININ;SCOLAIRE;BAC TECHNOLOGIQUE;BAC STMG;BAC STMG MERCATIQUE (MARKETING);338;338;274;13;51;34;17;308;0;5;29;108;166;30
10473.0;2022;07;DIJON;MASCULIN;APPRENTISSAGE;BAC PROFESSIONNEL;BAC PRO PROD;BAC PRO 22704 TECHN. MAINT. SYST.ENERG.CLIMATI;12;12;8;3;1;1;0;9;0;0;3;3;3;3
10476.0;2022;07;DIJON;MASCULIN;APPRENTISSAGE;BAC PROFESSIONNEL;BAC PRO PROD;BAC PRO 23102 TRAVAUX PUBLICS;27;27;26;1;0;0;0;26;0;0;9;13;4;1
10482.0;2022;07;DIJON;MASCULIN;APPRENTISSAGE;BAC PROFESSIONNEL;BAC PRO PROD;BAC PRO 23304 AMENAGEMENT FINITION BATIMENT;9;9;5;3;1;0;1;5;0;0;2;2;1;4
10486.0;2022;07;DIJON;MASCULIN;APPRENTISSAGE;BAC PROFESSIONNEL;BAC PRO PROD;BAC PRO 25007 MAINTENANCE EQUIPEMENTS INDUST.;37;35;31;3;1;0;1;31;0;4;3;11;13;4
10496.0;2022;07;DIJON;MASCULIN;APPRENTISSAGE;BAC PROFESSIONNEL;BAC PRO PROD;BAC PRO 25509 TECHNIC. FROID CONDITIONNEMT AIR;2;2;2;0;0;0;0;2;0;0;0;2;0;0
10497.0;2022;07;DIJON;MASCULIN;APPRENTISSAGE;BAC PROFESSIONNEL;BAC PRO PROD;BAC PRO 25510 METIERS ELECT. ENVIRON. CONNECTES;31;31;23;3;5;2;3;25;0;2;5;9;9;6
10498.0;2022;07;DIJON;MASCULIN;APPRENTISSAGE;BAC PROFESSIONNEL;BAC PRO PROD;BAC PRO 25513 SYST.NUM.OPT.A SURETE SECURITE;1;1;1;0;0;0;0;1;0;0;1;0;0;0
10501.0;2022;07;DIJON;MASCULIN;APPRENTISSAGE;BAC PROFESSIONNEL;BAC PRO PROD;BAC PRO AG 21004 CGEA;64;62;48;14;0;0;0;48;0;0;3;19;26;14
10507.0;2022;07;DIJON;MASCULIN;APPRENTISSAGE;BAC PROFESSIONNEL;BAC PRO PROD;BAC PRO AG 22106 TEC CONS VTE ALIMENTATION VINS SP;2;2;1;1;0;0;0;1;0;0;0;0;1;1
10508.0;2022;07;DIJON;MASCULIN;APPRENTISSAGE;BAC PROFESSIONNEL;BAC PRO PROD;BAC PRO AG 22107 TEC CONS VTE ALIMENTATION P.ALIM;1;1;1;0;0;0;0;1;0;0;0;0;1;0
10511.0;2022;07;DIJON;MASCULIN;APPRENTISSAGE;BAC PROFESSIONNEL;BAC PRO SERV;BAC PRO 31108 TRANSPORT;1;1;1;0;0;0;0;1;0;0;0;1;0;0
10514.0;2022;07;DIJON;MASCULIN;APPRENTISSAGE;BAC PROFESSIONNEL;BAC PRO SERV;BAC PRO 32208 REAL.PR.IMPR.PLURI.OPTB.PR.IMPR.;2;2;2;0;0;0;0;2;0;1;0;1;0;0
10520.0;2022;07;DIJON;MASCULIN;ENSEIGNEMENT A DISTANCE;BAC PROFESSIONNEL;BAC PRO SERV;BAC PRO 31214 MET.COM.VEN.OP.B PR.CL.VA.OF.COM.;2;2;1;1;0;0;0;1;0;0;0;0;1;1
10522.0;2022;07;DIJON;MASCULIN;FORMATION CONTINUE;BAC PROFESSIONNEL;BAC PRO PROD;BAC PRO 22106 CUISINE;3;3;2;1;0;0;0;2;0;0;0;1;1;1
10524.0;2022;07;DIJON;MASCULIN;FORMATION CONTINUE;BAC PROFESSIONNEL;BAC PRO PROD;BAC PRO 23304 AMENAGEMENT FINITION BATIMENT;1;1;0;1;0;0;0;0;0;0;0;0;0;1
10525.0;2022;07;DIJON;MASCULIN;FORMATION CONTINUE;BAC PROFESSIONNEL;BAC PRO PROD;BAC PRO 25411 TECH.CHAUDRONNERIE INDUSTRIELLE;1;1;1;0;0;0;0;1;0;0;0;0;1;0
10530.0;2022;07;DIJON;MASCULIN;INDIVIDUEL;BAC PROFESSIONNEL;BAC PRO PROD;BAC PRO 25007 MAINTENANCE EQUIPEMENTS INDUST.;1;0;0;0;0;0;0;0;0;0;0;0;0;0
10535.0;2022;07;DIJON;MASCULIN;INDIVIDUEL;BAC PROFESSIONNEL;BAC PRO PROD;BAC PRO AG 21211 COND GEST ENTR HIPPIQUE;1;1;1;0;0;0;0;1;0;0;0;0;1;0
10540.0;2022;07;DIJON;MASCULIN;INDIVIDUEL;BAC PROFESSIONNEL;BAC PRO SERV;BAC PRO 31214 MET.COM.VEN.OP.B PR.CL.VA.OF.COM.;2;2;0;2;0;0;0;0;0;0;0;0;0;2
10541.0;2022;07;DIJON;MASCULIN;INDIVIDUEL;BAC PROFESSIONNEL;BAC PRO SERV;BAC PRO 32207 REAL.PR.IMPR.PLURI.OPTA.PR.GRAPH.;1;1;0;1;0;0;0;0;0;0;0;0;0;1
10545.0;2022;07;DIJON;MASCULIN;INDIVIDUEL;BAC TECHNOLOGIQUE;BAC ST2S;BAC ST2S SCIENCES & TECHNO. SANTE & SOCIAL;2;1;0;1;0;0;0;0;0;0;0;0;0;1
10549.0;2022;07;DIJON;MASCULIN;INDIVIDUEL;BAC TECHNOLOGIQUE;BAC STMG;BAC STMG GESTION ET FINANCE;2;1;0;1;0;0;0;0;0;0;0;0;0;1
10555.0;2022;07;DIJON;MASCULIN;SCOLAIRE;BAC PROFESSIONNEL;BAC PRO PROD;BAC PRO 22003 BIO-INDUSTRIES DE TRANSFORMATION;7;7;6;1;0;0;0;6;0;0;1;2;3;1
10557.0;2022;07;DIJON;MASCULIN;SCOLAIRE;BAC PROFESSIONNEL;BAC PRO PROD;BAC PRO 22105 BOULANGER-PÂTISSIER;20;20;19;1;0;0;0;19;0;0;7;9;3;1
10562.0;2022;07;DIJON;MASCULIN;SCOLAIRE;BAC PROFESSIONNEL;BAC PRO PROD;BAC PRO 23004 TECHN. ETUDES BAT.A ETUDES & ECO.;13;13;7;6;0;0;0;7;0;0;0;2;5;6
10568.0;2022;07;DIJON;MASCULIN;SCOLAIRE;BAC PROFESSIONNEL;BAC PRO PROD;BAC PRO 23208 METIERS ET ARTS DE LA PIERRE;3;3;2;0;1;1;0;3;0;0;0;1;2;0
10576.0;2022;07;DIJON;MASCULIN;SCOLAIRE;BAC PROFESSIONNEL;BAC PRO PROD;BAC PRO 25007 MAINTENANCE EQUIPEMENTS INDUST.;179;177;135;35;7;7;0;142;0;2;18;54;68;35
10584.0;2022;07;DIJON;MASCULIN;SCOLAIRE;BAC PROFESSIONNEL;BAC PRO PROD;BAC PRO 25221 MAINT.MATERIELS OPT.C ESP. VERTS;9;9;6;2;1;1;0;7;0;1;2;2;2;2
10585.0;2022;07;DIJON;MASCULIN;SCOLAIRE;BAC PROFESSIONNEL;BAC PRO PROD;BAC PRO 25303 AERONAUTIQUE OPTION SYSTEMES;11;11;11;0;0;0;0;11;0;0;5;3;3;0
10591.0;2022;07;DIJON;MASCULIN;SCOLAIRE;BAC PROFESSIONNEL;BAC PRO PROD;BAC PRO 25510 METIERS ELECT. ENVIRON. CONNECTES;212;212;159;45;8;5;3;164;0;11;34;58;61;48
10597.0;2022;07;DIJON;MASCULIN;SCOLAIRE;BAC PROFESSIONNEL;BAC PRO PROD;BAC PRO AG 21113 CGEVV;37;37;24;13;0;0;0;24;0;0;6;4;14;13
10601.0;2022;07;DIJON;MASCULIN;SCOLAIRE;BAC PROFESSIONNEL;BAC PRO PROD;BAC PRO AG 21210 COND GEST ENTR CANIN ET FELIN;11;11;11;0;0;0;0;11;0;0;0;2;9;0
10605.0;2022;07;DIJON;MASCULIN;SCOLAIRE;BAC PROFESSIONNEL;BAC PRO PROD;BAC PRO AG 21405 AMENAGEMENTS PAYSAGERS;48;48;43;5;0;0;0;43;0;1;5;12;25;5
10608.0;2022;07;DIJON;MASCULIN;SCOLAIRE;BAC PROFESSIONNEL;BAC PRO SERV;BAC PRO 30001 GESTION-ADMINISTRATION;109;109;84;23;2;2;0;86;0;1;9;31;45;23
10609.0;2022;07;DIJON;MASCULIN;SCOLAIRE;BAC PROFESSIONNEL;BAC PRO SERV;BAC PRO 31106 LOGISTIQUE;48;48;36;9;3;2;1;38;0;1;7;14;16;10
10621.0;2022;07;DIJON;MASCULIN;SCOLAIRE;BAC PROFESSIONNEL;BAC PRO SERV;BAC PRO 33102 PROTHESE DENTAIRE;4;4;4;0;0;0;0;4;0;0;1;1;2;0
10624.0;2022;07;DIJON;MASCULIN;SCOLAIRE;BAC PROFESSIONNEL;BAC PRO SERV;BAC PRO 34304 HYGIENE PROPRETE STERILISATION;4;4;2;2;0;0;0;2;0;0;2;0;0;2
10631.0;2022;07;DIJON;MASCULIN;SCOLAIRE;BAC TECHNOLOGIQUE;BAC STD2A;BAC STD2A SCIENCES & TECHNO. DESIGN-ARTS APPLIQUES;13;13;13;0;0;0;0;13;0;3;3;5;2;0
10632.0;2022;07;DIJON;MASCULIN;SCOLAIRE;BAC TECHNOLOGIQUE;BAC STHR;BAC STHR SC.&TEC. HOTELLERIE-RESTAURATION;23;23;20;0;3;3;0;23;1;3;5;6;8;0
10635.0;2022;07;DIJON;MASCULIN;SCOLAIRE;BAC TECHNOLOGIQUE;BAC STI2D;BAC STI2D INNOVATION TECHNO.  ET ECO CONCEPTION;245;245;194;6;45;29;16;223;0;1;19;67;136;22
10644.0;2022;08;GRENOBLE;FEMININ;APPRENTISSAGE;BAC PROFESSIONNEL;BAC PRO PROD;BAC PRO 22003 BIO-INDUSTRIES DE TRANSFORMATION;5;5;4;1;0;0;0;4;0;0;1;2;1;1
10645.0;2022;08;GRENOBLE;FEMININ;APPRENTISSAGE;BAC PROFESSIONNEL;BAC PRO PROD;BAC PRO 22004 PROC. CHIMIE EAU PAPIERS-CARTONS;5;5;5;0;0;0;0;5;0;4;1;0;0;0
10658.0;2022;08;GRENOBLE;FEMININ;APPRENTISSAGE;BAC PROFESSIONNEL;BAC PRO PROD;BAC PRO 25510 METIERS ELECT. ENVIRON. CONNECTES;2;2;2;0;0;0;0;2;0;2;0;0;0;0
10661.0;2022;08;GRENOBLE;FEMININ;APPRENTISSAGE;BAC PROFESSIONNEL;BAC PRO PROD;BAC PRO AG 22107 TEC CONS VTE ALIMENTATION P.ALIM;8;8;7;1;0;0;0;7;0;1;0;4;2;1
10662.0;2022;08;GRENOBLE;FEMININ;APPRENTISSAGE;BAC PROFESSIONNEL;BAC PRO SERV;BAC PRO 30001 GESTION-ADMINISTRATION;38;37;32;4;1;0;1;32;0;5;9;10;8;5
10665.0;2022;08;GRENOBLE;FEMININ;APPRENTISSAGE;BAC PROFESSIONNEL;BAC PRO SERV;BAC PRO 31212 METIERS DE L'ACCUEIL;26;26;20;5;1;0;1;20;0;2;4;12;2;6
10666.0;2022;08;GRENOBLE;FEMININ;APPRENTISSAGE;BAC PROFESSIONNEL;BAC PRO SERV;BAC PRO 31213 MET.COM.VEN.OP.A ANI.GES.ESP.COM.;141;138;116;12;10;9;1;125;0;4;23;46;52;13
10667.0;2022;08;GRENOBLE;FEMININ;APPRENTISSAGE;BAC PROFESSIONNEL;BAC PRO SERV;BAC PRO 31214 MET.COM.VEN.OP.B PR.CL.VA.OF.COM.;3;3;3;0;0;0;0;3;0;0;1;2;0;0
10670.0;2022;08;GRENOBLE;FEMININ;APPRENTISSAGE;BAC PROFESSIONNEL;BAC PRO SERV;BAC PRO 33004 ACC.SOINS-S.PERS. OPT.EN STRUCTUR;3;3;3;0;0;0;0;3;0;0;0;2;1;0
10671.0;2022;08;GRENOBLE;FEMININ;APPRENTISSAGE;BAC PROFESSIONNEL;BAC PRO SERV;BAC PRO 33403 COMMERC. SERVICES EN RESTAURATION;14;13;10;2;1;0;1;10;0;2;1;6;1;3
10676.0;2022;08;GRENOBLE;FEMININ;ENSEIGNEMENT A DISTANCE;BAC PROFESSIONNEL;BAC PRO PROD;BAC PRO 24301 METIERS DU CUIR : CHAUSSURES;1;1;0;1;0;0;0;0;0;0;0;0;0;1
10678.0;2022;08;GRENOBLE;FEMININ;ENSEIGNEMENT A DISTANCE;BAC PROFESSIONNEL;BAC PRO SERV;BAC PRO 31213 MET.COM.VEN.OP.A ANI.GES.ESP.COM.;6;5;5;0;0;0;0;5;0;0;1;1;3;0
10683.0;2022;08;GRENOBLE;FEMININ;ENSEIGNEMENT A DISTANCE;BAC TECHNOLOGIQUE;BAC STMG;BAC STMG GESTION ET FINANCE;3;3;2;0;1;1;0;3;0;0;0;1;2;0
10684.0;2022;08;GRENOBLE;FEMININ;ENSEIGNEMENT A DISTANCE;BAC TECHNOLOGIQUE;BAC STMG;BAC STMG MERCATIQUE (MARKETING);11;9;6;2;1;0;1;6;0;0;1;2;3;3
10687.0;2022;08;GRENOBLE;FEMININ;FORMATION CONTINUE;BAC PROFESSIONNEL;BAC PRO PROD;BAC PRO 25216 MAINT.VEHIC.OPTC MOTOCYCLES;1;1;1;0;0;0;0;1;0;0;1;0;0;0
10699.0;2022;08;GRENOBLE;FEMININ;INDIVIDUEL;BAC PROFESSIONNEL;BAC PRO SERV;BAC PRO 30001 GESTION-ADMINISTRATION;18;11;3;8;0;0;0;3;0;0;0;1;2;8
10702.0;2022;08;GRENOBLE;FEMININ;INDIVIDUEL;BAC PROFESSIONNEL;BAC PRO SERV;BAC PRO 31214 MET.COM.VEN.OP.B PR.CL.VA.OF.COM.;1;1;1;0;0;0;0;1;0;0;0;0;1;0
10705.0;2022;08;GRENOBLE;FEMININ;INDIVIDUEL;BAC TECHNOLOGIQUE;BAC ST2S;BAC ST2S SCIENCES & TECHNO. SANTE & SOCIAL;7;6;3;2;1;0;1;3;0;0;0;2;1;3
10707.0;2022;08;GRENOBLE;FEMININ;INDIVIDUEL;BAC TECHNOLOGIQUE;BAC STMG;BAC STMG GESTION ET FINANCE;6;2;2;0;0;0;0;2;0;0;1;1;0;0
10710.0;2022;08;GRENOBLE;FEMININ;INDIVIDUEL;BAC TECHNOLOGIQUE;BAC STMG;BAC STMG SYSTEMES D'INFORMATION DE GESTION;1;0;0;0;0;0;0;0;0;0;0;0;0;0
10725.0;2022;08;GRENOBLE;FEMININ;SCOLAIRE;BAC PROFESSIONNEL;BAC PRO PROD;BAC PRO 23404 TECHNICIEN CONSTRUCTEUR BOIS;1;1;1;0;0;0;0;1;0;1;0;0;0;0
10727.0;2022;08;GRENOBLE;FEMININ;SCOLAIRE;BAC PROFESSIONNEL;BAC PRO PROD;BAC PRO 23407 TECHNIC.FAB.BOIS ET MATERX ASSOC;2;2;1;1;0;0;0;1;0;0;1;0;0;1
10731.0;2022;08;GRENOBLE;FEMININ;SCOLAIRE;BAC PROFESSIONNEL;BAC PRO PROD;BAC PRO 24302 METIERS DU CUIR : MAROQUINERIE;7;7;4;3;0;0;0;4;0;0;1;2;1;3
10736.0;2022;08;GRENOBLE;FEMININ;SCOLAIRE;BAC PROFESSIONNEL;BAC PRO PROD;BAC PRO 25303 AERONAUTIQUE OPTION SYSTEMES;1;1;1;0;0;0;0;1;0;1;0;0;0;0
10742.0;2022;08;GRENOBLE;FEMININ;SCOLAIRE;BAC PROFESSIONNEL;BAC PRO PROD;BAC PRO 25514 SYST.NUM.OPT.B AUD.RES.EQUIP.DOM.;1;1;1;0;0;0;0;1;0;0;0;1;0;0
10743.0;2022;08;GRENOBLE;FEMININ;SCOLAIRE;BAC PROFESSIONNEL;BAC PRO PROD;BAC PRO 25515 SYST.NUM.OPT.C RES.INF.SYST.COMM.;4;4;3;1;0;0;0;3;0;1;1;1;0;1
10745.0;2022;08;GRENOBLE;FEMININ;SCOLAIRE;BAC PROFESSIONNEL;BAC PRO PROD;BAC PRO AG 21004 CGEA;68;65;50;15;0;0;0;50;0;3;3;27;17;15
10747.0;2022;08;GRENOBLE;FEMININ;SCOLAIRE;BAC PROFESSIONNEL;BAC PRO PROD;BAC PRO AG 21203 TECHN CONSEIL DE VENTE ANIMAL;45;44;36;8;0;0;0;36;0;1;5;12;18;8
10749.0;2022;08;GRENOBLE;FEMININ;SCOLAIRE;BAC PROFESSIONNEL;BAC PRO PROD;BAC PRO AG 21210 COND GEST ENTR CANIN ET FELIN;27;27;22;5;0;0;0;22;0;0;1;9;12;5
10751.0;2022;08;GRENOBLE;FEMININ;SCOLAIRE;BAC PROFESSIONNEL;BAC PRO PROD;BAC PRO AG 21302 GEST MILIEUX NATURELS FAUNE;15;15;15;0;0;0;0;15;0;1;2;8;4;0
10752.0;2022;08;GRENOBLE;FEMININ;SCOLAIRE;BAC PROFESSIONNEL;BAC PRO PROD;BAC PRO AG 21303 FORET;1;1;1;0;0;0;0;1;0;0;1;0;0;0
10758.0;2022;08;GRENOBLE;FEMININ;SCOLAIRE;BAC PROFESSIONNEL;BAC PRO SERV;BAC PRO 31106 LOGISTIQUE;18;18;13;4;1;1;0;14;0;1;3;6;4;4
10760.0;2022;08;GRENOBLE;FEMININ;SCOLAIRE;BAC PROFESSIONNEL;BAC PRO SERV;BAC PRO 31108 TRANSPORT;10;10;4;6;0;0;0;4;0;0;0;1;3;6
10761.0;2022;08;GRENOBLE;FEMININ;SCOLAIRE;BAC PROFESSIONNEL;BAC PRO SERV;BAC PRO 31109 TRANSPORT FLUVIAL;3;3;2;1;0;0;0;2;0;0;1;0;1;1
10762.0;2022;08;GRENOBLE;FEMININ;SCOLAIRE;BAC PROFESSIONNEL;BAC PRO SERV;BAC PRO 31212 METIERS DE L'ACCUEIL;247;246;213;18;15;10;5;223;0;15;60;73;75;23
10763.0;2022;08;GRENOBLE;FEMININ;SCOLAIRE;BAC PROFESSIONNEL;BAC PRO SERV;BAC PRO 31213 MET.COM.VEN.OP.A ANI.GES.ESP.COM.;401;401;358;32;11;7;4;365;0;11;86;171;97;36
10765.0;2022;08;GRENOBLE;FEMININ;SCOLAIRE;BAC PROFESSIONNEL;BAC PRO SERV;BAC PRO 32207 REAL.PR.IMPR.PLURI.OPTA.PR.GRAPH.;7;7;6;1;0;0;0;6;0;1;2;3;0;1
10774.0;2022;08;GRENOBLE;FEMININ;SCOLAIRE;BAC PROFESSIONNEL;BAC PRO SERV;BAC PRO 34304 HYGIENE PROPRETE STERILISATION;5;5;3;0;2;2;0;5;0;0;0;2;3;0
10787.0;2022;08;GRENOBLE;FEMININ;SCOLAIRE;BAC TECHNOLOGIQUE;BAC STI2D;BAC STI2D SYSTÈME D'INFORMATION  ET NUMERIQUE;19;19;16;1;2;1;1;17;0;0;6;7;4;2
10788.0;2022;08;GRENOBLE;FEMININ;SCOLAIRE;BAC TECHNOLOGIQUE;BAC STL;BAC STL BIOCHIM.-BIOLOGIE-BIOTECHNOL.;106;106;91;3;12;7;5;98;0;3;25;30;40;8
10803.0;2022;08;GRENOBLE;MASCULIN;APPRENTISSAGE;BAC PROFESSIONNEL;BAC PRO PROD;BAC PRO 23102 TRAVAUX PUBLICS;62;62;45;11;6;5;1;50;0;1;3;17;29;12
10804.0;2022;08;GRENOBLE;MASCULIN;APPRENTISSAGE;BAC PROFESSIONNEL;BAC PRO PROD;BAC PRO 23203 TECHNICIEN BAT. : ORG.REAL.GROS O;15;15;13;2;0;0;0;13;0;1;6;3;3;2
10807.0;2022;08;GRENOBLE;MASCULIN;APPRENTISSAGE;BAC PROFESSIONNEL;BAC PRO PROD;BAC PRO 23404 TECHNICIEN CONSTRUCTEUR BOIS;20;20;17;2;1;1;0;18;0;1;5;8;4;2
10808.0;2022;08;GRENOBLE;MASCULIN;APPRENTISSAGE;BAC PROFESSIONNEL;BAC PRO PROD;BAC PRO 23405 TECHNICIEN MENUISIER AGENCEUR;14;14;11;2;1;1;0;12;0;2;3;6;1;2
10817.0;2022;08;GRENOBLE;MASCULIN;APPRENTISSAGE;BAC PROFESSIONNEL;BAC PRO PROD;BAC PRO 25215 MAINT.VEHIC.OPTB VEHIC.TRANS.ROUT;43;43;38;2;3;1;2;39;0;2;10;20;7;4
10818.0;2022;08;GRENOBLE;MASCULIN;APPRENTISSAGE;BAC PROFESSIONNEL;BAC PRO PROD;BAC PRO 25216 MAINT.VEHIC.OPTC MOTOCYCLES;15;15;15;0;0;0;0;15;0;1;4;7;3;0
10821.0;2022;08;GRENOBLE;MASCULIN;APPRENTISSAGE;BAC PROFESSIONNEL;BAC PRO PROD;BAC PRO 25221 MAINT.MATERIELS OPT.C ESP. VERTS;14;14;8;6;0;0;0;8;0;0;1;3;4;6
10822.0;2022;08;GRENOBLE;MASCULIN;APPRENTISSAGE;BAC PROFESSIONNEL;BAC PRO PROD;BAC PRO 25303 AERONAUTIQUE OPTION SYSTEMES;16;16;14;2;0;0;0;14;0;3;6;3;2;2
10824.0;2022;08;GRENOBLE;MASCULIN;APPRENTISSAGE;BAC PROFESSIONNEL;BAC PRO PROD;BAC PRO 25408 REPARATION DES CARROSSERIES;13;13;12;1;0;0;0;12;0;1;2;3;6;1
10826.0;2022;08;GRENOBLE;MASCULIN;APPRENTISSAGE;BAC PROFESSIONNEL;BAC PRO PROD;BAC PRO 25509 TECHNIC. FROID CONDITIONNEMT AIR;4;4;1;1;2;0;2;1;0;0;1;0;0;3
10827.0;2022;08;GRENOBLE;MASCULIN;APPRENTISSAGE;BAC PROFESSIONNEL;BAC PRO PROD;BAC PRO 25510 METIERS ELECT. ENVIRON. CONNECTES;179;179;153;20;6;5;1;158;0;15;37;55;51;21
10833.0;2022;08;GRENOBLE;MASCULIN;APPRENTISSAGE;BAC PROFESSIONNEL;BAC PRO PROD;BAC PRO AG 21303 FORET;15;15;15;0;0;0;0;15;0;0;3;6;6;0
10838.0;2022;08;GRENOBLE;MASCULIN;APPRENTISSAGE;BAC PROFESSIONNEL;BAC PRO SERV;BAC PRO 31107 CONDUCT. TRANSP.ROUT.MARCHANDISES;8;8;8;0;0;0;0;8;0;0;2;2;4;0
10847.0;2022;08;GRENOBLE;MASCULIN;ENSEIGNEMENT A DISTANCE;BAC GENERAL;BAC GENERAL;BAC GENE 10019 BAC GENERAL;53;53;40;6;7;4;3;44;0;3;12;13;16;9
10848.0;2022;08;GRENOBLE;MASCULIN;ENSEIGNEMENT A DISTANCE;BAC PROFESSIONNEL;BAC PRO SERV;BAC PRO 30001 GESTION-ADMINISTRATION;4;3;2;1;0;0;0;2;0;0;0;1;1;1
10853.0;2022;08;GRENOBLE;MASCULIN;ENSEIGNEMENT A DISTANCE;BAC TECHNOLOGIQUE;BAC STMG;BAC STMG MERCATIQUE (MARKETING);5;5;3;1;1;1;0;4;0;0;0;0;4;1
10855.0;2022;08;GRENOBLE;MASCULIN;ENSEIGNEMENT A DISTANCE;BAC TECHNOLOGIQUE;BAC STMG;BAC STMG SYSTEMES D'INFORMATION DE GESTION;1;1;1;0;0;0;0;1;0;0;0;0;1;0
10859.0;2022;08;GRENOBLE;MASCULIN;INDIVIDUEL;BAC GENERAL;BAC GENERAL;BAC GENE 10019 BAC GENERAL;73;52;30;14;8;4;4;34;0;1;5;7;21;18
10874.0;2022;08;GRENOBLE;MASCULIN;INDIVIDUEL;BAC PROFESSIONNEL;BAC PRO PROD;BAC PRO AG 22107 TEC CONS VTE ALIMENTATION P.ALIM;1;0;0;0;0;0;0;0;0;0;0;0;0;0
10876.0;2022;08;GRENOBLE;MASCULIN;INDIVIDUEL;BAC PROFESSIONNEL;BAC PRO SERV;BAC PRO 31106 LOGISTIQUE;1;1;0;1;0;0;0;0;0;0;0;0;0;1
10878.0;2022;08;GRENOBLE;MASCULIN;INDIVIDUEL;BAC PROFESSIONNEL;BAC PRO SERV;BAC PRO 31213 MET.COM.VEN.OP.A ANI.GES.ESP.COM.;5;3;1;1;1;0;1;1;0;0;0;0;1;2
10884.0;2022;08;GRENOBLE;MASCULIN;INDIVIDUEL;BAC TECHNOLOGIQUE;BAC STI2D;BAC STI2D ENERGIES  ET ENVIRONNEMENT;1;1;0;1;0;0;0;0;0;0;0;0;0;1
10888.0;2022;08;GRENOBLE;MASCULIN;INDIVIDUEL;BAC TECHNOLOGIQUE;BAC STMG;BAC STMG GESTION ET FINANCE;5;3;2;0;1;0;1;2;0;0;0;0;2;1
10899.0;2022;08;GRENOBLE;MASCULIN;SCOLAIRE;BAC PROFESSIONNEL;BAC PRO PROD;BAC PRO 22503 PLASTIQUES ET COMPOSITES;4;4;2;1;1;0;1;2;0;0;0;1;1;2
10910.0;2022;08;GRENOBLE;MASCULIN;SCOLAIRE;BAC PROFESSIONNEL;BAC PRO PROD;BAC PRO 23405 TECHNICIEN MENUISIER AGENCEUR;113;113;90;17;6;4;2;94;0;4;27;35;28;19
10912.0;2022;08;GRENOBLE;MASCULIN;SCOLAIRE;BAC PROFESSIONNEL;BAC PRO PROD;BAC PRO 24202 ARTIS.& MET.ART : TAPIS.D'AMEUBL;2;2;1;1;0;0;0;1;0;0;0;0;1;1
10919.0;2022;08;GRENOBLE;MASCULIN;SCOLAIRE;BAC PROFESSIONNEL;BAC PRO PROD;BAC PRO 25106 TECHNICIEN D'USINAGE;138;138;87;40;11;7;4;94;0;5;16;39;34;44
10921.0;2022;08;GRENOBLE;MASCULIN;SCOLAIRE;BAC PROFESSIONNEL;BAC PRO PROD;BAC PRO 25214 MAINT.VEHIC.OPTA VOIT.PARTICUL.;147;147;116;26;5;4;1;120;0;7;26;45;42;27
10924.0;2022;08;GRENOBLE;MASCULIN;SCOLAIRE;BAC PROFESSIONNEL;BAC PRO PROD;BAC PRO 25303 AERONAUTIQUE OPTION SYSTEMES;12;12;11;1;0;0;0;11;0;2;2;5;2;1
10926.0;2022;08;GRENOBLE;MASCULIN;SCOLAIRE;BAC PROFESSIONNEL;BAC PRO PROD;BAC PRO 25408 REPARATION DES CARROSSERIES;62;62;41;18;3;1;2;42;0;3;6;13;20;20
10935.0;2022;08;GRENOBLE;MASCULIN;SCOLAIRE;BAC PROFESSIONNEL;BAC PRO PROD;BAC PRO AG 21114 CONDUITE PRODUCTIONS HORTICOLES;19;18;17;1;0;0;0;17;0;0;1;6;10;1
10946.0;2022;08;GRENOBLE;MASCULIN;SCOLAIRE;BAC PROFESSIONNEL;BAC PRO SERV;BAC PRO 30001 GESTION-ADMINISTRATION;271;271;163;98;10;7;3;170;0;4;19;66;81;101
10947.0;2022;08;GRENOBLE;MASCULIN;SCOLAIRE;BAC PROFESSIONNEL;BAC PRO SERV;BAC PRO 31106 LOGISTIQUE;82;82;60;13;9;5;4;65;0;3;11;29;22;17
10949.0;2022;08;GRENOBLE;MASCULIN;SCOLAIRE;BAC PROFESSIONNEL;BAC PRO SERV;BAC PRO 31108 TRANSPORT;30;30;22;8;0;0;0;22;0;2;4;9;7;8
10960.0;2022;08;GRENOBLE;MASCULIN;SCOLAIRE;BAC PROFESSIONNEL;BAC PRO SERV;BAC PRO 33101 OPTIQUE LUNETTERIE;9;9;7;2;0;0;0;7;0;0;0;6;1;2
10966.0;2022;08;GRENOBLE;MASCULIN;SCOLAIRE;BAC PROFESSIONNEL;BAC PRO SERV;BAC PRO AG 33002 SERV PERS TERRIT;79;77;66;11;0;0;0;66;0;3;9;24;30;11
10968.0;2022;08;GRENOBLE;MASCULIN;SCOLAIRE;BAC TECHNOLOGIQUE;BAC S2TMD;BAC S2TMD MUSIQUE;5;5;5;0;0;0;0;5;0;1;2;2;0;0
10971.0;2022;08;GRENOBLE;MASCULIN;SCOLAIRE;BAC TECHNOLOGIQUE;BAC STD2A;BAC STD2A SCIENCES & TECHNO. DESIGN-ARTS APPLIQUES;24;24;22;2;0;0;0;22;0;2;3;10;7;2
10972.0;2022;08;GRENOBLE;MASCULIN;SCOLAIRE;BAC TECHNOLOGIQUE;BAC STHR;BAC STHR SC.&TEC. HOTELLERIE-RESTAURATION;71;71;69;0;2;2;0;71;0;3;11;31;26;0
10973.0;2022;08;GRENOBLE;MASCULIN;SCOLAIRE;BAC TECHNOLOGIQUE;BAC STI2D;BAC STI2D ARCHITECTURE ET CONSTRUCTION;232;232;196;7;29;18;11;214;0;3;39;89;83;18
10975.0;2022;08;GRENOBLE;MASCULIN;SCOLAIRE;BAC TECHNOLOGIQUE;BAC STI2D;BAC STI2D INNOVATION TECHNO.  ET ECO CONCEPTION;522;522;460;18;44;27;17;487;1;10;79;177;220;35
10983.0;2022;32;GUADELOUPE;FEMININ;APPRENTISSAGE;BAC PROFESSIONNEL;BAC PRO SERV;BAC PRO 30001 GESTION-ADMINISTRATION;1;0;0;0;0;0;0;0;0;0;0;0;0;0
10995.0;2022;32;GUADELOUPE;FEMININ;FORMATION CONTINUE;BAC PROFESSIONNEL;BAC PRO SERV;BAC PRO 33603 ESTHETIQUE COSMETIQUE PARFUMERIE;1;1;0;1;0;0;0;0;0;0;0;0;0;1
11005.0;2022;32;GUADELOUPE;FEMININ;INDIVIDUEL;BAC PROFESSIONNEL;BAC PRO SERV;BAC PRO 33004 ACC.SOINS-S.PERS. OPT.EN STRUCTUR;3;2;0;2;0;0;0;0;0;0;0;0;0;2
11013.0;2022;32;GUADELOUPE;FEMININ;SCOLAIRE;BAC PROFESSIONNEL;BAC PRO PROD;BAC PRO 23003 ARTIS. & M.ART:MARCHANDISAGE VIS.;10;10;5;3;2;1;1;6;0;0;1;1;4;4
11028.0;2022;32;GUADELOUPE;FEMININ;SCOLAIRE;BAC PROFESSIONNEL;BAC PRO PROD;BAC PRO 25513 SYST.NUM.OPT.A SURETE SECURITE;1;1;1;0;0;0;0;1;0;0;0;1;0;0
11031.0;2022;32;GUADELOUPE;FEMININ;SCOLAIRE;BAC PROFESSIONNEL;BAC PRO PROD;BAC PRO AG 21004 CGEA;14;11;9;2;0;0;0;9;0;0;0;2;7;2
11032.0;2022;32;GUADELOUPE;FEMININ;SCOLAIRE;BAC PROFESSIONNEL;BAC PRO PROD;BAC PRO AG 21114 CONDUITE PRODUCTIONS HORTICOLES;7;7;6;1;0;0;0;6;0;0;0;1;5;1
11035.0;2022;32;GUADELOUPE;FEMININ;SCOLAIRE;BAC PROFESSIONNEL;BAC PRO SERV;BAC PRO 30001 GESTION-ADMINISTRATION;126;126;101;16;9;8;1;109;0;4;13;33;59;17
11039.0;2022;32;GUADELOUPE;FEMININ;SCOLAIRE;BAC PROFESSIONNEL;BAC PRO SERV;BAC PRO 31213 MET.COM.VEN.OP.A ANI.GES.ESP.COM.;70;70;50;14;6;3;3;53;0;1;9;21;22;17
11040.0;2022;32;GUADELOUPE;FEMININ;SCOLAIRE;BAC PROFESSIONNEL;BAC PRO SERV;BAC PRO 31214 MET.COM.VEN.OP.B PR.CL.VA.OF.COM.;37;37;26;4;7;7;0;33;0;0;0;15;18;4
11042.0;2022;32;GUADELOUPE;FEMININ;SCOLAIRE;BAC PROFESSIONNEL;BAC PRO SERV;BAC PRO 33002 SERVICES DE PROXIMITE  VIE LOCAL;39;39;25;12;2;2;0;27;0;0;3;12;12;12
11055.0;2022;32;GUADELOUPE;FEMININ;SCOLAIRE;BAC TECHNOLOGIQUE;BAC STHR;BAC STHR SC.&TEC. HOTELLERIE-RESTAURATION;13;13;13;0;0;0;0;13;0;0;4;4;5;0
11056.0;2022;32;GUADELOUPE;FEMININ;SCOLAIRE;BAC TECHNOLOGIQUE;BAC STI2D;BAC STI2D ARCHITECTURE ET CONSTRUCTION;10;10;6;1;3;2;1;8;0;0;1;2;5;2
11062.0;2022;32;GUADELOUPE;FEMININ;SCOLAIRE;BAC TECHNOLOGIQUE;BAC STMG;BAC STMG GESTION ET FINANCE;72;72;64;3;5;5;0;69;0;6;15;29;19;3
11066.0;2022;32;GUADELOUPE;MASCULIN;APPRENTISSAGE;BAC PROFESSIONNEL;BAC PRO PROD;BAC PRO 22106 CUISINE;1;1;0;1;0;0;0;0;0;0;0;0;0;1
11067.0;2022;32;GUADELOUPE;MASCULIN;APPRENTISSAGE;BAC PROFESSIONNEL;BAC PRO PROD;BAC PRO 23005 TECHN. ETUDES BAT B ASSIST.ARCHI.;2;2;1;1;0;0;0;1;0;0;0;1;0;1
11069.0;2022;32;GUADELOUPE;MASCULIN;APPRENTISSAGE;BAC PROFESSIONNEL;BAC PRO PROD;BAC PRO 25219 MAINT.MATERIELS OPT.A AGRICOLES;1;1;0;0;1;1;0;1;0;0;0;0;1;0
11074.0;2022;32;GUADELOUPE;MASCULIN;APPRENTISSAGE;BAC PROFESSIONNEL;BAC PRO SERV;BAC PRO AG 33002 SERV PERS TERRIT;1;1;0;1;0;0;0;0;0;0;0;0;0;1
11078.0;2022;32;GUADELOUPE;MASCULIN;FORMATION CONTINUE;BAC PROFESSIONNEL;BAC PRO PROD;BAC PRO 25510 METIERS ELECT. ENVIRON. CONNECTES;6;6;5;0;1;1;0;6;0;0;0;3;3;0
11080.0;2022;32;GUADELOUPE;MASCULIN;FORMATION CONTINUE;BAC PROFESSIONNEL;BAC PRO SERV;BAC PRO 31106 LOGISTIQUE;5;3;3;0;0;0;0;3;0;0;0;1;2;0
11085.0;2022;32;GUADELOUPE;MASCULIN;INDIVIDUEL;BAC PROFESSIONNEL;BAC PRO PROD;BAC PRO 25009 MAINTENANCE NAUTIQUE;1;1;0;1;0;0;0;0;0;0;0;0;0;1
11088.0;2022;32;GUADELOUPE;MASCULIN;INDIVIDUEL;BAC PROFESSIONNEL;BAC PRO SERV;BAC PRO 30001 GESTION-ADMINISTRATION;1;0;0;0;0;0;0;0;0;0;0;0;0;0
11099.0;2022;32;GUADELOUPE;MASCULIN;SCOLAIRE;BAC PROFESSIONNEL;BAC PRO PROD;BAC PRO 22105 BOULANGER-PÂTISSIER;5;5;5;0;0;0;0;5;0;0;1;3;1;0
11103.0;2022;32;GUADELOUPE;MASCULIN;SCOLAIRE;BAC PROFESSIONNEL;BAC PRO PROD;BAC PRO 23004 TECHN. ETUDES BAT.A ETUDES & ECO.;11;11;7;4;0;0;0;7;0;0;0;2;5;4
11109.0;2022;32;GUADELOUPE;MASCULIN;SCOLAIRE;BAC PROFESSIONNEL;BAC PRO PROD;BAC PRO 23405 TECHNICIEN MENUISIER AGENCEUR;40;39;22;15;2;2;0;24;0;1;0;1;22;15
11113.0;2022;32;GUADELOUPE;MASCULIN;SCOLAIRE;BAC PROFESSIONNEL;BAC PRO PROD;BAC PRO 25009 MAINTENANCE NAUTIQUE;65;62;37;16;9;5;4;42;0;0;5;9;28;20
11118.0;2022;32;GUADELOUPE;MASCULIN;SCOLAIRE;BAC PROFESSIONNEL;BAC PRO PROD;BAC PRO 25220 MAINT.MATERIELS OPT.B TP MANUT.;10;10;6;3;1;0;1;6;0;0;2;2;2;4
11120.0;2022;32;GUADELOUPE;MASCULIN;SCOLAIRE;BAC PROFESSIONNEL;BAC PRO PROD;BAC PRO 25406 OUVRAGES DU BATIMENT METALLERIE;15;14;7;2;5;3;2;10;0;0;1;1;8;4
11122.0;2022;32;GUADELOUPE;MASCULIN;SCOLAIRE;BAC PROFESSIONNEL;BAC PRO PROD;BAC PRO 25411 TECH.CHAUDRONNERIE INDUSTRIELLE;23;21;6;15;0;0;0;6;0;0;0;1;5;15
11125.0;2022;32;GUADELOUPE;MASCULIN;SCOLAIRE;BAC PROFESSIONNEL;BAC PRO PROD;BAC PRO 25513 SYST.NUM.OPT.A SURETE SECURITE;24;24;23;1;0;0;0;23;0;0;9;9;5;1
11139.0;2022;32;GUADELOUPE;MASCULIN;SCOLAIRE;BAC PROFESSIONNEL;BAC PRO SERV;BAC PRO 33002 SERVICES DE PROXIMITE  VIE LOCAL;7;7;7;0;0;0;0;7;0;0;2;3;2;0
11143.0;2022;32;GUADELOUPE;MASCULIN;SCOLAIRE;BAC PROFESSIONNEL;BAC PRO SERV;BAC PRO 34304 HYGIENE PROPRETE STERILISATION;2;2;0;2;0;0;0;0;0;0;0;0;0;2
11147.0;2022;32;GUADELOUPE;MASCULIN;SCOLAIRE;BAC TECHNOLOGIQUE;BAC S2TMD;BAC S2TMD MUSIQUE;3;3;3;0;0;0;0;3;0;1;1;1;0;0
11148.0;2022;32;GUADELOUPE;MASCULIN;SCOLAIRE;BAC TECHNOLOGIQUE;BAC S2TMD;BAC S2TMD THEATRE;1;1;1;0;0;0;0;1;0;0;1;0;0;0
11151.0;2022;32;GUADELOUPE;MASCULIN;SCOLAIRE;BAC TECHNOLOGIQUE;BAC STD2A;BAC STD2A SCIENCES & TECHNO. DESIGN-ARTS APPLIQUES;10;10;10;0;0;0;0;10;0;1;1;7;1;0
11158.0;2022;32;GUADELOUPE;MASCULIN;SCOLAIRE;BAC TECHNOLOGIQUE;BAC STL;BAC STL SCIENCES PHYSIQUES CHIMIQUES  EN LABORAT.;10;10;7;1;2;2;0;9;0;0;0;3;6;1
11163.0;2022;33;GUYANE;FEMININ;APPRENTISSAGE;BAC PROFESSIONNEL;BAC PRO SERV;BAC PRO 31212 METIERS DE L'ACCUEIL;1;1;1;0;0;0;0;1;0;0;0;1;0;0
11164.0;2022;33;GUYANE;FEMININ;APPRENTISSAGE;BAC PROFESSIONNEL;BAC PRO SERV;BAC PRO 31213 MET.COM.VEN.OP.A ANI.GES.ESP.COM.;7;4;3;1;0;0;0;3;0;0;0;0;3;1
11165.0;2022;33;GUYANE;FEMININ;APPRENTISSAGE;BAC PROFESSIONNEL;BAC PRO SERV;BAC PRO 31214 MET.COM.VEN.OP.B PR.CL.VA.OF.COM.;1;0;0;0;0;0;0;0;0;0;0;0;0;0
11170.0;2022;33;GUYANE;FEMININ;INDIVIDUEL;BAC GENERAL;BAC GENERAL;BAC GENE 10019 BAC GENERAL;8;6;2;3;1;0;1;2;0;0;0;1;1;4
11171.0;2022;33;GUYANE;FEMININ;INDIVIDUEL;BAC PROFESSIONNEL;BAC PRO PROD;BAC PRO 23004 TECHN. ETUDES BAT.A ETUDES & ECO.;1;1;0;1;0;0;0;0;0;0;0;0;0;1
11174.0;2022;33;GUYANE;FEMININ;INDIVIDUEL;BAC PROFESSIONNEL;BAC PRO SERV;BAC PRO 31212 METIERS DE L'ACCUEIL;1;0;0;0;0;0;0;0;0;0;0;0;0;0
11175.0;2022;33;GUYANE;FEMININ;INDIVIDUEL;BAC PROFESSIONNEL;BAC PRO SERV;BAC PRO 31213 MET.COM.VEN.OP.A ANI.GES.ESP.COM.;2;1;1;0;0;0;0;1;0;0;0;0;1;0
11178.0;2022;33;GUYANE;FEMININ;INDIVIDUEL;BAC PROFESSIONNEL;BAC PRO SERV;BAC PRO 33003 ACC.SOINS-S.PERS. OPT.A DOMICILE;1;1;0;1;0;0;0;0;0;0;0;0;0;1
11181.0;2022;33;GUYANE;FEMININ;INDIVIDUEL;BAC TECHNOLOGIQUE;BAC ST2S;BAC ST2S SCIENCES & TECHNO. SANTE & SOCIAL;5;2;0;2;0;0;0;0;0;0;0;0;0;2
11194.0;2022;33;GUYANE;FEMININ;SCOLAIRE;BAC PROFESSIONNEL;BAC PRO PROD;BAC PRO 23304 AMENAGEMENT FINITION BATIMENT;11;11;8;3;0;0;0;8;0;0;0;3;5;3
11197.0;2022;33;GUYANE;FEMININ;SCOLAIRE;BAC PROFESSIONNEL;BAC PRO PROD;BAC PRO 24203 METIERS DE LA MODE - VÊTEMENT;35;35;24;5;6;1;5;25;0;1;0;6;18;10
11199.0;2022;33;GUYANE;FEMININ;SCOLAIRE;BAC PROFESSIONNEL;BAC PRO PROD;BAC PRO 25509 TECHNIC. FROID CONDITIONNEMT AIR;1;0;0;0;0;0;0;0;0;0;0;0;0;0
11204.0;2022;33;GUYANE;FEMININ;SCOLAIRE;BAC PROFESSIONNEL;BAC PRO PROD;BAC PRO AG 22107 TEC CONS VTE ALIMENTATION P.ALIM;11;10;7;3;0;0;0;7;0;0;0;1;6;3
11208.0;2022;33;GUYANE;FEMININ;SCOLAIRE;BAC PROFESSIONNEL;BAC PRO SERV;BAC PRO 31212 METIERS DE L'ACCUEIL;86;86;54;14;18;9;9;63;0;0;4;23;36;23
11223.0;2022;33;GUYANE;FEMININ;SCOLAIRE;BAC TECHNOLOGIQUE;BAC STI2D;BAC STI2D ARCHITECTURE ET CONSTRUCTION;8;8;4;0;4;4;0;8;0;0;0;2;6;0
11224.0;2022;33;GUYANE;FEMININ;SCOLAIRE;BAC TECHNOLOGIQUE;BAC STI2D;BAC STI2D ENERGIES  ET ENVIRONNEMENT;3;3;3;0;0;0;0;3;0;0;2;1;0;0
11229.0;2022;33;GUYANE;FEMININ;SCOLAIRE;BAC TECHNOLOGIQUE;BAC STMG;BAC STMG GESTION ET FINANCE;57;57;40;4;13;11;2;51;0;2;8;14;27;6
11232.0;2022;33;GUYANE;FEMININ;SCOLAIRE;BAC TECHNOLOGIQUE;BAC STMG;BAC STMG SYSTEMES D'INFORMATION DE GESTION;10;10;3;2;5;5;0;8;0;0;0;1;7;2
11237.0;2022;33;GUYANE;MASCULIN;INDIVIDUEL;BAC GENERAL;BAC GENERAL;BAC GENE 10019 BAC GENERAL;2;1;0;0;1;1;0;1;0;0;0;0;1;0
11241.0;2022;33;GUYANE;MASCULIN;INDIVIDUEL;BAC PROFESSIONNEL;BAC PRO PROD;BAC PRO 25510 METIERS ELECT. ENVIRON. CONNECTES;1;1;0;1;0;0;0;0;0;0;0;0;0;1
11242.0;2022;33;GUYANE;MASCULIN;INDIVIDUEL;BAC PROFESSIONNEL;BAC PRO PROD;BAC PRO AG 21114 CONDUITE PRODUCTIONS HORTICOLES;1;0;0;0;0;0;0;0;0;0;0;0;0;0
11247.0;2022;33;GUYANE;MASCULIN;SCOLAIRE;BAC GENERAL;BAC GENERAL;BAC GENE 10019 BAC GENERAL;631;631;453;58;120;90;30;543;3;31;78;159;272;88
11268.0;2022;33;GUYANE;MASCULIN;SCOLAIRE;BAC PROFESSIONNEL;BAC PRO PROD;BAC PRO 25509 TECHNIC. FROID CONDITIONNEMT AIR;28;27;7;19;1;1;0;8;0;0;0;2;6;19
11272.0;2022;33;GUYANE;MASCULIN;SCOLAIRE;BAC PROFESSIONNEL;BAC PRO PROD;BAC PRO AG 21004 CGEA;20;19;15;4;0;0;0;15;0;0;1;1;13;4
11274.0;2022;33;GUYANE;MASCULIN;SCOLAIRE;BAC PROFESSIONNEL;BAC PRO PROD;BAC PRO AG 21405 AMENAGEMENTS PAYSAGERS;5;4;3;1;0;0;0;3;0;0;1;0;2;1
11275.0;2022;33;GUYANE;MASCULIN;SCOLAIRE;BAC PROFESSIONNEL;BAC PRO PROD;BAC PRO AG 22107 TEC CONS VTE ALIMENTATION P.ALIM;6;6;5;1;0;0;0;5;0;0;0;1;4;1
11288.0;2022;33;GUYANE;MASCULIN;SCOLAIRE;BAC PROFESSIONNEL;BAC PRO SERV;BAC PRO 34304 HYGIENE PROPRETE STERILISATION;10;10;4;6;0;0;0;4;0;0;0;2;2;6
11289.0;2022;33;GUYANE;MASCULIN;SCOLAIRE;BAC PROFESSIONNEL;BAC PRO SERV;BAC PRO 34403 METIERS DE LA SECURITE;14;14;13;0;1;0;1;13;0;0;0;3;10;1
11291.0;2022;33;GUYANE;MASCULIN;SCOLAIRE;BAC TECHNOLOGIQUE;BAC ST2S;BAC ST2S SCIENCES & TECHNO. SANTE & SOCIAL;37;37;21;9;7;5;2;26;0;0;0;7;19;11
11298.0;2022;33;GUYANE;MASCULIN;SCOLAIRE;BAC TECHNOLOGIQUE;BAC STL;BAC STL BIOCHIM.-BIOLOGIE-BIOTECHNOL.;8;8;2;2;4;3;1;5;0;0;0;1;4;3
11303.0;2022;33;GUYANE;MASCULIN;SCOLAIRE;BAC TECHNOLOGIQUE;BAC STMG;BAC STMG SYSTEMES D'INFORMATION DE GESTION;16;16;8;1;7;7;0;15;0;0;0;2;13;1
11312.0;2022;28;LA REUNION;FEMININ;INDIVIDUEL;BAC GENERAL;BAC GENERAL;BAC GENE 10019 BAC GENERAL;23;12;2;6;4;2;2;4;0;0;0;1;3;8
11320.0;2022;28;LA REUNION;FEMININ;INDIVIDUEL;BAC TECHNOLOGIQUE;BAC ST2S;BAC ST2S SCIENCES & TECHNO. SANTE & SOCIAL;6;3;2;0;1;0;1;2;0;0;0;0;2;1
11328.0;2022;28;LA REUNION;FEMININ;SCOLAIRE;BAC PROFESSIONNEL;BAC PRO PROD;BAC PRO 20102 PILOTE DE LIGNE DE PRODUCTION;2;2;2;0;0;0;0;2;0;0;1;1;0;0
11330.0;2022;28;LA REUNION;FEMININ;SCOLAIRE;BAC PROFESSIONNEL;BAC PRO PROD;BAC PRO 22004 PROC. CHIMIE EAU PAPIERS-CARTONS;1;1;1;0;0;0;0;1;0;0;0;1;0;0
11334.0;2022;28;LA REUNION;FEMININ;SCOLAIRE;BAC PROFESSIONNEL;BAC PRO PROD;BAC PRO 23003 ARTIS. & M.ART:MARCHANDISAGE VIS.;8;8;7;1;0;0;0;7;0;0;1;5;1;1
11346.0;2022;28;LA REUNION;FEMININ;SCOLAIRE;BAC PROFESSIONNEL;BAC PRO PROD;BAC PRO 25214 MAINT.VEHIC.OPTA VOIT.PARTICUL.;4;4;3;1;0;0;0;3;0;0;0;1;2;1
11355.0;2022;28;LA REUNION;FEMININ;SCOLAIRE;BAC PROFESSIONNEL;BAC PRO PROD;BAC PRO AG 21407 TEC CONS VTE UNIVERS JARDINERIE;1;1;1;0;0;0;0;1;0;0;0;0;1;0
11357.0;2022;28;LA REUNION;FEMININ;SCOLAIRE;BAC PROFESSIONNEL;BAC PRO SERV;BAC PRO 30001 GESTION-ADMINISTRATION;574;573;469;72;32;24;8;493;0;24;98;185;186;80
11374.0;2022;28;LA REUNION;FEMININ;SCOLAIRE;BAC PROFESSIONNEL;BAC PRO SERV;BAC PRO AG 33002 SERV PERS TERRIT;56;51;45;6;0;0;0;45;0;0;5;21;19;6
11375.0;2022;28;LA REUNION;FEMININ;SCOLAIRE;BAC TECHNOLOGIQUE;BAC ST2S;BAC ST2S SCIENCES & TECHNO. SANTE & SOCIAL;400;400;326;14;60;38;22;364;2;14;54;121;173;36
11376.0;2022;28;LA REUNION;FEMININ;SCOLAIRE;BAC TECHNOLOGIQUE;BAC STAV;BAC STAV AGRONOMIE ALIM ENV TERRITOI;10;10;9;1;0;0;0;9;0;0;1;1;7;1
11383.0;2022;28;LA REUNION;FEMININ;SCOLAIRE;BAC TECHNOLOGIQUE;BAC STL;BAC STL BIOCHIM.-BIOLOGIE-BIOTECHNOL.;77;77;54;1;22;14;8;68;0;3;11;15;39;9
11384.0;2022;28;LA REUNION;FEMININ;SCOLAIRE;BAC TECHNOLOGIQUE;BAC STL;BAC STL SCIENCES PHYSIQUES CHIMIQUES  EN LABORAT.;23;23;17;1;5;4;1;21;0;3;2;4;12;2
11386.0;2022;28;LA REUNION;FEMININ;SCOLAIRE;BAC TECHNOLOGIQUE;BAC STMG;BAC STMG MERCATIQUE (MARKETING);300;300;228;15;57;46;11;274;0;7;30;84;153;26
11388.0;2022;28;LA REUNION;FEMININ;SCOLAIRE;BAC TECHNOLOGIQUE;BAC STMG;BAC STMG SYSTEMES D'INFORMATION DE GESTION;13;13;7;2;4;4;0;11;0;0;1;2;8;2
11392.0;2022;28;LA REUNION;MASCULIN;APPRENTISSAGE;BAC PROFESSIONNEL;BAC PRO PROD;BAC PRO 23207 INTERV. SUR PATRIMOINE BATI OPT.C;4;4;4;0;0;0;0;4;0;0;1;2;1;0
11395.0;2022;28;LA REUNION;MASCULIN;APPRENTISSAGE;BAC PROFESSIONNEL;BAC PRO PROD;BAC PRO 25106 TECHNICIEN D'USINAGE;1;1;1;0;0;0;0;1;0;0;1;0;0;0
11402.0;2022;28;LA REUNION;MASCULIN;APPRENTISSAGE;BAC PROFESSIONNEL;BAC PRO SERV;BAC PRO 30001 GESTION-ADMINISTRATION;1;1;1;0;0;0;0;1;0;0;0;0;1;0
11403.0;2022;28;LA REUNION;MASCULIN;APPRENTISSAGE;BAC PROFESSIONNEL;BAC PRO SERV;BAC PRO 31213 MET.COM.VEN.OP.A ANI.GES.ESP.COM.;3;2;1;1;0;0;0;1;0;0;0;1;0;1
11412.0;2022;28;LA REUNION;MASCULIN;INDIVIDUEL;BAC PROFESSIONNEL;BAC PRO PROD;BAC PRO 25216 MAINT.VEHIC.OPTC MOTOCYCLES;2;1;0;1;0;0;0;0;0;0;0;0;0;1
11425.0;2022;28;LA REUNION;MASCULIN;SCOLAIRE;BAC PROFESSIONNEL;BAC PRO PROD;BACPRO 20002 ETUD.DEFINITION PRDTS INDUSTRIEL;5;5;3;2;0;0;0;3;0;1;0;1;1;2
11449.0;2022;28;LA REUNION;MASCULIN;SCOLAIRE;BAC PROFESSIONNEL;BAC PRO PROD;BAC PRO 24203 METIERS DE LA MODE - VÊTEMENT;1;1;1;0;0;0;0;1;0;0;0;1;0;0
11450.0;2022;28;LA REUNION;MASCULIN;SCOLAIRE;BAC PROFESSIONNEL;BAC PRO PROD;BAC PRO 25007 MAINTENANCE EQUIPEMENTS INDUST.;82;82;47;30;5;5;0;52;0;2;8;17;25;30
11452.0;2022;28;LA REUNION;MASCULIN;SCOLAIRE;BAC PROFESSIONNEL;BAC PRO PROD;BAC PRO 25214 MAINT.VEHIC.OPTA VOIT.PARTICUL.;152;152;99;35;18;12;6;111;0;1;15;36;59;41
11456.0;2022;28;LA REUNION;MASCULIN;SCOLAIRE;BAC PROFESSIONNEL;BAC PRO PROD;BAC PRO 25221 MAINT.MATERIELS OPT.C ESP. VERTS;3;3;1;1;1;1;0;2;0;0;1;0;1;1
11465.0;2022;28;LA REUNION;MASCULIN;SCOLAIRE;BAC PROFESSIONNEL;BAC PRO PROD;BAC PRO 25515 SYST.NUM.OPT.C RES.INF.SYST.COMM.;115;115;101;10;4;4;0;105;0;4;29;31;41;10
11469.0;2022;28;LA REUNION;MASCULIN;SCOLAIRE;BAC PROFESSIONNEL;BAC PRO PROD;BAC PRO AG 21302 GEST MILIEUX NATURELS FAUNE;15;14;13;1;0;0;0;13;0;0;2;7;4;1
11472.0;2022;28;LA REUNION;MASCULIN;SCOLAIRE;BAC PROFESSIONNEL;BAC PRO PROD;BAC PRO AG 22107 TEC CONS VTE ALIMENTATION P.ALIM;10;10;4;6;0;0;0;4;0;0;0;0;4;6
11474.0;2022;28;LA REUNION;MASCULIN;SCOLAIRE;BAC PROFESSIONNEL;BAC PRO SERV;BAC PRO 31106 LOGISTIQUE;69;69;46;16;7;5;2;51;0;2;6;25;18;18
11475.0;2022;28;LA REUNION;MASCULIN;SCOLAIRE;BAC PROFESSIONNEL;BAC PRO SERV;BAC PRO 31108 TRANSPORT;42;42;27;12;3;2;1;29;0;2;1;6;20;13
11486.0;2022;28;LA REUNION;MASCULIN;SCOLAIRE;BAC PROFESSIONNEL;BAC PRO SERV;BAC PRO 33403 COMMERC. SERVICES EN RESTAURATION;10;10;10;0;0;0;0;10;0;0;2;7;1;0
11505.0;2022;09;LILLE;FEMININ;APPRENTISSAGE;BAC PROFESSIONNEL;BAC PRO PROD;BAC PRO 20102 PILOTE DE LIGNE DE PRODUCTION;2;2;2;0;0;0;0;2;0;1;1;0;0;0
11506.0;2022;09;LILLE;FEMININ;APPRENTISSAGE;BAC PROFESSIONNEL;BAC PRO PROD;BAC PRO 22105 BOULANGER-PÂTISSIER;1;1;1;0;0;0;0;1;0;0;0;0;1;0
11531.0;2022;09;LILLE;FEMININ;APPRENTISSAGE;BAC PROFESSIONNEL;BAC PRO SERV;BAC PRO 31213 MET.COM.VEN.OP.A ANI.GES.ESP.COM.;140;127;91;29;7;5;2;96;0;5;18;26;47;31
11534.0;2022;09;LILLE;FEMININ;APPRENTISSAGE;BAC PROFESSIONNEL;BAC PRO SERV;BAC PRO 33403 COMMERC. SERVICES EN RESTAURATION;10;9;8;1;0;0;0;8;0;0;1;5;2;1
11544.0;2022;09;LILLE;FEMININ;ENSEIGNEMENT A DISTANCE;BAC TECHNOLOGIQUE;BAC STMG;BAC STMG GESTION ET FINANCE;1;1;1;0;0;0;0;1;0;0;0;1;0;0
11549.0;2022;09;LILLE;FEMININ;FORMATION CONTINUE;BAC PROFESSIONNEL;BAC PRO SERV;BAC PRO 30001 GESTION-ADMINISTRATION;16;16;15;1;0;0;0;15;0;1;4;6;4;1
11550.0;2022;09;LILLE;FEMININ;FORMATION CONTINUE;BAC PROFESSIONNEL;BAC PRO SERV;BAC PRO 31108 TRANSPORT;1;1;1;0;0;0;0;1;0;0;0;0;1;0
11558.0;2022;09;LILLE;FEMININ;INDIVIDUEL;BAC PROFESSIONNEL;BAC PRO PROD;BAC PRO AG 21004 CGEA;3;3;3;0;0;0;0;3;0;0;0;0;3;0
11559.0;2022;09;LILLE;FEMININ;INDIVIDUEL;BAC PROFESSIONNEL;BAC PRO PROD;BAC PRO AG 21114 CONDUITE PRODUCTIONS HORTICOLES;1;1;1;0;0;0;0;1;0;0;1;0;0;0
11562.0;2022;09;LILLE;FEMININ;INDIVIDUEL;BAC PROFESSIONNEL;BAC PRO SERV;BAC PRO 31212 METIERS DE L'ACCUEIL;1;1;1;0;0;0;0;1;0;0;0;0;1;0
11565.0;2022;09;LILLE;FEMININ;INDIVIDUEL;BAC PROFESSIONNEL;BAC PRO SERV;BAC PRO 32304 PHOTOGRAPHIE;1;0;0;0;0;0;0;0;0;0;0;0;0;0
11566.0;2022;09;LILLE;FEMININ;INDIVIDUEL;BAC PROFESSIONNEL;BAC PRO SERV;BAC PRO 33003 ACC.SOINS-S.PERS. OPT.A DOMICILE;2;1;1;0;0;0;0;1;0;0;0;0;1;0
11576.0;2022;09;LILLE;FEMININ;SCOLAIRE;BAC PROFESSIONNEL;BAC PRO PROD;BACPRO 20002 ETUD.DEFINITION PRDTS INDUSTRIEL;1;1;1;0;0;0;0;1;0;0;0;0;1;0
11577.0;2022;09;LILLE;FEMININ;SCOLAIRE;BAC PROFESSIONNEL;BAC PRO PROD;BAC PRO 22003 BIO-INDUSTRIES DE TRANSFORMATION;21;21;16;4;1;0;1;16;0;2;3;11;0;5
11579.0;2022;09;LILLE;FEMININ;SCOLAIRE;BAC PROFESSIONNEL;BAC PRO PROD;BAC PRO 22105 BOULANGER-PÂTISSIER;48;48;45;2;1;1;0;46;0;5;12;18;11;2
11581.0;2022;09;LILLE;FEMININ;SCOLAIRE;BAC PROFESSIONNEL;BAC PRO PROD;BAC PRO 22403 ARTS.& MET.ART:MET.ENSEIGN SIGNA;4;4;4;0;0;0;0;4;0;0;0;3;1;0
11584.0;2022;09;LILLE;FEMININ;SCOLAIRE;BAC PROFESSIONNEL;BAC PRO PROD;BAC PRO 23004 TECHN. ETUDES BAT.A ETUDES & ECO.;17;17;13;2;2;2;0;15;0;0;1;6;8;2
11599.0;2022;09;LILLE;FEMININ;SCOLAIRE;BAC PROFESSIONNEL;BAC PRO PROD;BAC PRO 25303 AERONAUTIQUE OPTION SYSTEMES;1;1;0;1;0;0;0;0;0;0;0;0;0;1
11603.0;2022;09;LILLE;FEMININ;SCOLAIRE;BAC PROFESSIONNEL;BAC PRO PROD;BAC PRO 25510 METIERS ELECT. ENVIRON. CONNECTES;15;15;10;3;2;1;1;11;0;2;2;3;4;4
11604.0;2022;09;LILLE;FEMININ;SCOLAIRE;BAC PROFESSIONNEL;BAC PRO PROD;BAC PRO 25514 SYST.NUM.OPT.B AUD.RES.EQUIP.DOM.;1;1;1;0;0;0;0;1;0;0;1;0;0;0
11620.0;2022;09;LILLE;FEMININ;SCOLAIRE;BAC PROFESSIONNEL;BAC PRO SERV;BAC PRO 31108 TRANSPORT;23;23;14;7;2;0;2;14;0;0;3;7;4;9
11622.0;2022;09;LILLE;FEMININ;SCOLAIRE;BAC PROFESSIONNEL;BAC PRO SERV;BAC PRO 31213 MET.COM.VEN.OP.A ANI.GES.ESP.COM.;1211;1204;921;225;58;23;35;944;0;31;182;323;408;260
11624.0;2022;09;LILLE;FEMININ;SCOLAIRE;BAC PROFESSIONNEL;BAC PRO SERV;BAC PRO 32207 REAL.PR.IMPR.PLURI.OPTA.PR.GRAPH.;5;5;4;1;0;0;0;4;0;2;0;0;2;1
11628.0;2022;09;LILLE;FEMININ;SCOLAIRE;BAC PROFESSIONNEL;BAC PRO SERV;BAC PRO 33002 SERVICES DE PROXIMITE  VIE LOCAL;145;144;132;5;7;4;3;136;0;12;29;52;43;8
11633.0;2022;09;LILLE;FEMININ;SCOLAIRE;BAC PROFESSIONNEL;BAC PRO SERV;BAC PRO 33103 TECHNICIEN APPAREIL. ORTHOPEDIQUE;5;5;3;2;0;0;0;3;0;0;0;1;2;2
11638.0;2022;09;LILLE;FEMININ;SCOLAIRE;BAC PROFESSIONNEL;BAC PRO SERV;BAC PRO 34403 METIERS DE LA SECURITE;76;76;64;7;5;4;1;68;0;1;7;32;28;8
11640.0;2022;09;LILLE;FEMININ;SCOLAIRE;BAC TECHNOLOGIQUE;BAC S2TMD;BAC S2TMD DANSE;5;5;5;0;0;0;0;5;0;3;1;0;1;0
11643.0;2022;09;LILLE;FEMININ;SCOLAIRE;BAC TECHNOLOGIQUE;BAC STAV;BAC STAV AGRONOMIE ALIM ENV TERRITOI;131;131;127;4;0;0;0;127;0;2;14;44;67;4
11645.0;2022;09;LILLE;FEMININ;SCOLAIRE;BAC TECHNOLOGIQUE;BAC STHR;BAC STHR SC.&TEC. HOTELLERIE-RESTAURATION;47;47;43;1;3;1;2;44;2;5;13;18;6;3
11646.0;2022;09;LILLE;FEMININ;SCOLAIRE;BAC TECHNOLOGIQUE;BAC STI2D;BAC STI2D ARCHITECTURE ET CONSTRUCTION;52;52;40;1;11;6;5;46;0;2;9;12;23;6
11652.0;2022;09;LILLE;FEMININ;SCOLAIRE;BAC TECHNOLOGIQUE;BAC STMG;BAC STMG GESTION ET FINANCE;328;328;276;11;41;26;15;302;0;12;50;108;132;26
11654.0;2022;09;LILLE;FEMININ;SCOLAIRE;BAC TECHNOLOGIQUE;BAC STMG;BAC STMG RESSOURCES HUMAINES ET COMMUNICATION;810;810;633;60;117;86;31;719;0;13;81;231;394;91
11658.0;2022;09;LILLE;MASCULIN;APPRENTISSAGE;BAC PROFESSIONNEL;BAC PRO PROD;BAC PRO 22105 BOULANGER-PÂTISSIER;1;1;0;1;0;0;0;0;0;0;0;0;0;1
11661.0;2022;09;LILLE;MASCULIN;APPRENTISSAGE;BAC PROFESSIONNEL;BAC PRO PROD;BAC PRO 22703 TECHN.INSTALL.SYST.ENERG.CLIMATI;33;33;22;10;1;0;1;22;0;3;3;7;9;11
11662.0;2022;09;LILLE;MASCULIN;APPRENTISSAGE;BAC PROFESSIONNEL;BAC PRO PROD;BAC PRO 22704 TECHN. MAINT. SYST.ENERG.CLIMATI;27;25;21;4;0;0;0;21;0;2;6;9;4;4
11666.0;2022;09;LILLE;MASCULIN;APPRENTISSAGE;BAC PROFESSIONNEL;BAC PRO PROD;BAC PRO 23303 MENUISERIE ALUMINIUM-VERRE;11;11;11;0;0;0;0;11;0;1;1;5;4;0
11668.0;2022;09;LILLE;MASCULIN;APPRENTISSAGE;BAC PROFESSIONNEL;BAC PRO PROD;BAC PRO 23404 TECHNICIEN CONSTRUCTEUR BOIS;3;3;1;2;0;0;0;1;0;0;0;0;1;2
11669.0;2022;09;LILLE;MASCULIN;APPRENTISSAGE;BAC PROFESSIONNEL;BAC PRO PROD;BAC PRO 23405 TECHNICIEN MENUISIER AGENCEUR;32;32;15;16;1;1;0;16;0;1;4;5;6;16
11674.0;2022;09;LILLE;MASCULIN;APPRENTISSAGE;BAC PROFESSIONNEL;BAC PRO PROD;BAC PRO 25106 TECHNICIEN D'USINAGE;16;16;9;6;1;1;0;10;0;0;4;2;4;6
11675.0;2022;09;LILLE;MASCULIN;APPRENTISSAGE;BAC PROFESSIONNEL;BAC PRO PROD;BAC PRO 25214 MAINT.VEHIC.OPTA VOIT.PARTICUL.;130;124;89;25;10;5;5;94;0;10;15;30;39;30
11683.0;2022;09;LILLE;MASCULIN;APPRENTISSAGE;BAC PROFESSIONNEL;BAC PRO PROD;BAC PRO 25408 REPARATION DES CARROSSERIES;26;26;22;4;0;0;0;22;0;4;9;6;3;4
11687.0;2022;09;LILLE;MASCULIN;APPRENTISSAGE;BAC PROFESSIONNEL;BAC PRO PROD;BAC PRO 25510 METIERS ELECT. ENVIRON. CONNECTES;140;139;119;11;9;2;7;121;0;20;24;48;29;18
11693.0;2022;09;LILLE;MASCULIN;APPRENTISSAGE;BAC PROFESSIONNEL;BAC PRO PROD;BAC PRO AG 21211 COND GEST ENTR HIPPIQUE;5;5;5;0;0;0;0;5;0;0;1;0;4;0
11695.0;2022;09;LILLE;MASCULIN;APPRENTISSAGE;BAC PROFESSIONNEL;BAC PRO PROD;BAC PRO AG 22107 TEC CONS VTE ALIMENTATION P.ALIM;21;18;16;2;0;0;0;16;0;0;3;5;8;2
11700.0;2022;09;LILLE;MASCULIN;APPRENTISSAGE;BAC PROFESSIONNEL;BAC PRO SERV;BAC PRO 32303 ART.& MET.ART:COM.VIS.VIS.PLURI-M;5;5;5;0;0;0;0;5;0;0;2;1;2;0
11702.0;2022;09;LILLE;MASCULIN;APPRENTISSAGE;BAC PROFESSIONNEL;BAC PRO SERV;BAC PRO 33403 COMMERC. SERVICES EN RESTAURATION;16;15;11;3;1;1;0;12;0;0;3;3;6;3
11719.0;2022;09;LILLE;MASCULIN;FORMATION CONTINUE;BAC PROFESSIONNEL;BAC PRO PROD;BAC PRO 25214 MAINT.VEHIC.OPTA VOIT.PARTICUL.;1;1;1;0;0;0;0;1;0;1;0;0;0;0
11720.0;2022;09;LILLE;MASCULIN;FORMATION CONTINUE;BAC PROFESSIONNEL;BAC PRO PROD;BAC PRO 25216 MAINT.VEHIC.OPTC MOTOCYCLES;1;1;1;0;0;0;0;1;0;1;0;0;0;0
11723.0;2022;09;LILLE;MASCULIN;FORMATION CONTINUE;BAC PROFESSIONNEL;BAC PRO PROD;BAC PRO 25510 METIERS ELECT. ENVIRON. CONNECTES;1;1;1;0;0;0;0;1;0;1;0;0;0;0
11732.0;2022;09;LILLE;MASCULIN;INDIVIDUEL;BAC PROFESSIONNEL;BAC PRO PROD;BAC PRO 23304 AMENAGEMENT FINITION BATIMENT;1;0;0;0;0;0;0;0;0;0;0;0;0;0
11736.0;2022;09;LILLE;MASCULIN;INDIVIDUEL;BAC PROFESSIONNEL;BAC PRO PROD;BAC PRO 25408 REPARATION DES CARROSSERIES;1;1;1;0;0;0;0;1;0;0;1;0;0;0
11737.0;2022;09;LILLE;MASCULIN;INDIVIDUEL;BAC PROFESSIONNEL;BAC PRO PROD;BAC PRO 25509 TECHNIC. FROID CONDITIONNEMT AIR;1;0;0;0;0;0;0;0;0;0;0;0;0;0
11746.0;2022;09;LILLE;MASCULIN;INDIVIDUEL;BAC PROFESSIONNEL;BAC PRO SERV;BAC PRO 31106 LOGISTIQUE;1;0;0;0;0;0;0;0;0;0;0;0;0;0
11752.0;2022;09;LILLE;MASCULIN;INDIVIDUEL;BAC PROFESSIONNEL;BAC PRO SERV;BAC PRO 34403 METIERS DE LA SECURITE;4;2;1;1;0;0;0;1;0;0;0;0;1;1
11753.0;2022;09;LILLE;MASCULIN;INDIVIDUEL;BAC TECHNOLOGIQUE;BAC ST2S;BAC ST2S SCIENCES & TECHNO. SANTE & SOCIAL;7;3;2;0;1;1;0;3;0;0;0;0;3;0
11756.0;2022;09;LILLE;MASCULIN;INDIVIDUEL;BAC TECHNOLOGIQUE;BAC STMG;BAC STMG GESTION ET FINANCE;11;4;1;1;2;2;0;3;0;0;1;0;2;1
11761.0;2022;09;LILLE;MASCULIN;SCOLAIRE;BAC PROFESSIONNEL;BAC PRO PROD;BAC PRO 22003 BIO-INDUSTRIES DE TRANSFORMATION;13;13;10;3;0;0;0;10;0;1;0;4;5;3
11766.0;2022;09;LILLE;MASCULIN;SCOLAIRE;BAC PROFESSIONNEL;BAC PRO PROD;BAC PRO 22303 FONDERIE;14;14;10;4;0;0;0;10;0;1;1;5;3;4
11768.0;2022;09;LILLE;MASCULIN;SCOLAIRE;BAC PROFESSIONNEL;BAC PRO PROD;BAC PRO 22503 PLASTIQUES ET COMPOSITES;15;15;11;4;0;0;0;11;0;1;1;4;5;4
11769.0;2022;09;LILLE;MASCULIN;SCOLAIRE;BAC PROFESSIONNEL;BAC PRO PROD;BAC PRO 22703 TECHN.INSTALL.SYST.ENERG.CLIMATI;110;108;64;42;2;1;1;65;0;3;8;20;34;43
11772.0;2022;09;LILLE;MASCULIN;SCOLAIRE;BAC PROFESSIONNEL;BAC PRO PROD;BAC PRO 23004 TECHN. ETUDES BAT.A ETUDES & ECO.;54;54;33;21;0;0;0;33;0;2;5;14;12;21
11777.0;2022;09;LILLE;MASCULIN;SCOLAIRE;BAC PROFESSIONNEL;BAC PRO PROD;BAC PRO 23205 INTERV. SUR PATRIMOINE BATI OPT.A;7;7;4;1;2;0;2;4;0;0;0;1;3;3
11779.0;2022;09;LILLE;MASCULIN;SCOLAIRE;BAC PROFESSIONNEL;BAC PRO PROD;BAC PRO 23304 AMENAGEMENT FINITION BATIMENT;104;104;64;25;15;10;5;74;0;1;10;26;37;30
11785.0;2022;09;LILLE;MASCULIN;SCOLAIRE;BAC PROFESSIONNEL;BAC PRO PROD;BAC PRO 25007 MAINTENANCE EQUIPEMENTS INDUST.;390;390;269;108;13;8;5;277;0;2;37;117;121;113
11786.0;2022;09;LILLE;MASCULIN;SCOLAIRE;BAC PROFESSIONNEL;BAC PRO PROD;BAC PRO 25106 TECHNICIEN D'USINAGE;110;110;93;12;5;4;1;97;0;2;19;38;38;13
11792.0;2022;09;LILLE;MASCULIN;SCOLAIRE;BAC PROFESSIONNEL;BAC PRO PROD;BAC PRO 25303 AERONAUTIQUE OPTION SYSTEMES;20;20;20;0;0;0;0;20;0;1;4;12;3;0
11796.0;2022;09;LILLE;MASCULIN;SCOLAIRE;BAC PROFESSIONNEL;BAC PRO PROD;BAC PRO 25411 TECH.CHAUDRONNERIE INDUSTRIELLE;151;151;110;32;9;6;3;116;0;3;19;39;55;35
11801.0;2022;09;LILLE;MASCULIN;SCOLAIRE;BAC PROFESSIONNEL;BAC PRO PROD;BAC PRO 25515 SYST.NUM.OPT.C RES.INF.SYST.COMM.;363;360;296;49;15;15;0;311;0;15;83;113;100;49
11836.0;2022;09;LILLE;MASCULIN;SCOLAIRE;BAC PROFESSIONNEL;BAC PRO SERV;BAC PRO AG 33002 SERV PERS TERRIT;15;15;14;1;0;0;0;14;0;1;0;6;7;1
11841.0;2022;09;LILLE;MASCULIN;SCOLAIRE;BAC TECHNOLOGIQUE;BAC STD2A;BAC STD2A SCIENCES & TECHNO. DESIGN-ARTS APPLIQUES;46;46;42;1;3;3;0;45;1;1;14;8;21;1
11848.0;2022;09;LILLE;MASCULIN;SCOLAIRE;BAC TECHNOLOGIQUE;BAC STL;BAC STL SCIENCES PHYSIQUES CHIMIQUES  EN LABORAT.;75;75;66;0;9;4;5;70;0;4;10;21;35;5
11868.0;2022;22;LIMOGES;FEMININ;ENSEIGNEMENT A DISTANCE;BAC TECHNOLOGIQUE;BAC STMG;BAC STMG RESSOURCES HUMAINES ET COMMUNICATION;2;2;1;0;1;1;0;2;0;0;1;0;1;0
11870.0;2022;22;LIMOGES;FEMININ;FORMATION CONTINUE;BAC PROFESSIONNEL;BAC PRO SERV;BAC PRO 30001 GESTION-ADMINISTRATION;4;4;4;0;0;0;0;4;0;0;2;2;0;0
11881.0;2022;22;LIMOGES;FEMININ;SCOLAIRE;BAC GENERAL;BAC GENERAL;BAC GENE 10019 BAC GENERAL;1880;1880;1749;14;117;81;36;1830;28;220;447;602;533;50
11888.0;2022;22;LIMOGES;FEMININ;SCOLAIRE;BAC PROFESSIONNEL;BAC PRO PROD;BAC PRO 24202 ARTIS.& MET.ART : TAPIS.D'AMEUBL;9;9;9;0;0;0;0;9;0;1;2;3;3;0
11889.0;2022;22;LIMOGES;FEMININ;SCOLAIRE;BAC PROFESSIONNEL;BAC PRO PROD;BAC PRO 24203 METIERS DE LA MODE - VÊTEMENT;31;31;28;2;1;1;0;29;0;2;1;9;17;2
11892.0;2022;22;LIMOGES;FEMININ;SCOLAIRE;BAC PROFESSIONNEL;BAC PRO PROD;BAC PRO 25107 TECHNICIEN OUTILLEUR;1;1;1;0;0;0;0;1;0;0;0;0;1;0
11893.0;2022;22;LIMOGES;FEMININ;SCOLAIRE;BAC PROFESSIONNEL;BAC PRO PROD;BAC PRO 25108 TECHNICIEN MODELEUR;1;1;0;1;0;0;0;0;0;0;0;0;0;1
11895.0;2022;22;LIMOGES;FEMININ;SCOLAIRE;BAC PROFESSIONNEL;BAC PRO PROD;BAC PRO 25411 TECH.CHAUDRONNERIE INDUSTRIELLE;1;1;1;0;0;0;0;1;0;0;0;0;1;0
11897.0;2022;22;LIMOGES;FEMININ;SCOLAIRE;BAC PROFESSIONNEL;BAC PRO PROD;BAC PRO 25515 SYST.NUM.OPT.C RES.INF.SYST.COMM.;1;1;1;0;0;0;0;1;0;0;0;1;0;0
11906.0;2022;22;LIMOGES;FEMININ;SCOLAIRE;BAC PROFESSIONNEL;BAC PRO SERV;BAC PRO 31106 LOGISTIQUE;4;4;4;0;0;0;0;4;0;1;0;3;0;0
11908.0;2022;22;LIMOGES;FEMININ;SCOLAIRE;BAC PROFESSIONNEL;BAC PRO SERV;BAC PRO 31212 METIERS DE L'ACCUEIL;19;19;13;5;1;1;0;14;0;0;3;6;5;5
11911.0;2022;22;LIMOGES;FEMININ;SCOLAIRE;BAC PROFESSIONNEL;BAC PRO SERV;BAC PRO 32207 REAL.PR.IMPR.PLURI.OPTA.PR.GRAPH.;7;7;6;0;1;0;1;6;0;0;3;2;1;1
11912.0;2022;22;LIMOGES;FEMININ;SCOLAIRE;BAC PROFESSIONNEL;BAC PRO SERV;BAC PRO 32208 REAL.PR.IMPR.PLURI.OPTB.PR.IMPR.;1;1;1;0;0;0;0;1;0;0;0;1;0;0
11914.0;2022;22;LIMOGES;FEMININ;SCOLAIRE;BAC PROFESSIONNEL;BAC PRO SERV;BAC PRO 33002 SERVICES DE PROXIMITE  VIE LOCAL;22;22;19;2;1;1;0;20;0;1;8;7;4;2
11932.0;2022;22;LIMOGES;FEMININ;SCOLAIRE;BAC TECHNOLOGIQUE;BAC STL;BAC STL SCIENCES PHYSIQUES CHIMIQUES  EN LABORAT.;16;16;13;0;3;3;0;16;0;1;2;5;8;0
11933.0;2022;22;LIMOGES;FEMININ;SCOLAIRE;BAC TECHNOLOGIQUE;BAC STMG;BAC STMG GESTION ET FINANCE;40;40;37;1;2;2;0;39;0;0;7;25;7;1
11940.0;2022;22;LIMOGES;MASCULIN;APPRENTISSAGE;BAC PROFESSIONNEL;BAC PRO PROD;BAC PRO 23102 TRAVAUX PUBLICS;14;14;13;1;0;0;0;13;0;0;4;6;3;1
11942.0;2022;22;LIMOGES;MASCULIN;APPRENTISSAGE;BAC PROFESSIONNEL;BAC PRO PROD;BAC PRO 23205 INTERV. SUR PATRIMOINE BATI OPT.A;7;7;6;1;0;0;0;6;0;0;1;2;3;1
11946.0;2022;22;LIMOGES;MASCULIN;APPRENTISSAGE;BAC PROFESSIONNEL;BAC PRO PROD;BAC PRO 23404 TECHNICIEN CONSTRUCTEUR BOIS;1;1;1;0;0;0;0;1;0;0;0;1;0;0
11948.0;2022;22;LIMOGES;MASCULIN;APPRENTISSAGE;BAC PROFESSIONNEL;BAC PRO PROD;BAC PRO 25007 MAINTENANCE EQUIPEMENTS INDUST.;18;18;15;2;1;1;0;16;0;0;2;6;8;2
11963.0;2022;22;LIMOGES;MASCULIN;APPRENTISSAGE;BAC PROFESSIONNEL;BAC PRO SERV;BAC PRO 30001 GESTION-ADMINISTRATION;1;1;1;0;0;0;0;1;0;0;1;0;0;0
11964.0;2022;22;LIMOGES;MASCULIN;APPRENTISSAGE;BAC PROFESSIONNEL;BAC PRO SERV;BAC PRO 31212 METIERS DE L'ACCUEIL;1;1;1;0;0;0;0;1;0;0;0;1;0;0
11970.0;2022;22;LIMOGES;MASCULIN;ENSEIGNEMENT A DISTANCE;BAC PROFESSIONNEL;BAC PRO SERV;BAC PRO 30001 GESTION-ADMINISTRATION;1;1;0;1;0;0;0;0;0;0;0;0;0;1
11972.0;2022;22;LIMOGES;MASCULIN;FORMATION CONTINUE;BAC PROFESSIONNEL;BAC PRO PROD;BAC PRO 23102 TRAVAUX PUBLICS;68;68;65;1;2;2;0;67;0;3;12;35;17;1
11976.0;2022;22;LIMOGES;MASCULIN;INDIVIDUEL;BAC PROFESSIONNEL;BAC PRO PROD;BAC PRO 25214 MAINT.VEHIC.OPTA VOIT.PARTICUL.;1;1;1;0;0;0;0;1;0;0;0;0;1;0
11988.0;2022;22;LIMOGES;MASCULIN;SCOLAIRE;BAC PROFESSIONNEL;BAC PRO PROD;BAC PRO 22004 PROC. CHIMIE EAU PAPIERS-CARTONS;11;11;7;4;0;0;0;7;0;1;0;1;5;4
11994.0;2022;22;LIMOGES;MASCULIN;SCOLAIRE;BAC PROFESSIONNEL;BAC PRO PROD;BAC PRO 23005 TECHN. ETUDES BAT B ASSIST.ARCHI.;10;10;10;0;0;0;0;10;0;0;0;5;5;0
12003.0;2022;22;LIMOGES;MASCULIN;SCOLAIRE;BAC PROFESSIONNEL;BAC PRO PROD;BAC PRO 25107 TECHNICIEN OUTILLEUR;4;4;4;0;0;0;0;4;0;0;1;1;2;0
12021.0;2022;22;LIMOGES;MASCULIN;SCOLAIRE;BAC PROFESSIONNEL;BAC PRO PROD;BAC PRO AG 21203 TECHN CONSEIL DE VENTE ANIMAL;16;15;10;5;0;0;0;10;0;1;2;5;2;5
12022.0;2022;22;LIMOGES;MASCULIN;SCOLAIRE;BAC PROFESSIONNEL;BAC PRO PROD;BAC PRO AG 21204 PROD-AQUACOLES;12;9;5;4;0;0;0;5;0;0;1;1;3;4
12025.0;2022;22;LIMOGES;MASCULIN;SCOLAIRE;BAC PROFESSIONNEL;BAC PRO PROD;BAC PRO AG 21405 AMENAGEMENTS PAYSAGERS;18;18;17;1;0;0;0;17;0;0;3;5;9;1
12030.0;2022;22;LIMOGES;MASCULIN;SCOLAIRE;BAC PROFESSIONNEL;BAC PRO SERV;BAC PRO 31108 TRANSPORT;8;8;4;4;0;0;0;4;0;0;0;1;3;4
12038.0;2022;22;LIMOGES;MASCULIN;SCOLAIRE;BAC PROFESSIONNEL;BAC PRO SERV;BAC PRO 33003 ACC.SOINS-S.PERS. OPT.A DOMICILE;4;4;3;0;1;1;0;4;0;0;0;1;3;0
12040.0;2022;22;LIMOGES;MASCULIN;SCOLAIRE;BAC PROFESSIONNEL;BAC PRO SERV;BAC PRO 33101 OPTIQUE LUNETTERIE;8;8;7;1;0;0;0;7;0;1;1;2;3;1
12041.0;2022;22;LIMOGES;MASCULIN;SCOLAIRE;BAC PROFESSIONNEL;BAC PRO SERV;BAC PRO 33403 COMMERC. SERVICES EN RESTAURATION;12;12;11;1;0;0;0;11;0;0;2;5;4;1
12047.0;2022;22;LIMOGES;MASCULIN;SCOLAIRE;BAC TECHNOLOGIQUE;BAC STD2A;BAC STD2A SCIENCES & TECHNO. DESIGN-ARTS APPLIQUES;7;7;6;1;0;0;0;6;0;0;1;3;2;1
12054.0;2022;22;LIMOGES;MASCULIN;SCOLAIRE;BAC TECHNOLOGIQUE;BAC STL;BAC STL SCIENCES PHYSIQUES CHIMIQUES  EN LABORAT.;11;11;9;0;2;2;0;11;0;2;4;2;3;0
12055.0;2022;22;LIMOGES;MASCULIN;SCOLAIRE;BAC TECHNOLOGIQUE;BAC STMG;BAC STMG GESTION ET FINANCE;58;58;45;2;11;9;2;54;0;0;8;18;28;4
12060.0;2022;10;LYON;FEMININ;APPRENTISSAGE;BAC PROFESSIONNEL;BAC PRO PROD;BAC PRO 22003 BIO-INDUSTRIES DE TRANSFORMATION;3;3;3;0;0;0;0;3;0;0;1;2;0;0
12062.0;2022;10;LYON;FEMININ;APPRENTISSAGE;BAC PROFESSIONNEL;BAC PRO PROD;BAC PRO 22705 TECHNICIEN GAZ;1;1;1;0;0;0;0;1;0;1;0;0;0;0
12065.0;2022;10;LYON;FEMININ;APPRENTISSAGE;BAC PROFESSIONNEL;BAC PRO PROD;BAC PRO 23304 AMENAGEMENT FINITION BATIMENT;2;2;2;0;0;0;0;2;0;0;1;0;1;0
12070.0;2022;10;LYON;FEMININ;APPRENTISSAGE;BAC PROFESSIONNEL;BAC PRO PROD;BAC PRO 24302 METIERS DU CUIR : MAROQUINERIE;1;1;1;0;0;0;0;1;0;0;1;0;0;0
12071.0;2022;10;LYON;FEMININ;APPRENTISSAGE;BAC PROFESSIONNEL;BAC PRO PROD;BAC PRO 25007 MAINTENANCE EQUIPEMENTS INDUST.;4;4;4;0;0;0;0;4;0;0;0;3;1;0
12078.0;2022;10;LYON;FEMININ;APPRENTISSAGE;BAC PROFESSIONNEL;BAC PRO PROD;BAC PRO 25411 TECH.CHAUDRONNERIE INDUSTRIELLE;5;5;5;0;0;0;0;5;0;4;0;1;0;0
12084.0;2022;10;LYON;FEMININ;APPRENTISSAGE;BAC PROFESSIONNEL;BAC PRO PROD;BAC PRO AG 21210 COND GEST ENTR CANIN ET FELIN;2;2;2;0;0;0;0;2;0;0;0;1;1;0
12096.0;2022;10;LYON;FEMININ;APPRENTISSAGE;BAC PROFESSIONNEL;BAC PRO SERV;BAC PRO 32303 ART.& MET.ART:COM.VIS.VIS.PLURI-M;6;6;6;0;0;0;0;6;0;2;1;3;0;0
12109.0;2022;10;LYON;FEMININ;FORMATION CONTINUE;BAC PROFESSIONNEL;BAC PRO SERV;BAC PRO 30001 GESTION-ADMINISTRATION;15;14;13;1;0;0;0;13;0;0;6;5;2;1
12110.0;2022;10;LYON;FEMININ;FORMATION CONTINUE;BAC PROFESSIONNEL;BAC PRO SERV;BAC PRO 31213 MET.COM.VEN.OP.A ANI.GES.ESP.COM.;8;8;5;1;2;2;0;7;0;0;1;2;4;1
12115.0;2022;10;LYON;FEMININ;INDIVIDUEL;BAC PROFESSIONNEL;BAC PRO PROD;BAC PRO AG 21210 COND GEST ENTR CANIN ET FELIN;1;1;1;0;0;0;0;1;0;0;0;0;1;0
12117.0;2022;10;LYON;FEMININ;INDIVIDUEL;BAC PROFESSIONNEL;BAC PRO SERV;BAC PRO 30001 GESTION-ADMINISTRATION;16;10;6;4;0;0;0;6;0;0;1;1;4;4
12133.0;2022;10;LYON;FEMININ;INDIVIDUEL;BAC TECHNOLOGIQUE;BAC STMG;BAC STMG MERCATIQUE (MARKETING);18;8;2;4;2;0;2;2;0;0;1;0;1;6
12135.0;2022;10;LYON;FEMININ;SCOLAIRE;BAC GENERAL;BAC GENERAL;BAC GENE 10019 BAC GENERAL;10529;10529;9822;155;552;373;179;10195;163;1292;2727;3372;2641;334
12138.0;2022;10;LYON;FEMININ;SCOLAIRE;BAC PROFESSIONNEL;BAC PRO PROD;BAC PRO 22003 BIO-INDUSTRIES DE TRANSFORMATION;27;27;20;6;1;1;0;21;0;1;4;6;10;6
12140.0;2022;10;LYON;FEMININ;SCOLAIRE;BAC PROFESSIONNEL;BAC PRO PROD;BAC PRO 22105 BOULANGER-PÂTISSIER;26;26;26;0;0;0;0;26;0;2;8;11;5;0
12143.0;2022;10;LYON;FEMININ;SCOLAIRE;BAC PROFESSIONNEL;BAC PRO PROD;BAC PRO 23003 ARTIS. & M.ART:MARCHANDISAGE VIS.;14;14;12;2;0;0;0;12;0;0;3;6;3;2
12148.0;2022;10;LYON;FEMININ;SCOLAIRE;BAC PROFESSIONNEL;BAC PRO PROD;BAC PRO 23407 TECHNIC.FAB.BOIS ET MATERX ASSOC;1;1;1;0;0;0;0;1;0;0;0;1;0;0
12154.0;2022;10;LYON;FEMININ;SCOLAIRE;BAC PROFESSIONNEL;BAC PRO PROD;BAC PRO 24303 MET. DU CUIR: SELLERIE GARNISSAGE;9;9;4;5;0;0;0;4;0;0;1;1;2;5
12159.0;2022;10;LYON;FEMININ;SCOLAIRE;BAC PROFESSIONNEL;BAC PRO PROD;BAC PRO 25215 MAINT.VEHIC.OPTB VEHIC.TRANS.ROUT;2;2;1;1;0;0;0;1;0;0;1;0;0;1
12162.0;2022;10;LYON;FEMININ;SCOLAIRE;BAC PROFESSIONNEL;BAC PRO PROD;BAC PRO 25411 TECH.CHAUDRONNERIE INDUSTRIELLE;1;1;1;0;0;0;0;1;0;0;0;1;0;0
12170.0;2022;10;LYON;FEMININ;SCOLAIRE;BAC PROFESSIONNEL;BAC PRO PROD;BAC PRO AG 21203 TECHN CONSEIL DE VENTE ANIMAL;33;33;22;11;0;0;0;22;0;1;2;7;12;11
12172.0;2022;10;LYON;FEMININ;SCOLAIRE;BAC PROFESSIONNEL;BAC PRO PROD;BAC PRO AG 21211 COND GEST ENTR HIPPIQUE;56;55;49;6;0;0;0;49;0;0;2;9;38;6
12176.0;2022;10;LYON;FEMININ;SCOLAIRE;BAC PROFESSIONNEL;BAC PRO PROD;BAC PRO AG 21407 TEC CONS VTE UNIVERS JARDINERIE;11;10;6;4;0;0;0;6;0;1;0;1;4;4
12180.0;2022;10;LYON;FEMININ;SCOLAIRE;BAC PROFESSIONNEL;BAC PRO SERV;BAC PRO 31106 LOGISTIQUE;24;24;16;8;0;0;0;16;0;0;3;7;6;8
12182.0;2022;10;LYON;FEMININ;SCOLAIRE;BAC PROFESSIONNEL;BAC PRO SERV;BAC PRO 31108 TRANSPORT;19;19;12;7;0;0;0;12;0;1;3;6;2;7
12187.0;2022;10;LYON;FEMININ;SCOLAIRE;BAC PROFESSIONNEL;BAC PRO SERV;BAC PRO 32208 REAL.PR.IMPR.PLURI.OPTB.PR.IMPR.;8;8;8;0;0;0;0;8;0;0;1;5;2;0
12190.0;2022;10;LYON;FEMININ;SCOLAIRE;BAC PROFESSIONNEL;BAC PRO SERV;BAC PRO 33002 SERVICES DE PROXIMITE  VIE LOCAL;51;51;47;4;0;0;0;47;0;2;11;14;20;4
12192.0;2022;10;LYON;FEMININ;SCOLAIRE;BAC PROFESSIONNEL;BAC PRO SERV;BAC PRO 33004 ACC.SOINS-S.PERS. OPT.EN STRUCTUR;598;598;535;48;15;12;3;547;0;37;134;192;184;51
12202.0;2022;10;LYON;FEMININ;SCOLAIRE;BAC TECHNOLOGIQUE;BAC S2TMD;BAC S2TMD MUSIQUE;6;6;6;0;0;0;0;6;0;2;2;2;0;0
12203.0;2022;10;LYON;FEMININ;SCOLAIRE;BAC TECHNOLOGIQUE;BAC ST2S;BAC ST2S SCIENCES & TECHNO. SANTE & SOCIAL;983;983;806;50;127;74;53;880;0;19;113;308;440;103
12210.0;2022;10;LYON;FEMININ;SCOLAIRE;BAC TECHNOLOGIQUE;BAC STI2D;BAC STI2D SYSTÈME D'INFORMATION  ET NUMERIQUE;23;23;19;1;3;2;1;21;0;0;0;7;14;2
12211.0;2022;10;LYON;FEMININ;SCOLAIRE;BAC TECHNOLOGIQUE;BAC STL;BAC STL BIOCHIM.-BIOLOGIE-BIOTECHNOL.;132;132;106;2;24;18;6;124;1;2;15;42;64;8
12216.0;2022;10;LYON;FEMININ;SCOLAIRE;BAC TECHNOLOGIQUE;BAC STMG;BAC STMG SYSTEMES D'INFORMATION DE GESTION;13;13;12;1;0;0;0;12;0;0;1;4;7;1
12236.0;2022;10;LYON;MASCULIN;APPRENTISSAGE;BAC PROFESSIONNEL;BAC PRO PROD;BAC PRO 23407 TECHNIC.FAB.BOIS ET MATERX ASSOC;5;5;4;1;0;0;0;4;0;1;1;0;2;1
12237.0;2022;10;LYON;MASCULIN;APPRENTISSAGE;BAC PROFESSIONNEL;BAC PRO PROD;BAC PRO 23408 Etude et réalisation d'agencement;2;2;2;0;0;0;0;2;0;0;1;1;0;0
12240.0;2022;10;LYON;MASCULIN;APPRENTISSAGE;BAC PROFESSIONNEL;BAC PRO PROD;BAC PRO 25007 MAINTENANCE EQUIPEMENTS INDUST.;61;61;57;4;0;0;0;57;0;4;18;15;20;4
12244.0;2022;10;LYON;MASCULIN;APPRENTISSAGE;BAC PROFESSIONNEL;BAC PRO PROD;BAC PRO 25215 MAINT.VEHIC.OPTB VEHIC.TRANS.ROUT;4;4;4;0;0;0;0;4;0;0;3;1;0;0
12246.0;2022;10;LYON;MASCULIN;APPRENTISSAGE;BAC PROFESSIONNEL;BAC PRO PROD;BAC PRO 25219 MAINT.MATERIELS OPT.A AGRICOLES;32;32;31;0;1;1;0;32;0;6;11;9;6;0
12270.0;2022;10;LYON;MASCULIN;APPRENTISSAGE;BAC PROFESSIONNEL;BAC PRO SERV;BAC PRO 31212 METIERS DE L'ACCUEIL;9;9;7;0;2;2;0;9;0;0;4;2;3;0
12271.0;2022;10;LYON;MASCULIN;APPRENTISSAGE;BAC PROFESSIONNEL;BAC PRO SERV;BAC PRO 31213 MET.COM.VEN.OP.A ANI.GES.ESP.COM.;139;131;103;19;9;9;0;112;0;4;24;32;52;19
12272.0;2022;10;LYON;MASCULIN;APPRENTISSAGE;BAC PROFESSIONNEL;BAC PRO SERV;BAC PRO 31214 MET.COM.VEN.OP.B PR.CL.VA.OF.COM.;9;9;9;0;0;0;0;9;0;0;1;4;4;0
12273.0;2022;10;LYON;MASCULIN;APPRENTISSAGE;BAC PROFESSIONNEL;BAC PRO SERV;BAC PRO 32208 REAL.PR.IMPR.PLURI.OPTB.PR.IMPR.;5;5;4;1;0;0;0;4;0;1;1;1;1;1
12275.0;2022;10;LYON;MASCULIN;APPRENTISSAGE;BAC PROFESSIONNEL;BAC PRO SERV;BAC PRO 33102 PROTHESE DENTAIRE;6;6;4;2;0;0;0;4;0;0;0;1;3;2
12281.0;2022;10;LYON;MASCULIN;ENSEIGNEMENT A DISTANCE;BAC TECHNOLOGIQUE;BAC STMG;BAC STMG RESSOURCES HUMAINES ET COMMUNICATION;1;1;1;0;0;0;0;1;0;0;0;1;0;0
12282.0;2022;10;LYON;MASCULIN;FORMATION CONTINUE;BAC PROFESSIONNEL;BAC PRO PROD;BAC PRO 22004 PROC. CHIMIE EAU PAPIERS-CARTONS;4;4;4;0;0;0;0;4;0;0;3;1;0;0
12285.0;2022;10;LYON;MASCULIN;FORMATION CONTINUE;BAC PROFESSIONNEL;BAC PRO PROD;BAC PRO 25509 TECHNIC. FROID CONDITIONNEMT AIR;3;3;3;0;0;0;0;3;0;0;0;2;1;0
12287.0;2022;10;LYON;MASCULIN;FORMATION CONTINUE;BAC PROFESSIONNEL;BAC PRO PROD;BAC PRO AG 21405 AMENAGEMENTS PAYSAGERS;1;1;1;0;0;0;0;1;0;0;0;0;1;0
12290.0;2022;10;LYON;MASCULIN;FORMATION CONTINUE;BAC PROFESSIONNEL;BAC PRO SERV;BAC PRO 33102 PROTHESE DENTAIRE;2;2;2;0;0;0;0;2;0;0;0;1;1;0
12300.0;2022;10;LYON;MASCULIN;INDIVIDUEL;BAC PROFESSIONNEL;BAC PRO PROD;BAC PRO 25510 METIERS ELECT. ENVIRON. CONNECTES;2;1;1;0;0;0;0;1;0;0;0;0;1;0
12303.0;2022;10;LYON;MASCULIN;INDIVIDUEL;BAC PROFESSIONNEL;BAC PRO PROD;BAC PRO AG 21113 CGEVV;2;1;1;0;0;0;0;1;0;0;0;0;1;0
12324.0;2022;10;LYON;MASCULIN;INDIVIDUEL;BAC TECHNOLOGIQUE;BAC STMG;BAC STMG RESSOURCES HUMAINES ET COMMUNICATION;8;5;0;3;2;1;1;1;0;0;0;0;1;4
12328.0;2022;10;LYON;MASCULIN;SCOLAIRE;BAC PROFESSIONNEL;BAC PRO PROD;BAC PRO 20102 PILOTE DE LIGNE DE PRODUCTION;18;18;11;4;3;2;1;13;0;0;2;3;8;5
12332.0;2022;10;LYON;MASCULIN;SCOLAIRE;BAC PROFESSIONNEL;BAC PRO PROD;BAC PRO 22105 BOULANGER-PÂTISSIER;20;20;19;1;0;0;0;19;0;1;6;4;8;1
12335.0;2022;10;LYON;MASCULIN;SCOLAIRE;BAC PROFESSIONNEL;BAC PRO PROD;BAC PRO 22503 PLASTIQUES ET COMPOSITES;16;16;10;5;1;0;1;10;0;0;4;3;3;6
12341.0;2022;10;LYON;MASCULIN;SCOLAIRE;BAC PROFESSIONNEL;BAC PRO PROD;BAC PRO 23102 TRAVAUX PUBLICS;7;7;7;0;0;0;0;7;0;0;2;2;3;0
12342.0;2022;10;LYON;MASCULIN;SCOLAIRE;BAC PROFESSIONNEL;BAC PRO PROD;BACPRO 23103 TECHNICIEN GEOMETRE-TOPOGRAPHE;10;10;8;1;1;1;0;9;0;0;0;4;5;1
12347.0;2022;10;LYON;MASCULIN;SCOLAIRE;BAC PROFESSIONNEL;BAC PRO PROD;BAC PRO 23405 TECHNICIEN MENUISIER AGENCEUR;116;116;102;13;1;0;1;102;0;1;29;45;27;14
12351.0;2022;10;LYON;MASCULIN;SCOLAIRE;BAC PROFESSIONNEL;BAC PRO PROD;BAC PRO 24202 ARTIS.& MET.ART : TAPIS.D'AMEUBL;2;2;2;0;0;0;0;2;0;0;1;1;0;0
12358.0;2022;10;LYON;MASCULIN;SCOLAIRE;BAC PROFESSIONNEL;BAC PRO PROD;BAC PRO 25108 TECHNICIEN MODELEUR;2;2;1;1;0;0;0;1;0;0;0;1;0;1
12364.0;2022;10;LYON;MASCULIN;SCOLAIRE;BAC PROFESSIONNEL;BAC PRO PROD;BAC PRO 25221 MAINT.MATERIELS OPT.C ESP. VERTS;1;1;1;0;0;0;0;1;0;0;0;1;0;0
12375.0;2022;10;LYON;MASCULIN;SCOLAIRE;BAC PROFESSIONNEL;BAC PRO PROD;BAC PRO AG 21004 CGEA;72;69;67;2;0;0;0;67;0;1;11;24;31;2
12390.0;2022;10;LYON;MASCULIN;SCOLAIRE;BAC PROFESSIONNEL;BAC PRO SERV;BAC PRO 31106 LOGISTIQUE;94;94;61;31;2;1;1;62;0;7;10;22;23;32
12392.0;2022;10;LYON;MASCULIN;SCOLAIRE;BAC PROFESSIONNEL;BAC PRO SERV;BAC PRO 31108 TRANSPORT;75;75;55;18;2;2;0;57;0;1;14;27;15;18
12393.0;2022;10;LYON;MASCULIN;SCOLAIRE;BAC PROFESSIONNEL;BAC PRO SERV;BAC PRO 31212 METIERS DE L'ACCUEIL;80;80;64;12;4;1;3;65;0;2;7;23;33;15
12394.0;2022;10;LYON;MASCULIN;SCOLAIRE;BAC PROFESSIONNEL;BAC PRO SERV;BAC PRO 31213 MET.COM.VEN.OP.A ANI.GES.ESP.COM.;337;337;267;54;16;11;5;278;0;8;50;105;115;59
12396.0;2022;10;LYON;MASCULIN;SCOLAIRE;BAC PROFESSIONNEL;BAC PRO SERV;BAC PRO 32207 REAL.PR.IMPR.PLURI.OPTA.PR.GRAPH.;20;20;17;3;0;0;0;17;0;0;2;10;5;3
12398.0;2022;10;LYON;MASCULIN;SCOLAIRE;BAC PROFESSIONNEL;BAC PRO SERV;BAC PRO 32303 ART.& MET.ART:COM.VIS.VIS.PLURI-M;34;34;27;5;2;2;0;29;0;1;10;10;8;5
12401.0;2022;10;LYON;MASCULIN;SCOLAIRE;BAC PROFESSIONNEL;BAC PRO SERV;BAC PRO 33003 ACC.SOINS-S.PERS. OPT.A DOMICILE;4;4;3;1;0;0;0;3;0;0;1;1;1;1
12417.0;2022;10;LYON;MASCULIN;SCOLAIRE;BAC TECHNOLOGIQUE;BAC STI2D;BAC STI2D INNOVATION TECHNO.  ET ECO CONCEPTION;493;493;385;25;83;43;40;428;0;11;61;143;213;65
12419.0;2022;10;LYON;MASCULIN;SCOLAIRE;BAC TECHNOLOGIQUE;BAC STL;BAC STL BIOCHIM.-BIOLOGIE-BIOTECHNOL.;74;74;59;2;13;10;3;69;0;2;5;28;34;5
12429.0;2022;31;MARTINIQUE;FEMININ;APPRENTISSAGE;BAC PROFESSIONNEL;BAC PRO SERV;BAC PRO 31106 LOGISTIQUE;2;2;1;1;0;0;0;1;0;0;0;0;1;1
12430.0;2022;31;MARTINIQUE;FEMININ;APPRENTISSAGE;BAC PROFESSIONNEL;BAC PRO SERV;BAC PRO 31212 METIERS DE L'ACCUEIL;5;4;4;0;0;0;0;4;0;0;3;0;1;0
12442.0;2022;31;MARTINIQUE;FEMININ;INDIVIDUEL;BAC TECHNOLOGIQUE;BAC ST2S;BAC ST2S SCIENCES & TECHNO. SANTE & SOCIAL;1;0;0;0;0;0;0;0;0;0;0;0;0;0
12453.0;2022;31;MARTINIQUE;FEMININ;SCOLAIRE;BAC PROFESSIONNEL;BAC PRO PROD;BAC PRO 23408 Etude et réalisation d'agencement;4;4;1;3;0;0;0;1;0;0;0;0;1;3
12454.0;2022;31;MARTINIQUE;FEMININ;SCOLAIRE;BAC PROFESSIONNEL;BAC PRO PROD;BAC PRO 24203 METIERS DE LA MODE - VÊTEMENT;20;20;12;7;1;0;1;12;0;0;2;5;5;8
12458.0;2022;31;MARTINIQUE;FEMININ;SCOLAIRE;BAC PROFESSIONNEL;BAC PRO PROD;BAC PRO 25220 MAINT.MATERIELS OPT.B TP MANUT.;1;1;1;0;0;0;0;1;0;0;0;1;0;0
12463.0;2022;31;MARTINIQUE;FEMININ;SCOLAIRE;BAC PROFESSIONNEL;BAC PRO PROD;BAC PRO 25514 SYST.NUM.OPT.B AUD.RES.EQUIP.DOM.;3;3;3;0;0;0;0;3;0;0;1;1;1;0
12468.0;2022;31;MARTINIQUE;FEMININ;SCOLAIRE;BAC PROFESSIONNEL;BAC PRO SERV;BAC PRO 30001 GESTION-ADMINISTRATION;102;99;76;19;4;2;2;78;0;4;13;29;32;21
12471.0;2022;31;MARTINIQUE;FEMININ;SCOLAIRE;BAC PROFESSIONNEL;BAC PRO SERV;BAC PRO 31213 MET.COM.VEN.OP.A ANI.GES.ESP.COM.;45;45;36;8;1;1;0;37;0;0;11;12;14;8
12473.0;2022;31;MARTINIQUE;FEMININ;SCOLAIRE;BAC PROFESSIONNEL;BAC PRO SERV;BAC PRO 32303 ART.& MET.ART:COM.VIS.VIS.PLURI-M;7;7;7;0;0;0;0;7;0;0;4;3;0;0
12474.0;2022;31;MARTINIQUE;FEMININ;SCOLAIRE;BAC PROFESSIONNEL;BAC PRO SERV;BAC PRO 33002 SERVICES DE PROXIMITE  VIE LOCAL;20;20;14;5;1;1;0;15;0;1;1;3;10;5
12480.0;2022;31;MARTINIQUE;FEMININ;SCOLAIRE;BAC PROFESSIONNEL;BAC PRO SERV;BAC PRO 34304 HYGIENE PROPRETE STERILISATION;5;5;1;4;0;0;0;1;0;0;0;0;1;4
12492.0;2022;31;MARTINIQUE;FEMININ;SCOLAIRE;BAC TECHNOLOGIQUE;BAC STMG;BAC STMG MERCATIQUE (MARKETING);64;64;57;2;5;5;0;62;0;0;10;24;28;2
12493.0;2022;31;MARTINIQUE;FEMININ;SCOLAIRE;BAC TECHNOLOGIQUE;BAC STMG;BAC STMG RESSOURCES HUMAINES ET COMMUNICATION;92;92;72;5;15;14;1;86;0;1;7;25;53;6
12494.0;2022;31;MARTINIQUE;FEMININ;SCOLAIRE;BAC TECHNOLOGIQUE;BAC STMG;BAC STMG SYSTEMES D'INFORMATION DE GESTION;11;11;10;0;1;1;0;11;0;0;0;2;9;0
12500.0;2022;31;MARTINIQUE;MASCULIN;APPRENTISSAGE;BAC PROFESSIONNEL;BAC PRO PROD;BAC PRO 23304 AMENAGEMENT FINITION BATIMENT;8;7;5;0;2;1;1;6;0;0;1;1;4;1
12502.0;2022;31;MARTINIQUE;MASCULIN;APPRENTISSAGE;BAC PROFESSIONNEL;BAC PRO PROD;BAC PRO 23405 TECHNICIEN MENUISIER AGENCEUR;2;2;2;0;0;0;0;2;0;0;0;0;2;0
12508.0;2022;31;MARTINIQUE;MASCULIN;APPRENTISSAGE;BAC PROFESSIONNEL;BAC PRO SERV;BAC PRO 31212 METIERS DE L'ACCUEIL;1;1;1;0;0;0;0;1;0;0;0;0;1;0
12514.0;2022;31;MARTINIQUE;MASCULIN;FORMATION CONTINUE;BAC PROFESSIONNEL;BAC PRO SERV;BAC PRO 31106 LOGISTIQUE;1;1;1;0;0;0;0;1;0;0;0;0;1;0
12518.0;2022;31;MARTINIQUE;MASCULIN;INDIVIDUEL;BAC PROFESSIONNEL;BAC PRO PROD;BAC PRO 22704 TECHN. MAINT. SYST.ENERG.CLIMATI;1;0;0;0;0;0;0;0;0;0;0;0;0;0
12520.0;2022;31;MARTINIQUE;MASCULIN;INDIVIDUEL;BAC PROFESSIONNEL;BAC PRO PROD;BAC PRO 23005 TECHN. ETUDES BAT B ASSIST.ARCHI.;1;0;0;0;0;0;0;0;0;0;0;0;0;0
12528.0;2022;31;MARTINIQUE;MASCULIN;INDIVIDUEL;BAC TECHNOLOGIQUE;BAC STMG;BAC STMG SYSTEMES D'INFORMATION DE GESTION;1;1;0;1;0;0;0;0;0;0;0;0;0;1
12534.0;2022;31;MARTINIQUE;MASCULIN;SCOLAIRE;BAC PROFESSIONNEL;BAC PRO PROD;BAC PRO 22703 TECHN.INSTALL.SYST.ENERG.CLIMATI;10;10;4;4;2;2;0;6;0;0;0;2;4;4
12539.0;2022;31;MARTINIQUE;MASCULIN;SCOLAIRE;BAC PROFESSIONNEL;BAC PRO PROD;BACPRO 23103 TECHNICIEN GEOMETRE-TOPOGRAPHE;6;6;4;2;0;0;0;4;0;0;0;1;3;2
12565.0;2022;31;MARTINIQUE;MASCULIN;SCOLAIRE;BAC PROFESSIONNEL;BAC PRO PROD;BAC PRO AG 22107 TEC CONS VTE ALIMENTATION P.ALIM;5;4;4;0;0;0;0;4;0;0;0;1;3;0
12569.0;2022;31;MARTINIQUE;MASCULIN;SCOLAIRE;BAC PROFESSIONNEL;BAC PRO SERV;BAC PRO 31212 METIERS DE L'ACCUEIL;10;10;8;2;0;0;0;8;0;1;3;3;1;2
12572.0;2022;31;MARTINIQUE;MASCULIN;SCOLAIRE;BAC PROFESSIONNEL;BAC PRO SERV;BAC PRO 32303 ART.& MET.ART:COM.VIS.VIS.PLURI-M;4;4;3;1;0;0;0;3;0;0;1;1;1;1
12586.0;2022;31;MARTINIQUE;MASCULIN;SCOLAIRE;BAC TECHNOLOGIQUE;BAC STI2D;BAC STI2D ENERGIES  ET ENVIRONNEMENT;18;18;10;0;8;8;0;18;0;0;1;5;12;0
12587.0;2022;31;MARTINIQUE;MASCULIN;SCOLAIRE;BAC TECHNOLOGIQUE;BAC STI2D;BAC STI2D INNOVATION TECHNO.  ET ECO CONCEPTION;30;30;21;0;9;9;0;30;0;0;1;5;24;0
12589.0;2022;31;MARTINIQUE;MASCULIN;SCOLAIRE;BAC TECHNOLOGIQUE;BAC STL;BAC STL BIOCHIM.-BIOLOGIE-BIOTECHNOL.;10;10;10;0;0;0;0;10;0;0;0;3;7;0
12605.0;2022;43;MAYOTTE;FEMININ;INDIVIDUEL;BAC TECHNOLOGIQUE;BAC STMG;BAC STMG GESTION ET FINANCE;2;2;0;2;0;0;0;0;0;0;0;0;0;2
12610.0;2022;43;MAYOTTE;FEMININ;SCOLAIRE;BAC PROFESSIONNEL;BAC PRO PROD;BAC PRO 23004 TECHN. ETUDES BAT.A ETUDES & ECO.;1;1;1;0;0;0;0;1;0;0;0;1;0;0
12618.0;2022;43;MAYOTTE;FEMININ;SCOLAIRE;BAC PROFESSIONNEL;BAC PRO PROD;BAC PRO AG 21004 CGEA;3;3;3;0;0;0;0;3;0;0;1;0;2;0
12629.0;2022;43;MAYOTTE;FEMININ;SCOLAIRE;BAC PROFESSIONNEL;BAC PRO SERV;BAC PRO 33004 ACC.SOINS-S.PERS. OPT.EN STRUCTUR;16;16;13;1;2;2;0;15;0;0;1;6;8;1
12634.0;2022;43;MAYOTTE;FEMININ;SCOLAIRE;BAC TECHNOLOGIQUE;BAC STD2A;BAC STD2A SCIENCES & TECHNO. DESIGN-ARTS APPLIQUES;17;17;5;7;5;0;5;5;0;0;0;1;4;12
12635.0;2022;43;MAYOTTE;FEMININ;SCOLAIRE;BAC TECHNOLOGIQUE;BAC STHR;BAC STHR SC.&TEC. HOTELLERIE-RESTAURATION;20;20;7;5;8;5;3;12;0;0;1;2;9;8
12636.0;2022;43;MAYOTTE;FEMININ;SCOLAIRE;BAC TECHNOLOGIQUE;BAC STI2D;BAC STI2D ARCHITECTURE ET CONSTRUCTION;12;12;2;4;6;4;2;6;0;0;0;2;4;6
12640.0;2022;43;MAYOTTE;FEMININ;SCOLAIRE;BAC TECHNOLOGIQUE;BAC STL;BAC STL SCIENCES PHYSIQUES CHIMIQUES  EN LABORAT.;64;64;30;12;22;21;1;51;0;0;3;8;40;13
12644.0;2022;43;MAYOTTE;MASCULIN;APPRENTISSAGE;BAC PROFESSIONNEL;BAC PRO PROD;BAC PRO 25215 MAINT.VEHIC.OPTB VEHIC.TRANS.ROUT;16;16;6;6;4;2;2;8;0;0;0;4;4;8
12657.0;2022;43;MAYOTTE;MASCULIN;INDIVIDUEL;BAC PROFESSIONNEL;BAC PRO SERV;BAC PRO 30001 GESTION-ADMINISTRATION;2;2;1;1;0;0;0;1;0;0;0;0;1;1
12675.0;2022;43;MAYOTTE;MASCULIN;SCOLAIRE;BAC PROFESSIONNEL;BAC PRO PROD;BAC PRO 23408 Etude et réalisation d'agencement;11;11;6;4;1;1;0;7;0;0;0;4;3;4
12679.0;2022;43;MAYOTTE;MASCULIN;SCOLAIRE;BAC PROFESSIONNEL;BAC PRO PROD;BAC PRO 25216 MAINT.VEHIC.OPTC MOTOCYCLES;16;16;5;7;4;2;2;7;0;0;0;0;7;9
12693.0;2022;43;MAYOTTE;MASCULIN;SCOLAIRE;BAC PROFESSIONNEL;BAC PRO SERV;BAC PRO 31213 MET.COM.VEN.OP.A ANI.GES.ESP.COM.;77;77;40;24;13;12;1;52;0;0;0;13;39;25
12695.0;2022;43;MAYOTTE;MASCULIN;SCOLAIRE;BAC PROFESSIONNEL;BAC PRO SERV;BAC PRO 32303 ART.& MET.ART:COM.VIS.VIS.PLURI-M;10;10;8;1;1;0;1;8;0;0;1;1;6;2
12702.0;2022;43;MAYOTTE;MASCULIN;SCOLAIRE;BAC TECHNOLOGIQUE;BAC ST2S;BAC ST2S SCIENCES & TECHNO. SANTE & SOCIAL;30;30;18;2;10;6;4;24;0;0;2;6;16;6
12703.0;2022;43;MAYOTTE;MASCULIN;SCOLAIRE;BAC TECHNOLOGIQUE;BAC STD2A;BAC STD2A SCIENCES & TECHNO. DESIGN-ARTS APPLIQUES;27;27;18;1;8;3;5;21;0;0;2;3;16;6
12705.0;2022;43;MAYOTTE;MASCULIN;SCOLAIRE;BAC TECHNOLOGIQUE;BAC STI2D;BAC STI2D ARCHITECTURE ET CONSTRUCTION;37;37;15;9;13;10;3;25;0;0;0;4;21;12
12713.0;2022;11;MONTPELLIER;FEMININ;APPRENTISSAGE;BAC PROFESSIONNEL;BAC PRO PROD;BAC PRO 20102 PILOTE DE LIGNE DE PRODUCTION;1;1;1;0;0;0;0;1;0;1;0;0;0;0
12714.0;2022;11;MONTPELLIER;FEMININ;APPRENTISSAGE;BAC PROFESSIONNEL;BAC PRO PROD;BAC PRO 22106 CUISINE;4;4;1;3;0;0;0;1;0;0;0;0;1;3
12720.0;2022;11;MONTPELLIER;FEMININ;APPRENTISSAGE;BAC PROFESSIONNEL;BAC PRO PROD;BAC PRO 25215 MAINT.VEHIC.OPTB VEHIC.TRANS.ROUT;2;2;2;0;0;0;0;2;0;1;0;0;1;0
12722.0;2022;11;MONTPELLIER;FEMININ;APPRENTISSAGE;BAC PROFESSIONNEL;BAC PRO PROD;BAC PRO 25408 REPARATION DES CARROSSERIES;3;3;2;1;0;0;0;2;0;0;2;0;0;1
12734.0;2022;11;MONTPELLIER;FEMININ;APPRENTISSAGE;BAC PROFESSIONNEL;BAC PRO SERV;BAC PRO 31214 MET.COM.VEN.OP.B PR.CL.VA.OF.COM.;1;1;1;0;0;0;0;1;0;0;0;1;0;0
12738.0;2022;11;MONTPELLIER;FEMININ;APPRENTISSAGE;BAC PROFESSIONNEL;BAC PRO SERV;BAC PRO 33403 COMMERC. SERVICES EN RESTAURATION;3;3;2;1;0;0;0;2;0;2;0;0;0;1
12741.0;2022;11;MONTPELLIER;FEMININ;ENSEIGNEMENT A DISTANCE;BAC GENERAL;BAC GENERAL;BAC GENE 10019 BAC GENERAL;51;51;36;10;5;1;4;37;0;3;12;6;16;14
12742.0;2022;11;MONTPELLIER;FEMININ;ENSEIGNEMENT A DISTANCE;BAC PROFESSIONNEL;BAC PRO SERV;BAC PRO 30001 GESTION-ADMINISTRATION;3;2;2;0;0;0;0;2;0;0;0;1;1;0
12746.0;2022;11;MONTPELLIER;FEMININ;ENSEIGNEMENT A DISTANCE;BAC TECHNOLOGIQUE;BAC ST2S;BAC ST2S SCIENCES & TECHNO. SANTE & SOCIAL;6;6;5;1;0;0;0;5;0;0;2;2;1;1
12763.0;2022;11;MONTPELLIER;FEMININ;INDIVIDUEL;BAC PROFESSIONNEL;BAC PRO SERV;BAC PRO 31212 METIERS DE L'ACCUEIL;2;2;1;1;0;0;0;1;0;0;0;0;1;1
12765.0;2022;11;MONTPELLIER;FEMININ;INDIVIDUEL;BAC PROFESSIONNEL;BAC PRO SERV;BAC PRO 31214 MET.COM.VEN.OP.B PR.CL.VA.OF.COM.;2;1;1;0;0;0;0;1;0;0;0;0;1;0
12775.0;2022;11;MONTPELLIER;FEMININ;INDIVIDUEL;BAC TECHNOLOGIQUE;BAC STMG;BAC STMG GESTION ET FINANCE;2;0;0;0;0;0;0;0;0;0;0;0;0;0
12788.0;2022;11;MONTPELLIER;FEMININ;SCOLAIRE;BAC PROFESSIONNEL;BAC PRO PROD;BAC PRO 23005 TECHN. ETUDES BAT B ASSIST.ARCHI.;15;14;10;4;0;0;0;10;0;0;3;4;3;4
12797.0;2022;11;MONTPELLIER;FEMININ;SCOLAIRE;BAC PROFESSIONNEL;BAC PRO PROD;BAC PRO 24302 METIERS DU CUIR : MAROQUINERIE;8;8;4;2;2;1;1;5;0;0;3;0;2;3
12811.0;2022;11;MONTPELLIER;FEMININ;SCOLAIRE;BAC PROFESSIONNEL;BAC PRO PROD;BAC PRO AG 21004 CGEA;32;31;25;6;0;0;0;25;0;0;1;7;17;6
12814.0;2022;11;MONTPELLIER;FEMININ;SCOLAIRE;BAC PROFESSIONNEL;BAC PRO PROD;BAC PRO AG 21203 TECHN CONSEIL DE VENTE ANIMAL;24;24;22;2;0;0;0;22;0;0;2;6;14;2
12817.0;2022;11;MONTPELLIER;FEMININ;SCOLAIRE;BAC PROFESSIONNEL;BAC PRO PROD;BAC PRO AG 21302 GEST MILIEUX NATURELS FAUNE;3;3;3;0;0;0;0;3;0;0;0;1;2;0
12819.0;2022;11;MONTPELLIER;FEMININ;SCOLAIRE;BAC PROFESSIONNEL;BAC PRO PROD;BAC PRO AG 21407 TEC CONS VTE UNIVERS JARDINERIE;1;1;0;1;0;0;0;0;0;0;0;0;0;1
12820.0;2022;11;MONTPELLIER;FEMININ;SCOLAIRE;BAC PROFESSIONNEL;BAC PRO PROD;BAC PRO AG 22105 LABORATOIRE CONTROLE QUALITE;13;11;10;1;0;0;0;10;0;0;3;2;5;1
12826.0;2022;11;MONTPELLIER;FEMININ;SCOLAIRE;BAC PROFESSIONNEL;BAC PRO SERV;BAC PRO 31212 METIERS DE L'ACCUEIL;172;171;139;21;11;8;3;147;0;8;30;51;58;24
12827.0;2022;11;MONTPELLIER;FEMININ;SCOLAIRE;BAC PROFESSIONNEL;BAC PRO SERV;BAC PRO 31213 MET.COM.VEN.OP.A ANI.GES.ESP.COM.;408;406;335;46;25;21;4;356;0;20;70;142;124;50
12838.0;2022;11;MONTPELLIER;FEMININ;SCOLAIRE;BAC PROFESSIONNEL;BAC PRO SERV;BAC PRO 33403 COMMERC. SERVICES EN RESTAURATION;67;67;55;9;3;2;1;57;0;4;14;17;22;10
12848.0;2022;11;MONTPELLIER;FEMININ;SCOLAIRE;BAC TECHNOLOGIQUE;BAC STHR;BAC STHR SC.&TEC. HOTELLERIE-RESTAURATION;64;64;59;1;4;2;2;61;0;4;21;20;16;3
12858.0;2022;11;MONTPELLIER;FEMININ;SCOLAIRE;BAC TECHNOLOGIQUE;BAC STMG;BAC STMG SYSTEMES D'INFORMATION DE GESTION;17;17;10;4;3;3;0;13;0;0;3;2;8;4
12860.0;2022;11;MONTPELLIER;MASCULIN;APPRENTISSAGE;BAC PROFESSIONNEL;BAC PRO PROD;BAC PRO 22004 PROC. CHIMIE EAU PAPIERS-CARTONS;7;7;6;1;0;0;0;6;0;2;1;3;0;1
12862.0;2022;11;MONTPELLIER;MASCULIN;APPRENTISSAGE;BAC PROFESSIONNEL;BAC PRO PROD;BAC PRO 22503 PLASTIQUES ET COMPOSITES;2;2;1;0;1;1;0;2;0;0;1;0;1;0
12868.0;2022;11;MONTPELLIER;MASCULIN;APPRENTISSAGE;BAC PROFESSIONNEL;BAC PRO PROD;BAC PRO 23203 TECHNICIEN BAT. : ORG.REAL.GROS O;2;2;2;0;0;0;0;2;0;0;1;0;1;0
12873.0;2022;11;MONTPELLIER;MASCULIN;APPRENTISSAGE;BAC PROFESSIONNEL;BAC PRO PROD;BAC PRO 25009 MAINTENANCE NAUTIQUE;7;7;7;0;0;0;0;7;0;1;2;2;2;0
12875.0;2022;11;MONTPELLIER;MASCULIN;APPRENTISSAGE;BAC PROFESSIONNEL;BAC PRO PROD;BAC PRO 25214 MAINT.VEHIC.OPTA VOIT.PARTICUL.;95;91;76;13;2;2;0;78;0;10;21;19;28;13
12877.0;2022;11;MONTPELLIER;MASCULIN;APPRENTISSAGE;BAC PROFESSIONNEL;BAC PRO PROD;BAC PRO 25216 MAINT.VEHIC.OPTC MOTOCYCLES;10;9;8;1;0;0;0;8;0;0;1;3;4;1
12880.0;2022;11;MONTPELLIER;MASCULIN;APPRENTISSAGE;BAC PROFESSIONNEL;BAC PRO PROD;BAC PRO 25303 AERONAUTIQUE OPTION SYSTEMES;9;9;9;0;0;0;0;9;0;1;4;3;1;0
12887.0;2022;11;MONTPELLIER;MASCULIN;APPRENTISSAGE;BAC PROFESSIONNEL;BAC PRO PROD;BAC PRO AG 21113 CGEVV;12;10;7;3;0;0;0;7;0;0;1;2;4;3
12891.0;2022;11;MONTPELLIER;MASCULIN;APPRENTISSAGE;BAC PROFESSIONNEL;BAC PRO PROD;BAC PRO AG 21405 AMENAGEMENTS PAYSAGERS;37;35;31;4;0;0;0;31;0;0;2;14;15;4
12894.0;2022;11;MONTPELLIER;MASCULIN;APPRENTISSAGE;BAC PROFESSIONNEL;BAC PRO SERV;BAC PRO 31212 METIERS DE L'ACCUEIL;2;2;2;0;0;0;0;2;0;0;1;1;0;0
12897.0;2022;11;MONTPELLIER;MASCULIN;APPRENTISSAGE;BAC PROFESSIONNEL;BAC PRO SERV;BAC PRO 33102 PROTHESE DENTAIRE;2;2;2;0;0;0;0;2;0;0;1;1;0;0
12911.0;2022;11;MONTPELLIER;MASCULIN;FORMATION CONTINUE;BAC PROFESSIONNEL;BAC PRO PROD;BAC PRO 22703 TECHN.INSTALL.SYST.ENERG.CLIMATI;2;2;2;0;0;0;0;2;0;1;0;1;0;0
12912.0;2022;11;MONTPELLIER;MASCULIN;FORMATION CONTINUE;BAC PROFESSIONNEL;BAC PRO PROD;BAC PRO 25007 MAINTENANCE EQUIPEMENTS INDUST.;4;4;4;0;0;0;0;4;0;0;1;3;0;0
12928.0;2022;11;MONTPELLIER;MASCULIN;INDIVIDUEL;BAC PROFESSIONNEL;BAC PRO PROD;BAC PRO AG 21004 CGEA;2;2;2;0;0;0;0;2;0;0;0;0;2;0
12937.0;2022;11;MONTPELLIER;MASCULIN;INDIVIDUEL;BAC TECHNOLOGIQUE;BAC STAV;BAC STAV AGRONOMIE ALIM ENV TERRITOI;1;1;0;1;0;0;0;0;0;0;0;0;0;1
12945.0;2022;11;MONTPELLIER;MASCULIN;INDIVIDUEL;BAC TECHNOLOGIQUE;BAC STMG;BAC STMG RESSOURCES HUMAINES ET COMMUNICATION;7;5;1;3;1;1;0;2;0;0;0;0;2;3
12946.0;2022;11;MONTPELLIER;MASCULIN;INDIVIDUEL;BAC TECHNOLOGIQUE;BAC STMG;BAC STMG SYSTEMES D'INFORMATION DE GESTION;1;1;0;1;0;0;0;0;0;0;0;0;0;1
12951.0;2022;11;MONTPELLIER;MASCULIN;SCOLAIRE;BAC PROFESSIONNEL;BAC PRO PROD;BAC PRO 22004 PROC. CHIMIE EAU PAPIERS-CARTONS;31;31;23;6;2;2;0;25;0;2;6;8;9;6
12955.0;2022;11;MONTPELLIER;MASCULIN;SCOLAIRE;BAC PROFESSIONNEL;BAC PRO PROD;BAC PRO 22503 PLASTIQUES ET COMPOSITES;22;22;18;4;0;0;0;18;0;1;4;9;4;4
12956.0;2022;11;MONTPELLIER;MASCULIN;SCOLAIRE;BAC PROFESSIONNEL;BAC PRO PROD;BAC PRO 22703 TECHN.INSTALL.SYST.ENERG.CLIMATI;71;70;47;17;6;5;1;52;0;0;4;22;26;18
12968.0;2022;11;MONTPELLIER;MASCULIN;SCOLAIRE;BAC PROFESSIONNEL;BAC PRO PROD;BAC PRO 23404 TECHNICIEN CONSTRUCTEUR BOIS;24;24;14;10;0;0;0;14;0;0;1;2;11;10
12971.0;2022;11;MONTPELLIER;MASCULIN;SCOLAIRE;BAC PROFESSIONNEL;BAC PRO PROD;BAC PRO 24202 ARTIS.& MET.ART : TAPIS.D'AMEUBL;1;1;1;0;0;0;0;1;0;0;0;1;0;0
12974.0;2022;11;MONTPELLIER;MASCULIN;SCOLAIRE;BAC PROFESSIONNEL;BAC PRO PROD;BAC PRO 24303 MET. DU CUIR: SELLERIE GARNISSAGE;8;8;5;1;2;1;1;6;0;0;2;0;4;2
12977.0;2022;11;MONTPELLIER;MASCULIN;SCOLAIRE;BAC PROFESSIONNEL;BAC PRO PROD;BAC PRO 25009 MAINTENANCE NAUTIQUE;40;40;24;14;2;0;2;24;0;3;2;11;8;16
12985.0;2022;11;MONTPELLIER;MASCULIN;SCOLAIRE;BAC PROFESSIONNEL;BAC PRO PROD;BAC PRO 25303 AERONAUTIQUE OPTION SYSTEMES;10;10;10;0;0;0;0;10;0;0;4;4;2;0
12995.0;2022;11;MONTPELLIER;MASCULIN;SCOLAIRE;BAC PROFESSIONNEL;BAC PRO PROD;BAC PRO AG 21004 CGEA;51;51;49;2;0;0;0;49;0;0;7;17;25;2
13001.0;2022;11;MONTPELLIER;MASCULIN;SCOLAIRE;BAC PROFESSIONNEL;BAC PRO PROD;BAC PRO AG 21211 COND GEST ENTR HIPPIQUE;5;5;5;0;0;0;0;5;0;1;1;0;3;0
13002.0;2022;11;MONTPELLIER;MASCULIN;SCOLAIRE;BAC PROFESSIONNEL;BAC PRO PROD;BAC PRO AG 21302 GEST MILIEUX NATURELS FAUNE;21;21;19;2;0;0;0;19;0;0;1;7;11;2
13009.0;2022;11;MONTPELLIER;MASCULIN;SCOLAIRE;BAC PROFESSIONNEL;BAC PRO SERV;BAC PRO 31106 LOGISTIQUE;101;100;63;28;9;4;5;67;0;4;10;29;24;33
13011.0;2022;11;MONTPELLIER;MASCULIN;SCOLAIRE;BAC PROFESSIONNEL;BAC PRO SERV;BAC PRO 31108 TRANSPORT;23;23;15;8;0;0;0;15;0;1;2;6;6;8
13018.0;2022;11;MONTPELLIER;MASCULIN;SCOLAIRE;BAC PROFESSIONNEL;BAC PRO SERV;BAC PRO 32304 PHOTOGRAPHIE;2;2;2;0;0;0;0;2;0;0;2;0;0;0
13026.0;2022;11;MONTPELLIER;MASCULIN;SCOLAIRE;BAC PROFESSIONNEL;BAC PRO SERV;BAC PRO 34403 METIERS DE LA SECURITE;141;141;125;14;2;1;1;126;0;6;39;49;32;15
13027.0;2022;11;MONTPELLIER;MASCULIN;SCOLAIRE;BAC PROFESSIONNEL;BAC PRO SERV;BAC PRO AG 33002 SERV PERS TERRIT;65;64;54;10;0;0;0;54;0;2;6;19;27;10
13033.0;2022;11;MONTPELLIER;MASCULIN;SCOLAIRE;BAC TECHNOLOGIQUE;BAC STI2D;BAC STI2D ARCHITECTURE ET CONSTRUCTION;240;240;191;19;30;17;13;208;0;3;18;71;116;32
13034.0;2022;11;MONTPELLIER;MASCULIN;SCOLAIRE;BAC TECHNOLOGIQUE;BAC STI2D;BAC STI2D ENERGIES  ET ENVIRONNEMENT;203;203;152;12;39;27;12;179;0;3;20;46;110;24
13035.0;2022;11;MONTPELLIER;MASCULIN;SCOLAIRE;BAC TECHNOLOGIQUE;BAC STI2D;BAC STI2D INNOVATION TECHNO.  ET ECO CONCEPTION;188;188;152;4;32;19;13;171;0;5;18;55;93;17
13039.0;2022;11;MONTPELLIER;MASCULIN;SCOLAIRE;BAC TECHNOLOGIQUE;BAC STMG;BAC STMG GESTION ET FINANCE;450;450;363;30;57;37;20;400;2;4;55;122;217;50
13044.0;2022;12;NANCY-METZ;FEMININ;APPRENTISSAGE;BAC PROFESSIONNEL;BAC PRO PROD;BAC PRO 22004 PROC. CHIMIE EAU PAPIERS-CARTONS;2;2;2;0;0;0;0;2;0;0;2;0;0;0
13050.0;2022;12;NANCY-METZ;FEMININ;APPRENTISSAGE;BAC PROFESSIONNEL;BAC PRO PROD;BAC PRO 25106 TECHNICIEN D'USINAGE;2;2;2;0;0;0;0;2;0;0;0;2;0;0
13055.0;2022;12;NANCY-METZ;FEMININ;APPRENTISSAGE;BAC PROFESSIONNEL;BAC PRO PROD;BAC PRO 25411 TECH.CHAUDRONNERIE INDUSTRIELLE;1;1;1;0;0;0;0;1;0;1;0;0;0;0
13063.0;2022;12;NANCY-METZ;FEMININ;APPRENTISSAGE;BAC PROFESSIONNEL;BAC PRO PROD;BAC PRO AG 21405 AMENAGEMENTS PAYSAGERS;3;2;2;0;0;0;0;2;0;0;0;1;1;0
13066.0;2022;12;NANCY-METZ;FEMININ;APPRENTISSAGE;BAC PROFESSIONNEL;BAC PRO SERV;BAC PRO 31212 METIERS DE L'ACCUEIL;1;1;1;0;0;0;0;1;0;1;0;0;0;0
13069.0;2022;12;NANCY-METZ;FEMININ;APPRENTISSAGE;BAC PROFESSIONNEL;BAC PRO SERV;BAC PRO 33003 ACC.SOINS-S.PERS. OPT.A DOMICILE;1;1;1;0;0;0;0;1;0;0;1;0;0;0
13072.0;2022;12;NANCY-METZ;FEMININ;APPRENTISSAGE;BAC PROFESSIONNEL;BAC PRO SERV;BAC PRO 33403 COMMERC. SERVICES EN RESTAURATION;4;4;3;0;1;0;1;3;0;0;0;1;2;1
13073.0;2022;12;NANCY-METZ;FEMININ;APPRENTISSAGE;BAC PROFESSIONNEL;BAC PRO SERV;BAC PRO 33603 ESTHETIQUE COSMETIQUE PARFUMERIE;1;1;1;0;0;0;0;1;0;0;0;1;0;0
13084.0;2022;12;NANCY-METZ;FEMININ;FORMATION CONTINUE;BAC PROFESSIONNEL;BAC PRO PROD;BAC PRO AG 22107 TEC CONS VTE ALIMENTATION P.ALIM;11;10;8;2;0;0;0;8;0;0;2;1;5;2
13086.0;2022;12;NANCY-METZ;FEMININ;FORMATION CONTINUE;BAC PROFESSIONNEL;BAC PRO SERV;BAC PRO 31106 LOGISTIQUE;2;2;2;0;0;0;0;2;0;1;1;0;0;0
13090.0;2022;12;NANCY-METZ;FEMININ;FORMATION CONTINUE;BAC PROFESSIONNEL;BAC PRO SERV;BAC PRO 33102 PROTHESE DENTAIRE;2;2;2;0;0;0;0;2;0;0;0;0;2;0
13096.0;2022;12;NANCY-METZ;FEMININ;INDIVIDUEL;BAC PROFESSIONNEL;BAC PRO PROD;BAC PRO AG 21203 TECHN CONSEIL DE VENTE ANIMAL;1;0;0;0;0;0;0;0;0;0;0;0;0;0
13102.0;2022;12;NANCY-METZ;FEMININ;INDIVIDUEL;BAC PROFESSIONNEL;BAC PRO SERV;BAC PRO 31213 MET.COM.VEN.OP.A ANI.GES.ESP.COM.;4;1;0;1;0;0;0;0;0;0;0;0;0;1
13111.0;2022;12;NANCY-METZ;FEMININ;INDIVIDUEL;BAC TECHNOLOGIQUE;BAC STHR;BAC STHR SC.&TEC. HOTELLERIE-RESTAURATION;1;0;0;0;0;0;0;0;0;0;0;0;0;0
13117.0;2022;12;NANCY-METZ;FEMININ;SCOLAIRE;BAC PROFESSIONNEL;BAC PRO PROD;BAC PRO 22003 BIO-INDUSTRIES DE TRANSFORMATION;13;13;10;3;0;0;0;10;0;0;4;3;3;3
13123.0;2022;12;NANCY-METZ;FEMININ;SCOLAIRE;BAC PROFESSIONNEL;BAC PRO PROD;BAC PRO 22703 TECHN.INSTALL.SYST.ENERG.CLIMATI;1;1;1;0;0;0;0;1;0;0;0;1;0;0
13132.0;2022;12;NANCY-METZ;FEMININ;SCOLAIRE;BAC PROFESSIONNEL;BAC PRO PROD;BAC PRO 24203 METIERS DE LA MODE - VÊTEMENT;81;81;66;14;1;0;1;66;0;9;18;24;15;15
13133.0;2022;12;NANCY-METZ;FEMININ;SCOLAIRE;BAC PROFESSIONNEL;BAC PRO PROD;BAC PRO 25007 MAINTENANCE EQUIPEMENTS INDUST.;3;3;3;0;0;0;0;3;0;0;1;1;1;0
13134.0;2022;12;NANCY-METZ;FEMININ;SCOLAIRE;BAC PROFESSIONNEL;BAC PRO PROD;BAC PRO 25106 TECHNICIEN D'USINAGE;3;3;1;2;0;0;0;1;0;0;0;0;1;2
13154.0;2022;12;NANCY-METZ;FEMININ;SCOLAIRE;BAC PROFESSIONNEL;BAC PRO SERV;BAC PRO 31107 CONDUCT. TRANSP.ROUT.MARCHANDISES;4;4;2;2;0;0;0;2;0;0;1;0;1;2
13156.0;2022;12;NANCY-METZ;FEMININ;SCOLAIRE;BAC PROFESSIONNEL;BAC PRO SERV;BAC PRO 31212 METIERS DE L'ACCUEIL;118;118;101;12;5;2;3;103;0;9;34;34;26;15
13171.0;2022;12;NANCY-METZ;FEMININ;SCOLAIRE;BAC PROFESSIONNEL;BAC PRO SERV;BAC PRO 34403 METIERS DE LA SECURITE;34;34;32;2;0;0;0;32;0;4;7;10;11;2
13176.0;2022;12;NANCY-METZ;FEMININ;SCOLAIRE;BAC TECHNOLOGIQUE;BAC ST2S;BAC ST2S SCIENCES & TECHNO. SANTE & SOCIAL;728;728;613;18;97;54;43;667;4;28;104;228;303;61
13179.0;2022;12;NANCY-METZ;FEMININ;SCOLAIRE;BAC TECHNOLOGIQUE;BAC STHR;BAC STHR SC.&TEC. HOTELLERIE-RESTAURATION;51;51;47;0;4;4;0;51;0;3;11;19;18;0
13182.0;2022;12;NANCY-METZ;FEMININ;SCOLAIRE;BAC TECHNOLOGIQUE;BAC STI2D;BAC STI2D INNOVATION TECHNO.  ET ECO CONCEPTION;28;28;24;1;3;2;1;26;0;1;4;9;12;2
13183.0;2022;12;NANCY-METZ;FEMININ;SCOLAIRE;BAC TECHNOLOGIQUE;BAC STI2D;BAC STI2D SYSTÈME D'INFORMATION  ET NUMERIQUE;24;24;20;1;3;2;1;22;0;0;5;6;11;2
13188.0;2022;12;NANCY-METZ;FEMININ;SCOLAIRE;BAC TECHNOLOGIQUE;BAC STMG;BAC STMG RESSOURCES HUMAINES ET COMMUNICATION;464;464;376;20;68;44;24;420;0;2;54;161;203;44
13192.0;2022;12;NANCY-METZ;MASCULIN;APPRENTISSAGE;BAC PROFESSIONNEL;BAC PRO PROD;BAC PRO 22105 BOULANGER-PÂTISSIER;1;1;1;0;0;0;0;1;0;0;0;1;0;0
13198.0;2022;12;NANCY-METZ;MASCULIN;APPRENTISSAGE;BAC PROFESSIONNEL;BAC PRO PROD;BAC PRO 23102 TRAVAUX PUBLICS;13;13;11;2;0;0;0;11;0;0;2;8;1;2
13201.0;2022;12;NANCY-METZ;MASCULIN;APPRENTISSAGE;BAC PROFESSIONNEL;BAC PRO PROD;BAC PRO 23404 TECHNICIEN CONSTRUCTEUR BOIS;5;5;4;1;0;0;0;4;0;0;2;1;1;1
13202.0;2022;12;NANCY-METZ;MASCULIN;APPRENTISSAGE;BAC PROFESSIONNEL;BAC PRO PROD;BAC PRO 23405 TECHNICIEN MENUISIER AGENCEUR;14;14;9;4;1;1;0;10;0;0;2;1;7;4
13203.0;2022;12;NANCY-METZ;MASCULIN;APPRENTISSAGE;BAC PROFESSIONNEL;BAC PRO PROD;BAC PRO 23406 TECHNICIEN DE SCIERIE;3;3;3;0;0;0;0;3;0;0;1;0;2;0
13205.0;2022;12;NANCY-METZ;MASCULIN;APPRENTISSAGE;BAC PROFESSIONNEL;BAC PRO PROD;BAC PRO 24202 ARTIS.& MET.ART : TAPIS.D'AMEUBL;1;1;1;0;0;0;0;1;0;0;0;1;0;0
13211.0;2022;12;NANCY-METZ;MASCULIN;APPRENTISSAGE;BAC PROFESSIONNEL;BAC PRO PROD;BAC PRO 25216 MAINT.VEHIC.OPTC MOTOCYCLES;8;8;8;0;0;0;0;8;0;1;3;1;3;0
13212.0;2022;12;NANCY-METZ;MASCULIN;APPRENTISSAGE;BAC PROFESSIONNEL;BAC PRO PROD;BAC PRO 25219 MAINT.MATERIELS OPT.A AGRICOLES;12;12;11;1;0;0;0;11;0;0;4;5;2;1
13221.0;2022;12;NANCY-METZ;MASCULIN;APPRENTISSAGE;BAC PROFESSIONNEL;BAC PRO PROD;BAC PRO 25509 TECHNIC. FROID CONDITIONNEMT AIR;5;5;2;2;1;0;1;2;0;1;0;0;1;3
13228.0;2022;12;NANCY-METZ;MASCULIN;APPRENTISSAGE;BAC PROFESSIONNEL;BAC PRO PROD;BAC PRO AG 21210 COND GEST ENTR CANIN ET FELIN;3;3;2;1;0;0;0;2;0;0;0;0;2;1
13229.0;2022;12;NANCY-METZ;MASCULIN;APPRENTISSAGE;BAC PROFESSIONNEL;BAC PRO PROD;BAC PRO AG 21211 COND GEST ENTR HIPPIQUE;7;6;3;3;0;0;0;3;0;0;0;1;2;3
13236.0;2022;12;NANCY-METZ;MASCULIN;APPRENTISSAGE;BAC PROFESSIONNEL;BAC PRO SERV;BAC PRO 31107 CONDUCT. TRANSP.ROUT.MARCHANDISES;1;1;1;0;0;0;0;1;0;0;1;0;0;0
13237.0;2022;12;NANCY-METZ;MASCULIN;APPRENTISSAGE;BAC PROFESSIONNEL;BAC PRO SERV;BAC PRO 31213 MET.COM.VEN.OP.A ANI.GES.ESP.COM.;46;45;37;5;3;1;2;38;0;0;7;14;17;7
13255.0;2022;12;NANCY-METZ;MASCULIN;FORMATION CONTINUE;BAC PROFESSIONNEL;BAC PRO PROD;BAC PRO 25214 MAINT.VEHIC.OPTA VOIT.PARTICUL.;10;10;8;2;0;0;0;8;0;3;3;2;0;2
13258.0;2022;12;NANCY-METZ;MASCULIN;FORMATION CONTINUE;BAC PROFESSIONNEL;BAC PRO PROD;BAC PRO 25515 SYST.NUM.OPT.C RES.INF.SYST.COMM.;4;3;3;0;0;0;0;3;0;1;1;1;0;0
13269.0;2022;12;NANCY-METZ;MASCULIN;INDIVIDUEL;BAC PROFESSIONNEL;BAC PRO PROD;BAC PRO 23004 TECHN. ETUDES BAT.A ETUDES & ECO.;1;1;0;1;0;0;0;0;0;0;0;0;0;1
13272.0;2022;12;NANCY-METZ;MASCULIN;INDIVIDUEL;BAC PROFESSIONNEL;BAC PRO PROD;BAC PRO 25214 MAINT.VEHIC.OPTA VOIT.PARTICUL.;2;1;1;0;0;0;0;1;0;0;0;1;0;0
13278.0;2022;12;NANCY-METZ;MASCULIN;INDIVIDUEL;BAC PROFESSIONNEL;BAC PRO SERV;BAC PRO 31108 TRANSPORT;1;0;0;0;0;0;0;0;0;0;0;0;0;0
13283.0;2022;12;NANCY-METZ;MASCULIN;INDIVIDUEL;BAC TECHNOLOGIQUE;BAC ST2S;BAC ST2S SCIENCES & TECHNO. SANTE & SOCIAL;3;2;1;0;1;1;0;2;0;0;0;0;2;0
13284.0;2022;12;NANCY-METZ;MASCULIN;INDIVIDUEL;BAC TECHNOLOGIQUE;BAC STI2D;BAC STI2D ENERGIES  ET ENVIRONNEMENT;1;0;0;0;0;0;0;0;0;0;0;0;0;0
13285.0;2022;12;NANCY-METZ;MASCULIN;INDIVIDUEL;BAC TECHNOLOGIQUE;BAC STI2D;BAC STI2D SYSTÈME D'INFORMATION  ET NUMERIQUE;2;2;1;1;0;0;0;1;0;0;0;0;1;1
13290.0;2022;12;NANCY-METZ;MASCULIN;SCOLAIRE;BAC GENERAL;BAC GENERAL;BAC GENE 10019 BAC GENERAL;5007;5007;4521;67;419;304;115;4825;93;515;1075;1548;1594;182
13298.0;2022;12;NANCY-METZ;MASCULIN;SCOLAIRE;BAC PROFESSIONNEL;BAC PRO PROD;BAC PRO 22503 PLASTIQUES ET COMPOSITES;13;13;10;3;0;0;0;10;0;1;0;0;9;3
13300.0;2022;12;NANCY-METZ;MASCULIN;SCOLAIRE;BAC PROFESSIONNEL;BAC PRO PROD;BAC PRO 22704 TECHN. MAINT. SYST.ENERG.CLIMATI;41;41;24;16;1;1;0;25;0;0;0;9;16;16
13306.0;2022;12;NANCY-METZ;MASCULIN;SCOLAIRE;BAC PROFESSIONNEL;BAC PRO PROD;BAC PRO 23303 MENUISERIE ALUMINIUM-VERRE;3;3;2;1;0;0;0;2;0;0;0;1;1;1
13315.0;2022;12;NANCY-METZ;MASCULIN;SCOLAIRE;BAC PROFESSIONNEL;BAC PRO PROD;BAC PRO 25106 TECHNICIEN D'USINAGE;68;68;51;17;0;0;0;51;0;2;10;21;18;17
13319.0;2022;12;NANCY-METZ;MASCULIN;SCOLAIRE;BAC PROFESSIONNEL;BAC PRO PROD;BAC PRO 25216 MAINT.VEHIC.OPTC MOTOCYCLES;33;33;23;8;2;2;0;25;0;2;5;7;11;8
13321.0;2022;12;NANCY-METZ;MASCULIN;SCOLAIRE;BAC PROFESSIONNEL;BAC PRO PROD;BAC PRO 25220 MAINT.MATERIELS OPT.B TP MANUT.;19;18;13;3;2;2;0;15;0;0;3;1;11;3
13323.0;2022;12;NANCY-METZ;MASCULIN;SCOLAIRE;BAC PROFESSIONNEL;BAC PRO PROD;BAC PRO 25303 AERONAUTIQUE OPTION SYSTEMES;10;10;10;0;0;0;0;10;0;0;4;4;2;0
13327.0;2022;12;NANCY-METZ;MASCULIN;SCOLAIRE;BAC PROFESSIONNEL;BAC PRO PROD;BAC PRO 25411 TECH.CHAUDRONNERIE INDUSTRIELLE;67;67;54;11;2;2;0;56;0;2;17;16;21;11
13328.0;2022;12;NANCY-METZ;MASCULIN;SCOLAIRE;BAC PROFESSIONNEL;BAC PRO PROD;BAC PRO 25509 TECHNIC. FROID CONDITIONNEMT AIR;62;62;51;8;3;3;0;54;0;5;14;12;23;8
13329.0;2022;12;NANCY-METZ;MASCULIN;SCOLAIRE;BAC PROFESSIONNEL;BAC PRO PROD;BAC PRO 25510 METIERS ELECT. ENVIRON. CONNECTES;460;458;343;88;27;17;10;360;0;25;69;135;131;98
13332.0;2022;12;NANCY-METZ;MASCULIN;SCOLAIRE;BAC PROFESSIONNEL;BAC PRO PROD;BAC PRO 25515 SYST.NUM.OPT.C RES.INF.SYST.COMM.;131;131;109;16;6;6;0;115;0;11;27;39;38;16
13334.0;2022;12;NANCY-METZ;MASCULIN;SCOLAIRE;BAC PROFESSIONNEL;BAC PRO PROD;BAC PRO AG 21004 CGEA;59;58;54;4;0;0;0;54;0;0;4;22;28;4
13338.0;2022;12;NANCY-METZ;MASCULIN;SCOLAIRE;BAC PROFESSIONNEL;BAC PRO PROD;BAC PRO AG 21302 GEST MILIEUX NATURELS FAUNE;37;37;33;4;0;0;0;33;0;0;5;10;18;4
13344.0;2022;12;NANCY-METZ;MASCULIN;SCOLAIRE;BAC PROFESSIONNEL;BAC PRO SERV;BAC PRO 31107 CONDUCT. TRANSP.ROUT.MARCHANDISES;81;81;70;10;1;0;1;70;0;2;25;28;15;11
13353.0;2022;12;NANCY-METZ;MASCULIN;SCOLAIRE;BAC PROFESSIONNEL;BAC PRO SERV;BAC PRO 33002 SERVICES DE PROXIMITE  VIE LOCAL;29;29;28;1;0;0;0;28;0;1;14;6;7;1
13357.0;2022;12;NANCY-METZ;MASCULIN;SCOLAIRE;BAC PROFESSIONNEL;BAC PRO SERV;BAC PRO 33102 PROTHESE DENTAIRE;4;4;4;0;0;0;0;4;0;0;0;4;0;0
13364.0;2022;12;NANCY-METZ;MASCULIN;SCOLAIRE;BAC TECHNOLOGIQUE;BAC S2TMD;BAC S2TMD THEATRE;1;1;1;0;0;0;0;1;0;0;1;0;0;0
13368.0;2022;12;NANCY-METZ;MASCULIN;SCOLAIRE;BAC TECHNOLOGIQUE;BAC STHR;BAC STHR SC.&TEC. HOTELLERIE-RESTAURATION;59;59;54;1;4;4;0;58;2;2;11;25;18;1
13372.0;2022;12;NANCY-METZ;MASCULIN;SCOLAIRE;BAC TECHNOLOGIQUE;BAC STI2D;BAC STI2D SYSTÈME D'INFORMATION  ET NUMERIQUE;260;260;217;6;37;23;14;240;0;6;22;91;121;20
13386.0;2022;17;NANTES;FEMININ;APPRENTISSAGE;BAC PROFESSIONNEL;BAC PRO PROD;BAC PRO 23205 INTERV. SUR PATRIMOINE BATI OPT.A;1;1;0;1;0;0;0;0;0;0;0;0;0;1
13387.0;2022;17;NANTES;FEMININ;APPRENTISSAGE;BAC PROFESSIONNEL;BAC PRO PROD;BAC PRO 23303 MENUISERIE ALUMINIUM-VERRE;1;1;1;0;0;0;0;1;0;0;0;1;0;0
13394.0;2022;17;NANTES;FEMININ;APPRENTISSAGE;BAC PROFESSIONNEL;BAC PRO PROD;BAC PRO 25303 AERONAUTIQUE OPTION SYSTEMES;3;3;3;0;0;0;0;3;0;0;0;1;2;0
13396.0;2022;17;NANTES;FEMININ;APPRENTISSAGE;BAC PROFESSIONNEL;BAC PRO PROD;BAC PRO 25408 REPARATION DES CARROSSERIES;3;3;3;0;0;0;0;3;0;0;0;2;1;0
13411.0;2022;17;NANTES;FEMININ;APPRENTISSAGE;BAC PROFESSIONNEL;BAC PRO SERV;BAC PRO 31106 LOGISTIQUE;6;6;5;0;1;1;0;6;0;3;1;0;2;0
13420.0;2022;17;NANTES;FEMININ;APPRENTISSAGE;BAC PROFESSIONNEL;BAC PRO SERV;BAC PRO 33004 ACC.SOINS-S.PERS. OPT.EN STRUCTUR;10;10;8;2;0;0;0;8;0;1;4;1;2;2
13431.0;2022;17;NANTES;FEMININ;ENSEIGNEMENT A DISTANCE;BAC PROFESSIONNEL;BAC PRO SERV;BAC PRO 33004 ACC.SOINS-S.PERS. OPT.EN STRUCTUR;5;5;4;1;0;0;0;4;0;1;0;1;2;1
13441.0;2022;17;NANTES;FEMININ;FORMATION CONTINUE;BAC PROFESSIONNEL;BAC PRO SERV;BAC PRO 31213 MET.COM.VEN.OP.A ANI.GES.ESP.COM.;6;5;1;3;1;0;1;1;0;0;0;0;1;4
13443.0;2022;17;NANTES;FEMININ;INDIVIDUEL;BAC GENERAL;BAC GENERAL;BAC GENE 10019 BAC GENERAL;117;77;48;21;8;5;3;53;1;2;6;17;27;24
13444.0;2022;17;NANTES;FEMININ;INDIVIDUEL;BAC PROFESSIONNEL;BAC PRO PROD;BAC PRO 20102 PILOTE DE LIGNE DE PRODUCTION;1;1;1;0;0;0;0;1;0;0;0;1;0;0
13450.0;2022;17;NANTES;FEMININ;INDIVIDUEL;BAC PROFESSIONNEL;BAC PRO SERV;BAC PRO 31214 MET.COM.VEN.OP.B PR.CL.VA.OF.COM.;1;0;0;0;0;0;0;0;0;0;0;0;0;0
13458.0;2022;17;NANTES;FEMININ;INDIVIDUEL;BAC TECHNOLOGIQUE;BAC STMG;BAC STMG GESTION ET FINANCE;4;3;2;0;1;1;0;3;0;0;0;1;2;0
13461.0;2022;17;NANTES;FEMININ;SCOLAIRE;BAC GENERAL;BAC GENERAL;BAC GENE 10019 BAC GENERAL;12091;12091;11436;108;547;397;150;11833;148;1427;3153;4041;3064;258
13473.0;2022;17;NANTES;FEMININ;SCOLAIRE;BAC PROFESSIONNEL;BAC PRO PROD;BAC PRO 23408 Etude et réalisation d'agencement;12;12;12;0;0;0;0;12;0;0;3;3;6;0
13477.0;2022;17;NANTES;FEMININ;SCOLAIRE;BAC PROFESSIONNEL;BAC PRO PROD;BAC PRO 25007 MAINTENANCE EQUIPEMENTS INDUST.;8;8;5;3;0;0;0;5;0;0;1;2;2;3
13484.0;2022;17;NANTES;FEMININ;SCOLAIRE;BAC PROFESSIONNEL;BAC PRO PROD;BAC PRO 25406 OUVRAGES DU BATIMENT METALLERIE;1;1;0;1;0;0;0;0;0;0;0;0;0;1
13487.0;2022;17;NANTES;FEMININ;SCOLAIRE;BAC PROFESSIONNEL;BAC PRO PROD;BAC PRO 25510 METIERS ELECT. ENVIRON. CONNECTES;4;4;2;1;1;0;1;2;0;1;1;0;0;2
13490.0;2022;17;NANTES;FEMININ;SCOLAIRE;BAC PROFESSIONNEL;BAC PRO PROD;BAC PRO 25515 SYST.NUM.OPT.C RES.INF.SYST.COMM.;5;5;5;0;0;0;0;5;0;1;1;3;0;0
13498.0;2022;17;NANTES;FEMININ;SCOLAIRE;BAC PROFESSIONNEL;BAC PRO PROD;BAC PRO AG 21302 GEST MILIEUX NATURELS FAUNE;14;14;12;2;0;0;0;12;0;0;2;7;3;2
13504.0;2022;17;NANTES;FEMININ;SCOLAIRE;BAC PROFESSIONNEL;BAC PRO SERV;BAC PRO 30001 GESTION-ADMINISTRATION;564;563;465;75;23;20;3;485;0;27;97;193;168;78
13505.0;2022;17;NANTES;FEMININ;SCOLAIRE;BAC PROFESSIONNEL;BAC PRO SERV;BAC PRO 31106 LOGISTIQUE;16;16;15;1;0;0;0;15;0;3;1;6;5;1
13510.0;2022;17;NANTES;FEMININ;SCOLAIRE;BAC PROFESSIONNEL;BAC PRO SERV;BAC PRO 31214 MET.COM.VEN.OP.B PR.CL.VA.OF.COM.;152;152;135;11;6;6;0;141;0;12;34;52;43;11
13512.0;2022;17;NANTES;FEMININ;SCOLAIRE;BAC PROFESSIONNEL;BAC PRO SERV;BAC PRO 32208 REAL.PR.IMPR.PLURI.OPTB.PR.IMPR.;3;3;3;0;0;0;0;3;0;1;0;2;0;0
13519.0;2022;17;NANTES;FEMININ;SCOLAIRE;BAC PROFESSIONNEL;BAC PRO SERV;BAC PRO 33102 PROTHESE DENTAIRE;18;18;17;1;0;0;0;17;0;0;3;7;7;1
13529.0;2022;17;NANTES;FEMININ;SCOLAIRE;BAC TECHNOLOGIQUE;BAC ST2S;BAC ST2S SCIENCES & TECHNO. SANTE & SOCIAL;1043;1043;906;19;118;66;52;972;0;26;165;342;439;71
13533.0;2022;17;NANTES;FEMININ;SCOLAIRE;BAC TECHNOLOGIQUE;BAC STI2D;BAC STI2D ARCHITECTURE ET CONSTRUCTION;44;44;39;2;3;2;1;41;0;4;6;17;14;3
13534.0;2022;17;NANTES;FEMININ;SCOLAIRE;BAC TECHNOLOGIQUE;BAC STI2D;BAC STI2D ENERGIES  ET ENVIRONNEMENT;11;11;8;1;2;1;1;9;0;0;1;4;4;2
13536.0;2022;17;NANTES;FEMININ;SCOLAIRE;BAC TECHNOLOGIQUE;BAC STI2D;BAC STI2D SYSTÈME D'INFORMATION  ET NUMERIQUE;24;24;19;1;4;3;1;22;0;1;3;9;9;2
13543.0;2022;17;NANTES;MASCULIN;APPRENTISSAGE;BAC PROFESSIONNEL;BAC PRO PROD;BAC PRO 20102 PILOTE DE LIGNE DE PRODUCTION;11;11;11;0;0;0;0;11;0;1;1;5;4;0
13545.0;2022;17;NANTES;MASCULIN;APPRENTISSAGE;BAC PROFESSIONNEL;BAC PRO PROD;BAC PRO 22106 CUISINE;42;41;32;8;1;1;0;33;0;0;6;10;17;8
13555.0;2022;17;NANTES;MASCULIN;APPRENTISSAGE;BAC PROFESSIONNEL;BAC PRO PROD;BAC PRO 23205 INTERV. SUR PATRIMOINE BATI OPT.A;1;1;1;0;0;0;0;1;0;0;0;0;1;0
13556.0;2022;17;NANTES;MASCULIN;APPRENTISSAGE;BAC PROFESSIONNEL;BAC PRO PROD;BAC PRO 23303 MENUISERIE ALUMINIUM-VERRE;11;11;9;0;2;2;0;11;0;0;1;3;7;0
13564.0;2022;17;NANTES;MASCULIN;APPRENTISSAGE;BAC PROFESSIONNEL;BAC PRO PROD;BAC PRO 25106 TECHNICIEN D'USINAGE;65;65;51;12;2;1;1;52;0;3;13;24;12;13
13566.0;2022;17;NANTES;MASCULIN;APPRENTISSAGE;BAC PROFESSIONNEL;BAC PRO PROD;BAC PRO 25215 MAINT.VEHIC.OPTB VEHIC.TRANS.ROUT;56;54;39;11;4;3;1;42;0;2;5;18;17;12
13570.0;2022;17;NANTES;MASCULIN;APPRENTISSAGE;BAC PROFESSIONNEL;BAC PRO PROD;BAC PRO 25221 MAINT.MATERIELS OPT.C ESP. VERTS;34;34;23;6;5;2;3;25;0;1;3;6;15;9
13571.0;2022;17;NANTES;MASCULIN;APPRENTISSAGE;BAC PROFESSIONNEL;BAC PRO PROD;BAC PRO 25302 AERONAUTIQUE OPTION AVIONIQUE;12;12;12;0;0;0;0;12;0;0;5;7;0;0
13573.0;2022;17;NANTES;MASCULIN;APPRENTISSAGE;BAC PROFESSIONNEL;BAC PRO PROD;BAC PRO 25304 AERONAUTIQUE OPTION STRUCTURE;22;22;22;0;0;0;0;22;0;1;11;6;4;0
13581.0;2022;17;NANTES;MASCULIN;APPRENTISSAGE;BAC PROFESSIONNEL;BAC PRO PROD;BAC PRO 25514 SYST.NUM.OPT.B AUD.RES.EQUIP.DOM.;10;10;8;1;1;0;1;8;0;1;4;2;1;2
13582.0;2022;17;NANTES;MASCULIN;APPRENTISSAGE;BAC PROFESSIONNEL;BAC PRO PROD;BAC PRO 25515 SYST.NUM.OPT.C RES.INF.SYST.COMM.;30;30;28;2;0;0;0;28;0;3;6;14;5;2
13599.0;2022;17;NANTES;MASCULIN;APPRENTISSAGE;BAC PROFESSIONNEL;BAC PRO SERV;BAC PRO 31212 METIERS DE L'ACCUEIL;1;1;1;0;0;0;0;1;0;0;0;1;0;0
13601.0;2022;17;NANTES;MASCULIN;APPRENTISSAGE;BAC PROFESSIONNEL;BAC PRO SERV;BAC PRO 31214 MET.COM.VEN.OP.B PR.CL.VA.OF.COM.;10;10;7;1;2;1;1;8;0;0;1;5;2;2
13603.0;2022;17;NANTES;MASCULIN;APPRENTISSAGE;BAC PROFESSIONNEL;BAC PRO SERV;BAC PRO 32207 REAL.PR.IMPR.PLURI.OPTA.PR.GRAPH.;2;2;2;0;0;0;0;2;0;0;1;0;1;0
13604.0;2022;17;NANTES;MASCULIN;APPRENTISSAGE;BAC PROFESSIONNEL;BAC PRO SERV;BAC PRO 32208 REAL.PR.IMPR.PLURI.OPTB.PR.IMPR.;7;6;5;1;0;0;0;5;0;0;1;3;1;1
13606.0;2022;17;NANTES;MASCULIN;APPRENTISSAGE;BAC PROFESSIONNEL;BAC PRO SERV;BAC PRO 33403 COMMERC. SERVICES EN RESTAURATION;21;20;18;2;0;0;0;18;0;0;1;8;9;2
13611.0;2022;17;NANTES;MASCULIN;ENSEIGNEMENT A DISTANCE;BAC PROFESSIONNEL;BAC PRO PROD;BAC PRO AG 21114 CONDUITE PRODUCTIONS HORTICOLES;13;12;12;0;0;0;0;12;0;0;0;0;12;0
13614.0;2022;17;NANTES;MASCULIN;ENSEIGNEMENT A DISTANCE;BAC TECHNOLOGIQUE;BAC STMG;BAC STMG GESTION ET FINANCE;1;1;1;0;0;0;0;1;0;0;0;0;1;0
13620.0;2022;17;NANTES;MASCULIN;FORMATION CONTINUE;BAC PROFESSIONNEL;BAC PRO PROD;BAC PRO 22705 TECHNICIEN GAZ;2;2;2;0;0;0;0;2;0;2;0;0;0;0
13621.0;2022;17;NANTES;MASCULIN;FORMATION CONTINUE;BAC PROFESSIONNEL;BAC PRO PROD;BAC PRO 23004 TECHN. ETUDES BAT.A ETUDES & ECO.;14;13;12;1;0;0;0;12;0;2;5;2;3;1
13622.0;2022;17;NANTES;MASCULIN;FORMATION CONTINUE;BAC PROFESSIONNEL;BAC PRO PROD;BAC PRO 23404 TECHNICIEN CONSTRUCTEUR BOIS;3;3;3;0;0;0;0;3;0;2;1;0;0;0
13631.0;2022;17;NANTES;MASCULIN;FORMATION CONTINUE;BAC PROFESSIONNEL;BAC PRO SERV;BAC PRO 31213 MET.COM.VEN.OP.A ANI.GES.ESP.COM.;10;10;8;2;0;0;0;8;0;1;3;1;3;2
13632.0;2022;17;NANTES;MASCULIN;FORMATION CONTINUE;BAC PROFESSIONNEL;BAC PRO SERV;BAC PRO 33102 PROTHESE DENTAIRE;7;7;7;0;0;0;0;7;0;1;1;2;3;0
13634.0;2022;17;NANTES;MASCULIN;INDIVIDUEL;BAC PROFESSIONNEL;BAC PRO PROD;BAC PRO 20102 PILOTE DE LIGNE DE PRODUCTION;2;2;2;0;0;0;0;2;0;0;0;1;1;0
13640.0;2022;17;NANTES;MASCULIN;INDIVIDUEL;BAC PROFESSIONNEL;BAC PRO PROD;BAC PRO 25106 TECHNICIEN D'USINAGE;1;1;1;0;0;0;0;1;0;0;0;0;1;0
13642.0;2022;17;NANTES;MASCULIN;INDIVIDUEL;BAC PROFESSIONNEL;BAC PRO PROD;BAC PRO 25406 OUVRAGES DU BATIMENT METALLERIE;1;1;1;0;0;0;0;1;0;1;0;0;0;0
13643.0;2022;17;NANTES;MASCULIN;INDIVIDUEL;BAC PROFESSIONNEL;BAC PRO PROD;BAC PRO 25411 TECH.CHAUDRONNERIE INDUSTRIELLE;1;1;0;1;0;0;0;0;0;0;0;0;0;1
13646.0;2022;17;NANTES;MASCULIN;INDIVIDUEL;BAC PROFESSIONNEL;BAC PRO PROD;BAC PRO 25514 SYST.NUM.OPT.B AUD.RES.EQUIP.DOM.;1;1;1;0;0;0;0;1;0;0;0;0;1;0
13650.0;2022;17;NANTES;MASCULIN;INDIVIDUEL;BAC PROFESSIONNEL;BAC PRO PROD;BAC PRO AG 21114 CONDUITE PRODUCTIONS HORTICOLES;5;5;4;1;0;0;0;4;0;0;0;0;4;1
13654.0;2022;17;NANTES;MASCULIN;INDIVIDUEL;BAC PROFESSIONNEL;BAC PRO SERV;BAC PRO 31106 LOGISTIQUE;1;1;1;0;0;0;0;1;0;0;0;0;1;0
13662.0;2022;17;NANTES;MASCULIN;INDIVIDUEL;BAC TECHNOLOGIQUE;BAC STAV;BAC STAV AGRONOMIE ALIM ENV TERRITOI;1;1;1;0;0;0;0;1;0;0;0;0;1;0
13671.0;2022;17;NANTES;MASCULIN;INDIVIDUEL;BAC TECHNOLOGIQUE;BAC STMG;BAC STMG RESSOURCES HUMAINES ET COMMUNICATION;9;5;3;0;2;1;1;4;0;0;0;0;4;1
13676.0;2022;17;NANTES;MASCULIN;SCOLAIRE;BAC PROFESSIONNEL;BAC PRO PROD;BAC PRO 22004 PROC. CHIMIE EAU PAPIERS-CARTONS;13;13;13;0;0;0;0;13;0;1;5;5;2;0
13680.0;2022;17;NANTES;MASCULIN;SCOLAIRE;BAC PROFESSIONNEL;BAC PRO PROD;BAC PRO 22503 PLASTIQUES ET COMPOSITES;22;22;18;2;2;1;1;19;0;0;3;6;10;3
13683.0;2022;17;NANTES;MASCULIN;SCOLAIRE;BAC PROFESSIONNEL;BAC PRO PROD;BAC PRO 23003 ARTIS. & M.ART:MARCHANDISAGE VIS.;8;8;8;0;0;0;0;8;0;1;3;0;4;0
13690.0;2022;17;NANTES;MASCULIN;SCOLAIRE;BAC PROFESSIONNEL;BAC PRO PROD;BAC PRO 23303 MENUISERIE ALUMINIUM-VERRE;13;13;6;6;1;0;1;6;0;0;1;1;4;7
13695.0;2022;17;NANTES;MASCULIN;SCOLAIRE;BAC PROFESSIONNEL;BAC PRO PROD;BAC PRO 23408 Etude et réalisation d'agencement;3;3;2;1;0;0;0;2;0;0;0;1;1;1
13704.0;2022;17;NANTES;MASCULIN;SCOLAIRE;BAC PROFESSIONNEL;BAC PRO PROD;BAC PRO 25214 MAINT.VEHIC.OPTA VOIT.PARTICUL.;240;240;190;42;8;5;3;195;0;11;41;59;84;45
13711.0;2022;17;NANTES;MASCULIN;SCOLAIRE;BAC PROFESSIONNEL;BAC PRO PROD;BAC PRO 25408 REPARATION DES CARROSSERIES;51;51;44;2;5;3;2;47;0;1;10;16;20;4
13713.0;2022;17;NANTES;MASCULIN;SCOLAIRE;BAC PROFESSIONNEL;BAC PRO PROD;BAC PRO 25411 TECH.CHAUDRONNERIE INDUSTRIELLE;71;71;54;15;2;1;1;55;0;1;10;23;21;16
13714.0;2022;17;NANTES;MASCULIN;SCOLAIRE;BAC PROFESSIONNEL;BAC PRO PROD;BAC PRO 25509 TECHNIC. FROID CONDITIONNEMT AIR;38;38;27;10;1;1;0;28;0;1;7;6;14;10
13720.0;2022;17;NANTES;MASCULIN;SCOLAIRE;BAC PROFESSIONNEL;BAC PRO PROD;BAC PRO AG 21004 CGEA;246;245;212;33;0;0;0;212;0;3;22;74;113;33
13721.0;2022;17;NANTES;MASCULIN;SCOLAIRE;BAC PROFESSIONNEL;BAC PRO PROD;BAC PRO AG 21113 CGEVV;19;19;17;2;0;0;0;17;0;0;1;8;8;2
13722.0;2022;17;NANTES;MASCULIN;SCOLAIRE;BAC PROFESSIONNEL;BAC PRO PROD;BAC PRO AG 21114 CONDUITE PRODUCTIONS HORTICOLES;27;26;24;2;0;0;0;24;0;1;5;11;7;2
13728.0;2022;17;NANTES;MASCULIN;SCOLAIRE;BAC PROFESSIONNEL;BAC PRO PROD;BAC PRO AG 21303 FORET;5;5;5;0;0;0;0;5;0;0;0;1;4;0
13730.0;2022;17;NANTES;MASCULIN;SCOLAIRE;BAC PROFESSIONNEL;BAC PRO PROD;BAC PRO AG 21407 TEC CONS VTE UNIVERS JARDINERIE;5;5;5;0;0;0;0;5;0;0;0;1;4;0
13734.0;2022;17;NANTES;MASCULIN;SCOLAIRE;BAC PROFESSIONNEL;BAC PRO SERV;BAC PRO 30001 GESTION-ADMINISTRATION;255;254;199;47;8;7;1;206;0;2;26;75;103;48
13751.0;2022;17;NANTES;MASCULIN;SCOLAIRE;BAC PROFESSIONNEL;BAC PRO SERV;BAC PRO 33403 COMMERC. SERVICES EN RESTAURATION;93;92;78;12;2;2;0;80;0;4;19;29;28;12
13753.0;2022;17;NANTES;MASCULIN;SCOLAIRE;BAC PROFESSIONNEL;BAC PRO SERV;BAC PRO 34304 HYGIENE PROPRETE STERILISATION;1;1;1;0;0;0;0;1;0;0;0;1;0;0
13755.0;2022;17;NANTES;MASCULIN;SCOLAIRE;BAC PROFESSIONNEL;BAC PRO SERV;BAC PRO AG 33002 SERV PERS TERRIT;124;120;111;9;0;0;0;111;0;0;20;39;52;9
13757.0;2022;17;NANTES;MASCULIN;SCOLAIRE;BAC TECHNOLOGIQUE;BAC S2TMD;BAC S2TMD MUSIQUE;12;12;12;0;0;0;0;12;1;6;4;1;0;0
13766.0;2022;17;NANTES;MASCULIN;SCOLAIRE;BAC TECHNOLOGIQUE;BAC STL;BAC STL BIOCHIM.-BIOLOGIE-BIOTECHNOL.;56;56;53;1;2;2;0;55;0;3;6;22;24;1
13767.0;2022;17;NANTES;MASCULIN;SCOLAIRE;BAC TECHNOLOGIQUE;BAC STL;BAC STL SCIENCES PHYSIQUES CHIMIQUES  EN LABORAT.;91;91;72;1;18;7;11;79;0;2;9;30;38;12
13784.0;2022;23;NICE;FEMININ;APPRENTISSAGE;BAC PROFESSIONNEL;BAC PRO PROD;BAC PRO AG 21405 AMENAGEMENTS PAYSAGERS;1;1;1;0;0;0;0;1;0;0;0;0;1;0
13787.0;2022;23;NICE;FEMININ;APPRENTISSAGE;BAC PROFESSIONNEL;BAC PRO SERV;BAC PRO 31212 METIERS DE L'ACCUEIL;2;2;2;0;0;0;0;2;0;1;1;0;0;0
13799.0;2022;23;NICE;FEMININ;ENSEIGNEMENT A DISTANCE;BAC TECHNOLOGIQUE;BAC ST2S;BAC ST2S SCIENCES & TECHNO. SANTE & SOCIAL;6;6;4;2;0;0;0;4;0;0;0;2;2;2
13807.0;2022;23;NICE;FEMININ;FORMATION CONTINUE;BAC PROFESSIONNEL;BAC PRO SERV;BAC PRO 31213 MET.COM.VEN.OP.A ANI.GES.ESP.COM.;8;7;5;2;0;0;0;5;0;0;1;2;2;2
13810.0;2022;23;NICE;FEMININ;FORMATION CONTINUE;BAC PROFESSIONNEL;BAC PRO SERV;BAC PRO AG 33002 SERV PERS TERRIT;5;5;5;0;0;0;0;5;0;2;2;1;0;0
13811.0;2022;23;NICE;FEMININ;INDIVIDUEL;BAC GENERAL;BAC GENERAL;BAC GENE 10019 BAC GENERAL;118;117;58;41;18;10;8;68;1;14;12;11;30;49
13820.0;2022;23;NICE;FEMININ;INDIVIDUEL;BAC PROFESSIONNEL;BAC PRO SERV;BAC PRO AG 33002 SERV PERS TERRIT;1;1;0;1;0;0;0;0;0;0;0;0;0;1
13822.0;2022;23;NICE;FEMININ;INDIVIDUEL;BAC TECHNOLOGIQUE;BAC ST2S;BAC ST2S SCIENCES & TECHNO. SANTE & SOCIAL;4;4;1;2;1;1;0;2;0;0;0;0;2;2
13823.0;2022;23;NICE;FEMININ;INDIVIDUEL;BAC TECHNOLOGIQUE;BAC STD2A;BAC STD2A SCIENCES & TECHNO. DESIGN-ARTS APPLIQUES;1;1;0;1;0;0;0;0;0;0;0;0;0;1
13828.0;2022;23;NICE;FEMININ;SCOLAIRE;BAC GENERAL;BAC GENERAL;BAC GENE 10019 BAC GENERAL;6393;6393;5982;83;328;192;136;6174;200;890;1666;1916;1502;219
13838.0;2022;23;NICE;FEMININ;SCOLAIRE;BAC PROFESSIONNEL;BAC PRO PROD;BAC PRO 23405 TECHNICIEN MENUISIER AGENCEUR;1;1;1;0;0;0;0;1;0;0;1;0;0;0
13852.0;2022;23;NICE;FEMININ;SCOLAIRE;BAC PROFESSIONNEL;BAC PRO PROD;BAC PRO 25513 SYST.NUM.OPT.A SURETE SECURITE;1;1;1;0;0;0;0;1;0;0;0;0;1;0
13857.0;2022;23;NICE;FEMININ;SCOLAIRE;BAC PROFESSIONNEL;BAC PRO PROD;BAC PRO AG 21114 CONDUITE PRODUCTIONS HORTICOLES;11;10;4;6;0;0;0;4;0;0;0;2;2;6
13862.0;2022;23;NICE;FEMININ;SCOLAIRE;BAC PROFESSIONNEL;BAC PRO SERV;BAC PRO 31107 CONDUCT. TRANSP.ROUT.MARCHANDISES;1;1;1;0;0;0;0;1;0;0;1;0;0;0
13865.0;2022;23;NICE;FEMININ;SCOLAIRE;BAC PROFESSIONNEL;BAC PRO SERV;BAC PRO 31213 MET.COM.VEN.OP.A ANI.GES.ESP.COM.;281;280;222;39;19;10;9;232;0;7;42;90;93;48
13866.0;2022;23;NICE;FEMININ;SCOLAIRE;BAC PROFESSIONNEL;BAC PRO SERV;BAC PRO 31214 MET.COM.VEN.OP.B PR.CL.VA.OF.COM.;105;105;94;8;3;1;2;95;0;10;30;25;30;10
13867.0;2022;23;NICE;FEMININ;SCOLAIRE;BAC PROFESSIONNEL;BAC PRO SERV;BAC PRO 32207 REAL.PR.IMPR.PLURI.OPTA.PR.GRAPH.;4;4;4;0;0;0;0;4;0;2;0;1;1;0
13871.0;2022;23;NICE;FEMININ;SCOLAIRE;BAC PROFESSIONNEL;BAC PRO SERV;BAC PRO 33004 ACC.SOINS-S.PERS. OPT.EN STRUCTUR;295;295;265;25;5;4;1;269;0;13;63;113;80;26
13875.0;2022;23;NICE;FEMININ;SCOLAIRE;BAC PROFESSIONNEL;BAC PRO SERV;BAC PRO 34304 HYGIENE PROPRETE STERILISATION;21;21;18;3;0;0;0;18;0;2;4;5;7;3
13879.0;2022;23;NICE;FEMININ;SCOLAIRE;BAC TECHNOLOGIQUE;BAC S2TMD;BAC S2TMD MUSIQUE;5;5;4;0;1;1;0;5;1;2;0;0;2;0
13885.0;2022;23;NICE;FEMININ;SCOLAIRE;BAC TECHNOLOGIQUE;BAC STI2D;BAC STI2D ENERGIES  ET ENVIRONNEMENT;16;16;14;1;1;1;0;15;0;0;2;3;10;1
13889.0;2022;23;NICE;FEMININ;SCOLAIRE;BAC TECHNOLOGIQUE;BAC STL;BAC STL SCIENCES PHYSIQUES CHIMIQUES  EN LABORAT.;63;63;52;2;9;7;2;59;0;1;12;23;23;4
13891.0;2022;23;NICE;FEMININ;SCOLAIRE;BAC TECHNOLOGIQUE;BAC STMG;BAC STMG MERCATIQUE (MARKETING);565;565;478;28;59;39;20;517;1;16;71;177;252;48
13893.0;2022;23;NICE;FEMININ;SCOLAIRE;BAC TECHNOLOGIQUE;BAC STMG;BAC STMG SYSTEMES D'INFORMATION DE GESTION;4;4;2;0;2;2;0;4;0;0;1;0;3;0
13901.0;2022;23;NICE;MASCULIN;APPRENTISSAGE;BAC PROFESSIONNEL;BAC PRO PROD;BAC PRO 23405 TECHNICIEN MENUISIER AGENCEUR;2;2;2;0;0;0;0;2;0;0;1;0;1;0
13903.0;2022;23;NICE;MASCULIN;APPRENTISSAGE;BAC PROFESSIONNEL;BAC PRO PROD;BAC PRO 25009 MAINTENANCE NAUTIQUE;31;30;22;7;1;1;0;23;0;2;2;11;8;7
13912.0;2022;23;NICE;MASCULIN;APPRENTISSAGE;BAC PROFESSIONNEL;BAC PRO PROD;BAC PRO 25509 TECHNIC. FROID CONDITIONNEMT AIR;19;19;13;3;3;2;1;15;0;1;4;4;6;4
13914.0;2022;23;NICE;MASCULIN;APPRENTISSAGE;BAC PROFESSIONNEL;BAC PRO PROD;BAC PRO 25513 SYST.NUM.OPT.A SURETE SECURITE;1;1;1;0;0;0;0;1;0;0;0;1;0;0
13917.0;2022;23;NICE;MASCULIN;APPRENTISSAGE;BAC PROFESSIONNEL;BAC PRO PROD;BAC PRO AG 21113 CGEVV;6;6;5;1;0;0;0;5;0;0;2;1;2;1
13920.0;2022;23;NICE;MASCULIN;APPRENTISSAGE;BAC PROFESSIONNEL;BAC PRO SERV;BAC PRO 30001 GESTION-ADMINISTRATION;2;2;2;0;0;0;0;2;0;0;1;0;1;0
13926.0;2022;23;NICE;MASCULIN;APPRENTISSAGE;BAC PROFESSIONNEL;BAC PRO SERV;BAC PRO 33102 PROTHESE DENTAIRE;1;1;0;1;0;0;0;0;0;0;0;0;0;1
13932.0;2022;23;NICE;MASCULIN;ENSEIGNEMENT A DISTANCE;BAC TECHNOLOGIQUE;BAC ST2S;BAC ST2S SCIENCES & TECHNO. SANTE & SOCIAL;2;2;1;0;1;0;1;1;0;0;0;0;1;1
13935.0;2022;23;NICE;MASCULIN;ENSEIGNEMENT A DISTANCE;BAC TECHNOLOGIQUE;BAC STMG;BAC STMG RESSOURCES HUMAINES ET COMMUNICATION;3;3;2;0;1;1;0;3;0;1;0;0;2;0
13940.0;2022;23;NICE;MASCULIN;FORMATION CONTINUE;BAC PROFESSIONNEL;BAC PRO SERV;BAC PRO 31214 MET.COM.VEN.OP.B PR.CL.VA.OF.COM.;1;1;1;0;0;0;0;1;0;0;0;0;1;0
13945.0;2022;23;NICE;MASCULIN;INDIVIDUEL;BAC PROFESSIONNEL;BAC PRO PROD;BAC PRO 25009 MAINTENANCE NAUTIQUE;1;0;0;0;0;0;0;0;0;0;0;0;0;0
13949.0;2022;23;NICE;MASCULIN;INDIVIDUEL;BAC PROFESSIONNEL;BAC PRO PROD;BAC PRO 25510 METIERS ELECT. ENVIRON. CONNECTES;2;2;0;2;0;0;0;0;0;0;0;0;0;2
13957.0;2022;23;NICE;MASCULIN;INDIVIDUEL;BAC PROFESSIONNEL;BAC PRO SERV;BAC PRO 31213 MET.COM.VEN.OP.A ANI.GES.ESP.COM.;5;1;0;1;0;0;0;0;0;0;0;0;0;1
13964.0;2022;23;NICE;MASCULIN;INDIVIDUEL;BAC TECHNOLOGIQUE;BAC STI2D;BAC STI2D SYSTÈME D'INFORMATION  ET NUMERIQUE;4;4;2;1;1;0;1;2;0;0;0;1;1;2
13969.0;2022;23;NICE;MASCULIN;SCOLAIRE;BAC PROFESSIONNEL;BAC PRO PROD;BACPRO 20002 ETUD.DEFINITION PRDTS INDUSTRIEL;22;22;21;1;0;0;0;21;0;2;1;8;10;1
13983.0;2022;23;NICE;MASCULIN;SCOLAIRE;BAC PROFESSIONNEL;BAC PRO PROD;BAC PRO 23304 AMENAGEMENT FINITION BATIMENT;16;16;12;3;1;1;0;13;0;1;0;6;6;3
13988.0;2022;23;NICE;MASCULIN;SCOLAIRE;BAC PROFESSIONNEL;BAC PRO PROD;BAC PRO 24203 METIERS DE LA MODE - VÊTEMENT;6;6;6;0;0;0;0;6;0;0;0;5;1;0
13990.0;2022;23;NICE;MASCULIN;SCOLAIRE;BAC PROFESSIONNEL;BAC PRO PROD;BAC PRO 25006 MICROTECHNIQUES;23;23;15;4;4;1;3;16;0;1;8;2;5;7
13993.0;2022;23;NICE;MASCULIN;SCOLAIRE;BAC PROFESSIONNEL;BAC PRO PROD;BAC PRO 25106 TECHNICIEN D'USINAGE;32;32;20;12;0;0;0;20;0;2;8;8;2;12
14001.0;2022;23;NICE;MASCULIN;SCOLAIRE;BAC PROFESSIONNEL;BAC PRO PROD;BAC PRO 25411 TECH.CHAUDRONNERIE INDUSTRIELLE;20;20;17;3;0;0;0;17;0;1;5;3;8;3
14004.0;2022;23;NICE;MASCULIN;SCOLAIRE;BAC PROFESSIONNEL;BAC PRO PROD;BAC PRO 25513 SYST.NUM.OPT.A SURETE SECURITE;34;31;27;4;0;0;0;27;0;1;6;12;8;4
14013.0;2022;23;NICE;MASCULIN;SCOLAIRE;BAC PROFESSIONNEL;BAC PRO SERV;BAC PRO 30001 GESTION-ADMINISTRATION;211;210;149;56;5;5;0;154;0;2;16;64;72;56
14014.0;2022;23;NICE;MASCULIN;SCOLAIRE;BAC PROFESSIONNEL;BAC PRO SERV;BAC PRO 31106 LOGISTIQUE;31;30;16;10;4;3;1;19;0;0;1;4;14;11
14015.0;2022;23;NICE;MASCULIN;SCOLAIRE;BAC PROFESSIONNEL;BAC PRO SERV;BAC PRO 31107 CONDUCT. TRANSP.ROUT.MARCHANDISES;19;19;11;7;1;1;0;12;0;0;2;4;6;7
14020.0;2022;23;NICE;MASCULIN;SCOLAIRE;BAC PROFESSIONNEL;BAC PRO SERV;BAC PRO 32207 REAL.PR.IMPR.PLURI.OPTA.PR.GRAPH.;8;8;7;1;0;0;0;7;0;0;4;2;1;1
14022.0;2022;23;NICE;MASCULIN;SCOLAIRE;BAC PROFESSIONNEL;BAC PRO SERV;BAC PRO 32303 ART.& MET.ART:COM.VIS.VIS.PLURI-M;6;6;3;3;0;0;0;3;0;1;0;2;0;3
14034.0;2022;23;NICE;MASCULIN;SCOLAIRE;BAC TECHNOLOGIQUE;BAC STAV;BAC STAV AGRONOMIE ALIM ENV TERRITOI;34;34;33;1;0;0;0;33;0;0;6;11;16;1
14035.0;2022;23;NICE;MASCULIN;SCOLAIRE;BAC TECHNOLOGIQUE;BAC STD2A;BAC STD2A SCIENCES & TECHNO. DESIGN-ARTS APPLIQUES;22;22;21;0;1;1;0;22;0;0;4;10;8;0
14036.0;2022;23;NICE;MASCULIN;SCOLAIRE;BAC TECHNOLOGIQUE;BAC STHR;BAC STHR SC.&TEC. HOTELLERIE-RESTAURATION;49;49;46;0;3;3;0;49;0;1;15;15;18;0
14048.0;2022;70;NORMANDIE;FEMININ;APPRENTISSAGE;BAC PROFESSIONNEL;BAC PRO PROD;BAC PRO 22003 BIO-INDUSTRIES DE TRANSFORMATION;5;5;4;1;0;0;0;4;0;0;0;1;3;1
14055.0;2022;70;NORMANDIE;FEMININ;APPRENTISSAGE;BAC PROFESSIONNEL;BAC PRO PROD;BAC PRO 25214 MAINT.VEHIC.OPTA VOIT.PARTICUL.;4;4;3;1;0;0;0;3;0;0;0;2;1;1
14056.0;2022;70;NORMANDIE;FEMININ;APPRENTISSAGE;BAC PROFESSIONNEL;BAC PRO PROD;BAC PRO 25215 MAINT.VEHIC.OPTB VEHIC.TRANS.ROUT;1;1;1;0;0;0;0;1;0;1;0;0;0;0
14059.0;2022;70;NORMANDIE;FEMININ;APPRENTISSAGE;BAC PROFESSIONNEL;BAC PRO PROD;BAC PRO 25411 TECH.CHAUDRONNERIE INDUSTRIELLE;6;6;6;0;0;0;0;6;0;1;1;2;2;0
14064.0;2022;70;NORMANDIE;FEMININ;APPRENTISSAGE;BAC PROFESSIONNEL;BAC PRO PROD;BAC PRO AG 21210 COND GEST ENTR CANIN ET FELIN;4;4;4;0;0;0;0;4;0;0;0;1;3;0
14065.0;2022;70;NORMANDIE;FEMININ;APPRENTISSAGE;BAC PROFESSIONNEL;BAC PRO PROD;BAC PRO AG 21211 COND GEST ENTR HIPPIQUE;53;50;43;7;0;0;0;43;0;0;2;12;29;7
14069.0;2022;70;NORMANDIE;FEMININ;APPRENTISSAGE;BAC PROFESSIONNEL;BAC PRO SERV;BAC PRO 31106 LOGISTIQUE;8;8;8;0;0;0;0;8;0;2;4;2;0;0
14070.0;2022;70;NORMANDIE;FEMININ;APPRENTISSAGE;BAC PROFESSIONNEL;BAC PRO SERV;BAC PRO 31212 METIERS DE L'ACCUEIL;3;3;3;0;0;0;0;3;0;1;0;2;0;0
14073.0;2022;70;NORMANDIE;FEMININ;APPRENTISSAGE;BAC PROFESSIONNEL;BAC PRO SERV;BAC PRO 33004 ACC.SOINS-S.PERS. OPT.EN STRUCTUR;2;2;1;0;1;0;1;1;0;0;0;1;0;1
14080.0;2022;70;NORMANDIE;FEMININ;ENSEIGNEMENT A DISTANCE;BAC PROFESSIONNEL;BAC PRO SERV;BAC PRO 33603 ESTHETIQUE COSMETIQUE PARFUMERIE;1;1;0;1;0;0;0;0;0;0;0;0;0;1
14083.0;2022;70;NORMANDIE;FEMININ;ENSEIGNEMENT A DISTANCE;BAC TECHNOLOGIQUE;BAC STMG;BAC STMG MERCATIQUE (MARKETING);5;5;5;0;0;0;0;5;0;0;0;1;4;0
14084.0;2022;70;NORMANDIE;FEMININ;ENSEIGNEMENT A DISTANCE;BAC TECHNOLOGIQUE;BAC STMG;BAC STMG RESSOURCES HUMAINES ET COMMUNICATION;6;6;3;1;2;1;1;4;0;0;0;1;3;2
14089.0;2022;70;NORMANDIE;FEMININ;FORMATION CONTINUE;BAC PROFESSIONNEL;BAC PRO PROD;BAC PRO 23404 TECHNICIEN CONSTRUCTEUR BOIS;1;1;1;0;0;0;0;1;0;0;1;0;0;0
14096.0;2022;70;NORMANDIE;FEMININ;FORMATION CONTINUE;BAC PROFESSIONNEL;BAC PRO SERV;BAC PRO 31213 MET.COM.VEN.OP.A ANI.GES.ESP.COM.;24;21;14;7;0;0;0;14;0;2;2;4;6;7
14101.0;2022;70;NORMANDIE;FEMININ;INDIVIDUEL;BAC GENERAL;BAC GENERAL;BAC GENE 10019 BAC GENERAL;91;62;34;17;11;8;3;42;0;0;8;15;19;20
14113.0;2022;70;NORMANDIE;FEMININ;INDIVIDUEL;BAC TECHNOLOGIQUE;BAC ST2S;BAC ST2S SCIENCES & TECHNO. SANTE & SOCIAL;10;8;1;6;1;0;1;1;0;0;0;0;1;7
14123.0;2022;70;NORMANDIE;FEMININ;SCOLAIRE;BAC PROFESSIONNEL;BAC PRO PROD;BAC PRO 22106 CUISINE;71;71;62;5;4;4;0;66;0;0;6;35;25;5
14124.0;2022;70;NORMANDIE;FEMININ;SCOLAIRE;BAC PROFESSIONNEL;BAC PRO PROD;BAC PRO 22303 FONDERIE;1;1;1;0;0;0;0;1;0;0;0;0;1;0
14131.0;2022;70;NORMANDIE;FEMININ;SCOLAIRE;BAC PROFESSIONNEL;BAC PRO PROD;BAC PRO 23205 INTERV. SUR PATRIMOINE BATI OPT.A;2;2;2;0;0;0;0;2;0;0;0;1;1;0
14137.0;2022;70;NORMANDIE;FEMININ;SCOLAIRE;BAC PROFESSIONNEL;BAC PRO PROD;BAC PRO 24203 METIERS DE LA MODE - VÊTEMENT;167;167;140;26;1;1;0;141;0;23;40;43;35;26
14138.0;2022;70;NORMANDIE;FEMININ;SCOLAIRE;BAC PROFESSIONNEL;BAC PRO PROD;BAC PRO 24302 METIERS DU CUIR : MAROQUINERIE;11;11;11;0;0;0;0;11;0;4;4;3;0;0
14141.0;2022;70;NORMANDIE;FEMININ;SCOLAIRE;BAC PROFESSIONNEL;BAC PRO PROD;BAC PRO 25106 TECHNICIEN D'USINAGE;2;2;2;0;0;0;0;2;0;0;0;0;2;0
14153.0;2022;70;NORMANDIE;FEMININ;SCOLAIRE;BAC PROFESSIONNEL;BAC PRO PROD;BAC PRO AG 21004 CGEA;96;95;70;25;0;0;0;70;0;1;2;28;39;25
14159.0;2022;70;NORMANDIE;FEMININ;SCOLAIRE;BAC PROFESSIONNEL;BAC PRO PROD;BAC PRO AG 21303 FORET;1;1;1;0;0;0;0;1;0;0;0;0;1;0
14170.0;2022;70;NORMANDIE;FEMININ;SCOLAIRE;BAC PROFESSIONNEL;BAC PRO SERV;BAC PRO 31214 MET.COM.VEN.OP.B PR.CL.VA.OF.COM.;111;111;96;9;6;5;1;101;0;6;20;41;34;10
14174.0;2022;70;NORMANDIE;FEMININ;SCOLAIRE;BAC PROFESSIONNEL;BAC PRO SERV;BAC PRO 32304 PHOTOGRAPHIE;11;11;11;0;0;0;0;11;0;0;1;4;6;0
14184.0;2022;70;NORMANDIE;FEMININ;SCOLAIRE;BAC PROFESSIONNEL;BAC PRO SERV;BAC PRO 34305 TECHN.D'INTERV.SUR INSTALL. NUCL.;1;1;1;0;0;0;0;1;0;0;0;1;0;0
14187.0;2022;70;NORMANDIE;FEMININ;SCOLAIRE;BAC TECHNOLOGIQUE;BAC S2TMD;BAC S2TMD DANSE;14;14;14;0;0;0;0;14;1;2;5;5;1;0
14191.0;2022;70;NORMANDIE;FEMININ;SCOLAIRE;BAC TECHNOLOGIQUE;BAC STD2A;BAC STD2A SCIENCES & TECHNO. DESIGN-ARTS APPLIQUES;89;89;88;0;1;1;0;89;1;12;42;21;13;0
14200.0;2022;70;NORMANDIE;FEMININ;SCOLAIRE;BAC TECHNOLOGIQUE;BAC STMG;BAC STMG MERCATIQUE (MARKETING);895;895;738;43;114;69;45;807;0;13;78;297;419;88
14201.0;2022;70;NORMANDIE;FEMININ;SCOLAIRE;BAC TECHNOLOGIQUE;BAC STMG;BAC STMG RESSOURCES HUMAINES ET COMMUNICATION;689;689;550;35;104;68;36;618;0;8;56;196;358;71
14204.0;2022;70;NORMANDIE;MASCULIN;APPRENTISSAGE;BAC PROFESSIONNEL;BAC PRO PROD;BAC PRO 22003 BIO-INDUSTRIES DE TRANSFORMATION;2;2;2;0;0;0;0;2;0;0;0;1;1;0
14208.0;2022;70;NORMANDIE;MASCULIN;APPRENTISSAGE;BAC PROFESSIONNEL;BAC PRO PROD;BAC PRO 22703 TECHN.INSTALL.SYST.ENERG.CLIMATI;21;21;17;2;2;2;0;19;0;3;4;4;8;2
14215.0;2022;70;NORMANDIE;MASCULIN;APPRENTISSAGE;BAC PROFESSIONNEL;BAC PRO PROD;BAC PRO 23404 TECHNICIEN CONSTRUCTEUR BOIS;16;16;14;2;0;0;0;14;0;1;3;5;5;2
14226.0;2022;70;NORMANDIE;MASCULIN;APPRENTISSAGE;BAC PROFESSIONNEL;BAC PRO PROD;BAC PRO 25221 MAINT.MATERIELS OPT.C ESP. VERTS;1;1;0;0;1;1;0;1;0;0;0;0;1;0
14230.0;2022;70;NORMANDIE;MASCULIN;APPRENTISSAGE;BAC PROFESSIONNEL;BAC PRO PROD;BAC PRO 25509 TECHNIC. FROID CONDITIONNEMT AIR;15;15;14;1;0;0;0;14;0;2;5;4;3;1
14231.0;2022;70;NORMANDIE;MASCULIN;APPRENTISSAGE;BAC PROFESSIONNEL;BAC PRO PROD;BAC PRO 25510 METIERS ELECT. ENVIRON. CONNECTES;118;118;100;15;3;3;0;103;0;17;24;39;23;15
14240.0;2022;70;NORMANDIE;MASCULIN;APPRENTISSAGE;BAC PROFESSIONNEL;BAC PRO PROD;BAC PRO AG 21210 COND GEST ENTR CANIN ET FELIN;2;2;2;0;0;0;0;2;0;0;2;0;0;0
14241.0;2022;70;NORMANDIE;MASCULIN;APPRENTISSAGE;BAC PROFESSIONNEL;BAC PRO PROD;BAC PRO AG 21211 COND GEST ENTR HIPPIQUE;23;23;18;5;0;0;0;18;0;0;3;4;11;5
14249.0;2022;70;NORMANDIE;MASCULIN;APPRENTISSAGE;BAC PROFESSIONNEL;BAC PRO SERV;BAC PRO 32207 REAL.PR.IMPR.PLURI.OPTA.PR.GRAPH.;4;4;4;0;0;0;0;4;0;0;3;1;0;0
14250.0;2022;70;NORMANDIE;MASCULIN;APPRENTISSAGE;BAC PROFESSIONNEL;BAC PRO SERV;BAC PRO 32208 REAL.PR.IMPR.PLURI.OPTB.PR.IMPR.;5;5;3;1;1;1;0;4;0;0;1;0;3;1
14254.0;2022;70;NORMANDIE;MASCULIN;ENSEIGNEMENT A DISTANCE;BAC GENERAL;BAC GENERAL;BAC GENE 10019 BAC GENERAL;24;24;11;11;2;0;2;11;1;1;3;3;3;13
14257.0;2022;70;NORMANDIE;MASCULIN;ENSEIGNEMENT A DISTANCE;BAC PROFESSIONNEL;BAC PRO SERV;BAC PRO 31214 MET.COM.VEN.OP.B PR.CL.VA.OF.COM.;1;0;0;0;0;0;0;0;0;0;0;0;0;0
14258.0;2022;70;NORMANDIE;MASCULIN;ENSEIGNEMENT A DISTANCE;BAC TECHNOLOGIQUE;BAC STMG;BAC STMG GESTION ET FINANCE;2;2;1;0;1;0;1;1;0;0;0;1;0;1
14263.0;2022;70;NORMANDIE;MASCULIN;FORMATION CONTINUE;BAC PROFESSIONNEL;BAC PRO PROD;BAC PRO 20102 PILOTE DE LIGNE DE PRODUCTION;9;8;8;0;0;0;0;8;0;0;6;1;1;0
14264.0;2022;70;NORMANDIE;MASCULIN;FORMATION CONTINUE;BAC PROFESSIONNEL;BAC PRO PROD;BAC PRO 22003 BIO-INDUSTRIES DE TRANSFORMATION;2;2;2;0;0;0;0;2;0;0;2;0;0;0
14279.0;2022;70;NORMANDIE;MASCULIN;FORMATION CONTINUE;BAC PROFESSIONNEL;BAC PRO SERV;BAC PRO 30001 GESTION-ADMINISTRATION;7;7;6;1;0;0;0;6;0;3;2;1;0;1
14281.0;2022;70;NORMANDIE;MASCULIN;FORMATION CONTINUE;BAC PROFESSIONNEL;BAC PRO SERV;BAC PRO 32207 REAL.PR.IMPR.PLURI.OPTA.PR.GRAPH.;7;6;2;4;0;0;0;2;0;0;1;0;1;4
14282.0;2022;70;NORMANDIE;MASCULIN;FORMATION CONTINUE;BAC PROFESSIONNEL;BAC PRO SERV;BAC PRO 34303 GEST. POLLUTIONS PROTEC. ENVIRON.;4;4;4;0;0;0;0;4;0;0;1;1;2;0
14290.0;2022;70;NORMANDIE;MASCULIN;INDIVIDUEL;BAC PROFESSIONNEL;BAC PRO PROD;BAC PRO 25106 TECHNICIEN D'USINAGE;2;1;1;0;0;0;0;1;0;0;0;0;1;0
14292.0;2022;70;NORMANDIE;MASCULIN;INDIVIDUEL;BAC PROFESSIONNEL;BAC PRO PROD;BAC PRO 25215 MAINT.VEHIC.OPTB VEHIC.TRANS.ROUT;1;1;0;1;0;0;0;0;0;0;0;0;0;1
14294.0;2022;70;NORMANDIE;MASCULIN;INDIVIDUEL;BAC PROFESSIONNEL;BAC PRO PROD;BAC PRO 25510 METIERS ELECT. ENVIRON. CONNECTES;4;2;1;1;0;0;0;1;0;0;0;0;1;1
14297.0;2022;70;NORMANDIE;MASCULIN;INDIVIDUEL;BAC PROFESSIONNEL;BAC PRO PROD;BAC PRO AG 21203 TECHN CONSEIL DE VENTE ANIMAL;1;0;0;0;0;0;0;0;0;0;0;0;0;0
14298.0;2022;70;NORMANDIE;MASCULIN;INDIVIDUEL;BAC PROFESSIONNEL;BAC PRO PROD;BAC PRO AG 21210 COND GEST ENTR CANIN ET FELIN;1;1;0;1;0;0;0;0;0;0;0;0;0;1
14307.0;2022;70;NORMANDIE;MASCULIN;INDIVIDUEL;BAC TECHNOLOGIQUE;BAC STAV;BAC STAV AGRONOMIE ALIM ENV TERRITOI;1;0;0;0;0;0;0;0;0;0;0;0;0;0
14317.0;2022;70;NORMANDIE;MASCULIN;SCOLAIRE;BAC PROFESSIONNEL;BAC PRO PROD;BACPRO 20002 ETUD.DEFINITION PRDTS INDUSTRIEL;42;42;28;13;1;0;1;28;0;3;3;14;8;14
14318.0;2022;70;NORMANDIE;MASCULIN;SCOLAIRE;BAC PROFESSIONNEL;BAC PRO PROD;BAC PRO 20102 PILOTE DE LIGNE DE PRODUCTION;11;11;7;3;1;0;1;7;0;0;1;4;2;4
14322.0;2022;70;NORMANDIE;MASCULIN;SCOLAIRE;BAC PROFESSIONNEL;BAC PRO PROD;BAC PRO 22106 CUISINE;140;140;122;13;5;4;1;126;0;11;20;41;54;14
14325.0;2022;70;NORMANDIE;MASCULIN;SCOLAIRE;BAC PROFESSIONNEL;BAC PRO PROD;BAC PRO 22703 TECHN.INSTALL.SYST.ENERG.CLIMATI;32;32;17;15;0;0;0;17;0;0;6;4;7;15
14332.0;2022;70;NORMANDIE;MASCULIN;SCOLAIRE;BAC PROFESSIONNEL;BAC PRO PROD;BAC PRO 23203 TECHNICIEN BAT. : ORG.REAL.GROS O;46;46;31;11;4;4;0;35;0;1;8;11;15;11
14337.0;2022;70;NORMANDIE;MASCULIN;SCOLAIRE;BAC PROFESSIONNEL;BAC PRO PROD;BAC PRO 23405 TECHNICIEN MENUISIER AGENCEUR;80;78;57;19;2;2;0;59;0;1;10;25;23;19
14345.0;2022;70;NORMANDIE;MASCULIN;SCOLAIRE;BAC PROFESSIONNEL;BAC PRO PROD;BAC PRO 25007 MAINTENANCE EQUIPEMENTS INDUST.;346;346;247;90;9;8;1;255;0;8;40;107;100;91
14350.0;2022;70;NORMANDIE;MASCULIN;SCOLAIRE;BAC PROFESSIONNEL;BAC PRO PROD;BAC PRO 25215 MAINT.VEHIC.OPTB VEHIC.TRANS.ROUT;36;36;28;4;4;4;0;32;0;1;7;11;13;4
14352.0;2022;70;NORMANDIE;MASCULIN;SCOLAIRE;BAC PROFESSIONNEL;BAC PRO PROD;BAC PRO 25219 MAINT.MATERIELS OPT.A AGRICOLES;72;72;63;5;4;3;1;66;0;8;13;23;22;6
14357.0;2022;70;NORMANDIE;MASCULIN;SCOLAIRE;BAC PROFESSIONNEL;BAC PRO PROD;BAC PRO 25408 REPARATION DES CARROSSERIES;60;60;40;14;6;6;0;46;0;1;6;16;23;14
14361.0;2022;70;NORMANDIE;MASCULIN;SCOLAIRE;BAC PROFESSIONNEL;BAC PRO PROD;BAC PRO 25513 SYST.NUM.OPT.A SURETE SECURITE;69;69;53;11;5;5;0;58;0;5;16;15;22;11
14362.0;2022;70;NORMANDIE;MASCULIN;SCOLAIRE;BAC PROFESSIONNEL;BAC PRO PROD;BAC PRO 25514 SYST.NUM.OPT.B AUD.RES.EQUIP.DOM.;60;60;49;9;2;2;0;51;0;2;18;11;20;9
14365.0;2022;70;NORMANDIE;MASCULIN;SCOLAIRE;BAC PROFESSIONNEL;BAC PRO PROD;BAC PRO AG 21004 CGEA;227;223;176;47;0;0;0;176;0;3;17;50;106;47
14368.0;2022;70;NORMANDIE;MASCULIN;SCOLAIRE;BAC PROFESSIONNEL;BAC PRO PROD;BAC PRO AG 21204 PROD-AQUACOLES;2;2;2;0;0;0;0;2;0;0;0;1;1;0
14384.0;2022;70;NORMANDIE;MASCULIN;SCOLAIRE;BAC PROFESSIONNEL;BAC PRO SERV;BAC PRO 32207 REAL.PR.IMPR.PLURI.OPTA.PR.GRAPH.;19;18;17;1;0;0;0;17;0;0;11;5;1;1
14389.0;2022;70;NORMANDIE;MASCULIN;SCOLAIRE;BAC PROFESSIONNEL;BAC PRO SERV;BAC PRO 33003 ACC.SOINS-S.PERS. OPT.A DOMICILE;11;11;10;1;0;0;0;10;0;0;4;2;4;1
14393.0;2022;70;NORMANDIE;MASCULIN;SCOLAIRE;BAC PROFESSIONNEL;BAC PRO SERV;BAC PRO 33403 COMMERC. SERVICES EN RESTAURATION;88;88;64;24;0;0;0;64;0;4;3;23;34;24
14397.0;2022;70;NORMANDIE;MASCULIN;SCOLAIRE;BAC PROFESSIONNEL;BAC PRO SERV;BAC PRO 34403 METIERS DE LA SECURITE;81;81;75;5;1;0;1;75;0;4;16;28;27;6
14403.0;2022;70;NORMANDIE;MASCULIN;SCOLAIRE;BAC TECHNOLOGIQUE;BAC STD2A;BAC STD2A SCIENCES & TECHNO. DESIGN-ARTS APPLIQUES;22;22;19;1;2;2;0;21;0;1;4;10;6;1
14407.0;2022;70;NORMANDIE;MASCULIN;SCOLAIRE;BAC TECHNOLOGIQUE;BAC STI2D;BAC STI2D INNOVATION TECHNO.  ET ECO CONCEPTION;458;458;367;18;73;53;20;420;0;5;44;135;236;38
14408.0;2022;70;NORMANDIE;MASCULIN;SCOLAIRE;BAC TECHNOLOGIQUE;BAC STI2D;BAC STI2D SYSTÈME D'INFORMATION  ET NUMERIQUE;417;417;341;12;64;47;17;388;0;6;53;121;208;29
14413.0;2022;70;NORMANDIE;MASCULIN;SCOLAIRE;BAC TECHNOLOGIQUE;BAC STMG;BAC STMG RESSOURCES HUMAINES ET COMMUNICATION;346;346;223;37;86;57;29;280;0;0;17;72;191;66
14416.0;2022;18;ORLEANS-TOURS;FEMININ;APPRENTISSAGE;BAC PROFESSIONNEL;BAC PRO PROD;BAC PRO 22503 PLASTIQUES ET COMPOSITES;1;1;1;0;0;0;0;1;0;0;0;1;0;0
14427.0;2022;18;ORLEANS-TOURS;FEMININ;APPRENTISSAGE;BAC PROFESSIONNEL;BAC PRO PROD;BAC PRO AG 21004 CGEA;10;10;9;1;0;0;0;9;0;0;1;2;6;1
14429.0;2022;18;ORLEANS-TOURS;FEMININ;APPRENTISSAGE;BAC PROFESSIONNEL;BAC PRO PROD;BAC PRO AG 21203 TECHN CONSEIL DE VENTE ANIMAL;5;5;5;0;0;0;0;5;0;0;1;2;2;0
14434.0;2022;18;ORLEANS-TOURS;FEMININ;APPRENTISSAGE;BAC PROFESSIONNEL;BAC PRO PROD;BAC PRO AG 22107 TEC CONS VTE ALIMENTATION P.ALIM;3;3;1;2;0;0;0;1;0;0;0;0;1;2
14438.0;2022;18;ORLEANS-TOURS;FEMININ;APPRENTISSAGE;BAC PROFESSIONNEL;BAC PRO SERV;BAC PRO 31213 MET.COM.VEN.OP.A ANI.GES.ESP.COM.;90;87;62;18;7;2;5;64;0;2;10;19;33;23
14443.0;2022;18;ORLEANS-TOURS;FEMININ;APPRENTISSAGE;BAC PROFESSIONNEL;BAC PRO SERV;BAC PRO 34304 HYGIENE PROPRETE STERILISATION;7;7;7;0;0;0;0;7;0;1;2;4;0;0
14445.0;2022;18;ORLEANS-TOURS;FEMININ;APPRENTISSAGE;BAC PROFESSIONNEL;BAC PRO SERV;BAC PRO AG 33002 SERV PERS TERRIT;8;8;6;2;0;0;0;6;0;0;2;1;3;2
14461.0;2022;18;ORLEANS-TOURS;FEMININ;INDIVIDUEL;BAC GENERAL;BAC GENERAL;BAC GENE 10019 BAC GENERAL;58;37;8;13;16;8;8;16;0;1;0;3;12;21
14475.0;2022;18;ORLEANS-TOURS;FEMININ;INDIVIDUEL;BAC TECHNOLOGIQUE;BAC STD2A;BAC STD2A SCIENCES & TECHNO. DESIGN-ARTS APPLIQUES;1;1;0;0;1;1;0;1;0;0;0;0;1;0
14479.0;2022;18;ORLEANS-TOURS;FEMININ;INDIVIDUEL;BAC TECHNOLOGIQUE;BAC STMG;BAC STMG GESTION ET FINANCE;2;2;1;1;0;0;0;1;0;0;0;0;1;1
14480.0;2022;18;ORLEANS-TOURS;FEMININ;INDIVIDUEL;BAC TECHNOLOGIQUE;BAC STMG;BAC STMG MERCATIQUE (MARKETING);6;3;0;2;1;0;1;0;0;0;0;0;0;3
14491.0;2022;18;ORLEANS-TOURS;FEMININ;SCOLAIRE;BAC PROFESSIONNEL;BAC PRO PROD;BAC PRO 22503 PLASTIQUES ET COMPOSITES;2;2;2;0;0;0;0;2;0;0;0;1;1;0
14499.0;2022;18;ORLEANS-TOURS;FEMININ;SCOLAIRE;BAC PROFESSIONNEL;BAC PRO PROD;BAC PRO 23304 AMENAGEMENT FINITION BATIMENT;16;16;11;3;2;2;0;13;0;0;1;6;6;3
14501.0;2022;18;ORLEANS-TOURS;FEMININ;SCOLAIRE;BAC PROFESSIONNEL;BAC PRO PROD;BAC PRO 23408 Etude et réalisation d'agencement;17;17;14;3;0;0;0;14;0;0;3;7;4;3
14506.0;2022;18;ORLEANS-TOURS;FEMININ;SCOLAIRE;BAC PROFESSIONNEL;BAC PRO PROD;BAC PRO 25007 MAINTENANCE EQUIPEMENTS INDUST.;9;9;5;2;2;2;0;7;0;0;2;3;2;2
14511.0;2022;18;ORLEANS-TOURS;FEMININ;SCOLAIRE;BAC PROFESSIONNEL;BAC PRO PROD;BAC PRO 25406 OUVRAGES DU BATIMENT METALLERIE;1;1;1;0;0;0;0;1;0;0;0;1;0;0
14516.0;2022;18;ORLEANS-TOURS;FEMININ;SCOLAIRE;BAC PROFESSIONNEL;BAC PRO PROD;BAC PRO 25514 SYST.NUM.OPT.B AUD.RES.EQUIP.DOM.;2;2;1;1;0;0;0;1;0;0;1;0;0;1
14525.0;2022;18;ORLEANS-TOURS;FEMININ;SCOLAIRE;BAC PROFESSIONNEL;BAC PRO PROD;BAC PRO AG 21303 FORET;1;1;1;0;0;0;0;1;0;0;0;0;1;0
14528.0;2022;18;ORLEANS-TOURS;FEMININ;SCOLAIRE;BAC PROFESSIONNEL;BAC PRO PROD;BAC PRO AG 22105 LABORATOIRE CONTROLE QUALITE;5;5;3;2;0;0;0;3;0;0;0;1;2;2
14535.0;2022;18;ORLEANS-TOURS;FEMININ;SCOLAIRE;BAC PROFESSIONNEL;BAC PRO SERV;BAC PRO 31212 METIERS DE L'ACCUEIL;211;211;169;24;18;10;8;179;0;7;25;65;82;32
14540.0;2022;18;ORLEANS-TOURS;FEMININ;SCOLAIRE;BAC PROFESSIONNEL;BAC PRO SERV;BAC PRO 32303 ART.& MET.ART:COM.VIS.VIS.PLURI-M;16;16;15;1;0;0;0;15;0;4;6;4;1;1
14547.0;2022;18;ORLEANS-TOURS;FEMININ;SCOLAIRE;BAC PROFESSIONNEL;BAC PRO SERV;BAC PRO 33603 ESTHETIQUE COSMETIQUE PARFUMERIE;121;121;105;15;1;1;0;106;0;4;20;48;34;15
14549.0;2022;18;ORLEANS-TOURS;FEMININ;SCOLAIRE;BAC PROFESSIONNEL;BAC PRO SERV;BAC PRO 34403 METIERS DE LA SECURITE;28;28;28;0;0;0;0;28;0;3;14;5;6;0
14551.0;2022;18;ORLEANS-TOURS;FEMININ;SCOLAIRE;BAC TECHNOLOGIQUE;BAC S2TMD;BAC S2TMD DANSE;8;8;8;0;0;0;0;8;0;3;3;1;1;0
14567.0;2022;18;ORLEANS-TOURS;MASCULIN;APPRENTISSAGE;BAC PROFESSIONNEL;BAC PRO PROD;BAC PRO 22104 BOUCHER CHARCUTIER TRAITEUR;2;2;2;0;0;0;0;2;0;0;0;1;1;0
14568.0;2022;18;ORLEANS-TOURS;MASCULIN;APPRENTISSAGE;BAC PROFESSIONNEL;BAC PRO PROD;BAC PRO 22106 CUISINE;5;5;3;1;1;1;0;4;0;0;0;3;1;1
14569.0;2022;18;ORLEANS-TOURS;MASCULIN;APPRENTISSAGE;BAC PROFESSIONNEL;BAC PRO PROD;BAC PRO 22703 TECHN.INSTALL.SYST.ENERG.CLIMATI;3;3;2;1;0;0;0;2;0;0;0;1;1;1
14570.0;2022;18;ORLEANS-TOURS;MASCULIN;APPRENTISSAGE;BAC PROFESSIONNEL;BAC PRO PROD;BAC PRO 22704 TECHN. MAINT. SYST.ENERG.CLIMATI;7;7;6;1;0;0;0;6;0;0;0;4;2;1
14576.0;2022;18;ORLEANS-TOURS;MASCULIN;APPRENTISSAGE;BAC PROFESSIONNEL;BAC PRO PROD;BAC PRO 23404 TECHNICIEN CONSTRUCTEUR BOIS;1;1;1;0;0;0;0;1;0;0;1;0;0;0
14577.0;2022;18;ORLEANS-TOURS;MASCULIN;APPRENTISSAGE;BAC PROFESSIONNEL;BAC PRO PROD;BAC PRO 23405 TECHNICIEN MENUISIER AGENCEUR;9;9;6;1;2;2;0;8;0;0;1;5;2;1
14590.0;2022;18;ORLEANS-TOURS;MASCULIN;APPRENTISSAGE;BAC PROFESSIONNEL;BAC PRO PROD;BAC PRO 25509 TECHNIC. FROID CONDITIONNEMT AIR;14;14;10;3;1;1;0;11;0;2;4;3;2;3
14594.0;2022;18;ORLEANS-TOURS;MASCULIN;APPRENTISSAGE;BAC PROFESSIONNEL;BAC PRO PROD;BAC PRO 25515 SYST.NUM.OPT.C RES.INF.SYST.COMM.;22;22;21;1;0;0;0;21;0;1;10;6;4;1
14599.0;2022;18;ORLEANS-TOURS;MASCULIN;APPRENTISSAGE;BAC PROFESSIONNEL;BAC PRO PROD;BAC PRO AG 21211 COND GEST ENTR HIPPIQUE;1;1;1;0;0;0;0;1;0;0;0;0;1;0
14603.0;2022;18;ORLEANS-TOURS;MASCULIN;APPRENTISSAGE;BAC PROFESSIONNEL;BAC PRO PROD;BAC PRO AG 22107 TEC CONS VTE ALIMENTATION P.ALIM;3;3;3;0;0;0;0;3;0;0;0;2;1;0
14605.0;2022;18;ORLEANS-TOURS;MASCULIN;APPRENTISSAGE;BAC PROFESSIONNEL;BAC PRO SERV;BAC PRO 31106 LOGISTIQUE;26;26;14;7;5;3;2;17;0;0;1;8;8;9
14610.0;2022;18;ORLEANS-TOURS;MASCULIN;APPRENTISSAGE;BAC PROFESSIONNEL;BAC PRO SERV;BAC PRO 32208 REAL.PR.IMPR.PLURI.OPTB.PR.IMPR.;5;5;4;0;1;0;1;4;0;0;1;2;1;1
14613.0;2022;18;ORLEANS-TOURS;MASCULIN;APPRENTISSAGE;BAC PROFESSIONNEL;BAC PRO SERV;BAC PRO 34304 HYGIENE PROPRETE STERILISATION;7;7;4;3;0;0;0;4;0;0;1;1;2;3
14614.0;2022;18;ORLEANS-TOURS;MASCULIN;APPRENTISSAGE;BAC PROFESSIONNEL;BAC PRO SERV;BAC PRO 34403 METIERS DE LA SECURITE;1;1;1;0;0;0;0;1;0;0;0;0;1;0
14616.0;2022;18;ORLEANS-TOURS;MASCULIN;ENSEIGNEMENT A DISTANCE;BAC GENERAL;BAC GENERAL;BAC GENE 10019 BAC GENERAL;13;12;7;3;2;1;1;8;1;1;1;0;5;4
14621.0;2022;18;ORLEANS-TOURS;MASCULIN;FORMATION CONTINUE;BAC PROFESSIONNEL;BAC PRO PROD;BAC PRO 23102 TRAVAUX PUBLICS;1;1;1;0;0;0;0;1;0;0;1;0;0;0
14622.0;2022;18;ORLEANS-TOURS;MASCULIN;FORMATION CONTINUE;BAC PROFESSIONNEL;BAC PRO PROD;BAC PRO 24301 METIERS DU CUIR : CHAUSSURES;1;0;0;0;0;0;0;0;0;0;0;0;0;0
14627.0;2022;18;ORLEANS-TOURS;MASCULIN;FORMATION CONTINUE;BAC PROFESSIONNEL;BAC PRO PROD;BAC PRO 25411 TECH.CHAUDRONNERIE INDUSTRIELLE;1;1;1;0;0;0;0;1;0;0;0;1;0;0
14631.0;2022;18;ORLEANS-TOURS;MASCULIN;FORMATION CONTINUE;BAC PROFESSIONNEL;BAC PRO SERV;BAC PRO 31214 MET.COM.VEN.OP.B PR.CL.VA.OF.COM.;5;4;3;1;0;0;0;3;0;0;1;0;2;1
14634.0;2022;18;ORLEANS-TOURS;MASCULIN;INDIVIDUEL;BAC PROFESSIONNEL;BAC PRO PROD;BAC PRO 20102 PILOTE DE LIGNE DE PRODUCTION;1;1;1;0;0;0;0;1;0;0;1;0;0;0
14635.0;2022;18;ORLEANS-TOURS;MASCULIN;INDIVIDUEL;BAC PROFESSIONNEL;BAC PRO PROD;BAC PRO 22106 CUISINE;2;2;0;2;0;0;0;0;0;0;0;0;0;2
14639.0;2022;18;ORLEANS-TOURS;MASCULIN;INDIVIDUEL;BAC PROFESSIONNEL;BAC PRO PROD;BAC PRO 25510 METIERS ELECT. ENVIRON. CONNECTES;2;2;0;2;0;0;0;0;0;0;0;0;0;2
14641.0;2022;18;ORLEANS-TOURS;MASCULIN;INDIVIDUEL;BAC PROFESSIONNEL;BAC PRO PROD;BAC PRO AG 21004 CGEA;12;8;7;1;0;0;0;7;0;0;0;0;7;1
14649.0;2022;18;ORLEANS-TOURS;MASCULIN;INDIVIDUEL;BAC PROFESSIONNEL;BAC PRO SERV;BAC PRO 31214 MET.COM.VEN.OP.B PR.CL.VA.OF.COM.;1;1;0;1;0;0;0;0;0;0;0;0;0;1
14654.0;2022;18;ORLEANS-TOURS;MASCULIN;INDIVIDUEL;BAC TECHNOLOGIQUE;BAC STI2D;BAC STI2D ENERGIES  ET ENVIRONNEMENT;1;1;0;0;1;0;1;0;0;0;0;0;0;1
14656.0;2022;18;ORLEANS-TOURS;MASCULIN;INDIVIDUEL;BAC TECHNOLOGIQUE;BAC STL;BAC STL SCIENCES PHYSIQUES CHIMIQUES  EN LABORAT.;1;1;0;0;1;0;1;0;0;0;0;0;0;1
14660.0;2022;18;ORLEANS-TOURS;MASCULIN;INDIVIDUEL;BAC TECHNOLOGIQUE;BAC STMG;BAC STMG SYSTEMES D'INFORMATION DE GESTION;1;1;1;0;0;0;0;1;0;0;0;0;1;0
14667.0;2022;18;ORLEANS-TOURS;MASCULIN;SCOLAIRE;BAC PROFESSIONNEL;BAC PRO PROD;BAC PRO 22303 FONDERIE;4;4;2;1;1;1;0;3;0;1;0;1;1;1
14691.0;2022;18;ORLEANS-TOURS;MASCULIN;SCOLAIRE;BAC PROFESSIONNEL;BAC PRO PROD;BAC PRO 25106 TECHNICIEN D'USINAGE;86;86;54;28;4;3;1;57;0;4;12;17;24;29
14692.0;2022;18;ORLEANS-TOURS;MASCULIN;SCOLAIRE;BAC PROFESSIONNEL;BAC PRO PROD;BAC PRO 25107 TECHNICIEN OUTILLEUR;10;10;8;2;0;0;0;8;0;1;2;3;2;2
14693.0;2022;18;ORLEANS-TOURS;MASCULIN;SCOLAIRE;BAC PROFESSIONNEL;BAC PRO PROD;BAC PRO 25108 TECHNICIEN MODELEUR;12;12;11;1;0;0;0;11;0;1;6;3;1;1
14695.0;2022;18;ORLEANS-TOURS;MASCULIN;SCOLAIRE;BAC PROFESSIONNEL;BAC PRO PROD;BAC PRO 25215 MAINT.VEHIC.OPTB VEHIC.TRANS.ROUT;19;19;12;7;0;0;0;12;0;0;5;3;4;7
14699.0;2022;18;ORLEANS-TOURS;MASCULIN;SCOLAIRE;BAC PROFESSIONNEL;BAC PRO PROD;BAC PRO 25221 MAINT.MATERIELS OPT.C ESP. VERTS;7;7;3;2;2;1;1;4;0;0;0;1;3;3
14702.0;2022;18;ORLEANS-TOURS;MASCULIN;SCOLAIRE;BAC PROFESSIONNEL;BAC PRO PROD;BAC PRO 25410 CONSTRUCTION DES CARROSSERIES;5;5;3;2;0;0;0;3;0;0;0;1;2;2
14706.0;2022;18;ORLEANS-TOURS;MASCULIN;SCOLAIRE;BAC PROFESSIONNEL;BAC PRO PROD;BAC PRO 25513 SYST.NUM.OPT.A SURETE SECURITE;30;30;26;2;2;2;0;28;0;1;6;10;11;2
14714.0;2022;18;ORLEANS-TOURS;MASCULIN;SCOLAIRE;BAC PROFESSIONNEL;BAC PRO PROD;BAC PRO AG 21211 COND GEST ENTR HIPPIQUE;7;7;5;2;0;0;0;5;0;0;0;3;2;2
14715.0;2022;18;ORLEANS-TOURS;MASCULIN;SCOLAIRE;BAC PROFESSIONNEL;BAC PRO PROD;BAC PRO AG 21212 TECH EXPE ANIMALE;9;9;8;1;0;0;0;8;0;0;3;2;3;1
14718.0;2022;18;ORLEANS-TOURS;MASCULIN;SCOLAIRE;BAC PROFESSIONNEL;BAC PRO PROD;BAC PRO AG 21405 AMENAGEMENTS PAYSAGERS;45;44;40;4;0;0;0;40;0;0;4;14;22;4
14721.0;2022;18;ORLEANS-TOURS;MASCULIN;SCOLAIRE;BAC PROFESSIONNEL;BAC PRO PROD;BAC PRO AG 22106 TEC CONS VTE ALIMENTATION VINS SP;3;3;2;1;0;0;0;2;0;0;0;0;2;1
14724.0;2022;18;ORLEANS-TOURS;MASCULIN;SCOLAIRE;BAC PROFESSIONNEL;BAC PRO SERV;BAC PRO 31106 LOGISTIQUE;118;118;75;35;8;6;2;81;0;2;22;19;38;37
14725.0;2022;18;ORLEANS-TOURS;MASCULIN;SCOLAIRE;BAC PROFESSIONNEL;BAC PRO SERV;BAC PRO 31107 CONDUCT. TRANSP.ROUT.MARCHANDISES;54;54;50;4;0;0;0;50;0;2;16;26;6;4
14726.0;2022;18;ORLEANS-TOURS;MASCULIN;SCOLAIRE;BAC PROFESSIONNEL;BAC PRO SERV;BAC PRO 31108 TRANSPORT;25;25;16;8;1;1;0;17;0;1;2;6;8;8
14727.0;2022;18;ORLEANS-TOURS;MASCULIN;SCOLAIRE;BAC PROFESSIONNEL;BAC PRO SERV;BAC PRO 31212 METIERS DE L'ACCUEIL;90;90;73;14;3;2;1;75;0;1;10;33;31;15
14731.0;2022;18;ORLEANS-TOURS;MASCULIN;SCOLAIRE;BAC PROFESSIONNEL;BAC PRO SERV;BAC PRO 32208 REAL.PR.IMPR.PLURI.OPTB.PR.IMPR.;15;15;12;3;0;0;0;12;0;0;1;4;7;3
14738.0;2022;18;ORLEANS-TOURS;MASCULIN;SCOLAIRE;BAC PROFESSIONNEL;BAC PRO SERV;BAC PRO 33403 COMMERC. SERVICES EN RESTAURATION;78;78;60;15;3;2;1;62;0;4;17;20;21;16
14743.0;2022;18;ORLEANS-TOURS;MASCULIN;SCOLAIRE;BAC TECHNOLOGIQUE;BAC S2TMD;BAC S2TMD DANSE;3;3;3;0;0;0;0;3;0;0;1;1;1;0
14746.0;2022;18;ORLEANS-TOURS;MASCULIN;SCOLAIRE;BAC TECHNOLOGIQUE;BAC STAV;BAC STAV AGRONOMIE ALIM ENV TERRITOI;132;132;132;0;0;0;0;132;0;3;19;50;60;0
14747.0;2022;18;ORLEANS-TOURS;MASCULIN;SCOLAIRE;BAC TECHNOLOGIQUE;BAC STD2A;BAC STD2A SCIENCES & TECHNO. DESIGN-ARTS APPLIQUES;58;58;56;0;2;2;0;58;0;2;12;26;18;0
14750.0;2022;18;ORLEANS-TOURS;MASCULIN;SCOLAIRE;BAC TECHNOLOGIQUE;BAC STI2D;BAC STI2D ENERGIES  ET ENVIRONNEMENT;159;159;135;7;17;11;6;146;0;5;17;48;76;13
14754.0;2022;18;ORLEANS-TOURS;MASCULIN;SCOLAIRE;BAC TECHNOLOGIQUE;BAC STL;BAC STL SCIENCES PHYSIQUES CHIMIQUES  EN LABORAT.;50;50;48;0;2;2;0;50;0;5;5;14;26;0
14761.0;2022;01;PARIS;FEMININ;APPRENTISSAGE;BAC PROFESSIONNEL;BAC PRO PROD;BAC PRO 22106 CUISINE;32;32;29;2;1;1;0;30;0;4;10;8;8;2
14771.0;2022;01;PARIS;FEMININ;APPRENTISSAGE;BAC PROFESSIONNEL;BAC PRO SERV;BAC PRO 32207 REAL.PR.IMPR.PLURI.OPTA.PR.GRAPH.;3;3;3;0;0;0;0;3;0;0;1;1;1;0
14773.0;2022;01;PARIS;FEMININ;APPRENTISSAGE;BAC PROFESSIONNEL;BAC PRO SERV;BAC PRO 33003 ACC.SOINS-S.PERS. OPT.A DOMICILE;22;22;11;10;1;0;1;11;0;0;0;8;3;11
14777.0;2022;01;PARIS;FEMININ;APPRENTISSAGE;BAC PROFESSIONNEL;BAC PRO SERV;BAC PRO 34403 METIERS DE LA SECURITE;3;3;3;0;0;0;0;3;0;0;1;2;0;0
14782.0;2022;01;PARIS;FEMININ;ENSEIGNEMENT A DISTANCE;BAC PROFESSIONNEL;BAC PRO SERV;BAC PRO 33004 ACC.SOINS-S.PERS. OPT.EN STRUCTUR;2;1;0;1;0;0;0;0;0;0;0;0;0;1
14784.0;2022;01;PARIS;FEMININ;ENSEIGNEMENT A DISTANCE;BAC TECHNOLOGIQUE;BAC ST2S;BAC ST2S SCIENCES & TECHNO. SANTE & SOCIAL;3;3;2;1;0;0;0;2;0;0;0;0;2;1
14792.0;2022;01;PARIS;FEMININ;FORMATION CONTINUE;BAC PROFESSIONNEL;BAC PRO SERV;BAC PRO 30001 GESTION-ADMINISTRATION;27;22;15;5;2;2;0;17;0;0;3;7;7;5
14810.0;2022;01;PARIS;FEMININ;INDIVIDUEL;BAC PROFESSIONNEL;BAC PRO SERV;BAC PRO 33603 ESTHETIQUE COSMETIQUE PARFUMERIE;1;1;0;1;0;0;0;0;0;0;0;0;0;1
14812.0;2022;01;PARIS;FEMININ;INDIVIDUEL;BAC TECHNOLOGIQUE;BAC ST2S;BAC ST2S SCIENCES & TECHNO. SANTE & SOCIAL;4;0;0;0;0;0;0;0;0;0;0;0;0;0
14813.0;2022;01;PARIS;FEMININ;INDIVIDUEL;BAC TECHNOLOGIQUE;BAC STAV;BAC STAV AGRONOMIE ALIM ENV TERRITOI;2;1;1;0;0;0;0;1;0;0;0;0;1;0
14818.0;2022;01;PARIS;FEMININ;SCOLAIRE;BAC GENERAL;BAC GENERAL;BAC GENE 10019 BAC GENERAL;8438;8438;8109;90;239;171;68;8280;272;1887;2666;2147;1308;158
14823.0;2022;01;PARIS;FEMININ;SCOLAIRE;BAC PROFESSIONNEL;BAC PRO PROD;BAC PRO 22106 CUISINE;20;20;17;3;0;0;0;17;0;1;2;10;4;3
14834.0;2022;01;PARIS;FEMININ;SCOLAIRE;BAC PROFESSIONNEL;BAC PRO PROD;BAC PRO 24301 METIERS DU CUIR : CHAUSSURES;3;3;1;1;1;1;0;2;0;0;0;0;2;1
14836.0;2022;01;PARIS;FEMININ;SCOLAIRE;BAC PROFESSIONNEL;BAC PRO PROD;BAC PRO 25007 MAINTENANCE EQUIPEMENTS INDUST.;2;2;2;0;0;0;0;2;0;0;1;1;0;0
14838.0;2022;01;PARIS;FEMININ;SCOLAIRE;BAC PROFESSIONNEL;BAC PRO PROD;BAC PRO 25513 SYST.NUM.OPT.A SURETE SECURITE;1;1;1;0;0;0;0;1;0;0;0;1;0;0
14839.0;2022;01;PARIS;FEMININ;SCOLAIRE;BAC PROFESSIONNEL;BAC PRO PROD;BAC PRO 25514 SYST.NUM.OPT.B AUD.RES.EQUIP.DOM.;4;4;4;0;0;0;0;4;0;0;0;3;1;0
14851.0;2022;01;PARIS;FEMININ;SCOLAIRE;BAC PROFESSIONNEL;BAC PRO SERV;BAC PRO 32303 ART.& MET.ART:COM.VIS.VIS.PLURI-M;49;49;43;6;0;0;0;43;0;4;15;18;6;6
14857.0;2022;01;PARIS;FEMININ;SCOLAIRE;BAC PROFESSIONNEL;BAC PRO SERV;BAC PRO 33102 PROTHESE DENTAIRE;14;14;12;2;0;0;0;12;0;1;1;3;7;2
14859.0;2022;01;PARIS;FEMININ;SCOLAIRE;BAC PROFESSIONNEL;BAC PRO SERV;BAC PRO 33403 COMMERC. SERVICES EN RESTAURATION;30;28;27;1;0;0;0;27;0;3;5;7;12;1
14872.0;2022;01;PARIS;FEMININ;SCOLAIRE;BAC TECHNOLOGIQUE;BAC STI2D;BAC STI2D SYSTÈME D'INFORMATION  ET NUMERIQUE;20;20;16;0;4;2;2;18;0;0;5;7;6;2
14876.0;2022;01;PARIS;FEMININ;SCOLAIRE;BAC TECHNOLOGIQUE;BAC STMG;BAC STMG MERCATIQUE (MARKETING);386;386;353;9;24;16;8;369;1;15;71;155;127;17
14886.0;2022;01;PARIS;MASCULIN;APPRENTISSAGE;BAC PROFESSIONNEL;BAC PRO PROD;BAC PRO 24302 METIERS DU CUIR : MAROQUINERIE;1;1;1;0;0;0;0;1;0;0;1;0;0;0
14893.0;2022;01;PARIS;MASCULIN;APPRENTISSAGE;BAC PROFESSIONNEL;BAC PRO SERV;BAC PRO 31212 METIERS DE L'ACCUEIL;7;7;4;3;0;0;0;4;0;0;1;2;1;3
14898.0;2022;01;PARIS;MASCULIN;APPRENTISSAGE;BAC PROFESSIONNEL;BAC PRO SERV;BAC PRO 33101 OPTIQUE LUNETTERIE;20;18;11;5;2;1;1;12;0;0;3;4;5;6
14907.0;2022;01;PARIS;MASCULIN;FORMATION CONTINUE;BAC PROFESSIONNEL;BAC PRO PROD;BAC PRO 20102 PILOTE DE LIGNE DE PRODUCTION;1;1;1;0;0;0;0;1;0;0;1;0;0;0
14908.0;2022;01;PARIS;MASCULIN;FORMATION CONTINUE;BAC PROFESSIONNEL;BAC PRO PROD;BAC PRO 22704 TECHN. MAINT. SYST.ENERG.CLIMATI;6;6;4;2;0;0;0;4;0;2;0;2;0;2
14910.0;2022;01;PARIS;MASCULIN;FORMATION CONTINUE;BAC PROFESSIONNEL;BAC PRO PROD;BAC PRO 25007 MAINTENANCE EQUIPEMENTS INDUST.;12;11;11;0;0;0;0;11;0;1;3;4;3;0
14912.0;2022;01;PARIS;MASCULIN;FORMATION CONTINUE;BAC PROFESSIONNEL;BAC PRO PROD;BAC PRO 25509 TECHNIC. FROID CONDITIONNEMT AIR;8;8;7;1;0;0;0;7;0;2;0;4;1;1
14920.0;2022;01;PARIS;MASCULIN;INDIVIDUEL;BAC PROFESSIONNEL;BAC PRO PROD;BAC PRO 24203 METIERS DE LA MODE - VÊTEMENT;1;1;0;1;0;0;0;0;0;0;0;0;0;1
14939.0;2022;01;PARIS;MASCULIN;INDIVIDUEL;BAC TECHNOLOGIQUE;BAC STI2D;BAC STI2D INNOVATION TECHNO.  ET ECO CONCEPTION;1;1;0;1;0;0;0;0;0;0;0;0;0;1
14945.0;2022;01;PARIS;MASCULIN;INDIVIDUEL;BAC TECHNOLOGIQUE;BAC STMG;BAC STMG SYSTEMES D'INFORMATION DE GESTION;10;9;5;2;2;2;0;7;0;0;0;0;7;2
14948.0;2022;01;PARIS;MASCULIN;SCOLAIRE;BAC PROFESSIONNEL;BAC PRO PROD;BAC PRO 20102 PILOTE DE LIGNE DE PRODUCTION;5;5;4;0;1;1;0;5;0;0;2;1;2;0
14955.0;2022;01;PARIS;MASCULIN;SCOLAIRE;BAC PROFESSIONNEL;BAC PRO PROD;BAC PRO 22704 TECHN. MAINT. SYST.ENERG.CLIMATI;12;12;5;6;1;1;0;6;0;0;0;2;4;6
14956.0;2022;01;PARIS;MASCULIN;SCOLAIRE;BAC PROFESSIONNEL;BAC PRO PROD;BAC PRO 23003 ARTIS. & M.ART:MARCHANDISAGE VIS.;4;4;3;1;0;0;0;3;0;0;1;2;0;1
14960.0;2022;01;PARIS;MASCULIN;SCOLAIRE;BAC PROFESSIONNEL;BAC PRO PROD;BAC PRO 23203 TECHNICIEN BAT. : ORG.REAL.GROS O;4;4;2;2;0;0;0;2;0;0;0;1;1;2
14967.0;2022;01;PARIS;MASCULIN;SCOLAIRE;BAC PROFESSIONNEL;BAC PRO PROD;BAC PRO 24202 ARTIS.& MET.ART : TAPIS.D'AMEUBL;6;6;4;1;1;0;1;4;0;1;1;1;1;2
14977.0;2022;01;PARIS;MASCULIN;SCOLAIRE;BAC PROFESSIONNEL;BAC PRO PROD;BAC PRO 25406 OUVRAGES DU BATIMENT METALLERIE;12;12;9;3;0;0;0;9;0;0;1;5;3;3
14996.0;2022;01;PARIS;MASCULIN;SCOLAIRE;BAC PROFESSIONNEL;BAC PRO SERV;BAC PRO 32304 PHOTOGRAPHIE;21;21;15;6;0;0;0;15;0;3;2;5;5;6
14998.0;2022;01;PARIS;MASCULIN;SCOLAIRE;BAC PROFESSIONNEL;BAC PRO SERV;BAC PRO 33003 ACC.SOINS-S.PERS. OPT.A DOMICILE;1;1;1;0;0;0;0;1;0;0;0;0;1;0
15002.0;2022;01;PARIS;MASCULIN;SCOLAIRE;BAC PROFESSIONNEL;BAC PRO SERV;BAC PRO 33103 TECHNICIEN APPAREIL. ORTHOPEDIQUE;9;9;7;1;1;1;0;8;0;0;2;3;3;1
15015.0;2022;01;PARIS;MASCULIN;SCOLAIRE;BAC TECHNOLOGIQUE;BAC STI2D;BAC STI2D SYSTÈME D'INFORMATION  ET NUMERIQUE;289;289;242;12;35;21;14;263;0;18;41;103;101;26
15024.0;2022;13;POITIERS;FEMININ;APPRENTISSAGE;BAC PROFESSIONNEL;BAC PRO PROD;BAC PRO 23407 TECHNIC.FAB.BOIS ET MATERX ASSOC;1;1;1;0;0;0;0;1;0;0;0;1;0;0
15025.0;2022;13;POITIERS;FEMININ;APPRENTISSAGE;BAC PROFESSIONNEL;BAC PRO PROD;BAC PRO 25007 MAINTENANCE EQUIPEMENTS INDUST.;1;1;1;0;0;0;0;1;0;0;0;0;1;0
15026.0;2022;13;POITIERS;FEMININ;APPRENTISSAGE;BAC PROFESSIONNEL;BAC PRO PROD;BAC PRO 25106 TECHNICIEN D'USINAGE;1;1;1;0;0;0;0;1;0;0;1;0;0;0
15031.0;2022;13;POITIERS;FEMININ;APPRENTISSAGE;BAC PROFESSIONNEL;BAC PRO PROD;BAC PRO 25411 TECH.CHAUDRONNERIE INDUSTRIELLE;1;1;1;0;0;0;0;1;0;0;0;1;0;0
15038.0;2022;13;POITIERS;FEMININ;APPRENTISSAGE;BAC PROFESSIONNEL;BAC PRO PROD;BAC PRO AG 21405 AMENAGEMENTS PAYSAGERS;4;3;3;0;0;0;0;3;0;0;0;1;2;0
15043.0;2022;13;POITIERS;FEMININ;APPRENTISSAGE;BAC PROFESSIONNEL;BAC PRO SERV;BAC PRO 32207 REAL.PR.IMPR.PLURI.OPTA.PR.GRAPH.;1;1;1;0;0;0;0;1;0;0;0;1;0;0
15047.0;2022;13;POITIERS;FEMININ;APPRENTISSAGE;BAC PROFESSIONNEL;BAC PRO SERV;BAC PRO 33403 COMMERC. SERVICES EN RESTAURATION;14;13;12;1;0;0;0;12;0;0;2;7;3;1
15057.0;2022;13;POITIERS;FEMININ;ENSEIGNEMENT A DISTANCE;BAC TECHNOLOGIQUE;BAC ST2S;BAC ST2S SCIENCES & TECHNO. SANTE & SOCIAL;1;1;0;0;1;0;1;0;0;0;0;0;0;1
15065.0;2022;13;POITIERS;FEMININ;INDIVIDUEL;BAC GENERAL;BAC GENERAL;BAC GENE 10019 BAC GENERAL;44;32;19;7;6;3;3;22;0;2;5;5;10;10
15071.0;2022;13;POITIERS;FEMININ;INDIVIDUEL;BAC PROFESSIONNEL;BAC PRO SERV;BAC PRO 30001 GESTION-ADMINISTRATION;1;0;0;0;0;0;0;0;0;0;0;0;0;0
15078.0;2022;13;POITIERS;FEMININ;INDIVIDUEL;BAC TECHNOLOGIQUE;BAC ST2S;BAC ST2S SCIENCES & TECHNO. SANTE & SOCIAL;16;14;6;2;6;4;2;10;0;0;1;0;9;4
15081.0;2022;13;POITIERS;FEMININ;INDIVIDUEL;BAC TECHNOLOGIQUE;BAC STMG;BAC STMG RESSOURCES HUMAINES ET COMMUNICATION;4;2;0;1;1;1;0;1;0;0;0;0;1;1
15083.0;2022;13;POITIERS;FEMININ;SCOLAIRE;BAC GENERAL;BAC GENERAL;BAC GENE 10019 BAC GENERAL;5142;5142;4805;50;287;203;84;5008;104;682;1259;1575;1388;134
15085.0;2022;13;POITIERS;FEMININ;SCOLAIRE;BAC PROFESSIONNEL;BAC PRO PROD;BAC PRO 20102 PILOTE DE LIGNE DE PRODUCTION;1;1;1;0;0;0;0;1;0;0;0;1;0;0
15093.0;2022;13;POITIERS;FEMININ;SCOLAIRE;BAC PROFESSIONNEL;BAC PRO PROD;BAC PRO 23005 TECHN. ETUDES BAT B ASSIST.ARCHI.;16;16;14;2;0;0;0;14;0;0;4;7;3;2
15095.0;2022;13;POITIERS;FEMININ;SCOLAIRE;BAC PROFESSIONNEL;BAC PRO PROD;BACPRO 23103 TECHNICIEN GEOMETRE-TOPOGRAPHE;3;3;3;0;0;0;0;3;0;0;0;2;1;0
15106.0;2022;13;POITIERS;FEMININ;SCOLAIRE;BAC PROFESSIONNEL;BAC PRO PROD;BAC PRO 25302 AERONAUTIQUE OPTION AVIONIQUE;7;7;7;0;0;0;0;7;0;0;4;3;0;0
15107.0;2022;13;POITIERS;FEMININ;SCOLAIRE;BAC PROFESSIONNEL;BAC PRO PROD;BAC PRO 25303 AERONAUTIQUE OPTION SYSTEMES;5;5;5;0;0;0;0;5;0;1;1;3;0;0
15109.0;2022;13;POITIERS;FEMININ;SCOLAIRE;BAC PROFESSIONNEL;BAC PRO PROD;BAC PRO 25408 REPARATION DES CARROSSERIES;1;1;1;0;0;0;0;1;0;0;0;0;1;0
15112.0;2022;13;POITIERS;FEMININ;SCOLAIRE;BAC PROFESSIONNEL;BAC PRO PROD;BAC PRO 25515 SYST.NUM.OPT.C RES.INF.SYST.COMM.;1;1;1;0;0;0;0;1;0;0;0;1;0;0
15113.0;2022;13;POITIERS;FEMININ;SCOLAIRE;BAC PROFESSIONNEL;BAC PRO PROD;BAC PRO AG 21004 CGEA;77;74;58;16;0;0;0;58;0;1;10;16;31;16
15123.0;2022;13;POITIERS;FEMININ;SCOLAIRE;BAC PROFESSIONNEL;BAC PRO PROD;BAC PRO AG 21407 TEC CONS VTE UNIVERS JARDINERIE;21;21;20;1;0;0;0;20;0;0;0;3;17;1
15130.0;2022;13;POITIERS;FEMININ;SCOLAIRE;BAC PROFESSIONNEL;BAC PRO SERV;BAC PRO 31108 TRANSPORT;23;23;14;9;0;0;0;14;0;0;4;3;7;9
15133.0;2022;13;POITIERS;FEMININ;SCOLAIRE;BAC PROFESSIONNEL;BAC PRO SERV;BAC PRO 31214 MET.COM.VEN.OP.B PR.CL.VA.OF.COM.;70;70;54;12;4;4;0;58;0;2;10;25;21;12
15146.0;2022;13;POITIERS;FEMININ;SCOLAIRE;BAC TECHNOLOGIQUE;BAC ST2S;BAC ST2S SCIENCES & TECHNO. SANTE & SOCIAL;398;398;351;10;37;21;16;372;1;8;65;151;147;26
15153.0;2022;13;POITIERS;FEMININ;SCOLAIRE;BAC TECHNOLOGIQUE;BAC STI2D;BAC STI2D SYSTÈME D'INFORMATION  ET NUMERIQUE;20;20;17;0;3;2;1;19;0;0;1;9;9;1
15155.0;2022;13;POITIERS;FEMININ;SCOLAIRE;BAC TECHNOLOGIQUE;BAC STL;BAC STL SCIENCES PHYSIQUES CHIMIQUES  EN LABORAT.;9;9;6;1;2;2;0;8;0;0;1;2;5;1
15163.0;2022;13;POITIERS;MASCULIN;APPRENTISSAGE;BAC PROFESSIONNEL;BAC PRO PROD;BAC PRO 22703 TECHN.INSTALL.SYST.ENERG.CLIMATI;8;8;5;3;0;0;0;5;0;0;0;1;4;3
15165.0;2022;13;POITIERS;MASCULIN;APPRENTISSAGE;BAC PROFESSIONNEL;BAC PRO PROD;BAC PRO 23102 TRAVAUX PUBLICS;13;13;11;2;0;0;0;11;0;1;3;2;5;2
15166.0;2022;13;POITIERS;MASCULIN;APPRENTISSAGE;BAC PROFESSIONNEL;BAC PRO PROD;BAC PRO 23203 TECHNICIEN BAT. : ORG.REAL.GROS O;4;4;4;0;0;0;0;4;0;0;2;1;1;0
15171.0;2022;13;POITIERS;MASCULIN;APPRENTISSAGE;BAC PROFESSIONNEL;BAC PRO PROD;BAC PRO 25007 MAINTENANCE EQUIPEMENTS INDUST.;25;25;21;3;1;1;0;22;0;1;3;9;9;3
15173.0;2022;13;POITIERS;MASCULIN;APPRENTISSAGE;BAC PROFESSIONNEL;BAC PRO PROD;BAC PRO 25106 TECHNICIEN D'USINAGE;13;13;9;4;0;0;0;9;0;1;2;4;2;4
15175.0;2022;13;POITIERS;MASCULIN;APPRENTISSAGE;BAC PROFESSIONNEL;BAC PRO PROD;BAC PRO 25215 MAINT.VEHIC.OPTB VEHIC.TRANS.ROUT;32;32;23;7;2;1;1;24;0;2;4;8;10;8
15190.0;2022;13;POITIERS;MASCULIN;APPRENTISSAGE;BAC PROFESSIONNEL;BAC PRO PROD;BAC PRO AG 21114 CONDUITE PRODUCTIONS HORTICOLES;1;1;1;0;0;0;0;1;0;0;0;1;0;0
15191.0;2022;13;POITIERS;MASCULIN;APPRENTISSAGE;BAC PROFESSIONNEL;BAC PRO PROD;BAC PRO AG 21210 COND GEST ENTR CANIN ET FELIN;1;1;1;0;0;0;0;1;0;0;0;1;0;0
15197.0;2022;13;POITIERS;MASCULIN;APPRENTISSAGE;BAC PROFESSIONNEL;BAC PRO SERV;BAC PRO 31212 METIERS DE L'ACCUEIL;2;2;2;0;0;0;0;2;0;0;0;1;1;0
15215.0;2022;13;POITIERS;MASCULIN;FORMATION CONTINUE;BAC PROFESSIONNEL;BAC PRO PROD;BAC PRO 25510 METIERS ELECT. ENVIRON. CONNECTES;2;2;1;1;0;0;0;1;0;1;0;0;0;1
15216.0;2022;13;POITIERS;MASCULIN;INDIVIDUEL;BAC GENERAL;BAC GENERAL;BAC GENE 10019 BAC GENERAL;33;18;7;10;1;0;1;7;0;1;0;2;4;11
15228.0;2022;13;POITIERS;MASCULIN;INDIVIDUEL;BAC TECHNOLOGIQUE;BAC STMG;BAC STMG RESSOURCES HUMAINES ET COMMUNICATION;1;0;0;0;0;0;0;0;0;0;0;0;0;0
15234.0;2022;13;POITIERS;MASCULIN;SCOLAIRE;BAC PROFESSIONNEL;BAC PRO PROD;BAC PRO 22004 PROC. CHIMIE EAU PAPIERS-CARTONS;5;5;4;1;0;0;0;4;0;1;1;0;2;1
15235.0;2022;13;POITIERS;MASCULIN;SCOLAIRE;BAC PROFESSIONNEL;BAC PRO PROD;BAC PRO 22105 BOULANGER-PÂTISSIER;15;15;12;3;0;0;0;12;0;1;3;3;5;3
15241.0;2022;13;POITIERS;MASCULIN;SCOLAIRE;BAC PROFESSIONNEL;BAC PRO PROD;BAC PRO 23005 TECHN. ETUDES BAT B ASSIST.ARCHI.;27;27;20;6;1;1;0;21;0;0;4;11;6;6
15245.0;2022;13;POITIERS;MASCULIN;SCOLAIRE;BAC PROFESSIONNEL;BAC PRO PROD;BAC PRO 23205 INTERV. SUR PATRIMOINE BATI OPT.A;9;9;7;2;0;0;0;7;0;0;0;2;5;2
15250.0;2022;13;POITIERS;MASCULIN;SCOLAIRE;BAC PROFESSIONNEL;BAC PRO PROD;BAC PRO 23407 TECHNIC.FAB.BOIS ET MATERX ASSOC;11;11;9;1;1;1;0;10;0;1;1;3;5;1
15251.0;2022;13;POITIERS;MASCULIN;SCOLAIRE;BAC PROFESSIONNEL;BAC PRO PROD;BAC PRO 24203 METIERS DE LA MODE - VÊTEMENT;4;4;3;1;0;0;0;3;0;1;1;0;1;1
15252.0;2022;13;POITIERS;MASCULIN;SCOLAIRE;BAC PROFESSIONNEL;BAC PRO PROD;BAC PRO 24302 METIERS DU CUIR : MAROQUINERIE;1;1;1;0;0;0;0;1;0;0;0;1;0;0
15254.0;2022;13;POITIERS;MASCULIN;SCOLAIRE;BAC PROFESSIONNEL;BAC PRO PROD;BAC PRO 25007 MAINTENANCE EQUIPEMENTS INDUST.;115;113;80;29;4;2;2;82;0;2;14;31;35;31
15257.0;2022;13;POITIERS;MASCULIN;SCOLAIRE;BAC PROFESSIONNEL;BAC PRO PROD;BAC PRO 25107 TECHNICIEN OUTILLEUR;14;14;11;1;2;0;2;11;0;1;0;5;5;3
15262.0;2022;13;POITIERS;MASCULIN;SCOLAIRE;BAC PROFESSIONNEL;BAC PRO PROD;BAC PRO 25220 MAINT.MATERIELS OPT.B TP MANUT.;11;11;8;3;0;0;0;8;0;1;2;3;2;3
15263.0;2022;13;POITIERS;MASCULIN;SCOLAIRE;BAC PROFESSIONNEL;BAC PRO PROD;BAC PRO 25221 MAINT.MATERIELS OPT.C ESP. VERTS;9;9;7;2;0;0;0;7;0;0;2;4;1;2
15265.0;2022;13;POITIERS;MASCULIN;SCOLAIRE;BAC PROFESSIONNEL;BAC PRO PROD;BAC PRO 25303 AERONAUTIQUE OPTION SYSTEMES;46;46;46;0;0;0;0;46;0;7;14;18;7;0
15266.0;2022;13;POITIERS;MASCULIN;SCOLAIRE;BAC PROFESSIONNEL;BAC PRO PROD;BAC PRO 25304 AERONAUTIQUE OPTION STRUCTURE;9;9;9;0;0;0;0;9;0;0;2;4;3;0
15271.0;2022;13;POITIERS;MASCULIN;SCOLAIRE;BAC PROFESSIONNEL;BAC PRO PROD;BAC PRO 25513 SYST.NUM.OPT.A SURETE SECURITE;26;26;20;5;1;0;1;20;0;0;5;7;8;6
15274.0;2022;13;POITIERS;MASCULIN;SCOLAIRE;BAC PROFESSIONNEL;BAC PRO PROD;BAC PRO AG 21001 AGRO-EQUIPEMENT;13;13;9;4;0;0;0;9;0;0;2;1;6;4
15281.0;2022;13;POITIERS;MASCULIN;SCOLAIRE;BAC PROFESSIONNEL;BAC PRO PROD;BAC PRO AG 21211 COND GEST ENTR HIPPIQUE;13;12;12;0;0;0;0;12;0;1;2;3;6;0
15284.0;2022;13;POITIERS;MASCULIN;SCOLAIRE;BAC PROFESSIONNEL;BAC PRO PROD;BAC PRO AG 21405 AMENAGEMENTS PAYSAGERS;53;50;38;12;0;0;0;38;0;1;8;10;19;12
15285.0;2022;13;POITIERS;MASCULIN;SCOLAIRE;BAC PROFESSIONNEL;BAC PRO PROD;BAC PRO AG 21407 TEC CONS VTE UNIVERS JARDINERIE;11;9;8;1;0;0;0;8;0;0;0;3;5;1
15286.0;2022;13;POITIERS;MASCULIN;SCOLAIRE;BAC PROFESSIONNEL;BAC PRO PROD;BAC PRO AG 22105 LABORATOIRE CONTROLE QUALITE;14;14;10;4;0;0;0;10;0;2;1;2;5;4
15289.0;2022;13;POITIERS;MASCULIN;SCOLAIRE;BAC PROFESSIONNEL;BAC PRO SERV;BAC PRO 30001 GESTION-ADMINISTRATION;92;92;79;12;1;1;0;80;0;3;13;30;34;12
15290.0;2022;13;POITIERS;MASCULIN;SCOLAIRE;BAC PROFESSIONNEL;BAC PRO SERV;BAC PRO 31106 LOGISTIQUE;62;61;40;14;7;5;2;45;0;1;14;11;19;16
15293.0;2022;13;POITIERS;MASCULIN;SCOLAIRE;BAC PROFESSIONNEL;BAC PRO SERV;BAC PRO 31212 METIERS DE L'ACCUEIL;12;12;10;0;2;2;0;12;0;0;3;4;5;0
15304.0;2022;13;POITIERS;MASCULIN;SCOLAIRE;BAC PROFESSIONNEL;BAC PRO SERV;BAC PRO 34303 GEST. POLLUTIONS PROTEC. ENVIRON.;12;12;11;0;1;0;1;11;0;0;2;5;4;1
15305.0;2022;13;POITIERS;MASCULIN;SCOLAIRE;BAC PROFESSIONNEL;BAC PRO SERV;BAC PRO 34403 METIERS DE LA SECURITE;31;31;27;4;0;0;0;27;0;3;8;10;6;4
15312.0;2022;13;POITIERS;MASCULIN;SCOLAIRE;BAC TECHNOLOGIQUE;BAC STI2D;BAC STI2D ENERGIES  ET ENVIRONNEMENT;53;53;38;7;8;3;5;41;0;0;6;17;18;12
15331.0;2022;19;REIMS;FEMININ;APPRENTISSAGE;BAC PROFESSIONNEL;BAC PRO PROD;BAC PRO AG 21405 AMENAGEMENTS PAYSAGERS;1;1;1;0;0;0;0;1;0;0;0;1;0;0
15332.0;2022;19;REIMS;FEMININ;APPRENTISSAGE;BAC PROFESSIONNEL;BAC PRO SERV;BAC PRO 30001 GESTION-ADMINISTRATION;8;7;7;0;0;0;0;7;0;1;2;4;0;0
15336.0;2022;19;REIMS;FEMININ;APPRENTISSAGE;BAC PROFESSIONNEL;BAC PRO SERV;BAC PRO 32207 REAL.PR.IMPR.PLURI.OPTA.PR.GRAPH.;1;1;1;0;0;0;0;1;0;0;1;0;0;0
15353.0;2022;19;REIMS;FEMININ;FORMATION CONTINUE;BAC PROFESSIONNEL;BAC PRO SERV;BAC PRO 33603 ESTHETIQUE COSMETIQUE PARFUMERIE;1;1;1;0;0;0;0;1;0;0;0;0;1;0
15354.0;2022;19;REIMS;FEMININ;FORMATION CONTINUE;BAC PROFESSIONNEL;BAC PRO SERV;BAC PRO 34403 METIERS DE LA SECURITE;1;1;1;0;0;0;0;1;0;0;0;0;1;0
15356.0;2022;19;REIMS;FEMININ;INDIVIDUEL;BAC PROFESSIONNEL;BAC PRO PROD;BAC PRO 24203 METIERS DE LA MODE - VÊTEMENT;3;2;0;2;0;0;0;0;0;0;0;0;0;2
15361.0;2022;19;REIMS;FEMININ;INDIVIDUEL;BAC PROFESSIONNEL;BAC PRO SERV;BAC PRO 30001 GESTION-ADMINISTRATION;6;3;1;2;0;0;0;1;0;0;0;0;1;2
15362.0;2022;19;REIMS;FEMININ;INDIVIDUEL;BAC PROFESSIONNEL;BAC PRO SERV;BAC PRO 31213 MET.COM.VEN.OP.A ANI.GES.ESP.COM.;1;0;0;0;0;0;0;0;0;0;0;0;0;0
15363.0;2022;19;REIMS;FEMININ;INDIVIDUEL;BAC PROFESSIONNEL;BAC PRO SERV;BAC PRO 33004 ACC.SOINS-S.PERS. OPT.EN STRUCTUR;3;3;1;2;0;0;0;1;0;0;0;1;0;2
15372.0;2022;19;REIMS;FEMININ;SCOLAIRE;BAC PROFESSIONNEL;BAC PRO PROD;BAC PRO 22003 BIO-INDUSTRIES DE TRANSFORMATION;21;21;19;2;0;0;0;19;0;0;2;11;6;2
15385.0;2022;19;REIMS;FEMININ;SCOLAIRE;BAC PROFESSIONNEL;BAC PRO PROD;BAC PRO 25214 MAINT.VEHIC.OPTA VOIT.PARTICUL.;6;6;4;2;0;0;0;4;0;0;0;2;2;2
15396.0;2022;19;REIMS;FEMININ;SCOLAIRE;BAC PROFESSIONNEL;BAC PRO PROD;BAC PRO AG 21210 COND GEST ENTR CANIN ET FELIN;8;8;7;1;0;0;0;7;0;0;2;4;1;1
15397.0;2022;19;REIMS;FEMININ;SCOLAIRE;BAC PROFESSIONNEL;BAC PRO PROD;BAC PRO AG 21211 COND GEST ENTR HIPPIQUE;10;10;9;1;0;0;0;9;0;1;3;2;3;1
15401.0;2022;19;REIMS;FEMININ;SCOLAIRE;BAC PROFESSIONNEL;BAC PRO PROD;BAC PRO AG 22105 LABORATOIRE CONTROLE QUALITE;5;5;5;0;0;0;0;5;0;0;0;2;3;0
15403.0;2022;19;REIMS;FEMININ;SCOLAIRE;BAC PROFESSIONNEL;BAC PRO PROD;BAC PRO AG 22107 TEC CONS VTE ALIMENTATION P.ALIM;4;4;3;1;0;0;0;3;0;0;1;1;1;1
15405.0;2022;19;REIMS;FEMININ;SCOLAIRE;BAC PROFESSIONNEL;BAC PRO SERV;BAC PRO 31106 LOGISTIQUE;11;10;7;2;1;1;0;8;0;1;2;2;3;2
15416.0;2022;19;REIMS;FEMININ;SCOLAIRE;BAC PROFESSIONNEL;BAC PRO SERV;BAC PRO 33004 ACC.SOINS-S.PERS. OPT.EN STRUCTUR;240;240;215;19;6;4;2;219;0;9;55;101;54;21
15418.0;2022;19;REIMS;FEMININ;SCOLAIRE;BAC PROFESSIONNEL;BAC PRO SERV;BAC PRO 33102 PROTHESE DENTAIRE;1;1;1;0;0;0;0;1;0;0;1;0;0;0
15420.0;2022;19;REIMS;FEMININ;SCOLAIRE;BAC PROFESSIONNEL;BAC PRO SERV;BAC PRO 33603 ESTHETIQUE COSMETIQUE PARFUMERIE;69;68;60;7;1;1;0;61;0;2;11;17;31;7
15421.0;2022;19;REIMS;FEMININ;SCOLAIRE;BAC PROFESSIONNEL;BAC PRO SERV;BAC PRO 34304 HYGIENE PROPRETE STERILISATION;9;9;7;0;2;2;0;9;0;0;0;4;5;0
15425.0;2022;19;REIMS;FEMININ;SCOLAIRE;BAC TECHNOLOGIQUE;BAC S2TMD;BAC S2TMD DANSE;5;5;5;0;0;0;0;5;0;0;2;1;2;0
15429.0;2022;19;REIMS;FEMININ;SCOLAIRE;BAC TECHNOLOGIQUE;BAC STD2A;BAC STD2A SCIENCES & TECHNO. DESIGN-ARTS APPLIQUES;72;72;69;1;2;0;2;69;0;6;20;29;14;3
15432.0;2022;19;REIMS;FEMININ;SCOLAIRE;BAC TECHNOLOGIQUE;BAC STI2D;BAC STI2D ENERGIES  ET ENVIRONNEMENT;14;14;9;2;3;2;1;11;0;0;1;2;8;3
15433.0;2022;19;REIMS;FEMININ;SCOLAIRE;BAC TECHNOLOGIQUE;BAC STI2D;BAC STI2D INNOVATION TECHNO.  ET ECO CONCEPTION;14;14;11;0;3;2;1;13;0;0;3;5;5;1
15449.0;2022;19;REIMS;MASCULIN;APPRENTISSAGE;BAC PROFESSIONNEL;BAC PRO PROD;BAC PRO 23304 AMENAGEMENT FINITION BATIMENT;3;3;3;0;0;0;0;3;0;1;0;1;1;0
15450.0;2022;19;REIMS;MASCULIN;APPRENTISSAGE;BAC PROFESSIONNEL;BAC PRO PROD;BAC PRO 23404 TECHNICIEN CONSTRUCTEUR BOIS;1;1;1;0;0;0;0;1;0;0;1;0;0;0
15454.0;2022;19;REIMS;MASCULIN;APPRENTISSAGE;BAC PROFESSIONNEL;BAC PRO PROD;BAC PRO 25106 TECHNICIEN D'USINAGE;12;11;8;3;0;0;0;8;0;2;3;2;1;3
15465.0;2022;19;REIMS;MASCULIN;APPRENTISSAGE;BAC PROFESSIONNEL;BAC PRO PROD;BAC PRO 25510 METIERS ELECT. ENVIRON. CONNECTES;45;45;40;3;2;2;0;42;0;6;13;11;12;3
15471.0;2022;19;REIMS;MASCULIN;APPRENTISSAGE;BAC PROFESSIONNEL;BAC PRO PROD;BAC PRO AG 21302 GEST MILIEUX NATURELS FAUNE;2;2;2;0;0;0;0;2;0;0;0;1;1;0
15478.0;2022;19;REIMS;MASCULIN;APPRENTISSAGE;BAC PROFESSIONNEL;BAC PRO SERV;BAC PRO 33102 PROTHESE DENTAIRE;3;3;3;0;0;0;0;3;0;0;0;1;2;0
15480.0;2022;19;REIMS;MASCULIN;APPRENTISSAGE;BAC PROFESSIONNEL;BAC PRO SERV;BAC PRO AG 33002 SERV PERS TERRIT;1;1;1;0;0;0;0;1;0;0;0;0;1;0
15481.0;2022;19;REIMS;MASCULIN;ENSEIGNEMENT A DISTANCE;BAC GENERAL;BAC GENERAL;BAC GENE 10019 BAC GENERAL;6;5;4;1;0;0;0;4;0;0;1;1;2;1
15483.0;2022;19;REIMS;MASCULIN;ENSEIGNEMENT A DISTANCE;BAC PROFESSIONNEL;BAC PRO SERV;BAC PRO 31213 MET.COM.VEN.OP.A ANI.GES.ESP.COM.;1;1;1;0;0;0;0;1;0;0;0;0;1;0
15484.0;2022;19;REIMS;MASCULIN;ENSEIGNEMENT A DISTANCE;BAC TECHNOLOGIQUE;BAC ST2S;BAC ST2S SCIENCES & TECHNO. SANTE & SOCIAL;1;1;1;0;0;0;0;1;0;0;0;1;0;0
15490.0;2022;19;REIMS;MASCULIN;FORMATION CONTINUE;BAC PROFESSIONNEL;BAC PRO SERV;BAC PRO 31213 MET.COM.VEN.OP.A ANI.GES.ESP.COM.;1;1;1;0;0;0;0;1;0;0;0;0;1;0
15497.0;2022;19;REIMS;MASCULIN;INDIVIDUEL;BAC PROFESSIONNEL;BAC PRO SERV;BAC PRO 30001 GESTION-ADMINISTRATION;1;0;0;0;0;0;0;0;0;0;0;0;0;0
15499.0;2022;19;REIMS;MASCULIN;INDIVIDUEL;BAC PROFESSIONNEL;BAC PRO SERV;BAC PRO 31214 MET.COM.VEN.OP.B PR.CL.VA.OF.COM.;1;1;0;1;0;0;0;0;0;0;0;0;0;1
15508.0;2022;19;REIMS;MASCULIN;SCOLAIRE;BAC PROFESSIONNEL;BAC PRO PROD;BAC PRO 20102 PILOTE DE LIGNE DE PRODUCTION;11;11;8;2;1;1;0;9;0;1;0;2;6;2
15513.0;2022;19;REIMS;MASCULIN;SCOLAIRE;BAC PROFESSIONNEL;BAC PRO PROD;BAC PRO 22303 FONDERIE;6;6;5;1;0;0;0;5;0;0;1;3;1;1
15514.0;2022;19;REIMS;MASCULIN;SCOLAIRE;BAC PROFESSIONNEL;BAC PRO PROD;BAC PRO 22503 PLASTIQUES ET COMPOSITES;16;16;12;4;0;0;0;12;0;0;1;8;3;4
15518.0;2022;19;REIMS;MASCULIN;SCOLAIRE;BAC PROFESSIONNEL;BAC PRO PROD;BAC PRO 23005 TECHN. ETUDES BAT B ASSIST.ARCHI.;25;25;15;8;2;2;0;17;0;0;2;7;8;8
15524.0;2022;19;REIMS;MASCULIN;SCOLAIRE;BAC PROFESSIONNEL;BAC PRO PROD;BAC PRO 23404 TECHNICIEN CONSTRUCTEUR BOIS;11;11;7;2;2;2;0;9;0;1;1;2;5;2
15537.0;2022;19;REIMS;MASCULIN;SCOLAIRE;BAC PROFESSIONNEL;BAC PRO PROD;BAC PRO 25408 REPARATION DES CARROSSERIES;37;36;24;12;0;0;0;24;0;1;2;10;11;12
15544.0;2022;19;REIMS;MASCULIN;SCOLAIRE;BAC PROFESSIONNEL;BAC PRO PROD;BAC PRO AG 21001 AGRO-EQUIPEMENT;23;23;19;4;0;0;0;19;0;0;6;5;8;4
15548.0;2022;19;REIMS;MASCULIN;SCOLAIRE;BAC PROFESSIONNEL;BAC PRO PROD;BAC PRO AG 21203 TECHN CONSEIL DE VENTE ANIMAL;3;3;3;0;0;0;0;3;0;0;1;0;2;0
15549.0;2022;19;REIMS;MASCULIN;SCOLAIRE;BAC PROFESSIONNEL;BAC PRO PROD;BAC PRO AG 21210 COND GEST ENTR CANIN ET FELIN;9;9;7;2;0;0;0;7;0;0;0;1;6;2
15555.0;2022;19;REIMS;MASCULIN;SCOLAIRE;BAC PROFESSIONNEL;BAC PRO PROD;BAC PRO AG 22106 TEC CONS VTE ALIMENTATION VINS SP;3;3;3;0;0;0;0;3;0;0;2;1;0;0
15558.0;2022;19;REIMS;MASCULIN;SCOLAIRE;BAC PROFESSIONNEL;BAC PRO SERV;BAC PRO 31106 LOGISTIQUE;37;37;30;5;2;2;0;32;0;0;6;16;10;5
15560.0;2022;19;REIMS;MASCULIN;SCOLAIRE;BAC PROFESSIONNEL;BAC PRO SERV;BAC PRO 31108 TRANSPORT;17;17;8;8;1;1;0;9;0;2;2;3;2;8
15568.0;2022;19;REIMS;MASCULIN;SCOLAIRE;BAC PROFESSIONNEL;BAC PRO SERV;BAC PRO 33003 ACC.SOINS-S.PERS. OPT.A DOMICILE;6;6;4;2;0;0;0;4;0;0;1;1;2;2
15570.0;2022;19;REIMS;MASCULIN;SCOLAIRE;BAC PROFESSIONNEL;BAC PRO SERV;BAC PRO 33101 OPTIQUE LUNETTERIE;5;5;5;0;0;0;0;5;0;0;0;2;3;0
15572.0;2022;19;REIMS;MASCULIN;SCOLAIRE;BAC PROFESSIONNEL;BAC PRO SERV;BAC PRO 34304 HYGIENE PROPRETE STERILISATION;3;3;2;0;1;0;1;2;0;0;0;2;0;1
15576.0;2022;19;REIMS;MASCULIN;SCOLAIRE;BAC TECHNOLOGIQUE;BAC S2TMD;BAC S2TMD MUSIQUE;2;2;2;0;0;0;0;2;0;0;1;1;0;0
15581.0;2022;19;REIMS;MASCULIN;SCOLAIRE;BAC TECHNOLOGIQUE;BAC STI2D;BAC STI2D ARCHITECTURE ET CONSTRUCTION;113;113;95;4;14;4;10;99;0;2;17;33;47;14
15582.0;2022;19;REIMS;MASCULIN;SCOLAIRE;BAC TECHNOLOGIQUE;BAC STI2D;BAC STI2D ENERGIES  ET ENVIRONNEMENT;95;95;74;3;18;8;10;82;0;1;7;23;51;13
15586.0;2022;19;REIMS;MASCULIN;SCOLAIRE;BAC TECHNOLOGIQUE;BAC STL;BAC STL SCIENCES PHYSIQUES CHIMIQUES  EN LABORAT.;21;21;16;1;4;3;1;19;0;1;4;2;12;2
15590.0;2022;19;REIMS;MASCULIN;SCOLAIRE;BAC TECHNOLOGIQUE;BAC STMG;BAC STMG SYSTEMES D'INFORMATION DE GESTION;18;18;8;5;5;3;2;11;1;0;0;2;8;7
15594.0;2022;14;RENNES;FEMININ;APPRENTISSAGE;BAC PROFESSIONNEL;BAC PRO PROD;BAC PRO 23405 TECHNICIEN MENUISIER AGENCEUR;2;2;2;0;0;0;0;2;0;0;1;0;1;0
15599.0;2022;14;RENNES;FEMININ;APPRENTISSAGE;BAC PROFESSIONNEL;BAC PRO PROD;BAC PRO AG 21001 AGRO-EQUIPEMENT;2;2;1;1;0;0;0;1;0;0;1;0;0;1
15609.0;2022;14;RENNES;FEMININ;APPRENTISSAGE;BAC PROFESSIONNEL;BAC PRO SERV;BAC PRO 31209 POISSONIER ECAILLER TRAITEUR;1;1;1;0;0;0;0;1;0;1;0;0;0;0
15615.0;2022;14;RENNES;FEMININ;ENSEIGNEMENT A DISTANCE;BAC GENERAL;BAC GENERAL;BAC GENE 10019 BAC GENERAL;69;69;46;14;9;6;3;52;0;0;13;11;28;17
15624.0;2022;14;RENNES;FEMININ;FORMATION CONTINUE;BAC PROFESSIONNEL;BAC PRO PROD;BAC PRO 23004 TECHN. ETUDES BAT.A ETUDES & ECO.;3;3;3;0;0;0;0;3;0;1;1;1;0;0
15630.0;2022;14;RENNES;FEMININ;INDIVIDUEL;BAC PROFESSIONNEL;BAC PRO PROD;BAC PRO 24203 METIERS DE LA MODE - VÊTEMENT;2;1;1;0;0;0;0;1;0;0;0;0;1;0
15631.0;2022;14;RENNES;FEMININ;INDIVIDUEL;BAC PROFESSIONNEL;BAC PRO PROD;BAC PRO AG 21004 CGEA;13;12;9;3;0;0;0;9;0;0;0;0;9;3
15635.0;2022;14;RENNES;FEMININ;INDIVIDUEL;BAC PROFESSIONNEL;BAC PRO SERV;BAC PRO 30001 GESTION-ADMINISTRATION;7;3;2;1;0;0;0;2;0;0;0;0;2;1
15648.0;2022;14;RENNES;FEMININ;SCOLAIRE;BAC GENERAL;BAC GENERAL;BAC GENE 10019 BAC GENERAL;10402;10402;9990;79;333;240;93;10230;178;1415;3022;3409;2206;172
15650.0;2022;14;RENNES;FEMININ;SCOLAIRE;BAC PROFESSIONNEL;BAC PRO PROD;BAC PRO 22105 BOULANGER-PÂTISSIER;53;53;52;1;0;0;0;52;0;9;17;20;6;1
15653.0;2022;14;RENNES;FEMININ;SCOLAIRE;BAC PROFESSIONNEL;BAC PRO PROD;BAC PRO 22703 TECHN.INSTALL.SYST.ENERG.CLIMATI;1;1;0;0;1;0;1;0;0;0;0;0;0;1
15670.0;2022;14;RENNES;FEMININ;SCOLAIRE;BAC PROFESSIONNEL;BAC PRO PROD;BAC PRO 25107 TECHNICIEN OUTILLEUR;1;1;1;0;0;0;0;1;0;0;1;0;0;0
15684.0;2022;14;RENNES;FEMININ;SCOLAIRE;BAC PROFESSIONNEL;BAC PRO PROD;BAC PRO AG 21001 AGRO-EQUIPEMENT;1;1;1;0;0;0;0;1;0;0;0;1;0;0
15688.0;2022;14;RENNES;FEMININ;SCOLAIRE;BAC PROFESSIONNEL;BAC PRO PROD;BAC PRO AG 21204 PROD-AQUACOLES;1;1;0;1;0;0;0;0;0;0;0;0;0;1
15691.0;2022;14;RENNES;FEMININ;SCOLAIRE;BAC PROFESSIONNEL;BAC PRO PROD;BAC PRO AG 21302 GEST MILIEUX NATURELS FAUNE;7;7;7;0;0;0;0;7;0;0;0;2;5;0
15694.0;2022;14;RENNES;FEMININ;SCOLAIRE;BAC PROFESSIONNEL;BAC PRO PROD;BAC PRO AG 22105 LABORATOIRE CONTROLE QUALITE;12;12;7;5;0;0;0;7;0;0;2;3;2;5
15699.0;2022;14;RENNES;FEMININ;SCOLAIRE;BAC PROFESSIONNEL;BAC PRO SERV;BAC PRO 31108 TRANSPORT;3;3;3;0;0;0;0;3;0;0;1;2;0;0
15709.0;2022;14;RENNES;FEMININ;SCOLAIRE;BAC PROFESSIONNEL;BAC PRO SERV;BAC PRO 33101 OPTIQUE LUNETTERIE;37;37;34;1;2;0;2;34;0;4;12;13;5;3
15715.0;2022;14;RENNES;FEMININ;SCOLAIRE;BAC PROFESSIONNEL;BAC PRO SERV;BAC PRO AG 33002 SERV PERS TERRIT;725;715;646;69;0;0;0;646;0;10;68;238;330;69
15723.0;2022;14;RENNES;FEMININ;SCOLAIRE;BAC TECHNOLOGIQUE;BAC STI2D;BAC STI2D ENERGIES  ET ENVIRONNEMENT;18;18;17;0;1;0;1;17;0;1;3;8;5;1
15734.0;2022;14;RENNES;MASCULIN;APPRENTISSAGE;BAC PROFESSIONNEL;BAC PRO PROD;BAC PRO 22106 CUISINE;47;47;35;9;3;2;1;37;0;0;9;16;12;10
15743.0;2022;14;RENNES;MASCULIN;APPRENTISSAGE;BAC PROFESSIONNEL;BAC PRO PROD;BAC PRO 25007 MAINTENANCE EQUIPEMENTS INDUST.;39;39;30;7;2;1;1;31;0;4;9;9;9;8
15752.0;2022;14;RENNES;MASCULIN;APPRENTISSAGE;BAC PROFESSIONNEL;BAC PRO PROD;BAC PRO 25221 MAINT.MATERIELS OPT.C ESP. VERTS;15;15;12;1;2;0;2;12;0;0;4;2;6;3
15762.0;2022;14;RENNES;MASCULIN;APPRENTISSAGE;BAC PROFESSIONNEL;BAC PRO PROD;BAC PRO AG 21114 CONDUITE PRODUCTIONS HORTICOLES;7;7;7;0;0;0;0;7;0;0;0;1;6;0
15766.0;2022;14;RENNES;MASCULIN;APPRENTISSAGE;BAC PROFESSIONNEL;BAC PRO PROD;BAC PRO AG 21405 AMENAGEMENTS PAYSAGERS;80;72;60;12;0;0;0;60;0;0;3;13;44;12
15767.0;2022;14;RENNES;MASCULIN;APPRENTISSAGE;BAC PROFESSIONNEL;BAC PRO PROD;BAC PRO AG 22107 TEC CONS VTE ALIMENTATION P.ALIM;3;3;2;1;0;0;0;2;0;0;0;0;2;1
15770.0;2022;14;RENNES;MASCULIN;APPRENTISSAGE;BAC PROFESSIONNEL;BAC PRO SERV;BAC PRO 31209 POISSONIER ECAILLER TRAITEUR;5;5;5;0;0;0;0;5;0;4;0;1;0;0
15778.0;2022;14;RENNES;MASCULIN;ENSEIGNEMENT A DISTANCE;BAC PROFESSIONNEL;BAC PRO SERV;BAC PRO 31213 MET.COM.VEN.OP.A ANI.GES.ESP.COM.;3;3;3;0;0;0;0;3;0;0;0;0;3;0
15782.0;2022;14;RENNES;MASCULIN;ENSEIGNEMENT A DISTANCE;BAC TECHNOLOGIQUE;BAC STMG;BAC STMG MERCATIQUE (MARKETING);3;3;1;2;0;0;0;1;0;0;0;0;1;2
15794.0;2022;14;RENNES;MASCULIN;INDIVIDUEL;BAC PROFESSIONNEL;BAC PRO PROD;BAC PRO 25007 MAINTENANCE EQUIPEMENTS INDUST.;1;0;0;0;0;0;0;0;0;0;0;0;0;0
15798.0;2022;14;RENNES;MASCULIN;INDIVIDUEL;BAC PROFESSIONNEL;BAC PRO PROD;BAC PRO 25411 TECH.CHAUDRONNERIE INDUSTRIELLE;1;1;0;1;0;0;0;0;0;0;0;0;0;1
15800.0;2022;14;RENNES;MASCULIN;INDIVIDUEL;BAC PROFESSIONNEL;BAC PRO PROD;BAC PRO 25514 SYST.NUM.OPT.B AUD.RES.EQUIP.DOM.;1;0;0;0;0;0;0;0;0;0;0;0;0;0
15804.0;2022;14;RENNES;MASCULIN;INDIVIDUEL;BAC PROFESSIONNEL;BAC PRO PROD;BAC PRO AG 21114 CONDUITE PRODUCTIONS HORTICOLES;9;5;5;0;0;0;0;5;0;1;0;0;4;0
15809.0;2022;14;RENNES;MASCULIN;INDIVIDUEL;BAC PROFESSIONNEL;BAC PRO PROD;BAC PRO AG 22107 TEC CONS VTE ALIMENTATION P.ALIM;2;0;0;0;0;0;0;0;0;0;0;0;0;0
15820.0;2022;14;RENNES;MASCULIN;INDIVIDUEL;BAC TECHNOLOGIQUE;BAC STMG;BAC STMG RESSOURCES HUMAINES ET COMMUNICATION;2;0;0;0;0;0;0;0;0;0;0;0;0;0
15821.0;2022;14;RENNES;MASCULIN;INDIVIDUEL;BAC TECHNOLOGIQUE;BAC STMG;BAC STMG SYSTEMES D'INFORMATION DE GESTION;2;1;0;0;1;0;1;0;0;0;0;0;0;1
15839.0;2022;14;RENNES;MASCULIN;SCOLAIRE;BAC PROFESSIONNEL;BAC PRO PROD;BAC PRO 23405 TECHNICIEN MENUISIER AGENCEUR;227;227;186;33;8;6;2;192;0;13;51;72;56;35
15845.0;2022;14;RENNES;MASCULIN;SCOLAIRE;BAC PROFESSIONNEL;BAC PRO PROD;BAC PRO 25007 MAINTENANCE EQUIPEMENTS INDUST.;237;237;190;44;3;3;0;193;0;4;27;78;84;44
15846.0;2022;14;RENNES;MASCULIN;SCOLAIRE;BAC PROFESSIONNEL;BAC PRO PROD;BAC PRO 25009 MAINTENANCE NAUTIQUE;48;48;38;10;0;0;0;38;0;2;8;10;18;10
15847.0;2022;14;RENNES;MASCULIN;SCOLAIRE;BAC PROFESSIONNEL;BAC PRO PROD;BAC PRO 25106 TECHNICIEN D'USINAGE;91;91;82;8;1;1;0;83;0;6;20;35;22;8
15848.0;2022;14;RENNES;MASCULIN;SCOLAIRE;BAC PROFESSIONNEL;BAC PRO PROD;BAC PRO 25107 TECHNICIEN OUTILLEUR;6;6;4;1;1;1;0;5;0;0;1;3;1;1
15851.0;2022;14;RENNES;MASCULIN;SCOLAIRE;BAC PROFESSIONNEL;BAC PRO PROD;BAC PRO 25216 MAINT.VEHIC.OPTC MOTOCYCLES;39;39;32;4;3;1;2;33;0;0;10;15;8;6
15853.0;2022;14;RENNES;MASCULIN;SCOLAIRE;BAC PROFESSIONNEL;BAC PRO PROD;BAC PRO 25220 MAINT.MATERIELS OPT.B TP MANUT.;21;21;13;5;3;2;1;15;0;0;5;2;8;6
15858.0;2022;14;RENNES;MASCULIN;SCOLAIRE;BAC PROFESSIONNEL;BAC PRO PROD;BAC PRO 25406 OUVRAGES DU BATIMENT METALLERIE;21;21;19;2;0;0;0;19;0;0;2;7;10;2
15859.0;2022;14;RENNES;MASCULIN;SCOLAIRE;BAC PROFESSIONNEL;BAC PRO PROD;BAC PRO 25408 REPARATION DES CARROSSERIES;24;24;20;4;0;0;0;20;0;0;1;8;11;4
15861.0;2022;14;RENNES;MASCULIN;SCOLAIRE;BAC PROFESSIONNEL;BAC PRO PROD;BAC PRO 25509 TECHNIC. FROID CONDITIONNEMT AIR;35;35;28;6;1;1;0;29;0;1;6;8;14;6
15863.0;2022;14;RENNES;MASCULIN;SCOLAIRE;BAC PROFESSIONNEL;BAC PRO PROD;BAC PRO 25513 SYST.NUM.OPT.A SURETE SECURITE;95;95;79;15;1;1;0;80;0;2;23;33;22;15
15870.0;2022;14;RENNES;MASCULIN;SCOLAIRE;BAC PROFESSIONNEL;BAC PRO PROD;BAC PRO AG 21204 PROD-AQUACOLES;6;6;5;1;0;0;0;5;0;0;1;2;2;1
15874.0;2022;14;RENNES;MASCULIN;SCOLAIRE;BAC PROFESSIONNEL;BAC PRO PROD;BAC PRO AG 21303 FORET;10;10;7;3;0;0;0;7;0;0;0;2;5;3
15877.0;2022;14;RENNES;MASCULIN;SCOLAIRE;BAC PROFESSIONNEL;BAC PRO PROD;BAC PRO AG 22105 LABORATOIRE CONTROLE QUALITE;19;19;14;5;0;0;0;14;0;1;1;5;7;5
15878.0;2022;14;RENNES;MASCULIN;SCOLAIRE;BAC PROFESSIONNEL;BAC PRO PROD;BAC PRO AG 22107 TEC CONS VTE ALIMENTATION P.ALIM;70;68;61;7;0;0;0;61;0;0;2;16;43;7
15879.0;2022;14;RENNES;MASCULIN;SCOLAIRE;BAC PROFESSIONNEL;BAC PRO SERV;BAC PRO 30001 GESTION-ADMINISTRATION;182;181;137;40;4;2;2;139;0;5;16;57;61;42
15882.0;2022;14;RENNES;MASCULIN;SCOLAIRE;BAC PROFESSIONNEL;BAC PRO SERV;BAC PRO 31108 TRANSPORT;9;9;5;2;2;2;0;7;0;0;1;2;4;2
15888.0;2022;14;RENNES;MASCULIN;SCOLAIRE;BAC PROFESSIONNEL;BAC PRO SERV;BAC PRO 32303 ART.& MET.ART:COM.VIS.VIS.PLURI-M;10;10;10;0;0;0;0;10;0;2;2;4;2;0
15889.0;2022;14;RENNES;MASCULIN;SCOLAIRE;BAC PROFESSIONNEL;BAC PRO SERV;BAC PRO 33002 SERVICES DE PROXIMITE  VIE LOCAL;42;42;38;4;0;0;0;38;0;0;4;21;13;4
15898.0;2022;14;RENNES;MASCULIN;SCOLAIRE;BAC PROFESSIONNEL;BAC PRO SERV;BAC PRO AG 33002 SERV PERS TERRIT;110;106;92;14;0;0;0;92;0;0;4;37;51;14
15901.0;2022;14;RENNES;MASCULIN;SCOLAIRE;BAC TECHNOLOGIQUE;BAC ST2S;BAC ST2S SCIENCES & TECHNO. SANTE & SOCIAL;114;114;95;3;16;12;4;107;0;0;4;37;66;7
15902.0;2022;14;RENNES;MASCULIN;SCOLAIRE;BAC TECHNOLOGIQUE;BAC STAV;BAC STAV AGRONOMIE ALIM ENV TERRITOI;204;202;198;4;0;0;0;198;0;9;30;77;82;4
15909.0;2022;14;RENNES;MASCULIN;SCOLAIRE;BAC TECHNOLOGIQUE;BAC STL;BAC STL BIOCHIM.-BIOLOGIE-BIOTECHNOL.;60;60;58;0;2;0;2;58;0;2;11;19;26;2
15911.0;2022;14;RENNES;MASCULIN;SCOLAIRE;BAC TECHNOLOGIQUE;BAC STMG;BAC STMG GESTION ET FINANCE;566;566;496;14;56;48;8;544;0;5;41;219;279;22
15915.0;2022;15;STRASBOURG;FEMININ;APPRENTISSAGE;BAC PROFESSIONNEL;BAC PRO PROD;BAC PRO 22106 CUISINE;3;3;2;1;0;0;0;2;0;0;0;0;2;1
15921.0;2022;15;STRASBOURG;FEMININ;APPRENTISSAGE;BAC PROFESSIONNEL;BAC PRO PROD;BAC PRO 25007 MAINTENANCE EQUIPEMENTS INDUST.;2;2;2;0;0;0;0;2;0;1;1;0;0;0
15924.0;2022;15;STRASBOURG;FEMININ;APPRENTISSAGE;BAC PROFESSIONNEL;BAC PRO PROD;BAC PRO 25214 MAINT.VEHIC.OPTA VOIT.PARTICUL.;3;3;3;0;0;0;0;3;0;1;0;2;0;0
15928.0;2022;15;STRASBOURG;FEMININ;APPRENTISSAGE;BAC PROFESSIONNEL;BAC PRO PROD;BAC PRO AG 21001 AGRO-EQUIPEMENT;2;2;2;0;0;0;0;2;0;0;0;0;2;0
15935.0;2022;15;STRASBOURG;FEMININ;APPRENTISSAGE;BAC PROFESSIONNEL;BAC PRO SERV;BAC PRO 30001 GESTION-ADMINISTRATION;18;18;12;6;0;0;0;12;0;1;2;4;5;6
15942.0;2022;15;STRASBOURG;FEMININ;ENSEIGNEMENT A DISTANCE;BAC GENERAL;BAC GENERAL;BAC GENE 10019 BAC GENERAL;32;32;20;9;3;1;2;21;0;3;4;5;9;11
15946.0;2022;15;STRASBOURG;FEMININ;ENSEIGNEMENT A DISTANCE;BAC PROFESSIONNEL;BAC PRO SERV;BAC PRO 33004 ACC.SOINS-S.PERS. OPT.EN STRUCTUR;1;0;0;0;0;0;0;0;0;0;0;0;0;0
15947.0;2022;15;STRASBOURG;FEMININ;ENSEIGNEMENT A DISTANCE;BAC PROFESSIONNEL;BAC PRO SERV;BAC PRO 33603 ESTHETIQUE COSMETIQUE PARFUMERIE;2;2;1;1;0;0;0;1;0;0;1;0;0;1
15951.0;2022;15;STRASBOURG;FEMININ;FORMATION CONTINUE;BAC PROFESSIONNEL;BAC PRO PROD;BAC PRO 22704 TECHN. MAINT. SYST.ENERG.CLIMATI;2;2;2;0;0;0;0;2;0;1;0;0;1;0
15963.0;2022;15;STRASBOURG;FEMININ;INDIVIDUEL;BAC PROFESSIONNEL;BAC PRO PROD;BAC PRO AG 21302 GEST MILIEUX NATURELS FAUNE;1;1;0;1;0;0;0;0;0;0;0;0;0;1
15971.0;2022;15;STRASBOURG;FEMININ;INDIVIDUEL;BAC PROFESSIONNEL;BAC PRO SERV;BAC PRO 34403 METIERS DE LA SECURITE;1;1;0;1;0;0;0;0;0;0;0;0;0;1
15978.0;2022;15;STRASBOURG;FEMININ;SCOLAIRE;BAC GENERAL;BAC GENERAL;BAC GENE 10019 BAC GENERAL;5569;5569;5263;66;240;150;90;5413;161;969;1577;1565;1141;156
15984.0;2022;15;STRASBOURG;FEMININ;SCOLAIRE;BAC PROFESSIONNEL;BAC PRO PROD;BAC PRO 23004 TECHN. ETUDES BAT.A ETUDES & ECO.;9;9;9;0;0;0;0;9;0;0;0;1;8;0
15990.0;2022;15;STRASBOURG;FEMININ;SCOLAIRE;BAC PROFESSIONNEL;BAC PRO PROD;BAC PRO 25006 MICROTECHNIQUES;1;1;1;0;0;0;0;1;0;0;0;0;1;0
15992.0;2022;15;STRASBOURG;FEMININ;SCOLAIRE;BAC PROFESSIONNEL;BAC PRO PROD;BAC PRO 25106 TECHNICIEN D'USINAGE;1;1;1;0;0;0;0;1;0;0;1;0;0;0
15995.0;2022;15;STRASBOURG;FEMININ;SCOLAIRE;BAC PROFESSIONNEL;BAC PRO PROD;BAC PRO 25216 MAINT.VEHIC.OPTC MOTOCYCLES;2;2;2;0;0;0;0;2;0;1;0;0;1;0
16001.0;2022;15;STRASBOURG;FEMININ;SCOLAIRE;BAC PROFESSIONNEL;BAC PRO PROD;BAC PRO AG 21004 CGEA;19;19;15;4;0;0;0;15;0;1;2;8;4;4
16004.0;2022;15;STRASBOURG;FEMININ;SCOLAIRE;BAC PROFESSIONNEL;BAC PRO PROD;BAC PRO AG 21302 GEST MILIEUX NATURELS FAUNE;4;4;4;0;0;0;0;4;0;0;0;2;2;0
16009.0;2022;15;STRASBOURG;FEMININ;SCOLAIRE;BAC PROFESSIONNEL;BAC PRO SERV;BAC PRO 30001 GESTION-ADMINISTRATION;412;412;312;85;15;9;6;321;0;21;65;91;144;91
16018.0;2022;15;STRASBOURG;FEMININ;SCOLAIRE;BAC PROFESSIONNEL;BAC PRO SERV;BAC PRO 32208 REAL.PR.IMPR.PLURI.OPTB.PR.IMPR.;5;5;5;0;0;0;0;5;0;0;1;1;3;0
16021.0;2022;15;STRASBOURG;FEMININ;SCOLAIRE;BAC PROFESSIONNEL;BAC PRO SERV;BAC PRO 33004 ACC.SOINS-S.PERS. OPT.EN STRUCTUR;426;426;369;35;22;16;6;385;0;17;93;142;133;41
16022.0;2022;15;STRASBOURG;FEMININ;SCOLAIRE;BAC PROFESSIONNEL;BAC PRO SERV;BAC PRO 33101 OPTIQUE LUNETTERIE;8;8;8;0;0;0;0;8;0;2;1;5;0;0
16023.0;2022;15;STRASBOURG;FEMININ;SCOLAIRE;BAC PROFESSIONNEL;BAC PRO SERV;BAC PRO 33102 PROTHESE DENTAIRE;8;8;5;3;0;0;0;5;0;0;2;0;3;3
16033.0;2022;15;STRASBOURG;FEMININ;SCOLAIRE;BAC TECHNOLOGIQUE;BAC STI2D;BAC STI2D ARCHITECTURE ET CONSTRUCTION;40;40;36;2;2;2;0;38;0;2;3;12;21;2
16040.0;2022;15;STRASBOURG;FEMININ;SCOLAIRE;BAC TECHNOLOGIQUE;BAC STMG;BAC STMG MERCATIQUE (MARKETING);414;414;358;10;46;32;14;390;0;11;56;161;162;24
16055.0;2022;15;STRASBOURG;MASCULIN;APPRENTISSAGE;BAC PROFESSIONNEL;BAC PRO PROD;BAC PRO 25007 MAINTENANCE EQUIPEMENTS INDUST.;60;59;49;7;3;2;1;51;0;13;11;12;15;8
16059.0;2022;15;STRASBOURG;MASCULIN;APPRENTISSAGE;BAC PROFESSIONNEL;BAC PRO PROD;BAC PRO 25215 MAINT.VEHIC.OPTB VEHIC.TRANS.ROUT;26;25;22;2;1;1;0;23;0;3;7;6;7;2
16061.0;2022;15;STRASBOURG;MASCULIN;APPRENTISSAGE;BAC PROFESSIONNEL;BAC PRO PROD;BAC PRO 25219 MAINT.MATERIELS OPT.A AGRICOLES;12;12;12;0;0;0;0;12;0;3;1;4;4;0
16070.0;2022;15;STRASBOURG;MASCULIN;APPRENTISSAGE;BAC PROFESSIONNEL;BAC PRO PROD;BAC PRO 25514 SYST.NUM.OPT.B AUD.RES.EQUIP.DOM.;2;2;2;0;0;0;0;2;0;1;1;0;0;0
16072.0;2022;15;STRASBOURG;MASCULIN;APPRENTISSAGE;BAC PROFESSIONNEL;BAC PRO PROD;BAC PRO AG 21001 AGRO-EQUIPEMENT;24;24;22;2;0;0;0;22;0;0;2;6;14;2
16075.0;2022;15;STRASBOURG;MASCULIN;APPRENTISSAGE;BAC PROFESSIONNEL;BAC PRO PROD;BAC PRO AG 21114 CONDUITE PRODUCTIONS HORTICOLES;7;7;6;1;0;0;0;6;0;0;0;4;2;1
16083.0;2022;15;STRASBOURG;MASCULIN;APPRENTISSAGE;BAC PROFESSIONNEL;BAC PRO SERV;BAC PRO 32207 REAL.PR.IMPR.PLURI.OPTA.PR.GRAPH.;1;1;0;1;0;0;0;0;0;0;0;0;0;1
16092.0;2022;15;STRASBOURG;MASCULIN;FORMATION CONTINUE;BAC PROFESSIONNEL;BAC PRO PROD;BAC PRO 23205 INTERV. SUR PATRIMOINE BATI OPT.A;1;1;1;0;0;0;0;1;0;0;0;1;0;0
16102.0;2022;15;STRASBOURG;MASCULIN;INDIVIDUEL;BAC GENERAL;BAC GENERAL;BAC GENE 10019 BAC GENERAL;66;51;28;15;8;5;3;33;0;3;11;8;11;18
16104.0;2022;15;STRASBOURG;MASCULIN;INDIVIDUEL;BAC PROFESSIONNEL;BAC PRO PROD;BAC PRO 22703 TECHN.INSTALL.SYST.ENERG.CLIMATI;1;1;0;1;0;0;0;0;0;0;0;0;0;1
16111.0;2022;15;STRASBOURG;MASCULIN;INDIVIDUEL;BAC PROFESSIONNEL;BAC PRO PROD;BAC PRO 25216 MAINT.VEHIC.OPTC MOTOCYCLES;2;2;2;0;0;0;0;2;0;1;0;0;1;0
16121.0;2022;15;STRASBOURG;MASCULIN;INDIVIDUEL;BAC PROFESSIONNEL;BAC PRO SERV;BAC PRO 31213 MET.COM.VEN.OP.A ANI.GES.ESP.COM.;6;2;0;2;0;0;0;0;0;0;0;0;0;2
16124.0;2022;15;STRASBOURG;MASCULIN;INDIVIDUEL;BAC PROFESSIONNEL;BAC PRO SERV;BAC PRO 34304 HYGIENE PROPRETE STERILISATION;1;1;0;1;0;0;0;0;0;0;0;0;0;1
16130.0;2022;15;STRASBOURG;MASCULIN;INDIVIDUEL;BAC TECHNOLOGIQUE;BAC STMG;BAC STMG MERCATIQUE (MARKETING);6;3;0;2;1;1;0;1;0;0;0;0;1;2
16134.0;2022;15;STRASBOURG;MASCULIN;SCOLAIRE;BAC PROFESSIONNEL;BAC PRO PROD;BAC PRO 22003 BIO-INDUSTRIES DE TRANSFORMATION;15;15;12;3;0;0;0;12;0;0;2;2;8;3
16135.0;2022;15;STRASBOURG;MASCULIN;SCOLAIRE;BAC PROFESSIONNEL;BAC PRO PROD;BAC PRO 22004 PROC. CHIMIE EAU PAPIERS-CARTONS;17;17;14;2;1;1;0;15;0;0;1;7;7;2
16141.0;2022;15;STRASBOURG;MASCULIN;SCOLAIRE;BAC PROFESSIONNEL;BAC PRO PROD;BAC PRO 23004 TECHN. ETUDES BAT.A ETUDES & ECO.;26;26;19;7;0;0;0;19;0;0;1;3;15;7
16142.0;2022;15;STRASBOURG;MASCULIN;SCOLAIRE;BAC PROFESSIONNEL;BAC PRO PROD;BAC PRO 23005 TECHN. ETUDES BAT B ASSIST.ARCHI.;16;16;9;4;3;3;0;12;0;0;1;1;10;4
16145.0;2022;15;STRASBOURG;MASCULIN;SCOLAIRE;BAC PROFESSIONNEL;BAC PRO PROD;BAC PRO 23205 INTERV. SUR PATRIMOINE BATI OPT.A;4;4;1;2;1;1;0;2;0;0;0;1;1;2
16146.0;2022;15;STRASBOURG;MASCULIN;SCOLAIRE;BAC PROFESSIONNEL;BAC PRO PROD;BAC PRO 23303 MENUISERIE ALUMINIUM-VERRE;5;5;3;1;1;1;0;4;0;0;0;0;4;1
16147.0;2022;15;STRASBOURG;MASCULIN;SCOLAIRE;BAC PROFESSIONNEL;BAC PRO PROD;BAC PRO 23404 TECHNICIEN CONSTRUCTEUR BOIS;20;20;10;9;1;1;0;11;0;0;1;1;9;9
16152.0;2022;15;STRASBOURG;MASCULIN;SCOLAIRE;BAC PROFESSIONNEL;BAC PRO PROD;BAC PRO 25007 MAINTENANCE EQUIPEMENTS INDUST.;186;186;135;44;7;5;2;140;0;3;36;43;58;46
16156.0;2022;15;STRASBOURG;MASCULIN;SCOLAIRE;BAC PROFESSIONNEL;BAC PRO PROD;BAC PRO 25215 MAINT.VEHIC.OPTB VEHIC.TRANS.ROUT;25;25;15;7;3;3;0;18;0;1;1;8;8;7
16168.0;2022;15;STRASBOURG;MASCULIN;SCOLAIRE;BAC PROFESSIONNEL;BAC PRO PROD;BAC PRO AG 21004 CGEA;22;22;20;2;0;0;0;20;0;2;3;7;8;2
16169.0;2022;15;STRASBOURG;MASCULIN;SCOLAIRE;BAC PROFESSIONNEL;BAC PRO PROD;BAC PRO AG 21113 CGEVV;10;10;6;4;0;0;0;6;0;1;0;3;2;4
16178.0;2022;15;STRASBOURG;MASCULIN;SCOLAIRE;BAC PROFESSIONNEL;BAC PRO SERV;BAC PRO 31107 CONDUCT. TRANSP.ROUT.MARCHANDISES;44;44;33;7;4;2;2;35;0;2;10;14;9;9
16179.0;2022;15;STRASBOURG;MASCULIN;SCOLAIRE;BAC PROFESSIONNEL;BAC PRO SERV;BAC PRO 31108 TRANSPORT;17;17;9;8;0;0;0;9;0;0;4;4;1;8
16182.0;2022;15;STRASBOURG;MASCULIN;SCOLAIRE;BAC PROFESSIONNEL;BAC PRO SERV;BAC PRO 31213 MET.COM.VEN.OP.A ANI.GES.ESP.COM.;377;376;273;62;41;28;13;301;0;8;43;120;130;75
16191.0;2022;15;STRASBOURG;MASCULIN;SCOLAIRE;BAC PROFESSIONNEL;BAC PRO SERV;BAC PRO 33403 COMMERC. SERVICES EN RESTAURATION;34;34;29;2;3;2;1;31;0;1;12;13;5;3
16195.0;2022;15;STRASBOURG;MASCULIN;SCOLAIRE;BAC PROFESSIONNEL;BAC PRO SERV;BAC PRO AG 33002 SERV PERS TERRIT;7;7;6;1;0;0;0;6;0;0;0;4;2;1
16198.0;2022;15;STRASBOURG;MASCULIN;SCOLAIRE;BAC TECHNOLOGIQUE;BAC STD2A;BAC STD2A SCIENCES & TECHNO. DESIGN-ARTS APPLIQUES;19;19;19;0;0;0;0;19;0;3;5;7;4;0
16202.0;2022;15;STRASBOURG;MASCULIN;SCOLAIRE;BAC TECHNOLOGIQUE;BAC STI2D;BAC STI2D INNOVATION TECHNO.  ET ECO CONCEPTION;226;226;189;12;25;11;14;200;0;7;46;77;70;26
16209.0;2022;15;STRASBOURG;MASCULIN;SCOLAIRE;BAC TECHNOLOGIQUE;BAC STMG;BAC STMG SYSTEMES D'INFORMATION DE GESTION;38;38;27;3;8;5;3;32;0;0;1;6;25;6
16217.0;2022;16;TOULOUSE;FEMININ;APPRENTISSAGE;BAC PROFESSIONNEL;BAC PRO PROD;BAC PRO 24203 METIERS DE LA MODE - VÊTEMENT;1;1;1;0;0;0;0;1;0;0;1;0;0;0
16218.0;2022;16;TOULOUSE;FEMININ;APPRENTISSAGE;BAC PROFESSIONNEL;BAC PRO PROD;BAC PRO 24302 METIERS DU CUIR : MAROQUINERIE;1;1;1;0;0;0;0;1;0;1;0;0;0;0
16222.0;2022;16;TOULOUSE;FEMININ;APPRENTISSAGE;BAC PROFESSIONNEL;BAC PRO PROD;BAC PRO 25215 MAINT.VEHIC.OPTB VEHIC.TRANS.ROUT;1;1;1;0;0;0;0;1;0;0;0;1;0;0
16226.0;2022;16;TOULOUSE;FEMININ;APPRENTISSAGE;BAC PROFESSIONNEL;BAC PRO PROD;BAC PRO 25304 AERONAUTIQUE OPTION STRUCTURE;16;16;16;0;0;0;0;16;0;5;3;6;2;0
16227.0;2022;16;TOULOUSE;FEMININ;APPRENTISSAGE;BAC PROFESSIONNEL;BAC PRO PROD;BAC PRO 25408 REPARATION DES CARROSSERIES;2;2;2;0;0;0;0;2;0;0;0;0;2;0
16228.0;2022;16;TOULOUSE;FEMININ;APPRENTISSAGE;BAC PROFESSIONNEL;BAC PRO PROD;BAC PRO 25411 TECH.CHAUDRONNERIE INDUSTRIELLE;7;7;7;0;0;0;0;7;0;3;2;2;0;0
16235.0;2022;16;TOULOUSE;FEMININ;APPRENTISSAGE;BAC PROFESSIONNEL;BAC PRO SERV;BAC PRO 30001 GESTION-ADMINISTRATION;19;19;12;7;0;0;0;12;0;2;1;6;3;7
16240.0;2022;16;TOULOUSE;FEMININ;APPRENTISSAGE;BAC PROFESSIONNEL;BAC PRO SERV;BAC PRO 32207 REAL.PR.IMPR.PLURI.OPTA.PR.GRAPH.;1;1;1;0;0;0;0;1;0;0;1;0;0;0
16248.0;2022;16;TOULOUSE;FEMININ;APPRENTISSAGE;BAC PROFESSIONNEL;BAC PRO SERV;BAC PRO 34304 HYGIENE PROPRETE STERILISATION;21;21;16;4;1;0;1;16;0;5;2;7;2;5
16249.0;2022;16;TOULOUSE;FEMININ;APPRENTISSAGE;BAC PROFESSIONNEL;BAC PRO SERV;BAC PRO AG 33002 SERV PERS TERRIT;4;4;2;2;0;0;0;2;0;0;2;0;0;2
16251.0;2022;16;TOULOUSE;FEMININ;ENSEIGNEMENT A DISTANCE;BAC PROFESSIONNEL;BAC PRO SERV;BAC PRO 30001 GESTION-ADMINISTRATION;4;3;0;3;0;0;0;0;0;0;0;0;0;3
16255.0;2022;16;TOULOUSE;FEMININ;ENSEIGNEMENT A DISTANCE;BAC PROFESSIONNEL;BAC PRO SERV;BAC PRO 33603 ESTHETIQUE COSMETIQUE PARFUMERIE;3;1;1;0;0;0;0;1;0;0;0;0;1;0
16257.0;2022;16;TOULOUSE;FEMININ;ENSEIGNEMENT A DISTANCE;BAC TECHNOLOGIQUE;BAC STMG;BAC STMG MERCATIQUE (MARKETING);5;5;4;0;1;1;0;5;0;0;1;3;1;0
16262.0;2022;16;TOULOUSE;FEMININ;FORMATION CONTINUE;BAC PROFESSIONNEL;BAC PRO SERV;BAC PRO 31213 MET.COM.VEN.OP.A ANI.GES.ESP.COM.;2;1;1;0;0;0;0;1;0;0;0;1;0;0
16263.0;2022;16;TOULOUSE;FEMININ;FORMATION CONTINUE;BAC PROFESSIONNEL;BAC PRO SERV;BAC PRO 31214 MET.COM.VEN.OP.B PR.CL.VA.OF.COM.;3;3;3;0;0;0;0;3;0;0;1;2;0;0
16266.0;2022;16;TOULOUSE;FEMININ;INDIVIDUEL;BAC PROFESSIONNEL;BAC PRO PROD;BAC PRO 23003 ARTIS. & M.ART:MARCHANDISAGE VIS.;1;1;0;1;0;0;0;0;0;0;0;0;0;1
16269.0;2022;16;TOULOUSE;FEMININ;INDIVIDUEL;BAC PROFESSIONNEL;BAC PRO PROD;BAC PRO AG 21113 CGEVV;1;1;1;0;0;0;0;1;0;0;0;0;1;0
16275.0;2022;16;TOULOUSE;FEMININ;INDIVIDUEL;BAC PROFESSIONNEL;BAC PRO SERV;BAC PRO 31214 MET.COM.VEN.OP.B PR.CL.VA.OF.COM.;1;1;0;1;0;0;0;0;0;0;0;0;0;1
16281.0;2022;16;TOULOUSE;FEMININ;INDIVIDUEL;BAC TECHNOLOGIQUE;BAC STAV;BAC STAV AGRONOMIE ALIM ENV TERRITOI;1;1;0;1;0;0;0;0;0;0;0;0;0;1
16284.0;2022;16;TOULOUSE;FEMININ;INDIVIDUEL;BAC TECHNOLOGIQUE;BAC STMG;BAC STMG MERCATIQUE (MARKETING);4;2;2;0;0;0;0;2;0;0;0;1;1;0
16296.0;2022;16;TOULOUSE;FEMININ;SCOLAIRE;BAC PROFESSIONNEL;BAC PRO PROD;BAC PRO 23004 TECHN. ETUDES BAT.A ETUDES & ECO.;7;7;3;4;0;0;0;3;0;0;1;0;2;4
16311.0;2022;16;TOULOUSE;FEMININ;SCOLAIRE;BAC PROFESSIONNEL;BAC PRO PROD;BAC PRO 25304 AERONAUTIQUE OPTION STRUCTURE;2;2;1;1;0;0;0;1;0;0;0;0;1;1
16312.0;2022;16;TOULOUSE;FEMININ;SCOLAIRE;BAC PROFESSIONNEL;BAC PRO PROD;BAC PRO 25408 REPARATION DES CARROSSERIES;1;1;1;0;0;0;0;1;0;0;0;1;0;0
16313.0;2022;16;TOULOUSE;FEMININ;SCOLAIRE;BAC PROFESSIONNEL;BAC PRO PROD;BAC PRO 25510 METIERS ELECT. ENVIRON. CONNECTES;8;8;8;0;0;0;0;8;0;0;2;3;3;0
16319.0;2022;16;TOULOUSE;FEMININ;SCOLAIRE;BAC PROFESSIONNEL;BAC PRO PROD;BAC PRO AG 21114 CONDUITE PRODUCTIONS HORTICOLES;16;16;9;7;0;0;0;9;0;0;1;5;3;7
16322.0;2022;16;TOULOUSE;FEMININ;SCOLAIRE;BAC PROFESSIONNEL;BAC PRO PROD;BAC PRO AG 21211 COND GEST ENTR HIPPIQUE;54;51;46;5;0;0;0;46;0;2;8;18;18;5
16323.0;2022;16;TOULOUSE;FEMININ;SCOLAIRE;BAC PROFESSIONNEL;BAC PRO PROD;BAC PRO AG 21302 GEST MILIEUX NATURELS FAUNE;15;15;15;0;0;0;0;15;0;1;2;6;6;0
16324.0;2022;16;TOULOUSE;FEMININ;SCOLAIRE;BAC PROFESSIONNEL;BAC PRO PROD;BAC PRO AG 21303 FORET;1;1;1;0;0;0;0;1;0;0;0;1;0;0
16327.0;2022;16;TOULOUSE;FEMININ;SCOLAIRE;BAC PROFESSIONNEL;BAC PRO PROD;BAC PRO AG 22105 LABORATOIRE CONTROLE QUALITE;6;6;6;0;0;0;0;6;0;1;0;3;2;0
16329.0;2022;16;TOULOUSE;FEMININ;SCOLAIRE;BAC PROFESSIONNEL;BAC PRO SERV;BAC PRO 30001 GESTION-ADMINISTRATION;452;449;320;106;23;21;2;341;0;6;55;125;155;108
16331.0;2022;16;TOULOUSE;FEMININ;SCOLAIRE;BAC PROFESSIONNEL;BAC PRO SERV;BAC PRO 31107 CONDUCT. TRANSP.ROUT.MARCHANDISES;4;4;2;1;1;1;0;3;0;1;0;1;1;1
16334.0;2022;16;TOULOUSE;FEMININ;SCOLAIRE;BAC PROFESSIONNEL;BAC PRO SERV;BAC PRO 31213 MET.COM.VEN.OP.A ANI.GES.ESP.COM.;409;407;354;33;20;14;6;368;0;15;80;150;123;39
16341.0;2022;16;TOULOUSE;FEMININ;SCOLAIRE;BAC PROFESSIONNEL;BAC PRO SERV;BAC PRO 33003 ACC.SOINS-S.PERS. OPT.A DOMICILE;55;55;37;12;6;3;3;40;0;1;3;12;24;15
16346.0;2022;16;TOULOUSE;FEMININ;SCOLAIRE;BAC PROFESSIONNEL;BAC PRO SERV;BAC PRO 33403 COMMERC. SERVICES EN RESTAURATION;76;76;63;11;2;1;1;64;0;2;8;20;34;12
16357.0;2022;16;TOULOUSE;FEMININ;SCOLAIRE;BAC TECHNOLOGIQUE;BAC STD2A;BAC STD2A SCIENCES & TECHNO. DESIGN-ARTS APPLIQUES;122;122;118;2;2;2;0;120;1;11;47;42;19;2
16362.0;2022;16;TOULOUSE;FEMININ;SCOLAIRE;BAC TECHNOLOGIQUE;BAC STI2D;BAC STI2D SYSTÈME D'INFORMATION  ET NUMERIQUE;20;20;18;0;2;2;0;20;0;0;2;9;9;0
16374.0;2022;16;TOULOUSE;MASCULIN;APPRENTISSAGE;BAC PROFESSIONNEL;BAC PRO PROD;BAC PRO 22703 TECHN.INSTALL.SYST.ENERG.CLIMATI;33;32;22;9;1;1;0;23;0;2;2;7;12;9
16379.0;2022;16;TOULOUSE;MASCULIN;APPRENTISSAGE;BAC PROFESSIONNEL;BAC PRO PROD;BAC PRO 23102 TRAVAUX PUBLICS;14;13;13;0;0;0;0;13;0;2;2;6;3;0
16380.0;2022;16;TOULOUSE;MASCULIN;APPRENTISSAGE;BAC PROFESSIONNEL;BAC PRO PROD;BACPRO 23103 TECHNICIEN GEOMETRE-TOPOGRAPHE;1;1;0;1;0;0;0;0;0;0;0;0;0;1
16387.0;2022;16;TOULOUSE;MASCULIN;APPRENTISSAGE;BAC PROFESSIONNEL;BAC PRO PROD;BAC PRO 23405 TECHNICIEN MENUISIER AGENCEUR;6;6;6;0;0;0;0;6;0;3;0;2;1;0
16396.0;2022;16;TOULOUSE;MASCULIN;APPRENTISSAGE;BAC PROFESSIONNEL;BAC PRO PROD;BAC PRO 25220 MAINT.MATERIELS OPT.B TP MANUT.;12;12;9;3;0;0;0;9;0;0;2;0;7;3
16400.0;2022;16;TOULOUSE;MASCULIN;APPRENTISSAGE;BAC PROFESSIONNEL;BAC PRO PROD;BAC PRO 25304 AERONAUTIQUE OPTION STRUCTURE;36;36;35;1;0;0;0;35;0;9;10;11;5;1
16401.0;2022;16;TOULOUSE;MASCULIN;APPRENTISSAGE;BAC PROFESSIONNEL;BAC PRO PROD;BAC PRO 25406 OUVRAGES DU BATIMENT METALLERIE;6;6;3;0;3;2;1;5;0;0;1;1;3;1
16402.0;2022;16;TOULOUSE;MASCULIN;APPRENTISSAGE;BAC PROFESSIONNEL;BAC PRO PROD;BAC PRO 25408 REPARATION DES CARROSSERIES;17;17;9;4;4;4;0;13;0;1;3;3;6;4
16406.0;2022;16;TOULOUSE;MASCULIN;APPRENTISSAGE;BAC PROFESSIONNEL;BAC PRO PROD;BAC PRO 25515 SYST.NUM.OPT.C RES.INF.SYST.COMM.;7;7;5;2;0;0;0;5;0;0;2;2;1;2
16410.0;2022;16;TOULOUSE;MASCULIN;APPRENTISSAGE;BAC PROFESSIONNEL;BAC PRO SERV;BAC PRO 30001 GESTION-ADMINISTRATION;2;2;2;0;0;0;0;2;0;0;0;2;0;0
16411.0;2022;16;TOULOUSE;MASCULIN;APPRENTISSAGE;BAC PROFESSIONNEL;BAC PRO SERV;BAC PRO 31106 LOGISTIQUE;17;17;13;3;1;1;0;14;0;1;4;3;6;3
16417.0;2022;16;TOULOUSE;MASCULIN;APPRENTISSAGE;BAC PROFESSIONNEL;BAC PRO SERV;BAC PRO 33102 PROTHESE DENTAIRE;4;4;4;0;0;0;0;4;0;0;2;2;0;0
16420.0;2022;16;TOULOUSE;MASCULIN;APPRENTISSAGE;BAC PROFESSIONNEL;BAC PRO SERV;BAC PRO AG 33002 SERV PERS TERRIT;2;2;2;0;0;0;0;2;0;0;0;0;2;0
16430.0;2022;16;TOULOUSE;MASCULIN;FORMATION CONTINUE;BAC PROFESSIONNEL;BAC PRO PROD;BAC PRO 22004 PROC. CHIMIE EAU PAPIERS-CARTONS;5;5;5;0;0;0;0;5;0;4;1;0;0;0
16434.0;2022;16;TOULOUSE;MASCULIN;FORMATION CONTINUE;BAC PROFESSIONNEL;BAC PRO PROD;BAC PRO 25215 MAINT.VEHIC.OPTB VEHIC.TRANS.ROUT;1;1;1;0;0;0;0;1;0;1;0;0;0;0
16454.0;2022;16;TOULOUSE;MASCULIN;INDIVIDUEL;BAC PROFESSIONNEL;BAC PRO PROD;BAC PRO AG 21004 CGEA;9;5;5;0;0;0;0;5;0;0;0;0;5;0
16457.0;2022;16;TOULOUSE;MASCULIN;INDIVIDUEL;BAC PROFESSIONNEL;BAC PRO PROD;BAC PRO AG 21203 TECHN CONSEIL DE VENTE ANIMAL;1;1;0;1;0;0;0;0;0;0;0;0;0;1
16459.0;2022;16;TOULOUSE;MASCULIN;INDIVIDUEL;BAC PROFESSIONNEL;BAC PRO SERV;BAC PRO 30001 GESTION-ADMINISTRATION;6;3;2;1;0;0;0;2;0;0;0;0;2;1
16481.0;2022;16;TOULOUSE;MASCULIN;SCOLAIRE;BAC PROFESSIONNEL;BAC PRO PROD;BAC PRO 22503 PLASTIQUES ET COMPOSITES;10;10;7;3;0;0;0;7;0;0;1;4;2;3
16486.0;2022;16;TOULOUSE;MASCULIN;SCOLAIRE;BAC PROFESSIONNEL;BAC PRO PROD;BAC PRO 23004 TECHN. ETUDES BAT.A ETUDES & ECO.;57;57;41;16;0;0;0;41;0;0;6;19;16;16
16487.0;2022;16;TOULOUSE;MASCULIN;SCOLAIRE;BAC PROFESSIONNEL;BAC PRO PROD;BAC PRO 23005 TECHN. ETUDES BAT B ASSIST.ARCHI.;39;39;33;6;0;0;0;33;0;1;4;11;17;6
16498.0;2022;16;TOULOUSE;MASCULIN;SCOLAIRE;BAC PROFESSIONNEL;BAC PRO PROD;BAC PRO 23408 Etude et réalisation d'agencement;5;5;2;3;0;0;0;2;0;0;0;1;1;3
16501.0;2022;16;TOULOUSE;MASCULIN;SCOLAIRE;BAC PROFESSIONNEL;BAC PRO PROD;BAC PRO 24302 METIERS DU CUIR : MAROQUINERIE;2;2;2;0;0;0;0;2;0;0;2;0;0;0
16506.0;2022;16;TOULOUSE;MASCULIN;SCOLAIRE;BAC PROFESSIONNEL;BAC PRO PROD;BAC PRO 25108 TECHNICIEN MODELEUR;8;8;6;2;0;0;0;6;0;2;0;3;1;2
16518.0;2022;16;TOULOUSE;MASCULIN;SCOLAIRE;BAC PROFESSIONNEL;BAC PRO PROD;BAC PRO 25411 TECH.CHAUDRONNERIE INDUSTRIELLE;84;84;67;11;6;4;2;71;0;3;27;23;18;13
16524.0;2022;16;TOULOUSE;MASCULIN;SCOLAIRE;BAC PROFESSIONNEL;BAC PRO PROD;BAC PRO AG 21001 AGRO-EQUIPEMENT;30;29;21;8;0;0;0;21;0;0;3;4;14;8
16525.0;2022;16;TOULOUSE;MASCULIN;SCOLAIRE;BAC PROFESSIONNEL;BAC PRO PROD;BAC PRO AG 21004 CGEA;193;188;159;29;0;0;0;159;0;3;22;63;71;29
16530.0;2022;16;TOULOUSE;MASCULIN;SCOLAIRE;BAC PROFESSIONNEL;BAC PRO PROD;BAC PRO AG 21211 COND GEST ENTR HIPPIQUE;2;2;1;1;0;0;0;1;0;0;0;1;0;1
16532.0;2022;16;TOULOUSE;MASCULIN;SCOLAIRE;BAC PROFESSIONNEL;BAC PRO PROD;BAC PRO AG 21303 FORET;17;17;16;1;0;0;0;16;0;0;2;6;8;1
16539.0;2022;16;TOULOUSE;MASCULIN;SCOLAIRE;BAC PROFESSIONNEL;BAC PRO SERV;BAC PRO 31107 CONDUCT. TRANSP.ROUT.MARCHANDISES;42;42;35;6;1;1;0;36;0;1;6;19;10;6
16545.0;2022;16;TOULOUSE;MASCULIN;SCOLAIRE;BAC PROFESSIONNEL;BAC PRO SERV;BAC PRO 32208 REAL.PR.IMPR.PLURI.OPTB.PR.IMPR.;9;9;9;0;0;0;0;9;0;2;4;2;1;0
16552.0;2022;16;TOULOUSE;MASCULIN;SCOLAIRE;BAC PROFESSIONNEL;BAC PRO SERV;BAC PRO 33102 PROTHESE DENTAIRE;11;10;10;0;0;0;0;10;0;0;3;4;3;0
16557.0;2022;16;TOULOUSE;MASCULIN;SCOLAIRE;BAC PROFESSIONNEL;BAC PRO SERV;BAC PRO 34403 METIERS DE LA SECURITE;49;49;46;1;2;1;1;47;0;3;18;17;9;2
16559.0;2022;16;TOULOUSE;MASCULIN;SCOLAIRE;BAC TECHNOLOGIQUE;BAC S2TMD;BAC S2TMD DANSE;2;2;2;0;0;0;0;2;0;0;0;2;0;0
16573.0;2022;16;TOULOUSE;MASCULIN;SCOLAIRE;BAC TECHNOLOGIQUE;BAC STMG;BAC STMG MERCATIQUE (MARKETING);727;727;569;38;120;84;36;653;0;2;52;191;408;74
16599.0;2022;25;VERSAILLES;FEMININ;APPRENTISSAGE;BAC PROFESSIONNEL;BAC PRO SERV;BAC PRO 33403 COMMERC. SERVICES EN RESTAURATION;21;21;17;3;1;1;0;18;0;1;8;2;7;3
16601.0;2022;25;VERSAILLES;FEMININ;APPRENTISSAGE;BAC PROFESSIONNEL;BAC PRO SERV;BAC PRO 34304 HYGIENE PROPRETE STERILISATION;5;5;3;2;0;0;0;3;0;0;0;2;1;2
16602.0;2022;25;VERSAILLES;FEMININ;APPRENTISSAGE;BAC PROFESSIONNEL;BAC PRO SERV;BAC PRO 34403 METIERS DE LA SECURITE;10;10;7;3;0;0;0;7;0;1;0;2;4;3
16605.0;2022;25;VERSAILLES;FEMININ;ENSEIGNEMENT A DISTANCE;BAC PROFESSIONNEL;BAC PRO SERV;BAC PRO 30001 GESTION-ADMINISTRATION;6;2;1;1;0;0;0;1;0;0;0;1;0;1
16618.0;2022;25;VERSAILLES;FEMININ;FORMATION CONTINUE;BAC PROFESSIONNEL;BAC PRO PROD;BAC PRO 23004 TECHN. ETUDES BAT.A ETUDES & ECO.;1;1;0;1;0;0;0;0;0;0;0;0;0;1
16627.0;2022;25;VERSAILLES;FEMININ;INDIVIDUEL;BAC GENERAL;BAC GENERAL;BAC GENE 10019 BAC GENERAL;334;229;146;58;25;10;15;156;2;36;47;26;45;73
16631.0;2022;25;VERSAILLES;FEMININ;INDIVIDUEL;BAC PROFESSIONNEL;BAC PRO PROD;BAC PRO AG 21114 CONDUITE PRODUCTIONS HORTICOLES;5;3;3;0;0;0;0;3;0;0;0;0;3;0
16632.0;2022;25;VERSAILLES;FEMININ;INDIVIDUEL;BAC PROFESSIONNEL;BAC PRO PROD;BAC PRO AG 21203 TECHN CONSEIL DE VENTE ANIMAL;1;1;0;1;0;0;0;0;0;0;0;0;0;1
16638.0;2022;25;VERSAILLES;FEMININ;INDIVIDUEL;BAC PROFESSIONNEL;BAC PRO SERV;BAC PRO 32303 ART.& MET.ART:COM.VIS.VIS.PLURI-M;3;3;1;2;0;0;0;1;0;0;0;0;1;2
16645.0;2022;25;VERSAILLES;FEMININ;INDIVIDUEL;BAC PROFESSIONNEL;BAC PRO SERV;BAC PRO 34403 METIERS DE LA SECURITE;1;0;0;0;0;0;0;0;0;0;0;0;0;0
16646.0;2022;25;VERSAILLES;FEMININ;INDIVIDUEL;BAC TECHNOLOGIQUE;BAC ST2S;BAC ST2S SCIENCES & TECHNO. SANTE & SOCIAL;36;22;7;9;6;3;3;10;0;0;1;4;5;12
16647.0;2022;25;VERSAILLES;FEMININ;INDIVIDUEL;BAC TECHNOLOGIQUE;BAC STD2A;BAC STD2A SCIENCES & TECHNO. DESIGN-ARTS APPLIQUES;4;2;1;0;1;1;0;2;0;0;0;1;1;0
16648.0;2022;25;VERSAILLES;FEMININ;INDIVIDUEL;BAC TECHNOLOGIQUE;BAC STMG;BAC STMG GESTION ET FINANCE;15;8;1;3;4;3;1;4;0;0;0;0;4;4
16649.0;2022;25;VERSAILLES;FEMININ;INDIVIDUEL;BAC TECHNOLOGIQUE;BAC STMG;BAC STMG MERCATIQUE (MARKETING);39;30;17;8;5;4;1;21;0;0;1;7;13;9
16653.0;2022;25;VERSAILLES;FEMININ;SCOLAIRE;BAC PROFESSIONNEL;BAC PRO PROD;BACPRO 20002 ETUD.DEFINITION PRDTS INDUSTRIEL;4;4;3;1;0;0;0;3;0;0;1;0;2;1
16654.0;2022;25;VERSAILLES;FEMININ;SCOLAIRE;BAC PROFESSIONNEL;BAC PRO PROD;BAC PRO 22004 PROC. CHIMIE EAU PAPIERS-CARTONS;1;1;1;0;0;0;0;1;0;0;1;0;0;0
16664.0;2022;25;VERSAILLES;FEMININ;SCOLAIRE;BAC PROFESSIONNEL;BAC PRO PROD;BAC PRO 24202 ARTIS.& MET.ART : TAPIS.D'AMEUBL;2;2;2;0;0;0;0;2;0;0;1;0;1;0
16669.0;2022;25;VERSAILLES;FEMININ;SCOLAIRE;BAC PROFESSIONNEL;BAC PRO PROD;BAC PRO 25106 TECHNICIEN D'USINAGE;3;3;2;1;0;0;0;2;0;0;0;0;2;1
16670.0;2022;25;VERSAILLES;FEMININ;SCOLAIRE;BAC PROFESSIONNEL;BAC PRO PROD;BAC PRO 25108 TECHNICIEN MODELEUR;4;4;4;0;0;0;0;4;0;1;3;0;0;0
16677.0;2022;25;VERSAILLES;FEMININ;SCOLAIRE;BAC PROFESSIONNEL;BAC PRO PROD;BAC PRO 25408 REPARATION DES CARROSSERIES;3;3;2;1;0;0;0;2;0;0;0;2;0;1
16683.0;2022;25;VERSAILLES;FEMININ;SCOLAIRE;BAC PROFESSIONNEL;BAC PRO PROD;BAC PRO AG 21004 CGEA;8;7;6;1;0;0;0;6;0;0;1;1;4;1
16686.0;2022;25;VERSAILLES;FEMININ;SCOLAIRE;BAC PROFESSIONNEL;BAC PRO PROD;BAC PRO AG 21302 GEST MILIEUX NATURELS FAUNE;8;8;7;1;0;0;0;7;0;1;0;4;2;1
16692.0;2022;25;VERSAILLES;FEMININ;SCOLAIRE;BAC PROFESSIONNEL;BAC PRO SERV;BAC PRO 31212 METIERS DE L'ACCUEIL;485;483;367;68;48;31;17;398;0;26;87;120;165;85
16695.0;2022;25;VERSAILLES;FEMININ;SCOLAIRE;BAC PROFESSIONNEL;BAC PRO SERV;BAC PRO 32206 FACONNAGE PRODTS IMPRIMES ROUTAGE;1;1;0;1;0;0;0;0;0;0;0;0;0;1
16720.0;2022;25;VERSAILLES;FEMININ;SCOLAIRE;BAC TECHNOLOGIQUE;BAC STL;BAC STL SCIENCES PHYSIQUES CHIMIQUES  EN LABORAT.;68;68;54;2;12;7;5;61;0;3;15;19;24;7
16726.0;2022;25;VERSAILLES;MASCULIN;APPRENTISSAGE;BAC PROFESSIONNEL;BAC PRO PROD;BAC PRO 22106 CUISINE;84;82;63;16;3;2;1;65;0;6;21;23;15;17
16734.0;2022;25;VERSAILLES;MASCULIN;APPRENTISSAGE;BAC PROFESSIONNEL;BAC PRO PROD;BAC PRO 25006 MICROTECHNIQUES;1;1;0;1;0;0;0;0;0;0;0;0;0;1
16736.0;2022;25;VERSAILLES;MASCULIN;APPRENTISSAGE;BAC PROFESSIONNEL;BAC PRO PROD;BAC PRO 25106 TECHNICIEN D'USINAGE;18;17;14;3;0;0;0;14;0;0;3;5;6;3
16743.0;2022;25;VERSAILLES;MASCULIN;APPRENTISSAGE;BAC PROFESSIONNEL;BAC PRO PROD;BAC PRO 25302 AERONAUTIQUE OPTION AVIONIQUE;6;6;6;0;0;0;0;6;0;1;4;0;1;0
16746.0;2022;25;VERSAILLES;MASCULIN;APPRENTISSAGE;BAC PROFESSIONNEL;BAC PRO PROD;BAC PRO 25408 REPARATION DES CARROSSERIES;92;87;69;16;2;1;1;70;0;7;11;31;21;17
16750.0;2022;25;VERSAILLES;MASCULIN;APPRENTISSAGE;BAC PROFESSIONNEL;BAC PRO PROD;BAC PRO 25513 SYST.NUM.OPT.A SURETE SECURITE;9;9;8;0;1;0;1;8;0;0;2;5;1;1
16753.0;2022;25;VERSAILLES;MASCULIN;APPRENTISSAGE;BAC PROFESSIONNEL;BAC PRO PROD;BAC PRO AG 21203 TECHN CONSEIL DE VENTE ANIMAL;10;8;8;0;0;0;0;8;0;0;1;2;5;0
16757.0;2022;25;VERSAILLES;MASCULIN;APPRENTISSAGE;BAC PROFESSIONNEL;BAC PRO SERV;BAC PRO 31106 LOGISTIQUE;37;34;25;8;1;0;1;25;0;0;7;8;10;9
16765.0;2022;25;VERSAILLES;MASCULIN;APPRENTISSAGE;BAC PROFESSIONNEL;BAC PRO SERV;BAC PRO 34304 HYGIENE PROPRETE STERILISATION;10;10;6;4;0;0;0;6;0;0;1;0;5;4
16766.0;2022;25;VERSAILLES;MASCULIN;APPRENTISSAGE;BAC PROFESSIONNEL;BAC PRO SERV;BAC PRO 34403 METIERS DE LA SECURITE;20;19;14;3;2;2;0;16;0;0;1;7;8;3
16778.0;2022;25;VERSAILLES;MASCULIN;FORMATION CONTINUE;BAC PROFESSIONNEL;BAC PRO PROD;BAC PRO 20102 PILOTE DE LIGNE DE PRODUCTION;9;9;8;1;0;0;0;8;0;1;3;2;2;1
16779.0;2022;25;VERSAILLES;MASCULIN;FORMATION CONTINUE;BAC PROFESSIONNEL;BAC PRO PROD;BAC PRO 22106 CUISINE;1;1;1;0;0;0;0;1;0;0;0;0;1;0
16785.0;2022;25;VERSAILLES;MASCULIN;FORMATION CONTINUE;BAC PROFESSIONNEL;BAC PRO SERV;BAC PRO 30001 GESTION-ADMINISTRATION;5;3;3;0;0;0;0;3;0;0;1;1;1;0
16787.0;2022;25;VERSAILLES;MASCULIN;FORMATION CONTINUE;BAC PROFESSIONNEL;BAC PRO SERV;BAC PRO 32303 ART.& MET.ART:COM.VIS.VIS.PLURI-M;7;5;5;0;0;0;0;5;0;0;3;0;2;0
16796.0;2022;25;VERSAILLES;MASCULIN;INDIVIDUEL;BAC PROFESSIONNEL;BAC PRO PROD;BAC PRO 22704 TECHN. MAINT. SYST.ENERG.CLIMATI;4;3;0;2;1;1;0;1;0;0;0;0;1;2
16797.0;2022;25;VERSAILLES;MASCULIN;INDIVIDUEL;BAC PROFESSIONNEL;BAC PRO PROD;BAC PRO 23004 TECHN. ETUDES BAT.A ETUDES & ECO.;1;1;1;0;0;0;0;1;0;0;0;0;1;0
16802.0;2022;25;VERSAILLES;MASCULIN;INDIVIDUEL;BAC PROFESSIONNEL;BAC PRO PROD;BAC PRO 25214 MAINT.VEHIC.OPTA VOIT.PARTICUL.;1;1;1;0;0;0;0;1;0;0;1;0;0;0
16805.0;2022;25;VERSAILLES;MASCULIN;INDIVIDUEL;BAC PROFESSIONNEL;BAC PRO PROD;BAC PRO 25303 AERONAUTIQUE OPTION SYSTEMES;2;2;2;0;0;0;0;2;0;0;0;0;2;0
16812.0;2022;25;VERSAILLES;MASCULIN;INDIVIDUEL;BAC PROFESSIONNEL;BAC PRO PROD;BAC PRO AG 21203 TECHN CONSEIL DE VENTE ANIMAL;1;0;0;0;0;0;0;0;0;0;0;0;0;0
16826.0;2022;25;VERSAILLES;MASCULIN;INDIVIDUEL;BAC PROFESSIONNEL;BAC PRO SERV;BAC PRO 33004 ACC.SOINS-S.PERS. OPT.EN STRUCTUR;1;1;1;0;0;0;0;1;0;0;0;1;0;0
16827.0;2022;25;VERSAILLES;MASCULIN;INDIVIDUEL;BAC PROFESSIONNEL;BAC PRO SERV;BAC PRO 34403 METIERS DE LA SECURITE;1;1;1;0;0;0;0;1;0;0;0;0;1;0
16831.0;2022;25;VERSAILLES;MASCULIN;INDIVIDUEL;BAC TECHNOLOGIQUE;BAC STHR;BAC STHR SC.&TEC. HOTELLERIE-RESTAURATION;1;0;0;0;0;0;0;0;0;0;0;0;0;0
16835.0;2022;25;VERSAILLES;MASCULIN;INDIVIDUEL;BAC TECHNOLOGIQUE;BAC STI2D;BAC STI2D SYSTÈME D'INFORMATION  ET NUMERIQUE;6;6;2;1;3;3;0;5;0;0;0;1;4;1
16838.0;2022;25;VERSAILLES;MASCULIN;INDIVIDUEL;BAC TECHNOLOGIQUE;BAC STMG;BAC STMG GESTION ET FINANCE;22;18;4;7;7;4;3;8;0;0;0;1;7;10
16840.0;2022;25;VERSAILLES;MASCULIN;INDIVIDUEL;BAC TECHNOLOGIQUE;BAC STMG;BAC STMG RESSOURCES HUMAINES ET COMMUNICATION;19;10;2;7;1;1;0;3;0;0;0;0;3;7
16841.0;2022;25;VERSAILLES;MASCULIN;INDIVIDUEL;BAC TECHNOLOGIQUE;BAC STMG;BAC STMG SYSTEMES D'INFORMATION DE GESTION;4;1;0;0;1;1;0;1;0;0;0;0;1;0
16842.0;2022;25;VERSAILLES;MASCULIN;SCOLAIRE;BAC GENERAL;BAC GENERAL;BAC GENE 10019 BAC GENERAL;17892;17892;16143;392;1357;896;461;17039;249;2029;4389;5364;5008;853
16855.0;2022;25;VERSAILLES;MASCULIN;SCOLAIRE;BAC PROFESSIONNEL;BAC PRO PROD;BACPRO 23103 TECHNICIEN GEOMETRE-TOPOGRAPHE;37;37;21;16;0;0;0;21;0;0;5;8;8;16
16873.0;2022;25;VERSAILLES;MASCULIN;SCOLAIRE;BAC PROFESSIONNEL;BAC PRO PROD;BAC PRO 25219 MAINT.MATERIELS OPT.A AGRICOLES;6;6;4;1;1;0;1;4;0;0;1;2;1;2
16877.0;2022;25;VERSAILLES;MASCULIN;SCOLAIRE;BAC PROFESSIONNEL;BAC PRO PROD;BAC PRO 25303 AERONAUTIQUE OPTION SYSTEMES;47;47;34;7;6;5;1;39;0;0;4;14;21;8
16900.0;2022;25;VERSAILLES;MASCULIN;SCOLAIRE;BAC PROFESSIONNEL;BAC PRO SERV;BAC PRO 31214 MET.COM.VEN.OP.B PR.CL.VA.OF.COM.;656;652;525;95;32;22;10;547;0;11;111;243;182;105
16910.0;2022;25;VERSAILLES;MASCULIN;SCOLAIRE;BAC PROFESSIONNEL;BAC PRO SERV;BAC PRO 33102 PROTHESE DENTAIRE;1;1;1;0;0;0;0;1;0;0;0;0;1;0
16912.0;2022;25;VERSAILLES;MASCULIN;SCOLAIRE;BAC PROFESSIONNEL;BAC PRO SERV;BAC PRO 34304 HYGIENE PROPRETE STERILISATION;14;14;8;5;1;0;1;8;0;0;0;5;3;6
16913.0;2022;25;VERSAILLES;MASCULIN;SCOLAIRE;BAC PROFESSIONNEL;BAC PRO SERV;BAC PRO 34403 METIERS DE LA SECURITE;176;176;141;24;11;8;3;149;0;8;30;58;53;27
16916.0;2022;25;VERSAILLES;MASCULIN;SCOLAIRE;BAC TECHNOLOGIQUE;BAC ST2S;BAC ST2S SCIENCES & TECHNO. SANTE & SOCIAL;238;238;192;10;36;21;15;213;0;5;20;71;117;25
16918.0;2022;25;VERSAILLES;MASCULIN;SCOLAIRE;BAC TECHNOLOGIQUE;BAC STD2A;BAC STD2A SCIENCES & TECHNO. DESIGN-ARTS APPLIQUES;38;38;38;0;0;0;0;38;0;1;11;14;12;0
16920.0;2022;25;VERSAILLES;MASCULIN;SCOLAIRE;BAC TECHNOLOGIQUE;BAC STI2D;BAC STI2D ARCHITECTURE ET CONSTRUCTION;194;194;146;17;31;23;8;169;0;0;13;58;98;25
16924.0;2022;25;VERSAILLES;MASCULIN;SCOLAIRE;BAC TECHNOLOGIQUE;BAC STL;BAC STL BIOCHIM.-BIOLOGIE-BIOTECHNOL.;176;176;138;8;30;22;8;160;1;4;19;57;79;16
16926.0;2022;25;VERSAILLES;MASCULIN;SCOLAIRE;BAC TECHNOLOGIQUE;BAC STMG;BAC STMG GESTION ET FINANCE;944;944;756;59;129;92;37;848;0;15;106;310;417;96
16931.0;2023;02;AIX-MARSEILLE;FEMININ;APPRENTISSAGE;BAC PROFESSIONNEL;BAC PRO PROD;BAC PRO 22703 TECHN.INSTALL.SYST.ENERG.CLIMATI;1;1;1;0;0;0;0;1;0;0;1;0;0;0
16934.0;2023;02;AIX-MARSEILLE;FEMININ;APPRENTISSAGE;BAC PROFESSIONNEL;BAC PRO PROD;BAC PRO 25106 TECHNICIEN D'USINAGE;1;1;1;0;0;0;0;1;0;0;0;1;0;0
16935.0;2023;02;AIX-MARSEILLE;FEMININ;APPRENTISSAGE;BAC PROFESSIONNEL;BAC PRO PROD;BAC PRO 25214 MAINT.VEHIC.OPTA VOIT.PARTICUL.;5;5;5;0;0;0;0;5;0;2;2;1;0;0
16940.0;2023;02;AIX-MARSEILLE;FEMININ;APPRENTISSAGE;BAC PROFESSIONNEL;BAC PRO PROD;BAC PRO AG 21004 CGEA;1;1;1;0;0;0;0;1;0;0;0;0;1;0
16942.0;2023;02;AIX-MARSEILLE;FEMININ;APPRENTISSAGE;BAC PROFESSIONNEL;BAC PRO PROD;BAC PRO AG 21114 CONDUITE PRODUCTIONS HORTICOLES;1;1;1;0;0;0;0;1;0;0;0;0;1;0
16947.0;2023;02;AIX-MARSEILLE;FEMININ;APPRENTISSAGE;BAC PROFESSIONNEL;BAC PRO PROD;BAC PRO AG 22108 TEC CONS VTE ALIMENTATION (PAB);2;2;2;0;0;0;0;2;0;0;0;2;0;0
16956.0;2023;02;AIX-MARSEILLE;FEMININ;APPRENTISSAGE;BAC PROFESSIONNEL;BAC PRO SERV;BAC PRO 33104 TECHNICIEN EN PROTHESE DENTAIRE;11;10;10;0;0;0;0;10;0;2;5;2;1;0
16962.0;2023;02;AIX-MARSEILLE;FEMININ;ENSEIGNEMENT A DISTANCE;BAC PROFESSIONNEL;BAC PRO SERV;BAC PRO 30004 ASSISTANC.GEST.ORGANIS.ACTIVITES;4;1;1;0;0;0;0;1;0;0;0;1;0;0
16964.0;2023;02;AIX-MARSEILLE;FEMININ;ENSEIGNEMENT A DISTANCE;BAC PROFESSIONNEL;BAC PRO SERV;BAC PRO 31214 MET.COM.VEN.OP.B PR.CL.VA.OF.COM.;3;1;0;1;0;0;0;0;0;0;0;0;0;1
16967.0;2023;02;AIX-MARSEILLE;FEMININ;ENSEIGNEMENT A DISTANCE;BAC PROFESSIONNEL;BAC PRO SERV;BAC PRO 33603 ESTHETIQUE COSMETIQUE PARFUMERIE;3;2;1;1;0;0;0;1;0;0;0;0;1;1
16977.0;2023;02;AIX-MARSEILLE;FEMININ;FORMATION CONTINUE;BAC PROFESSIONNEL;BAC PRO SERV;BAC PRO 31212 METIERS DE L'ACCUEIL;11;10;7;1;2;1;1;8;0;2;1;2;3;2
16978.0;2023;02;AIX-MARSEILLE;FEMININ;FORMATION CONTINUE;BAC PROFESSIONNEL;BAC PRO SERV;BAC PRO 31213 MET.COM.VEN.OP.A ANI.GES.ESP.COM.;5;5;4;0;1;1;0;5;0;0;3;1;1;0
16982.0;2023;02;AIX-MARSEILLE;FEMININ;FORMATION CONTINUE;BAC PROFESSIONNEL;BAC PRO SERV;BAC PRO 33603 ESTHETIQUE COSMETIQUE PARFUMERIE;2;2;1;1;0;0;0;1;0;0;1;0;0;1
16984.0;2023;02;AIX-MARSEILLE;FEMININ;INDIVIDUEL;BAC PROFESSIONNEL;BAC PRO PROD;BAC PRO 22003 BIO-INDUSTRIES DE TRANSFORMATION;1;1;0;1;0;0;0;0;0;0;0;0;0;1
16986.0;2023;02;AIX-MARSEILLE;FEMININ;INDIVIDUEL;BAC PROFESSIONNEL;BAC PRO PROD;BAC PRO 23005 TECHN. ETUDES BAT B ASSIST.ARCHI.;1;0;0;0;0;0;0;0;0;0;0;0;0;0
16989.0;2023;02;AIX-MARSEILLE;FEMININ;INDIVIDUEL;BAC PROFESSIONNEL;BAC PRO PROD;BAC PRO AG 21113 CGEVV;1;1;1;0;0;0;0;1;0;0;0;0;1;0
16995.0;2023;02;AIX-MARSEILLE;FEMININ;INDIVIDUEL;BAC PROFESSIONNEL;BAC PRO SERV;BAC PRO 31214 MET.COM.VEN.OP.B PR.CL.VA.OF.COM.;3;0;0;0;0;0;0;0;0;0;0;0;0;0
17000.0;2023;02;AIX-MARSEILLE;FEMININ;INDIVIDUEL;BAC PROFESSIONNEL;BAC PRO SERV;BAC PRO 34403 METIERS DE LA SECURITE;1;0;0;0;0;0;0;0;0;0;0;0;0;0
17003.0;2023;02;AIX-MARSEILLE;FEMININ;INDIVIDUEL;BAC TECHNOLOGIQUE;BAC STD2A;BAC STD2A SCIENCES & TECHNO. DESIGN-ARTS APPLIQUES;1;1;1;0;0;0;0;1;0;0;0;1;0;0
17010.0;2023;02;AIX-MARSEILLE;FEMININ;SCOLAIRE;BAC GENERAL;BAC GENERAL;BAC GENE 10019 BAC GENERAL;9231;9231;8672;97;462;339;123;9011;269;1376;2396;2659;2311;220
17011.0;2023;02;AIX-MARSEILLE;FEMININ;SCOLAIRE;BAC PROFESSIONNEL;BAC PRO PROD;BACPRO 20002 ETUD.DEFINITION PRDTS INDUSTRIEL;3;3;0;2;1;1;0;1;0;0;0;0;1;2
17015.0;2023;02;AIX-MARSEILLE;FEMININ;SCOLAIRE;BAC PROFESSIONNEL;BAC PRO PROD;BAC PRO 22106 CUISINE;41;41;39;2;0;0;0;39;0;1;7;17;14;2
17018.0;2023;02;AIX-MARSEILLE;FEMININ;SCOLAIRE;BAC PROFESSIONNEL;BAC PRO PROD;BAC PRO 23004 TECHN. ETUDES BAT.A ETUDES & ECO.;11;11;9;2;0;0;0;9;0;0;1;5;3;2
17023.0;2023;02;AIX-MARSEILLE;FEMININ;SCOLAIRE;BAC PROFESSIONNEL;BAC PRO PROD;BAC PRO 23405 TECHNICIEN MENUISIER AGENCEUR;3;3;2;1;0;0;0;2;0;0;0;1;1;1
17024.0;2023;02;AIX-MARSEILLE;FEMININ;SCOLAIRE;BAC PROFESSIONNEL;BAC PRO PROD;BAC PRO 23408 Etude et réalisation d'agencement;11;10;9;1;0;0;0;9;0;0;4;3;2;1
17045.0;2023;02;AIX-MARSEILLE;FEMININ;SCOLAIRE;BAC PROFESSIONNEL;BAC PRO PROD;BAC PRO AG 21302 GEST MILIEUX NATURELS FAUNE;13;13;13;0;0;0;0;13;0;0;2;4;7;0
17050.0;2023;02;AIX-MARSEILLE;FEMININ;SCOLAIRE;BAC PROFESSIONNEL;BAC PRO SERV;BAC PRO 30004 ASSISTANC.GEST.ORGANIS.ACTIVITES;566;566;426;118;22;18;4;444;0;12;71;169;192;122
17056.0;2023;02;AIX-MARSEILLE;FEMININ;SCOLAIRE;BAC PROFESSIONNEL;BAC PRO SERV;BAC PRO 31214 MET.COM.VEN.OP.B PR.CL.VA.OF.COM.;201;201;161;30;10;10;0;171;0;5;39;57;70;30
17063.0;2023;02;AIX-MARSEILLE;FEMININ;SCOLAIRE;BAC PROFESSIONNEL;BAC PRO SERV;BAC PRO 33006 ANIMAT. ENFANCE& PERSONNES AGEES;73;72;61;8;3;0;3;61;0;4;17;23;17;11
17069.0;2023;02;AIX-MARSEILLE;FEMININ;SCOLAIRE;BAC PROFESSIONNEL;BAC PRO SERV;BAC PRO 33604 METIERS DE LA COIFFURE;45;45;31;14;0;0;0;31;0;0;5;13;13;14
17076.0;2023;02;AIX-MARSEILLE;FEMININ;SCOLAIRE;BAC TECHNOLOGIQUE;BAC STHR;BAC STHR SC.&TEC. HOTELLERIE-RESTAURATION;21;21;19;0;2;2;0;21;0;1;6;5;9;0
17086.0;2023;02;AIX-MARSEILLE;FEMININ;SCOLAIRE;BAC TECHNOLOGIQUE;BAC STMG;BAC STMG SYSTEMES D'INFORMATION DE GESTION;13;13;12;0;1;1;0;13;0;0;0;4;9;0
17090.0;2023;02;AIX-MARSEILLE;MASCULIN;APPRENTISSAGE;BAC PROFESSIONNEL;BAC PRO PROD;BAC PRO 22106 CUISINE;47;44;36;6;2;1;1;37;0;3;11;10;13;7
17105.0;2023;02;AIX-MARSEILLE;MASCULIN;APPRENTISSAGE;BAC PROFESSIONNEL;BAC PRO PROD;BAC PRO 25215 MAINT.VEHIC.OPTB VEHIC.TRANS.ROUT;24;24;13;8;3;2;1;15;0;1;1;3;10;9
17107.0;2023;02;AIX-MARSEILLE;MASCULIN;APPRENTISSAGE;BAC PROFESSIONNEL;BAC PRO PROD;BAC PRO 25220 MAINT.MATERIELS OPT.B TP MANUT.;10;10;8;1;1;1;0;9;0;1;3;2;3;1
17117.0;2023;02;AIX-MARSEILLE;MASCULIN;APPRENTISSAGE;BAC PROFESSIONNEL;BAC PRO PROD;BAC PRO AG 21113 CGEVV;13;10;7;3;0;0;0;7;0;0;1;1;5;3
17133.0;2023;02;AIX-MARSEILLE;MASCULIN;APPRENTISSAGE;BAC PROFESSIONNEL;BAC PRO SERV;BAC PRO 33104 TECHNICIEN EN PROTHESE DENTAIRE;13;12;10;0;2;1;1;11;0;0;3;6;2;1
17135.0;2023;02;AIX-MARSEILLE;MASCULIN;APPRENTISSAGE;BAC PROFESSIONNEL;BAC PRO SERV;BAC PRO 34304 HYGIENE PROPRETE STERILISATION;11;11;7;4;0;0;0;7;0;0;1;2;4;4
17137.0;2023;02;AIX-MARSEILLE;MASCULIN;ENSEIGNEMENT A DISTANCE;BAC GENERAL;BAC GENERAL;BAC GENE 10019 BAC GENERAL;43;43;20;11;12;9;3;29;0;2;1;3;23;14
17142.0;2023;02;AIX-MARSEILLE;MASCULIN;ENSEIGNEMENT A DISTANCE;BAC PROFESSIONNEL;BAC PRO SERV;BAC PRO 33004 ACC.SOINS-S.PERS. OPT.EN STRUCTUR;1;0;0;0;0;0;0;0;0;0;0;0;0;0
17145.0;2023;02;AIX-MARSEILLE;MASCULIN;ENSEIGNEMENT A DISTANCE;BAC TECHNOLOGIQUE;BAC STMG;BAC STMG GESTION ET FINANCE;2;2;1;1;0;0;0;1;0;0;0;0;1;1
17156.0;2023;02;AIX-MARSEILLE;MASCULIN;FORMATION CONTINUE;BAC PROFESSIONNEL;BAC PRO SERV;BAC PRO 30004 ASSISTANC.GEST.ORGANIS.ACTIVITES;8;8;5;3;0;0;0;5;0;0;4;1;0;3
17164.0;2023;02;AIX-MARSEILLE;MASCULIN;INDIVIDUEL;BAC PROFESSIONNEL;BAC PRO PROD;BAC PRO 22704 TECHN. MAINT. SYST.ENERG.CLIMATI;2;0;0;0;0;0;0;0;0;0;0;0;0;0
17165.0;2023;02;AIX-MARSEILLE;MASCULIN;INDIVIDUEL;BAC PROFESSIONNEL;BAC PRO PROD;BAC PRO 23102 TRAVAUX PUBLICS;1;0;0;0;0;0;0;0;0;0;0;0;0;0
17167.0;2023;02;AIX-MARSEILLE;MASCULIN;INDIVIDUEL;BAC PROFESSIONNEL;BAC PRO PROD;BAC PRO 25007 MAINTENANCE EQUIPEMENTS INDUST.;2;2;2;0;0;0;0;2;0;0;0;0;2;0
17172.0;2023;02;AIX-MARSEILLE;MASCULIN;INDIVIDUEL;BAC PROFESSIONNEL;BAC PRO PROD;BAC PRO 25304 AERONAUTIQUE OPTION STRUCTURE;1;1;0;1;0;0;0;0;0;0;0;0;0;1
17180.0;2023;02;AIX-MARSEILLE;MASCULIN;INDIVIDUEL;BAC PROFESSIONNEL;BAC PRO PROD;BAC PRO AG 21113 CGEVV;3;3;3;0;0;0;0;3;0;0;0;1;2;0
17199.0;2023;02;AIX-MARSEILLE;MASCULIN;INDIVIDUEL;BAC TECHNOLOGIQUE;BAC STMG;BAC STMG SYSTEMES D'INFORMATION DE GESTION;3;3;0;2;1;1;0;1;0;0;0;0;1;2
17202.0;2023;02;AIX-MARSEILLE;MASCULIN;SCOLAIRE;BAC PROFESSIONNEL;BAC PRO PROD;BAC PRO 20102 PILOTE DE LIGNE DE PRODUCTION;8;8;5;2;1;1;0;6;0;0;0;2;4;2
17212.0;2023;02;AIX-MARSEILLE;MASCULIN;SCOLAIRE;BAC PROFESSIONNEL;BAC PRO PROD;BAC PRO 23005 TECHN. ETUDES BAT B ASSIST.ARCHI.;37;37;32;4;1;1;0;33;0;1;7;14;11;4
17213.0;2023;02;AIX-MARSEILLE;MASCULIN;SCOLAIRE;BAC PROFESSIONNEL;BAC PRO PROD;BAC PRO 23102 TRAVAUX PUBLICS;18;18;14;3;1;0;1;14;0;1;1;3;9;4
17214.0;2023;02;AIX-MARSEILLE;MASCULIN;SCOLAIRE;BAC PROFESSIONNEL;BAC PRO PROD;BACPRO 23103 TECHNICIEN GEOMETRE-TOPOGRAPHE;19;19;13;6;0;0;0;13;0;1;1;3;8;6
17218.0;2023;02;AIX-MARSEILLE;MASCULIN;SCOLAIRE;BAC PROFESSIONNEL;BAC PRO PROD;BAC PRO 23304 AMENAGEMENT FINITION BATIMENT;10;10;4;5;1;1;0;5;0;0;1;1;3;5
17221.0;2023;02;AIX-MARSEILLE;MASCULIN;SCOLAIRE;BAC PROFESSIONNEL;BAC PRO PROD;BAC PRO 23408 Etude et réalisation d'agencement;1;1;1;0;0;0;0;1;0;0;0;0;1;0
17222.0;2023;02;AIX-MARSEILLE;MASCULIN;SCOLAIRE;BAC PROFESSIONNEL;BAC PRO PROD;BAC PRO 24203 METIERS DE LA MODE - VÊTEMENT;9;9;6;3;0;0;0;6;0;1;1;3;1;3
17233.0;2023;02;AIX-MARSEILLE;MASCULIN;SCOLAIRE;BAC PROFESSIONNEL;BAC PRO PROD;BAC PRO 25221 MAINT.MATERIELS OPT.C ESP. VERTS;5;5;4;1;0;0;0;4;0;0;1;1;2;1
17236.0;2023;02;AIX-MARSEILLE;MASCULIN;SCOLAIRE;BAC PROFESSIONNEL;BAC PRO PROD;BAC PRO 25304 AERONAUTIQUE OPTION STRUCTURE;9;9;8;1;0;0;0;8;0;0;2;3;3;1
17237.0;2023;02;AIX-MARSEILLE;MASCULIN;SCOLAIRE;BAC PROFESSIONNEL;BAC PRO PROD;BAC PRO 25406 OUVRAGES DU BATIMENT METALLERIE;17;17;14;2;1;0;1;14;0;1;5;3;5;3
17238.0;2023;02;AIX-MARSEILLE;MASCULIN;SCOLAIRE;BAC PROFESSIONNEL;BAC PRO PROD;BAC PRO 25408 REPARATION DES CARROSSERIES;21;21;18;3;0;0;0;18;0;0;2;8;8;3
17240.0;2023;02;AIX-MARSEILLE;MASCULIN;SCOLAIRE;BAC PROFESSIONNEL;BAC PRO PROD;BAC PRO 25509 TECHNIC. FROID CONDITIONNEMT AIR;56;54;34;15;5;3;2;37;0;1;5;8;23;17
17248.0;2023;02;AIX-MARSEILLE;MASCULIN;SCOLAIRE;BAC PROFESSIONNEL;BAC PRO PROD;BAC PRO AG 21114 CONDUITE PRODUCTIONS HORTICOLES;6;6;5;1;0;0;0;5;0;0;0;0;5;1
17254.0;2023;02;AIX-MARSEILLE;MASCULIN;SCOLAIRE;BAC PROFESSIONNEL;BAC PRO PROD;BAC PRO AG 21405 AMENAGEMENTS PAYSAGERS;59;59;52;7;0;0;0;52;0;0;4;21;27;7
17259.0;2023;02;AIX-MARSEILLE;MASCULIN;SCOLAIRE;BAC PROFESSIONNEL;BAC PRO SERV;BAC PRO 31107 CONDUCT. TRANSP.ROUT.MARCHANDISES;77;77;63;11;3;3;0;66;0;0;13;21;32;11
17262.0;2023;02;AIX-MARSEILLE;MASCULIN;SCOLAIRE;BAC PROFESSIONNEL;BAC PRO SERV;BAC PRO 31213 MET.COM.VEN.OP.A ANI.GES.ESP.COM.;279;278;204;55;19;17;2;221;0;5;32;80;104;57
17264.0;2023;02;AIX-MARSEILLE;MASCULIN;SCOLAIRE;BAC PROFESSIONNEL;BAC PRO SERV;BAC PRO 32207 REAL.PR.IMPR.PLURI.OPTA.PR.GRAPH.;25;25;23;2;0;0;0;23;0;3;8;7;5;2
17277.0;2023;02;AIX-MARSEILLE;MASCULIN;SCOLAIRE;BAC PROFESSIONNEL;BAC PRO SERV;BAC PRO 34403 METIERS DE LA SECURITE;56;56;54;0;2;2;0;56;0;5;15;24;12;0
17278.0;2023;02;AIX-MARSEILLE;MASCULIN;SCOLAIRE;BAC PROFESSIONNEL;BAC PRO SERV;BAC PRO AG 33002 SERV PERS TERRIT;28;27;23;4;0;0;0;23;0;2;2;6;13;4
17280.0;2023;02;AIX-MARSEILLE;MASCULIN;SCOLAIRE;BAC TECHNOLOGIQUE;BAC ST2S;BAC ST2S SCIENCES & TECHNO. SANTE & SOCIAL;170;170;125;11;34;20;14;145;0;3;15;45;82;25
17286.0;2023;02;AIX-MARSEILLE;MASCULIN;SCOLAIRE;BAC TECHNOLOGIQUE;BAC STI2D;BAC STI2D INNOVATION TECHNO.  ET ECO CONCEPTION;325;325;275;4;46;30;16;305;0;8;49;94;154;20
17293.0;2023;02;AIX-MARSEILLE;MASCULIN;SCOLAIRE;BAC TECHNOLOGIQUE;BAC STMG;BAC STMG SYSTEMES D'INFORMATION DE GESTION;38;38;30;2;6;6;0;36;0;0;2;13;21;2
17298.0;2023;20;AMIENS;FEMININ;APPRENTISSAGE;BAC PROFESSIONNEL;BAC PRO PROD;BAC PRO 23304 AMENAGEMENT FINITION BATIMENT;3;3;3;0;0;0;0;3;0;0;1;2;0;0
17300.0;2023;20;AMIENS;FEMININ;APPRENTISSAGE;BAC PROFESSIONNEL;BAC PRO PROD;BAC PRO 25214 MAINT.VEHIC.OPTA VOIT.PARTICUL.;3;3;2;0;1;0;1;2;0;1;0;0;1;1
17310.0;2023;20;AMIENS;FEMININ;APPRENTISSAGE;BAC PROFESSIONNEL;BAC PRO SERV;BAC PRO 31212 METIERS DE L'ACCUEIL;2;2;2;0;0;0;0;2;0;1;0;0;1;0
17315.0;2023;20;AMIENS;FEMININ;ENSEIGNEMENT A DISTANCE;BAC TECHNOLOGIQUE;BAC ST2S;BAC ST2S SCIENCES & TECHNO. SANTE & SOCIAL;7;7;3;2;2;0;2;3;0;0;0;1;2;4
17316.0;2023;20;AMIENS;FEMININ;ENSEIGNEMENT A DISTANCE;BAC TECHNOLOGIQUE;BAC STMG;BAC STMG GESTION ET FINANCE;1;1;0;1;0;0;0;0;0;0;0;0;0;1
17317.0;2023;20;AMIENS;FEMININ;ENSEIGNEMENT A DISTANCE;BAC TECHNOLOGIQUE;BAC STMG;BAC STMG MERCATIQUE (MARKETING);2;2;0;1;1;1;0;1;0;0;0;0;1;1
17329.0;2023;20;AMIENS;FEMININ;INDIVIDUEL;BAC PROFESSIONNEL;BAC PRO PROD;BAC PRO AG 21203 TECHN CONSEIL DE VENTE ANIMAL;1;1;0;1;0;0;0;0;0;0;0;0;0;1
17330.0;2023;20;AMIENS;FEMININ;INDIVIDUEL;BAC PROFESSIONNEL;BAC PRO SERV;BAC PRO 30004 ASSISTANC.GEST.ORGANIS.ACTIVITES;4;3;2;1;0;0;0;2;0;0;0;0;2;1
17333.0;2023;20;AMIENS;FEMININ;INDIVIDUEL;BAC PROFESSIONNEL;BAC PRO SERV;BAC PRO 31213 MET.COM.VEN.OP.A ANI.GES.ESP.COM.;5;4;2;2;0;0;0;2;0;0;0;0;2;2
17343.0;2023;20;AMIENS;FEMININ;INDIVIDUEL;BAC TECHNOLOGIQUE;BAC STMG;BAC STMG GESTION ET FINANCE;3;2;1;1;0;0;0;1;0;0;0;0;1;1
17347.0;2023;20;AMIENS;FEMININ;SCOLAIRE;BAC GENERAL;BAC GENERAL;BAC GENE 10019 BAC GENERAL;5674;5674;5215;88;371;240;131;5455;133;766;1390;1660;1506;219
17348.0;2023;20;AMIENS;FEMININ;SCOLAIRE;BAC PROFESSIONNEL;BAC PRO PROD;BACPRO 20002 ETUD.DEFINITION PRDTS INDUSTRIEL;2;2;2;0;0;0;0;2;0;0;1;1;0;0
17359.0;2023;20;AMIENS;FEMININ;SCOLAIRE;BAC PROFESSIONNEL;BAC PRO PROD;BAC PRO 23304 AMENAGEMENT FINITION BATIMENT;3;3;3;0;0;0;0;3;0;1;0;2;0;0
17362.0;2023;20;AMIENS;FEMININ;SCOLAIRE;BAC PROFESSIONNEL;BAC PRO PROD;BAC PRO 24203 METIERS DE LA MODE - VÊTEMENT;81;80;58;22;0;0;0;58;0;9;9;22;18;22
17365.0;2023;20;AMIENS;FEMININ;SCOLAIRE;BAC PROFESSIONNEL;BAC PRO PROD;BAC PRO 25106 TECHNICIEN D'USINAGE;3;3;3;0;0;0;0;3;0;0;0;3;0;0
17366.0;2023;20;AMIENS;FEMININ;SCOLAIRE;BAC PROFESSIONNEL;BAC PRO PROD;BAC PRO 25108 TECHNICIEN MODELEUR;4;4;3;1;0;0;0;3;0;0;0;2;1;1
17377.0;2023;20;AMIENS;FEMININ;SCOLAIRE;BAC PROFESSIONNEL;BAC PRO PROD;BAC PRO AG 21004 CGEA;47;45;28;17;0;0;0;28;0;1;5;7;15;17
17381.0;2023;20;AMIENS;FEMININ;SCOLAIRE;BAC PROFESSIONNEL;BAC PRO PROD;BAC PRO AG 21211 COND GEST ENTR HIPPIQUE;36;36;29;7;0;0;0;29;0;0;2;4;23;7
17383.0;2023;20;AMIENS;FEMININ;SCOLAIRE;BAC PROFESSIONNEL;BAC PRO PROD;BAC PRO AG 21405 AMENAGEMENTS PAYSAGERS;2;2;2;0;0;0;0;2;0;0;0;1;1;0
17400.0;2023;20;AMIENS;FEMININ;SCOLAIRE;BAC PROFESSIONNEL;BAC PRO SERV;BAC PRO 33603 ESTHETIQUE COSMETIQUE PARFUMERIE;68;68;58;10;0;0;0;58;0;2;7;21;28;10
17403.0;2023;20;AMIENS;FEMININ;SCOLAIRE;BAC PROFESSIONNEL;BAC PRO SERV;BAC PRO 34403 METIERS DE LA SECURITE;44;44;36;7;1;1;0;37;0;0;8;17;12;7
17404.0;2023;20;AMIENS;FEMININ;SCOLAIRE;BAC PROFESSIONNEL;BAC PRO SERV;BAC PRO AG 33002 SERV PERS TERRIT;148;143;121;22;0;0;0;121;0;2;5;34;80;22
17411.0;2023;20;AMIENS;FEMININ;SCOLAIRE;BAC TECHNOLOGIQUE;BAC STI2D;BAC STI2D INNOVATION TECHNO.  ET ECO CONCEPTION;26;26;23;2;1;1;0;24;0;2;2;6;14;2
17417.0;2023;20;AMIENS;FEMININ;SCOLAIRE;BAC TECHNOLOGIQUE;BAC STMG;BAC STMG RESSOURCES HUMAINES ET COMMUNICATION;408;408;289;29;90;69;21;358;0;0;22;88;248;50
17419.0;2023;20;AMIENS;MASCULIN;APPRENTISSAGE;BAC PROFESSIONNEL;BAC PRO PROD;BAC PRO 20102 PILOTE DE LIGNE DE PRODUCTION;3;3;3;0;0;0;0;3;0;2;1;0;0;0
17420.0;2023;20;AMIENS;MASCULIN;APPRENTISSAGE;BAC PROFESSIONNEL;BAC PRO PROD;BAC PRO 22106 CUISINE;28;27;18;4;5;5;0;23;0;2;6;3;12;4
17422.0;2023;20;AMIENS;MASCULIN;APPRENTISSAGE;BAC PROFESSIONNEL;BAC PRO PROD;BAC PRO 22704 TECHN. MAINT. SYST.ENERG.CLIMATI;5;5;4;1;0;0;0;4;0;1;1;1;1;1
17438.0;2023;20;AMIENS;MASCULIN;APPRENTISSAGE;BAC PROFESSIONNEL;BAC PRO PROD;BAC PRO 25220 MAINT.MATERIELS OPT.B TP MANUT.;1;1;1;0;0;0;0;1;0;1;0;0;0;0
17439.0;2023;20;AMIENS;MASCULIN;APPRENTISSAGE;BAC PROFESSIONNEL;BAC PRO PROD;BAC PRO 25221 MAINT.MATERIELS OPT.C ESP. VERTS;1;1;1;0;0;0;0;1;0;0;0;1;0;0
17444.0;2023;20;AMIENS;MASCULIN;APPRENTISSAGE;BAC PROFESSIONNEL;BAC PRO PROD;BAC PRO 25510 METIERS ELECT. ENVIRON. CONNECTES;76;75;66;6;3;2;1;68;0;8;13;21;26;7
17448.0;2023;20;AMIENS;MASCULIN;APPRENTISSAGE;BAC PROFESSIONNEL;BAC PRO PROD;BAC PRO AG 21114 CONDUITE PRODUCTIONS HORTICOLES;2;2;2;0;0;0;0;2;0;0;0;0;2;0
17456.0;2023;20;AMIENS;MASCULIN;APPRENTISSAGE;BAC PROFESSIONNEL;BAC PRO SERV;BAC PRO 31214 MET.COM.VEN.OP.B PR.CL.VA.OF.COM.;3;3;2;0;1;1;0;3;0;0;1;1;1;0
17458.0;2023;20;AMIENS;MASCULIN;APPRENTISSAGE;BAC PROFESSIONNEL;BAC PRO SERV;BAC PRO AG 33002 SERV PERS TERRIT;6;6;6;0;0;0;0;6;0;0;1;3;2;0
17462.0;2023;20;AMIENS;MASCULIN;FORMATION CONTINUE;BAC PROFESSIONNEL;BAC PRO PROD;BAC PRO 22703 TECHN.INSTALL.SYST.ENERG.CLIMATI;1;1;1;0;0;0;0;1;0;0;1;0;0;0
17478.0;2023;20;AMIENS;MASCULIN;INDIVIDUEL;BAC PROFESSIONNEL;BAC PRO SERV;BAC PRO 31213 MET.COM.VEN.OP.A ANI.GES.ESP.COM.;6;2;1;1;0;0;0;1;0;0;1;0;0;1
17479.0;2023;20;AMIENS;MASCULIN;INDIVIDUEL;BAC PROFESSIONNEL;BAC PRO SERV;BAC PRO 32304 PHOTOGRAPHIE;1;0;0;0;0;0;0;0;0;0;0;0;0;0
17481.0;2023;20;AMIENS;MASCULIN;INDIVIDUEL;BAC PROFESSIONNEL;BAC PRO SERV;BAC PRO 34403 METIERS DE LA SECURITE;1;1;1;0;0;0;0;1;0;0;0;0;1;0
17496.0;2023;20;AMIENS;MASCULIN;SCOLAIRE;BAC PROFESSIONNEL;BAC PRO PROD;BAC PRO 22106 CUISINE;89;87;74;11;2;2;0;76;0;5;14;28;29;11
17503.0;2023;20;AMIENS;MASCULIN;SCOLAIRE;BAC PROFESSIONNEL;BAC PRO PROD;BAC PRO 23102 TRAVAUX PUBLICS;3;3;3;0;0;0;0;3;0;1;1;1;0;0
17507.0;2023;20;AMIENS;MASCULIN;SCOLAIRE;BAC PROFESSIONNEL;BAC PRO PROD;BAC PRO 23303 MENUISERIE ALUMINIUM-VERRE;2;2;1;1;0;0;0;1;0;0;0;0;1;1
17508.0;2023;20;AMIENS;MASCULIN;SCOLAIRE;BAC PROFESSIONNEL;BAC PRO PROD;BAC PRO 23304 AMENAGEMENT FINITION BATIMENT;23;23;14;7;2;1;1;15;0;0;0;8;7;8
17517.0;2023;20;AMIENS;MASCULIN;SCOLAIRE;BAC PROFESSIONNEL;BAC PRO PROD;BAC PRO 25106 TECHNICIEN D'USINAGE;60;60;32;25;3;2;1;34;0;0;3;11;20;26
17522.0;2023;20;AMIENS;MASCULIN;SCOLAIRE;BAC PROFESSIONNEL;BAC PRO PROD;BAC PRO 25219 MAINT.MATERIELS OPT.A AGRICOLES;15;15;13;1;1;1;0;14;0;1;3;6;4;1
17524.0;2023;20;AMIENS;MASCULIN;SCOLAIRE;BAC PROFESSIONNEL;BAC PRO PROD;BAC PRO 25221 MAINT.MATERIELS OPT.C ESP. VERTS;7;7;5;0;2;0;2;5;0;0;1;2;2;2
17528.0;2023;20;AMIENS;MASCULIN;SCOLAIRE;BAC PROFESSIONNEL;BAC PRO PROD;BAC PRO 25411 TECH.CHAUDRONNERIE INDUSTRIELLE;44;44;38;2;4;2;2;40;0;3;7;12;18;4
17530.0;2023;20;AMIENS;MASCULIN;SCOLAIRE;BAC PROFESSIONNEL;BAC PRO PROD;BAC PRO 25510 METIERS ELECT. ENVIRON. CONNECTES;396;395;286;72;37;28;9;314;0;13;61;112;128;81
17541.0;2023;20;AMIENS;MASCULIN;SCOLAIRE;BAC PROFESSIONNEL;BAC PRO PROD;BAC PRO AG 21405 AMENAGEMENTS PAYSAGERS;29;28;22;6;0;0;0;22;0;0;4;6;12;6
17542.0;2023;20;AMIENS;MASCULIN;SCOLAIRE;BAC PROFESSIONNEL;BAC PRO PROD;BAC PRO AG 22105 LABORATOIRE CONTROLE QUALITE;4;4;4;0;0;0;0;4;0;0;2;1;1;0
17544.0;2023;20;AMIENS;MASCULIN;SCOLAIRE;BAC PROFESSIONNEL;BAC PRO SERV;BAC PRO 30004 ASSISTANC.GEST.ORGANIS.ACTIVITES;184;184;118;56;10;8;2;126;0;7;16;44;59;58
17548.0;2023;20;AMIENS;MASCULIN;SCOLAIRE;BAC PROFESSIONNEL;BAC PRO SERV;BAC PRO 31212 METIERS DE L'ACCUEIL;56;56;42;11;3;2;1;44;0;2;5;12;25;12
17550.0;2023;20;AMIENS;MASCULIN;SCOLAIRE;BAC PROFESSIONNEL;BAC PRO SERV;BAC PRO 31214 MET.COM.VEN.OP.B PR.CL.VA.OF.COM.;180;178;144;27;7;3;4;147;0;6;27;55;59;31
17557.0;2023;20;AMIENS;MASCULIN;SCOLAIRE;BAC PROFESSIONNEL;BAC PRO SERV;BAC PRO 33403 COMMERC. SERVICES EN RESTAURATION;58;57;46;6;5;3;2;49;0;2;15;17;15;8
17561.0;2023;20;AMIENS;MASCULIN;SCOLAIRE;BAC PROFESSIONNEL;BAC PRO SERV;BAC PRO AG 33002 SERV PERS TERRIT;10;10;9;1;0;0;0;9;0;0;0;2;7;1
17567.0;2023;20;AMIENS;MASCULIN;SCOLAIRE;BAC TECHNOLOGIQUE;BAC STI2D;BAC STI2D ENERGIES  ET ENVIRONNEMENT;139;139;95;11;33;25;8;120;0;3;11;27;79;19
17576.0;2023;03;BESANCON;FEMININ;APPRENTISSAGE;BAC PROFESSIONNEL;BAC PRO PROD;BAC PRO 22003 BIO-INDUSTRIES DE TRANSFORMATION;4;4;4;0;0;0;0;4;0;0;2;2;0;0
17580.0;2023;03;BESANCON;FEMININ;APPRENTISSAGE;BAC PROFESSIONNEL;BAC PRO PROD;BAC PRO 25106 TECHNICIEN D'USINAGE;1;1;1;0;0;0;0;1;0;0;0;0;1;0
17582.0;2023;03;BESANCON;FEMININ;APPRENTISSAGE;BAC PROFESSIONNEL;BAC PRO PROD;BAC PRO 25411 TECH.CHAUDRONNERIE INDUSTRIELLE;2;2;2;0;0;0;0;2;0;0;0;0;2;0
17586.0;2023;03;BESANCON;FEMININ;APPRENTISSAGE;BAC PROFESSIONNEL;BAC PRO PROD;BAC PRO AG 21203 TECHN CONSEIL DE VENTE ANIMAL;6;6;6;0;0;0;0;6;0;1;1;4;0;0
17592.0;2023;03;BESANCON;FEMININ;APPRENTISSAGE;BAC PROFESSIONNEL;BAC PRO PROD;BAC PRO AG 22108 TEC CONS VTE ALIMENTATION (PAB);4;4;4;0;0;0;0;4;0;0;0;1;3;0
17594.0;2023;03;BESANCON;FEMININ;APPRENTISSAGE;BAC PROFESSIONNEL;BAC PRO SERV;BAC PRO 31106 LOGISTIQUE;4;4;4;0;0;0;0;4;0;0;3;0;1;0
17596.0;2023;03;BESANCON;FEMININ;APPRENTISSAGE;BAC PROFESSIONNEL;BAC PRO SERV;BAC PRO 31213 MET.COM.VEN.OP.A ANI.GES.ESP.COM.;75;74;51;12;11;10;1;61;0;5;16;11;29;13
17598.0;2023;03;BESANCON;FEMININ;APPRENTISSAGE;BAC PROFESSIONNEL;BAC PRO SERV;BAC PRO 33004 ACC.SOINS-S.PERS. OPT.EN STRUCTUR;1;1;1;0;0;0;0;1;0;0;1;0;0;0
17600.0;2023;03;BESANCON;FEMININ;APPRENTISSAGE;BAC PROFESSIONNEL;BAC PRO SERV;BAC PRO 33101 OPTIQUE LUNETTERIE;3;3;3;0;0;0;0;3;0;2;1;0;0;0
17608.0;2023;03;BESANCON;FEMININ;ENSEIGNEMENT A DISTANCE;BAC PROFESSIONNEL;BAC PRO SERV;BAC PRO 32304 PHOTOGRAPHIE;1;1;1;0;0;0;0;1;0;0;1;0;0;0
17617.0;2023;03;BESANCON;FEMININ;INDIVIDUEL;BAC PROFESSIONNEL;BAC PRO PROD;BAC PRO AG 21114 CONDUITE PRODUCTIONS HORTICOLES;1;1;1;0;0;0;0;1;0;0;0;0;1;0
17620.0;2023;03;BESANCON;FEMININ;INDIVIDUEL;BAC TECHNOLOGIQUE;BAC STMG;BAC STMG RESSOURCES HUMAINES ET COMMUNICATION;1;1;0;1;0;0;0;0;0;0;0;0;0;1
17628.0;2023;03;BESANCON;FEMININ;SCOLAIRE;BAC PROFESSIONNEL;BAC PRO PROD;BAC PRO 23405 TECHNICIEN MENUISIER AGENCEUR;8;8;8;0;0;0;0;8;0;3;2;2;1;0
17630.0;2023;03;BESANCON;FEMININ;SCOLAIRE;BAC PROFESSIONNEL;BAC PRO PROD;BAC PRO 23408 Etude et réalisation d'agencement;22;22;22;0;0;0;0;22;0;5;6;4;7;0
17636.0;2023;03;BESANCON;FEMININ;SCOLAIRE;BAC PROFESSIONNEL;BAC PRO PROD;BAC PRO 25214 MAINT.VEHIC.OPTA VOIT.PARTICUL.;4;4;3;0;1;1;0;4;0;0;0;0;4;0
17638.0;2023;03;BESANCON;FEMININ;SCOLAIRE;BAC PROFESSIONNEL;BAC PRO PROD;BAC PRO 25408 REPARATION DES CARROSSERIES;2;2;2;0;0;0;0;2;0;0;1;0;1;0
17639.0;2023;03;BESANCON;FEMININ;SCOLAIRE;BAC PROFESSIONNEL;BAC PRO PROD;BAC PRO 25411 TECH.CHAUDRONNERIE INDUSTRIELLE;2;2;2;0;0;0;0;2;0;0;0;1;1;0
17640.0;2023;03;BESANCON;FEMININ;SCOLAIRE;BAC PROFESSIONNEL;BAC PRO PROD;BAC PRO 25509 TECHNIC. FROID CONDITIONNEMT AIR;1;1;1;0;0;0;0;1;0;0;0;0;1;0
17659.0;2023;03;BESANCON;FEMININ;SCOLAIRE;BAC PROFESSIONNEL;BAC PRO SERV;BAC PRO 33003 ACC.SOINS-S.PERS. OPT.A DOMICILE;46;46;36;7;3;2;1;38;0;1;8;14;15;8
17663.0;2023;03;BESANCON;FEMININ;SCOLAIRE;BAC PROFESSIONNEL;BAC PRO SERV;BAC PRO 33403 COMMERC. SERVICES EN RESTAURATION;35;35;33;1;1;1;0;34;0;3;8;11;12;1
17668.0;2023;03;BESANCON;FEMININ;SCOLAIRE;BAC PROFESSIONNEL;BAC PRO SERV;BAC PRO AG 33002 SERV PERS TERRIT;211;208;174;34;0;0;0;174;0;5;22;59;88;34
17669.0;2023;03;BESANCON;FEMININ;SCOLAIRE;BAC TECHNOLOGIQUE;BAC S2TMD;BAC S2TMD DANSE;4;4;4;0;0;0;0;4;0;1;1;1;1;0
17676.0;2023;03;BESANCON;FEMININ;SCOLAIRE;BAC TECHNOLOGIQUE;BAC STI2D;BAC STI2D ENERGIES  ET ENVIRONNEMENT;3;3;1;1;1;1;0;2;0;0;0;1;1;1
17701.0;2023;03;BESANCON;MASCULIN;APPRENTISSAGE;BAC PROFESSIONNEL;BAC PRO PROD;BAC PRO 25006 MICROTECHNIQUES;9;9;9;0;0;0;0;9;0;1;4;3;1;0
17702.0;2023;03;BESANCON;MASCULIN;APPRENTISSAGE;BAC PROFESSIONNEL;BAC PRO PROD;BAC PRO 25007 MAINTENANCE EQUIPEMENTS INDUST.;31;31;25;5;1;0;1;25;0;2;6;5;12;6
17720.0;2023;03;BESANCON;MASCULIN;APPRENTISSAGE;BAC PROFESSIONNEL;BAC PRO PROD;BAC PRO AG 21114 CONDUITE PRODUCTIONS HORTICOLES;1;1;1;0;0;0;0;1;0;0;0;0;1;0
17731.0;2023;03;BESANCON;MASCULIN;APPRENTISSAGE;BAC PROFESSIONNEL;BAC PRO SERV;BAC PRO 31214 MET.COM.VEN.OP.B PR.CL.VA.OF.COM.;7;7;5;1;1;1;0;6;0;0;3;2;1;1
17742.0;2023;03;BESANCON;MASCULIN;ENSEIGNEMENT A DISTANCE;BAC TECHNOLOGIQUE;BAC STMG;BAC STMG MERCATIQUE (MARKETING);1;1;1;0;0;0;0;1;0;0;0;0;1;0
17743.0;2023;03;BESANCON;MASCULIN;FORMATION CONTINUE;BAC PROFESSIONNEL;BAC PRO SERV;BAC PRO 33101 OPTIQUE LUNETTERIE;4;4;4;0;0;0;0;4;0;2;1;0;1;0
17750.0;2023;03;BESANCON;MASCULIN;INDIVIDUEL;BAC PROFESSIONNEL;BAC PRO PROD;BAC PRO 25215 MAINT.VEHIC.OPTB VEHIC.TRANS.ROUT;1;0;0;0;0;0;0;0;0;0;0;0;0;0
17755.0;2023;03;BESANCON;MASCULIN;INDIVIDUEL;BAC PROFESSIONNEL;BAC PRO SERV;BAC PRO 31214 MET.COM.VEN.OP.B PR.CL.VA.OF.COM.;1;0;0;0;0;0;0;0;0;0;0;0;0;0
17759.0;2023;03;BESANCON;MASCULIN;INDIVIDUEL;BAC TECHNOLOGIQUE;BAC STI2D;BAC STI2D INNOVATION TECHNO.  ET ECO CONCEPTION;1;1;1;0;0;0;0;1;0;0;0;0;1;0
17767.0;2023;03;BESANCON;MASCULIN;SCOLAIRE;BAC PROFESSIONNEL;BAC PRO PROD;BAC PRO 22503 PLASTIQUES ET COMPOSITES;9;9;7;1;1;1;0;8;0;1;1;2;4;1
17768.0;2023;03;BESANCON;MASCULIN;SCOLAIRE;BAC PROFESSIONNEL;BAC PRO PROD;BAC PRO 22703 TECHN.INSTALL.SYST.ENERG.CLIMATI;15;15;9;4;2;2;0;11;0;1;2;3;5;4
17770.0;2023;03;BESANCON;MASCULIN;SCOLAIRE;BAC PROFESSIONNEL;BAC PRO PROD;BAC PRO 23004 TECHN. ETUDES BAT.A ETUDES & ECO.;6;6;2;4;0;0;0;2;0;0;1;0;1;4
17775.0;2023;03;BESANCON;MASCULIN;SCOLAIRE;BAC PROFESSIONNEL;BAC PRO PROD;BAC PRO 23207 INTERV. SUR PATRIMOINE BATI OPT.C;3;3;3;0;0;0;0;3;0;0;0;0;3;0
17778.0;2023;03;BESANCON;MASCULIN;SCOLAIRE;BAC PROFESSIONNEL;BAC PRO PROD;BAC PRO 23405 TECHNICIEN MENUISIER AGENCEUR;52;52;46;3;3;3;0;49;0;2;12;20;15;3
17784.0;2023;03;BESANCON;MASCULIN;SCOLAIRE;BAC PROFESSIONNEL;BAC PRO PROD;BAC PRO 25006 MICROTECHNIQUES;93;93;80;4;9;2;7;82;0;3;20;38;21;11
17790.0;2023;03;BESANCON;MASCULIN;SCOLAIRE;BAC PROFESSIONNEL;BAC PRO PROD;BAC PRO 25216 MAINT.VEHIC.OPTC MOTOCYCLES;19;19;18;1;0;0;0;18;0;3;4;8;3;1
17794.0;2023;03;BESANCON;MASCULIN;SCOLAIRE;BAC PROFESSIONNEL;BAC PRO PROD;BAC PRO 25509 TECHNIC. FROID CONDITIONNEMT AIR;9;9;9;0;0;0;0;9;0;0;1;3;5;0
17806.0;2023;03;BESANCON;MASCULIN;SCOLAIRE;BAC PROFESSIONNEL;BAC PRO PROD;BAC PRO AG 22108 TEC CONS VTE ALIMENTATION (PAB);14;13;9;4;0;0;0;9;0;0;1;3;5;4
17809.0;2023;03;BESANCON;MASCULIN;SCOLAIRE;BAC PROFESSIONNEL;BAC PRO SERV;BAC PRO 31107 CONDUCT. TRANSP.ROUT.MARCHANDISES;46;46;43;2;1;1;0;44;0;7;11;11;15;2
17810.0;2023;03;BESANCON;MASCULIN;SCOLAIRE;BAC PROFESSIONNEL;BAC PRO SERV;BAC PRO 31114 ORGANIS. TRANSPORT MARCHANDISES;2;2;2;0;0;0;0;2;0;0;0;1;1;0
17816.0;2023;03;BESANCON;MASCULIN;SCOLAIRE;BAC PROFESSIONNEL;BAC PRO SERV;BAC PRO 33006 ANIMAT. ENFANCE& PERSONNES AGEES;5;5;4;1;0;0;0;4;0;0;1;1;2;1
17817.0;2023;03;BESANCON;MASCULIN;SCOLAIRE;BAC PROFESSIONNEL;BAC PRO SERV;BAC PRO 33101 OPTIQUE LUNETTERIE;6;6;6;0;0;0;0;6;0;0;2;2;2;0
17820.0;2023;03;BESANCON;MASCULIN;SCOLAIRE;BAC PROFESSIONNEL;BAC PRO SERV;BAC PRO 34304 HYGIENE PROPRETE STERILISATION;3;3;2;0;1;1;0;3;0;0;0;1;2;0
17821.0;2023;03;BESANCON;MASCULIN;SCOLAIRE;BAC PROFESSIONNEL;BAC PRO SERV;BAC PRO 34403 METIERS DE LA SECURITE;52;52;40;11;1;1;0;41;0;0;10;16;15;11
17833.0;2023;03;BESANCON;MASCULIN;SCOLAIRE;BAC TECHNOLOGIQUE;BAC STL;BAC STL SCIENCES PHYSIQUES CHIMIQUES  EN LABORAT.;23;23;20;0;3;2;1;22;0;0;10;8;4;1
17837.0;2023;03;BESANCON;MASCULIN;SCOLAIRE;BAC TECHNOLOGIQUE;BAC STMG;BAC STMG SYSTEMES D'INFORMATION DE GESTION;8;8;6;0;2;2;0;8;0;0;1;1;6;0
17841.0;2023;04;BORDEAUX;FEMININ;APPRENTISSAGE;BAC PROFESSIONNEL;BAC PRO PROD;BAC PRO 22403 ARTS.& MET.ART:MET.ENSEIGN SIGNA;1;1;1;0;0;0;0;1;0;0;1;0;0;0
17847.0;2023;04;BORDEAUX;FEMININ;APPRENTISSAGE;BAC PROFESSIONNEL;BAC PRO PROD;BAC PRO 25107 TECHNICIEN OUTILLEUR;1;1;1;0;0;0;0;1;0;0;0;1;0;0
17848.0;2023;04;BORDEAUX;FEMININ;APPRENTISSAGE;BAC PROFESSIONNEL;BAC PRO PROD;BAC PRO 25214 MAINT.VEHIC.OPTA VOIT.PARTICUL.;5;5;3;1;1;0;1;3;0;0;1;1;1;2
17857.0;2023;04;BORDEAUX;FEMININ;APPRENTISSAGE;BAC PROFESSIONNEL;BAC PRO PROD;BAC PRO AG 21405 AMENAGEMENTS PAYSAGERS;4;4;3;1;0;0;0;3;0;0;0;0;3;1
17861.0;2023;04;BORDEAUX;FEMININ;APPRENTISSAGE;BAC PROFESSIONNEL;BAC PRO SERV;BAC PRO 31106 LOGISTIQUE;1;1;1;0;0;0;0;1;0;0;0;1;0;0
17867.0;2023;04;BORDEAUX;FEMININ;APPRENTISSAGE;BAC PROFESSIONNEL;BAC PRO SERV;BAC PRO 33004 ACC.SOINS-S.PERS. OPT.EN STRUCTUR;1;1;1;0;0;0;0;1;0;0;0;0;1;0
17877.0;2023;04;BORDEAUX;FEMININ;ENSEIGNEMENT A DISTANCE;BAC PROFESSIONNEL;BAC PRO SERV;BAC PRO 30004 ASSISTANC.GEST.ORGANIS.ACTIVITES;1;0;0;0;0;0;0;0;0;0;0;0;0;0
17881.0;2023;04;BORDEAUX;FEMININ;ENSEIGNEMENT A DISTANCE;BAC PROFESSIONNEL;BAC PRO SERV;BAC PRO 33003 ACC.SOINS-S.PERS. OPT.A DOMICILE;2;1;1;0;0;0;0;1;0;0;0;0;1;0
17884.0;2023;04;BORDEAUX;FEMININ;ENSEIGNEMENT A DISTANCE;BAC TECHNOLOGIQUE;BAC ST2S;BAC ST2S SCIENCES & TECHNO. SANTE & SOCIAL;6;6;3;2;1;1;0;4;0;0;1;2;1;2
17888.0;2023;04;BORDEAUX;FEMININ;FORMATION CONTINUE;BAC PROFESSIONNEL;BAC PRO PROD;BAC PRO 22004 PROC. CHIMIE EAU PAPIERS-CARTONS;3;3;3;0;0;0;0;3;0;1;1;1;0;0
17893.0;2023;04;BORDEAUX;FEMININ;FORMATION CONTINUE;BAC PROFESSIONNEL;BAC PRO PROD;BAC PRO AG 21405 AMENAGEMENTS PAYSAGERS;3;3;3;0;0;0;0;3;0;0;1;0;2;0
17907.0;2023;04;BORDEAUX;FEMININ;INDIVIDUEL;BAC PROFESSIONNEL;BAC PRO SERV;BAC PRO 33004 ACC.SOINS-S.PERS. OPT.EN STRUCTUR;7;4;2;2;0;0;0;2;0;1;0;0;1;2
17910.0;2023;04;BORDEAUX;FEMININ;INDIVIDUEL;BAC PROFESSIONNEL;BAC PRO SERV;BAC PRO 33603 ESTHETIQUE COSMETIQUE PARFUMERIE;2;1;1;0;0;0;0;1;0;0;0;1;0;0
17913.0;2023;04;BORDEAUX;FEMININ;INDIVIDUEL;BAC TECHNOLOGIQUE;BAC STD2A;BAC STD2A SCIENCES & TECHNO. DESIGN-ARTS APPLIQUES;1;1;0;1;0;0;0;0;0;0;0;0;0;1
17914.0;2023;04;BORDEAUX;FEMININ;INDIVIDUEL;BAC TECHNOLOGIQUE;BAC STI2D;BAC STI2D ENERGIES  ET ENVIRONNEMENT;1;1;0;1;0;0;0;0;0;0;0;0;0;1
17923.0;2023;04;BORDEAUX;FEMININ;SCOLAIRE;BAC PROFESSIONNEL;BAC PRO PROD;BAC PRO 22104 BOUCHER CHARCUTIER TRAITEUR;1;1;1;0;0;0;0;1;0;0;1;0;0;0
17931.0;2023;04;BORDEAUX;FEMININ;SCOLAIRE;BAC PROFESSIONNEL;BAC PRO PROD;BAC PRO 23102 TRAVAUX PUBLICS;1;1;1;0;0;0;0;1;0;0;1;0;0;0
17936.0;2023;04;BORDEAUX;FEMININ;SCOLAIRE;BAC PROFESSIONNEL;BAC PRO PROD;BAC PRO 24202 ARTIS.& MET.ART : TAPIS.D'AMEUBL;22;22;22;0;0;0;0;22;0;3;7;7;5;0
17940.0;2023;04;BORDEAUX;FEMININ;SCOLAIRE;BAC PROFESSIONNEL;BAC PRO PROD;BAC PRO 25106 TECHNICIEN D'USINAGE;1;1;1;0;0;0;0;1;0;0;0;1;0;0
17943.0;2023;04;BORDEAUX;FEMININ;SCOLAIRE;BAC PROFESSIONNEL;BAC PRO PROD;BAC PRO 25215 MAINT.VEHIC.OPTB VEHIC.TRANS.ROUT;2;2;1;0;1;1;0;2;0;0;0;0;2;0
17948.0;2023;04;BORDEAUX;FEMININ;SCOLAIRE;BAC PROFESSIONNEL;BAC PRO PROD;BAC PRO 25304 AERONAUTIQUE OPTION STRUCTURE;3;3;3;0;0;0;0;3;0;0;0;3;0;0
17959.0;2023;04;BORDEAUX;FEMININ;SCOLAIRE;BAC PROFESSIONNEL;BAC PRO PROD;BAC PRO AG 21204 PROD-AQUACOLES;3;3;3;0;0;0;0;3;0;0;0;1;2;0
17962.0;2023;04;BORDEAUX;FEMININ;SCOLAIRE;BAC PROFESSIONNEL;BAC PRO PROD;BAC PRO AG 21302 GEST MILIEUX NATURELS FAUNE;25;25;25;0;0;0;0;25;0;0;4;13;8;0
17964.0;2023;04;BORDEAUX;FEMININ;SCOLAIRE;BAC PROFESSIONNEL;BAC PRO PROD;BAC PRO AG 21407 TEC CONS VTE UNIVERS JARDINERIE;15;14;12;2;0;0;0;12;0;0;0;3;9;2
17970.0;2023;04;BORDEAUX;FEMININ;SCOLAIRE;BAC PROFESSIONNEL;BAC PRO SERV;BAC PRO 31114 ORGANIS. TRANSPORT MARCHANDISES;24;24;20;4;0;0;0;20;0;0;3;6;11;4
17971.0;2023;04;BORDEAUX;FEMININ;SCOLAIRE;BAC PROFESSIONNEL;BAC PRO SERV;BAC PRO 31212 METIERS DE L'ACCUEIL;214;213;180;26;7;4;3;184;0;11;52;62;59;29
17983.0;2023;04;BORDEAUX;FEMININ;SCOLAIRE;BAC PROFESSIONNEL;BAC PRO SERV;BAC PRO 33403 COMMERC. SERVICES EN RESTAURATION;93;92;86;1;5;3;2;89;0;6;20;29;34;3
17985.0;2023;04;BORDEAUX;FEMININ;SCOLAIRE;BAC PROFESSIONNEL;BAC PRO SERV;BAC PRO 33604 METIERS DE LA COIFFURE;67;67;58;7;2;2;0;60;0;0;10;28;22;7
17986.0;2023;04;BORDEAUX;FEMININ;SCOLAIRE;BAC PROFESSIONNEL;BAC PRO SERV;BAC PRO 34304 HYGIENE PROPRETE STERILISATION;6;6;4;0;2;1;1;5;0;0;0;2;3;1
17987.0;2023;04;BORDEAUX;FEMININ;SCOLAIRE;BAC PROFESSIONNEL;BAC PRO SERV;BAC PRO 34403 METIERS DE LA SECURITE;28;28;27;1;0;0;0;27;0;0;6;14;7;1
17989.0;2023;04;BORDEAUX;FEMININ;SCOLAIRE;BAC TECHNOLOGIQUE;BAC S2TMD;BAC S2TMD DANSE;6;6;6;0;0;0;0;6;0;1;3;2;0;0
18002.0;2023;04;BORDEAUX;FEMININ;SCOLAIRE;BAC TECHNOLOGIQUE;BAC STMG;BAC STMG MERCATIQUE (MARKETING);875;875;697;46;132;94;38;791;0;7;71;286;427;84
18009.0;2023;04;BORDEAUX;MASCULIN;APPRENTISSAGE;BAC PROFESSIONNEL;BAC PRO PROD;BAC PRO 22403 ARTS.& MET.ART:MET.ENSEIGN SIGNA;1;1;1;0;0;0;0;1;0;0;0;0;1;0
18010.0;2023;04;BORDEAUX;MASCULIN;APPRENTISSAGE;BAC PROFESSIONNEL;BAC PRO PROD;BAC PRO 22703 TECHN.INSTALL.SYST.ENERG.CLIMATI;31;31;25;5;1;0;1;25;0;3;2;10;10;6
18016.0;2023;04;BORDEAUX;MASCULIN;APPRENTISSAGE;BAC PROFESSIONNEL;BAC PRO PROD;BAC PRO 23303 MENUISERIE ALUMINIUM-VERRE;3;3;2;1;0;0;0;2;0;0;0;2;0;1
18018.0;2023;04;BORDEAUX;MASCULIN;APPRENTISSAGE;BAC PROFESSIONNEL;BAC PRO PROD;BAC PRO 23404 TECHNICIEN CONSTRUCTEUR BOIS;5;5;5;0;0;0;0;5;0;1;2;0;2;0
18027.0;2023;04;BORDEAUX;MASCULIN;APPRENTISSAGE;BAC PROFESSIONNEL;BAC PRO PROD;BAC PRO 25220 MAINT.MATERIELS OPT.B TP MANUT.;5;5;3;2;0;0;0;3;0;0;0;0;3;2
18032.0;2023;04;BORDEAUX;MASCULIN;APPRENTISSAGE;BAC PROFESSIONNEL;BAC PRO PROD;BAC PRO 25406 OUVRAGES DU BATIMENT METALLERIE;2;2;2;0;0;0;0;2;0;0;0;2;0;0
18035.0;2023;04;BORDEAUX;MASCULIN;APPRENTISSAGE;BAC PROFESSIONNEL;BAC PRO PROD;BAC PRO 25510 METIERS ELECT. ENVIRON. CONNECTES;138;138;111;16;11;9;2;120;0;17;23;39;41;18
18036.0;2023;04;BORDEAUX;MASCULIN;APPRENTISSAGE;BAC PROFESSIONNEL;BAC PRO PROD;BAC PRO 25513 SYST.NUM.OPT.A SURETE SECURITE;3;3;3;0;0;0;0;3;0;0;0;2;1;0
18038.0;2023;04;BORDEAUX;MASCULIN;APPRENTISSAGE;BAC PROFESSIONNEL;BAC PRO PROD;BAC PRO 25515 SYST.NUM.OPT.C RES.INF.SYST.COMM.;11;11;6;3;2;1;1;7;0;1;0;3;3;4
18049.0;2023;04;BORDEAUX;MASCULIN;APPRENTISSAGE;BAC PROFESSIONNEL;BAC PRO SERV;BAC PRO 31106 LOGISTIQUE;19;19;15;4;0;0;0;15;0;0;3;4;8;4
18052.0;2023;04;BORDEAUX;MASCULIN;APPRENTISSAGE;BAC PROFESSIONNEL;BAC PRO SERV;BAC PRO 31213 MET.COM.VEN.OP.A ANI.GES.ESP.COM.;118;118;76;33;9;6;3;82;0;4;20;17;41;36
18067.0;2023;04;BORDEAUX;MASCULIN;ENSEIGNEMENT A DISTANCE;BAC TECHNOLOGIQUE;BAC ST2S;BAC ST2S SCIENCES & TECHNO. SANTE & SOCIAL;2;2;1;1;0;0;0;1;0;0;0;1;0;1
18072.0;2023;04;BORDEAUX;MASCULIN;FORMATION CONTINUE;BAC PROFESSIONNEL;BAC PRO PROD;BAC PRO 25007 MAINTENANCE EQUIPEMENTS INDUST.;1;1;1;0;0;0;0;1;0;1;0;0;0;0
18076.0;2023;04;BORDEAUX;MASCULIN;FORMATION CONTINUE;BAC PROFESSIONNEL;BAC PRO PROD;BAC PRO 25510 METIERS ELECT. ENVIRON. CONNECTES;2;2;2;0;0;0;0;2;0;1;0;0;1;0
18080.0;2023;04;BORDEAUX;MASCULIN;INDIVIDUEL;BAC GENERAL;BAC GENERAL;BAC GENE 10019 BAC GENERAL;85;80;25;45;10;6;4;31;0;0;1;7;23;49
18082.0;2023;04;BORDEAUX;MASCULIN;INDIVIDUEL;BAC PROFESSIONNEL;BAC PRO PROD;BAC PRO 22106 CUISINE;1;1;1;0;0;0;0;1;0;0;0;0;1;0
18085.0;2023;04;BORDEAUX;MASCULIN;INDIVIDUEL;BAC PROFESSIONNEL;BAC PRO PROD;BAC PRO 25216 MAINT.VEHIC.OPTC MOTOCYCLES;1;0;0;0;0;0;0;0;0;0;0;0;0;0
18088.0;2023;04;BORDEAUX;MASCULIN;INDIVIDUEL;BAC PROFESSIONNEL;BAC PRO PROD;BAC PRO AG 21004 CGEA;1;1;1;0;0;0;0;1;0;0;0;0;1;0
18093.0;2023;04;BORDEAUX;MASCULIN;INDIVIDUEL;BAC PROFESSIONNEL;BAC PRO SERV;BAC PRO 31212 METIERS DE L'ACCUEIL;1;1;0;1;0;0;0;0;0;0;0;0;0;1
18095.0;2023;04;BORDEAUX;MASCULIN;INDIVIDUEL;BAC PROFESSIONNEL;BAC PRO SERV;BAC PRO 31214 MET.COM.VEN.OP.B PR.CL.VA.OF.COM.;3;0;0;0;0;0;0;0;0;0;0;0;0;0
18096.0;2023;04;BORDEAUX;MASCULIN;INDIVIDUEL;BAC PROFESSIONNEL;BAC PRO SERV;BAC PRO 32208 REAL.PR.IMPR.PLURI.OPTB.PR.IMPR.;1;1;0;1;0;0;0;0;0;0;0;0;0;1
18101.0;2023;04;BORDEAUX;MASCULIN;INDIVIDUEL;BAC TECHNOLOGIQUE;BAC STI2D;BAC STI2D SYSTÈME D'INFORMATION  ET NUMERIQUE;1;1;0;1;0;0;0;0;0;0;0;0;0;1
18107.0;2023;04;BORDEAUX;MASCULIN;SCOLAIRE;BAC GENERAL;BAC GENERAL;BAC GENE 10019 BAC GENERAL;8431;8431;7603;149;679;479;200;8082;99;857;1788;2594;2744;349
18112.0;2023;04;BORDEAUX;MASCULIN;SCOLAIRE;BAC PROFESSIONNEL;BAC PRO PROD;BAC PRO 22104 BOUCHER CHARCUTIER TRAITEUR;9;9;9;0;0;0;0;9;0;0;4;4;1;0
18115.0;2023;04;BORDEAUX;MASCULIN;SCOLAIRE;BAC PROFESSIONNEL;BAC PRO PROD;BAC PRO 22403 ARTS.& MET.ART:MET.ENSEIGN SIGNA;8;8;7;0;1;0;1;7;0;0;2;1;4;1
18117.0;2023;04;BORDEAUX;MASCULIN;SCOLAIRE;BAC PROFESSIONNEL;BAC PRO PROD;BAC PRO 22703 TECHN.INSTALL.SYST.ENERG.CLIMATI;70;70;49;15;6;4;2;53;0;1;7;20;25;17
18120.0;2023;04;BORDEAUX;MASCULIN;SCOLAIRE;BAC PROFESSIONNEL;BAC PRO PROD;BAC PRO 23004 TECHN. ETUDES BAT.A ETUDES & ECO.;55;55;43;11;1;1;0;44;0;1;7;13;23;11
18124.0;2023;04;BORDEAUX;MASCULIN;SCOLAIRE;BAC PROFESSIONNEL;BAC PRO PROD;BAC PRO 23203 TECHNICIEN BAT. : ORG.REAL.GROS O;23;23;19;4;0;0;0;19;0;1;2;6;10;4
18128.0;2023;04;BORDEAUX;MASCULIN;SCOLAIRE;BAC PROFESSIONNEL;BAC PRO PROD;BAC PRO 23404 TECHNICIEN CONSTRUCTEUR BOIS;67;67;55;12;0;0;0;55;0;1;8;23;23;12
18131.0;2023;04;BORDEAUX;MASCULIN;SCOLAIRE;BAC PROFESSIONNEL;BAC PRO PROD;BAC PRO 23408 Etude et réalisation d'agencement;4;4;4;0;0;0;0;4;0;1;1;1;1;0
18132.0;2023;04;BORDEAUX;MASCULIN;SCOLAIRE;BAC PROFESSIONNEL;BAC PRO PROD;BAC PRO 24202 ARTIS.& MET.ART : TAPIS.D'AMEUBL;4;4;4;0;0;0;0;4;0;0;1;1;2;0
18133.0;2023;04;BORDEAUX;MASCULIN;SCOLAIRE;BAC PROFESSIONNEL;BAC PRO PROD;BAC PRO 24203 METIERS DE LA MODE - VÊTEMENT;17;17;15;2;0;0;0;15;0;2;3;3;7;2
18134.0;2023;04;BORDEAUX;MASCULIN;SCOLAIRE;BAC PROFESSIONNEL;BAC PRO PROD;BAC PRO 25007 MAINTENANCE EQUIPEMENTS INDUST.;158;157;114;36;7;5;2;119;0;7;27;46;39;38
18137.0;2023;04;BORDEAUX;MASCULIN;SCOLAIRE;BAC PROFESSIONNEL;BAC PRO PROD;BAC PRO 25107 TECHNICIEN OUTILLEUR;18;18;17;1;0;0;0;17;0;0;4;10;3;1
18139.0;2023;04;BORDEAUX;MASCULIN;SCOLAIRE;BAC PROFESSIONNEL;BAC PRO PROD;BAC PRO 25215 MAINT.VEHIC.OPTB VEHIC.TRANS.ROUT;39;39;27;9;3;3;0;30;0;4;5;6;15;9
18143.0;2023;04;BORDEAUX;MASCULIN;SCOLAIRE;BAC PROFESSIONNEL;BAC PRO PROD;BAC PRO 25221 MAINT.MATERIELS OPT.C ESP. VERTS;6;6;4;2;0;0;0;4;0;0;0;2;2;2
18148.0;2023;04;BORDEAUX;MASCULIN;SCOLAIRE;BAC PROFESSIONNEL;BAC PRO PROD;BAC PRO 25408 REPARATION DES CARROSSERIES;34;34;22;12;0;0;0;22;0;1;6;9;6;12
18149.0;2023;04;BORDEAUX;MASCULIN;SCOLAIRE;BAC PROFESSIONNEL;BAC PRO PROD;BAC PRO 25411 TECH.CHAUDRONNERIE INDUSTRIELLE;145;144;117;21;6;6;0;123;0;12;30;47;34;21
18163.0;2023;04;BORDEAUX;MASCULIN;SCOLAIRE;BAC PROFESSIONNEL;BAC PRO PROD;BAC PRO AG 21302 GEST MILIEUX NATURELS FAUNE;65;65;60;5;0;0;0;60;0;2;13;23;22;5
18165.0;2023;04;BORDEAUX;MASCULIN;SCOLAIRE;BAC PROFESSIONNEL;BAC PRO PROD;BAC PRO AG 21405 AMENAGEMENTS PAYSAGERS;84;84;74;10;0;0;0;74;0;2;12;29;31;10
18167.0;2023;04;BORDEAUX;MASCULIN;SCOLAIRE;BAC PROFESSIONNEL;BAC PRO PROD;BAC PRO AG 22105 LABORATOIRE CONTROLE QUALITE;19;19;19;0;0;0;0;19;0;1;4;9;5;0
18175.0;2023;04;BORDEAUX;MASCULIN;SCOLAIRE;BAC PROFESSIONNEL;BAC PRO SERV;BAC PRO 31214 MET.COM.VEN.OP.B PR.CL.VA.OF.COM.;238;235;184;42;9;6;3;190;0;9;36;74;71;45
18186.0;2023;04;BORDEAUX;MASCULIN;SCOLAIRE;BAC PROFESSIONNEL;BAC PRO SERV;BAC PRO 33603 ESTHETIQUE COSMETIQUE PARFUMERIE;1;1;1;0;0;0;0;1;0;0;1;0;0;0
18187.0;2023;04;BORDEAUX;MASCULIN;SCOLAIRE;BAC PROFESSIONNEL;BAC PRO SERV;BAC PRO 33604 METIERS DE LA COIFFURE;2;2;1;1;0;0;0;1;0;0;0;0;1;1
18191.0;2023;04;BORDEAUX;MASCULIN;SCOLAIRE;BAC PROFESSIONNEL;BAC PRO SERV;BAC PRO AG 33002 SERV PERS TERRIT;81;80;74;6;0;0;0;74;0;0;9;26;39;6
18203.0;2023;04;BORDEAUX;MASCULIN;SCOLAIRE;BAC TECHNOLOGIQUE;BAC STL;BAC STL SCIENCES PHYSIQUES CHIMIQUES  EN LABORAT.;71;71;63;2;6;3;3;66;0;1;21;22;22;5
18208.0;2023;06;CLERMONT-FERRAND;FEMININ;APPRENTISSAGE;BAC PROFESSIONNEL;BAC PRO PROD;BAC PRO 20102 PILOTE DE LIGNE DE PRODUCTION;1;1;1;0;0;0;0;1;0;0;1;0;0;0
18217.0;2023;06;CLERMONT-FERRAND;FEMININ;APPRENTISSAGE;BAC PROFESSIONNEL;BAC PRO PROD;BAC PRO AG 21203 TECHN CONSEIL DE VENTE ANIMAL;3;3;2;1;0;0;0;2;0;0;0;1;1;1
18236.0;2023;06;CLERMONT-FERRAND;FEMININ;ENSEIGNEMENT A DISTANCE;BAC TECHNOLOGIQUE;BAC STMG;BAC STMG MERCATIQUE (MARKETING);1;1;0;0;1;1;0;1;0;0;0;0;1;0
18250.0;2023;06;CLERMONT-FERRAND;FEMININ;INDIVIDUEL;BAC PROFESSIONNEL;BAC PRO PROD;BAC PRO AG 21211 COND GEST ENTR HIPPIQUE;4;4;3;1;0;0;0;3;0;0;0;0;3;1
18257.0;2023;06;CLERMONT-FERRAND;FEMININ;INDIVIDUEL;BAC TECHNOLOGIQUE;BAC STMG;BAC STMG GESTION ET FINANCE;2;2;1;1;0;0;0;1;0;1;0;0;0;1
18261.0;2023;06;CLERMONT-FERRAND;FEMININ;SCOLAIRE;BAC PROFESSIONNEL;BAC PRO PROD;BACPRO 20002 ETUD.DEFINITION PRDTS INDUSTRIEL;1;1;1;0;0;0;0;1;0;0;0;0;1;0
18262.0;2023;06;CLERMONT-FERRAND;FEMININ;SCOLAIRE;BAC PROFESSIONNEL;BAC PRO PROD;BAC PRO 22003 BIO-INDUSTRIES DE TRANSFORMATION;19;19;18;1;0;0;0;18;0;1;7;7;3;1
18263.0;2023;06;CLERMONT-FERRAND;FEMININ;SCOLAIRE;BAC PROFESSIONNEL;BAC PRO PROD;BAC PRO 22106 CUISINE;38;38;35;2;1;1;0;36;0;2;8;13;13;2
18271.0;2023;06;CLERMONT-FERRAND;FEMININ;SCOLAIRE;BAC PROFESSIONNEL;BAC PRO PROD;BAC PRO 23405 TECHNICIEN MENUISIER AGENCEUR;1;1;1;0;0;0;0;1;0;0;0;0;1;0
18279.0;2023;06;CLERMONT-FERRAND;FEMININ;SCOLAIRE;BAC PROFESSIONNEL;BAC PRO PROD;BAC PRO 25304 AERONAUTIQUE OPTION STRUCTURE;2;2;2;0;0;0;0;2;0;0;0;2;0;0
18280.0;2023;06;CLERMONT-FERRAND;FEMININ;SCOLAIRE;BAC PROFESSIONNEL;BAC PRO PROD;BAC PRO 25408 REPARATION DES CARROSSERIES;1;1;1;0;0;0;0;1;0;0;0;1;0;0
18292.0;2023;06;CLERMONT-FERRAND;FEMININ;SCOLAIRE;BAC PROFESSIONNEL;BAC PRO PROD;BAC PRO AG 21405 AMENAGEMENTS PAYSAGERS;8;8;8;0;0;0;0;8;0;0;2;2;4;0
18297.0;2023;06;CLERMONT-FERRAND;FEMININ;SCOLAIRE;BAC PROFESSIONNEL;BAC PRO SERV;BAC PRO 31106 LOGISTIQUE;3;3;1;1;1;1;0;2;0;0;1;0;1;1
18299.0;2023;06;CLERMONT-FERRAND;FEMININ;SCOLAIRE;BAC PROFESSIONNEL;BAC PRO SERV;BAC PRO 31114 ORGANIS. TRANSPORT MARCHANDISES;10;10;7;3;0;0;0;7;0;0;0;4;3;3
18300.0;2023;06;CLERMONT-FERRAND;FEMININ;SCOLAIRE;BAC PROFESSIONNEL;BAC PRO SERV;BAC PRO 31212 METIERS DE L'ACCUEIL;86;86;72;7;7;6;1;78;0;4;18;23;33;8
18307.0;2023;06;CLERMONT-FERRAND;FEMININ;SCOLAIRE;BAC PROFESSIONNEL;BAC PRO SERV;BAC PRO 33003 ACC.SOINS-S.PERS. OPT.A DOMICILE;51;51;46;3;2;1;1;47;0;3;3;24;17;4
18310.0;2023;06;CLERMONT-FERRAND;FEMININ;SCOLAIRE;BAC PROFESSIONNEL;BAC PRO SERV;BAC PRO 33101 OPTIQUE LUNETTERIE;18;18;18;0;0;0;0;18;0;2;4;9;3;0
18312.0;2023;06;CLERMONT-FERRAND;FEMININ;SCOLAIRE;BAC PROFESSIONNEL;BAC PRO SERV;BAC PRO 33403 COMMERC. SERVICES EN RESTAURATION;28;28;18;6;4;4;0;22;0;1;3;7;11;6
18316.0;2023;06;CLERMONT-FERRAND;FEMININ;SCOLAIRE;BAC PROFESSIONNEL;BAC PRO SERV;BAC PRO 34403 METIERS DE LA SECURITE;17;17;15;1;1;1;0;16;0;1;3;8;4;1
18317.0;2023;06;CLERMONT-FERRAND;FEMININ;SCOLAIRE;BAC PROFESSIONNEL;BAC PRO SERV;BAC PRO AG 33002 SERV PERS TERRIT;130;129;121;8;0;0;0;121;0;3;16;50;52;8
18320.0;2023;06;CLERMONT-FERRAND;FEMININ;SCOLAIRE;BAC TECHNOLOGIQUE;BAC STD2A;BAC STD2A SCIENCES & TECHNO. DESIGN-ARTS APPLIQUES;80;80;79;0;1;1;0;80;1;4;24;34;17;0
18322.0;2023;06;CLERMONT-FERRAND;FEMININ;SCOLAIRE;BAC TECHNOLOGIQUE;BAC STI2D;BAC STI2D ARCHITECTURE ET CONSTRUCTION;28;28;23;3;2;2;0;25;0;1;4;10;10;3
18323.0;2023;06;CLERMONT-FERRAND;FEMININ;SCOLAIRE;BAC TECHNOLOGIQUE;BAC STI2D;BAC STI2D ENERGIES  ET ENVIRONNEMENT;4;4;3;0;1;0;1;3;0;0;0;1;2;1
18326.0;2023;06;CLERMONT-FERRAND;FEMININ;SCOLAIRE;BAC TECHNOLOGIQUE;BAC STL;BAC STL BIOCHIM.-BIOLOGIE-BIOTECHNOL.;62;62;53;0;9;6;3;59;1;2;10;27;19;3
18334.0;2023;06;CLERMONT-FERRAND;MASCULIN;APPRENTISSAGE;BAC PROFESSIONNEL;BAC PRO PROD;BAC PRO 22403 ARTS.& MET.ART:MET.ENSEIGN SIGNA;2;2;2;0;0;0;0;2;0;1;0;1;0;0
18341.0;2023;06;CLERMONT-FERRAND;MASCULIN;APPRENTISSAGE;BAC PROFESSIONNEL;BAC PRO PROD;BAC PRO 23404 TECHNICIEN CONSTRUCTEUR BOIS;4;4;3;1;0;0;0;3;0;0;1;0;2;1
18348.0;2023;06;CLERMONT-FERRAND;MASCULIN;APPRENTISSAGE;BAC PROFESSIONNEL;BAC PRO PROD;BAC PRO 25219 MAINT.MATERIELS OPT.A AGRICOLES;16;16;14;1;1;0;1;14;0;1;3;2;8;2
18350.0;2023;06;CLERMONT-FERRAND;MASCULIN;APPRENTISSAGE;BAC PROFESSIONNEL;BAC PRO PROD;BAC PRO 25221 MAINT.MATERIELS OPT.C ESP. VERTS;7;7;5;1;1;0;1;5;0;0;2;2;1;2
18358.0;2023;06;CLERMONT-FERRAND;MASCULIN;APPRENTISSAGE;BAC PROFESSIONNEL;BAC PRO PROD;BAC PRO 25513 SYST.NUM.OPT.A SURETE SECURITE;1;1;1;0;0;0;0;1;0;0;0;0;1;0
18367.0;2023;06;CLERMONT-FERRAND;MASCULIN;APPRENTISSAGE;BAC PROFESSIONNEL;BAC PRO PROD;BAC PRO AG 22108 TEC CONS VTE ALIMENTATION (PAB);1;1;1;0;0;0;0;1;0;0;1;0;0;0
18375.0;2023;06;CLERMONT-FERRAND;MASCULIN;ENSEIGNEMENT A DISTANCE;BAC PROFESSIONNEL;BAC PRO PROD;BAC PRO AG 21004 CGEA;12;10;6;4;0;0;0;6;0;0;0;0;6;4
18384.0;2023;06;CLERMONT-FERRAND;MASCULIN;FORMATION CONTINUE;BAC PROFESSIONNEL;BAC PRO SERV;BAC PRO 32304 PHOTOGRAPHIE;2;2;2;0;0;0;0;2;0;0;1;1;0;0
18389.0;2023;06;CLERMONT-FERRAND;MASCULIN;INDIVIDUEL;BAC PROFESSIONNEL;BAC PRO PROD;BAC PRO 25410 CONSTRUCTION DES CARROSSERIES;1;1;1;0;0;0;0;1;0;0;0;0;1;0
18392.0;2023;06;CLERMONT-FERRAND;MASCULIN;INDIVIDUEL;BAC PROFESSIONNEL;BAC PRO PROD;BAC PRO AG 21004 CGEA;2;2;2;0;0;0;0;2;0;0;0;0;2;0
18399.0;2023;06;CLERMONT-FERRAND;MASCULIN;INDIVIDUEL;BAC PROFESSIONNEL;BAC PRO SERV;BAC PRO 33002 SERVICES DE PROXIMITE  VIE LOCAL;1;1;1;0;0;0;0;1;0;0;0;0;1;0
18400.0;2023;06;CLERMONT-FERRAND;MASCULIN;INDIVIDUEL;BAC PROFESSIONNEL;BAC PRO SERV;BAC PRO 34403 METIERS DE LA SECURITE;1;1;1;0;0;0;0;1;0;0;0;1;0;0
18413.0;2023;06;CLERMONT-FERRAND;MASCULIN;SCOLAIRE;BAC PROFESSIONNEL;BAC PRO PROD;BAC PRO 22403 ARTS.& MET.ART:MET.ENSEIGN SIGNA;7;7;7;0;0;0;0;7;0;0;3;4;0;0
18416.0;2023;06;CLERMONT-FERRAND;MASCULIN;SCOLAIRE;BAC PROFESSIONNEL;BAC PRO PROD;BAC PRO 22704 TECHN. MAINT. SYST.ENERG.CLIMATI;6;6;5;1;0;0;0;5;0;0;0;1;4;1
18420.0;2023;06;CLERMONT-FERRAND;MASCULIN;SCOLAIRE;BAC PROFESSIONNEL;BAC PRO PROD;BAC PRO 23102 TRAVAUX PUBLICS;10;10;8;1;1;1;0;9;0;0;0;6;3;1
18422.0;2023;06;CLERMONT-FERRAND;MASCULIN;SCOLAIRE;BAC PROFESSIONNEL;BAC PRO PROD;BAC PRO 23203 TECHNICIEN BAT. : ORG.REAL.GROS O;7;7;6;1;0;0;0;6;0;0;2;4;0;1
18425.0;2023;06;CLERMONT-FERRAND;MASCULIN;SCOLAIRE;BAC PROFESSIONNEL;BAC PRO PROD;BAC PRO 23405 TECHNICIEN MENUISIER AGENCEUR;32;32;24;6;2;2;0;26;0;1;6;6;13;6
18426.0;2023;06;CLERMONT-FERRAND;MASCULIN;SCOLAIRE;BAC PROFESSIONNEL;BAC PRO PROD;BAC PRO 24203 METIERS DE LA MODE - VÊTEMENT;3;3;3;0;0;0;0;3;0;1;0;1;1;0
18427.0;2023;06;CLERMONT-FERRAND;MASCULIN;SCOLAIRE;BAC PROFESSIONNEL;BAC PRO PROD;BAC PRO 24302 METIERS DU CUIR : MAROQUINERIE;3;3;3;0;0;0;0;3;0;0;0;0;3;0
18432.0;2023;06;CLERMONT-FERRAND;MASCULIN;SCOLAIRE;BAC PROFESSIONNEL;BAC PRO PROD;BAC PRO 25219 MAINT.MATERIELS OPT.A AGRICOLES;22;22;21;0;1;1;0;22;0;2;4;8;8;0
18435.0;2023;06;CLERMONT-FERRAND;MASCULIN;SCOLAIRE;BAC PROFESSIONNEL;BAC PRO PROD;BAC PRO 25302 AERONAUTIQUE OPTION AVIONIQUE;8;8;7;0;1;1;0;8;0;0;2;2;4;0
18442.0;2023;06;CLERMONT-FERRAND;MASCULIN;SCOLAIRE;BAC PROFESSIONNEL;BAC PRO PROD;BAC PRO 25510 METIERS ELECT. ENVIRON. CONNECTES;198;198;128;60;10;7;3;135;0;7;25;31;72;63
18443.0;2023;06;CLERMONT-FERRAND;MASCULIN;SCOLAIRE;BAC PROFESSIONNEL;BAC PRO PROD;BAC PRO 25513 SYST.NUM.OPT.A SURETE SECURITE;24;24;16;3;5;2;3;18;0;0;2;4;12;6
18447.0;2023;06;CLERMONT-FERRAND;MASCULIN;SCOLAIRE;BAC PROFESSIONNEL;BAC PRO PROD;BAC PRO AG 21004 CGEA;186;184;159;25;0;0;0;159;0;3;24;55;77;25
18448.0;2023;06;CLERMONT-FERRAND;MASCULIN;SCOLAIRE;BAC PROFESSIONNEL;BAC PRO PROD;BAC PRO AG 21114 CONDUITE PRODUCTIONS HORTICOLES;5;5;5;0;0;0;0;5;0;0;0;4;1;0
18455.0;2023;06;CLERMONT-FERRAND;MASCULIN;SCOLAIRE;BAC PROFESSIONNEL;BAC PRO PROD;BAC PRO AG 21407 TEC CONS VTE UNIVERS JARDINERIE;3;3;3;0;0;0;0;3;0;0;1;0;2;0
18459.0;2023;06;CLERMONT-FERRAND;MASCULIN;SCOLAIRE;BAC PROFESSIONNEL;BAC PRO SERV;BAC PRO 31107 CONDUCT. TRANSP.ROUT.MARCHANDISES;20;20;20;0;0;0;0;20;0;0;5;11;4;0
18467.0;2023;06;CLERMONT-FERRAND;MASCULIN;SCOLAIRE;BAC PROFESSIONNEL;BAC PRO SERV;BAC PRO 32304 PHOTOGRAPHIE;5;4;4;0;0;0;0;4;0;2;1;1;0;0
18468.0;2023;06;CLERMONT-FERRAND;MASCULIN;SCOLAIRE;BAC PROFESSIONNEL;BAC PRO SERV;BAC PRO 33003 ACC.SOINS-S.PERS. OPT.A DOMICILE;5;5;4;0;1;1;0;5;0;0;1;1;3;0
18475.0;2023;06;CLERMONT-FERRAND;MASCULIN;SCOLAIRE;BAC PROFESSIONNEL;BAC PRO SERV;BAC PRO 34304 HYGIENE PROPRETE STERILISATION;4;4;1;3;0;0;0;1;0;0;0;0;1;3
18477.0;2023;06;CLERMONT-FERRAND;MASCULIN;SCOLAIRE;BAC PROFESSIONNEL;BAC PRO SERV;BAC PRO AG 33002 SERV PERS TERRIT;15;15;13;2;0;0;0;13;0;0;1;5;7;2
18478.0;2023;06;CLERMONT-FERRAND;MASCULIN;SCOLAIRE;BAC TECHNOLOGIQUE;BAC ST2S;BAC ST2S SCIENCES & TECHNO. SANTE & SOCIAL;61;61;44;3;14;7;7;51;0;1;1;14;35;10
18482.0;2023;06;CLERMONT-FERRAND;MASCULIN;SCOLAIRE;BAC TECHNOLOGIQUE;BAC STI2D;BAC STI2D ARCHITECTURE ET CONSTRUCTION;103;103;99;0;4;3;1;102;0;2;13;48;39;1
18489.0;2023;06;CLERMONT-FERRAND;MASCULIN;SCOLAIRE;BAC TECHNOLOGIQUE;BAC STMG;BAC STMG MERCATIQUE (MARKETING);309;309;192;18;99;63;36;255;0;1;9;42;203;54
18501.0;2023;27;CORSE;FEMININ;ENSEIGNEMENT A DISTANCE;BAC TECHNOLOGIQUE;BAC STMG;BAC STMG RESSOURCES HUMAINES ET COMMUNICATION;1;1;0;1;0;0;0;0;0;0;0;0;0;1
18506.0;2023;27;CORSE;FEMININ;INDIVIDUEL;BAC PROFESSIONNEL;BAC PRO PROD;BAC PRO AG 21211 COND GEST ENTR HIPPIQUE;1;1;1;0;0;0;0;1;0;0;0;0;1;0
18513.0;2023;27;CORSE;FEMININ;SCOLAIRE;BAC PROFESSIONNEL;BAC PRO PROD;BAC PRO 25007 MAINTENANCE EQUIPEMENTS INDUST.;1;1;1;0;0;0;0;1;0;0;0;1;0;0
18515.0;2023;27;CORSE;FEMININ;SCOLAIRE;BAC PROFESSIONNEL;BAC PRO PROD;BAC PRO AG 21004 CGEA;4;4;2;2;0;0;0;2;0;0;0;2;0;2
18520.0;2023;27;CORSE;FEMININ;SCOLAIRE;BAC PROFESSIONNEL;BAC PRO SERV;BAC PRO 30004 ASSISTANC.GEST.ORGANIS.ACTIVITES;52;52;32;13;7;6;1;38;0;2;3;15;18;14
18524.0;2023;27;CORSE;FEMININ;SCOLAIRE;BAC PROFESSIONNEL;BAC PRO SERV;BAC PRO 31213 MET.COM.VEN.OP.A ANI.GES.ESP.COM.;23;23;19;4;0;0;0;19;0;2;3;5;9;4
18527.0;2023;27;CORSE;FEMININ;SCOLAIRE;BAC PROFESSIONNEL;BAC PRO SERV;BAC PRO 33004 ACC.SOINS-S.PERS. OPT.EN STRUCTUR;68;68;61;5;2;2;0;63;0;4;13;22;24;5
18528.0;2023;27;CORSE;FEMININ;SCOLAIRE;BAC PROFESSIONNEL;BAC PRO SERV;BAC PRO 33006 ANIMAT. ENFANCE& PERSONNES AGEES;10;10;10;0;0;0;0;10;0;2;3;3;2;0
18533.0;2023;27;CORSE;FEMININ;SCOLAIRE;BAC TECHNOLOGIQUE;BAC STAV;BAC STAV AGRONOMIE ALIM ENV TERRITOI;9;9;7;2;0;0;0;7;0;1;0;4;2;2
18538.0;2023;27;CORSE;FEMININ;SCOLAIRE;BAC TECHNOLOGIQUE;BAC STMG;BAC STMG GESTION ET FINANCE;36;36;30;1;5;4;1;34;0;2;11;11;10;2
18547.0;2023;27;CORSE;MASCULIN;APPRENTISSAGE;BAC PROFESSIONNEL;BAC PRO PROD;BAC PRO 25510 METIERS ELECT. ENVIRON. CONNECTES;17;16;14;0;2;2;0;16;0;2;4;6;4;0
18552.0;2023;27;CORSE;MASCULIN;APPRENTISSAGE;BAC PROFESSIONNEL;BAC PRO SERV;BAC PRO 31213 MET.COM.VEN.OP.A ANI.GES.ESP.COM.;13;12;9;3;0;0;0;9;0;1;1;4;3;3
18554.0;2023;27;CORSE;MASCULIN;APPRENTISSAGE;BAC PROFESSIONNEL;BAC PRO SERV;BAC PRO 33403 COMMERC. SERVICES EN RESTAURATION;1;1;1;0;0;0;0;1;0;0;0;1;0;0
18570.0;2023;27;CORSE;MASCULIN;SCOLAIRE;BAC PROFESSIONNEL;BAC PRO PROD;BAC PRO 25007 MAINTENANCE EQUIPEMENTS INDUST.;19;19;12;6;1;1;0;13;0;0;3;4;6;6
18580.0;2023;27;CORSE;MASCULIN;SCOLAIRE;BAC PROFESSIONNEL;BAC PRO PROD;BAC PRO AG 21211 COND GEST ENTR HIPPIQUE;1;1;1;0;0;0;0;1;0;0;1;0;0;0
18583.0;2023;27;CORSE;MASCULIN;SCOLAIRE;BAC PROFESSIONNEL;BAC PRO PROD;BAC PRO AG 21405 AMENAGEMENTS PAYSAGERS;9;9;8;1;0;0;0;8;0;0;0;2;6;1
18585.0;2023;27;CORSE;MASCULIN;SCOLAIRE;BAC PROFESSIONNEL;BAC PRO SERV;BAC PRO 31106 LOGISTIQUE;13;13;11;2;0;0;0;11;0;0;1;6;4;2
18596.0;2023;27;CORSE;MASCULIN;SCOLAIRE;BAC TECHNOLOGIQUE;BAC STAV;BAC STAV AGRONOMIE ALIM ENV TERRITOI;4;4;4;0;0;0;0;4;0;0;0;3;1;0
18601.0;2023;27;CORSE;MASCULIN;SCOLAIRE;BAC TECHNOLOGIQUE;BAC STI2D;BAC STI2D SYSTÈME D'INFORMATION  ET NUMERIQUE;42;42;42;0;0;0;0;42;0;1;8;18;15;0
18607.0;2023;24;CRETEIL;FEMININ;APPRENTISSAGE;BAC PROFESSIONNEL;BAC PRO PROD;BAC PRO 22704 TECHN. MAINT. SYST.ENERG.CLIMATI;1;1;1;0;0;0;0;1;0;0;0;1;0;0
18611.0;2023;24;CRETEIL;FEMININ;APPRENTISSAGE;BAC PROFESSIONNEL;BAC PRO PROD;BAC PRO 24302 METIERS DU CUIR : MAROQUINERIE;15;15;13;2;0;0;0;13;0;2;5;6;0;2
18634.0;2023;24;CRETEIL;FEMININ;ENSEIGNEMENT A DISTANCE;BAC PROFESSIONNEL;BAC PRO SERV;BAC PRO 31213 MET.COM.VEN.OP.A ANI.GES.ESP.COM.;9;6;3;2;1;0;1;3;0;0;0;2;1;3
18636.0;2023;24;CRETEIL;FEMININ;ENSEIGNEMENT A DISTANCE;BAC PROFESSIONNEL;BAC PRO SERV;BAC PRO 33004 ACC.SOINS-S.PERS. OPT.EN STRUCTUR;10;7;4;3;0;0;0;4;0;0;0;1;3;3
18640.0;2023;24;CRETEIL;FEMININ;ENSEIGNEMENT A DISTANCE;BAC TECHNOLOGIQUE;BAC STMG;BAC STMG MERCATIQUE (MARKETING);7;7;2;3;2;2;0;4;0;0;0;1;3;3
18645.0;2023;24;CRETEIL;FEMININ;FORMATION CONTINUE;BAC PROFESSIONNEL;BAC PRO PROD;BAC PRO 24303 MET. DU CUIR: SELLERIE GARNISSAGE;9;8;8;0;0;0;0;8;0;3;2;1;2;0
18647.0;2023;24;CRETEIL;FEMININ;FORMATION CONTINUE;BAC PROFESSIONNEL;BAC PRO PROD;BAC PRO 25303 AERONAUTIQUE OPTION SYSTEMES;1;1;1;0;0;0;0;1;0;0;1;0;0;0
18653.0;2023;24;CRETEIL;FEMININ;FORMATION CONTINUE;BAC PROFESSIONNEL;BAC PRO SERV;BAC PRO 33604 METIERS DE LA COIFFURE;39;30;22;8;0;0;0;22;0;0;4;5;13;8
18657.0;2023;24;CRETEIL;FEMININ;INDIVIDUEL;BAC PROFESSIONNEL;BAC PRO PROD;BAC PRO 23408 Etude et réalisation d'agencement;1;1;0;1;0;0;0;0;0;0;0;0;0;1
18658.0;2023;24;CRETEIL;FEMININ;INDIVIDUEL;BAC PROFESSIONNEL;BAC PRO PROD;BAC PRO 24203 METIERS DE LA MODE - VÊTEMENT;2;2;1;1;0;0;0;1;0;0;0;0;1;1
18660.0;2023;24;CRETEIL;FEMININ;INDIVIDUEL;BAC PROFESSIONNEL;BAC PRO PROD;BAC PRO AG 21211 COND GEST ENTR HIPPIQUE;6;6;2;4;0;0;0;2;0;0;0;0;2;4
18665.0;2023;24;CRETEIL;FEMININ;INDIVIDUEL;BAC PROFESSIONNEL;BAC PRO SERV;BAC PRO 33002 SERVICES DE PROXIMITE  VIE LOCAL;3;3;0;3;0;0;0;0;0;0;0;0;0;3
18672.0;2023;24;CRETEIL;FEMININ;INDIVIDUEL;BAC TECHNOLOGIQUE;BAC STD2A;BAC STD2A SCIENCES & TECHNO. DESIGN-ARTS APPLIQUES;2;2;0;2;0;0;0;0;0;0;0;0;0;2
18676.0;2023;24;CRETEIL;FEMININ;INDIVIDUEL;BAC TECHNOLOGIQUE;BAC STL;BAC STL BIOCHIM.-BIOLOGIE-BIOTECHNOL.;2;2;1;1;0;0;0;1;0;0;0;0;1;1
18682.0;2023;24;CRETEIL;FEMININ;SCOLAIRE;BAC PROFESSIONNEL;BAC PRO PROD;BACPRO 20002 ETUD.DEFINITION PRDTS INDUSTRIEL;1;1;1;0;0;0;0;1;0;1;0;0;0;0
18683.0;2023;24;CRETEIL;FEMININ;SCOLAIRE;BAC PROFESSIONNEL;BAC PRO PROD;BAC PRO 22004 PROC. CHIMIE EAU PAPIERS-CARTONS;5;5;4;1;0;0;0;4;0;0;0;1;3;1
18684.0;2023;24;CRETEIL;FEMININ;SCOLAIRE;BAC PROFESSIONNEL;BAC PRO PROD;BAC PRO 22106 CUISINE;47;47;37;7;3;2;1;39;0;3;7;16;13;8
18685.0;2023;24;CRETEIL;FEMININ;SCOLAIRE;BAC PROFESSIONNEL;BAC PRO PROD;BAC PRO 22703 TECHN.INSTALL.SYST.ENERG.CLIMATI;2;2;2;0;0;0;0;2;0;0;0;0;2;0
18694.0;2023;24;CRETEIL;FEMININ;SCOLAIRE;BAC PROFESSIONNEL;BAC PRO PROD;BAC PRO 23405 TECHNICIEN MENUISIER AGENCEUR;8;8;5;1;2;1;1;6;0;0;1;3;2;2
18697.0;2023;24;CRETEIL;FEMININ;SCOLAIRE;BAC PROFESSIONNEL;BAC PRO PROD;BAC PRO 24203 METIERS DE LA MODE - VÊTEMENT;148;148;122;23;3;2;1;124;0;10;39;40;35;24
18713.0;2023;24;CRETEIL;FEMININ;SCOLAIRE;BAC PROFESSIONNEL;BAC PRO PROD;BAC PRO AG 21407 TEC CONS VTE UNIVERS JARDINERIE;6;6;6;0;0;0;0;6;0;0;0;0;6;0
18714.0;2023;24;CRETEIL;FEMININ;SCOLAIRE;BAC PROFESSIONNEL;BAC PRO PROD;BAC PRO AG 22105 LABORATOIRE CONTROLE QUALITE;19;18;14;4;0;0;0;14;0;0;1;3;10;4
18716.0;2023;24;CRETEIL;FEMININ;SCOLAIRE;BAC PROFESSIONNEL;BAC PRO SERV;BAC PRO 30004 ASSISTANC.GEST.ORGANIS.ACTIVITES;1092;1092;835;222;35;24;11;859;0;25;147;320;367;233
18722.0;2023;24;CRETEIL;FEMININ;SCOLAIRE;BAC PROFESSIONNEL;BAC PRO SERV;BAC PRO 31214 MET.COM.VEN.OP.B PR.CL.VA.OF.COM.;327;327;268;41;18;14;4;282;0;20;54;99;109;45
18723.0;2023;24;CRETEIL;FEMININ;SCOLAIRE;BAC PROFESSIONNEL;BAC PRO SERV;BAC PRO 32206 FACONNAGE PRODTS IMPRIMES ROUTAGE;4;4;4;0;0;0;0;4;0;0;1;2;1;0
18727.0;2023;24;CRETEIL;FEMININ;SCOLAIRE;BAC PROFESSIONNEL;BAC PRO SERV;BAC PRO 32304 PHOTOGRAPHIE;29;29;24;2;3;2;1;26;0;4;4;10;8;3
18732.0;2023;24;CRETEIL;FEMININ;SCOLAIRE;BAC PROFESSIONNEL;BAC PRO SERV;BAC PRO 33403 COMMERC. SERVICES EN RESTAURATION;50;50;38;11;1;1;0;39;0;0;4;17;18;11
18739.0;2023;24;CRETEIL;FEMININ;SCOLAIRE;BAC TECHNOLOGIQUE;BAC ST2S;BAC ST2S SCIENCES & TECHNO. SANTE & SOCIAL;1368;1368;1084;56;228;159;69;1243;2;39;167;378;657;125
18740.0;2023;24;CRETEIL;FEMININ;SCOLAIRE;BAC TECHNOLOGIQUE;BAC STAV;BAC STAV AGRONOMIE ALIM ENV TERRITOI;22;21;21;0;0;0;0;21;0;0;2;4;15;0
18741.0;2023;24;CRETEIL;FEMININ;SCOLAIRE;BAC TECHNOLOGIQUE;BAC STD2A;BAC STD2A SCIENCES & TECHNO. DESIGN-ARTS APPLIQUES;223;223;192;6;25;13;12;205;1;5;33;75;91;18
18744.0;2023;24;CRETEIL;FEMININ;SCOLAIRE;BAC TECHNOLOGIQUE;BAC STI2D;BAC STI2D ENERGIES  ET ENVIRONNEMENT;25;25;16;2;7;5;2;21;0;2;0;6;13;4
18745.0;2023;24;CRETEIL;FEMININ;SCOLAIRE;BAC TECHNOLOGIQUE;BAC STI2D;BAC STI2D INNOVATION TECHNO.  ET ECO CONCEPTION;44;44;31;9;4;3;1;34;0;0;3;4;27;10
18746.0;2023;24;CRETEIL;FEMININ;SCOLAIRE;BAC TECHNOLOGIQUE;BAC STI2D;BAC STI2D SYSTÈME D'INFORMATION  ET NUMERIQUE;40;40;33;1;6;6;0;39;0;1;5;13;20;1
18751.0;2023;24;CRETEIL;FEMININ;SCOLAIRE;BAC TECHNOLOGIQUE;BAC STMG;BAC STMG RESSOURCES HUMAINES ET COMMUNICATION;1170;1170;793;97;280;230;50;1023;0;8;61;231;723;147
18759.0;2023;24;CRETEIL;MASCULIN;APPRENTISSAGE;BAC PROFESSIONNEL;BAC PRO PROD;BAC PRO 24302 METIERS DU CUIR : MAROQUINERIE;2;2;2;0;0;0;0;2;0;0;0;1;1;0
18760.0;2023;24;CRETEIL;MASCULIN;APPRENTISSAGE;BAC PROFESSIONNEL;BAC PRO PROD;BAC PRO 24303 MET. DU CUIR: SELLERIE GARNISSAGE;11;10;9;1;0;0;0;9;0;1;3;3;2;1
18767.0;2023;24;CRETEIL;MASCULIN;APPRENTISSAGE;BAC PROFESSIONNEL;BAC PRO PROD;BAC PRO 25220 MAINT.MATERIELS OPT.B TP MANUT.;8;8;7;1;0;0;0;7;0;0;2;2;3;1
18768.0;2023;24;CRETEIL;MASCULIN;APPRENTISSAGE;BAC PROFESSIONNEL;BAC PRO PROD;BAC PRO 25221 MAINT.MATERIELS OPT.C ESP. VERTS;4;4;3;1;0;0;0;3;0;0;1;2;0;1
18772.0;2023;24;CRETEIL;MASCULIN;APPRENTISSAGE;BAC PROFESSIONNEL;BAC PRO PROD;BAC PRO 25509 TECHNIC. FROID CONDITIONNEMT AIR;31;31;22;6;3;3;0;25;0;1;6;5;13;6
18776.0;2023;24;CRETEIL;MASCULIN;APPRENTISSAGE;BAC PROFESSIONNEL;BAC PRO PROD;BAC PRO AG 21004 CGEA;16;15;11;4;0;0;0;11;0;0;1;3;7;4
18780.0;2023;24;CRETEIL;MASCULIN;APPRENTISSAGE;BAC PROFESSIONNEL;BAC PRO SERV;BAC PRO 31106 LOGISTIQUE;47;47;38;6;3;1;2;39;0;3;4;10;22;8
18791.0;2023;24;CRETEIL;MASCULIN;ENSEIGNEMENT A DISTANCE;BAC PROFESSIONNEL;BAC PRO SERV;BAC PRO 31213 MET.COM.VEN.OP.A ANI.GES.ESP.COM.;1;1;1;0;0;0;0;1;0;0;0;0;1;0
18792.0;2023;24;CRETEIL;MASCULIN;ENSEIGNEMENT A DISTANCE;BAC PROFESSIONNEL;BAC PRO SERV;BAC PRO 31214 MET.COM.VEN.OP.B PR.CL.VA.OF.COM.;1;1;1;0;0;0;0;1;0;0;0;0;1;0
18797.0;2023;24;CRETEIL;MASCULIN;ENSEIGNEMENT A DISTANCE;BAC TECHNOLOGIQUE;BAC STMG;BAC STMG MERCATIQUE (MARKETING);2;2;1;1;0;0;0;1;0;0;0;0;1;1
18800.0;2023;24;CRETEIL;MASCULIN;FORMATION CONTINUE;BAC PROFESSIONNEL;BAC PRO PROD;BAC PRO 22704 TECHN. MAINT. SYST.ENERG.CLIMATI;12;12;11;1;0;0;0;11;0;1;1;8;1;1
18812.0;2023;24;CRETEIL;MASCULIN;INDIVIDUEL;BAC GENERAL;BAC GENERAL;BAC GENE 10019 BAC GENERAL;208;204;41;135;28;17;11;58;0;4;4;7;43;146
18815.0;2023;24;CRETEIL;MASCULIN;INDIVIDUEL;BAC PROFESSIONNEL;BAC PRO PROD;BAC PRO 22704 TECHN. MAINT. SYST.ENERG.CLIMATI;1;0;0;0;0;0;0;0;0;0;0;0;0;0
18817.0;2023;24;CRETEIL;MASCULIN;INDIVIDUEL;BAC PROFESSIONNEL;BAC PRO PROD;BAC PRO 23005 TECHN. ETUDES BAT B ASSIST.ARCHI.;1;1;0;1;0;0;0;0;0;0;0;0;0;1
18824.0;2023;24;CRETEIL;MASCULIN;INDIVIDUEL;BAC PROFESSIONNEL;BAC PRO PROD;BAC PRO 25303 AERONAUTIQUE OPTION SYSTEMES;2;0;0;0;0;0;0;0;0;0;0;0;0;0
18834.0;2023;24;CRETEIL;MASCULIN;INDIVIDUEL;BAC PROFESSIONNEL;BAC PRO SERV;BAC PRO 31106 LOGISTIQUE;2;1;0;1;0;0;0;0;0;0;0;0;0;1
18853.0;2023;24;CRETEIL;MASCULIN;INDIVIDUEL;BAC TECHNOLOGIQUE;BAC STMG;BAC STMG MERCATIQUE (MARKETING);43;42;10;26;6;6;0;16;0;0;0;0;16;26
18855.0;2023;24;CRETEIL;MASCULIN;INDIVIDUEL;BAC TECHNOLOGIQUE;BAC STMG;BAC STMG SYSTEMES D'INFORMATION DE GESTION;6;6;2;3;1;1;0;3;0;0;0;0;3;3
18856.0;2023;24;CRETEIL;MASCULIN;SCOLAIRE;BAC GENERAL;BAC GENERAL;BAC GENE 10019 BAC GENERAL;12010;12010;9815;535;1660;1188;472;11003;99;934;2070;3125;4775;1007
18866.0;2023;24;CRETEIL;MASCULIN;SCOLAIRE;BAC PROFESSIONNEL;BAC PRO PROD;BAC PRO 23102 TRAVAUX PUBLICS;18;18;15;2;1;0;1;15;0;1;2;7;5;3
18869.0;2023;24;CRETEIL;MASCULIN;SCOLAIRE;BAC PROFESSIONNEL;BAC PRO PROD;BAC PRO 23303 MENUISERIE ALUMINIUM-VERRE;11;11;8;1;2;2;0;10;0;0;0;3;7;1
18871.0;2023;24;CRETEIL;MASCULIN;SCOLAIRE;BAC PROFESSIONNEL;BAC PRO PROD;BAC PRO 23404 TECHNICIEN CONSTRUCTEUR BOIS;6;6;4;2;0;0;0;4;0;1;0;1;2;2
18872.0;2023;24;CRETEIL;MASCULIN;SCOLAIRE;BAC PROFESSIONNEL;BAC PRO PROD;BAC PRO 23405 TECHNICIEN MENUISIER AGENCEUR;79;79;50;22;7;6;1;56;0;3;12;13;28;23
18875.0;2023;24;CRETEIL;MASCULIN;SCOLAIRE;BAC PROFESSIONNEL;BAC PRO PROD;BAC PRO 24202 ARTIS.& MET.ART : TAPIS.D'AMEUBL;2;2;2;0;0;0;0;2;0;0;0;1;1;0
18879.0;2023;24;CRETEIL;MASCULIN;SCOLAIRE;BAC PROFESSIONNEL;BAC PRO PROD;BAC PRO 25007 MAINTENANCE EQUIPEMENTS INDUST.;273;273;155;99;19;15;4;170;0;2;19;42;107;103
18883.0;2023;24;CRETEIL;MASCULIN;SCOLAIRE;BAC PROFESSIONNEL;BAC PRO PROD;BAC PRO 25215 MAINT.VEHIC.OPTB VEHIC.TRANS.ROUT;7;7;4;3;0;0;0;4;0;0;1;1;2;3
18889.0;2023;24;CRETEIL;MASCULIN;SCOLAIRE;BAC PROFESSIONNEL;BAC PRO PROD;BAC PRO 25303 AERONAUTIQUE OPTION SYSTEMES;23;23;23;0;0;0;0;23;0;7;10;6;0;0
18894.0;2023;24;CRETEIL;MASCULIN;SCOLAIRE;BAC PROFESSIONNEL;BAC PRO PROD;BAC PRO 25411 TECH.CHAUDRONNERIE INDUSTRIELLE;59;59;48;11;0;0;0;48;0;8;12;18;10;11
18895.0;2023;24;CRETEIL;MASCULIN;SCOLAIRE;BAC PROFESSIONNEL;BAC PRO PROD;BAC PRO 25509 TECHNIC. FROID CONDITIONNEMT AIR;106;106;75;29;2;2;0;77;0;5;12;25;35;29
18900.0;2023;24;CRETEIL;MASCULIN;SCOLAIRE;BAC PROFESSIONNEL;BAC PRO PROD;BAC PRO AG 21004 CGEA;15;15;9;6;0;0;0;9;0;0;1;3;5;6
18913.0;2023;24;CRETEIL;MASCULIN;SCOLAIRE;BAC PROFESSIONNEL;BAC PRO SERV;BAC PRO 32206 FACONNAGE PRODTS IMPRIMES ROUTAGE;12;12;8;4;0;0;0;8;0;1;2;1;4;4
18921.0;2023;24;CRETEIL;MASCULIN;SCOLAIRE;BAC PROFESSIONNEL;BAC PRO SERV;BAC PRO 33101 OPTIQUE LUNETTERIE;31;30;22;6;2;1;1;23;0;0;3;9;11;7
18924.0;2023;24;CRETEIL;MASCULIN;SCOLAIRE;BAC PROFESSIONNEL;BAC PRO SERV;BAC PRO 33604 METIERS DE LA COIFFURE;4;4;4;0;0;0;0;4;0;0;0;2;2;0
18925.0;2023;24;CRETEIL;MASCULIN;SCOLAIRE;BAC PROFESSIONNEL;BAC PRO SERV;BAC PRO 34303 GEST. POLLUTIONS PROTEC. ENVIRON.;12;12;8;4;0;0;0;8;0;0;1;2;5;4
18930.0;2023;24;CRETEIL;MASCULIN;SCOLAIRE;BAC TECHNOLOGIQUE;BAC STAV;BAC STAV AGRONOMIE ALIM ENV TERRITOI;18;18;18;0;0;0;0;18;0;0;0;6;12;0
18943.0;2023;07;DIJON;FEMININ;APPRENTISSAGE;BAC PROFESSIONNEL;BAC PRO PROD;BAC PRO 22106 CUISINE;6;5;4;0;1;0;1;4;0;0;2;2;0;1
18967.0;2023;07;DIJON;FEMININ;APPRENTISSAGE;BAC PROFESSIONNEL;BAC PRO SERV;BAC PRO AG 33002 SERV PERS TERRIT;5;5;4;1;0;0;0;4;0;0;0;2;2;1
18976.0;2023;07;DIJON;FEMININ;ENSEIGNEMENT A DISTANCE;BAC TECHNOLOGIQUE;BAC STMG;BAC STMG RESSOURCES HUMAINES ET COMMUNICATION;5;5;4;0;1;1;0;5;0;0;0;2;3;0
18978.0;2023;07;DIJON;FEMININ;FORMATION CONTINUE;BAC PROFESSIONNEL;BAC PRO SERV;BAC PRO 30004 ASSISTANC.GEST.ORGANIS.ACTIVITES;5;5;3;1;1;1;0;4;0;0;1;0;3;1
18982.0;2023;07;DIJON;FEMININ;INDIVIDUEL;BAC PROFESSIONNEL;BAC PRO PROD;BAC PRO 24203 METIERS DE LA MODE - VÊTEMENT;1;0;0;0;0;0;0;0;0;0;0;0;0;0
18983.0;2023;07;DIJON;FEMININ;INDIVIDUEL;BAC PROFESSIONNEL;BAC PRO PROD;BAC PRO AG 21114 CONDUITE PRODUCTIONS HORTICOLES;2;2;2;0;0;0;0;2;0;0;0;0;2;0
18985.0;2023;07;DIJON;FEMININ;INDIVIDUEL;BAC PROFESSIONNEL;BAC PRO PROD;BAC PRO AG 21405 AMENAGEMENTS PAYSAGERS;1;1;1;0;0;0;0;1;0;0;0;0;1;0
18987.0;2023;07;DIJON;FEMININ;INDIVIDUEL;BAC PROFESSIONNEL;BAC PRO SERV;BAC PRO 31213 MET.COM.VEN.OP.A ANI.GES.ESP.COM.;2;2;2;0;0;0;0;2;0;0;0;0;2;0
18991.0;2023;07;DIJON;FEMININ;INDIVIDUEL;BAC TECHNOLOGIQUE;BAC STAV;BAC STAV AGRONOMIE ALIM ENV TERRITOI;1;1;1;0;0;0;0;1;0;0;0;0;1;0
18995.0;2023;07;DIJON;FEMININ;SCOLAIRE;BAC GENERAL;BAC GENERAL;BAC GENE 10019 BAC GENERAL;4505;4505;4219;28;258;184;74;4403;73;527;1044;1414;1345;102
19012.0;2023;07;DIJON;FEMININ;SCOLAIRE;BAC PROFESSIONNEL;BAC PRO PROD;BAC PRO 25108 TECHNICIEN MODELEUR;6;6;6;0;0;0;0;6;0;0;3;2;1;0
19023.0;2023;07;DIJON;FEMININ;SCOLAIRE;BAC PROFESSIONNEL;BAC PRO PROD;BAC PRO AG 21113 CGEVV;7;7;5;2;0;0;0;5;0;0;0;2;3;2
19032.0;2023;07;DIJON;FEMININ;SCOLAIRE;BAC PROFESSIONNEL;BAC PRO SERV;BAC PRO 31107 CONDUCT. TRANSP.ROUT.MARCHANDISES;1;1;1;0;0;0;0;1;0;1;0;0;0;0
19047.0;2023;07;DIJON;FEMININ;SCOLAIRE;BAC PROFESSIONNEL;BAC PRO SERV;BAC PRO 34305 TECHN.D'INTERV.SUR INSTALL. NUCL.;1;1;0;1;0;0;0;0;0;0;0;0;0;1
19049.0;2023;07;DIJON;FEMININ;SCOLAIRE;BAC PROFESSIONNEL;BAC PRO SERV;BAC PRO AG 33002 SERV PERS TERRIT;193;189;165;24;0;0;0;165;0;4;17;59;85;24
19069.0;2023;07;DIJON;MASCULIN;APPRENTISSAGE;BAC PROFESSIONNEL;BAC PRO PROD;BAC PRO 22704 TECHN. MAINT. SYST.ENERG.CLIMATI;12;12;7;5;0;0;0;7;0;0;0;6;1;5
19073.0;2023;07;DIJON;MASCULIN;APPRENTISSAGE;BAC PROFESSIONNEL;BAC PRO PROD;BAC PRO 23303 MENUISERIE ALUMINIUM-VERRE;3;3;3;0;0;0;0;3;0;1;1;0;1;0
19076.0;2023;07;DIJON;MASCULIN;APPRENTISSAGE;BAC PROFESSIONNEL;BAC PRO PROD;BAC PRO 24302 METIERS DU CUIR : MAROQUINERIE;1;1;1;0;0;0;0;1;0;0;1;0;0;0
19086.0;2023;07;DIJON;MASCULIN;APPRENTISSAGE;BAC PROFESSIONNEL;BAC PRO PROD;BAC PRO 25411 TECH.CHAUDRONNERIE INDUSTRIELLE;70;70;63;1;6;2;4;65;0;11;17;26;11;5
19095.0;2023;07;DIJON;MASCULIN;APPRENTISSAGE;BAC PROFESSIONNEL;BAC PRO PROD;BAC PRO AG 21211 COND GEST ENTR HIPPIQUE;1;1;1;0;0;0;0;1;0;0;0;0;1;0
19103.0;2023;07;DIJON;MASCULIN;APPRENTISSAGE;BAC PROFESSIONNEL;BAC PRO SERV;BAC PRO AG 33002 SERV PERS TERRIT;2;2;1;1;0;0;0;1;0;0;1;0;0;1
19106.0;2023;07;DIJON;MASCULIN;ENSEIGNEMENT A DISTANCE;BAC TECHNOLOGIQUE;BAC STMG;BAC STMG GESTION ET FINANCE;1;1;0;1;0;0;0;0;0;0;0;0;0;1
19109.0;2023;07;DIJON;MASCULIN;FORMATION CONTINUE;BAC PROFESSIONNEL;BAC PRO PROD;BAC PRO 22106 CUISINE;2;2;0;1;1;1;0;1;0;0;0;0;1;1
19112.0;2023;07;DIJON;MASCULIN;FORMATION CONTINUE;BAC PROFESSIONNEL;BAC PRO SERV;BAC PRO 31212 METIERS DE L'ACCUEIL;1;1;0;1;0;0;0;0;0;0;0;0;0;1
19113.0;2023;07;DIJON;MASCULIN;FORMATION CONTINUE;BAC PROFESSIONNEL;BAC PRO SERV;BAC PRO 33403 COMMERC. SERVICES EN RESTAURATION;3;3;0;3;0;0;0;0;0;0;0;0;0;3
19128.0;2023;07;DIJON;MASCULIN;INDIVIDUEL;BAC TECHNOLOGIQUE;BAC STI2D;BAC STI2D ARCHITECTURE ET CONSTRUCTION;1;1;0;0;1;0;1;0;0;0;0;0;0;1
19131.0;2023;07;DIJON;MASCULIN;INDIVIDUEL;BAC TECHNOLOGIQUE;BAC STMG;BAC STMG MERCATIQUE (MARKETING);27;27;8;11;8;5;3;13;0;0;0;1;12;14
19132.0;2023;07;DIJON;MASCULIN;INDIVIDUEL;BAC TECHNOLOGIQUE;BAC STMG;BAC STMG RESSOURCES HUMAINES ET COMMUNICATION;5;5;0;4;1;1;0;1;0;0;0;0;1;4
19138.0;2023;07;DIJON;MASCULIN;SCOLAIRE;BAC PROFESSIONNEL;BAC PRO PROD;BAC PRO 22105 BOULANGER-PÂTISSIER;19;19;16;3;0;0;0;16;0;2;7;4;3;3
19142.0;2023;07;DIJON;MASCULIN;SCOLAIRE;BAC PROFESSIONNEL;BAC PRO PROD;BAC PRO 22704 TECHN. MAINT. SYST.ENERG.CLIMATI;22;21;14;6;1;1;0;15;0;1;1;3;10;6
19145.0;2023;07;DIJON;MASCULIN;SCOLAIRE;BAC PROFESSIONNEL;BAC PRO PROD;BAC PRO 23102 TRAVAUX PUBLICS;12;12;9;1;2;2;0;11;0;0;3;3;5;1
19151.0;2023;07;DIJON;MASCULIN;SCOLAIRE;BAC PROFESSIONNEL;BAC PRO PROD;BAC PRO 23405 TECHNICIEN MENUISIER AGENCEUR;46;46;35;10;1;1;0;36;0;2;4;17;13;10
19154.0;2023;07;DIJON;MASCULIN;SCOLAIRE;BAC PROFESSIONNEL;BAC PRO PROD;BAC PRO 24203 METIERS DE LA MODE - VÊTEMENT;5;5;5;0;0;0;0;5;0;0;1;2;2;0
19164.0;2023;07;DIJON;MASCULIN;SCOLAIRE;BAC PROFESSIONNEL;BAC PRO PROD;BAC PRO 25221 MAINT.MATERIELS OPT.C ESP. VERTS;9;9;7;2;0;0;0;7;0;0;2;3;2;2
19173.0;2023;07;DIJON;MASCULIN;SCOLAIRE;BAC PROFESSIONNEL;BAC PRO PROD;BAC PRO 25514 SYST.NUM.OPT.B AUD.RES.EQUIP.DOM.;36;36;32;4;0;0;0;32;0;3;7;9;13;4
19177.0;2023;07;DIJON;MASCULIN;SCOLAIRE;BAC PROFESSIONNEL;BAC PRO PROD;BAC PRO AG 21113 CGEVV;41;41;34;7;0;0;0;34;0;0;4;12;18;7
19191.0;2023;07;DIJON;MASCULIN;SCOLAIRE;BAC PROFESSIONNEL;BAC PRO SERV;BAC PRO 31212 METIERS DE L'ACCUEIL;32;32;23;8;1;1;0;24;0;0;4;10;10;8
19192.0;2023;07;DIJON;MASCULIN;SCOLAIRE;BAC PROFESSIONNEL;BAC PRO SERV;BAC PRO 31213 MET.COM.VEN.OP.A ANI.GES.ESP.COM.;165;165;134;25;6;6;0;140;0;4;31;45;60;25
19199.0;2023;07;DIJON;MASCULIN;SCOLAIRE;BAC PROFESSIONNEL;BAC PRO SERV;BAC PRO 33006 ANIMAT. ENFANCE& PERSONNES AGEES;25;25;22;3;0;0;0;22;0;1;4;9;8;3
19206.0;2023;07;DIJON;MASCULIN;SCOLAIRE;BAC PROFESSIONNEL;BAC PRO SERV;BAC PRO 34304 HYGIENE PROPRETE STERILISATION;3;3;2;1;0;0;0;2;0;0;1;0;1;1
19207.0;2023;07;DIJON;MASCULIN;SCOLAIRE;BAC PROFESSIONNEL;BAC PRO SERV;BAC PRO 34305 TECHN.D'INTERV.SUR INSTALL. NUCL.;5;5;5;0;0;0;0;5;0;0;0;1;4;0
19209.0;2023;07;DIJON;MASCULIN;SCOLAIRE;BAC PROFESSIONNEL;BAC PRO SERV;BAC PRO AG 33002 SERV PERS TERRIT;27;27;26;1;0;0;0;26;0;0;0;8;18;1
19213.0;2023;07;DIJON;MASCULIN;SCOLAIRE;BAC TECHNOLOGIQUE;BAC STAV;BAC STAV AGRONOMIE ALIM ENV TERRITOI;112;112;108;4;0;0;0;108;0;5;13;34;56;4
19214.0;2023;07;DIJON;MASCULIN;SCOLAIRE;BAC TECHNOLOGIQUE;BAC STD2A;BAC STD2A SCIENCES & TECHNO. DESIGN-ARTS APPLIQUES;7;7;7;0;0;0;0;7;0;1;2;3;1;0
19220.0;2023;07;DIJON;MASCULIN;SCOLAIRE;BAC TECHNOLOGIQUE;BAC STL;BAC STL BIOCHIM.-BIOLOGIE-BIOTECHNOL.;27;27;22;2;3;0;3;22;1;1;4;8;8;5
19222.0;2023;07;DIJON;MASCULIN;SCOLAIRE;BAC TECHNOLOGIQUE;BAC STMG;BAC STMG GESTION ET FINANCE;167;167;127;8;32;24;8;151;0;3;11;54;83;16
19228.0;2023;08;GRENOBLE;FEMININ;APPRENTISSAGE;BAC PROFESSIONNEL;BAC PRO PROD;BAC PRO 22004 PROC. CHIMIE EAU PAPIERS-CARTONS;2;2;2;0;0;0;0;2;0;1;1;0;0;0
19230.0;2023;08;GRENOBLE;FEMININ;APPRENTISSAGE;BAC PROFESSIONNEL;BAC PRO PROD;BAC PRO 22503 PLASTIQUES ET COMPOSITES;1;1;1;0;0;0;0;1;0;0;1;0;0;0
19233.0;2023;08;GRENOBLE;FEMININ;APPRENTISSAGE;BAC PROFESSIONNEL;BAC PRO PROD;BAC PRO 23303 MENUISERIE ALUMINIUM-VERRE;1;1;1;0;0;0;0;1;0;0;0;0;1;0
19248.0;2023;08;GRENOBLE;FEMININ;APPRENTISSAGE;BAC PROFESSIONNEL;BAC PRO PROD;BAC PRO AG 21210 COND GEST ENTR CANIN ET FELIN;2;2;2;0;0;0;0;2;0;0;0;0;2;0
19260.0;2023;08;GRENOBLE;FEMININ;APPRENTISSAGE;BAC PROFESSIONNEL;BAC PRO SERV;BAC PRO 33403 COMMERC. SERVICES EN RESTAURATION;5;5;5;0;0;0;0;5;0;0;1;0;4;0
19261.0;2023;08;GRENOBLE;FEMININ;APPRENTISSAGE;BAC PROFESSIONNEL;BAC PRO SERV;BAC PRO 33603 ESTHETIQUE COSMETIQUE PARFUMERIE;3;3;2;0;1;1;0;3;0;0;0;1;2;0
19264.0;2023;08;GRENOBLE;FEMININ;ENSEIGNEMENT A DISTANCE;BAC PROFESSIONNEL;BAC PRO SERV;BAC PRO 30004 ASSISTANC.GEST.ORGANIS.ACTIVITES;11;5;0;5;0;0;0;0;0;0;0;0;0;5
19265.0;2023;08;GRENOBLE;FEMININ;ENSEIGNEMENT A DISTANCE;BAC PROFESSIONNEL;BAC PRO SERV;BAC PRO 31213 MET.COM.VEN.OP.A ANI.GES.ESP.COM.;6;4;2;1;1;1;0;3;0;0;0;0;3;1
19275.0;2023;08;GRENOBLE;FEMININ;INDIVIDUEL;BAC PROFESSIONNEL;BAC PRO PROD;BAC PRO AG 21114 CONDUITE PRODUCTIONS HORTICOLES;6;6;6;0;0;0;0;6;0;0;0;0;6;0
19284.0;2023;08;GRENOBLE;FEMININ;INDIVIDUEL;BAC PROFESSIONNEL;BAC PRO SERV;BAC PRO 33004 ACC.SOINS-S.PERS. OPT.EN STRUCTUR;5;3;0;3;0;0;0;0;0;0;0;0;0;3
19285.0;2023;08;GRENOBLE;FEMININ;INDIVIDUEL;BAC PROFESSIONNEL;BAC PRO SERV;BAC PRO 33403 COMMERC. SERVICES EN RESTAURATION;3;1;1;0;0;0;0;1;0;0;1;0;0;0
19294.0;2023;08;GRENOBLE;FEMININ;INDIVIDUEL;BAC TECHNOLOGIQUE;BAC STMG;BAC STMG GESTION ET FINANCE;1;1;0;1;0;0;0;0;0;0;0;0;0;1
19316.0;2023;08;GRENOBLE;FEMININ;SCOLAIRE;BAC PROFESSIONNEL;BAC PRO PROD;BAC PRO 24302 METIERS DU CUIR : MAROQUINERIE;9;9;6;3;0;0;0;6;0;1;1;1;3;3
19319.0;2023;08;GRENOBLE;FEMININ;SCOLAIRE;BAC PROFESSIONNEL;BAC PRO PROD;BAC PRO 25007 MAINTENANCE EQUIPEMENTS INDUST.;2;2;2;0;0;0;0;2;0;0;0;1;1;0
19322.0;2023;08;GRENOBLE;FEMININ;SCOLAIRE;BAC PROFESSIONNEL;BAC PRO PROD;BAC PRO 25215 MAINT.VEHIC.OPTB VEHIC.TRANS.ROUT;1;1;0;1;0;0;0;0;0;0;0;0;0;1
19334.0;2023;08;GRENOBLE;FEMININ;SCOLAIRE;BAC PROFESSIONNEL;BAC PRO PROD;BAC PRO AG 21407 TEC CONS VTE UNIVERS JARDINERIE;26;26;21;5;0;0;0;21;0;0;1;7;13;5
19335.0;2023;08;GRENOBLE;FEMININ;SCOLAIRE;BAC PROFESSIONNEL;BAC PRO PROD;BAC PRO AG 22105 LABORATOIRE CONTROLE QUALITE;17;17;16;1;0;0;0;16;0;0;4;3;9;1
19342.0;2023;08;GRENOBLE;FEMININ;SCOLAIRE;BAC PROFESSIONNEL;BAC PRO SERV;BAC PRO 31212 METIERS DE L'ACCUEIL;187;187;169;8;10;5;5;174;0;13;42;66;53;13
19344.0;2023;08;GRENOBLE;FEMININ;SCOLAIRE;BAC PROFESSIONNEL;BAC PRO SERV;BAC PRO 31214 MET.COM.VEN.OP.B PR.CL.VA.OF.COM.;193;193;176;12;5;4;1;180;0;8;47;80;45;13
19350.0;2023;08;GRENOBLE;FEMININ;SCOLAIRE;BAC PROFESSIONNEL;BAC PRO SERV;BAC PRO 33006 ANIMAT. ENFANCE& PERSONNES AGEES;33;33;31;2;0;0;0;31;0;5;11;5;10;2
19353.0;2023;08;GRENOBLE;FEMININ;SCOLAIRE;BAC PROFESSIONNEL;BAC PRO SERV;BAC PRO 33603 ESTHETIQUE COSMETIQUE PARFUMERIE;139;138;112;23;3;3;0;115;0;3;21;44;47;23
19360.0;2023;08;GRENOBLE;FEMININ;SCOLAIRE;BAC TECHNOLOGIQUE;BAC ST2S;BAC ST2S SCIENCES & TECHNO. SANTE & SOCIAL;749;749;637;14;98;66;32;703;2;24;107;239;331;46
19365.0;2023;08;GRENOBLE;FEMININ;SCOLAIRE;BAC TECHNOLOGIQUE;BAC STI2D;BAC STI2D ENERGIES  ET ENVIRONNEMENT;11;11;10;0;1;0;1;10;0;2;3;2;3;1
19367.0;2023;08;GRENOBLE;FEMININ;SCOLAIRE;BAC TECHNOLOGIQUE;BAC STI2D;BAC STI2D SYSTÈME D'INFORMATION  ET NUMERIQUE;21;21;20;0;1;1;0;21;0;2;3;9;7;0
19368.0;2023;08;GRENOBLE;FEMININ;SCOLAIRE;BAC TECHNOLOGIQUE;BAC STL;BAC STL BIOCHIM.-BIOLOGIE-BIOTECHNOL.;92;92;81;3;8;5;3;86;0;3;15;30;38;6
19374.0;2023;08;GRENOBLE;MASCULIN;APPRENTISSAGE;BAC PROFESSIONNEL;BAC PRO PROD;BACPRO 20002 ETUD.DEFINITION PRDTS INDUSTRIEL;2;2;2;0;0;0;0;2;0;0;1;0;1;0
19377.0;2023;08;GRENOBLE;MASCULIN;APPRENTISSAGE;BAC PROFESSIONNEL;BAC PRO PROD;BAC PRO 22004 PROC. CHIMIE EAU PAPIERS-CARTONS;17;17;17;0;0;0;0;17;0;9;6;2;0;0
19379.0;2023;08;GRENOBLE;MASCULIN;APPRENTISSAGE;BAC PROFESSIONNEL;BAC PRO PROD;BAC PRO 22703 TECHN.INSTALL.SYST.ENERG.CLIMATI;18;18;13;3;2;2;0;15;0;1;3;6;5;3
19394.0;2023;08;GRENOBLE;MASCULIN;APPRENTISSAGE;BAC PROFESSIONNEL;BAC PRO PROD;BAC PRO 25106 TECHNICIEN D'USINAGE;80;80;65;12;3;2;1;67;0;2;22;25;18;13
19395.0;2023;08;GRENOBLE;MASCULIN;APPRENTISSAGE;BAC PROFESSIONNEL;BAC PRO PROD;BAC PRO 25214 MAINT.VEHIC.OPTA VOIT.PARTICUL.;234;234;204;17;13;7;6;211;0;20;61;78;52;23
19409.0;2023;08;GRENOBLE;MASCULIN;APPRENTISSAGE;BAC PROFESSIONNEL;BAC PRO PROD;BAC PRO 25514 SYST.NUM.OPT.B AUD.RES.EQUIP.DOM.;5;5;5;0;0;0;0;5;0;0;0;2;3;0
19411.0;2023;08;GRENOBLE;MASCULIN;APPRENTISSAGE;BAC PROFESSIONNEL;BAC PRO PROD;BAC PRO AG 21004 CGEA;14;14;12;2;0;0;0;12;0;1;0;5;6;2
19419.0;2023;08;GRENOBLE;MASCULIN;APPRENTISSAGE;BAC PROFESSIONNEL;BAC PRO SERV;BAC PRO 31114 ORGANIS. TRANSPORT MARCHANDISES;2;2;2;0;0;0;0;2;0;0;0;1;1;0
19421.0;2023;08;GRENOBLE;MASCULIN;APPRENTISSAGE;BAC PROFESSIONNEL;BAC PRO SERV;BAC PRO 31213 MET.COM.VEN.OP.A ANI.GES.ESP.COM.;151;151;124;19;8;5;3;129;0;5;26;51;47;22
19425.0;2023;08;GRENOBLE;MASCULIN;APPRENTISSAGE;BAC PROFESSIONNEL;BAC PRO SERV;BAC PRO AG 33002 SERV PERS TERRIT;8;8;8;0;0;0;0;8;0;1;1;2;4;0
19431.0;2023;08;GRENOBLE;MASCULIN;ENSEIGNEMENT A DISTANCE;BAC TECHNOLOGIQUE;BAC ST2S;BAC ST2S SCIENCES & TECHNO. SANTE & SOCIAL;1;1;1;0;0;0;0;1;0;0;0;0;1;0
19433.0;2023;08;GRENOBLE;MASCULIN;ENSEIGNEMENT A DISTANCE;BAC TECHNOLOGIQUE;BAC STMG;BAC STMG MERCATIQUE (MARKETING);2;2;1;0;1;1;0;2;0;0;0;0;2;0
19434.0;2023;08;GRENOBLE;MASCULIN;ENSEIGNEMENT A DISTANCE;BAC TECHNOLOGIQUE;BAC STMG;BAC STMG RESSOURCES HUMAINES ET COMMUNICATION;4;4;2;2;0;0;0;2;0;0;0;2;0;2
19436.0;2023;08;GRENOBLE;MASCULIN;FORMATION CONTINUE;BAC PROFESSIONNEL;BAC PRO PROD;BAC PRO 23404 TECHNICIEN CONSTRUCTEUR BOIS;1;1;1;0;0;0;0;1;0;1;0;0;0;0
19439.0;2023;08;GRENOBLE;MASCULIN;FORMATION CONTINUE;BAC PROFESSIONNEL;BAC PRO PROD;BAC PRO 25510 METIERS ELECT. ENVIRON. CONNECTES;1;1;1;0;0;0;0;1;0;0;0;0;1;0
19442.0;2023;08;GRENOBLE;MASCULIN;INDIVIDUEL;BAC PROFESSIONNEL;BAC PRO PROD;BACPRO 20002 ETUD.DEFINITION PRDTS INDUSTRIEL;1;0;0;0;0;0;0;0;0;0;0;0;0;0
19446.0;2023;08;GRENOBLE;MASCULIN;INDIVIDUEL;BAC PROFESSIONNEL;BAC PRO PROD;BAC PRO 23102 TRAVAUX PUBLICS;1;0;0;0;0;0;0;0;0;0;0;0;0;0
19450.0;2023;08;GRENOBLE;MASCULIN;INDIVIDUEL;BAC PROFESSIONNEL;BAC PRO PROD;BAC PRO 25007 MAINTENANCE EQUIPEMENTS INDUST.;2;0;0;0;0;0;0;0;0;0;0;0;0;0
19452.0;2023;08;GRENOBLE;MASCULIN;INDIVIDUEL;BAC PROFESSIONNEL;BAC PRO PROD;BAC PRO 25214 MAINT.VEHIC.OPTA VOIT.PARTICUL.;4;2;1;1;0;0;0;1;0;0;0;0;1;1
19453.0;2023;08;GRENOBLE;MASCULIN;INDIVIDUEL;BAC PROFESSIONNEL;BAC PRO PROD;BAC PRO 25221 MAINT.MATERIELS OPT.C ESP. VERTS;1;0;0;0;0;0;0;0;0;0;0;0;0;0
19454.0;2023;08;GRENOBLE;MASCULIN;INDIVIDUEL;BAC PROFESSIONNEL;BAC PRO PROD;BAC PRO 25411 TECH.CHAUDRONNERIE INDUSTRIELLE;1;0;0;0;0;0;0;0;0;0;0;0;0;0
19463.0;2023;08;GRENOBLE;MASCULIN;INDIVIDUEL;BAC PROFESSIONNEL;BAC PRO SERV;BAC PRO 31107 CONDUCT. TRANSP.ROUT.MARCHANDISES;1;1;1;0;0;0;0;1;0;0;0;0;1;0
19466.0;2023;08;GRENOBLE;MASCULIN;INDIVIDUEL;BAC PROFESSIONNEL;BAC PRO SERV;BAC PRO 33101 OPTIQUE LUNETTERIE;1;1;0;1;0;0;0;0;0;0;0;0;0;1
19467.0;2023;08;GRENOBLE;MASCULIN;INDIVIDUEL;BAC PROFESSIONNEL;BAC PRO SERV;BAC PRO 33403 COMMERC. SERVICES EN RESTAURATION;2;2;1;1;0;0;0;1;0;0;0;0;1;1
19493.0;2023;08;GRENOBLE;MASCULIN;SCOLAIRE;BAC PROFESSIONNEL;BAC PRO PROD;BAC PRO 23304 AMENAGEMENT FINITION BATIMENT;26;26;20;6;0;0;0;20;0;2;4;6;8;6
19497.0;2023;08;GRENOBLE;MASCULIN;SCOLAIRE;BAC PROFESSIONNEL;BAC PRO PROD;BAC PRO 24202 ARTIS.& MET.ART : TAPIS.D'AMEUBL;4;4;2;2;0;0;0;2;0;0;2;0;0;2
19499.0;2023;08;GRENOBLE;MASCULIN;SCOLAIRE;BAC PROFESSIONNEL;BAC PRO PROD;BAC PRO 24301 METIERS DU CUIR : CHAUSSURES;2;2;2;0;0;0;0;2;0;0;0;1;1;0
19505.0;2023;08;GRENOBLE;MASCULIN;SCOLAIRE;BAC PROFESSIONNEL;BAC PRO PROD;BAC PRO 25107 TECHNICIEN OUTILLEUR;7;7;4;3;0;0;0;4;0;1;1;1;1;3
19507.0;2023;08;GRENOBLE;MASCULIN;SCOLAIRE;BAC PROFESSIONNEL;BAC PRO PROD;BAC PRO 25215 MAINT.VEHIC.OPTB VEHIC.TRANS.ROUT;21;21;14;5;2;2;0;16;0;1;1;4;10;5
19509.0;2023;08;GRENOBLE;MASCULIN;SCOLAIRE;BAC PROFESSIONNEL;BAC PRO PROD;BAC PRO 25303 AERONAUTIQUE OPTION SYSTEMES;11;11;11;0;0;0;0;11;0;2;6;3;0;0
19510.0;2023;08;GRENOBLE;MASCULIN;SCOLAIRE;BAC PROFESSIONNEL;BAC PRO PROD;BAC PRO 25406 OUVRAGES DU BATIMENT METALLERIE;29;29;25;3;1;1;0;26;0;1;2;13;10;3
19515.0;2023;08;GRENOBLE;MASCULIN;SCOLAIRE;BAC PROFESSIONNEL;BAC PRO PROD;BAC PRO 25513 SYST.NUM.OPT.A SURETE SECURITE;42;42;32;7;3;2;1;34;0;2;7;10;15;8
19524.0;2023;08;GRENOBLE;MASCULIN;SCOLAIRE;BAC PROFESSIONNEL;BAC PRO PROD;BAC PRO AG 21211 COND GEST ENTR HIPPIQUE;13;13;10;3;0;0;0;10;0;1;1;4;4;3
19528.0;2023;08;GRENOBLE;MASCULIN;SCOLAIRE;BAC PROFESSIONNEL;BAC PRO PROD;BAC PRO AG 21407 TEC CONS VTE UNIVERS JARDINERIE;20;20;20;0;0;0;0;20;0;0;5;4;11;0
19529.0;2023;08;GRENOBLE;MASCULIN;SCOLAIRE;BAC PROFESSIONNEL;BAC PRO PROD;BAC PRO AG 22105 LABORATOIRE CONTROLE QUALITE;17;16;16;0;0;0;0;16;0;1;2;9;4;0
19534.0;2023;08;GRENOBLE;MASCULIN;SCOLAIRE;BAC PROFESSIONNEL;BAC PRO SERV;BAC PRO 31109 TRANSPORT FLUVIAL;7;7;7;0;0;0;0;7;0;1;2;1;3;0
19535.0;2023;08;GRENOBLE;MASCULIN;SCOLAIRE;BAC PROFESSIONNEL;BAC PRO SERV;BAC PRO 31114 ORGANIS. TRANSPORT MARCHANDISES;25;25;15;8;2;1;1;16;0;0;3;5;8;9
19536.0;2023;08;GRENOBLE;MASCULIN;SCOLAIRE;BAC PROFESSIONNEL;BAC PRO SERV;BAC PRO 31212 METIERS DE L'ACCUEIL;106;106;78;21;7;6;1;84;0;2;14;30;38;22
19537.0;2023;08;GRENOBLE;MASCULIN;SCOLAIRE;BAC PROFESSIONNEL;BAC PRO SERV;BAC PRO 31213 MET.COM.VEN.OP.A ANI.GES.ESP.COM.;338;338;283;41;14;11;3;294;0;11;60;128;95;44
19540.0;2023;08;GRENOBLE;MASCULIN;SCOLAIRE;BAC PROFESSIONNEL;BAC PRO SERV;BAC PRO 32208 REAL.PR.IMPR.PLURI.OPTB.PR.IMPR.;4;4;4;0;0;0;0;4;0;2;1;1;0;0
19551.0;2023;08;GRENOBLE;MASCULIN;SCOLAIRE;BAC TECHNOLOGIQUE;BAC S2TMD;BAC S2TMD DANSE;1;1;1;0;0;0;0;1;0;0;1;0;0;0
19552.0;2023;08;GRENOBLE;MASCULIN;SCOLAIRE;BAC TECHNOLOGIQUE;BAC S2TMD;BAC S2TMD MUSIQUE;2;2;2;0;0;0;0;2;0;1;0;1;0;0
19555.0;2023;08;GRENOBLE;MASCULIN;SCOLAIRE;BAC TECHNOLOGIQUE;BAC STD2A;BAC STD2A SCIENCES & TECHNO. DESIGN-ARTS APPLIQUES;32;32;29;0;3;1;2;30;0;3;7;10;10;2
19559.0;2023;08;GRENOBLE;MASCULIN;SCOLAIRE;BAC TECHNOLOGIQUE;BAC STI2D;BAC STI2D INNOVATION TECHNO.  ET ECO CONCEPTION;470;470;424;9;37;19;18;443;0;20;85;173;165;27
19562.0;2023;08;GRENOBLE;MASCULIN;SCOLAIRE;BAC TECHNOLOGIQUE;BAC STL;BAC STL SCIENCES PHYSIQUES CHIMIQUES  EN LABORAT.;41;41;36;2;3;0;3;36;0;2;6;18;10;5
19564.0;2023;08;GRENOBLE;MASCULIN;SCOLAIRE;BAC TECHNOLOGIQUE;BAC STMG;BAC STMG MERCATIQUE (MARKETING);1056;1056;716;87;253;187;66;903;0;2;45;217;639;153
19567.0;2023;32;GUADELOUPE;FEMININ;APPRENTISSAGE;BAC PROFESSIONNEL;BAC PRO SERV;BAC PRO 30004 ASSISTANC.GEST.ORGANIS.ACTIVITES;3;3;3;0;0;0;0;3;0;0;2;1;0;0
19575.0;2023;32;GUADELOUPE;FEMININ;ENSEIGNEMENT A DISTANCE;BAC PROFESSIONNEL;BAC PRO SERV;BAC PRO 31213 MET.COM.VEN.OP.A ANI.GES.ESP.COM.;1;1;1;0;0;0;0;1;0;0;0;0;1;0
19577.0;2023;32;GUADELOUPE;FEMININ;ENSEIGNEMENT A DISTANCE;BAC PROFESSIONNEL;BAC PRO SERV;BAC PRO 33004 ACC.SOINS-S.PERS. OPT.EN STRUCTUR;1;0;0;0;0;0;0;0;0;0;0;0;0;0
19581.0;2023;32;GUADELOUPE;FEMININ;FORMATION CONTINUE;BAC PROFESSIONNEL;BAC PRO SERV;BAC PRO 31212 METIERS DE L'ACCUEIL;2;2;2;0;0;0;0;2;0;0;2;0;0;0
19585.0;2023;32;GUADELOUPE;FEMININ;FORMATION CONTINUE;BAC PROFESSIONNEL;BAC PRO SERV;BAC PRO 33604 METIERS DE LA COIFFURE;1;1;1;0;0;0;0;1;0;0;0;1;0;0
19586.0;2023;32;GUADELOUPE;FEMININ;INDIVIDUEL;BAC GENERAL;BAC GENERAL;BAC GENE 10019 BAC GENERAL;24;23;14;4;5;4;1;18;1;5;3;2;7;5
19595.0;2023;32;GUADELOUPE;FEMININ;INDIVIDUEL;BAC PROFESSIONNEL;BAC PRO SERV;BAC PRO 33603 ESTHETIQUE COSMETIQUE PARFUMERIE;1;0;0;0;0;0;0;0;0;0;0;0;0;0
19596.0;2023;32;GUADELOUPE;FEMININ;INDIVIDUEL;BAC PROFESSIONNEL;BAC PRO SERV;BAC PRO 34304 HYGIENE PROPRETE STERILISATION;2;1;0;1;0;0;0;0;0;0;0;0;0;1
19599.0;2023;32;GUADELOUPE;FEMININ;INDIVIDUEL;BAC TECHNOLOGIQUE;BAC STL;BAC STL SCIENCES PHYSIQUES CHIMIQUES  EN LABORAT.;1;1;0;1;0;0;0;0;0;0;0;0;0;1
19603.0;2023;32;GUADELOUPE;FEMININ;SCOLAIRE;BAC PROFESSIONNEL;BAC PRO PROD;BAC PRO 22104 BOUCHER CHARCUTIER TRAITEUR;2;2;1;0;1;1;0;2;0;0;0;0;2;0
19606.0;2023;32;GUADELOUPE;FEMININ;SCOLAIRE;BAC PROFESSIONNEL;BAC PRO PROD;BAC PRO 23003 ARTIS. & M.ART:MARCHANDISAGE VIS.;13;13;9;4;0;0;0;9;0;0;4;3;2;4
19615.0;2023;32;GUADELOUPE;FEMININ;SCOLAIRE;BAC PROFESSIONNEL;BAC PRO PROD;BAC PRO 25009 MAINTENANCE NAUTIQUE;1;1;1;0;0;0;0;1;0;0;0;1;0;0
19629.0;2023;32;GUADELOUPE;FEMININ;SCOLAIRE;BAC PROFESSIONNEL;BAC PRO SERV;BAC PRO 31106 LOGISTIQUE;3;3;3;0;0;0;0;3;0;0;2;1;0;0
19636.0;2023;32;GUADELOUPE;FEMININ;SCOLAIRE;BAC PROFESSIONNEL;BAC PRO SERV;BAC PRO 33003 ACC.SOINS-S.PERS. OPT.A DOMICILE;87;87;51;29;7;6;1;57;0;0;5;23;29;30
19638.0;2023;32;GUADELOUPE;FEMININ;SCOLAIRE;BAC PROFESSIONNEL;BAC PRO SERV;BAC PRO 33006 ANIMAT. ENFANCE& PERSONNES AGEES;35;35;27;5;3;2;1;29;0;5;3;7;14;6
19641.0;2023;32;GUADELOUPE;FEMININ;SCOLAIRE;BAC PROFESSIONNEL;BAC PRO SERV;BAC PRO 33604 METIERS DE LA COIFFURE;20;20;8;10;2;2;0;10;0;2;2;0;6;10
19649.0;2023;32;GUADELOUPE;FEMININ;SCOLAIRE;BAC TECHNOLOGIQUE;BAC STD2A;BAC STD2A SCIENCES & TECHNO. DESIGN-ARTS APPLIQUES;25;25;25;0;0;0;0;25;1;2;9;7;6;0
19651.0;2023;32;GUADELOUPE;FEMININ;SCOLAIRE;BAC TECHNOLOGIQUE;BAC STI2D;BAC STI2D ARCHITECTURE ET CONSTRUCTION;13;13;7;2;4;4;0;11;0;0;0;2;9;2
19657.0;2023;32;GUADELOUPE;FEMININ;SCOLAIRE;BAC TECHNOLOGIQUE;BAC STMG;BAC STMG GESTION ET FINANCE;80;80;66;1;13;13;0;79;0;2;10;23;44;1
19659.0;2023;32;GUADELOUPE;FEMININ;SCOLAIRE;BAC TECHNOLOGIQUE;BAC STMG;BAC STMG RESSOURCES HUMAINES ET COMMUNICATION;95;95;72;7;16;14;2;86;0;1;11;25;49;9
19669.0;2023;32;GUADELOUPE;MASCULIN;ENSEIGNEMENT A DISTANCE;BAC GENERAL;BAC GENERAL;BAC GENE 10019 BAC GENERAL;4;4;2;1;1;0;1;2;0;0;0;2;0;2
19670.0;2023;32;GUADELOUPE;MASCULIN;ENSEIGNEMENT A DISTANCE;BAC TECHNOLOGIQUE;BAC STMG;BAC STMG SYSTEMES D'INFORMATION DE GESTION;1;1;1;0;0;0;0;1;0;0;0;0;1;0
19679.0;2023;32;GUADELOUPE;MASCULIN;INDIVIDUEL;BAC PROFESSIONNEL;BAC PRO PROD;BAC PRO AG 21004 CGEA;1;1;1;0;0;0;0;1;0;0;0;0;1;0
19689.0;2023;32;GUADELOUPE;MASCULIN;SCOLAIRE;BAC PROFESSIONNEL;BAC PRO PROD;BAC PRO 22104 BOUCHER CHARCUTIER TRAITEUR;6;6;5;1;0;0;0;5;0;0;2;1;2;1
19693.0;2023;32;GUADELOUPE;MASCULIN;SCOLAIRE;BAC PROFESSIONNEL;BAC PRO PROD;BAC PRO 23003 ARTIS. & M.ART:MARCHANDISAGE VIS.;11;11;7;2;2;2;0;9;0;0;1;3;5;2
19698.0;2023;32;GUADELOUPE;MASCULIN;SCOLAIRE;BAC PROFESSIONNEL;BAC PRO PROD;BAC PRO 23304 AMENAGEMENT FINITION BATIMENT;23;23;18;2;3;2;1;20;0;2;3;4;11;3
19704.0;2023;32;GUADELOUPE;MASCULIN;SCOLAIRE;BAC PROFESSIONNEL;BAC PRO PROD;BAC PRO 25009 MAINTENANCE NAUTIQUE;68;65;42;9;14;10;4;52;0;0;2;18;32;13
19710.0;2023;32;GUADELOUPE;MASCULIN;SCOLAIRE;BAC PROFESSIONNEL;BAC PRO PROD;BAC PRO 25303 AERONAUTIQUE OPTION SYSTEMES;9;9;9;0;0;0;0;9;0;0;3;2;4;0
19714.0;2023;32;GUADELOUPE;MASCULIN;SCOLAIRE;BAC PROFESSIONNEL;BAC PRO PROD;BAC PRO 25509 TECHNIC. FROID CONDITIONNEMT AIR;60;60;51;5;4;3;1;54;0;2;8;22;22;6
19724.0;2023;32;GUADELOUPE;MASCULIN;SCOLAIRE;BAC PROFESSIONNEL;BAC PRO SERV;BAC PRO 31106 LOGISTIQUE;13;13;13;0;0;0;0;13;0;0;3;9;1;0
19732.0;2023;32;GUADELOUPE;MASCULIN;SCOLAIRE;BAC PROFESSIONNEL;BAC PRO SERV;BAC PRO 33006 ANIMAT. ENFANCE& PERSONNES AGEES;5;5;3;1;1;1;0;4;0;0;0;1;3;1
19735.0;2023;32;GUADELOUPE;MASCULIN;SCOLAIRE;BAC PROFESSIONNEL;BAC PRO SERV;BAC PRO 34304 HYGIENE PROPRETE STERILISATION;5;5;3;2;0;0;0;3;0;0;0;2;1;2
19736.0;2023;32;GUADELOUPE;MASCULIN;SCOLAIRE;BAC PROFESSIONNEL;BAC PRO SERV;BAC PRO 34403 METIERS DE LA SECURITE;41;41;34;5;2;1;1;35;0;2;8;13;12;6
19739.0;2023;32;GUADELOUPE;MASCULIN;SCOLAIRE;BAC TECHNOLOGIQUE;BAC S2TMD;BAC S2TMD MUSIQUE;6;6;6;0;0;0;0;6;0;0;4;1;1;0
19743.0;2023;32;GUADELOUPE;MASCULIN;SCOLAIRE;BAC TECHNOLOGIQUE;BAC STD2A;BAC STD2A SCIENCES & TECHNO. DESIGN-ARTS APPLIQUES;7;7;6;0;1;1;0;7;0;0;1;2;4;0
19750.0;2023;32;GUADELOUPE;MASCULIN;SCOLAIRE;BAC TECHNOLOGIQUE;BAC STL;BAC STL SCIENCES PHYSIQUES CHIMIQUES  EN LABORAT.;6;6;4;1;1;1;0;5;0;0;2;0;3;1
19754.0;2023;32;GUADELOUPE;MASCULIN;SCOLAIRE;BAC TECHNOLOGIQUE;BAC STMG;BAC STMG SYSTEMES D'INFORMATION DE GESTION;21;21;7;4;10;10;0;17;0;0;1;2;14;4
19757.0;2023;33;GUYANE;FEMININ;APPRENTISSAGE;BAC PROFESSIONNEL;BAC PRO SERV;BAC PRO 33004 ACC.SOINS-S.PERS. OPT.EN STRUCTUR;6;6;0;5;1;0;1;0;0;0;0;0;0;6
19770.0;2023;33;GUYANE;FEMININ;INDIVIDUEL;BAC PROFESSIONNEL;BAC PRO SERV;BAC PRO 31212 METIERS DE L'ACCUEIL;2;1;1;0;0;0;0;1;0;0;0;0;1;0
19779.0;2023;33;GUYANE;FEMININ;SCOLAIRE;BAC PROFESSIONNEL;BAC PRO PROD;BAC PRO 22004 PROC. CHIMIE EAU PAPIERS-CARTONS;5;5;2;1;2;2;0;4;0;0;0;0;4;1
19782.0;2023;33;GUYANE;FEMININ;SCOLAIRE;BAC PROFESSIONNEL;BAC PRO PROD;BAC PRO 23003 ARTIS. & M.ART:MARCHANDISAGE VIS.;4;4;3;1;0;0;0;3;0;0;0;3;0;1
19789.0;2023;33;GUYANE;FEMININ;SCOLAIRE;BAC PROFESSIONNEL;BAC PRO PROD;BAC PRO 23404 TECHNICIEN CONSTRUCTEUR BOIS;4;4;2;1;1;1;0;3;0;0;0;0;3;1
19790.0;2023;33;GUYANE;FEMININ;SCOLAIRE;BAC PROFESSIONNEL;BAC PRO PROD;BAC PRO 24002 METIERS PRESSING BLANCHISSERIE;6;6;0;6;0;0;0;0;0;0;0;0;0;6
19799.0;2023;33;GUYANE;FEMININ;SCOLAIRE;BAC PROFESSIONNEL;BAC PRO PROD;BAC PRO AG 21114 CONDUITE PRODUCTIONS HORTICOLES;2;2;2;0;0;0;0;2;0;0;0;0;2;0
19801.0;2023;33;GUYANE;FEMININ;SCOLAIRE;BAC PROFESSIONNEL;BAC PRO PROD;BAC PRO AG 22108 TEC CONS VTE ALIMENTATION (PAB);7;7;6;1;0;0;0;6;0;0;0;1;5;1
19802.0;2023;33;GUYANE;FEMININ;SCOLAIRE;BAC PROFESSIONNEL;BAC PRO SERV;BAC PRO 30004 ASSISTANC.GEST.ORGANIS.ACTIVITES;126;125;84;25;16;12;4;96;0;3;13;36;44;29
19808.0;2023;33;GUYANE;FEMININ;SCOLAIRE;BAC PROFESSIONNEL;BAC PRO SERV;BAC PRO 32303 ART.& MET.ART:COM.VIS.VIS.PLURI-M;3;3;1;2;0;0;0;1;0;0;0;0;1;2
19811.0;2023;33;GUYANE;FEMININ;SCOLAIRE;BAC PROFESSIONNEL;BAC PRO SERV;BAC PRO 33004 ACC.SOINS-S.PERS. OPT.EN STRUCTUR;54;54;41;12;1;1;0;42;0;1;6;12;23;12
19812.0;2023;33;GUYANE;FEMININ;SCOLAIRE;BAC PROFESSIONNEL;BAC PRO SERV;BAC PRO 33006 ANIMAT. ENFANCE& PERSONNES AGEES;58;58;27;25;6;5;1;32;0;1;5;9;17;26
19814.0;2023;33;GUYANE;FEMININ;SCOLAIRE;BAC PROFESSIONNEL;BAC PRO SERV;BAC PRO 34303 GEST. POLLUTIONS PROTEC. ENVIRON.;5;5;2;3;0;0;0;2;0;0;1;0;1;3
19820.0;2023;33;GUYANE;FEMININ;SCOLAIRE;BAC TECHNOLOGIQUE;BAC STHR;BAC STHR SC.&TEC. HOTELLERIE-RESTAURATION;13;13;9;2;2;2;0;11;0;0;1;2;8;2
19825.0;2023;33;GUYANE;FEMININ;SCOLAIRE;BAC TECHNOLOGIQUE;BAC STL;BAC STL BIOCHIM.-BIOLOGIE-BIOTECHNOL.;20;20;11;2;7;6;1;17;0;1;0;4;12;3
19828.0;2023;33;GUYANE;FEMININ;SCOLAIRE;BAC TECHNOLOGIQUE;BAC STMG;BAC STMG MERCATIQUE (MARKETING);68;68;47;4;17;10;7;57;0;0;3;15;39;11
19836.0;2023;33;GUYANE;MASCULIN;FORMATION CONTINUE;BAC PROFESSIONNEL;BAC PRO SERV;BAC PRO 31213 MET.COM.VEN.OP.A ANI.GES.ESP.COM.;8;6;4;2;0;0;0;4;0;0;0;1;3;2
19839.0;2023;33;GUYANE;MASCULIN;INDIVIDUEL;BAC PROFESSIONNEL;BAC PRO PROD;BAC PRO 23004 TECHN. ETUDES BAT.A ETUDES & ECO.;4;4;1;3;0;0;0;1;0;0;0;0;1;3
19840.0;2023;33;GUYANE;MASCULIN;INDIVIDUEL;BAC PROFESSIONNEL;BAC PRO PROD;BAC PRO 23203 TECHNICIEN BAT. : ORG.REAL.GROS O;1;0;0;0;0;0;0;0;0;0;0;0;0;0
19841.0;2023;33;GUYANE;MASCULIN;INDIVIDUEL;BAC PROFESSIONNEL;BAC PRO PROD;BAC PRO 23205 INTERV. SUR PATRIMOINE BATI OPT.A;1;1;0;0;1;0;1;0;0;0;0;0;0;1
19842.0;2023;33;GUYANE;MASCULIN;INDIVIDUEL;BAC PROFESSIONNEL;BAC PRO PROD;BAC PRO 23404 TECHNICIEN CONSTRUCTEUR BOIS;2;1;0;1;0;0;0;0;0;0;0;0;0;1
19843.0;2023;33;GUYANE;MASCULIN;INDIVIDUEL;BAC PROFESSIONNEL;BAC PRO PROD;BAC PRO 25510 METIERS ELECT. ENVIRON. CONNECTES;2;2;1;1;0;0;0;1;0;0;0;0;1;1
19846.0;2023;33;GUYANE;MASCULIN;INDIVIDUEL;BAC PROFESSIONNEL;BAC PRO PROD;BAC PRO AG 21114 CONDUITE PRODUCTIONS HORTICOLES;2;2;2;0;0;0;0;2;0;0;0;0;2;0
19886.0;2023;33;GUYANE;MASCULIN;SCOLAIRE;BAC PROFESSIONNEL;BAC PRO SERV;BAC PRO 31213 MET.COM.VEN.OP.A ANI.GES.ESP.COM.;87;87;50;24;13;10;3;60;0;0;4;16;40;27
19891.0;2023;33;GUYANE;MASCULIN;SCOLAIRE;BAC PROFESSIONNEL;BAC PRO SERV;BAC PRO 33004 ACC.SOINS-S.PERS. OPT.EN STRUCTUR;9;9;5;4;0;0;0;5;0;0;0;0;5;4
19894.0;2023;33;GUYANE;MASCULIN;SCOLAIRE;BAC PROFESSIONNEL;BAC PRO SERV;BAC PRO 34303 GEST. POLLUTIONS PROTEC. ENVIRON.;7;7;5;1;1;1;0;6;0;0;1;0;5;1
19895.0;2023;33;GUYANE;MASCULIN;SCOLAIRE;BAC PROFESSIONNEL;BAC PRO SERV;BAC PRO 34304 HYGIENE PROPRETE STERILISATION;8;8;5;3;0;0;0;5;0;0;0;1;4;3
19896.0;2023;33;GUYANE;MASCULIN;SCOLAIRE;BAC PROFESSIONNEL;BAC PRO SERV;BAC PRO 34403 METIERS DE LA SECURITE;14;14;4;9;1;1;0;5;0;0;0;1;4;9
19898.0;2023;33;GUYANE;MASCULIN;SCOLAIRE;BAC TECHNOLOGIQUE;BAC ST2S;BAC ST2S SCIENCES & TECHNO. SANTE & SOCIAL;42;42;27;3;12;10;2;37;0;0;4;8;25;5
19901.0;2023;33;GUYANE;MASCULIN;SCOLAIRE;BAC TECHNOLOGIQUE;BAC STI2D;BAC STI2D ARCHITECTURE ET CONSTRUCTION;21;21;14;1;6;3;3;17;0;0;1;5;11;4
19908.0;2023;33;GUYANE;MASCULIN;SCOLAIRE;BAC TECHNOLOGIQUE;BAC STMG;BAC STMG MERCATIQUE (MARKETING);28;28;25;1;2;2;0;27;0;1;1;9;16;1
19910.0;2023;33;GUYANE;MASCULIN;SCOLAIRE;BAC TECHNOLOGIQUE;BAC STMG;BAC STMG SYSTEMES D'INFORMATION DE GESTION;8;8;3;2;3;2;1;5;0;0;0;0;5;3
19929.0;2023;28;LA REUNION;FEMININ;INDIVIDUEL;BAC PROFESSIONNEL;BAC PRO SERV;BAC PRO 33603 ESTHETIQUE COSMETIQUE PARFUMERIE;1;1;1;0;0;0;0;1;0;0;1;0;0;0
19930.0;2023;28;LA REUNION;FEMININ;INDIVIDUEL;BAC TECHNOLOGIQUE;BAC ST2S;BAC ST2S SCIENCES & TECHNO. SANTE & SOCIAL;2;2;0;0;2;0;2;0;0;0;0;0;0;2
19943.0;2023;28;LA REUNION;FEMININ;SCOLAIRE;BAC PROFESSIONNEL;BAC PRO PROD;BAC PRO 23003 ARTIS. & M.ART:MARCHANDISAGE VIS.;2;2;2;0;0;0;0;2;0;0;1;0;1;0
19949.0;2023;28;LA REUNION;FEMININ;SCOLAIRE;BAC PROFESSIONNEL;BAC PRO PROD;BAC PRO 23205 INTERV. SUR PATRIMOINE BATI OPT.A;1;1;1;0;0;0;0;1;0;1;0;0;0;0
19951.0;2023;28;LA REUNION;FEMININ;SCOLAIRE;BAC PROFESSIONNEL;BAC PRO PROD;BAC PRO 23304 AMENAGEMENT FINITION BATIMENT;6;6;6;0;0;0;0;6;0;0;3;2;1;0
19965.0;2023;28;LA REUNION;FEMININ;SCOLAIRE;BAC PROFESSIONNEL;BAC PRO PROD;BAC PRO AG 21114 CONDUITE PRODUCTIONS HORTICOLES;4;4;4;0;0;0;0;4;0;0;0;1;3;0
19970.0;2023;28;LA REUNION;FEMININ;SCOLAIRE;BAC PROFESSIONNEL;BAC PRO SERV;BAC PRO 30004 ASSISTANC.GEST.ORGANIS.ACTIVITES;517;515;366;103;46;40;6;406;0;10;56;132;208;109
19977.0;2023;28;LA REUNION;FEMININ;SCOLAIRE;BAC PROFESSIONNEL;BAC PRO SERV;BAC PRO 32208 REAL.PR.IMPR.PLURI.OPTB.PR.IMPR.;6;6;4;1;1;0;1;4;0;0;1;3;0;2
19979.0;2023;28;LA REUNION;FEMININ;SCOLAIRE;BAC PROFESSIONNEL;BAC PRO SERV;BAC PRO 33003 ACC.SOINS-S.PERS. OPT.A DOMICILE;27;27;17;9;1;1;0;18;0;0;2;3;13;9
19985.0;2023;28;LA REUNION;FEMININ;SCOLAIRE;BAC PROFESSIONNEL;BAC PRO SERV;BAC PRO 34303 GEST. POLLUTIONS PROTEC. ENVIRON.;2;2;0;2;0;0;0;0;0;0;0;0;0;2
19991.0;2023;28;LA REUNION;FEMININ;SCOLAIRE;BAC TECHNOLOGIQUE;BAC STD2A;BAC STD2A SCIENCES & TECHNO. DESIGN-ARTS APPLIQUES;24;24;24;0;0;0;0;24;0;2;9;8;5;0
19996.0;2023;28;LA REUNION;FEMININ;SCOLAIRE;BAC TECHNOLOGIQUE;BAC STI2D;BAC STI2D SYSTÈME D'INFORMATION  ET NUMERIQUE;13;13;12;0;1;1;0;13;0;1;0;6;6;0
7.0;2021;02;AIX-MARSEILLE;FEMININ;APPRENTISSAGE;BAC PROFESSIONNEL;BAC PRO PROD;BAC PRO AG 21113 CGEVV;3;3;3;0;0;0;0;3;0;0;0;1;2;0
14.0;2021;02;AIX-MARSEILLE;FEMININ;APPRENTISSAGE;BAC PROFESSIONNEL;BAC PRO SERV;BAC PRO 30001 GESTION-ADMINISTRATION;17;17;13;4;0;0;0;13;0;3;3;2;5;4
16.0;2021;02;AIX-MARSEILLE;FEMININ;APPRENTISSAGE;BAC PROFESSIONNEL;BAC PRO SERV;BAC PRO 31202 COMMERCE;56;55;47;5;3;1;2;48;0;2;13;18;15;7
21.0;2021;02;AIX-MARSEILLE;FEMININ;APPRENTISSAGE;BAC PROFESSIONNEL;BAC PRO SERV;BAC PRO 33102 PROTHESE DENTAIRE;11;11;8;3;0;0;0;8;0;0;3;3;2;3
30.0;2021;02;AIX-MARSEILLE;FEMININ;ENSEIGNEMENT A DISTANCE;BAC PROFESSIONNEL;BAC PRO SERV;BAC PRO 31210 ACCUEIL -RELATION CLIENTS USAGERS;1;0;0;0;0;0;0;0;0;0;0;0;0;0
39.0;2021;02;AIX-MARSEILLE;FEMININ;FORMATION CONTINUE;BAC PROFESSIONNEL;BAC PRO PROD;BAC PRO 25510 METIERS ELECT. ENVIRON. CONNECTES;2;2;2;0;0;0;0;2;0;2;0;0;0;0
41.0;2021;02;AIX-MARSEILLE;FEMININ;FORMATION CONTINUE;BAC PROFESSIONNEL;BAC PRO SERV;BAC PRO 31202 COMMERCE;11;9;6;1;2;2;0;8;0;2;2;0;4;1
46.0;2021;02;AIX-MARSEILLE;FEMININ;INDIVIDUEL;BAC GENERAL;BAC GENERAL;BAC GENE 10019 BAC GENERAL;130;90;61;21;8;8;0;69;0;10;12;12;35;21
48.0;2021;02;AIX-MARSEILLE;FEMININ;INDIVIDUEL;BAC PROFESSIONNEL;BAC PRO PROD;BAC PRO 23004 TECHN. ETUDES BAT.A ETUDES & ECO.;1;1;1;0;0;0;0;1;0;0;0;0;1;0
63.0;2021;02;AIX-MARSEILLE;FEMININ;INDIVIDUEL;BAC PROFESSIONNEL;BAC PRO SERV;BAC PRO 33101 OPTIQUE LUNETTERIE;2;0;0;0;0;0;0;0;0;0;0;0;0;0
64.0;2021;02;AIX-MARSEILLE;FEMININ;INDIVIDUEL;BAC PROFESSIONNEL;BAC PRO SERV;BAC PRO 33603 ESTHETIQUE COSMETIQUE PARFUMERIE;1;1;1;0;0;0;0;1;0;0;0;0;1;0
71.0;2021;02;AIX-MARSEILLE;FEMININ;INDIVIDUEL;BAC TECHNOLOGIQUE;BAC STMG;BAC STMG GESTION ET FINANCE;4;2;1;0;1;1;0;2;0;0;0;0;2;0
76.0;2021;02;AIX-MARSEILLE;FEMININ;SCOLAIRE;BAC PROFESSIONNEL;BAC PRO PROD;BACPRO 20002 ETUD.DEFINITION PRDTS INDUSTRIEL;2;2;1;1;0;0;0;1;0;0;0;1;0;1
77.0;2021;02;AIX-MARSEILLE;FEMININ;SCOLAIRE;BAC PROFESSIONNEL;BAC PRO PROD;BAC PRO 22003 BIO-INDUSTRIES DE TRANSFORMATION;16;15;12;3;0;0;0;12;0;0;4;3;5;3
80.0;2021;02;AIX-MARSEILLE;FEMININ;SCOLAIRE;BAC PROFESSIONNEL;BAC PRO PROD;BAC PRO 22106 CUISINE;39;38;35;3;0;0;0;35;0;8;11;13;3;3
88.0;2021;02;AIX-MARSEILLE;FEMININ;SCOLAIRE;BAC PROFESSIONNEL;BAC PRO PROD;BAC PRO 25006 MICROTECHNIQUES;2;2;1;1;0;0;0;1;0;0;1;0;0;1
107.0;2021;02;AIX-MARSEILLE;FEMININ;SCOLAIRE;BAC PROFESSIONNEL;BAC PRO PROD;BAC PRO AG 21302 GEST MILIEUX NATURELS FAUNE;16;15;13;2;0;0;0;13;0;1;0;4;8;2
108.0;2021;02;AIX-MARSEILLE;FEMININ;SCOLAIRE;BAC PROFESSIONNEL;BAC PRO PROD;BAC PRO AG 21405 AMENAGEMENTS PAYSAGERS;8;8;8;0;0;0;0;8;0;0;3;2;3;0
109.0;2021;02;AIX-MARSEILLE;FEMININ;SCOLAIRE;BAC PROFESSIONNEL;BAC PRO PROD;BAC PRO AG 22105 LABORATOIRE CONTROLE QUALITE;7;7;7;0;0;0;0;7;0;1;1;3;2;0
117.0;2021;02;AIX-MARSEILLE;FEMININ;SCOLAIRE;BAC PROFESSIONNEL;BAC PRO SERV;BAC PRO 31206 VENTE (PROSPECT.NEGO.SUIV.CLIENT;145;144;113;15;16;13;3;126;0;1;26;45;54;18
136.0;2021;02;AIX-MARSEILLE;FEMININ;SCOLAIRE;BAC TECHNOLOGIQUE;BAC STD2A;BAC STD2A SCIENCES & TECHNO. DESIGN-ARTS APPLIQUES;134;134;132;1;1;1;0;133;2;15;48;47;21;1
139.0;2021;02;AIX-MARSEILLE;FEMININ;SCOLAIRE;BAC TECHNOLOGIQUE;BAC STI2D;BAC STI2D ENERGIES  ET ENVIRONNEMENT;14;14;12;0;2;2;0;14;0;2;2;4;6;0
143.0;2021;02;AIX-MARSEILLE;FEMININ;SCOLAIRE;BAC TECHNOLOGIQUE;BAC STL;BAC STL SCIENCES PHYSIQUES CHIMIQUES  EN LABORAT.;105;105;97;2;6;5;1;102;0;2;27;34;39;3
148.0;2021;02;AIX-MARSEILLE;MASCULIN;APPRENTISSAGE;BAC PROFESSIONNEL;BAC PRO PROD;BAC PRO 22004 PROC. CHIMIE EAU PAPIERS-CARTONS;6;5;5;0;0;0;0;5;0;1;2;1;1;0
152.0;2021;02;AIX-MARSEILLE;MASCULIN;APPRENTISSAGE;BAC PROFESSIONNEL;BAC PRO PROD;BAC PRO 22705 TECHNICIEN GAZ;6;6;6;0;0;0;0;6;0;0;5;1;0;0
159.0;2021;02;AIX-MARSEILLE;MASCULIN;APPRENTISSAGE;BAC PROFESSIONNEL;BAC PRO PROD;BAC PRO 25214 MAINT.VEHIC.OPTA VOIT.PARTICUL.;113;112;92;14;6;3;3;95;0;5;19;39;32;17
166.0;2021;02;AIX-MARSEILLE;MASCULIN;APPRENTISSAGE;BAC PROFESSIONNEL;BAC PRO PROD;BAC PRO 25411 TECH.CHAUDRONNERIE INDUSTRIELLE;20;20;14;6;0;0;0;14;0;0;1;9;4;6
175.0;2021;02;AIX-MARSEILLE;MASCULIN;APPRENTISSAGE;BAC PROFESSIONNEL;BAC PRO PROD;BAC PRO AG 21303 FORET;4;3;2;1;0;0;0;2;0;1;0;0;1;1
177.0;2021;02;AIX-MARSEILLE;MASCULIN;APPRENTISSAGE;BAC PROFESSIONNEL;BAC PRO PROD;BAC PRO AG 22107 TEC CONS VTE ALIMENTATION P.ALIM;1;1;1;0;0;0;0;1;0;0;1;0;0;0
178.0;2021;02;AIX-MARSEILLE;MASCULIN;APPRENTISSAGE;BAC PROFESSIONNEL;BAC PRO SERV;BAC PRO 30001 GESTION-ADMINISTRATION;3;3;2;1;0;0;0;2;0;0;1;0;1;1
179.0;2021;02;AIX-MARSEILLE;MASCULIN;APPRENTISSAGE;BAC PROFESSIONNEL;BAC PRO SERV;BAC PRO 31106 LOGISTIQUE;7;6;5;1;0;0;0;5;0;1;1;2;1;1
191.0;2021;02;AIX-MARSEILLE;MASCULIN;ENSEIGNEMENT A DISTANCE;BAC GENERAL;BAC GENERAL;BAC GENE 10019 BAC GENERAL;45;44;42;1;1;0;1;42;1;10;13;14;4;2
195.0;2021;02;AIX-MARSEILLE;MASCULIN;ENSEIGNEMENT A DISTANCE;BAC PROFESSIONNEL;BAC PRO SERV;BAC PRO 31206 VENTE (PROSPECT.NEGO.SUIV.CLIENT;1;1;0;1;0;0;0;0;0;0;0;0;0;1
196.0;2021;02;AIX-MARSEILLE;MASCULIN;ENSEIGNEMENT A DISTANCE;BAC TECHNOLOGIQUE;BAC STMG;BAC STMG GESTION ET FINANCE;4;4;4;0;0;0;0;4;0;0;2;2;0;0
199.0;2021;02;AIX-MARSEILLE;MASCULIN;ENSEIGNEMENT A DISTANCE;BAC TECHNOLOGIQUE;BAC STMG;BAC STMG SYSTEMES D'INFORMATION DE GESTION;1;1;1;0;0;0;0;1;0;0;1;0;0;0
201.0;2021;02;AIX-MARSEILLE;MASCULIN;FORMATION CONTINUE;BAC PROFESSIONNEL;BAC PRO PROD;BAC PRO 22106 CUISINE;1;1;0;1;0;0;0;0;0;0;0;0;0;1
218.0;2021;02;AIX-MARSEILLE;MASCULIN;INDIVIDUEL;BAC PROFESSIONNEL;BAC PRO PROD;BAC PRO 22703 TECHN.INSTALL.SYST.ENERG.CLIMATI;1;1;0;0;1;0;1;0;0;0;0;0;0;1
228.0;2021;02;AIX-MARSEILLE;MASCULIN;INDIVIDUEL;BAC PROFESSIONNEL;BAC PRO PROD;BAC PRO AG 21114 CONDUITE PRODUCTIONS HORTICOLES;5;5;4;1;0;0;0;4;0;0;0;0;4;1
234.0;2021;02;AIX-MARSEILLE;MASCULIN;INDIVIDUEL;BAC PROFESSIONNEL;BAC PRO SERV;BAC PRO 31202 COMMERCE;4;1;0;1;0;0;0;0;0;0;0;0;0;1
235.0;2021;02;AIX-MARSEILLE;MASCULIN;INDIVIDUEL;BAC PROFESSIONNEL;BAC PRO SERV;BAC PRO 31206 VENTE (PROSPECT.NEGO.SUIV.CLIENT;2;1;1;0;0;0;0;1;0;0;0;1;0;0
241.0;2021;02;AIX-MARSEILLE;MASCULIN;INDIVIDUEL;BAC TECHNOLOGIQUE;BAC ST2S;BAC ST2S SCIENCES & TECHNO. SANTE & SOCIAL;6;5;3;2;0;0;0;3;0;0;0;1;2;2
249.0;2021;02;AIX-MARSEILLE;MASCULIN;INDIVIDUEL;BAC TECHNOLOGIQUE;BAC STMG;BAC STMG GESTION ET FINANCE;8;5;2;1;2;2;0;4;0;0;0;0;4;1
254.0;2021;02;AIX-MARSEILLE;MASCULIN;SCOLAIRE;BAC PROFESSIONNEL;BAC PRO PROD;BACPRO 20002 ETUD.DEFINITION PRDTS INDUSTRIEL;29;28;18;4;6;2;4;20;0;0;5;8;7;8
270.0;2021;02;AIX-MARSEILLE;MASCULIN;SCOLAIRE;BAC PROFESSIONNEL;BAC PRO PROD;BAC PRO 23303 MENUISERIE ALUMINIUM-VERRE;7;7;3;3;1;0;1;3;0;0;0;1;2;4
272.0;2021;02;AIX-MARSEILLE;MASCULIN;SCOLAIRE;BAC PROFESSIONNEL;BAC PRO PROD;BAC PRO 23404 TECHNICIEN CONSTRUCTEUR BOIS;26;26;21;2;3;2;1;23;0;2;4;6;11;3
273.0;2021;02;AIX-MARSEILLE;MASCULIN;SCOLAIRE;BAC PROFESSIONNEL;BAC PRO PROD;BAC PRO 23405 TECHNICIEN MENUISIER AGENCEUR;66;66;45;14;7;5;2;50;0;1;12;14;23;16
275.0;2021;02;AIX-MARSEILLE;MASCULIN;SCOLAIRE;BAC PROFESSIONNEL;BAC PRO PROD;BAC PRO 24203 METIERS DE LA MODE - VÊTEMENT;9;9;6;3;0;0;0;6;0;1;4;1;0;3
279.0;2021;02;AIX-MARSEILLE;MASCULIN;SCOLAIRE;BAC PROFESSIONNEL;BAC PRO PROD;BAC PRO 25106 TECHNICIEN D'USINAGE;43;43;36;4;3;0;3;36;0;4;10;9;13;7
294.0;2021;02;AIX-MARSEILLE;MASCULIN;SCOLAIRE;BAC PROFESSIONNEL;BAC PRO PROD;BAC PRO 25510 METIERS ELECT. ENVIRON. CONNECTES;504;502;424;62;16;11;5;435;0;26;118;145;146;67
302.0;2021;02;AIX-MARSEILLE;MASCULIN;SCOLAIRE;BAC PROFESSIONNEL;BAC PRO PROD;BAC PRO AG 21203 TECHN CONSEIL DE VENTE ANIMAL;15;15;13;2;0;0;0;13;0;0;1;6;6;2
311.0;2021;02;AIX-MARSEILLE;MASCULIN;SCOLAIRE;BAC PROFESSIONNEL;BAC PRO SERV;BAC PRO 31106 LOGISTIQUE;60;60;44;13;3;3;0;47;0;0;3;16;28;13
313.0;2021;02;AIX-MARSEILLE;MASCULIN;SCOLAIRE;BAC PROFESSIONNEL;BAC PRO SERV;BAC PRO 31108 TRANSPORT;56;55;35;15;5;3;2;38;0;2;6;7;23;17
315.0;2021;02;AIX-MARSEILLE;MASCULIN;SCOLAIRE;BAC PROFESSIONNEL;BAC PRO SERV;BAC PRO 31206 VENTE (PROSPECT.NEGO.SUIV.CLIENT;236;233;184;23;26;20;6;204;0;4;27;74;99;29
317.0;2021;02;AIX-MARSEILLE;MASCULIN;SCOLAIRE;BAC PROFESSIONNEL;BAC PRO SERV;BAC PRO 32207 REAL.PR.IMPR.PLURI.OPTA.PR.GRAPH.;17;16;13;2;1;1;0;14;0;0;6;4;4;2
319.0;2021;02;AIX-MARSEILLE;MASCULIN;SCOLAIRE;BAC PROFESSIONNEL;BAC PRO SERV;BAC PRO 32303 ART.& MET.ART:COM.VIS.VIS.PLURI-M;39;39;31;8;0;0;0;31;0;5;2;14;10;8
321.0;2021;02;AIX-MARSEILLE;MASCULIN;SCOLAIRE;BAC PROFESSIONNEL;BAC PRO SERV;BAC PRO 33002 SERVICES DE PROXIMITE  VIE LOCAL;40;39;28;5;6;5;1;33;0;0;0;16;17;6
324.0;2021;02;AIX-MARSEILLE;MASCULIN;SCOLAIRE;BAC PROFESSIONNEL;BAC PRO SERV;BAC PRO 33101 OPTIQUE LUNETTERIE;12;12;12;0;0;0;0;12;0;1;1;5;5;0
327.0;2021;02;AIX-MARSEILLE;MASCULIN;SCOLAIRE;BAC PROFESSIONNEL;BAC PRO SERV;BAC PRO 33403 COMMERC. SERVICES EN RESTAURATION;48;48;36;11;1;1;0;37;0;0;9;12;16;11
337.0;2021;02;AIX-MARSEILLE;MASCULIN;SCOLAIRE;BAC TECHNOLOGIQUE;BAC STI2D;BAC STI2D INNOVATION TECHNO.  ET ECO CONCEPTION;379;379;339;4;36;24;12;363;0;12;49;132;170;16
338.0;2021;02;AIX-MARSEILLE;MASCULIN;SCOLAIRE;BAC TECHNOLOGIQUE;BAC STI2D;BAC STI2D SYSTÈME D'INFORMATION  ET NUMERIQUE;395;395;344;7;44;25;19;369;0;8;54;126;181;26
345.0;2021;20;AMIENS;FEMININ;APPRENTISSAGE;BAC PROFESSIONNEL;BAC PRO PROD;BAC PRO 20102 PILOTE DE LIGNE DE PRODUCTION;2;2;2;0;0;0;0;2;0;0;0;2;0;0
346.0;2021;20;AMIENS;FEMININ;APPRENTISSAGE;BAC PROFESSIONNEL;BAC PRO PROD;BAC PRO 22106 CUISINE;3;3;2;1;0;0;0;2;0;0;0;1;1;1
353.0;2021;20;AMIENS;FEMININ;APPRENTISSAGE;BAC PROFESSIONNEL;BAC PRO PROD;BAC PRO AG 21211 COND GEST ENTR HIPPIQUE;19;18;16;2;0;0;0;16;0;0;4;5;7;2
355.0;2021;20;AMIENS;FEMININ;APPRENTISSAGE;BAC PROFESSIONNEL;BAC PRO PROD;BAC PRO AG 22107 TEC CONS VTE ALIMENTATION P.ALIM;14;14;14;0;0;0;0;14;0;1;5;2;6;0
361.0;2021;20;AMIENS;FEMININ;APPRENTISSAGE;BAC PROFESSIONNEL;BAC PRO SERV;BAC PRO AG 33002 SERV PERS TERRIT;18;17;15;2;0;0;0;15;0;0;2;7;6;2
367.0;2021;20;AMIENS;FEMININ;FORMATION CONTINUE;BAC PROFESSIONNEL;BAC PRO PROD;BAC PRO 20102 PILOTE DE LIGNE DE PRODUCTION;2;2;2;0;0;0;0;2;0;2;0;0;0;0
379.0;2021;20;AMIENS;FEMININ;INDIVIDUEL;BAC PROFESSIONNEL;BAC PRO SERV;BAC PRO 30001 GESTION-ADMINISTRATION;9;6;3;3;0;0;0;3;0;0;0;2;1;3
388.0;2021;20;AMIENS;FEMININ;INDIVIDUEL;BAC TECHNOLOGIQUE;BAC ST2S;BAC ST2S SCIENCES & TECHNO. SANTE & SOCIAL;11;11;2;6;3;3;0;5;0;0;0;1;4;6
390.0;2021;20;AMIENS;FEMININ;INDIVIDUEL;BAC TECHNOLOGIQUE;BAC STI2D;BAC STI2D ARCHITECTURE ET CONSTRUCTION;1;1;1;0;0;0;0;1;0;0;0;1;0;0
393.0;2021;20;AMIENS;FEMININ;INDIVIDUEL;BAC TECHNOLOGIQUE;BAC STMG;BAC STMG MERCATIQUE (MARKETING);6;6;1;4;1;1;0;2;0;0;0;1;1;4
398.0;2021;20;AMIENS;FEMININ;SCOLAIRE;BAC PROFESSIONNEL;BAC PRO PROD;BAC PRO 22004 PROC. CHIMIE EAU PAPIERS-CARTONS;7;7;6;1;0;0;0;6;0;0;1;1;4;1
406.0;2021;20;AMIENS;FEMININ;SCOLAIRE;BAC PROFESSIONNEL;BAC PRO PROD;BAC PRO 23304 AMENAGEMENT FINITION BATIMENT;7;7;5;2;0;0;0;5;0;0;0;3;2;2
408.0;2021;20;AMIENS;FEMININ;SCOLAIRE;BAC PROFESSIONNEL;BAC PRO PROD;BAC PRO 24202 ARTIS.& MET.ART : TAPIS.D'AMEUBL;6;6;5;0;1;1;0;6;0;1;1;3;1;0
414.0;2021;20;AMIENS;FEMININ;SCOLAIRE;BAC PROFESSIONNEL;BAC PRO PROD;BAC PRO 25215 MAINT.VEHIC.OPTB VEHIC.TRANS.ROUT;1;1;1;0;0;0;0;1;0;0;0;1;0;0
428.0;2021;20;AMIENS;FEMININ;SCOLAIRE;BAC PROFESSIONNEL;BAC PRO PROD;BAC PRO AG 22107 TEC CONS VTE ALIMENTATION P.ALIM;6;6;6;0;0;0;0;6;0;0;0;3;3;0
430.0;2021;20;AMIENS;FEMININ;SCOLAIRE;BAC PROFESSIONNEL;BAC PRO SERV;BAC PRO 31106 LOGISTIQUE;14;14;11;3;0;0;0;11;0;2;2;2;5;3
447.0;2021;20;AMIENS;FEMININ;SCOLAIRE;BAC TECHNOLOGIQUE;BAC STAV;BAC STAV AGRONOMIE ALIM ENV TERRITOI;62;62;62;0;0;0;0;62;0;1;8;34;19;0
448.0;2021;20;AMIENS;FEMININ;SCOLAIRE;BAC TECHNOLOGIQUE;BAC STD2A;BAC STD2A SCIENCES & TECHNO. DESIGN-ARTS APPLIQUES;70;70;70;0;0;0;0;70;0;14;26;24;6;0
450.0;2021;20;AMIENS;FEMININ;SCOLAIRE;BAC TECHNOLOGIQUE;BAC STI2D;BAC STI2D ARCHITECTURE ET CONSTRUCTION;24;24;22;0;2;1;1;23;1;0;4;13;5;1
453.0;2021;20;AMIENS;FEMININ;SCOLAIRE;BAC TECHNOLOGIQUE;BAC STI2D;BAC STI2D SYSTÈME D'INFORMATION  ET NUMERIQUE;7;7;7;0;0;0;0;7;0;1;2;2;2;0
454.0;2021;20;AMIENS;FEMININ;SCOLAIRE;BAC TECHNOLOGIQUE;BAC STL;BAC STL BIOCHIM.-BIOLOGIE-BIOTECHNOL.;71;71;56;3;12;4;8;60;0;2;10;20;28;11
460.0;2021;20;AMIENS;MASCULIN;APPRENTISSAGE;BAC PROFESSIONNEL;BAC PRO PROD;BAC PRO 20102 PILOTE DE LIGNE DE PRODUCTION;4;4;4;0;0;0;0;4;0;1;2;1;0;0
464.0;2021;20;AMIENS;MASCULIN;APPRENTISSAGE;BAC PROFESSIONNEL;BAC PRO PROD;BAC PRO 23102 TRAVAUX PUBLICS;19;19;17;2;0;0;0;17;0;0;4;10;3;2
466.0;2021;20;AMIENS;MASCULIN;APPRENTISSAGE;BAC PROFESSIONNEL;BAC PRO PROD;BAC PRO 25106 TECHNICIEN D'USINAGE;19;19;19;0;0;0;0;19;0;3;6;5;5;0
468.0;2021;20;AMIENS;MASCULIN;APPRENTISSAGE;BAC PROFESSIONNEL;BAC PRO PROD;BAC PRO 25215 MAINT.VEHIC.OPTB VEHIC.TRANS.ROUT;7;7;5;0;2;2;0;7;0;1;1;1;4;0
474.0;2021;20;AMIENS;MASCULIN;APPRENTISSAGE;BAC PROFESSIONNEL;BAC PRO PROD;BAC PRO 25408 REPARATION DES CARROSSERIES;15;15;11;4;0;0;0;11;0;0;3;4;4;4
475.0;2021;20;AMIENS;MASCULIN;APPRENTISSAGE;BAC PROFESSIONNEL;BAC PRO PROD;BAC PRO 25411 TECH.CHAUDRONNERIE INDUSTRIELLE;50;49;46;0;3;2;1;48;0;3;16;14;15;1
476.0;2021;20;AMIENS;MASCULIN;APPRENTISSAGE;BAC PROFESSIONNEL;BAC PRO PROD;BAC PRO 25509 TECHNIC. FROID CONDITIONNEMT AIR;11;11;10;0;1;1;0;11;0;0;3;4;4;0
481.0;2021;20;AMIENS;MASCULIN;APPRENTISSAGE;BAC PROFESSIONNEL;BAC PRO PROD;BAC PRO AG 21211 COND GEST ENTR HIPPIQUE;10;10;10;0;0;0;0;10;0;1;0;4;5;0
498.0;2021;20;AMIENS;MASCULIN;FORMATION CONTINUE;BAC PROFESSIONNEL;BAC PRO PROD;BAC PRO 25411 TECH.CHAUDRONNERIE INDUSTRIELLE;1;1;1;0;0;0;0;1;0;0;1;0;0;0
503.0;2021;20;AMIENS;MASCULIN;INDIVIDUEL;BAC GENERAL;BAC GENERAL;BAC GENE 10019 BAC GENERAL;42;40;12;23;5;4;1;16;1;0;5;3;7;24
504.0;2021;20;AMIENS;MASCULIN;INDIVIDUEL;BAC PROFESSIONNEL;BAC PRO PROD;BAC PRO 22105 BOULANGER-PÂTISSIER;1;1;1;0;0;0;0;1;0;0;0;0;1;0
508.0;2021;20;AMIENS;MASCULIN;INDIVIDUEL;BAC PROFESSIONNEL;BAC PRO PROD;BAC PRO 25106 TECHNICIEN D'USINAGE;1;0;0;0;0;0;0;0;0;0;0;0;0;0
514.0;2021;20;AMIENS;MASCULIN;INDIVIDUEL;BAC PROFESSIONNEL;BAC PRO PROD;BAC PRO AG 21004 CGEA;7;6;4;2;0;0;0;4;0;0;0;0;4;2
520.0;2021;20;AMIENS;MASCULIN;INDIVIDUEL;BAC PROFESSIONNEL;BAC PRO SERV;BAC PRO 31210 ACCUEIL -RELATION CLIENTS USAGERS;3;2;0;2;0;0;0;0;0;0;0;0;0;2
524.0;2021;20;AMIENS;MASCULIN;INDIVIDUEL;BAC TECHNOLOGIQUE;BAC STAV;BAC STAV AGRONOMIE ALIM ENV TERRITOI;1;1;0;1;0;0;0;0;0;0;0;0;0;1
526.0;2021;20;AMIENS;MASCULIN;INDIVIDUEL;BAC TECHNOLOGIQUE;BAC STI2D;BAC STI2D ENERGIES  ET ENVIRONNEMENT;1;1;0;1;0;0;0;0;0;0;0;0;0;1
532.0;2021;20;AMIENS;MASCULIN;INDIVIDUEL;BAC TECHNOLOGIQUE;BAC STMG;BAC STMG SYSTEMES D'INFORMATION DE GESTION;1;1;1;0;0;0;0;1;0;0;0;1;0;0
535.0;2021;20;AMIENS;MASCULIN;SCOLAIRE;BAC PROFESSIONNEL;BAC PRO PROD;BAC PRO 22003 BIO-INDUSTRIES DE TRANSFORMATION;11;11;8;1;2;2;0;10;0;1;3;3;3;1
536.0;2021;20;AMIENS;MASCULIN;SCOLAIRE;BAC PROFESSIONNEL;BAC PRO PROD;BAC PRO 22004 PROC. CHIMIE EAU PAPIERS-CARTONS;4;4;2;1;1;1;0;3;0;0;1;0;2;1
537.0;2021;20;AMIENS;MASCULIN;SCOLAIRE;BAC PROFESSIONNEL;BAC PRO PROD;BAC PRO 22104 BOUCHER CHARCUTIER TRAITEUR;9;9;8;0;1;1;0;9;0;0;1;2;6;0
547.0;2021;20;AMIENS;MASCULIN;SCOLAIRE;BAC PROFESSIONNEL;BAC PRO PROD;BACPRO 23103 TECHNICIEN GEOMETRE-TOPOGRAPHE;4;4;4;0;0;0;0;4;0;0;0;3;1;0
550.0;2021;20;AMIENS;MASCULIN;SCOLAIRE;BAC PROFESSIONNEL;BAC PRO PROD;BAC PRO 23303 MENUISERIE ALUMINIUM-VERRE;2;2;2;0;0;0;0;2;0;0;1;1;0;0
551.0;2021;20;AMIENS;MASCULIN;SCOLAIRE;BAC PROFESSIONNEL;BAC PRO PROD;BAC PRO 23304 AMENAGEMENT FINITION BATIMENT;31;31;19;11;1;1;0;20;0;1;4;7;8;11
555.0;2021;20;AMIENS;MASCULIN;SCOLAIRE;BAC PROFESSIONNEL;BAC PRO PROD;BAC PRO 24202 ARTIS.& MET.ART : TAPIS.D'AMEUBL;7;7;7;0;0;0;0;7;0;0;2;3;2;0
561.0;2021;20;AMIENS;MASCULIN;SCOLAIRE;BAC PROFESSIONNEL;BAC PRO PROD;BAC PRO 25106 TECHNICIEN D'USINAGE;78;78;55;22;1;1;0;56;0;3;12;19;22;22
568.0;2021;20;AMIENS;MASCULIN;SCOLAIRE;BAC PROFESSIONNEL;BAC PRO PROD;BAC PRO 25221 MAINT.MATERIELS OPT.C ESP. VERTS;11;11;7;3;1;0;1;7;0;0;1;3;3;4
571.0;2021;20;AMIENS;MASCULIN;SCOLAIRE;BAC PROFESSIONNEL;BAC PRO PROD;BAC PRO 25408 REPARATION DES CARROSSERIES;21;21;16;3;2;2;0;18;0;0;1;12;5;3
582.0;2021;20;AMIENS;MASCULIN;SCOLAIRE;BAC PROFESSIONNEL;BAC PRO PROD;BAC PRO AG 21203 TECHN CONSEIL DE VENTE ANIMAL;8;8;8;0;0;0;0;8;0;0;1;4;3;0
584.0;2021;20;AMIENS;MASCULIN;SCOLAIRE;BAC PROFESSIONNEL;BAC PRO PROD;BAC PRO AG 21211 COND GEST ENTR HIPPIQUE;8;8;8;0;0;0;0;8;0;0;1;2;5;0
589.0;2021;20;AMIENS;MASCULIN;SCOLAIRE;BAC PROFESSIONNEL;BAC PRO SERV;BAC PRO 30001 GESTION-ADMINISTRATION;216;215;167;36;12;8;4;175;0;3;32;55;85;40
591.0;2021;20;AMIENS;MASCULIN;SCOLAIRE;BAC PROFESSIONNEL;BAC PRO SERV;BAC PRO 31107 CONDUCT. TRANSP.ROUT.MARCHANDISES;19;18;15;3;0;0;0;15;0;4;4;5;2;3
592.0;2021;20;AMIENS;MASCULIN;SCOLAIRE;BAC PROFESSIONNEL;BAC PRO SERV;BAC PRO 31108 TRANSPORT;22;22;15;6;1;0;1;15;0;0;2;6;7;7
598.0;2021;20;AMIENS;MASCULIN;SCOLAIRE;BAC PROFESSIONNEL;BAC PRO SERV;BAC PRO 33002 SERVICES DE PROXIMITE  VIE LOCAL;16;16;13;3;0;0;0;13;0;0;4;6;3;3
601.0;2021;20;AMIENS;MASCULIN;SCOLAIRE;BAC PROFESSIONNEL;BAC PRO SERV;BAC PRO 33101 OPTIQUE LUNETTERIE;10;9;6;3;0;0;0;6;0;1;0;2;3;3
602.0;2021;20;AMIENS;MASCULIN;SCOLAIRE;BAC PROFESSIONNEL;BAC PRO SERV;BAC PRO 33403 COMMERC. SERVICES EN RESTAURATION;48;47;32;8;7;4;3;36;0;2;5;9;20;11
616.0;2021;20;AMIENS;MASCULIN;SCOLAIRE;BAC TECHNOLOGIQUE;BAC STMG;BAC STMG GESTION ET FINANCE;280;280;225;16;39;23;16;248;0;3;31;86;128;32
621.0;2021;03;BESANCON;FEMININ;APPRENTISSAGE;BAC PROFESSIONNEL;BAC PRO PROD;BAC PRO 23207 INTERV. SUR PATRIMOINE BATI OPT.C;1;1;1;0;0;0;0;1;0;0;0;1;0;0
622.0;2021;03;BESANCON;FEMININ;APPRENTISSAGE;BAC PROFESSIONNEL;BAC PRO PROD;BAC PRO 24302 METIERS DU CUIR : MAROQUINERIE;1;1;1;0;0;0;0;1;0;0;0;1;0;0
625.0;2021;03;BESANCON;FEMININ;APPRENTISSAGE;BAC PROFESSIONNEL;BAC PRO PROD;BAC PRO 25214 MAINT.VEHIC.OPTA VOIT.PARTICUL.;3;3;3;0;0;0;0;3;0;1;1;1;0;0
626.0;2021;03;BESANCON;FEMININ;APPRENTISSAGE;BAC PROFESSIONNEL;BAC PRO PROD;BAC PRO 25406 OUVRAGES DU BATIMENT METALLERIE;1;1;1;0;0;0;0;1;0;0;0;1;0;0
627.0;2021;03;BESANCON;FEMININ;APPRENTISSAGE;BAC PROFESSIONNEL;BAC PRO PROD;BAC PRO AG 21004 CGEA;11;10;10;0;0;0;0;10;0;0;1;3;6;0
629.0;2021;03;BESANCON;FEMININ;APPRENTISSAGE;BAC PROFESSIONNEL;BAC PRO PROD;BAC PRO AG 21203 TECHN CONSEIL DE VENTE ANIMAL;3;3;3;0;0;0;0;3;0;0;1;1;1;0
630.0;2021;03;BESANCON;FEMININ;APPRENTISSAGE;BAC PROFESSIONNEL;BAC PRO PROD;BAC PRO AG 21211 COND GEST ENTR HIPPIQUE;7;7;6;1;0;0;0;6;0;0;0;2;4;1
632.0;2021;03;BESANCON;FEMININ;APPRENTISSAGE;BAC PROFESSIONNEL;BAC PRO PROD;BAC PRO AG 21405 AMENAGEMENTS PAYSAGERS;1;1;1;0;0;0;0;1;0;0;0;0;1;0
633.0;2021;03;BESANCON;FEMININ;APPRENTISSAGE;BAC PROFESSIONNEL;BAC PRO PROD;BAC PRO AG 22107 TEC CONS VTE ALIMENTATION P.ALIM;2;2;2;0;0;0;0;2;0;0;0;1;1;0
635.0;2021;03;BESANCON;FEMININ;APPRENTISSAGE;BAC PROFESSIONNEL;BAC PRO SERV;BAC PRO 31202 COMMERCE;53;52;49;0;3;1;2;50;0;1;12;21;16;2
636.0;2021;03;BESANCON;FEMININ;APPRENTISSAGE;BAC PROFESSIONNEL;BAC PRO SERV;BAC PRO 32303 ART.& MET.ART:COM.VIS.VIS.PLURI-M;3;2;2;0;0;0;0;2;0;0;0;1;1;0
641.0;2021;03;BESANCON;FEMININ;ENSEIGNEMENT A DISTANCE;BAC GENERAL;BAC GENERAL;BAC GENE 10019 BAC GENERAL;26;25;23;2;0;0;0;23;0;2;15;6;0;2
661.0;2021;03;BESANCON;FEMININ;SCOLAIRE;BAC GENERAL;BAC GENERAL;BAC GENE 10019 BAC GENERAL;3356;3356;3200;21;135;83;52;3283;45;393;832;1150;863;73
663.0;2021;03;BESANCON;FEMININ;SCOLAIRE;BAC PROFESSIONNEL;BAC PRO PROD;BAC PRO 22106 CUISINE;45;45;41;1;3;2;1;43;0;2;11;18;12;2
664.0;2021;03;BESANCON;FEMININ;SCOLAIRE;BAC PROFESSIONNEL;BAC PRO PROD;BAC PRO 23004 TECHN. ETUDES BAT.A ETUDES & ECO.;2;2;2;0;0;0;0;2;0;0;0;2;0;0
670.0;2021;03;BESANCON;FEMININ;SCOLAIRE;BAC PROFESSIONNEL;BAC PRO PROD;BAC PRO 23407 TECHNIC.FAB.BOIS ET MATERX ASSOC;1;1;1;0;0;0;0;1;0;0;0;0;1;0
679.0;2021;03;BESANCON;FEMININ;SCOLAIRE;BAC PROFESSIONNEL;BAC PRO PROD;BAC PRO 25408 REPARATION DES CARROSSERIES;2;2;2;0;0;0;0;2;0;0;1;0;1;0
683.0;2021;03;BESANCON;FEMININ;SCOLAIRE;BAC PROFESSIONNEL;BAC PRO PROD;BAC PRO 25515 SYST.NUM.OPT.C RES.INF.SYST.COMM.;1;1;1;0;0;0;0;1;0;0;0;1;0;0
688.0;2021;03;BESANCON;FEMININ;SCOLAIRE;BAC PROFESSIONNEL;BAC PRO PROD;BAC PRO AG 21302 GEST MILIEUX NATURELS FAUNE;10;10;10;0;0;0;0;10;0;0;1;4;5;0
704.0;2021;03;BESANCON;FEMININ;SCOLAIRE;BAC PROFESSIONNEL;BAC PRO SERV;BAC PRO 34304 HYGIENE PROPRETE STERILISATION;13;13;10;2;1;0;1;10;0;0;2;4;4;3
708.0;2021;03;BESANCON;FEMININ;SCOLAIRE;BAC TECHNOLOGIQUE;BAC S2TMD;BAC S2TMD MUSIQUE;3;3;3;0;0;0;0;3;0;0;1;2;0;0
718.0;2021;03;BESANCON;FEMININ;SCOLAIRE;BAC TECHNOLOGIQUE;BAC STL;BAC STL SCIENCES PHYSIQUES CHIMIQUES  EN LABORAT.;43;43;41;0;2;2;0;43;0;1;5;17;20;0
720.0;2021;03;BESANCON;FEMININ;SCOLAIRE;BAC TECHNOLOGIQUE;BAC STMG;BAC STMG MERCATIQUE (MARKETING);246;246;228;2;16;11;5;239;0;2;26;106;105;7
727.0;2021;03;BESANCON;MASCULIN;APPRENTISSAGE;BAC PROFESSIONNEL;BAC PRO PROD;BAC PRO 23203 TECHNICIEN BAT. : ORG.REAL.GROS O;7;7;6;0;1;0;1;6;0;0;1;5;0;1
730.0;2021;03;BESANCON;MASCULIN;APPRENTISSAGE;BAC PROFESSIONNEL;BAC PRO PROD;BAC PRO 23404 TECHNICIEN CONSTRUCTEUR BOIS;12;12;12;0;0;0;0;12;0;2;1;6;3;0
742.0;2021;03;BESANCON;MASCULIN;APPRENTISSAGE;BAC PROFESSIONNEL;BAC PRO PROD;BAC PRO 25220 MAINT.MATERIELS OPT.B TP MANUT.;3;3;3;0;0;0;0;3;0;0;1;1;1;0
750.0;2021;03;BESANCON;MASCULIN;APPRENTISSAGE;BAC PROFESSIONNEL;BAC PRO PROD;BAC PRO AG 21001 AGRO-EQUIPEMENT;19;18;15;3;0;0;0;15;0;0;2;1;12;3
760.0;2021;03;BESANCON;MASCULIN;APPRENTISSAGE;BAC PROFESSIONNEL;BAC PRO SERV;BAC PRO 31202 COMMERCE;43;43;39;3;1;1;0;40;0;3;6;20;11;3
762.0;2021;03;BESANCON;MASCULIN;APPRENTISSAGE;BAC PROFESSIONNEL;BAC PRO SERV;BAC PRO 33101 OPTIQUE LUNETTERIE;2;2;1;1;0;0;0;1;0;0;0;1;0;1
764.0;2021;03;BESANCON;MASCULIN;APPRENTISSAGE;BAC PROFESSIONNEL;BAC PRO SERV;BAC PRO 33403 COMMERC. SERVICES EN RESTAURATION;2;2;2;0;0;0;0;2;0;0;1;0;1;0
766.0;2021;03;BESANCON;MASCULIN;APPRENTISSAGE;BAC PROFESSIONNEL;BAC PRO SERV;BAC PRO AG 33002 SERV PERS TERRIT;1;1;1;0;0;0;0;1;0;0;1;0;0;0
767.0;2021;03;BESANCON;MASCULIN;ENSEIGNEMENT A DISTANCE;BAC GENERAL;BAC GENERAL;BAC GENE 10019 BAC GENERAL;6;4;4;0;0;0;0;4;0;0;1;2;1;0
769.0;2021;03;BESANCON;MASCULIN;ENSEIGNEMENT A DISTANCE;BAC PROFESSIONNEL;BAC PRO SERV;BAC PRO 31202 COMMERCE;1;1;1;0;0;0;0;1;0;0;0;0;1;0
776.0;2021;03;BESANCON;MASCULIN;INDIVIDUEL;BAC GENERAL;BAC GENERAL;BAC GENE 10019 BAC GENERAL;22;14;7;3;4;4;0;11;0;0;1;0;10;3
779.0;2021;03;BESANCON;MASCULIN;INDIVIDUEL;BAC PROFESSIONNEL;BAC PRO PROD;BAC PRO 25514 SYST.NUM.OPT.B AUD.RES.EQUIP.DOM.;1;1;0;0;1;0;1;0;0;0;0;0;0;1
783.0;2021;03;BESANCON;MASCULIN;INDIVIDUEL;BAC PROFESSIONNEL;BAC PRO PROD;BAC PRO AG 21405 AMENAGEMENTS PAYSAGERS;1;0;0;0;0;0;0;0;0;0;0;0;0;0
787.0;2021;03;BESANCON;MASCULIN;INDIVIDUEL;BAC TECHNOLOGIQUE;BAC STHR;BAC STHR SC.&TEC. HOTELLERIE-RESTAURATION;1;1;0;1;0;0;0;0;0;0;0;0;0;1
800.0;2021;03;BESANCON;MASCULIN;SCOLAIRE;BAC PROFESSIONNEL;BAC PRO PROD;BAC PRO 23102 TRAVAUX PUBLICS;10;10;10;0;0;0;0;10;0;2;5;2;1;0
806.0;2021;03;BESANCON;MASCULIN;SCOLAIRE;BAC PROFESSIONNEL;BAC PRO PROD;BAC PRO 23405 TECHNICIEN MENUISIER AGENCEUR;44;44;43;0;1;1;0;44;0;5;12;19;8;0
810.0;2021;03;BESANCON;MASCULIN;SCOLAIRE;BAC PROFESSIONNEL;BAC PRO PROD;BAC PRO 25005 PRODUCTIQ.MECA. OPT.DECOLLETAGE;5;5;3;2;0;0;0;3;0;0;0;2;1;2
812.0;2021;03;BESANCON;MASCULIN;SCOLAIRE;BAC PROFESSIONNEL;BAC PRO PROD;BAC PRO 25007 MAINTENANCE EQUIPEMENTS INDUST.;131;131;91;27;13;8;5;99;0;4;10;32;53;32
817.0;2021;03;BESANCON;MASCULIN;SCOLAIRE;BAC PROFESSIONNEL;BAC PRO PROD;BAC PRO 25216 MAINT.VEHIC.OPTC MOTOCYCLES;23;23;18;2;3;3;0;21;0;3;6;6;6;2
819.0;2021;03;BESANCON;MASCULIN;SCOLAIRE;BAC PROFESSIONNEL;BAC PRO PROD;BAC PRO 25410 CONSTRUCTION DES CARROSSERIES;5;5;3;1;1;1;0;4;0;0;0;1;3;1
830.0;2021;03;BESANCON;MASCULIN;SCOLAIRE;BAC PROFESSIONNEL;BAC PRO PROD;BAC PRO AG 21211 COND GEST ENTR HIPPIQUE;5;5;4;1;0;0;0;4;0;0;1;1;2;1
831.0;2021;03;BESANCON;MASCULIN;SCOLAIRE;BAC PROFESSIONNEL;BAC PRO PROD;BAC PRO AG 21302 GEST MILIEUX NATURELS FAUNE;38;38;38;0;0;0;0;38;0;0;6;13;19;0
852.0;2021;03;BESANCON;MASCULIN;SCOLAIRE;BAC TECHNOLOGIQUE;BAC STD2A;BAC STD2A SCIENCES & TECHNO. DESIGN-ARTS APPLIQUES;13;13;13;0;0;0;0;13;0;2;3;5;3;0
858.0;2021;03;BESANCON;MASCULIN;SCOLAIRE;BAC TECHNOLOGIQUE;BAC STL;BAC STL BIOCHIM.-BIOLOGIE-BIOTECHNOL.;25;25;22;0;3;2;1;24;0;0;3;12;9;1
862.0;2021;03;BESANCON;MASCULIN;SCOLAIRE;BAC TECHNOLOGIQUE;BAC STMG;BAC STMG RESSOURCES HUMAINES ET COMMUNICATION;100;100;78;4;18;14;4;92;0;0;6;20;66;8
872.0;2021;04;BORDEAUX;FEMININ;APPRENTISSAGE;BAC PROFESSIONNEL;BAC PRO PROD;BAC PRO 25303 AERONAUTIQUE OPTION SYSTEMES;8;8;8;0;0;0;0;8;0;2;3;3;0;0
876.0;2021;04;BORDEAUX;FEMININ;APPRENTISSAGE;BAC PROFESSIONNEL;BAC PRO PROD;BAC PRO AG 21001 AGRO-EQUIPEMENT;1;1;1;0;0;0;0;1;0;0;0;0;1;0
878.0;2021;04;BORDEAUX;FEMININ;APPRENTISSAGE;BAC PROFESSIONNEL;BAC PRO PROD;BAC PRO AG 21113 CGEVV;6;5;4;1;0;0;0;4;0;0;0;1;3;1
885.0;2021;04;BORDEAUX;FEMININ;APPRENTISSAGE;BAC PROFESSIONNEL;BAC PRO SERV;BAC PRO 31202 COMMERCE;114;112;99;6;7;6;1;105;0;6;23;41;35;7
888.0;2021;04;BORDEAUX;FEMININ;APPRENTISSAGE;BAC PROFESSIONNEL;BAC PRO SERV;BAC PRO 32207 REAL.PR.IMPR.PLURI.OPTA.PR.GRAPH.;1;1;1;0;0;0;0;1;0;0;0;1;0;0
890.0;2021;04;BORDEAUX;FEMININ;APPRENTISSAGE;BAC PROFESSIONNEL;BAC PRO SERV;BAC PRO 33004 ACC.SOINS-S.PERS. OPT.EN STRUCTUR;2;2;2;0;0;0;0;2;0;0;0;2;0;0
891.0;2021;04;BORDEAUX;FEMININ;APPRENTISSAGE;BAC PROFESSIONNEL;BAC PRO SERV;BAC PRO 33101 OPTIQUE LUNETTERIE;8;8;8;0;0;0;0;8;0;1;5;2;0;0
895.0;2021;04;BORDEAUX;FEMININ;APPRENTISSAGE;BAC PROFESSIONNEL;BAC PRO SERV;BAC PRO AG 33002 SERV PERS TERRIT;6;6;6;0;0;0;0;6;0;1;1;2;2;0
896.0;2021;04;BORDEAUX;FEMININ;ENSEIGNEMENT A DISTANCE;BAC GENERAL;BAC GENERAL;BAC GENE 10019 BAC GENERAL;63;61;56;4;1;0;1;56;1;14;22;13;6;5
898.0;2021;04;BORDEAUX;FEMININ;ENSEIGNEMENT A DISTANCE;BAC PROFESSIONNEL;BAC PRO SERV;BAC PRO 31202 COMMERCE;6;4;1;3;0;0;0;1;0;0;0;0;1;3
901.0;2021;04;BORDEAUX;FEMININ;ENSEIGNEMENT A DISTANCE;BAC PROFESSIONNEL;BAC PRO SERV;BAC PRO 33003 ACC.SOINS-S.PERS. OPT.A DOMICILE;1;1;1;0;0;0;0;1;0;0;0;0;1;0
903.0;2021;04;BORDEAUX;FEMININ;ENSEIGNEMENT A DISTANCE;BAC PROFESSIONNEL;BAC PRO SERV;BAC PRO 33603 ESTHETIQUE COSMETIQUE PARFUMERIE;1;1;1;0;0;0;0;1;0;0;0;0;1;0
905.0;2021;04;BORDEAUX;FEMININ;ENSEIGNEMENT A DISTANCE;BAC TECHNOLOGIQUE;BAC STMG;BAC STMG MERCATIQUE (MARKETING);5;5;5;0;0;0;0;5;0;0;3;0;2;0
909.0;2021;04;BORDEAUX;FEMININ;FORMATION CONTINUE;BAC PROFESSIONNEL;BAC PRO PROD;BAC PRO AG 21114 CONDUITE PRODUCTIONS HORTICOLES;9;9;9;0;0;0;0;9;0;0;0;0;9;0
910.0;2021;04;BORDEAUX;FEMININ;FORMATION CONTINUE;BAC PROFESSIONNEL;BAC PRO PROD;BAC PRO AG 21405 AMENAGEMENTS PAYSAGERS;1;1;1;0;0;0;0;1;0;0;0;0;1;0
911.0;2021;04;BORDEAUX;FEMININ;FORMATION CONTINUE;BAC PROFESSIONNEL;BAC PRO SERV;BAC PRO 30001 GESTION-ADMINISTRATION;2;2;2;0;0;0;0;2;0;1;0;1;0;0
912.0;2021;04;BORDEAUX;FEMININ;FORMATION CONTINUE;BAC PROFESSIONNEL;BAC PRO SERV;BAC PRO 31202 COMMERCE;21;20;16;3;1;0;1;16;0;0;3;8;5;4
918.0;2021;04;BORDEAUX;FEMININ;INDIVIDUEL;BAC PROFESSIONNEL;BAC PRO PROD;BAC PRO AG 21004 CGEA;3;3;2;1;0;0;0;2;0;0;0;0;2;1
923.0;2021;04;BORDEAUX;FEMININ;INDIVIDUEL;BAC PROFESSIONNEL;BAC PRO SERV;BAC PRO 30001 GESTION-ADMINISTRATION;7;1;0;0;1;0;1;0;0;0;0;0;0;1
925.0;2021;04;BORDEAUX;FEMININ;INDIVIDUEL;BAC PROFESSIONNEL;BAC PRO SERV;BAC PRO 31202 COMMERCE;5;3;2;1;0;0;0;2;0;1;0;0;1;1
927.0;2021;04;BORDEAUX;FEMININ;INDIVIDUEL;BAC PROFESSIONNEL;BAC PRO SERV;BAC PRO 32304 PHOTOGRAPHIE;1;0;0;0;0;0;0;0;0;0;0;0;0;0
928.0;2021;04;BORDEAUX;FEMININ;INDIVIDUEL;BAC PROFESSIONNEL;BAC PRO SERV;BAC PRO 33003 ACC.SOINS-S.PERS. OPT.A DOMICILE;1;1;0;1;0;0;0;0;0;0;0;0;0;1
932.0;2021;04;BORDEAUX;FEMININ;INDIVIDUEL;BAC PROFESSIONNEL;BAC PRO SERV;BAC PRO 34304 HYGIENE PROPRETE STERILISATION;1;1;1;0;0;0;0;1;0;0;0;0;1;0
935.0;2021;04;BORDEAUX;FEMININ;INDIVIDUEL;BAC TECHNOLOGIQUE;BAC STD2A;BAC STD2A SCIENCES & TECHNO. DESIGN-ARTS APPLIQUES;3;3;2;1;0;0;0;2;0;0;0;1;1;1
944.0;2021;04;BORDEAUX;FEMININ;SCOLAIRE;BAC PROFESSIONNEL;BAC PRO PROD;BAC PRO 22003 BIO-INDUSTRIES DE TRANSFORMATION;5;5;5;0;0;0;0;5;0;1;2;2;0;0
949.0;2021;04;BORDEAUX;FEMININ;SCOLAIRE;BAC PROFESSIONNEL;BAC PRO PROD;BAC PRO 22503 PLASTIQUES ET COMPOSITES;1;1;0;0;1;1;0;1;0;0;0;0;1;0
957.0;2021;04;BORDEAUX;FEMININ;SCOLAIRE;BAC PROFESSIONNEL;BAC PRO PROD;BAC PRO 23404 TECHNICIEN CONSTRUCTEUR BOIS;1;1;1;0;0;0;0;1;0;0;0;1;0;0
958.0;2021;04;BORDEAUX;FEMININ;SCOLAIRE;BAC PROFESSIONNEL;BAC PRO PROD;BAC PRO 23405 TECHNICIEN MENUISIER AGENCEUR;6;5;5;0;0;0;0;5;0;0;2;1;2;0
960.0;2021;04;BORDEAUX;FEMININ;SCOLAIRE;BAC PROFESSIONNEL;BAC PRO PROD;BAC PRO 24202 ARTIS.& MET.ART : TAPIS.D'AMEUBL;32;31;27;3;1;1;0;28;0;0;4;16;8;3
968.0;2021;04;BORDEAUX;FEMININ;SCOLAIRE;BAC PROFESSIONNEL;BAC PRO PROD;BAC PRO 25303 AERONAUTIQUE OPTION SYSTEMES;7;7;7;0;0;0;0;7;0;2;2;3;0;0
971.0;2021;04;BORDEAUX;FEMININ;SCOLAIRE;BAC PROFESSIONNEL;BAC PRO PROD;BAC PRO 25411 TECH.CHAUDRONNERIE INDUSTRIELLE;4;3;3;0;0;0;0;3;0;0;0;1;2;0
981.0;2021;04;BORDEAUX;FEMININ;SCOLAIRE;BAC PROFESSIONNEL;BAC PRO PROD;BAC PRO AG 21204 PROD-AQUACOLES;3;2;2;0;0;0;0;2;0;0;0;1;1;0
983.0;2021;04;BORDEAUX;FEMININ;SCOLAIRE;BAC PROFESSIONNEL;BAC PRO PROD;BAC PRO AG 21211 COND GEST ENTR HIPPIQUE;47;46;44;2;0;0;0;44;0;1;7;17;19;2
987.0;2021;04;BORDEAUX;FEMININ;SCOLAIRE;BAC PROFESSIONNEL;BAC PRO PROD;BAC PRO AG 22105 LABORATOIRE CONTROLE QUALITE;22;22;21;1;0;0;0;21;0;1;5;7;8;1
989.0;2021;04;BORDEAUX;FEMININ;SCOLAIRE;BAC PROFESSIONNEL;BAC PRO PROD;BAC PRO AG 22107 TEC CONS VTE ALIMENTATION P.ALIM;8;8;8;0;0;0;0;8;0;0;1;2;5;0
990.0;2021;04;BORDEAUX;FEMININ;SCOLAIRE;BAC PROFESSIONNEL;BAC PRO SERV;BAC PRO 30001 GESTION-ADMINISTRATION;611;609;491;86;32;18;14;509;0;20;101;188;200;100
1005.0;2021;04;BORDEAUX;FEMININ;SCOLAIRE;BAC PROFESSIONNEL;BAC PRO SERV;BAC PRO 33102 PROTHESE DENTAIRE;10;10;10;0;0;0;0;10;0;2;4;4;0;0
1006.0;2021;04;BORDEAUX;FEMININ;SCOLAIRE;BAC PROFESSIONNEL;BAC PRO SERV;BAC PRO 33403 COMMERC. SERVICES EN RESTAURATION;96;96;91;2;3;3;0;94;0;5;11;39;39;2
1007.0;2021;04;BORDEAUX;FEMININ;SCOLAIRE;BAC PROFESSIONNEL;BAC PRO SERV;BAC PRO 33603 ESTHETIQUE COSMETIQUE PARFUMERIE;191;191;171;15;5;5;0;176;0;3;45;71;57;15
1009.0;2021;04;BORDEAUX;FEMININ;SCOLAIRE;BAC PROFESSIONNEL;BAC PRO SERV;BAC PRO 34305 TECHN.D'INTERV.SUR INSTALL. NUCL.;1;1;0;0;1;0;1;0;0;0;0;0;0;1
1010.0;2021;04;BORDEAUX;FEMININ;SCOLAIRE;BAC PROFESSIONNEL;BAC PRO SERV;BAC PRO 34403 METIERS DE LA SECURITE;19;18;18;0;0;0;0;18;0;1;7;10;0;0
1013.0;2021;04;BORDEAUX;FEMININ;SCOLAIRE;BAC TECHNOLOGIQUE;BAC ST2S;BAC ST2S SCIENCES & TECHNO. SANTE & SOCIAL;556;556;530;1;25;13;12;543;0;16;104;236;187;13
1016.0;2021;04;BORDEAUX;FEMININ;SCOLAIRE;BAC TECHNOLOGIQUE;BAC STHR;BAC STHR SC.&TEC. HOTELLERIE-RESTAURATION;83;83;73;1;9;9;0;82;0;2;20;27;33;1
1020.0;2021;04;BORDEAUX;FEMININ;SCOLAIRE;BAC TECHNOLOGIQUE;BAC STI2D;BAC STI2D SYSTÈME D'INFORMATION  ET NUMERIQUE;15;15;15;0;0;0;0;15;0;0;3;4;8;0
1024.0;2021;04;BORDEAUX;FEMININ;SCOLAIRE;BAC TECHNOLOGIQUE;BAC STMG;BAC STMG MERCATIQUE (MARKETING);808;808;744;10;54;23;31;767;0;10;150;332;275;41
1025.0;2021;04;BORDEAUX;FEMININ;SCOLAIRE;BAC TECHNOLOGIQUE;BAC STMG;BAC STMG RESSOURCES HUMAINES ET COMMUNICATION;585;585;526;11;48;27;21;553;0;8;77;232;236;32
1027.0;2021;04;BORDEAUX;MASCULIN;APPRENTISSAGE;BAC PROFESSIONNEL;BAC PRO PROD;BACPRO 20002 ETUD.DEFINITION PRDTS INDUSTRIEL;1;1;1;0;0;0;0;1;0;0;1;0;0;0
1034.0;2021;04;BORDEAUX;MASCULIN;APPRENTISSAGE;BAC PROFESSIONNEL;BAC PRO PROD;BAC PRO 23203 TECHNICIEN BAT. : ORG.REAL.GROS O;4;4;2;1;1;0;1;2;0;0;1;1;0;2
1040.0;2021;04;BORDEAUX;MASCULIN;APPRENTISSAGE;BAC PROFESSIONNEL;BAC PRO PROD;BAC PRO 24302 METIERS DU CUIR : MAROQUINERIE;1;1;1;0;0;0;0;1;0;1;0;0;0;0
1055.0;2021;04;BORDEAUX;MASCULIN;APPRENTISSAGE;BAC PROFESSIONNEL;BAC PRO PROD;BAC PRO 25510 METIERS ELECT. ENVIRON. CONNECTES;96;96;86;5;5;5;0;91;0;9;22;31;29;5
1072.0;2021;04;BORDEAUX;MASCULIN;APPRENTISSAGE;BAC PROFESSIONNEL;BAC PRO SERV;BAC PRO 31210 ACCUEIL -RELATION CLIENTS USAGERS;3;3;3;0;0;0;0;3;0;0;0;1;2;0
1077.0;2021;04;BORDEAUX;MASCULIN;APPRENTISSAGE;BAC PROFESSIONNEL;BAC PRO SERV;BAC PRO 33403 COMMERC. SERVICES EN RESTAURATION;11;11;11;0;0;0;0;11;0;0;2;6;3;0
1084.0;2021;04;BORDEAUX;MASCULIN;ENSEIGNEMENT A DISTANCE;BAC PROFESSIONNEL;BAC PRO SERV;BAC PRO 31202 COMMERCE;4;3;1;1;1;1;0;2;0;0;0;1;1;1
1106.0;2021;04;BORDEAUX;MASCULIN;INDIVIDUEL;BAC PROFESSIONNEL;BAC PRO PROD;BAC PRO 22503 PLASTIQUES ET COMPOSITES;1;0;0;0;0;0;0;0;0;0;0;0;0;0
1116.0;2021;04;BORDEAUX;MASCULIN;INDIVIDUEL;BAC PROFESSIONNEL;BAC PRO PROD;BAC PRO AG 21113 CGEVV;4;2;2;0;0;0;0;2;0;0;0;0;2;0
1117.0;2021;04;BORDEAUX;MASCULIN;INDIVIDUEL;BAC PROFESSIONNEL;BAC PRO PROD;BAC PRO AG 21114 CONDUITE PRODUCTIONS HORTICOLES;4;3;3;0;0;0;0;3;0;0;0;0;3;0
1118.0;2021;04;BORDEAUX;MASCULIN;INDIVIDUEL;BAC PROFESSIONNEL;BAC PRO PROD;BAC PRO AG 21302 GEST MILIEUX NATURELS FAUNE;1;0;0;0;0;0;0;0;0;0;0;0;0;0
1120.0;2021;04;BORDEAUX;MASCULIN;INDIVIDUEL;BAC PROFESSIONNEL;BAC PRO SERV;BAC PRO 30001 GESTION-ADMINISTRATION;2;1;1;0;0;0;0;1;0;0;0;0;1;0
1122.0;2021;04;BORDEAUX;MASCULIN;INDIVIDUEL;BAC PROFESSIONNEL;BAC PRO SERV;BAC PRO 31206 VENTE (PROSPECT.NEGO.SUIV.CLIENT;3;2;1;1;0;0;0;1;0;0;0;0;1;1
1124.0;2021;04;BORDEAUX;MASCULIN;INDIVIDUEL;BAC PROFESSIONNEL;BAC PRO SERV;BAC PRO 32303 ART.& MET.ART:COM.VIS.VIS.PLURI-M;1;1;1;0;0;0;0;1;0;0;0;0;1;0
1135.0;2021;04;BORDEAUX;MASCULIN;SCOLAIRE;BAC GENERAL;BAC GENERAL;BAC GENE 10019 BAC GENERAL;8076;8072;7657;58;357;233;124;7890;85;700;1825;2907;2373;182
1142.0;2021;04;BORDEAUX;MASCULIN;SCOLAIRE;BAC PROFESSIONNEL;BAC PRO PROD;BAC PRO 22106 CUISINE;165;165;149;7;9;4;5;153;0;15;48;52;38;12
1144.0;2021;04;BORDEAUX;MASCULIN;SCOLAIRE;BAC PROFESSIONNEL;BAC PRO PROD;BAC PRO 22703 TECHN.INSTALL.SYST.ENERG.CLIMATI;63;63;50;9;4;4;0;54;0;2;7;18;27;9
1149.0;2021;04;BORDEAUX;MASCULIN;SCOLAIRE;BAC PROFESSIONNEL;BAC PRO PROD;BACPRO 23103 TECHNICIEN GEOMETRE-TOPOGRAPHE;14;14;13;0;1;1;0;14;0;0;1;5;8;0
1154.0;2021;04;BORDEAUX;MASCULIN;SCOLAIRE;BAC PROFESSIONNEL;BAC PRO PROD;BAC PRO 23404 TECHNICIEN CONSTRUCTEUR BOIS;66;66;55;3;8;8;0;63;0;0;6;20;37;3
1159.0;2021;04;BORDEAUX;MASCULIN;SCOLAIRE;BAC PROFESSIONNEL;BAC PRO PROD;BAC PRO 24203 METIERS DE LA MODE - VÊTEMENT;14;14;14;0;0;0;0;14;0;0;3;8;3;0
1161.0;2021;04;BORDEAUX;MASCULIN;SCOLAIRE;BAC PROFESSIONNEL;BAC PRO PROD;BAC PRO 25009 MAINTENANCE NAUTIQUE;23;23;21;1;1;1;0;22;0;0;3;12;7;1
1162.0;2021;04;BORDEAUX;MASCULIN;SCOLAIRE;BAC PROFESSIONNEL;BAC PRO PROD;BAC PRO 25106 TECHNICIEN D'USINAGE;112;111;82;20;9;8;1;90;0;3;22;32;33;21
1166.0;2021;04;BORDEAUX;MASCULIN;SCOLAIRE;BAC PROFESSIONNEL;BAC PRO PROD;BAC PRO 25216 MAINT.VEHIC.OPTC MOTOCYCLES;53;53;42;8;3;1;2;43;0;0;7;12;24;10
1177.0;2021;04;BORDEAUX;MASCULIN;SCOLAIRE;BAC PROFESSIONNEL;BAC PRO PROD;BAC PRO 25510 METIERS ELECT. ENVIRON. CONNECTES;470;469;384;69;16;9;7;393;0;21;77;151;144;76
1181.0;2021;04;BORDEAUX;MASCULIN;SCOLAIRE;BAC PROFESSIONNEL;BAC PRO PROD;BAC PRO AG 21001 AGRO-EQUIPEMENT;37;36;33;3;0;0;0;33;0;0;5;9;19;3
1187.0;2021;04;BORDEAUX;MASCULIN;SCOLAIRE;BAC PROFESSIONNEL;BAC PRO PROD;BAC PRO AG 21210 COND GEST ENTR CANIN ET FELIN;10;10;7;3;0;0;0;7;0;0;0;3;4;3
1191.0;2021;04;BORDEAUX;MASCULIN;SCOLAIRE;BAC PROFESSIONNEL;BAC PRO PROD;BAC PRO AG 21405 AMENAGEMENTS PAYSAGERS;90;89;83;6;0;0;0;83;0;1;15;35;32;6
1192.0;2021;04;BORDEAUX;MASCULIN;SCOLAIRE;BAC PROFESSIONNEL;BAC PRO PROD;BAC PRO AG 21406 TEC CONS VTE PROD DES JARDINS;21;19;13;6;0;0;0;13;0;0;0;3;10;6
1195.0;2021;04;BORDEAUX;MASCULIN;SCOLAIRE;BAC PROFESSIONNEL;BAC PRO PROD;BAC PRO AG 22107 TEC CONS VTE ALIMENTATION P.ALIM;8;7;7;0;0;0;0;7;0;0;1;1;5;0
1208.0;2021;04;BORDEAUX;MASCULIN;SCOLAIRE;BAC PROFESSIONNEL;BAC PRO SERV;BAC PRO 33003 ACC.SOINS-S.PERS. OPT.A DOMICILE;23;23;22;1;0;0;0;22;0;0;5;10;7;1
1209.0;2021;04;BORDEAUX;MASCULIN;SCOLAIRE;BAC PROFESSIONNEL;BAC PRO SERV;BAC PRO 33004 ACC.SOINS-S.PERS. OPT.EN STRUCTUR;23;23;22;1;0;0;0;22;0;0;6;11;5;1
1210.0;2021;04;BORDEAUX;MASCULIN;SCOLAIRE;BAC PROFESSIONNEL;BAC PRO SERV;BAC PRO 33101 OPTIQUE LUNETTERIE;9;9;7;2;0;0;0;7;0;0;0;2;5;2
1214.0;2021;04;BORDEAUX;MASCULIN;SCOLAIRE;BAC PROFESSIONNEL;BAC PRO SERV;BAC PRO 34305 TECHN.D'INTERV.SUR INSTALL. NUCL.;7;7;5;2;0;0;0;5;0;0;2;1;2;2
1220.0;2021;04;BORDEAUX;MASCULIN;SCOLAIRE;BAC TECHNOLOGIQUE;BAC STD2A;BAC STD2A SCIENCES & TECHNO. DESIGN-ARTS APPLIQUES;44;44;40;1;3;3;0;43;0;6;10;19;8;1
1223.0;2021;04;BORDEAUX;MASCULIN;SCOLAIRE;BAC TECHNOLOGIQUE;BAC STI2D;BAC STI2D ENERGIES  ET ENVIRONNEMENT;197;197;179;5;13;6;7;185;0;3;27;74;81;12
1224.0;2021;04;BORDEAUX;MASCULIN;SCOLAIRE;BAC TECHNOLOGIQUE;BAC STI2D;BAC STI2D INNOVATION TECHNO.  ET ECO CONCEPTION;479;479;445;6;28;19;9;464;0;5;78;173;208;15
1226.0;2021;04;BORDEAUX;MASCULIN;SCOLAIRE;BAC TECHNOLOGIQUE;BAC STL;BAC STL BIOCHIM.-BIOLOGIE-BIOTECHNOL.;93;93;78;4;11;8;3;86;0;0;14;35;37;7
1231.0;2021;04;BORDEAUX;MASCULIN;SCOLAIRE;BAC TECHNOLOGIQUE;BAC STMG;BAC STMG SYSTEMES D'INFORMATION DE GESTION;38;38;28;2;8;4;4;32;0;0;4;10;18;6
1232.0;2021;06;CLERMONT-FERRAND;FEMININ;APPRENTISSAGE;BAC PROFESSIONNEL;BAC PRO PROD;BAC PRO 20102 PILOTE DE LIGNE DE PRODUCTION;4;4;4;0;0;0;0;4;0;3;0;1;0;0
1235.0;2021;06;CLERMONT-FERRAND;FEMININ;APPRENTISSAGE;BAC PROFESSIONNEL;BAC PRO PROD;BAC PRO 22705 TECHNICIEN GAZ;2;2;2;0;0;0;0;2;0;0;2;0;0;0
1236.0;2021;06;CLERMONT-FERRAND;FEMININ;APPRENTISSAGE;BAC PROFESSIONNEL;BAC PRO PROD;BAC PRO 23005 TECHN. ETUDES BAT B ASSIST.ARCHI.;1;1;1;0;0;0;0;1;0;1;0;0;0;0
1239.0;2021;06;CLERMONT-FERRAND;FEMININ;APPRENTISSAGE;BAC PROFESSIONNEL;BAC PRO PROD;BAC PRO 24302 METIERS DU CUIR : MAROQUINERIE;1;1;1;0;0;0;0;1;0;1;0;0;0;0
1240.0;2021;06;CLERMONT-FERRAND;FEMININ;APPRENTISSAGE;BAC PROFESSIONNEL;BAC PRO PROD;BAC PRO 25007 MAINTENANCE EQUIPEMENTS INDUST.;2;2;2;0;0;0;0;2;0;0;1;1;0;0
1241.0;2021;06;CLERMONT-FERRAND;FEMININ;APPRENTISSAGE;BAC PROFESSIONNEL;BAC PRO PROD;BAC PRO 25106 TECHNICIEN D'USINAGE;2;2;2;0;0;0;0;2;0;2;0;0;0;0
1252.0;2021;06;CLERMONT-FERRAND;FEMININ;APPRENTISSAGE;BAC PROFESSIONNEL;BAC PRO SERV;BAC PRO 33403 COMMERC. SERVICES EN RESTAURATION;3;3;1;1;1;1;0;2;0;0;0;1;1;1
1258.0;2021;06;CLERMONT-FERRAND;FEMININ;ENSEIGNEMENT A DISTANCE;BAC PROFESSIONNEL;BAC PRO SERV;BAC PRO 33004 ACC.SOINS-S.PERS. OPT.EN STRUCTUR;2;1;0;1;0;0;0;0;0;0;0;0;0;1
1259.0;2021;06;CLERMONT-FERRAND;FEMININ;ENSEIGNEMENT A DISTANCE;BAC PROFESSIONNEL;BAC PRO SERV;BAC PRO 33603 ESTHETIQUE COSMETIQUE PARFUMERIE;1;0;0;0;0;0;0;0;0;0;0;0;0;0
1263.0;2021;06;CLERMONT-FERRAND;FEMININ;ENSEIGNEMENT A DISTANCE;BAC TECHNOLOGIQUE;BAC STMG;BAC STMG SYSTEMES D'INFORMATION DE GESTION;1;1;1;0;0;0;0;1;0;0;0;1;0;0
1266.0;2021;06;CLERMONT-FERRAND;FEMININ;FORMATION CONTINUE;BAC PROFESSIONNEL;BAC PRO SERV;BAC PRO 31210 ACCUEIL -RELATION CLIENTS USAGERS;2;2;1;1;0;0;0;1;0;0;0;1;0;1
1267.0;2021;06;CLERMONT-FERRAND;FEMININ;FORMATION CONTINUE;BAC PROFESSIONNEL;BAC PRO SERV;BAC PRO 32304 PHOTOGRAPHIE;1;1;1;0;0;0;0;1;0;0;1;0;0;0
1268.0;2021;06;CLERMONT-FERRAND;FEMININ;FORMATION CONTINUE;BAC PROFESSIONNEL;BAC PRO SERV;BAC PRO 33403 COMMERC. SERVICES EN RESTAURATION;1;1;1;0;0;0;0;1;0;1;0;0;0;0
1269.0;2021;06;CLERMONT-FERRAND;FEMININ;INDIVIDUEL;BAC GENERAL;BAC GENERAL;BAC GENE 10019 BAC GENERAL;32;29;15;13;1;1;0;16;0;1;4;3;8;13
1270.0;2021;06;CLERMONT-FERRAND;FEMININ;INDIVIDUEL;BAC PROFESSIONNEL;BAC PRO PROD;BAC PRO AG 21004 CGEA;9;8;6;2;0;0;0;6;0;0;0;0;6;2
1280.0;2021;06;CLERMONT-FERRAND;FEMININ;INDIVIDUEL;BAC PROFESSIONNEL;BAC PRO SERV;BAC PRO 34403 METIERS DE LA SECURITE;1;0;0;0;0;0;0;0;0;0;0;0;0;0
1282.0;2021;06;CLERMONT-FERRAND;FEMININ;INDIVIDUEL;BAC TECHNOLOGIQUE;BAC STMG;BAC STMG GESTION ET FINANCE;3;3;2;1;0;0;0;2;0;0;0;0;2;1
1284.0;2021;06;CLERMONT-FERRAND;FEMININ;INDIVIDUEL;BAC TECHNOLOGIQUE;BAC STMG;BAC STMG RESSOURCES HUMAINES ET COMMUNICATION;3;3;1;2;0;0;0;1;0;0;0;0;1;2
1289.0;2021;06;CLERMONT-FERRAND;FEMININ;SCOLAIRE;BAC PROFESSIONNEL;BAC PRO PROD;BAC PRO 22403 ARTS.& MET.ART:MET.ENSEIGN SIGNA;2;2;2;0;0;0;0;2;0;0;0;2;0;0
1298.0;2021;06;CLERMONT-FERRAND;FEMININ;SCOLAIRE;BAC PROFESSIONNEL;BAC PRO PROD;BAC PRO 24302 METIERS DU CUIR : MAROQUINERIE;17;17;16;1;0;0;0;16;0;2;7;6;1;1
1299.0;2021;06;CLERMONT-FERRAND;FEMININ;SCOLAIRE;BAC PROFESSIONNEL;BAC PRO PROD;BAC PRO 25007 MAINTENANCE EQUIPEMENTS INDUST.;6;6;5;1;0;0;0;5;0;0;1;2;2;1
1304.0;2021;06;CLERMONT-FERRAND;FEMININ;SCOLAIRE;BAC PROFESSIONNEL;BAC PRO PROD;BAC PRO 25510 METIERS ELECT. ENVIRON. CONNECTES;4;4;3;1;0;0;0;3;0;0;0;2;1;1
1305.0;2021;06;CLERMONT-FERRAND;FEMININ;SCOLAIRE;BAC PROFESSIONNEL;BAC PRO PROD;BAC PRO 25514 SYST.NUM.OPT.B AUD.RES.EQUIP.DOM.;2;2;2;0;0;0;0;2;0;1;0;1;0;0
1308.0;2021;06;CLERMONT-FERRAND;FEMININ;SCOLAIRE;BAC PROFESSIONNEL;BAC PRO PROD;BAC PRO AG 21004 CGEA;56;56;51;5;0;0;0;51;0;2;6;23;20;5
1309.0;2021;06;CLERMONT-FERRAND;FEMININ;SCOLAIRE;BAC PROFESSIONNEL;BAC PRO PROD;BAC PRO AG 21113 CGEVV;1;0;0;0;0;0;0;0;0;0;0;0;0;0
1311.0;2021;06;CLERMONT-FERRAND;FEMININ;SCOLAIRE;BAC PROFESSIONNEL;BAC PRO PROD;BAC PRO AG 21203 TECHN CONSEIL DE VENTE ANIMAL;17;17;16;1;0;0;0;16;0;2;0;4;10;1
1314.0;2021;06;CLERMONT-FERRAND;FEMININ;SCOLAIRE;BAC PROFESSIONNEL;BAC PRO PROD;BAC PRO AG 21302 GEST MILIEUX NATURELS FAUNE;7;7;6;1;0;0;0;6;0;1;2;3;0;1
1321.0;2021;06;CLERMONT-FERRAND;FEMININ;SCOLAIRE;BAC PROFESSIONNEL;BAC PRO SERV;BAC PRO 31107 CONDUCT. TRANSP.ROUT.MARCHANDISES;3;3;2;1;0;0;0;2;0;1;1;0;0;1
1324.0;2021;06;CLERMONT-FERRAND;FEMININ;SCOLAIRE;BAC PROFESSIONNEL;BAC PRO SERV;BAC PRO 31206 VENTE (PROSPECT.NEGO.SUIV.CLIENT;34;34;27;1;6;1;5;28;0;0;4;14;10;6
1330.0;2021;06;CLERMONT-FERRAND;FEMININ;SCOLAIRE;BAC PROFESSIONNEL;BAC PRO SERV;BAC PRO 33002 SERVICES DE PROXIMITE  VIE LOCAL;28;28;25;1;2;1;1;26;0;2;4;10;10;2
1337.0;2021;06;CLERMONT-FERRAND;FEMININ;SCOLAIRE;BAC PROFESSIONNEL;BAC PRO SERV;BAC PRO 34304 HYGIENE PROPRETE STERILISATION;13;13;8;5;0;0;0;8;0;0;1;3;4;5
1338.0;2021;06;CLERMONT-FERRAND;FEMININ;SCOLAIRE;BAC PROFESSIONNEL;BAC PRO SERV;BAC PRO 34403 METIERS DE LA SECURITE;14;14;10;3;1;0;1;10;0;0;1;2;7;4
1344.0;2021;06;CLERMONT-FERRAND;FEMININ;SCOLAIRE;BAC TECHNOLOGIQUE;BAC STI2D;BAC STI2D ARCHITECTURE ET CONSTRUCTION;24;24;23;0;1;0;1;23;0;0;10;10;3;1
1345.0;2021;06;CLERMONT-FERRAND;FEMININ;SCOLAIRE;BAC TECHNOLOGIQUE;BAC STI2D;BAC STI2D ENERGIES  ET ENVIRONNEMENT;5;5;4;0;1;0;1;4;0;0;0;2;2;1
1350.0;2021;06;CLERMONT-FERRAND;FEMININ;SCOLAIRE;BAC TECHNOLOGIQUE;BAC STMG;BAC STMG GESTION ET FINANCE;79;79;70;4;5;3;2;73;0;4;10;23;36;6
1351.0;2021;06;CLERMONT-FERRAND;FEMININ;SCOLAIRE;BAC TECHNOLOGIQUE;BAC STMG;BAC STMG MERCATIQUE (MARKETING);184;184;169;1;14;6;8;175;0;1;17;73;84;9
1352.0;2021;06;CLERMONT-FERRAND;FEMININ;SCOLAIRE;BAC TECHNOLOGIQUE;BAC STMG;BAC STMG RESSOURCES HUMAINES ET COMMUNICATION;221;221;195;2;24;12;12;207;0;1;21;74;111;14
1354.0;2021;06;CLERMONT-FERRAND;MASCULIN;APPRENTISSAGE;BAC PROFESSIONNEL;BAC PRO PROD;BACPRO 20002 ETUD.DEFINITION PRDTS INDUSTRIEL;1;1;1;0;0;0;0;1;0;0;0;0;1;0
1355.0;2021;06;CLERMONT-FERRAND;MASCULIN;APPRENTISSAGE;BAC PROFESSIONNEL;BAC PRO PROD;BAC PRO 20102 PILOTE DE LIGNE DE PRODUCTION;11;11;11;0;0;0;0;11;0;2;4;4;1;0
1357.0;2021;06;CLERMONT-FERRAND;MASCULIN;APPRENTISSAGE;BAC PROFESSIONNEL;BAC PRO PROD;BAC PRO 22503 PLASTIQUES ET COMPOSITES;10;9;7;2;0;0;0;7;0;0;2;1;4;2
1358.0;2021;06;CLERMONT-FERRAND;MASCULIN;APPRENTISSAGE;BAC PROFESSIONNEL;BAC PRO PROD;BAC PRO 22703 TECHN.INSTALL.SYST.ENERG.CLIMATI;13;11;7;4;0;0;0;7;0;0;1;4;2;4
1360.0;2021;06;CLERMONT-FERRAND;MASCULIN;APPRENTISSAGE;BAC PROFESSIONNEL;BAC PRO PROD;BAC PRO 22705 TECHNICIEN GAZ;3;3;3;0;0;0;0;3;0;2;1;0;0;0
1365.0;2021;06;CLERMONT-FERRAND;MASCULIN;APPRENTISSAGE;BAC PROFESSIONNEL;BAC PRO PROD;BAC PRO 23406 TECHNICIEN DE SCIERIE;5;5;5;0;0;0;0;5;0;0;3;1;1;0
1368.0;2021;06;CLERMONT-FERRAND;MASCULIN;APPRENTISSAGE;BAC PROFESSIONNEL;BAC PRO PROD;BAC PRO 25107 TECHNICIEN OUTILLEUR;1;0;0;0;0;0;0;0;0;0;0;0;0;0
1369.0;2021;06;CLERMONT-FERRAND;MASCULIN;APPRENTISSAGE;BAC PROFESSIONNEL;BAC PRO PROD;BAC PRO 25214 MAINT.VEHIC.OPTA VOIT.PARTICUL.;42;42;30;10;2;0;2;30;0;3;10;10;7;12
1372.0;2021;06;CLERMONT-FERRAND;MASCULIN;APPRENTISSAGE;BAC PROFESSIONNEL;BAC PRO PROD;BAC PRO 25219 MAINT.MATERIELS OPT.A AGRICOLES;14;14;12;1;1;0;1;12;0;1;1;4;6;2
1376.0;2021;06;CLERMONT-FERRAND;MASCULIN;APPRENTISSAGE;BAC PROFESSIONNEL;BAC PRO PROD;BAC PRO 25303 AERONAUTIQUE OPTION SYSTEMES;9;9;8;0;1;1;0;9;0;0;3;4;2;0
1378.0;2021;06;CLERMONT-FERRAND;MASCULIN;APPRENTISSAGE;BAC PROFESSIONNEL;BAC PRO PROD;BAC PRO 25408 REPARATION DES CARROSSERIES;11;11;10;1;0;0;0;10;0;0;1;5;4;1
1390.0;2021;06;CLERMONT-FERRAND;MASCULIN;APPRENTISSAGE;BAC PROFESSIONNEL;BAC PRO SERV;BAC PRO 31202 COMMERCE;30;30;24;4;2;1;1;25;0;4;3;8;10;5
1391.0;2021;06;CLERMONT-FERRAND;MASCULIN;APPRENTISSAGE;BAC PROFESSIONNEL;BAC PRO SERV;BAC PRO 31206 VENTE (PROSPECT.NEGO.SUIV.CLIENT;1;1;1;0;0;0;0;1;0;0;1;0;0;0
1408.0;2021;06;CLERMONT-FERRAND;MASCULIN;FORMATION CONTINUE;BAC PROFESSIONNEL;BAC PRO SERV;BAC PRO 31202 COMMERCE;4;4;2;2;0;0;0;2;0;0;0;0;2;2
1409.0;2021;06;CLERMONT-FERRAND;MASCULIN;INDIVIDUEL;BAC GENERAL;BAC GENERAL;BAC GENE 10019 BAC GENERAL;23;21;3;15;3;2;1;5;0;0;0;1;4;16
1412.0;2021;06;CLERMONT-FERRAND;MASCULIN;INDIVIDUEL;BAC PROFESSIONNEL;BAC PRO PROD;BAC PRO AG 21113 CGEVV;1;0;0;0;0;0;0;0;0;0;0;0;0;0
1413.0;2021;06;CLERMONT-FERRAND;MASCULIN;INDIVIDUEL;BAC PROFESSIONNEL;BAC PRO PROD;BAC PRO AG 21114 CONDUITE PRODUCTIONS HORTICOLES;2;2;2;0;0;0;0;2;0;0;0;0;2;0
1414.0;2021;06;CLERMONT-FERRAND;MASCULIN;INDIVIDUEL;BAC PROFESSIONNEL;BAC PRO SERV;BAC PRO 30001 GESTION-ADMINISTRATION;2;1;1;0;0;0;0;1;0;0;0;0;1;0
1417.0;2021;06;CLERMONT-FERRAND;MASCULIN;INDIVIDUEL;BAC TECHNOLOGIQUE;BAC STI2D;BAC STI2D ENERGIES  ET ENVIRONNEMENT;1;1;0;1;0;0;0;0;0;0;0;0;0;1
1418.0;2021;06;CLERMONT-FERRAND;MASCULIN;INDIVIDUEL;BAC TECHNOLOGIQUE;BAC STI2D;BAC STI2D SYSTÈME D'INFORMATION  ET NUMERIQUE;1;1;0;1;0;0;0;0;0;0;0;0;0;1
1421.0;2021;06;CLERMONT-FERRAND;MASCULIN;INDIVIDUEL;BAC TECHNOLOGIQUE;BAC STMG;BAC STMG RESSOURCES HUMAINES ET COMMUNICATION;1;1;0;1;0;0;0;0;0;0;0;0;0;1
1424.0;2021;06;CLERMONT-FERRAND;MASCULIN;SCOLAIRE;BAC PROFESSIONNEL;BAC PRO PROD;BAC PRO 20102 PILOTE DE LIGNE DE PRODUCTION;2;2;1;1;0;0;0;1;0;0;0;1;0;1
1425.0;2021;06;CLERMONT-FERRAND;MASCULIN;SCOLAIRE;BAC PROFESSIONNEL;BAC PRO PROD;BAC PRO 22003 BIO-INDUSTRIES DE TRANSFORMATION;4;4;3;1;0;0;0;3;0;0;0;2;1;1
1426.0;2021;06;CLERMONT-FERRAND;MASCULIN;SCOLAIRE;BAC PROFESSIONNEL;BAC PRO PROD;BAC PRO 22106 CUISINE;67;67;54;6;7;6;1;60;0;4;8;23;25;7
1432.0;2021;06;CLERMONT-FERRAND;MASCULIN;SCOLAIRE;BAC PROFESSIONNEL;BAC PRO PROD;BAC PRO 23004 TECHN. ETUDES BAT.A ETUDES & ECO.;8;8;6;2;0;0;0;6;0;1;2;1;2;2
1433.0;2021;06;CLERMONT-FERRAND;MASCULIN;SCOLAIRE;BAC PROFESSIONNEL;BAC PRO PROD;BAC PRO 23005 TECHN. ETUDES BAT B ASSIST.ARCHI.;10;10;9;1;0;0;0;9;0;0;1;7;1;1
1436.0;2021;06;CLERMONT-FERRAND;MASCULIN;SCOLAIRE;BAC PROFESSIONNEL;BAC PRO PROD;BAC PRO 23203 TECHNICIEN BAT. : ORG.REAL.GROS O;8;8;4;1;3;0;3;4;0;0;1;1;2;4
1445.0;2021;06;CLERMONT-FERRAND;MASCULIN;SCOLAIRE;BAC PROFESSIONNEL;BAC PRO PROD;BAC PRO 25214 MAINT.VEHIC.OPTA VOIT.PARTICUL.;80;80;52;25;3;3;0;55;0;0;9;20;26;25
1457.0;2021;06;CLERMONT-FERRAND;MASCULIN;SCOLAIRE;BAC PROFESSIONNEL;BAC PRO PROD;BAC PRO 25510 METIERS ELECT. ENVIRON. CONNECTES;196;196;158;29;9;8;1;166;0;14;33;52;67;30
1459.0;2021;06;CLERMONT-FERRAND;MASCULIN;SCOLAIRE;BAC PROFESSIONNEL;BAC PRO PROD;BAC PRO 25514 SYST.NUM.OPT.B AUD.RES.EQUIP.DOM.;17;17;14;2;1;1;0;15;0;4;2;3;6;2
1471.0;2021;06;CLERMONT-FERRAND;MASCULIN;SCOLAIRE;BAC PROFESSIONNEL;BAC PRO PROD;BAC PRO AG 21406 TEC CONS VTE PROD DES JARDINS;1;1;1;0;0;0;0;1;0;0;1;0;0;0
1475.0;2021;06;CLERMONT-FERRAND;MASCULIN;SCOLAIRE;BAC PROFESSIONNEL;BAC PRO SERV;BAC PRO 31106 LOGISTIQUE;14;14;11;2;1;1;0;12;0;0;1;6;5;2
1488.0;2021;06;CLERMONT-FERRAND;MASCULIN;SCOLAIRE;BAC PROFESSIONNEL;BAC PRO SERV;BAC PRO 33101 OPTIQUE LUNETTERIE;12;12;12;0;0;0;0;12;0;0;1;8;3;0
1492.0;2021;06;CLERMONT-FERRAND;MASCULIN;SCOLAIRE;BAC PROFESSIONNEL;BAC PRO SERV;BAC PRO 34403 METIERS DE LA SECURITE;27;27;21;6;0;0;0;21;0;0;6;5;10;6
1493.0;2021;06;CLERMONT-FERRAND;MASCULIN;SCOLAIRE;BAC PROFESSIONNEL;BAC PRO SERV;BAC PRO AG 33002 SERV PERS TERRIT;23;21;20;1;0;0;0;20;0;0;3;8;9;1
1512.0;2021;27;CORSE;FEMININ;APPRENTISSAGE;BAC PROFESSIONNEL;BAC PRO SERV;BAC PRO 33403 COMMERC. SERVICES EN RESTAURATION;1;1;1;0;0;0;0;1;0;0;0;1;0;0
1520.0;2021;27;CORSE;FEMININ;INDIVIDUEL;BAC GENERAL;BAC GENERAL;BAC GENE 10019 BAC GENERAL;5;3;3;0;0;0;0;3;0;0;1;0;2;0
1524.0;2021;27;CORSE;FEMININ;INDIVIDUEL;BAC PROFESSIONNEL;BAC PRO PROD;BAC PRO AG 21114 CONDUITE PRODUCTIONS HORTICOLES;7;4;3;1;0;0;0;3;0;0;0;0;3;1
1534.0;2021;27;CORSE;FEMININ;SCOLAIRE;BAC PROFESSIONNEL;BAC PRO PROD;BAC PRO 25513 SYST.NUM.OPT.A SURETE SECURITE;1;1;1;0;0;0;0;1;0;0;1;0;0;0
1547.0;2021;27;CORSE;FEMININ;SCOLAIRE;BAC PROFESSIONNEL;BAC PRO SERV;BAC PRO 34403 METIERS DE LA SECURITE;2;2;2;0;0;0;0;2;0;0;0;1;1;0
1552.0;2021;27;CORSE;FEMININ;SCOLAIRE;BAC TECHNOLOGIQUE;BAC STI2D;BAC STI2D ARCHITECTURE ET CONSTRUCTION;2;2;2;0;0;0;0;2;0;0;1;1;0;0
1564.0;2021;27;CORSE;MASCULIN;APPRENTISSAGE;BAC PROFESSIONNEL;BAC PRO SERV;BAC PRO 31107 CONDUCT. TRANSP.ROUT.MARCHANDISES;1;1;0;1;0;0;0;0;0;0;0;0;0;1
1567.0;2021;27;CORSE;MASCULIN;ENSEIGNEMENT A DISTANCE;BAC GENERAL;BAC GENERAL;BAC GENE 10019 BAC GENERAL;2;2;2;0;0;0;0;2;0;1;0;1;0;0
1575.0;2021;27;CORSE;MASCULIN;INDIVIDUEL;BAC PROFESSIONNEL;BAC PRO PROD;BAC PRO AG 21302 GEST MILIEUX NATURELS FAUNE;1;0;0;0;0;0;0;0;0;0;0;0;0;0
1585.0;2021;27;CORSE;MASCULIN;SCOLAIRE;BAC PROFESSIONNEL;BAC PRO PROD;BAC PRO 22106 CUISINE;29;29;27;2;0;0;0;27;0;1;7;14;5;2
1586.0;2021;27;CORSE;MASCULIN;SCOLAIRE;BAC PROFESSIONNEL;BAC PRO PROD;BAC PRO 22703 TECHN.INSTALL.SYST.ENERG.CLIMATI;6;6;3;3;0;0;0;3;0;0;0;1;2;3
1593.0;2021;27;CORSE;MASCULIN;SCOLAIRE;BAC PROFESSIONNEL;BAC PRO PROD;BAC PRO 25406 OUVRAGES DU BATIMENT METALLERIE;3;3;2;0;1;1;0;3;0;0;0;0;3;0
1594.0;2021;27;CORSE;MASCULIN;SCOLAIRE;BAC PROFESSIONNEL;BAC PRO PROD;BAC PRO 25509 TECHNIC. FROID CONDITIONNEMT AIR;9;9;8;1;0;0;0;8;0;0;2;2;4;1
1596.0;2021;27;CORSE;MASCULIN;SCOLAIRE;BAC PROFESSIONNEL;BAC PRO PROD;BAC PRO 25513 SYST.NUM.OPT.A SURETE SECURITE;8;8;6;1;1;1;0;7;0;1;1;3;2;1
1598.0;2021;27;CORSE;MASCULIN;SCOLAIRE;BAC PROFESSIONNEL;BAC PRO PROD;BAC PRO 25515 SYST.NUM.OPT.C RES.INF.SYST.COMM.;19;19;16;2;1;1;0;17;0;2;2;8;5;2
1601.0;2021;27;CORSE;MASCULIN;SCOLAIRE;BAC PROFESSIONNEL;BAC PRO PROD;BAC PRO AG 21303 FORET;7;7;7;0;0;0;0;7;0;1;1;2;3;0
1604.0;2021;27;CORSE;MASCULIN;SCOLAIRE;BAC PROFESSIONNEL;BAC PRO SERV;BAC PRO 31106 LOGISTIQUE;12;12;10;1;1;1;0;11;0;0;0;4;7;1
1606.0;2021;27;CORSE;MASCULIN;SCOLAIRE;BAC PROFESSIONNEL;BAC PRO SERV;BAC PRO 31202 COMMERCE;23;23;19;3;1;1;0;20;0;2;2;7;9;3
1611.0;2021;27;CORSE;MASCULIN;SCOLAIRE;BAC PROFESSIONNEL;BAC PRO SERV;BAC PRO 33403 COMMERC. SERVICES EN RESTAURATION;10;10;9;1;0;0;0;9;0;1;3;1;4;1
1613.0;2021;27;CORSE;MASCULIN;SCOLAIRE;BAC TECHNOLOGIQUE;BAC ST2S;BAC ST2S SCIENCES & TECHNO. SANTE & SOCIAL;33;33;29;1;3;2;1;31;0;0;3;9;19;2
1617.0;2021;27;CORSE;MASCULIN;SCOLAIRE;BAC TECHNOLOGIQUE;BAC STI2D;BAC STI2D ENERGIES  ET ENVIRONNEMENT;14;14;12;0;2;2;0;14;0;0;1;4;9;0
1620.0;2021;27;CORSE;MASCULIN;SCOLAIRE;BAC TECHNOLOGIQUE;BAC STL;BAC STL BIOCHIM.-BIOLOGIE-BIOTECHNOL.;7;7;6;0;1;1;0;7;0;0;1;1;5;0
1628.0;2021;24;CRETEIL;FEMININ;APPRENTISSAGE;BAC PROFESSIONNEL;BAC PRO PROD;BAC PRO 25214 MAINT.VEHIC.OPTA VOIT.PARTICUL.;4;4;4;0;0;0;0;4;0;0;1;3;0;0
1632.0;2021;24;CRETEIL;FEMININ;APPRENTISSAGE;BAC PROFESSIONNEL;BAC PRO PROD;BAC PRO AG 21004 CGEA;1;1;1;0;0;0;0;1;0;0;0;0;1;0
1638.0;2021;24;CRETEIL;FEMININ;APPRENTISSAGE;BAC PROFESSIONNEL;BAC PRO SERV;BAC PRO 31206 VENTE (PROSPECT.NEGO.SUIV.CLIENT;2;2;2;0;0;0;0;2;0;1;1;0;0;0
1643.0;2021;24;CRETEIL;FEMININ;APPRENTISSAGE;BAC PROFESSIONNEL;BAC PRO SERV;BAC PRO 33603 ESTHETIQUE COSMETIQUE PARFUMERIE;16;15;8;7;0;0;0;8;0;0;1;3;4;7
1648.0;2021;24;CRETEIL;FEMININ;ENSEIGNEMENT A DISTANCE;BAC PROFESSIONNEL;BAC PRO SERV;BAC PRO 31206 VENTE (PROSPECT.NEGO.SUIV.CLIENT;1;1;1;0;0;0;0;1;0;0;1;0;0;0
1653.0;2021;24;CRETEIL;FEMININ;ENSEIGNEMENT A DISTANCE;BAC TECHNOLOGIQUE;BAC STMG;BAC STMG MERCATIQUE (MARKETING);7;7;7;0;0;0;0;7;0;0;1;3;3;0
1656.0;2021;24;CRETEIL;FEMININ;FORMATION CONTINUE;BAC PROFESSIONNEL;BAC PRO PROD;BAC PRO 25411 TECH.CHAUDRONNERIE INDUSTRIELLE;2;1;1;0;0;0;0;1;0;0;0;1;0;0
1657.0;2021;24;CRETEIL;FEMININ;FORMATION CONTINUE;BAC PROFESSIONNEL;BAC PRO PROD;BAC PRO 25510 METIERS ELECT. ENVIRON. CONNECTES;1;1;1;0;0;0;0;1;0;0;0;0;1;0
1663.0;2021;24;CRETEIL;FEMININ;INDIVIDUEL;BAC GENERAL;BAC GENERAL;BAC GENE 10019 BAC GENERAL;234;167;93;44;30;19;11;112;2;5;25;22;58;55
1667.0;2021;24;CRETEIL;FEMININ;INDIVIDUEL;BAC PROFESSIONNEL;BAC PRO PROD;BAC PRO AG 21004 CGEA;8;6;5;1;0;0;0;5;0;0;0;0;5;1
1669.0;2021;24;CRETEIL;FEMININ;INDIVIDUEL;BAC PROFESSIONNEL;BAC PRO PROD;BAC PRO AG 21203 TECHN CONSEIL DE VENTE ANIMAL;1;1;1;0;0;0;0;1;0;0;0;0;1;0
1679.0;2021;24;CRETEIL;FEMININ;INDIVIDUEL;BAC PROFESSIONNEL;BAC PRO SERV;BAC PRO 33003 ACC.SOINS-S.PERS. OPT.A DOMICILE;6;5;4;1;0;0;0;4;0;0;1;0;3;1
1688.0;2021;24;CRETEIL;FEMININ;INDIVIDUEL;BAC TECHNOLOGIQUE;BAC STL;BAC STL SCIENCES PHYSIQUES CHIMIQUES  EN LABORAT.;1;1;1;0;0;0;0;1;0;0;0;0;1;0
1692.0;2021;24;CRETEIL;FEMININ;INDIVIDUEL;BAC TECHNOLOGIQUE;BAC STMG;BAC STMG SYSTEMES D'INFORMATION DE GESTION;4;2;0;1;1;1;0;1;0;0;0;0;1;1
1695.0;2021;24;CRETEIL;FEMININ;SCOLAIRE;BAC PROFESSIONNEL;BAC PRO PROD;BAC PRO 22004 PROC. CHIMIE EAU PAPIERS-CARTONS;9;9;6;2;1;1;0;7;0;0;0;3;4;2
1697.0;2021;24;CRETEIL;FEMININ;SCOLAIRE;BAC PROFESSIONNEL;BAC PRO PROD;BAC PRO 23003 ARTIS. & M.ART:MARCHANDISAGE VIS.;16;16;16;0;0;0;0;16;0;3;5;5;3;0
1708.0;2021;24;CRETEIL;FEMININ;SCOLAIRE;BAC PROFESSIONNEL;BAC PRO PROD;BAC PRO 25007 MAINTENANCE EQUIPEMENTS INDUST.;3;3;3;0;0;0;0;3;0;0;0;2;1;0
1730.0;2021;24;CRETEIL;FEMININ;SCOLAIRE;BAC PROFESSIONNEL;BAC PRO SERV;BAC PRO 31206 VENTE (PROSPECT.NEGO.SUIV.CLIENT;230;229;205;17;7;1;6;206;0;11;46;75;74;23
1732.0;2021;24;CRETEIL;FEMININ;SCOLAIRE;BAC PROFESSIONNEL;BAC PRO SERV;BAC PRO 32206 FACONNAGE PRODTS IMPRIMES ROUTAGE;4;4;4;0;0;0;0;4;0;2;2;0;0;0
1733.0;2021;24;CRETEIL;FEMININ;SCOLAIRE;BAC PROFESSIONNEL;BAC PRO SERV;BAC PRO 32207 REAL.PR.IMPR.PLURI.OPTA.PR.GRAPH.;13;13;12;1;0;0;0;12;0;1;2;5;4;1
1737.0;2021;24;CRETEIL;FEMININ;SCOLAIRE;BAC PROFESSIONNEL;BAC PRO SERV;BAC PRO 33002 SERVICES DE PROXIMITE  VIE LOCAL;168;168;141;21;6;4;2;145;0;2;32;52;59;23
1742.0;2021;24;CRETEIL;FEMININ;SCOLAIRE;BAC PROFESSIONNEL;BAC PRO SERV;BAC PRO 33603 ESTHETIQUE COSMETIQUE PARFUMERIE;144;144;117;21;6;4;2;121;0;5;25;50;41;23
1748.0;2021;24;CRETEIL;FEMININ;SCOLAIRE;BAC TECHNOLOGIQUE;BAC STAV;BAC STAV AGRONOMIE ALIM ENV TERRITOI;31;31;31;0;0;0;0;31;0;1;5;15;10;0
1762.0;2021;24;CRETEIL;MASCULIN;APPRENTISSAGE;BAC PROFESSIONNEL;BAC PRO PROD;BAC PRO 22106 CUISINE;86;85;61;19;5;3;2;64;0;4;15;19;26;21
1771.0;2021;24;CRETEIL;MASCULIN;APPRENTISSAGE;BAC PROFESSIONNEL;BAC PRO PROD;BAC PRO 25214 MAINT.VEHIC.OPTA VOIT.PARTICUL.;146;135;111;20;4;2;2;113;0;11;18;51;33;22
1774.0;2021;24;CRETEIL;MASCULIN;APPRENTISSAGE;BAC PROFESSIONNEL;BAC PRO PROD;BAC PRO 25219 MAINT.MATERIELS OPT.A AGRICOLES;4;4;3;0;1;0;1;3;0;1;2;0;0;1
1782.0;2021;24;CRETEIL;MASCULIN;APPRENTISSAGE;BAC PROFESSIONNEL;BAC PRO PROD;BAC PRO AG 21004 CGEA;8;7;6;1;0;0;0;6;0;0;0;0;6;1
1785.0;2021;24;CRETEIL;MASCULIN;APPRENTISSAGE;BAC PROFESSIONNEL;BAC PRO SERV;BAC PRO 31106 LOGISTIQUE;36;36;27;6;3;3;0;30;0;1;8;9;12;6
1787.0;2021;24;CRETEIL;MASCULIN;APPRENTISSAGE;BAC PROFESSIONNEL;BAC PRO SERV;BAC PRO 31206 VENTE (PROSPECT.NEGO.SUIV.CLIENT;3;3;3;0;0;0;0;3;0;0;1;0;2;0
1797.0;2021;24;CRETEIL;MASCULIN;ENSEIGNEMENT A DISTANCE;BAC PROFESSIONNEL;BAC PRO SERV;BAC PRO 31206 VENTE (PROSPECT.NEGO.SUIV.CLIENT;1;1;1;0;0;0;0;1;0;0;0;1;0;0
1803.0;2021;24;CRETEIL;MASCULIN;ENSEIGNEMENT A DISTANCE;BAC TECHNOLOGIQUE;BAC STMG;BAC STMG SYSTEMES D'INFORMATION DE GESTION;1;1;1;0;0;0;0;1;0;0;0;0;1;0
1805.0;2021;24;CRETEIL;MASCULIN;FORMATION CONTINUE;BAC PROFESSIONNEL;BAC PRO PROD;BAC PRO 25006 MICROTECHNIQUES;1;0;0;0;0;0;0;0;0;0;0;0;0;0
1806.0;2021;24;CRETEIL;MASCULIN;FORMATION CONTINUE;BAC PROFESSIONNEL;BAC PRO PROD;BAC PRO 25007 MAINTENANCE EQUIPEMENTS INDUST.;2;2;2;0;0;0;0;2;0;1;1;0;0;0
1819.0;2021;24;CRETEIL;MASCULIN;INDIVIDUEL;BAC PROFESSIONNEL;BAC PRO PROD;BAC PRO 23102 TRAVAUX PUBLICS;1;1;1;0;0;0;0;1;0;1;0;0;0;0
1820.0;2021;24;CRETEIL;MASCULIN;INDIVIDUEL;BAC PROFESSIONNEL;BAC PRO PROD;BAC PRO 24203 METIERS DE LA MODE - VÊTEMENT;1;0;0;0;0;0;0;0;0;0;0;0;0;0
1825.0;2021;24;CRETEIL;MASCULIN;INDIVIDUEL;BAC PROFESSIONNEL;BAC PRO PROD;BAC PRO 25304 AERONAUTIQUE OPTION STRUCTURE;1;0;0;0;0;0;0;0;0;0;0;0;0;0
1833.0;2021;24;CRETEIL;MASCULIN;INDIVIDUEL;BAC PROFESSIONNEL;BAC PRO PROD;BAC PRO AG 21114 CONDUITE PRODUCTIONS HORTICOLES;4;3;3;0;0;0;0;3;0;0;0;0;3;0
1845.0;2021;24;CRETEIL;MASCULIN;INDIVIDUEL;BAC PROFESSIONNEL;BAC PRO SERV;BAC PRO 33403 COMMERC. SERVICES EN RESTAURATION;3;1;1;0;0;0;0;1;0;0;1;0;0;0
1848.0;2021;24;CRETEIL;MASCULIN;INDIVIDUEL;BAC TECHNOLOGIQUE;BAC S2TMD;BAC S2TMD DANSE;1;1;1;0;0;0;0;1;0;0;1;0;0;0
1851.0;2021;24;CRETEIL;MASCULIN;INDIVIDUEL;BAC TECHNOLOGIQUE;BAC STI2D;BAC STI2D ENERGIES  ET ENVIRONNEMENT;5;1;1;0;0;0;0;1;0;0;0;0;1;0
1859.0;2021;24;CRETEIL;MASCULIN;SCOLAIRE;BAC PROFESSIONNEL;BAC PRO PROD;BACPRO 20002 ETUD.DEFINITION PRDTS INDUSTRIEL;46;46;34;9;3;3;0;37;0;1;4;18;14;9
1865.0;2021;24;CRETEIL;MASCULIN;SCOLAIRE;BAC PROFESSIONNEL;BAC PRO PROD;BAC PRO 23003 ARTIS. & M.ART:MARCHANDISAGE VIS.;9;9;8;1;0;0;0;8;0;2;3;2;1;1
1867.0;2021;24;CRETEIL;MASCULIN;SCOLAIRE;BAC PROFESSIONNEL;BAC PRO PROD;BAC PRO 23005 TECHN. ETUDES BAT B ASSIST.ARCHI.;29;29;26;3;0;0;0;26;0;0;4;13;9;3
1874.0;2021;24;CRETEIL;MASCULIN;SCOLAIRE;BAC PROFESSIONNEL;BAC PRO PROD;BAC PRO 23405 TECHNICIEN MENUISIER AGENCEUR;76;76;56;13;7;5;2;61;0;0;11;13;37;15
1879.0;2021;24;CRETEIL;MASCULIN;SCOLAIRE;BAC PROFESSIONNEL;BAC PRO PROD;BAC PRO 25006 MICROTECHNIQUES;87;86;70;13;3;2;1;72;0;0;13;32;27;14
1883.0;2021;24;CRETEIL;MASCULIN;SCOLAIRE;BAC PROFESSIONNEL;BAC PRO PROD;BAC PRO 25214 MAINT.VEHIC.OPTA VOIT.PARTICUL.;169;162;123;31;8;6;2;129;0;7;30;41;51;33
1885.0;2021;24;CRETEIL;MASCULIN;SCOLAIRE;BAC PROFESSIONNEL;BAC PRO PROD;BAC PRO 25216 MAINT.VEHIC.OPTC MOTOCYCLES;61;60;44;13;3;2;1;46;0;3;11;18;14;14
1891.0;2021;24;CRETEIL;MASCULIN;SCOLAIRE;BAC PROFESSIONNEL;BAC PRO PROD;BAC PRO 25406 OUVRAGES DU BATIMENT METALLERIE;30;29;24;4;1;1;0;25;0;1;2;8;14;4
1894.0;2021;24;CRETEIL;MASCULIN;SCOLAIRE;BAC PROFESSIONNEL;BAC PRO PROD;BAC PRO 25411 TECH.CHAUDRONNERIE INDUSTRIELLE;78;78;65;11;2;0;2;65;0;6;11;26;22;13
1897.0;2021;24;CRETEIL;MASCULIN;SCOLAIRE;BAC PROFESSIONNEL;BAC PRO PROD;BAC PRO 25513 SYST.NUM.OPT.A SURETE SECURITE;124;124;100;20;4;3;1;103;0;1;20;36;46;21
1903.0;2021;24;CRETEIL;MASCULIN;SCOLAIRE;BAC PROFESSIONNEL;BAC PRO PROD;BAC PRO AG 21406 TEC CONS VTE PROD DES JARDINS;2;2;2;0;0;0;0;2;0;0;1;0;1;0
1905.0;2021;24;CRETEIL;MASCULIN;SCOLAIRE;BAC PROFESSIONNEL;BAC PRO PROD;BAC PRO AG 22107 TEC CONS VTE ALIMENTATION P.ALIM;10;10;8;2;0;0;0;8;0;0;0;1;7;2
1906.0;2021;24;CRETEIL;MASCULIN;SCOLAIRE;BAC PROFESSIONNEL;BAC PRO SERV;BAC PRO 30001 GESTION-ADMINISTRATION;1089;1087;679;304;104;70;34;749;0;17;95;224;413;338
1909.0;2021;24;CRETEIL;MASCULIN;SCOLAIRE;BAC PROFESSIONNEL;BAC PRO SERV;BAC PRO 31108 TRANSPORT;18;18;14;3;1;1;0;15;0;0;2;4;9;3
1938.0;2021;24;CRETEIL;MASCULIN;SCOLAIRE;BAC TECHNOLOGIQUE;BAC STMG;BAC STMG MERCATIQUE (MARKETING);1567;1564;1300;68;196;119;77;1419;0;7;117;521;774;145
1941.0;2021;07;DIJON;FEMININ;APPRENTISSAGE;BAC PROFESSIONNEL;BAC PRO PROD;BAC PRO 22106 CUISINE;1;1;0;0;1;0;1;0;0;0;0;0;0;1
1942.0;2021;07;DIJON;FEMININ;APPRENTISSAGE;BAC PROFESSIONNEL;BAC PRO PROD;BAC PRO 22704 TECHN. MAINT. SYST.ENERG.CLIMATI;1;1;1;0;0;0;0;1;0;1;0;0;0;0
1943.0;2021;07;DIJON;FEMININ;APPRENTISSAGE;BAC PROFESSIONNEL;BAC PRO PROD;BAC PRO 23102 TRAVAUX PUBLICS;1;1;1;0;0;0;0;1;0;1;0;0;0;0
1947.0;2021;07;DIJON;FEMININ;APPRENTISSAGE;BAC PROFESSIONNEL;BAC PRO PROD;BAC PRO 25106 TECHNICIEN D'USINAGE;1;1;1;0;0;0;0;1;0;0;0;0;1;0
1949.0;2021;07;DIJON;FEMININ;APPRENTISSAGE;BAC PROFESSIONNEL;BAC PRO PROD;BAC PRO 25216 MAINT.VEHIC.OPTC MOTOCYCLES;1;1;1;0;0;0;0;1;0;0;0;1;0;0
1959.0;2021;07;DIJON;FEMININ;APPRENTISSAGE;BAC PROFESSIONNEL;BAC PRO PROD;BAC PRO AG 22107 TEC CONS VTE ALIMENTATION P.ALIM;2;2;2;0;0;0;0;2;0;0;1;1;0;0
1962.0;2021;07;DIJON;FEMININ;APPRENTISSAGE;BAC PROFESSIONNEL;BAC PRO SERV;BAC PRO 31202 COMMERCE;45;41;39;0;2;0;2;39;0;3;9;14;13;2
1963.0;2021;07;DIJON;FEMININ;APPRENTISSAGE;BAC PROFESSIONNEL;BAC PRO SERV;BAC PRO 31210 ACCUEIL -RELATION CLIENTS USAGERS;1;1;1;0;0;0;0;1;0;0;0;0;1;0
1965.0;2021;07;DIJON;FEMININ;APPRENTISSAGE;BAC PROFESSIONNEL;BAC PRO SERV;BAC PRO 33403 COMMERC. SERVICES EN RESTAURATION;6;6;5;0;1;0;1;5;0;0;2;2;1;1
1970.0;2021;07;DIJON;FEMININ;ENSEIGNEMENT A DISTANCE;BAC PROFESSIONNEL;BAC PRO SERV;BAC PRO 33004 ACC.SOINS-S.PERS. OPT.EN STRUCTUR;1;0;0;0;0;0;0;0;0;0;0;0;0;0
1976.0;2021;07;DIJON;FEMININ;FORMATION CONTINUE;BAC PROFESSIONNEL;BAC PRO PROD;BAC PRO 24302 METIERS DU CUIR : MAROQUINERIE;2;2;2;0;0;0;0;2;0;1;0;1;0;0
1985.0;2021;07;DIJON;FEMININ;INDIVIDUEL;BAC PROFESSIONNEL;BAC PRO SERV;BAC PRO 30001 GESTION-ADMINISTRATION;3;1;1;0;0;0;0;1;0;0;0;0;1;0
1991.0;2021;07;DIJON;FEMININ;INDIVIDUEL;BAC PROFESSIONNEL;BAC PRO SERV;BAC PRO 33603 ESTHETIQUE COSMETIQUE PARFUMERIE;1;1;1;0;0;0;0;1;0;0;0;0;1;0
1997.0;2021;07;DIJON;FEMININ;SCOLAIRE;BAC GENERAL;BAC GENERAL;BAC GENE 10019 BAC GENERAL;4774;4774;4645;22;107;59;48;4704;76;603;1298;1669;1058;70
1998.0;2021;07;DIJON;FEMININ;SCOLAIRE;BAC PROFESSIONNEL;BAC PRO PROD;BAC PRO 20102 PILOTE DE LIGNE DE PRODUCTION;2;2;2;0;0;0;0;2;0;0;0;2;0;0
2013.0;2021;07;DIJON;FEMININ;SCOLAIRE;BAC PROFESSIONNEL;BAC PRO PROD;BAC PRO 24302 METIERS DU CUIR : MAROQUINERIE;9;9;8;1;0;0;0;8;0;0;2;4;2;1
2025.0;2021;07;DIJON;FEMININ;SCOLAIRE;BAC PROFESSIONNEL;BAC PRO PROD;BAC PRO 25513 SYST.NUM.OPT.A SURETE SECURITE;2;2;2;0;0;0;0;2;0;0;0;1;1;0
2027.0;2021;07;DIJON;FEMININ;SCOLAIRE;BAC PROFESSIONNEL;BAC PRO PROD;BAC PRO 25515 SYST.NUM.OPT.C RES.INF.SYST.COMM.;2;2;2;0;0;0;0;2;0;0;0;1;1;0
2030.0;2021;07;DIJON;FEMININ;SCOLAIRE;BAC PROFESSIONNEL;BAC PRO PROD;BAC PRO AG 21114 CONDUITE PRODUCTIONS HORTICOLES;8;8;8;0;0;0;0;8;0;0;0;5;3;0
2032.0;2021;07;DIJON;FEMININ;SCOLAIRE;BAC PROFESSIONNEL;BAC PRO PROD;BAC PRO AG 21204 PROD-AQUACOLES;1;1;1;0;0;0;0;1;0;0;0;1;0;0
2033.0;2021;07;DIJON;FEMININ;SCOLAIRE;BAC PROFESSIONNEL;BAC PRO PROD;BAC PRO AG 21210 COND GEST ENTR CANIN ET FELIN;17;17;13;4;0;0;0;13;0;1;1;8;3;4
2034.0;2021;07;DIJON;FEMININ;SCOLAIRE;BAC PROFESSIONNEL;BAC PRO PROD;BAC PRO AG 21211 COND GEST ENTR HIPPIQUE;33;32;30;2;0;0;0;30;0;1;4;13;12;2
2040.0;2021;07;DIJON;FEMININ;SCOLAIRE;BAC PROFESSIONNEL;BAC PRO SERV;BAC PRO 31106 LOGISTIQUE;8;8;6;2;0;0;0;6;0;0;1;1;4;2
2048.0;2021;07;DIJON;FEMININ;SCOLAIRE;BAC PROFESSIONNEL;BAC PRO SERV;BAC PRO 33002 SERVICES DE PROXIMITE  VIE LOCAL;44;44;40;4;0;0;0;40;0;1;8;13;18;4
2056.0;2021;07;DIJON;FEMININ;SCOLAIRE;BAC PROFESSIONNEL;BAC PRO SERV;BAC PRO 34304 HYGIENE PROPRETE STERILISATION;13;13;12;1;0;0;0;12;0;0;0;7;5;1
2059.0;2021;07;DIJON;FEMININ;SCOLAIRE;BAC TECHNOLOGIQUE;BAC S2TMD;BAC S2TMD DANSE;6;6;6;0;0;0;0;6;0;1;2;3;0;0
2060.0;2021;07;DIJON;FEMININ;SCOLAIRE;BAC TECHNOLOGIQUE;BAC S2TMD;BAC S2TMD MUSIQUE;1;1;1;0;0;0;0;1;0;0;0;1;0;0
2062.0;2021;07;DIJON;FEMININ;SCOLAIRE;BAC TECHNOLOGIQUE;BAC STAV;BAC STAV AGRONOMIE ALIM ENV TERRITOI;100;100;99;1;0;0;0;99;0;0;16;44;39;1
2069.0;2021;07;DIJON;FEMININ;SCOLAIRE;BAC TECHNOLOGIQUE;BAC STL;BAC STL BIOCHIM.-BIOLOGIE-BIOTECHNOL.;87;87;77;0;10;4;6;81;0;9;24;28;20;6
2076.0;2021;07;DIJON;MASCULIN;APPRENTISSAGE;BAC PROFESSIONNEL;BAC PRO PROD;BAC PRO 22503 PLASTIQUES ET COMPOSITES;1;1;1;0;0;0;0;1;0;0;0;1;0;0
2077.0;2021;07;DIJON;MASCULIN;APPRENTISSAGE;BAC PROFESSIONNEL;BAC PRO PROD;BAC PRO 22704 TECHN. MAINT. SYST.ENERG.CLIMATI;4;4;3;1;0;0;0;3;0;0;1;2;0;1
2079.0;2021;07;DIJON;MASCULIN;APPRENTISSAGE;BAC PROFESSIONNEL;BAC PRO PROD;BAC PRO 23102 TRAVAUX PUBLICS;24;24;23;0;1;0;1;23;0;1;8;11;3;1
2080.0;2021;07;DIJON;MASCULIN;APPRENTISSAGE;BAC PROFESSIONNEL;BAC PRO PROD;BACPRO 23103 TECHNICIEN GEOMETRE-TOPOGRAPHE;1;1;0;1;0;0;0;0;0;0;0;0;0;1
2099.0;2021;07;DIJON;MASCULIN;APPRENTISSAGE;BAC PROFESSIONNEL;BAC PRO PROD;BAC PRO AG 21004 CGEA;61;59;52;7;0;0;0;52;0;0;3;22;27;7
2100.0;2021;07;DIJON;MASCULIN;APPRENTISSAGE;BAC PROFESSIONNEL;BAC PRO PROD;BAC PRO AG 21113 CGEVV;14;14;12;2;0;0;0;12;0;0;1;4;7;2
2102.0;2021;07;DIJON;MASCULIN;APPRENTISSAGE;BAC PROFESSIONNEL;BAC PRO PROD;BAC PRO AG 21210 COND GEST ENTR CANIN ET FELIN;4;4;3;1;0;0;0;3;0;0;0;1;2;1
2104.0;2021;07;DIJON;MASCULIN;APPRENTISSAGE;BAC PROFESSIONNEL;BAC PRO PROD;BAC PRO AG 21405 AMENAGEMENTS PAYSAGERS;61;61;54;7;0;0;0;54;0;0;12;23;19;7
2112.0;2021;07;DIJON;MASCULIN;APPRENTISSAGE;BAC PROFESSIONNEL;BAC PRO SERV;BAC PRO 33403 COMMERC. SERVICES EN RESTAURATION;7;7;5;2;0;0;0;5;0;0;3;2;0;2
2113.0;2021;07;DIJON;MASCULIN;ENSEIGNEMENT A DISTANCE;BAC GENERAL;BAC GENERAL;BAC GENE 10019 BAC GENERAL;9;9;6;2;1;1;0;7;0;1;2;2;2;2
2114.0;2021;07;DIJON;MASCULIN;ENSEIGNEMENT A DISTANCE;BAC TECHNOLOGIQUE;BAC STMG;BAC STMG GESTION ET FINANCE;2;2;2;0;0;0;0;2;0;0;2;0;0;0
2119.0;2021;07;DIJON;MASCULIN;FORMATION CONTINUE;BAC PROFESSIONNEL;BAC PRO PROD;BAC PRO 24302 METIERS DU CUIR : MAROQUINERIE;1;1;1;0;0;0;0;1;0;0;0;1;0;0
2120.0;2021;07;DIJON;MASCULIN;FORMATION CONTINUE;BAC PROFESSIONNEL;BAC PRO PROD;BAC PRO 25214 MAINT.VEHIC.OPTA VOIT.PARTICUL.;1;1;1;0;0;0;0;1;0;1;0;0;0;0
2122.0;2021;07;DIJON;MASCULIN;FORMATION CONTINUE;BAC PROFESSIONNEL;BAC PRO SERV;BAC PRO 31202 COMMERCE;2;2;1;1;0;0;0;1;0;0;0;0;1;1
2126.0;2021;07;DIJON;MASCULIN;INDIVIDUEL;BAC PROFESSIONNEL;BAC PRO PROD;BAC PRO 23004 TECHN. ETUDES BAT.A ETUDES & ECO.;1;0;0;0;0;0;0;0;0;0;0;0;0;0
2134.0;2021;07;DIJON;MASCULIN;INDIVIDUEL;BAC PROFESSIONNEL;BAC PRO SERV;BAC PRO 31206 VENTE (PROSPECT.NEGO.SUIV.CLIENT;1;1;1;0;0;0;0;1;0;0;0;0;1;0
2139.0;2021;07;DIJON;MASCULIN;INDIVIDUEL;BAC TECHNOLOGIQUE;BAC ST2S;BAC ST2S SCIENCES & TECHNO. SANTE & SOCIAL;1;1;0;1;0;0;0;0;0;0;0;0;0;1
2142.0;2021;07;DIJON;MASCULIN;INDIVIDUEL;BAC TECHNOLOGIQUE;BAC STMG;BAC STMG GESTION ET FINANCE;7;7;0;6;1;1;0;1;0;0;0;0;1;6
2153.0;2021;07;DIJON;MASCULIN;SCOLAIRE;BAC PROFESSIONNEL;BAC PRO PROD;BAC PRO 22703 TECHN.INSTALL.SYST.ENERG.CLIMATI;32;31;16;10;5;2;3;18;0;0;2;6;10;13
2159.0;2021;07;DIJON;MASCULIN;SCOLAIRE;BAC PROFESSIONNEL;BAC PRO PROD;BAC PRO 23203 TECHNICIEN BAT. : ORG.REAL.GROS O;7;7;7;0;0;0;0;7;0;0;2;2;3;0
2168.0;2021;07;DIJON;MASCULIN;SCOLAIRE;BAC PROFESSIONNEL;BAC PRO PROD;BAC PRO 24203 METIERS DE LA MODE - VÊTEMENT;4;4;4;0;0;0;0;4;0;1;0;2;1;0
2170.0;2021;07;DIJON;MASCULIN;SCOLAIRE;BAC PROFESSIONNEL;BAC PRO PROD;BAC PRO 25007 MAINTENANCE EQUIPEMENTS INDUST.;187;187;149;23;15;5;10;154;0;5;33;61;55;33
2175.0;2021;07;DIJON;MASCULIN;SCOLAIRE;BAC PROFESSIONNEL;BAC PRO PROD;BAC PRO 25215 MAINT.VEHIC.OPTB VEHIC.TRANS.ROUT;8;8;8;0;0;0;0;8;0;1;1;5;1;0
2176.0;2021;07;DIJON;MASCULIN;SCOLAIRE;BAC PROFESSIONNEL;BAC PRO PROD;BAC PRO 25219 MAINT.MATERIELS OPT.A AGRICOLES;12;12;10;2;0;0;0;10;0;1;2;6;1;2
2180.0;2021;07;DIJON;MASCULIN;SCOLAIRE;BAC PROFESSIONNEL;BAC PRO PROD;BAC PRO 25305 AVIATION GENERALE;7;7;5;2;0;0;0;5;0;2;0;2;1;2
2183.0;2021;07;DIJON;MASCULIN;SCOLAIRE;BAC PROFESSIONNEL;BAC PRO PROD;BAC PRO 25411 TECH.CHAUDRONNERIE INDUSTRIELLE;61;61;50;5;6;3;3;53;0;2;8;18;25;8
2193.0;2021;07;DIJON;MASCULIN;SCOLAIRE;BAC PROFESSIONNEL;BAC PRO PROD;BAC PRO AG 21204 PROD-AQUACOLES;16;16;14;2;0;0;0;14;0;0;3;6;5;2
2202.0;2021;07;DIJON;MASCULIN;SCOLAIRE;BAC PROFESSIONNEL;BAC PRO SERV;BAC PRO 31106 LOGISTIQUE;43;43;32;7;4;3;1;35;0;0;7;10;18;8
2203.0;2021;07;DIJON;MASCULIN;SCOLAIRE;BAC PROFESSIONNEL;BAC PRO SERV;BAC PRO 31107 CONDUCT. TRANSP.ROUT.MARCHANDISES;27;27;25;2;0;0;0;25;0;1;5;12;7;2
2204.0;2021;07;DIJON;MASCULIN;SCOLAIRE;BAC PROFESSIONNEL;BAC PRO SERV;BAC PRO 31108 TRANSPORT;10;9;5;3;1;0;1;5;0;0;0;2;3;4
2209.0;2021;07;DIJON;MASCULIN;SCOLAIRE;BAC PROFESSIONNEL;BAC PRO SERV;BAC PRO 32208 REAL.PR.IMPR.PLURI.OPTB.PR.IMPR.;3;3;3;0;0;0;0;3;0;0;0;3;0;0
2231.0;2021;07;DIJON;MASCULIN;SCOLAIRE;BAC TECHNOLOGIQUE;BAC STL;BAC STL SCIENCES PHYSIQUES CHIMIQUES  EN LABORAT.;39;39;31;1;7;6;1;37;1;0;5;10;21;2
2241.0;2021;08;GRENOBLE;FEMININ;APPRENTISSAGE;BAC PROFESSIONNEL;BAC PRO PROD;BAC PRO 22704 TECHN. MAINT. SYST.ENERG.CLIMATI;1;1;1;0;0;0;0;1;0;0;0;1;0;0
2253.0;2021;08;GRENOBLE;FEMININ;APPRENTISSAGE;BAC PROFESSIONNEL;BAC PRO PROD;BAC PRO 25510 METIERS ELECT. ENVIRON. CONNECTES;7;7;7;0;0;0;0;7;0;6;1;0;0;0
2254.0;2021;08;GRENOBLE;FEMININ;APPRENTISSAGE;BAC PROFESSIONNEL;BAC PRO PROD;BAC PRO AG 21004 CGEA;3;3;3;0;0;0;0;3;0;1;0;1;1;0
2258.0;2021;08;GRENOBLE;FEMININ;APPRENTISSAGE;BAC PROFESSIONNEL;BAC PRO SERV;BAC PRO 30001 GESTION-ADMINISTRATION;32;30;27;3;0;0;0;27;0;2;9;10;6;3
2259.0;2021;08;GRENOBLE;FEMININ;APPRENTISSAGE;BAC PROFESSIONNEL;BAC PRO SERV;BAC PRO 31106 LOGISTIQUE;2;2;2;0;0;0;0;2;0;1;0;1;0;0
2265.0;2021;08;GRENOBLE;FEMININ;ENSEIGNEMENT A DISTANCE;BAC PROFESSIONNEL;BAC PRO SERV;BAC PRO 30001 GESTION-ADMINISTRATION;6;4;3;0;1;1;0;4;0;0;1;0;3;0
2271.0;2021;08;GRENOBLE;FEMININ;ENSEIGNEMENT A DISTANCE;BAC TECHNOLOGIQUE;BAC STMG;BAC STMG MERCATIQUE (MARKETING);8;7;6;0;1;0;1;6;0;0;0;3;3;1
2276.0;2021;08;GRENOBLE;FEMININ;FORMATION CONTINUE;BAC PROFESSIONNEL;BAC PRO SERV;BAC PRO 31210 ACCUEIL -RELATION CLIENTS USAGERS;1;1;1;0;0;0;0;1;0;0;0;1;0;0
2289.0;2021;08;GRENOBLE;FEMININ;INDIVIDUEL;BAC PROFESSIONNEL;BAC PRO SERV;BAC PRO 33002 SERVICES DE PROXIMITE  VIE LOCAL;2;2;1;0;1;1;0;2;0;0;0;0;2;0
2303.0;2021;08;GRENOBLE;FEMININ;SCOLAIRE;BAC PROFESSIONNEL;BAC PRO PROD;BAC PRO 20102 PILOTE DE LIGNE DE PRODUCTION;1;1;1;0;0;0;0;1;0;0;1;0;0;0
2311.0;2021;08;GRENOBLE;FEMININ;SCOLAIRE;BAC PROFESSIONNEL;BAC PRO PROD;BACPRO 23103 TECHNICIEN GEOMETRE-TOPOGRAPHE;1;1;0;1;0;0;0;0;0;0;0;0;0;1
2313.0;2021;08;GRENOBLE;FEMININ;SCOLAIRE;BAC PROFESSIONNEL;BAC PRO PROD;BAC PRO 23304 AMENAGEMENT FINITION BATIMENT;6;6;5;0;1;0;1;5;0;0;2;0;3;1
2315.0;2021;08;GRENOBLE;FEMININ;SCOLAIRE;BAC PROFESSIONNEL;BAC PRO PROD;BAC PRO 23405 TECHNICIEN MENUISIER AGENCEUR;5;5;4;0;1;0;1;4;0;0;2;2;0;1
2320.0;2021;08;GRENOBLE;FEMININ;SCOLAIRE;BAC PROFESSIONNEL;BAC PRO PROD;BAC PRO 24302 METIERS DU CUIR : MAROQUINERIE;8;7;6;1;0;0;0;6;0;0;0;3;3;1
2322.0;2021;08;GRENOBLE;FEMININ;SCOLAIRE;BAC PROFESSIONNEL;BAC PRO PROD;BAC PRO 25007 MAINTENANCE EQUIPEMENTS INDUST.;3;3;1;2;0;0;0;1;0;0;0;0;1;2
2325.0;2021;08;GRENOBLE;FEMININ;SCOLAIRE;BAC PROFESSIONNEL;BAC PRO PROD;BAC PRO 25214 MAINT.VEHIC.OPTA VOIT.PARTICUL.;5;4;4;0;0;0;0;4;0;0;1;2;1;0
2327.0;2021;08;GRENOBLE;FEMININ;SCOLAIRE;BAC PROFESSIONNEL;BAC PRO PROD;BAC PRO 25406 OUVRAGES DU BATIMENT METALLERIE;1;1;0;0;1;0;1;0;0;0;0;0;0;1
2331.0;2021;08;GRENOBLE;FEMININ;SCOLAIRE;BAC PROFESSIONNEL;BAC PRO PROD;BAC PRO 25513 SYST.NUM.OPT.A SURETE SECURITE;1;1;1;0;0;0;0;1;0;0;0;0;1;0
2333.0;2021;08;GRENOBLE;FEMININ;SCOLAIRE;BAC PROFESSIONNEL;BAC PRO PROD;BAC PRO AG 21001 AGRO-EQUIPEMENT;1;1;1;0;0;0;0;1;0;0;0;1;0;0
2349.0;2021;08;GRENOBLE;FEMININ;SCOLAIRE;BAC PROFESSIONNEL;BAC PRO SERV;BAC PRO 31202 COMMERCE;441;440;407;13;20;10;10;417;0;28;108;160;121;23
2357.0;2021;08;GRENOBLE;FEMININ;SCOLAIRE;BAC PROFESSIONNEL;BAC PRO SERV;BAC PRO 33101 OPTIQUE LUNETTERIE;14;14;13;1;0;0;0;13;0;3;4;4;2;1
2368.0;2021;08;GRENOBLE;FEMININ;SCOLAIRE;BAC TECHNOLOGIQUE;BAC STHR;BAC STHR SC.&TEC. HOTELLERIE-RESTAURATION;70;70;67;2;1;1;0;68;0;5;9;33;21;2
2369.0;2021;08;GRENOBLE;FEMININ;SCOLAIRE;BAC TECHNOLOGIQUE;BAC STI2D;BAC STI2D ARCHITECTURE ET CONSTRUCTION;51;51;48;0;3;1;2;49;1;4;11;14;19;2
2374.0;2021;08;GRENOBLE;FEMININ;SCOLAIRE;BAC TECHNOLOGIQUE;BAC STL;BAC STL SCIENCES PHYSIQUES CHIMIQUES  EN LABORAT.;53;53;50;1;2;1;1;51;0;2;12;22;15;2
2375.0;2021;08;GRENOBLE;FEMININ;SCOLAIRE;BAC TECHNOLOGIQUE;BAC STMG;BAC STMG GESTION ET FINANCE;309;309;296;1;12;7;5;303;1;18;71;123;90;6
2379.0;2021;08;GRENOBLE;MASCULIN;APPRENTISSAGE;BAC PROFESSIONNEL;BAC PRO PROD;BACPRO 20002 ETUD.DEFINITION PRDTS INDUSTRIEL;5;5;5;0;0;0;0;5;0;1;0;2;2;0
2394.0;2021;08;GRENOBLE;MASCULIN;APPRENTISSAGE;BAC PROFESSIONNEL;BAC PRO PROD;BAC PRO 23304 AMENAGEMENT FINITION BATIMENT;18;17;13;1;3;2;1;15;0;1;1;7;6;2
2396.0;2021;08;GRENOBLE;MASCULIN;APPRENTISSAGE;BAC PROFESSIONNEL;BAC PRO PROD;BAC PRO 23405 TECHNICIEN MENUISIER AGENCEUR;11;11;11;0;0;0;0;11;0;0;2;6;3;0
2397.0;2021;08;GRENOBLE;MASCULIN;APPRENTISSAGE;BAC PROFESSIONNEL;BAC PRO PROD;BAC PRO 25006 MICROTECHNIQUES;1;1;1;0;0;0;0;1;0;0;1;0;0;0
2399.0;2021;08;GRENOBLE;MASCULIN;APPRENTISSAGE;BAC PROFESSIONNEL;BAC PRO PROD;BAC PRO 25106 TECHNICIEN D'USINAGE;50;50;43;3;4;1;3;44;0;5;8;17;14;6
2416.0;2021;08;GRENOBLE;MASCULIN;APPRENTISSAGE;BAC PROFESSIONNEL;BAC PRO PROD;BAC PRO AG 21303 FORET;13;13;10;3;0;0;0;10;0;1;1;3;5;3
2421.0;2021;08;GRENOBLE;MASCULIN;APPRENTISSAGE;BAC PROFESSIONNEL;BAC PRO SERV;BAC PRO 31107 CONDUCT. TRANSP.ROUT.MARCHANDISES;9;9;9;0;0;0;0;9;0;1;3;3;2;0
2424.0;2021;08;GRENOBLE;MASCULIN;APPRENTISSAGE;BAC PROFESSIONNEL;BAC PRO SERV;BAC PRO 31206 VENTE (PROSPECT.NEGO.SUIV.CLIENT;3;3;3;0;0;0;0;3;0;0;2;0;1;0
2425.0;2021;08;GRENOBLE;MASCULIN;APPRENTISSAGE;BAC PROFESSIONNEL;BAC PRO SERV;BAC PRO 31210 ACCUEIL -RELATION CLIENTS USAGERS;8;8;8;0;0;0;0;8;0;0;0;5;3;0
2436.0;2021;08;GRENOBLE;MASCULIN;ENSEIGNEMENT A DISTANCE;BAC TECHNOLOGIQUE;BAC STMG;BAC STMG SYSTEMES D'INFORMATION DE GESTION;2;2;2;0;0;0;0;2;0;1;0;0;1;0
2445.0;2021;08;GRENOBLE;MASCULIN;INDIVIDUEL;BAC PROFESSIONNEL;BAC PRO PROD;BAC PRO 22703 TECHN.INSTALL.SYST.ENERG.CLIMATI;2;1;0;1;0;0;0;0;0;0;0;0;0;1
2461.0;2021;08;GRENOBLE;MASCULIN;INDIVIDUEL;BAC PROFESSIONNEL;BAC PRO PROD;BAC PRO AG 21302 GEST MILIEUX NATURELS FAUNE;2;2;1;1;0;0;0;1;0;0;0;0;1;1
2462.0;2021;08;GRENOBLE;MASCULIN;INDIVIDUEL;BAC PROFESSIONNEL;BAC PRO PROD;BAC PRO AG 21405 AMENAGEMENTS PAYSAGERS;3;1;1;0;0;0;0;1;0;0;0;0;1;0
2465.0;2021;08;GRENOBLE;MASCULIN;INDIVIDUEL;BAC PROFESSIONNEL;BAC PRO SERV;BAC PRO 31202 COMMERCE;5;2;2;0;0;0;0;2;0;0;0;1;1;0
2467.0;2021;08;GRENOBLE;MASCULIN;INDIVIDUEL;BAC PROFESSIONNEL;BAC PRO SERV;BAC PRO 33403 COMMERC. SERVICES EN RESTAURATION;1;1;0;0;1;0;1;0;0;0;0;0;0;1
2468.0;2021;08;GRENOBLE;MASCULIN;INDIVIDUEL;BAC PROFESSIONNEL;BAC PRO SERV;BAC PRO 34403 METIERS DE LA SECURITE;2;2;2;0;0;0;0;2;0;0;0;1;1;0
2476.0;2021;08;GRENOBLE;MASCULIN;INDIVIDUEL;BAC TECHNOLOGIQUE;BAC STI2D;BAC STI2D SYSTÈME D'INFORMATION  ET NUMERIQUE;3;3;1;0;2;2;0;3;0;0;0;0;3;0
2481.0;2021;08;GRENOBLE;MASCULIN;INDIVIDUEL;BAC TECHNOLOGIQUE;BAC STMG;BAC STMG SYSTEMES D'INFORMATION DE GESTION;3;2;1;1;0;0;0;1;0;0;0;1;0;1
2483.0;2021;08;GRENOBLE;MASCULIN;SCOLAIRE;BAC PROFESSIONNEL;BAC PRO PROD;BACPRO 20002 ETUD.DEFINITION PRDTS INDUSTRIEL;56;56;42;13;1;0;1;42;0;2;12;10;18;14
2484.0;2021;08;GRENOBLE;MASCULIN;SCOLAIRE;BAC PROFESSIONNEL;BAC PRO PROD;BAC PRO 20102 PILOTE DE LIGNE DE PRODUCTION;26;26;19;7;0;0;0;19;0;1;5;8;5;7
2485.0;2021;08;GRENOBLE;MASCULIN;SCOLAIRE;BAC PROFESSIONNEL;BAC PRO PROD;BAC PRO 22003 BIO-INDUSTRIES DE TRANSFORMATION;6;6;6;0;0;0;0;6;0;0;2;2;2;0
2497.0;2021;08;GRENOBLE;MASCULIN;SCOLAIRE;BAC PROFESSIONNEL;BAC PRO PROD;BAC PRO 23203 TECHNICIEN BAT. : ORG.REAL.GROS O;51;51;45;3;3;3;0;48;0;2;13;12;21;3
2498.0;2021;08;GRENOBLE;MASCULIN;SCOLAIRE;BAC PROFESSIONNEL;BAC PRO PROD;BAC PRO 23205 INTERV. SUR PATRIMOINE BATI OPT.A;3;3;3;0;0;0;0;3;0;0;0;0;3;0
2508.0;2021;08;GRENOBLE;MASCULIN;SCOLAIRE;BAC PROFESSIONNEL;BAC PRO PROD;BAC PRO 25005 PRODUCTIQ.MECA. OPT.DECOLLETAGE;10;10;5;5;0;0;0;5;0;0;1;2;2;5
2518.0;2021;08;GRENOBLE;MASCULIN;SCOLAIRE;BAC PROFESSIONNEL;BAC PRO PROD;BAC PRO 25406 OUVRAGES DU BATIMENT METALLERIE;29;29;23;3;3;1;2;24;0;1;0;14;9;5
2526.0;2021;08;GRENOBLE;MASCULIN;SCOLAIRE;BAC PROFESSIONNEL;BAC PRO PROD;BAC PRO AG 21001 AGRO-EQUIPEMENT;45;45;44;1;0;0;0;44;0;0;3;16;25;1
2534.0;2021;08;GRENOBLE;MASCULIN;SCOLAIRE;BAC PROFESSIONNEL;BAC PRO PROD;BAC PRO AG 21303 FORET;37;37;34;3;0;0;0;34;0;0;5;12;17;3
2543.0;2021;08;GRENOBLE;MASCULIN;SCOLAIRE;BAC PROFESSIONNEL;BAC PRO SERV;BAC PRO 31109 TRANSPORT FLUVIAL;7;7;7;0;0;0;0;7;0;0;2;3;2;0
2547.0;2021;08;GRENOBLE;MASCULIN;SCOLAIRE;BAC PROFESSIONNEL;BAC PRO SERV;BAC PRO 32207 REAL.PR.IMPR.PLURI.OPTA.PR.GRAPH.;5;5;5;0;0;0;0;5;0;0;2;2;1;0
2549.0;2021;08;GRENOBLE;MASCULIN;SCOLAIRE;BAC PROFESSIONNEL;BAC PRO SERV;BAC PRO 32303 ART.& MET.ART:COM.VIS.VIS.PLURI-M;31;31;28;3;0;0;0;28;0;0;11;13;4;3
2551.0;2021;08;GRENOBLE;MASCULIN;SCOLAIRE;BAC PROFESSIONNEL;BAC PRO SERV;BAC PRO 33003 ACC.SOINS-S.PERS. OPT.A DOMICILE;11;11;10;1;0;0;0;10;0;1;4;2;3;1
2554.0;2021;08;GRENOBLE;MASCULIN;SCOLAIRE;BAC PROFESSIONNEL;BAC PRO SERV;BAC PRO 33403 COMMERC. SERVICES EN RESTAURATION;88;88;77;9;2;2;0;79;0;1;12;49;17;9
2555.0;2021;08;GRENOBLE;MASCULIN;SCOLAIRE;BAC PROFESSIONNEL;BAC PRO SERV;BAC PRO 34304 HYGIENE PROPRETE STERILISATION;4;3;1;1;1;1;0;2;0;0;0;0;2;1
2564.0;2021;08;GRENOBLE;MASCULIN;SCOLAIRE;BAC TECHNOLOGIQUE;BAC STI2D;BAC STI2D ARCHITECTURE ET CONSTRUCTION;288;287;264;2;21;11;10;275;0;12;41;120;102;12
2571.0;2021;08;GRENOBLE;MASCULIN;SCOLAIRE;BAC TECHNOLOGIQUE;BAC STMG;BAC STMG MERCATIQUE (MARKETING);1082;1082;891;50;141;92;49;983;0;11;89;340;543;99
2572.0;2021;08;GRENOBLE;MASCULIN;SCOLAIRE;BAC TECHNOLOGIQUE;BAC STMG;BAC STMG RESSOURCES HUMAINES ET COMMUNICATION;302;302;260;9;33;22;11;282;0;0;17;105;160;20
2576.0;2021;32;GUADELOUPE;FEMININ;APPRENTISSAGE;BAC PROFESSIONNEL;BAC PRO SERV;BAC PRO 30001 GESTION-ADMINISTRATION;2;2;2;0;0;0;0;2;0;0;1;1;0;0
2579.0;2021;32;GUADELOUPE;FEMININ;ENSEIGNEMENT A DISTANCE;BAC PROFESSIONNEL;BAC PRO SERV;BAC PRO 30001 GESTION-ADMINISTRATION;2;0;0;0;0;0;0;0;0;0;0;0;0;0
2580.0;2021;32;GUADELOUPE;FEMININ;ENSEIGNEMENT A DISTANCE;BAC PROFESSIONNEL;BAC PRO SERV;BAC PRO 33004 ACC.SOINS-S.PERS. OPT.EN STRUCTUR;2;1;0;1;0;0;0;0;0;0;0;0;0;1
2584.0;2021;32;GUADELOUPE;FEMININ;FORMATION CONTINUE;BAC PROFESSIONNEL;BAC PRO SERV;BAC PRO 31210 ACCUEIL -RELATION CLIENTS USAGERS;2;2;2;0;0;0;0;2;0;0;1;0;1;0
2597.0;2021;32;GUADELOUPE;FEMININ;INDIVIDUEL;BAC TECHNOLOGIQUE;BAC STMG;BAC STMG MERCATIQUE (MARKETING);3;3;3;0;0;0;0;3;0;0;1;2;0;0
2600.0;2021;32;GUADELOUPE;FEMININ;SCOLAIRE;BAC PROFESSIONNEL;BAC PRO PROD;BAC PRO 22104 BOUCHER CHARCUTIER TRAITEUR;2;2;2;0;0;0;0;2;0;0;0;1;1;0
2601.0;2021;32;GUADELOUPE;FEMININ;SCOLAIRE;BAC PROFESSIONNEL;BAC PRO PROD;BAC PRO 22105 BOULANGER-PÂTISSIER;7;7;7;0;0;0;0;7;0;0;5;0;2;0
2603.0;2021;32;GUADELOUPE;FEMININ;SCOLAIRE;BAC PROFESSIONNEL;BAC PRO PROD;BAC PRO 23003 ARTIS. & M.ART:MARCHANDISAGE VIS.;15;15;12;2;1;1;0;13;0;0;1;6;6;2
2607.0;2021;32;GUADELOUPE;FEMININ;SCOLAIRE;BAC PROFESSIONNEL;BAC PRO PROD;BAC PRO 23304 AMENAGEMENT FINITION BATIMENT;3;3;3;0;0;0;0;3;0;0;0;1;2;0
2610.0;2021;32;GUADELOUPE;FEMININ;SCOLAIRE;BAC PROFESSIONNEL;BAC PRO PROD;BAC PRO 23407 TECHNIC.FAB.BOIS ET MATERX ASSOC;1;1;1;0;0;0;0;1;0;0;0;0;1;0
2611.0;2021;32;GUADELOUPE;FEMININ;SCOLAIRE;BAC PROFESSIONNEL;BAC PRO PROD;BAC PRO 24203 METIERS DE LA MODE - VÊTEMENT;24;24;21;0;3;3;0;24;0;4;4;7;9;0
2620.0;2021;32;GUADELOUPE;FEMININ;SCOLAIRE;BAC PROFESSIONNEL;BAC PRO PROD;BAC PRO AG 21114 CONDUITE PRODUCTIONS HORTICOLES;3;3;3;0;0;0;0;3;0;0;1;1;1;0
2623.0;2021;32;GUADELOUPE;FEMININ;SCOLAIRE;BAC PROFESSIONNEL;BAC PRO SERV;BAC PRO 30001 GESTION-ADMINISTRATION;159;158;126;17;15;13;2;139;0;5;22;51;61;19
2624.0;2021;32;GUADELOUPE;FEMININ;SCOLAIRE;BAC PROFESSIONNEL;BAC PRO SERV;BAC PRO 31106 LOGISTIQUE;2;2;1;0;1;1;0;2;0;0;0;0;2;0
2629.0;2021;32;GUADELOUPE;FEMININ;SCOLAIRE;BAC PROFESSIONNEL;BAC PRO SERV;BAC PRO 33002 SERVICES DE PROXIMITE  VIE LOCAL;41;41;26;8;7;6;1;32;0;0;1;16;15;9
2632.0;2021;32;GUADELOUPE;FEMININ;SCOLAIRE;BAC PROFESSIONNEL;BAC PRO SERV;BAC PRO 33403 COMMERC. SERVICES EN RESTAURATION;18;18;14;2;2;2;0;16;0;0;3;9;4;2
2640.0;2021;32;GUADELOUPE;FEMININ;SCOLAIRE;BAC TECHNOLOGIQUE;BAC ST2S;BAC ST2S SCIENCES & TECHNO. SANTE & SOCIAL;229;229;221;0;8;7;1;228;0;2;34;97;95;1
2643.0;2021;32;GUADELOUPE;FEMININ;SCOLAIRE;BAC TECHNOLOGIQUE;BAC STHR;BAC STHR SC.&TEC. HOTELLERIE-RESTAURATION;14;14;14;0;0;0;0;14;0;1;3;7;3;0
2657.0;2021;32;GUADELOUPE;MASCULIN;APPRENTISSAGE;BAC PROFESSIONNEL;BAC PRO PROD;BAC PRO AG 21405 AMENAGEMENTS PAYSAGERS;5;2;2;0;0;0;0;2;0;0;0;1;1;0
2663.0;2021;32;GUADELOUPE;MASCULIN;FORMATION CONTINUE;BAC PROFESSIONNEL;BAC PRO PROD;BAC PRO 25510 METIERS ELECT. ENVIRON. CONNECTES;6;6;6;0;0;0;0;6;0;1;1;0;4;0
2664.0;2021;32;GUADELOUPE;MASCULIN;FORMATION CONTINUE;BAC PROFESSIONNEL;BAC PRO SERV;BAC PRO 31202 COMMERCE;9;8;7;1;0;0;0;7;0;0;0;2;5;1
2668.0;2021;32;GUADELOUPE;MASCULIN;INDIVIDUEL;BAC PROFESSIONNEL;BAC PRO PROD;BAC PRO 25007 MAINTENANCE EQUIPEMENTS INDUST.;2;0;0;0;0;0;0;0;0;0;0;0;0;0
2672.0;2021;32;GUADELOUPE;MASCULIN;INDIVIDUEL;BAC PROFESSIONNEL;BAC PRO SERV;BAC PRO 30001 GESTION-ADMINISTRATION;3;1;0;1;0;0;0;0;0;0;0;0;0;1
2673.0;2021;32;GUADELOUPE;MASCULIN;INDIVIDUEL;BAC PROFESSIONNEL;BAC PRO SERV;BAC PRO 31202 COMMERCE;1;1;1;0;0;0;0;1;0;0;0;0;1;0
2674.0;2021;32;GUADELOUPE;MASCULIN;INDIVIDUEL;BAC PROFESSIONNEL;BAC PRO SERV;BAC PRO 33002 SERVICES DE PROXIMITE  VIE LOCAL;1;1;1;0;0;0;0;1;0;0;0;1;0;0
2678.0;2021;32;GUADELOUPE;MASCULIN;INDIVIDUEL;BAC TECHNOLOGIQUE;BAC STI2D;BAC STI2D SYSTÈME D'INFORMATION  ET NUMERIQUE;2;1;0;1;0;0;0;0;0;0;0;0;0;1
2681.0;2021;32;GUADELOUPE;MASCULIN;INDIVIDUEL;BAC TECHNOLOGIQUE;BAC STMG;BAC STMG RESSOURCES HUMAINES ET COMMUNICATION;2;1;0;0;1;1;0;1;0;0;0;0;1;0
2682.0;2021;32;GUADELOUPE;MASCULIN;SCOLAIRE;BAC GENERAL;BAC GENERAL;BAC GENE 10019 BAC GENERAL;1057;1057;979;11;67;58;9;1037;6;72;208;331;420;20
2685.0;2021;32;GUADELOUPE;MASCULIN;SCOLAIRE;BAC PROFESSIONNEL;BAC PRO PROD;BAC PRO 22106 CUISINE;23;23;20;0;3;2;1;22;0;0;3;11;8;1
2697.0;2021;32;GUADELOUPE;MASCULIN;SCOLAIRE;BAC PROFESSIONNEL;BAC PRO PROD;BAC PRO 25007 MAINTENANCE EQUIPEMENTS INDUST.;45;45;33;8;4;4;0;37;0;0;4;9;24;8
2700.0;2021;32;GUADELOUPE;MASCULIN;SCOLAIRE;BAC PROFESSIONNEL;BAC PRO PROD;BAC PRO 25215 MAINT.VEHIC.OPTB VEHIC.TRANS.ROUT;9;9;7;1;1;0;1;7;0;0;1;1;5;2
2701.0;2021;32;GUADELOUPE;MASCULIN;SCOLAIRE;BAC PROFESSIONNEL;BAC PRO PROD;BAC PRO 25216 MAINT.VEHIC.OPTC MOTOCYCLES;7;7;5;1;1;1;0;6;0;1;0;2;3;1
2711.0;2021;32;GUADELOUPE;MASCULIN;SCOLAIRE;BAC PROFESSIONNEL;BAC PRO PROD;BAC PRO 25514 SYST.NUM.OPT.B AUD.RES.EQUIP.DOM.;20;20;16;3;1;0;1;16;0;0;2;7;7;4
2715.0;2021;32;GUADELOUPE;MASCULIN;SCOLAIRE;BAC PROFESSIONNEL;BAC PRO PROD;BAC PRO AG 21405 AMENAGEMENTS PAYSAGERS;18;18;17;1;0;0;0;17;0;1;3;4;9;1
2720.0;2021;32;GUADELOUPE;MASCULIN;SCOLAIRE;BAC PROFESSIONNEL;BAC PRO SERV;BAC PRO 31206 VENTE (PROSPECT.NEGO.SUIV.CLIENT;60;60;48;4;8;8;0;56;0;1;6;16;33;4
2722.0;2021;32;GUADELOUPE;MASCULIN;SCOLAIRE;BAC PROFESSIONNEL;BAC PRO SERV;BAC PRO 32303 ART.& MET.ART:COM.VIS.VIS.PLURI-M;10;10;8;1;1;1;0;9;0;0;1;4;4;1
2725.0;2021;32;GUADELOUPE;MASCULIN;SCOLAIRE;BAC PROFESSIONNEL;BAC PRO SERV;BAC PRO 33004 ACC.SOINS-S.PERS. OPT.EN STRUCTUR;4;4;3;1;0;0;0;3;0;0;1;0;2;1
2727.0;2021;32;GUADELOUPE;MASCULIN;SCOLAIRE;BAC PROFESSIONNEL;BAC PRO SERV;BAC PRO 33602 PERRUQUIER POSTICHEUR;1;1;1;0;0;0;0;1;0;0;0;0;1;0
2729.0;2021;32;GUADELOUPE;MASCULIN;SCOLAIRE;BAC PROFESSIONNEL;BAC PRO SERV;BAC PRO 34403 METIERS DE LA SECURITE;11;11;7;2;2;2;0;9;0;0;2;1;6;2
2748.0;2021;33;GUYANE;FEMININ;ENSEIGNEMENT A DISTANCE;BAC GENERAL;BAC GENERAL;BAC GENE 10019 BAC GENERAL;6;6;5;1;0;0;0;5;0;0;2;1;2;1
2753.0;2021;33;GUYANE;FEMININ;INDIVIDUEL;BAC PROFESSIONNEL;BAC PRO PROD;BAC PRO AG 21004 CGEA;1;0;0;0;0;0;0;0;0;0;0;0;0;0
2758.0;2021;33;GUYANE;FEMININ;INDIVIDUEL;BAC PROFESSIONNEL;BAC PRO SERV;BAC PRO 33003 ACC.SOINS-S.PERS. OPT.A DOMICILE;1;0;0;0;0;0;0;0;0;0;0;0;0;0
2765.0;2021;33;GUYANE;FEMININ;SCOLAIRE;BAC PROFESSIONNEL;BAC PRO PROD;BAC PRO 22104 BOUCHER CHARCUTIER TRAITEUR;3;3;2;1;0;0;0;2;0;0;1;0;1;1
2770.0;2021;33;GUYANE;FEMININ;SCOLAIRE;BAC PROFESSIONNEL;BAC PRO PROD;BACPRO 23103 TECHNICIEN GEOMETRE-TOPOGRAPHE;2;2;2;0;0;0;0;2;0;0;0;1;1;0
2775.0;2021;33;GUYANE;FEMININ;SCOLAIRE;BAC PROFESSIONNEL;BAC PRO PROD;BAC PRO 23404 TECHNICIEN CONSTRUCTEUR BOIS;4;4;0;3;1;1;0;1;0;0;0;0;1;3
2778.0;2021;33;GUYANE;FEMININ;SCOLAIRE;BAC PROFESSIONNEL;BAC PRO PROD;BAC PRO 25214 MAINT.VEHIC.OPTA VOIT.PARTICUL.;4;4;2;2;0;0;0;2;0;0;1;0;1;2
2779.0;2021;33;GUYANE;FEMININ;SCOLAIRE;BAC PROFESSIONNEL;BAC PRO PROD;BAC PRO 25215 MAINT.VEHIC.OPTB VEHIC.TRANS.ROUT;1;1;0;1;0;0;0;0;0;0;0;0;0;1
2790.0;2021;33;GUYANE;FEMININ;SCOLAIRE;BAC PROFESSIONNEL;BAC PRO SERV;BAC PRO 31210 ACCUEIL -RELATION CLIENTS USAGERS;104;103;84;13;6;4;2;88;0;2;10;29;47;15
2797.0;2021;33;GUYANE;FEMININ;SCOLAIRE;BAC PROFESSIONNEL;BAC PRO SERV;BAC PRO 34304 HYGIENE PROPRETE STERILISATION;16;16;10;3;3;2;1;12;0;0;0;4;8;4
2798.0;2021;33;GUYANE;FEMININ;SCOLAIRE;BAC PROFESSIONNEL;BAC PRO SERV;BAC PRO AG 33002 SERV PERS TERRIT;11;8;8;0;0;0;0;8;0;0;0;6;2;0
2804.0;2021;33;GUYANE;FEMININ;SCOLAIRE;BAC TECHNOLOGIQUE;BAC STI2D;BAC STI2D INNOVATION TECHNO.  ET ECO CONCEPTION;8;8;6;1;1;1;0;7;0;0;0;2;5;1
2812.0;2021;33;GUYANE;MASCULIN;APPRENTISSAGE;BAC PROFESSIONNEL;BAC PRO PROD;BAC PRO AG 21406 TEC CONS VTE PROD DES JARDINS;1;0;0;0;0;0;0;0;0;0;0;0;0;0
2826.0;2021;33;GUYANE;MASCULIN;INDIVIDUEL;BAC PROFESSIONNEL;BAC PRO SERV;BAC PRO 31202 COMMERCE;7;7;2;1;4;3;1;5;0;0;0;0;5;2
2830.0;2021;33;GUYANE;MASCULIN;SCOLAIRE;BAC GENERAL;BAC GENERAL;BAC GENE 10019 BAC GENERAL;638;638;508;29;101;72;29;580;1;39;95;170;275;58
2831.0;2021;33;GUYANE;MASCULIN;SCOLAIRE;BAC PROFESSIONNEL;BAC PRO PROD;BAC PRO 22004 PROC. CHIMIE EAU PAPIERS-CARTONS;9;9;6;3;0;0;0;6;0;0;2;3;1;3
2839.0;2021;33;GUYANE;MASCULIN;SCOLAIRE;BAC PROFESSIONNEL;BAC PRO PROD;BAC PRO 23205 INTERV. SUR PATRIMOINE BATI OPT.A;9;9;4;3;2;2;0;6;0;0;0;0;6;3
2843.0;2021;33;GUYANE;MASCULIN;SCOLAIRE;BAC PROFESSIONNEL;BAC PRO PROD;BAC PRO 23405 TECHNICIEN MENUISIER AGENCEUR;38;38;28;5;5;2;3;30;0;0;1;7;22;8
2853.0;2021;33;GUYANE;MASCULIN;SCOLAIRE;BAC PROFESSIONNEL;BAC PRO PROD;BAC PRO AG 21004 CGEA;26;26;20;6;0;0;0;20;0;0;2;7;11;6
2862.0;2021;33;GUYANE;MASCULIN;SCOLAIRE;BAC PROFESSIONNEL;BAC PRO SERV;BAC PRO 32303 ART.& MET.ART:COM.VIS.VIS.PLURI-M;7;7;2;5;0;0;0;2;0;0;0;1;1;5
2864.0;2021;33;GUYANE;MASCULIN;SCOLAIRE;BAC PROFESSIONNEL;BAC PRO SERV;BAC PRO 33003 ACC.SOINS-S.PERS. OPT.A DOMICILE;3;3;3;0;0;0;0;3;0;0;0;1;2;0
2866.0;2021;33;GUYANE;MASCULIN;SCOLAIRE;BAC PROFESSIONNEL;BAC PRO SERV;BAC PRO 33403 COMMERC. SERVICES EN RESTAURATION;6;6;6;0;0;0;0;6;0;0;1;2;3;0
2868.0;2021;33;GUYANE;MASCULIN;SCOLAIRE;BAC PROFESSIONNEL;BAC PRO SERV;BAC PRO 34304 HYGIENE PROPRETE STERILISATION;11;11;7;2;2;2;0;9;0;0;0;1;8;2
2870.0;2021;33;GUYANE;MASCULIN;SCOLAIRE;BAC TECHNOLOGIQUE;BAC ST2S;BAC ST2S SCIENCES & TECHNO. SANTE & SOCIAL;19;19;10;2;7;2;5;12;0;0;0;1;11;7
2874.0;2021;33;GUYANE;MASCULIN;SCOLAIRE;BAC TECHNOLOGIQUE;BAC STI2D;BAC STI2D ENERGIES  ET ENVIRONNEMENT;26;26;19;2;5;5;0;24;0;1;0;8;15;2
2879.0;2021;33;GUYANE;MASCULIN;SCOLAIRE;BAC TECHNOLOGIQUE;BAC STMG;BAC STMG GESTION ET FINANCE;31;31;28;2;1;1;0;29;0;0;4;10;15;2
2886.0;2021;28;LA REUNION;FEMININ;ENSEIGNEMENT A DISTANCE;BAC TECHNOLOGIQUE;BAC ST2S;BAC ST2S SCIENCES & TECHNO. SANTE & SOCIAL;1;1;1;0;0;0;0;1;0;0;0;1;0;0
2890.0;2021;28;LA REUNION;FEMININ;INDIVIDUEL;BAC GENERAL;BAC GENERAL;BAC GENE 10019 BAC GENERAL;15;10;6;4;0;0;0;6;0;0;1;4;1;4
2892.0;2021;28;LA REUNION;FEMININ;INDIVIDUEL;BAC PROFESSIONNEL;BAC PRO PROD;BAC PRO AG 21004 CGEA;3;3;2;1;0;0;0;2;0;0;0;0;2;1
2895.0;2021;28;LA REUNION;FEMININ;INDIVIDUEL;BAC PROFESSIONNEL;BAC PRO SERV;BAC PRO AG 33002 SERV PERS TERRIT;1;0;0;0;0;0;0;0;0;0;0;0;0;0
2902.0;2021;28;LA REUNION;FEMININ;SCOLAIRE;BAC PROFESSIONNEL;BAC PRO PROD;BACPRO 20002 ETUD.DEFINITION PRDTS INDUSTRIEL;1;1;1;0;0;0;0;1;0;0;1;0;0;0
2903.0;2021;28;LA REUNION;FEMININ;SCOLAIRE;BAC PROFESSIONNEL;BAC PRO PROD;BAC PRO 22003 BIO-INDUSTRIES DE TRANSFORMATION;19;19;14;2;3;3;0;17;0;0;1;4;12;2
2906.0;2021;28;LA REUNION;FEMININ;SCOLAIRE;BAC PROFESSIONNEL;BAC PRO PROD;BAC PRO 23003 ARTIS. & M.ART:MARCHANDISAGE VIS.;9;9;6;3;0;0;0;6;0;2;2;0;2;3
2916.0;2021;28;LA REUNION;FEMININ;SCOLAIRE;BAC PROFESSIONNEL;BAC PRO PROD;BAC PRO 25007 MAINTENANCE EQUIPEMENTS INDUST.;2;2;1;1;0;0;0;1;0;0;0;0;1;1
2927.0;2021;28;LA REUNION;FEMININ;SCOLAIRE;BAC PROFESSIONNEL;BAC PRO PROD;BAC PRO AG 21405 AMENAGEMENTS PAYSAGERS;1;1;1;0;0;0;0;1;0;0;0;1;0;0
2930.0;2021;28;LA REUNION;FEMININ;SCOLAIRE;BAC PROFESSIONNEL;BAC PRO SERV;BAC PRO 30001 GESTION-ADMINISTRATION;590;590;494;49;47;29;18;523;0;22;105;198;198;67
2931.0;2021;28;LA REUNION;FEMININ;SCOLAIRE;BAC PROFESSIONNEL;BAC PRO SERV;BAC PRO 31106 LOGISTIQUE;16;16;12;2;2;2;0;14;0;0;3;1;10;2
2932.0;2021;28;LA REUNION;FEMININ;SCOLAIRE;BAC PROFESSIONNEL;BAC PRO SERV;BAC PRO 31108 TRANSPORT;8;8;8;0;0;0;0;8;0;1;1;5;1;0
2944.0;2021;28;LA REUNION;FEMININ;SCOLAIRE;BAC PROFESSIONNEL;BAC PRO SERV;BAC PRO 33603 ESTHETIQUE COSMETIQUE PARFUMERIE;17;17;16;1;0;0;0;16;0;0;1;7;8;1
2959.0;2021;28;LA REUNION;FEMININ;SCOLAIRE;BAC TECHNOLOGIQUE;BAC STMG;BAC STMG GESTION ET FINANCE;205;205;184;6;15;11;4;195;0;5;43;77;70;10
2965.0;2021;28;LA REUNION;MASCULIN;APPRENTISSAGE;BAC PROFESSIONNEL;BAC PRO PROD;BAC PRO 23102 TRAVAUX PUBLICS;4;4;3;1;0;0;0;3;0;0;0;1;2;1
2982.0;2021;28;LA REUNION;MASCULIN;INDIVIDUEL;BAC PROFESSIONNEL;BAC PRO PROD;BAC PRO AG 21114 CONDUITE PRODUCTIONS HORTICOLES;22;18;17;1;0;0;0;17;0;0;1;0;16;1
2983.0;2021;28;LA REUNION;MASCULIN;INDIVIDUEL;BAC PROFESSIONNEL;BAC PRO PROD;BAC PRO AG 21405 AMENAGEMENTS PAYSAGERS;1;0;0;0;0;0;0;0;0;0;0;0;0;0
2993.0;2021;28;LA REUNION;MASCULIN;SCOLAIRE;BAC GENERAL;BAC GENERAL;BAC GENE 10019 BAC GENERAL;2198;2198;2050;29;119;95;24;2145;55;214;506;705;665;53
2999.0;2021;28;LA REUNION;MASCULIN;SCOLAIRE;BAC PROFESSIONNEL;BAC PRO PROD;BAC PRO 22106 CUISINE;15;15;15;0;0;0;0;15;0;1;3;8;3;0
3002.0;2021;28;LA REUNION;MASCULIN;SCOLAIRE;BAC PROFESSIONNEL;BAC PRO PROD;BAC PRO 22704 TECHN. MAINT. SYST.ENERG.CLIMATI;23;23;15;5;3;1;2;16;0;0;0;6;10;7
3008.0;2021;28;LA REUNION;MASCULIN;SCOLAIRE;BAC PROFESSIONNEL;BAC PRO PROD;BAC PRO 23203 TECHNICIEN BAT. : ORG.REAL.GROS O;35;35;25;7;3;2;1;27;0;0;5;7;15;8
3011.0;2021;28;LA REUNION;MASCULIN;SCOLAIRE;BAC PROFESSIONNEL;BAC PRO PROD;BAC PRO 23207 INTERV. SUR PATRIMOINE BATI OPT.C;9;9;5;0;4;2;2;7;0;0;2;3;2;2
3012.0;2021;28;LA REUNION;MASCULIN;SCOLAIRE;BAC PROFESSIONNEL;BAC PRO PROD;BAC PRO 23303 MENUISERIE ALUMINIUM-VERRE;41;41;24;10;7;2;5;26;0;0;4;12;10;15
3016.0;2021;28;LA REUNION;MASCULIN;SCOLAIRE;BAC PROFESSIONNEL;BAC PRO PROD;BAC PRO 23407 TECHNIC.FAB.BOIS ET MATERX ASSOC;20;20;15;2;3;1;2;16;0;0;1;6;9;4
3027.0;2021;28;LA REUNION;MASCULIN;SCOLAIRE;BAC PROFESSIONNEL;BAC PRO PROD;BAC PRO 25406 OUVRAGES DU BATIMENT METALLERIE;36;36;22;13;1;1;0;23;0;1;4;7;11;13
3028.0;2021;28;LA REUNION;MASCULIN;SCOLAIRE;BAC PROFESSIONNEL;BAC PRO PROD;BAC PRO 25408 REPARATION DES CARROSSERIES;63;63;49;9;5;1;4;50;0;1;7;21;21;13
3033.0;2021;28;LA REUNION;MASCULIN;SCOLAIRE;BAC PROFESSIONNEL;BAC PRO PROD;BAC PRO 25514 SYST.NUM.OPT.B AUD.RES.EQUIP.DOM.;34;34;27;6;1;1;0;28;0;1;3;11;13;6
3038.0;2021;28;LA REUNION;MASCULIN;SCOLAIRE;BAC PROFESSIONNEL;BAC PRO PROD;BAC PRO AG 21302 GEST MILIEUX NATURELS FAUNE;13;13;13;0;0;0;0;13;0;0;1;6;6;0
3041.0;2021;28;LA REUNION;MASCULIN;SCOLAIRE;BAC PROFESSIONNEL;BAC PRO PROD;BAC PRO AG 22107 TEC CONS VTE ALIMENTATION P.ALIM;2;2;2;0;0;0;0;2;0;0;0;0;2;0
3047.0;2021;28;LA REUNION;MASCULIN;SCOLAIRE;BAC PROFESSIONNEL;BAC PRO SERV;BAC PRO 31210 ACCUEIL -RELATION CLIENTS USAGERS;21;21;19;2;0;0;0;19;0;1;4;9;5;2
3055.0;2021;28;LA REUNION;MASCULIN;SCOLAIRE;BAC PROFESSIONNEL;BAC PRO SERV;BAC PRO 33403 COMMERC. SERVICES EN RESTAURATION;7;7;6;1;0;0;0;6;0;0;1;3;2;1
3058.0;2021;28;LA REUNION;MASCULIN;SCOLAIRE;BAC PROFESSIONNEL;BAC PRO SERV;BAC PRO 34403 METIERS DE LA SECURITE;42;42;37;4;1;1;0;38;0;1;7;11;19;4
3068.0;2021;28;LA REUNION;MASCULIN;SCOLAIRE;BAC TECHNOLOGIQUE;BAC STL;BAC STL BIOCHIM.-BIOLOGIE-BIOTECHNOL.;56;56;51;0;5;2;3;53;0;3;4;18;28;3
3069.0;2021;28;LA REUNION;MASCULIN;SCOLAIRE;BAC TECHNOLOGIQUE;BAC STL;BAC STL SCIENCES PHYSIQUES CHIMIQUES  EN LABORAT.;13;13;11;0;2;2;0;13;0;0;0;6;7;0
3073.0;2021;28;LA REUNION;MASCULIN;SCOLAIRE;BAC TECHNOLOGIQUE;BAC STMG;BAC STMG SYSTEMES D'INFORMATION DE GESTION;53;53;40;2;11;8;3;48;0;0;2;13;33;5
3076.0;2021;09;LILLE;FEMININ;APPRENTISSAGE;BAC PROFESSIONNEL;BAC PRO PROD;BAC PRO 22106 CUISINE;6;6;6;0;0;0;0;6;0;0;0;4;2;0
3081.0;2021;09;LILLE;FEMININ;APPRENTISSAGE;BAC PROFESSIONNEL;BAC PRO PROD;BAC PRO 23405 TECHNICIEN MENUISIER AGENCEUR;2;2;2;0;0;0;0;2;0;1;0;1;0;0
3082.0;2021;09;LILLE;FEMININ;APPRENTISSAGE;BAC PROFESSIONNEL;BAC PRO PROD;BAC PRO 23408 Etude et réalisation d'agencement;1;1;0;1;0;0;0;0;0;0;0;0;0;1
3086.0;2021;09;LILLE;FEMININ;APPRENTISSAGE;BAC PROFESSIONNEL;BAC PRO PROD;BAC PRO 25215 MAINT.VEHIC.OPTB VEHIC.TRANS.ROUT;1;1;1;0;0;0;0;1;0;0;1;0;0;0
3093.0;2021;09;LILLE;FEMININ;APPRENTISSAGE;BAC PROFESSIONNEL;BAC PRO PROD;BAC PRO AG 21211 COND GEST ENTR HIPPIQUE;16;16;15;1;0;0;0;15;0;0;1;6;8;1
3094.0;2021;09;LILLE;FEMININ;APPRENTISSAGE;BAC PROFESSIONNEL;BAC PRO PROD;BAC PRO AG 22107 TEC CONS VTE ALIMENTATION P.ALIM;39;32;30;2;0;0;0;30;0;0;5;11;14;2
3096.0;2021;09;LILLE;FEMININ;APPRENTISSAGE;BAC PROFESSIONNEL;BAC PRO SERV;BAC PRO 31106 LOGISTIQUE;3;3;2;1;0;0;0;2;0;0;1;0;1;1
3097.0;2021;09;LILLE;FEMININ;APPRENTISSAGE;BAC PROFESSIONNEL;BAC PRO SERV;BAC PRO 31202 COMMERCE;92;82;70;8;4;3;1;73;0;6;19;24;24;9
3108.0;2021;09;LILLE;FEMININ;ENSEIGNEMENT A DISTANCE;BAC PROFESSIONNEL;BAC PRO SERV;BAC PRO 33004 ACC.SOINS-S.PERS. OPT.EN STRUCTUR;10;4;3;1;0;0;0;3;0;0;0;3;0;1
3110.0;2021;09;LILLE;FEMININ;ENSEIGNEMENT A DISTANCE;BAC TECHNOLOGIQUE;BAC STMG;BAC STMG GESTION ET FINANCE;3;3;3;0;0;0;0;3;0;0;0;0;3;0
3111.0;2021;09;LILLE;FEMININ;ENSEIGNEMENT A DISTANCE;BAC TECHNOLOGIQUE;BAC STMG;BAC STMG MERCATIQUE (MARKETING);4;4;4;0;0;0;0;4;0;1;2;1;0;0
3112.0;2021;09;LILLE;FEMININ;ENSEIGNEMENT A DISTANCE;BAC TECHNOLOGIQUE;BAC STMG;BAC STMG RESSOURCES HUMAINES ET COMMUNICATION;7;7;5;1;1;0;1;5;0;0;2;1;2;2
3121.0;2021;09;LILLE;FEMININ;FORMATION CONTINUE;BAC PROFESSIONNEL;BAC PRO SERV;BAC PRO 31106 LOGISTIQUE;7;7;7;0;0;0;0;7;0;2;3;1;1;0
3122.0;2021;09;LILLE;FEMININ;FORMATION CONTINUE;BAC PROFESSIONNEL;BAC PRO SERV;BAC PRO 31108 TRANSPORT;2;2;1;1;0;0;0;1;0;1;0;0;0;1
3128.0;2021;09;LILLE;FEMININ;INDIVIDUEL;BAC PROFESSIONNEL;BAC PRO PROD;BAC PRO 25214 MAINT.VEHIC.OPTA VOIT.PARTICUL.;1;0;0;0;0;0;0;0;0;0;0;0;0;0
3139.0;2021;09;LILLE;FEMININ;INDIVIDUEL;BAC PROFESSIONNEL;BAC PRO SERV;BAC PRO 33004 ACC.SOINS-S.PERS. OPT.EN STRUCTUR;6;4;2;1;1;1;0;3;0;0;0;0;3;1
3146.0;2021;09;LILLE;FEMININ;SCOLAIRE;BAC PROFESSIONNEL;BAC PRO PROD;BAC PRO 22003 BIO-INDUSTRIES DE TRANSFORMATION;14;14;10;3;1;1;0;11;0;0;2;3;6;3
3147.0;2021;09;LILLE;FEMININ;SCOLAIRE;BAC PROFESSIONNEL;BAC PRO PROD;BAC PRO 22004 PROC. CHIMIE EAU PAPIERS-CARTONS;8;8;7;1;0;0;0;7;0;0;1;5;1;1
3148.0;2021;09;LILLE;FEMININ;SCOLAIRE;BAC PROFESSIONNEL;BAC PRO PROD;BAC PRO 22105 BOULANGER-PÂTISSIER;48;48;45;1;2;1;1;46;0;6;15;17;8;2
3160.0;2021;09;LILLE;FEMININ;SCOLAIRE;BAC PROFESSIONNEL;BAC PRO PROD;BAC PRO 23407 TECHNIC.FAB.BOIS ET MATERX ASSOC;1;1;0;0;1;1;0;1;0;0;0;0;1;0
3163.0;2021;09;LILLE;FEMININ;SCOLAIRE;BAC PROFESSIONNEL;BAC PRO PROD;BAC PRO 25007 MAINTENANCE EQUIPEMENTS INDUST.;10;9;7;2;0;0;0;7;0;0;3;4;0;2
3164.0;2021;09;LILLE;FEMININ;SCOLAIRE;BAC PROFESSIONNEL;BAC PRO PROD;BAC PRO 25106 TECHNICIEN D'USINAGE;3;3;3;0;0;0;0;3;0;0;3;0;0;0
3167.0;2021;09;LILLE;FEMININ;SCOLAIRE;BAC PROFESSIONNEL;BAC PRO PROD;BAC PRO 25216 MAINT.VEHIC.OPTC MOTOCYCLES;1;1;0;1;0;0;0;0;0;0;0;0;0;1
3170.0;2021;09;LILLE;FEMININ;SCOLAIRE;BAC PROFESSIONNEL;BAC PRO PROD;BAC PRO 25408 REPARATION DES CARROSSERIES;11;11;10;0;1;1;0;11;0;0;2;5;4;0
3194.0;2021;09;LILLE;FEMININ;SCOLAIRE;BAC PROFESSIONNEL;BAC PRO SERV;BAC PRO 31206 VENTE (PROSPECT.NEGO.SUIV.CLIENT;131;130;110;16;4;1;3;111;0;5;25;51;30;19
3197.0;2021;09;LILLE;FEMININ;SCOLAIRE;BAC PROFESSIONNEL;BAC PRO SERV;BAC PRO 32208 REAL.PR.IMPR.PLURI.OPTB.PR.IMPR.;1;1;1;0;0;0;0;1;0;0;0;1;0;0
3203.0;2021;09;LILLE;FEMININ;SCOLAIRE;BAC PROFESSIONNEL;BAC PRO SERV;BAC PRO 33101 OPTIQUE LUNETTERIE;28;27;23;3;1;1;0;24;0;2;10;8;4;3
3213.0;2021;09;LILLE;FEMININ;SCOLAIRE;BAC TECHNOLOGIQUE;BAC S2TMD;BAC S2TMD MUSIQUE;15;15;15;0;0;0;0;15;2;3;5;4;1;0
3227.0;2021;09;LILLE;FEMININ;SCOLAIRE;BAC TECHNOLOGIQUE;BAC STMG;BAC STMG SYSTEMES D'INFORMATION DE GESTION;3;3;3;0;0;0;0;3;0;1;0;1;1;0
3230.0;2021;09;LILLE;MASCULIN;APPRENTISSAGE;BAC PROFESSIONNEL;BAC PRO PROD;BAC PRO 22004 PROC. CHIMIE EAU PAPIERS-CARTONS;1;1;1;0;0;0;0;1;0;0;1;0;0;0
3242.0;2021;09;LILLE;MASCULIN;APPRENTISSAGE;BAC PROFESSIONNEL;BAC PRO PROD;BAC PRO 25106 TECHNICIEN D'USINAGE;22;22;15;7;0;0;0;15;0;3;5;4;3;7
3245.0;2021;09;LILLE;MASCULIN;APPRENTISSAGE;BAC PROFESSIONNEL;BAC PRO PROD;BAC PRO 25216 MAINT.VEHIC.OPTC MOTOCYCLES;7;7;6;0;1;1;0;7;0;0;2;3;2;0
3247.0;2021;09;LILLE;MASCULIN;APPRENTISSAGE;BAC PROFESSIONNEL;BAC PRO PROD;BAC PRO 25220 MAINT.MATERIELS OPT.B TP MANUT.;4;4;3;1;0;0;0;3;0;1;0;2;0;1
3250.0;2021;09;LILLE;MASCULIN;APPRENTISSAGE;BAC PROFESSIONNEL;BAC PRO PROD;BAC PRO 25406 OUVRAGES DU BATIMENT METALLERIE;6;6;6;0;0;0;0;6;0;0;0;4;2;0
3266.0;2021;09;LILLE;MASCULIN;APPRENTISSAGE;BAC PROFESSIONNEL;BAC PRO SERV;BAC PRO 31210 ACCUEIL -RELATION CLIENTS USAGERS;3;3;3;0;0;0;0;3;0;0;1;1;1;0
3276.0;2021;09;LILLE;MASCULIN;ENSEIGNEMENT A DISTANCE;BAC TECHNOLOGIQUE;BAC STMG;BAC STMG GESTION ET FINANCE;1;1;1;0;0;0;0;1;0;0;0;1;0;0
3280.0;2021;09;LILLE;MASCULIN;FORMATION CONTINUE;BAC PROFESSIONNEL;BAC PRO PROD;BAC PRO 20102 PILOTE DE LIGNE DE PRODUCTION;7;5;5;0;0;0;0;5;0;1;1;2;1;0
3284.0;2021;09;LILLE;MASCULIN;FORMATION CONTINUE;BAC PROFESSIONNEL;BAC PRO PROD;BAC PRO 23304 AMENAGEMENT FINITION BATIMENT;1;1;1;0;0;0;0;1;0;1;0;0;0;0
3285.0;2021;09;LILLE;MASCULIN;FORMATION CONTINUE;BAC PROFESSIONNEL;BAC PRO PROD;BAC PRO 23405 TECHNICIEN MENUISIER AGENCEUR;1;1;1;0;0;0;0;1;0;1;0;0;0;0
3286.0;2021;09;LILLE;MASCULIN;FORMATION CONTINUE;BAC PROFESSIONNEL;BAC PRO PROD;BAC PRO 24303 MET. DU CUIR: SELLERIE GARNISSAGE;1;0;0;0;0;0;0;0;0;0;0;0;0;0
3293.0;2021;09;LILLE;MASCULIN;FORMATION CONTINUE;BAC PROFESSIONNEL;BAC PRO PROD;BAC PRO 25515 SYST.NUM.OPT.C RES.INF.SYST.COMM.;5;5;3;2;0;0;0;3;0;0;2;1;0;2
3306.0;2021;09;LILLE;MASCULIN;INDIVIDUEL;BAC PROFESSIONNEL;BAC PRO PROD;BAC PRO AG 21004 CGEA;3;3;2;1;0;0;0;2;0;0;0;0;2;1
3307.0;2021;09;LILLE;MASCULIN;INDIVIDUEL;BAC PROFESSIONNEL;BAC PRO PROD;BAC PRO AG 21405 AMENAGEMENTS PAYSAGERS;1;0;0;0;0;0;0;0;0;0;0;0;0;0
3315.0;2021;09;LILLE;MASCULIN;INDIVIDUEL;BAC TECHNOLOGIQUE;BAC ST2S;BAC ST2S SCIENCES & TECHNO. SANTE & SOCIAL;4;1;1;0;0;0;0;1;0;0;0;0;1;0
3320.0;2021;09;LILLE;MASCULIN;INDIVIDUEL;BAC TECHNOLOGIQUE;BAC STMG;BAC STMG GESTION ET FINANCE;7;3;1;1;1;1;0;2;0;0;0;0;2;1
3321.0;2021;09;LILLE;MASCULIN;INDIVIDUEL;BAC TECHNOLOGIQUE;BAC STMG;BAC STMG MERCATIQUE (MARKETING);26;13;8;4;1;1;0;9;0;0;1;2;6;4
3327.0;2021;09;LILLE;MASCULIN;SCOLAIRE;BAC PROFESSIONNEL;BAC PRO PROD;BAC PRO 22004 PROC. CHIMIE EAU PAPIERS-CARTONS;31;31;26;4;1;1;0;27;0;0;3;12;12;4
3330.0;2021;09;LILLE;MASCULIN;SCOLAIRE;BAC PROFESSIONNEL;BAC PRO PROD;BAC PRO 22403 ARTS.& MET.ART:MET.ENSEIGN SIGNA;10;10;10;0;0;0;0;10;0;0;0;7;3;0
3331.0;2021;09;LILLE;MASCULIN;SCOLAIRE;BAC PROFESSIONNEL;BAC PRO PROD;BAC PRO 22503 PLASTIQUES ET COMPOSITES;11;11;9;1;1;1;0;10;0;3;3;2;2;1
3333.0;2021;09;LILLE;MASCULIN;SCOLAIRE;BAC PROFESSIONNEL;BAC PRO PROD;BAC PRO 22704 TECHN. MAINT. SYST.ENERG.CLIMATI;70;69;45;17;7;2;5;47;0;1;5;19;22;22
3344.0;2021;09;LILLE;MASCULIN;SCOLAIRE;BAC PROFESSIONNEL;BAC PRO PROD;BAC PRO 23405 TECHNICIEN MENUISIER AGENCEUR;116;116;87;19;10;5;5;92;0;2;10;33;47;24
3348.0;2021;09;LILLE;MASCULIN;SCOLAIRE;BAC PROFESSIONNEL;BAC PRO PROD;BAC PRO 25007 MAINTENANCE EQUIPEMENTS INDUST.;411;408;295;75;38;26;12;321;0;10;65;94;152;87
3353.0;2021;09;LILLE;MASCULIN;SCOLAIRE;BAC PROFESSIONNEL;BAC PRO PROD;BAC PRO 25219 MAINT.MATERIELS OPT.A AGRICOLES;47;47;45;1;1;0;1;45;0;1;14;16;14;2
3359.0;2021;09;LILLE;MASCULIN;SCOLAIRE;BAC PROFESSIONNEL;BAC PRO PROD;BAC PRO 25410 CONSTRUCTION DES CARROSSERIES;8;8;7;1;0;0;0;7;0;0;2;3;2;1
3361.0;2021;09;LILLE;MASCULIN;SCOLAIRE;BAC PROFESSIONNEL;BAC PRO PROD;BAC PRO 25509 TECHNIC. FROID CONDITIONNEMT AIR;65;62;43;19;0;0;0;43;0;0;10;11;22;19
3367.0;2021;09;LILLE;MASCULIN;SCOLAIRE;BAC PROFESSIONNEL;BAC PRO PROD;BAC PRO AG 21004 CGEA;130;129;113;16;0;0;0;113;0;3;6;42;62;16
3387.0;2021;09;LILLE;MASCULIN;SCOLAIRE;BAC PROFESSIONNEL;BAC PRO SERV;BAC PRO 32208 REAL.PR.IMPR.PLURI.OPTB.PR.IMPR.;7;7;4;3;0;0;0;4;0;0;0;3;1;3
3396.0;2021;09;LILLE;MASCULIN;SCOLAIRE;BAC PROFESSIONNEL;BAC PRO SERV;BAC PRO 33403 COMMERC. SERVICES EN RESTAURATION;143;143;109;25;9;7;2;116;0;4;19;51;42;27
3398.0;2021;09;LILLE;MASCULIN;SCOLAIRE;BAC PROFESSIONNEL;BAC PRO SERV;BAC PRO 34304 HYGIENE PROPRETE STERILISATION;21;21;18;0;3;0;3;18;0;1;2;8;7;3
3408.0;2021;09;LILLE;MASCULIN;SCOLAIRE;BAC TECHNOLOGIQUE;BAC STI2D;BAC STI2D INNOVATION TECHNO.  ET ECO CONCEPTION;442;442;414;7;21;8;13;422;0;11;71;180;160;20
3415.0;2021;09;LILLE;MASCULIN;SCOLAIRE;BAC TECHNOLOGIQUE;BAC STMG;BAC STMG SYSTEMES D'INFORMATION DE GESTION;12;12;11;1;0;0;0;11;0;0;0;4;7;1
3418.0;2021;22;LIMOGES;FEMININ;APPRENTISSAGE;BAC PROFESSIONNEL;BAC PRO PROD;BAC PRO 25106 TECHNICIEN D'USINAGE;1;1;1;0;0;0;0;1;0;0;1;0;0;0
3422.0;2021;22;LIMOGES;FEMININ;APPRENTISSAGE;BAC PROFESSIONNEL;BAC PRO SERV;BAC PRO 30001 GESTION-ADMINISTRATION;1;1;1;0;0;0;0;1;0;1;0;0;0;0
3424.0;2021;22;LIMOGES;FEMININ;APPRENTISSAGE;BAC PROFESSIONNEL;BAC PRO SERV;BAC PRO 31210 ACCUEIL -RELATION CLIENTS USAGERS;7;7;7;0;0;0;0;7;0;3;2;2;0;0
3426.0;2021;22;LIMOGES;FEMININ;APPRENTISSAGE;BAC PROFESSIONNEL;BAC PRO SERV;BAC PRO AG 33002 SERV PERS TERRIT;2;2;2;0;0;0;0;2;0;0;0;2;0;0
3432.0;2021;22;LIMOGES;FEMININ;ENSEIGNEMENT A DISTANCE;BAC TECHNOLOGIQUE;BAC STMG;BAC STMG RESSOURCES HUMAINES ET COMMUNICATION;1;1;1;0;0;0;0;1;0;0;0;1;0;0
3433.0;2021;22;LIMOGES;FEMININ;FORMATION CONTINUE;BAC PROFESSIONNEL;BAC PRO SERV;BAC PRO 30001 GESTION-ADMINISTRATION;7;6;6;0;0;0;0;6;0;1;3;2;0;0
3438.0;2021;22;LIMOGES;FEMININ;INDIVIDUEL;BAC PROFESSIONNEL;BAC PRO PROD;BAC PRO AG 21211 COND GEST ENTR HIPPIQUE;2;1;1;0;0;0;0;1;0;0;0;0;1;0
3442.0;2021;22;LIMOGES;FEMININ;INDIVIDUEL;BAC PROFESSIONNEL;BAC PRO SERV;BAC PRO 31210 ACCUEIL -RELATION CLIENTS USAGERS;1;1;1;0;0;0;0;1;0;0;0;0;1;0
3457.0;2021;22;LIMOGES;FEMININ;SCOLAIRE;BAC PROFESSIONNEL;BAC PRO PROD;BAC PRO 23405 TECHNICIEN MENUISIER AGENCEUR;1;1;1;0;0;0;0;1;0;0;0;0;1;0
3462.0;2021;22;LIMOGES;FEMININ;SCOLAIRE;BAC PROFESSIONNEL;BAC PRO PROD;BAC PRO 25106 TECHNICIEN D'USINAGE;1;1;1;0;0;0;0;1;0;0;0;1;0;0
3463.0;2021;22;LIMOGES;FEMININ;SCOLAIRE;BAC PROFESSIONNEL;BAC PRO PROD;BAC PRO 25108 TECHNICIEN MODELEUR;3;3;3;0;0;0;0;3;0;0;2;1;0;0
3465.0;2021;22;LIMOGES;FEMININ;SCOLAIRE;BAC PROFESSIONNEL;BAC PRO PROD;BAC PRO 25219 MAINT.MATERIELS OPT.A AGRICOLES;1;1;1;0;0;0;0;1;0;0;0;0;1;0
3466.0;2021;22;LIMOGES;FEMININ;SCOLAIRE;BAC PROFESSIONNEL;BAC PRO PROD;BAC PRO 25411 TECH.CHAUDRONNERIE INDUSTRIELLE;2;2;1;0;1;1;0;2;0;0;0;1;1;0
3473.0;2021;22;LIMOGES;FEMININ;SCOLAIRE;BAC PROFESSIONNEL;BAC PRO PROD;BAC PRO AG 21211 COND GEST ENTR HIPPIQUE;23;23;20;3;0;0;0;20;0;3;1;8;8;3
3475.0;2021;22;LIMOGES;FEMININ;SCOLAIRE;BAC PROFESSIONNEL;BAC PRO PROD;BAC PRO AG 21405 AMENAGEMENTS PAYSAGERS;1;1;1;0;0;0;0;1;0;0;0;0;1;0
3478.0;2021;22;LIMOGES;FEMININ;SCOLAIRE;BAC PROFESSIONNEL;BAC PRO SERV;BAC PRO 30001 GESTION-ADMINISTRATION;82;82;59;15;8;6;2;65;0;2;9;24;30;17
3482.0;2021;22;LIMOGES;FEMININ;SCOLAIRE;BAC PROFESSIONNEL;BAC PRO SERV;BAC PRO 31210 ACCUEIL -RELATION CLIENTS USAGERS;19;19;16;1;2;1;1;17;0;1;3;7;6;2
3486.0;2021;22;LIMOGES;FEMININ;SCOLAIRE;BAC PROFESSIONNEL;BAC PRO SERV;BAC PRO 33002 SERVICES DE PROXIMITE  VIE LOCAL;20;20;15;2;3;3;0;18;0;0;3;6;9;2
3487.0;2021;22;LIMOGES;FEMININ;SCOLAIRE;BAC PROFESSIONNEL;BAC PRO SERV;BAC PRO 33003 ACC.SOINS-S.PERS. OPT.A DOMICILE;60;60;58;1;1;0;1;58;0;2;15;28;13;2
3493.0;2021;22;LIMOGES;FEMININ;SCOLAIRE;BAC PROFESSIONNEL;BAC PRO SERV;BAC PRO 34403 METIERS DE LA SECURITE;16;16;16;0;0;0;0;16;0;0;2;9;5;0
3496.0;2021;22;LIMOGES;FEMININ;SCOLAIRE;BAC TECHNOLOGIQUE;BAC STAV;BAC STAV AGRONOMIE ALIM ENV TERRITOI;38;37;37;0;0;0;0;37;0;0;10;16;11;0
3499.0;2021;22;LIMOGES;FEMININ;SCOLAIRE;BAC TECHNOLOGIQUE;BAC STI2D;BAC STI2D ARCHITECTURE ET CONSTRUCTION;12;12;10;1;1;0;1;10;0;0;3;4;3;2
3501.0;2021;22;LIMOGES;FEMININ;SCOLAIRE;BAC TECHNOLOGIQUE;BAC STI2D;BAC STI2D INNOVATION TECHNO.  ET ECO CONCEPTION;6;6;6;0;0;0;0;6;0;0;1;3;2;0
3502.0;2021;22;LIMOGES;FEMININ;SCOLAIRE;BAC TECHNOLOGIQUE;BAC STI2D;BAC STI2D SYSTÈME D'INFORMATION  ET NUMERIQUE;3;3;3;0;0;0;0;3;0;0;0;2;1;0
3509.0;2021;22;LIMOGES;MASCULIN;APPRENTISSAGE;BAC PROFESSIONNEL;BAC PRO PROD;BAC PRO 22703 TECHN.INSTALL.SYST.ENERG.CLIMATI;1;1;1;0;0;0;0;1;0;0;0;0;1;0
3519.0;2021;22;LIMOGES;MASCULIN;APPRENTISSAGE;BAC PROFESSIONNEL;BAC PRO PROD;BAC PRO 25007 MAINTENANCE EQUIPEMENTS INDUST.;11;10;10;0;0;0;0;10;0;1;3;3;3;0
3524.0;2021;22;LIMOGES;MASCULIN;APPRENTISSAGE;BAC PROFESSIONNEL;BAC PRO PROD;BAC PRO 25219 MAINT.MATERIELS OPT.A AGRICOLES;8;8;6;1;1;1;0;7;0;0;1;5;1;1
3528.0;2021;22;LIMOGES;MASCULIN;APPRENTISSAGE;BAC PROFESSIONNEL;BAC PRO PROD;BAC PRO 25411 TECH.CHAUDRONNERIE INDUSTRIELLE;5;5;4;1;0;0;0;4;0;1;0;0;3;1
3530.0;2021;22;LIMOGES;MASCULIN;APPRENTISSAGE;BAC PROFESSIONNEL;BAC PRO PROD;BAC PRO 25510 METIERS ELECT. ENVIRON. CONNECTES;22;22;21;1;0;0;0;21;0;7;4;7;3;1
3534.0;2021;22;LIMOGES;MASCULIN;APPRENTISSAGE;BAC PROFESSIONNEL;BAC PRO SERV;BAC PRO 31106 LOGISTIQUE;1;1;0;0;1;1;0;1;0;0;0;0;1;0
3535.0;2021;22;LIMOGES;MASCULIN;APPRENTISSAGE;BAC PROFESSIONNEL;BAC PRO SERV;BAC PRO 31202 COMMERCE;18;18;16;1;1;0;1;16;0;2;2;6;6;2
3536.0;2021;22;LIMOGES;MASCULIN;APPRENTISSAGE;BAC PROFESSIONNEL;BAC PRO SERV;BAC PRO AG 33002 SERV PERS TERRIT;2;2;2;0;0;0;0;2;0;0;0;1;1;0
3541.0;2021;22;LIMOGES;MASCULIN;FORMATION CONTINUE;BAC PROFESSIONNEL;BAC PRO PROD;BAC PRO 25510 METIERS ELECT. ENVIRON. CONNECTES;1;1;1;0;0;0;0;1;0;1;0;0;0;0
3547.0;2021;22;LIMOGES;MASCULIN;INDIVIDUEL;BAC PROFESSIONNEL;BAC PRO PROD;BAC PRO AG 21113 CGEVV;1;1;1;0;0;0;0;1;0;0;0;0;1;0
3560.0;2021;22;LIMOGES;MASCULIN;SCOLAIRE;BAC PROFESSIONNEL;BAC PRO PROD;BAC PRO 22105 BOULANGER-PÂTISSIER;12;12;11;0;1;1;0;12;0;1;1;5;5;0
3562.0;2021;22;LIMOGES;MASCULIN;SCOLAIRE;BAC PROFESSIONNEL;BAC PRO PROD;BAC PRO 22704 TECHN. MAINT. SYST.ENERG.CLIMATI;8;8;3;5;0;0;0;3;0;0;0;1;2;5
3564.0;2021;22;LIMOGES;MASCULIN;SCOLAIRE;BAC PROFESSIONNEL;BAC PRO PROD;BAC PRO 23005 TECHN. ETUDES BAT B ASSIST.ARCHI.;13;13;12;0;1;1;0;13;0;0;2;4;7;0
3568.0;2021;22;LIMOGES;MASCULIN;SCOLAIRE;BAC PROFESSIONNEL;BAC PRO PROD;BAC PRO 23404 TECHNICIEN CONSTRUCTEUR BOIS;4;3;3;0;0;0;0;3;0;0;0;2;1;0
3570.0;2021;22;LIMOGES;MASCULIN;SCOLAIRE;BAC PROFESSIONNEL;BAC PRO PROD;BAC PRO 23407 TECHNIC.FAB.BOIS ET MATERX ASSOC;8;8;6;0;2;2;0;8;0;0;1;2;5;0
3594.0;2021;22;LIMOGES;MASCULIN;SCOLAIRE;BAC PROFESSIONNEL;BAC PRO PROD;BAC PRO AG 21204 PROD-AQUACOLES;11;11;9;2;0;0;0;9;0;0;0;3;6;2
3599.0;2021;22;LIMOGES;MASCULIN;SCOLAIRE;BAC PROFESSIONNEL;BAC PRO PROD;BAC PRO AG 21406 TEC CONS VTE PROD DES JARDINS;3;3;1;2;0;0;0;1;0;0;0;0;1;2
3610.0;2021;22;LIMOGES;MASCULIN;SCOLAIRE;BAC PROFESSIONNEL;BAC PRO SERV;BAC PRO 32303 ART.& MET.ART:COM.VIS.VIS.PLURI-M;7;6;4;2;0;0;0;4;0;0;0;3;1;2
3615.0;2021;22;LIMOGES;MASCULIN;SCOLAIRE;BAC PROFESSIONNEL;BAC PRO SERV;BAC PRO 33403 COMMERC. SERVICES EN RESTAURATION;20;20;19;0;1;1;0;20;0;1;4;7;8;0
3616.0;2021;22;LIMOGES;MASCULIN;SCOLAIRE;BAC PROFESSIONNEL;BAC PRO SERV;BAC PRO 34304 HYGIENE PROPRETE STERILISATION;2;2;2;0;0;0;0;2;0;0;1;1;0;0
3618.0;2021;22;LIMOGES;MASCULIN;SCOLAIRE;BAC PROFESSIONNEL;BAC PRO SERV;BAC PRO AG 33002 SERV PERS TERRIT;9;9;8;1;0;0;0;8;0;0;1;3;4;1
3624.0;2021;22;LIMOGES;MASCULIN;SCOLAIRE;BAC TECHNOLOGIQUE;BAC STI2D;BAC STI2D ENERGIES  ET ENVIRONNEMENT;62;62;46;5;11;6;5;52;0;2;7;17;26;10
3625.0;2021;22;LIMOGES;MASCULIN;SCOLAIRE;BAC TECHNOLOGIQUE;BAC STI2D;BAC STI2D INNOVATION TECHNO.  ET ECO CONCEPTION;75;75;67;0;8;4;4;71;0;3;6;35;27;4
3630.0;2021;22;LIMOGES;MASCULIN;SCOLAIRE;BAC TECHNOLOGIQUE;BAC STMG;BAC STMG MERCATIQUE (MARKETING);154;154;136;3;15;7;8;143;0;2;12;56;73;11
3636.0;2021;10;LYON;FEMININ;APPRENTISSAGE;BAC PROFESSIONNEL;BAC PRO PROD;BAC PRO 22105 BOULANGER-PÂTISSIER;3;3;3;0;0;0;0;3;0;0;1;1;1;0
3643.0;2021;10;LYON;FEMININ;APPRENTISSAGE;BAC PROFESSIONNEL;BAC PRO PROD;BAC PRO 25007 MAINTENANCE EQUIPEMENTS INDUST.;1;1;1;0;0;0;0;1;0;0;1;0;0;0
3645.0;2021;10;LYON;FEMININ;APPRENTISSAGE;BAC PROFESSIONNEL;BAC PRO PROD;BAC PRO 25107 TECHNICIEN OUTILLEUR;1;1;1;0;0;0;0;1;0;0;0;1;0;0
3648.0;2021;10;LYON;FEMININ;APPRENTISSAGE;BAC PROFESSIONNEL;BAC PRO PROD;BAC PRO 25220 MAINT.MATERIELS OPT.B TP MANUT.;1;1;1;0;0;0;0;1;0;1;0;0;0;0
3652.0;2021;10;LYON;FEMININ;APPRENTISSAGE;BAC PROFESSIONNEL;BAC PRO PROD;BAC PRO AG 21113 CGEVV;1;1;1;0;0;0;0;1;0;0;0;0;1;0
3653.0;2021;10;LYON;FEMININ;APPRENTISSAGE;BAC PROFESSIONNEL;BAC PRO PROD;BAC PRO AG 21114 CONDUITE PRODUCTIONS HORTICOLES;4;4;4;0;0;0;0;4;0;1;0;0;3;0
3654.0;2021;10;LYON;FEMININ;APPRENTISSAGE;BAC PROFESSIONNEL;BAC PRO PROD;BAC PRO AG 21203 TECHN CONSEIL DE VENTE ANIMAL;3;3;3;0;0;0;0;3;0;0;0;2;1;0
3657.0;2021;10;LYON;FEMININ;APPRENTISSAGE;BAC PROFESSIONNEL;BAC PRO PROD;BAC PRO AG 21212 TECH EXPE ANIMALE;3;3;3;0;0;0;0;3;0;0;1;0;2;0
3662.0;2021;10;LYON;FEMININ;APPRENTISSAGE;BAC PROFESSIONNEL;BAC PRO SERV;BAC PRO 31202 COMMERCE;104;100;80;9;11;7;4;87;0;11;14;26;36;13
3664.0;2021;10;LYON;FEMININ;APPRENTISSAGE;BAC PROFESSIONNEL;BAC PRO SERV;BAC PRO 31210 ACCUEIL -RELATION CLIENTS USAGERS;13;12;12;0;0;0;0;12;0;3;4;3;2;0
3665.0;2021;10;LYON;FEMININ;APPRENTISSAGE;BAC PROFESSIONNEL;BAC PRO SERV;BAC PRO 32207 REAL.PR.IMPR.PLURI.OPTA.PR.GRAPH.;1;1;1;0;0;0;0;1;0;0;1;0;0;0
3668.0;2021;10;LYON;FEMININ;APPRENTISSAGE;BAC PROFESSIONNEL;BAC PRO SERV;BAC PRO 33403 COMMERC. SERVICES EN RESTAURATION;6;6;6;0;0;0;0;6;0;0;1;3;2;0
3677.0;2021;10;LYON;FEMININ;FORMATION CONTINUE;BAC PROFESSIONNEL;BAC PRO PROD;BAC PRO 25216 MAINT.VEHIC.OPTC MOTOCYCLES;1;0;0;0;0;0;0;0;0;0;0;0;0;0
3684.0;2021;10;LYON;FEMININ;INDIVIDUEL;BAC PROFESSIONNEL;BAC PRO PROD;BAC PRO AG 21004 CGEA;4;3;3;0;0;0;0;3;0;0;0;0;3;0
3690.0;2021;10;LYON;FEMININ;INDIVIDUEL;BAC PROFESSIONNEL;BAC PRO SERV;BAC PRO 31206 VENTE (PROSPECT.NEGO.SUIV.CLIENT;3;1;1;0;0;0;0;1;0;0;0;1;0;0
3701.0;2021;10;LYON;FEMININ;INDIVIDUEL;BAC TECHNOLOGIQUE;BAC STI2D;BAC STI2D ARCHITECTURE ET CONSTRUCTION;1;0;0;0;0;0;0;0;0;0;0;0;0;0
3713.0;2021;10;LYON;FEMININ;SCOLAIRE;BAC PROFESSIONNEL;BAC PRO PROD;BAC PRO 23003 ARTIS. & M.ART:MARCHANDISAGE VIS.;14;14;13;1;0;0;0;13;0;0;3;8;2;1
3722.0;2021;10;LYON;FEMININ;SCOLAIRE;BAC PROFESSIONNEL;BAC PRO PROD;BAC PRO 24203 METIERS DE LA MODE - VÊTEMENT;131;130;117;13;0;0;0;117;0;12;21;44;40;13
3724.0;2021;10;LYON;FEMININ;SCOLAIRE;BAC PROFESSIONNEL;BAC PRO PROD;BAC PRO 24303 MET. DU CUIR: SELLERIE GARNISSAGE;5;5;2;2;1;1;0;3;0;0;1;0;2;2
3732.0;2021;10;LYON;FEMININ;SCOLAIRE;BAC PROFESSIONNEL;BAC PRO PROD;BAC PRO 25406 OUVRAGES DU BATIMENT METALLERIE;1;1;1;0;0;0;0;1;0;0;0;1;0;0
3734.0;2021;10;LYON;FEMININ;SCOLAIRE;BAC PROFESSIONNEL;BAC PRO PROD;BAC PRO 25510 METIERS ELECT. ENVIRON. CONNECTES;4;4;4;0;0;0;0;4;0;0;1;1;2;0
3735.0;2021;10;LYON;FEMININ;SCOLAIRE;BAC PROFESSIONNEL;BAC PRO PROD;BAC PRO 25514 SYST.NUM.OPT.B AUD.RES.EQUIP.DOM.;2;2;1;1;0;0;0;1;0;0;0;1;0;1
3745.0;2021;10;LYON;FEMININ;SCOLAIRE;BAC PROFESSIONNEL;BAC PRO PROD;BAC PRO AG 21303 FORET;2;2;1;1;0;0;0;1;0;0;0;0;1;1
3748.0;2021;10;LYON;FEMININ;SCOLAIRE;BAC PROFESSIONNEL;BAC PRO PROD;BAC PRO AG 22105 LABORATOIRE CONTROLE QUALITE;27;27;24;3;0;0;0;24;0;0;1;10;13;3
3753.0;2021;10;LYON;FEMININ;SCOLAIRE;BAC PROFESSIONNEL;BAC PRO SERV;BAC PRO 31108 TRANSPORT;16;16;13;2;1;1;0;14;0;0;3;4;7;2
3754.0;2021;10;LYON;FEMININ;SCOLAIRE;BAC PROFESSIONNEL;BAC PRO SERV;BAC PRO 31202 COMMERCE;377;375;338;7;30;18;12;356;0;20;73;143;120;19
3757.0;2021;10;LYON;FEMININ;SCOLAIRE;BAC PROFESSIONNEL;BAC PRO SERV;BAC PRO 32207 REAL.PR.IMPR.PLURI.OPTA.PR.GRAPH.;10;10;8;1;1;1;0;9;0;4;1;0;4;1
3759.0;2021;10;LYON;FEMININ;SCOLAIRE;BAC PROFESSIONNEL;BAC PRO SERV;BAC PRO 32303 ART.& MET.ART:COM.VIS.VIS.PLURI-M;30;30;30;0;0;0;0;30;0;3;12;9;6;0
3772.0;2021;10;LYON;FEMININ;SCOLAIRE;BAC TECHNOLOGIQUE;BAC S2TMD;BAC S2TMD DANSE;7;7;7;0;0;0;0;7;1;2;2;2;0;0
3774.0;2021;10;LYON;FEMININ;SCOLAIRE;BAC TECHNOLOGIQUE;BAC ST2S;BAC ST2S SCIENCES & TECHNO. SANTE & SOCIAL;935;935;800;21;114;53;61;853;0;15;125;321;392;82
3782.0;2021;10;LYON;FEMININ;SCOLAIRE;BAC TECHNOLOGIQUE;BAC STL;BAC STL BIOCHIM.-BIOLOGIE-BIOTECHNOL.;143;143;135;0;8;3;5;138;0;2;22;53;61;5
3784.0;2021;10;LYON;FEMININ;SCOLAIRE;BAC TECHNOLOGIQUE;BAC STMG;BAC STMG GESTION ET FINANCE;389;389;348;10;31;17;14;365;0;9;57;148;151;24
3792.0;2021;10;LYON;MASCULIN;APPRENTISSAGE;BAC PROFESSIONNEL;BAC PRO PROD;BAC PRO 22106 CUISINE;8;8;5;2;1;0;1;5;0;0;1;1;3;3
3793.0;2021;10;LYON;MASCULIN;APPRENTISSAGE;BAC PROFESSIONNEL;BAC PRO PROD;BAC PRO 22403 ARTS.& MET.ART:MET.ENSEIGN SIGNA;3;3;3;0;0;0;0;3;0;1;0;1;1;0
3800.0;2021;10;LYON;MASCULIN;APPRENTISSAGE;BAC PROFESSIONNEL;BAC PRO PROD;BAC PRO 23203 TECHNICIEN BAT. : ORG.REAL.GROS O;13;13;13;0;0;0;0;13;0;0;3;4;6;0
3803.0;2021;10;LYON;MASCULIN;APPRENTISSAGE;BAC PROFESSIONNEL;BAC PRO PROD;BAC PRO 23404 TECHNICIEN CONSTRUCTEUR BOIS;13;13;10;1;2;2;0;12;0;1;1;5;5;1
3805.0;2021;10;LYON;MASCULIN;APPRENTISSAGE;BAC PROFESSIONNEL;BAC PRO PROD;BAC PRO 23407 TECHNIC.FAB.BOIS ET MATERX ASSOC;3;3;2;0;1;0;1;2;0;0;0;1;1;1
3813.0;2021;10;LYON;MASCULIN;APPRENTISSAGE;BAC PROFESSIONNEL;BAC PRO PROD;BAC PRO 25219 MAINT.MATERIELS OPT.A AGRICOLES;17;17;16;1;0;0;0;16;0;1;4;6;5;1
3818.0;2021;10;LYON;MASCULIN;APPRENTISSAGE;BAC PROFESSIONNEL;BAC PRO PROD;BAC PRO 25410 CONSTRUCTION DES CARROSSERIES;9;8;6;2;0;0;0;6;0;2;3;0;1;2
3821.0;2021;10;LYON;MASCULIN;APPRENTISSAGE;BAC PROFESSIONNEL;BAC PRO PROD;BAC PRO 25510 METIERS ELECT. ENVIRON. CONNECTES;100;98;85;10;3;1;2;86;0;14;19;31;22;12
3823.0;2021;10;LYON;MASCULIN;APPRENTISSAGE;BAC PROFESSIONNEL;BAC PRO PROD;BAC PRO 25515 SYST.NUM.OPT.C RES.INF.SYST.COMM.;9;9;8;1;0;0;0;8;0;0;3;1;4;1
3827.0;2021;10;LYON;MASCULIN;APPRENTISSAGE;BAC PROFESSIONNEL;BAC PRO PROD;BAC PRO AG 21203 TECHN CONSEIL DE VENTE ANIMAL;1;1;1;0;0;0;0;1;0;0;0;0;1;0
3828.0;2021;10;LYON;MASCULIN;APPRENTISSAGE;BAC PROFESSIONNEL;BAC PRO PROD;BAC PRO AG 21204 PROD-AQUACOLES;2;2;1;1;0;0;0;1;0;0;0;0;1;1
3831.0;2021;10;LYON;MASCULIN;APPRENTISSAGE;BAC PROFESSIONNEL;BAC PRO PROD;BAC PRO AG 22107 TEC CONS VTE ALIMENTATION P.ALIM;2;2;2;0;0;0;0;2;0;0;0;1;1;0
3835.0;2021;10;LYON;MASCULIN;APPRENTISSAGE;BAC PROFESSIONNEL;BAC PRO SERV;BAC PRO 31206 VENTE (PROSPECT.NEGO.SUIV.CLIENT;2;2;1;1;0;0;0;1;0;0;0;0;1;1
3836.0;2021;10;LYON;MASCULIN;APPRENTISSAGE;BAC PROFESSIONNEL;BAC PRO SERV;BAC PRO 31210 ACCUEIL -RELATION CLIENTS USAGERS;12;12;10;1;1;1;0;11;0;2;4;2;3;1
3837.0;2021;10;LYON;MASCULIN;APPRENTISSAGE;BAC PROFESSIONNEL;BAC PRO SERV;BAC PRO 32207 REAL.PR.IMPR.PLURI.OPTA.PR.GRAPH.;1;1;1;0;0;0;0;1;0;0;0;0;1;0
3838.0;2021;10;LYON;MASCULIN;APPRENTISSAGE;BAC PROFESSIONNEL;BAC PRO SERV;BAC PRO 32208 REAL.PR.IMPR.PLURI.OPTB.PR.IMPR.;2;2;2;0;0;0;0;2;0;0;0;2;0;0
3842.0;2021;10;LYON;MASCULIN;APPRENTISSAGE;BAC PROFESSIONNEL;BAC PRO SERV;BAC PRO 34304 HYGIENE PROPRETE STERILISATION;17;15;7;4;4;3;1;10;0;0;2;0;8;5
3855.0;2021;10;LYON;MASCULIN;FORMATION CONTINUE;BAC PROFESSIONNEL;BAC PRO PROD;BAC PRO 25509 TECHNIC. FROID CONDITIONNEMT AIR;3;3;2;1;0;0;0;2;0;0;0;2;0;1
3861.0;2021;10;LYON;MASCULIN;INDIVIDUEL;BAC PROFESSIONNEL;BAC PRO PROD;BAC PRO 22004 PROC. CHIMIE EAU PAPIERS-CARTONS;1;1;0;1;0;0;0;0;0;0;0;0;0;1
3869.0;2021;10;LYON;MASCULIN;INDIVIDUEL;BAC PROFESSIONNEL;BAC PRO PROD;BAC PRO 25214 MAINT.VEHIC.OPTA VOIT.PARTICUL.;3;2;2;0;0;0;0;2;0;0;0;1;1;0
3871.0;2021;10;LYON;MASCULIN;INDIVIDUEL;BAC PROFESSIONNEL;BAC PRO PROD;BAC PRO 25509 TECHNIC. FROID CONDITIONNEMT AIR;1;0;0;0;0;0;0;0;0;0;0;0;0;0
3877.0;2021;10;LYON;MASCULIN;INDIVIDUEL;BAC PROFESSIONNEL;BAC PRO PROD;BAC PRO AG 21302 GEST MILIEUX NATURELS FAUNE;1;1;1;0;0;0;0;1;0;0;0;0;1;0
3879.0;2021;10;LYON;MASCULIN;INDIVIDUEL;BAC PROFESSIONNEL;BAC PRO PROD;BAC PRO AG 22107 TEC CONS VTE ALIMENTATION P.ALIM;3;2;1;1;0;0;0;1;0;0;0;0;1;1
3898.0;2021;10;LYON;MASCULIN;INDIVIDUEL;BAC TECHNOLOGIQUE;BAC STI2D;BAC STI2D SYSTÈME D'INFORMATION  ET NUMERIQUE;5;3;0;2;1;0;1;0;0;0;0;0;0;3
3904.0;2021;10;LYON;MASCULIN;INDIVIDUEL;BAC TECHNOLOGIQUE;BAC STMG;BAC STMG SYSTEMES D'INFORMATION DE GESTION;1;1;0;1;0;0;0;0;0;0;0;0;0;1
3908.0;2021;10;LYON;MASCULIN;SCOLAIRE;BAC PROFESSIONNEL;BAC PRO PROD;BAC PRO 22003 BIO-INDUSTRIES DE TRANSFORMATION;13;13;12;1;0;0;0;12;0;0;1;4;7;1
3910.0;2021;10;LYON;MASCULIN;SCOLAIRE;BAC PROFESSIONNEL;BAC PRO PROD;BAC PRO 22104 BOUCHER CHARCUTIER TRAITEUR;11;11;11;0;0;0;0;11;0;0;5;5;1;0
3911.0;2021;10;LYON;MASCULIN;SCOLAIRE;BAC PROFESSIONNEL;BAC PRO PROD;BAC PRO 22105 BOULANGER-PÂTISSIER;21;21;18;2;1;1;0;19;0;3;6;5;5;2
3921.0;2021;10;LYON;MASCULIN;SCOLAIRE;BAC PROFESSIONNEL;BAC PRO PROD;BACPRO 23103 TECHNICIEN GEOMETRE-TOPOGRAPHE;8;8;6;2;0;0;0;6;0;0;1;2;3;2
3922.0;2021;10;LYON;MASCULIN;SCOLAIRE;BAC PROFESSIONNEL;BAC PRO PROD;BAC PRO 23203 TECHNICIEN BAT. : ORG.REAL.GROS O;14;14;12;2;0;0;0;12;0;0;3;1;8;2
3924.0;2021;10;LYON;MASCULIN;SCOLAIRE;BAC PROFESSIONNEL;BAC PRO PROD;BAC PRO 23304 AMENAGEMENT FINITION BATIMENT;17;17;9;5;3;3;0;12;0;0;1;5;6;5
3927.0;2021;10;LYON;MASCULIN;SCOLAIRE;BAC PROFESSIONNEL;BAC PRO PROD;BAC PRO 23406 TECHNICIEN DE SCIERIE;4;4;4;0;0;0;0;4;0;0;1;1;2;0
3931.0;2021;10;LYON;MASCULIN;SCOLAIRE;BAC PROFESSIONNEL;BAC PRO PROD;BAC PRO 24203 METIERS DE LA MODE - VÊTEMENT;14;12;11;1;0;0;0;11;0;1;1;7;2;1
3933.0;2021;10;LYON;MASCULIN;SCOLAIRE;BAC PROFESSIONNEL;BAC PRO PROD;BAC PRO 25005 PRODUCTIQ.MECA. OPT.DECOLLETAGE;6;6;5;1;0;0;0;5;0;0;2;2;1;1
3939.0;2021;10;LYON;MASCULIN;SCOLAIRE;BAC PROFESSIONNEL;BAC PRO PROD;BAC PRO 25214 MAINT.VEHIC.OPTA VOIT.PARTICUL.;197;197;147;45;5;3;2;150;0;13;44;50;43;47
3940.0;2021;10;LYON;MASCULIN;SCOLAIRE;BAC PROFESSIONNEL;BAC PRO PROD;BAC PRO 25215 MAINT.VEHIC.OPTB VEHIC.TRANS.ROUT;31;31;29;1;1;1;0;30;0;1;4;17;8;1
3942.0;2021;10;LYON;MASCULIN;SCOLAIRE;BAC PROFESSIONNEL;BAC PRO PROD;BAC PRO 25219 MAINT.MATERIELS OPT.A AGRICOLES;28;28;28;0;0;0;0;28;0;5;11;7;5;0
3944.0;2021;10;LYON;MASCULIN;SCOLAIRE;BAC PROFESSIONNEL;BAC PRO PROD;BAC PRO 25406 OUVRAGES DU BATIMENT METALLERIE;32;32;29;3;0;0;0;29;0;0;12;9;8;3
3958.0;2021;10;LYON;MASCULIN;SCOLAIRE;BAC PROFESSIONNEL;BAC PRO PROD;BAC PRO AG 21204 PROD-AQUACOLES;8;8;5;3;0;0;0;5;0;0;1;1;3;3
3960.0;2021;10;LYON;MASCULIN;SCOLAIRE;BAC PROFESSIONNEL;BAC PRO PROD;BAC PRO AG 21211 COND GEST ENTR HIPPIQUE;7;7;7;0;0;0;0;7;0;1;1;3;2;0
3963.0;2021;10;LYON;MASCULIN;SCOLAIRE;BAC PROFESSIONNEL;BAC PRO PROD;BAC PRO AG 21303 FORET;30;28;25;3;0;0;0;25;0;0;3;13;9;3
3964.0;2021;10;LYON;MASCULIN;SCOLAIRE;BAC PROFESSIONNEL;BAC PRO PROD;BAC PRO AG 21405 AMENAGEMENTS PAYSAGERS;105;103;102;1;0;0;0;102;0;1;19;50;32;1
3977.0;2021;10;LYON;MASCULIN;SCOLAIRE;BAC PROFESSIONNEL;BAC PRO SERV;BAC PRO 32303 ART.& MET.ART:COM.VIS.VIS.PLURI-M;45;45;43;2;0;0;0;43;0;2;11;18;12;2
3979.0;2021;10;LYON;MASCULIN;SCOLAIRE;BAC PROFESSIONNEL;BAC PRO SERV;BAC PRO 33002 SERVICES DE PROXIMITE  VIE LOCAL;17;17;13;3;1;1;0;14;0;0;3;5;6;3
3986.0;2021;10;LYON;MASCULIN;SCOLAIRE;BAC PROFESSIONNEL;BAC PRO SERV;BAC PRO 33603 ESTHETIQUE COSMETIQUE PARFUMERIE;1;1;1;0;0;0;0;1;0;0;0;1;0;0
3988.0;2021;10;LYON;MASCULIN;SCOLAIRE;BAC PROFESSIONNEL;BAC PRO SERV;BAC PRO 34403 METIERS DE LA SECURITE;45;45;44;1;0;0;0;44;0;0;15;17;12;1
3993.0;2021;10;LYON;MASCULIN;SCOLAIRE;BAC TECHNOLOGIQUE;BAC STAV;BAC STAV AGRONOMIE ALIM ENV TERRITOI;108;108;106;2;0;0;0;106;0;2;20;57;27;2
3997.0;2021;10;LYON;MASCULIN;SCOLAIRE;BAC TECHNOLOGIQUE;BAC STI2D;BAC STI2D ENERGIES  ET ENVIRONNEMENT;314;314;283;13;18;15;3;298;0;7;51;115;125;16
4000.0;2021;10;LYON;MASCULIN;SCOLAIRE;BAC TECHNOLOGIQUE;BAC STL;BAC STL BIOCHIM.-BIOLOGIE-BIOTECHNOL.;81;81;68;4;9;5;4;73;0;1;10;30;32;8
4002.0;2021;10;LYON;MASCULIN;SCOLAIRE;BAC TECHNOLOGIQUE;BAC STMG;BAC STMG GESTION ET FINANCE;526;526;452;23;51;35;16;487;0;5;47;197;238;39
4003.0;2021;10;LYON;MASCULIN;SCOLAIRE;BAC TECHNOLOGIQUE;BAC STMG;BAC STMG MERCATIQUE (MARKETING);949;948;798;40;110;56;54;854;0;7;55;321;471;94
4006.0;2021;31;MARTINIQUE;FEMININ;APPRENTISSAGE;BAC PROFESSIONNEL;BAC PRO PROD;BAC PRO 22105 BOULANGER-PÂTISSIER;4;4;3;1;0;0;0;3;0;0;0;1;2;1
4014.0;2021;31;MARTINIQUE;FEMININ;ENSEIGNEMENT A DISTANCE;BAC TECHNOLOGIQUE;BAC STMG;BAC STMG RESSOURCES HUMAINES ET COMMUNICATION;1;1;1;0;0;0;0;1;0;0;1;0;0;0
4015.0;2021;31;MARTINIQUE;FEMININ;INDIVIDUEL;BAC GENERAL;BAC GENERAL;BAC GENE 10019 BAC GENERAL;15;10;6;2;2;2;0;8;0;0;1;0;7;2
4016.0;2021;31;MARTINIQUE;FEMININ;INDIVIDUEL;BAC PROFESSIONNEL;BAC PRO SERV;BAC PRO 30001 GESTION-ADMINISTRATION;4;4;4;0;0;0;0;4;0;0;0;1;3;0
4019.0;2021;31;MARTINIQUE;FEMININ;INDIVIDUEL;BAC PROFESSIONNEL;BAC PRO SERV;BAC PRO 33004 ACC.SOINS-S.PERS. OPT.EN STRUCTUR;1;1;1;0;0;0;0;1;0;0;0;0;1;0
4022.0;2021;31;MARTINIQUE;FEMININ;INDIVIDUEL;BAC TECHNOLOGIQUE;BAC STMG;BAC STMG MERCATIQUE (MARKETING);2;1;1;0;0;0;0;1;0;0;0;1;0;0
4023.0;2021;31;MARTINIQUE;FEMININ;INDIVIDUEL;BAC TECHNOLOGIQUE;BAC STMG;BAC STMG RESSOURCES HUMAINES ET COMMUNICATION;1;0;0;0;0;0;0;0;0;0;0;0;0;0
4025.0;2021;31;MARTINIQUE;FEMININ;SCOLAIRE;BAC PROFESSIONNEL;BAC PRO PROD;BAC PRO 22003 BIO-INDUSTRIES DE TRANSFORMATION;11;11;8;2;1;1;0;9;0;0;1;2;6;2
4034.0;2021;31;MARTINIQUE;FEMININ;SCOLAIRE;BAC PROFESSIONNEL;BAC PRO PROD;BAC PRO 23405 TECHNICIEN MENUISIER AGENCEUR;1;1;1;0;0;0;0;1;0;0;1;0;0;0
4037.0;2021;31;MARTINIQUE;FEMININ;SCOLAIRE;BAC PROFESSIONNEL;BAC PRO PROD;BAC PRO 25009 MAINTENANCE NAUTIQUE;1;1;1;0;0;0;0;1;0;0;0;1;0;0
4043.0;2021;31;MARTINIQUE;FEMININ;SCOLAIRE;BAC PROFESSIONNEL;BAC PRO PROD;BAC PRO AG 21001 AGRO-EQUIPEMENT;1;1;1;0;0;0;0;1;0;0;0;0;1;0
4047.0;2021;31;MARTINIQUE;FEMININ;SCOLAIRE;BAC PROFESSIONNEL;BAC PRO PROD;BAC PRO AG 22107 TEC CONS VTE ALIMENTATION P.ALIM;6;5;5;0;0;0;0;5;0;0;0;1;4;0
4050.0;2021;31;MARTINIQUE;FEMININ;SCOLAIRE;BAC PROFESSIONNEL;BAC PRO SERV;BAC PRO 31108 TRANSPORT;3;3;3;0;0;0;0;3;0;0;0;2;1;0
4071.0;2021;31;MARTINIQUE;FEMININ;SCOLAIRE;BAC TECHNOLOGIQUE;BAC STL;BAC STL BIOCHIM.-BIOLOGIE-BIOTECHNOL.;15;15;15;0;0;0;0;15;0;0;5;7;3;0
4074.0;2021;31;MARTINIQUE;FEMININ;SCOLAIRE;BAC TECHNOLOGIQUE;BAC STMG;BAC STMG RESSOURCES HUMAINES ET COMMUNICATION;105;105;93;1;11;11;0;104;0;1;9;40;54;1
4076.0;2021;31;MARTINIQUE;MASCULIN;APPRENTISSAGE;BAC PROFESSIONNEL;BAC PRO PROD;BAC PRO 22105 BOULANGER-PÂTISSIER;6;6;4;2;0;0;0;4;0;0;0;2;2;2
4084.0;2021;31;MARTINIQUE;MASCULIN;APPRENTISSAGE;BAC PROFESSIONNEL;BAC PRO PROD;BAC PRO 25214 MAINT.VEHIC.OPTA VOIT.PARTICUL.;13;11;7;2;2;0;2;7;0;1;1;1;4;4
4086.0;2021;31;MARTINIQUE;MASCULIN;APPRENTISSAGE;BAC PROFESSIONNEL;BAC PRO PROD;BAC PRO 25510 METIERS ELECT. ENVIRON. CONNECTES;10;9;8;0;1;1;0;9;0;0;4;2;3;0
4095.0;2021;31;MARTINIQUE;MASCULIN;INDIVIDUEL;BAC GENERAL;BAC GENERAL;BAC GENE 10019 BAC GENERAL;9;5;1;3;1;1;0;2;0;0;1;0;1;3
4112.0;2021;31;MARTINIQUE;MASCULIN;SCOLAIRE;BAC PROFESSIONNEL;BAC PRO PROD;BAC PRO 22106 CUISINE;28;28;28;0;0;0;0;28;0;2;9;11;6;0
4114.0;2021;31;MARTINIQUE;MASCULIN;SCOLAIRE;BAC PROFESSIONNEL;BAC PRO PROD;BAC PRO 22704 TECHN. MAINT. SYST.ENERG.CLIMATI;16;16;11;3;2;2;0;13;0;0;1;5;7;3
4117.0;2021;31;MARTINIQUE;MASCULIN;SCOLAIRE;BAC PROFESSIONNEL;BAC PRO PROD;BAC PRO 23005 TECHN. ETUDES BAT B ASSIST.ARCHI.;21;21;15;3;3;3;0;18;0;0;2;5;11;3
4118.0;2021;31;MARTINIQUE;MASCULIN;SCOLAIRE;BAC PROFESSIONNEL;BAC PRO PROD;BAC PRO 23102 TRAVAUX PUBLICS;11;11;8;0;3;2;1;10;0;0;1;3;6;1
4129.0;2021;31;MARTINIQUE;MASCULIN;SCOLAIRE;BAC PROFESSIONNEL;BAC PRO PROD;BAC PRO 25106 TECHNICIEN D'USINAGE;22;22;13;6;3;3;0;16;0;0;0;5;11;6
4131.0;2021;31;MARTINIQUE;MASCULIN;SCOLAIRE;BAC PROFESSIONNEL;BAC PRO PROD;BAC PRO 25219 MAINT.MATERIELS OPT.A AGRICOLES;5;5;4;1;0;0;0;4;0;0;1;1;2;1
4133.0;2021;31;MARTINIQUE;MASCULIN;SCOLAIRE;BAC PROFESSIONNEL;BAC PRO PROD;BAC PRO 25406 OUVRAGES DU BATIMENT METALLERIE;11;11;5;3;3;3;0;8;0;0;0;0;8;3
4134.0;2021;31;MARTINIQUE;MASCULIN;SCOLAIRE;BAC PROFESSIONNEL;BAC PRO PROD;BAC PRO 25408 REPARATION DES CARROSSERIES;18;18;12;1;5;3;2;15;0;0;0;10;5;3
4142.0;2021;31;MARTINIQUE;MASCULIN;SCOLAIRE;BAC PROFESSIONNEL;BAC PRO PROD;BAC PRO AG 21004 CGEA;6;6;6;0;0;0;0;6;0;0;0;4;2;0
4150.0;2021;31;MARTINIQUE;MASCULIN;SCOLAIRE;BAC PROFESSIONNEL;BAC PRO SERV;BAC PRO 31206 VENTE (PROSPECT.NEGO.SUIV.CLIENT;46;46;34;8;4;4;0;38;0;0;4;12;22;8
4155.0;2021;31;MARTINIQUE;MASCULIN;SCOLAIRE;BAC PROFESSIONNEL;BAC PRO SERV;BAC PRO 33004 ACC.SOINS-S.PERS. OPT.EN STRUCTUR;11;11;9;1;1;1;0;10;0;0;0;6;4;1
4162.0;2021;31;MARTINIQUE;MASCULIN;SCOLAIRE;BAC TECHNOLOGIQUE;BAC STD2A;BAC STD2A SCIENCES & TECHNO. DESIGN-ARTS APPLIQUES;5;5;5;0;0;0;0;5;0;0;1;2;2;0
4170.0;2021;31;MARTINIQUE;MASCULIN;SCOLAIRE;BAC TECHNOLOGIQUE;BAC STMG;BAC STMG MERCATIQUE (MARKETING);90;90;81;1;8;7;1;88;0;1;4;25;58;2
4174.0;2021;43;MAYOTTE;FEMININ;APPRENTISSAGE;BAC PROFESSIONNEL;BAC PRO SERV;BAC PRO 31106 LOGISTIQUE;4;4;2;1;1;1;0;3;0;0;0;0;3;1
4180.0;2021;43;MAYOTTE;FEMININ;INDIVIDUEL;BAC PROFESSIONNEL;BAC PRO SERV;BAC PRO 31210 ACCUEIL -RELATION CLIENTS USAGERS;5;4;2;1;1;0;1;2;0;0;0;0;2;2
4195.0;2021;43;MAYOTTE;FEMININ;SCOLAIRE;BAC PROFESSIONNEL;BAC PRO PROD;BAC PRO 25514 SYST.NUM.OPT.B AUD.RES.EQUIP.DOM.;2;2;2;0;0;0;0;2;0;0;0;0;2;0
4198.0;2021;43;MAYOTTE;FEMININ;SCOLAIRE;BAC PROFESSIONNEL;BAC PRO SERV;BAC PRO 30001 GESTION-ADMINISTRATION;127;127;86;19;22;22;0;108;0;0;6;32;70;19
4204.0;2021;43;MAYOTTE;FEMININ;SCOLAIRE;BAC PROFESSIONNEL;BAC PRO SERV;BAC PRO 32303 ART.& MET.ART:COM.VIS.VIS.PLURI-M;3;3;3;0;0;0;0;3;0;0;0;3;0;0
4205.0;2021;43;MAYOTTE;FEMININ;SCOLAIRE;BAC PROFESSIONNEL;BAC PRO SERV;BAC PRO 33002 SERVICES DE PROXIMITE  VIE LOCAL;36;36;13;16;7;4;3;17;0;0;0;2;15;19
4207.0;2021;43;MAYOTTE;FEMININ;SCOLAIRE;BAC PROFESSIONNEL;BAC PRO SERV;BAC PRO 33004 ACC.SOINS-S.PERS. OPT.EN STRUCTUR;12;12;9;0;3;1;2;10;0;0;0;3;7;2
4210.0;2021;43;MAYOTTE;FEMININ;SCOLAIRE;BAC PROFESSIONNEL;BAC PRO SERV;BAC PRO AG 33002 SERV PERS TERRIT;24;24;24;0;0;0;0;24;0;0;5;7;12;0
4212.0;2021;43;MAYOTTE;FEMININ;SCOLAIRE;BAC TECHNOLOGIQUE;BAC STD2A;BAC STD2A SCIENCES & TECHNO. DESIGN-ARTS APPLIQUES;18;18;13;0;5;2;3;15;0;0;0;4;11;3
4215.0;2021;43;MAYOTTE;FEMININ;SCOLAIRE;BAC TECHNOLOGIQUE;BAC STI2D;BAC STI2D ENERGIES  ET ENVIRONNEMENT;23;23;14;3;6;2;4;16;0;0;0;3;13;7
4219.0;2021;43;MAYOTTE;FEMININ;SCOLAIRE;BAC TECHNOLOGIQUE;BAC STMG;BAC STMG GESTION ET FINANCE;144;144;69;22;53;23;30;92;0;0;2;16;74;52
4226.0;2021;43;MAYOTTE;MASCULIN;INDIVIDUEL;BAC PROFESSIONNEL;BAC PRO PROD;BAC PRO 23005 TECHN. ETUDES BAT B ASSIST.ARCHI.;1;0;0;0;0;0;0;0;0;0;0;0;0;0
4227.0;2021;43;MAYOTTE;MASCULIN;INDIVIDUEL;BAC PROFESSIONNEL;BAC PRO PROD;BAC PRO 23405 TECHNICIEN MENUISIER AGENCEUR;1;1;0;1;0;0;0;0;0;0;0;0;0;1
4234.0;2021;43;MAYOTTE;MASCULIN;INDIVIDUEL;BAC TECHNOLOGIQUE;BAC STI2D;BAC STI2D INNOVATION TECHNO.  ET ECO CONCEPTION;1;1;0;1;0;0;0;0;0;0;0;0;0;1
4245.0;2021;43;MAYOTTE;MASCULIN;SCOLAIRE;BAC PROFESSIONNEL;BAC PRO PROD;BACPRO 23103 TECHNICIEN GEOMETRE-TOPOGRAPHE;13;13;3;8;2;2;0;5;0;0;0;0;5;8
4249.0;2021;43;MAYOTTE;MASCULIN;SCOLAIRE;BAC PROFESSIONNEL;BAC PRO PROD;BAC PRO 23405 TECHNICIEN MENUISIER AGENCEUR;15;15;3;7;5;3;2;6;0;0;0;0;6;9
4250.0;2021;43;MAYOTTE;MASCULIN;SCOLAIRE;BAC PROFESSIONNEL;BAC PRO PROD;BAC PRO 23408 Etude et réalisation d'agencement;8;8;5;2;1;1;0;6;0;0;0;3;3;2
4253.0;2021;43;MAYOTTE;MASCULIN;SCOLAIRE;BAC PROFESSIONNEL;BAC PRO PROD;BAC PRO 25214 MAINT.VEHIC.OPTA VOIT.PARTICUL.;45;45;21;23;1;1;0;22;0;0;0;7;15;23
4255.0;2021;43;MAYOTTE;MASCULIN;SCOLAIRE;BAC PROFESSIONNEL;BAC PRO PROD;BAC PRO 25221 MAINT.MATERIELS OPT.C ESP. VERTS;9;9;2;6;1;1;0;3;0;0;0;1;2;6
4259.0;2021;43;MAYOTTE;MASCULIN;SCOLAIRE;BAC PROFESSIONNEL;BAC PRO PROD;BAC PRO 25514 SYST.NUM.OPT.B AUD.RES.EQUIP.DOM.;13;13;10;2;1;1;0;11;0;0;0;2;9;2
4260.0;2021;43;MAYOTTE;MASCULIN;SCOLAIRE;BAC PROFESSIONNEL;BAC PRO PROD;BAC PRO 25515 SYST.NUM.OPT.C RES.INF.SYST.COMM.;13;13;7;3;3;2;1;9;0;0;0;2;7;4
4262.0;2021;43;MAYOTTE;MASCULIN;SCOLAIRE;BAC PROFESSIONNEL;BAC PRO PROD;BAC PRO AG 21114 CONDUITE PRODUCTIONS HORTICOLES;7;7;7;0;0;0;0;7;0;0;0;2;5;0
4265.0;2021;43;MAYOTTE;MASCULIN;SCOLAIRE;BAC PROFESSIONNEL;BAC PRO SERV;BAC PRO 31108 TRANSPORT;38;38;20;3;15;5;10;25;0;0;1;6;18;13
4285.0;2021;43;MAYOTTE;MASCULIN;SCOLAIRE;BAC TECHNOLOGIQUE;BAC STMG;BAC STMG MERCATIQUE (MARKETING);158;158;75;29;54;36;18;111;0;0;3;17;91;47
4286.0;2021;43;MAYOTTE;MASCULIN;SCOLAIRE;BAC TECHNOLOGIQUE;BAC STMG;BAC STMG RESSOURCES HUMAINES ET COMMUNICATION;139;139;69;28;42;27;15;96;0;0;2;14;80;43
4289.0;2021;11;MONTPELLIER;FEMININ;APPRENTISSAGE;BAC PROFESSIONNEL;BAC PRO PROD;BAC PRO 24303 MET. DU CUIR: SELLERIE GARNISSAGE;3;3;3;0;0;0;0;3;0;3;0;0;0;0
4290.0;2021;11;MONTPELLIER;FEMININ;APPRENTISSAGE;BAC PROFESSIONNEL;BAC PRO PROD;BAC PRO 25214 MAINT.VEHIC.OPTA VOIT.PARTICUL.;4;3;3;0;0;0;0;3;0;0;3;0;0;0
4291.0;2021;11;MONTPELLIER;FEMININ;APPRENTISSAGE;BAC PROFESSIONNEL;BAC PRO PROD;BAC PRO 25215 MAINT.VEHIC.OPTB VEHIC.TRANS.ROUT;1;1;1;0;0;0;0;1;0;0;0;0;1;0
4301.0;2021;11;MONTPELLIER;FEMININ;APPRENTISSAGE;BAC PROFESSIONNEL;BAC PRO SERV;BAC PRO 31202 COMMERCE;18;17;17;0;0;0;0;17;0;0;5;8;4;0
4305.0;2021;11;MONTPELLIER;FEMININ;APPRENTISSAGE;BAC PROFESSIONNEL;BAC PRO SERV;BAC PRO 33603 ESTHETIQUE COSMETIQUE PARFUMERIE;1;1;0;1;0;0;0;0;0;0;0;0;0;1
4315.0;2021;11;MONTPELLIER;FEMININ;ENSEIGNEMENT A DISTANCE;BAC TECHNOLOGIQUE;BAC STMG;BAC STMG MERCATIQUE (MARKETING);15;15;13;1;1;0;1;13;0;0;6;5;2;2
4317.0;2021;11;MONTPELLIER;FEMININ;FORMATION CONTINUE;BAC PROFESSIONNEL;BAC PRO PROD;BAC PRO 25214 MAINT.VEHIC.OPTA VOIT.PARTICUL.;1;1;1;0;0;0;0;1;0;1;0;0;0;0
4337.0;2021;11;MONTPELLIER;FEMININ;INDIVIDUEL;BAC PROFESSIONNEL;BAC PRO SERV;BAC PRO 33403 COMMERC. SERVICES EN RESTAURATION;2;0;0;0;0;0;0;0;0;0;0;0;0;0
4340.0;2021;11;MONTPELLIER;FEMININ;INDIVIDUEL;BAC TECHNOLOGIQUE;BAC S2TMD;BAC S2TMD MUSIQUE;1;1;0;0;1;1;0;1;0;0;0;0;1;0
4344.0;2021;11;MONTPELLIER;FEMININ;INDIVIDUEL;BAC TECHNOLOGIQUE;BAC STMG;BAC STMG MERCATIQUE (MARKETING);12;6;5;1;0;0;0;5;0;0;1;1;3;1
4348.0;2021;11;MONTPELLIER;FEMININ;SCOLAIRE;BAC PROFESSIONNEL;BAC PRO PROD;BAC PRO 22004 PROC. CHIMIE EAU PAPIERS-CARTONS;6;6;5;1;0;0;0;5;0;2;1;1;1;1
4350.0;2021;11;MONTPELLIER;FEMININ;SCOLAIRE;BAC PROFESSIONNEL;BAC PRO PROD;BAC PRO 22106 CUISINE;50;50;46;2;2;2;0;48;0;5;11;20;12;2
4351.0;2021;11;MONTPELLIER;FEMININ;SCOLAIRE;BAC PROFESSIONNEL;BAC PRO PROD;BAC PRO 22403 ARTS.& MET.ART:MET.ENSEIGN SIGNA;4;4;3;1;0;0;0;3;0;2;0;1;0;1
4352.0;2021;11;MONTPELLIER;FEMININ;SCOLAIRE;BAC PROFESSIONNEL;BAC PRO PROD;BAC PRO 22503 PLASTIQUES ET COMPOSITES;4;4;4;0;0;0;0;4;0;0;0;2;2;0
4353.0;2021;11;MONTPELLIER;FEMININ;SCOLAIRE;BAC PROFESSIONNEL;BAC PRO PROD;BAC PRO 23003 ARTIS. & M.ART:MARCHANDISAGE VIS.;11;11;11;0;0;0;0;11;0;0;4;6;1;0
4357.0;2021;11;MONTPELLIER;FEMININ;SCOLAIRE;BAC PROFESSIONNEL;BAC PRO PROD;BAC PRO 23303 MENUISERIE ALUMINIUM-VERRE;1;1;0;1;0;0;0;0;0;0;0;0;0;1
4362.0;2021;11;MONTPELLIER;FEMININ;SCOLAIRE;BAC PROFESSIONNEL;BAC PRO PROD;BAC PRO 24202 ARTIS.& MET.ART : TAPIS.D'AMEUBL;11;11;10;0;1;1;0;11;0;2;2;3;4;0
4363.0;2021;11;MONTPELLIER;FEMININ;SCOLAIRE;BAC PROFESSIONNEL;BAC PRO PROD;BAC PRO 24203 METIERS DE LA MODE - VÊTEMENT;115;115;95;17;3;3;0;98;0;7;17;41;33;17
4369.0;2021;11;MONTPELLIER;FEMININ;SCOLAIRE;BAC PROFESSIONNEL;BAC PRO PROD;BAC PRO 25106 TECHNICIEN D'USINAGE;5;5;5;0;0;0;0;5;0;0;2;2;1;0
4371.0;2021;11;MONTPELLIER;FEMININ;SCOLAIRE;BAC PROFESSIONNEL;BAC PRO PROD;BAC PRO 25216 MAINT.VEHIC.OPTC MOTOCYCLES;2;2;1;1;0;0;0;1;0;0;1;0;0;1
4374.0;2021;11;MONTPELLIER;FEMININ;SCOLAIRE;BAC PROFESSIONNEL;BAC PRO PROD;BAC PRO 25303 AERONAUTIQUE OPTION SYSTEMES;1;1;1;0;0;0;0;1;0;0;0;1;0;0
4379.0;2021;11;MONTPELLIER;FEMININ;SCOLAIRE;BAC PROFESSIONNEL;BAC PRO PROD;BAC PRO 25515 SYST.NUM.OPT.C RES.INF.SYST.COMM.;8;8;7;0;1;1;0;8;0;0;1;3;4;0
4380.0;2021;11;MONTPELLIER;FEMININ;SCOLAIRE;BAC PROFESSIONNEL;BAC PRO PROD;BAC PRO AG 21004 CGEA;39;39;35;4;0;0;0;35;0;1;4;11;19;4
4385.0;2021;11;MONTPELLIER;FEMININ;SCOLAIRE;BAC PROFESSIONNEL;BAC PRO PROD;BAC PRO AG 21210 COND GEST ENTR CANIN ET FELIN;33;33;32;1;0;0;0;32;0;0;6;8;18;1
4390.0;2021;11;MONTPELLIER;FEMININ;SCOLAIRE;BAC PROFESSIONNEL;BAC PRO PROD;BAC PRO AG 22107 TEC CONS VTE ALIMENTATION P.ALIM;14;12;9;3;0;0;0;9;0;0;0;1;8;3
4393.0;2021;11;MONTPELLIER;FEMININ;SCOLAIRE;BAC PROFESSIONNEL;BAC PRO SERV;BAC PRO 31107 CONDUCT. TRANSP.ROUT.MARCHANDISES;3;3;2;1;0;0;0;2;0;0;1;0;1;1
4395.0;2021;11;MONTPELLIER;FEMININ;SCOLAIRE;BAC PROFESSIONNEL;BAC PRO SERV;BAC PRO 31202 COMMERCE;393;392;339;22;31;21;10;360;0;30;102;103;125;32
4397.0;2021;11;MONTPELLIER;FEMININ;SCOLAIRE;BAC PROFESSIONNEL;BAC PRO SERV;BAC PRO 31210 ACCUEIL -RELATION CLIENTS USAGERS;195;195;170;14;11;3;8;173;0;17;45;54;57;22
4398.0;2021;11;MONTPELLIER;FEMININ;SCOLAIRE;BAC PROFESSIONNEL;BAC PRO SERV;BAC PRO 32207 REAL.PR.IMPR.PLURI.OPTA.PR.GRAPH.;5;5;5;0;0;0;0;5;0;0;2;1;2;0
4405.0;2021;11;MONTPELLIER;FEMININ;SCOLAIRE;BAC PROFESSIONNEL;BAC PRO SERV;BAC PRO 33101 OPTIQUE LUNETTERIE;5;5;5;0;0;0;0;5;0;0;2;2;1;0
4416.0;2021;11;MONTPELLIER;FEMININ;SCOLAIRE;BAC TECHNOLOGIQUE;BAC STD2A;BAC STD2A SCIENCES & TECHNO. DESIGN-ARTS APPLIQUES;107;107;107;0;0;0;0;107;1;7;27;49;23;0
4418.0;2021;11;MONTPELLIER;FEMININ;SCOLAIRE;BAC TECHNOLOGIQUE;BAC STI2D;BAC STI2D ARCHITECTURE ET CONSTRUCTION;47;47;43;1;3;0;3;43;0;5;11;17;10;4
4427.0;2021;11;MONTPELLIER;FEMININ;SCOLAIRE;BAC TECHNOLOGIQUE;BAC STMG;BAC STMG SYSTEMES D'INFORMATION DE GESTION;13;13;10;2;1;1;0;11;0;0;1;2;8;2
4432.0;2021;11;MONTPELLIER;MASCULIN;APPRENTISSAGE;BAC PROFESSIONNEL;BAC PRO PROD;BAC PRO 22704 TECHN. MAINT. SYST.ENERG.CLIMATI;3;3;3;0;0;0;0;3;0;0;1;2;0;0
4444.0;2021;11;MONTPELLIER;MASCULIN;APPRENTISSAGE;BAC PROFESSIONNEL;BAC PRO PROD;BAC PRO 25302 AERONAUTIQUE OPTION AVIONIQUE;4;4;4;0;0;0;0;4;0;0;3;0;1;0
4445.0;2021;11;MONTPELLIER;MASCULIN;APPRENTISSAGE;BAC PROFESSIONNEL;BAC PRO PROD;BAC PRO 25303 AERONAUTIQUE OPTION SYSTEMES;10;10;10;0;0;0;0;10;0;1;3;4;2;0
4446.0;2021;11;MONTPELLIER;MASCULIN;APPRENTISSAGE;BAC PROFESSIONNEL;BAC PRO PROD;BAC PRO 25408 REPARATION DES CARROSSERIES;23;23;19;4;0;0;0;19;0;0;7;4;8;4
4449.0;2021;11;MONTPELLIER;MASCULIN;APPRENTISSAGE;BAC PROFESSIONNEL;BAC PRO PROD;BAC PRO 25515 SYST.NUM.OPT.C RES.INF.SYST.COMM.;14;12;6;3;3;2;1;8;0;0;2;3;3;4
4453.0;2021;11;MONTPELLIER;MASCULIN;APPRENTISSAGE;BAC PROFESSIONNEL;BAC PRO PROD;BAC PRO AG 21203 TECHN CONSEIL DE VENTE ANIMAL;3;3;3;0;0;0;0;3;0;0;1;2;0;0
4460.0;2021;11;MONTPELLIER;MASCULIN;APPRENTISSAGE;BAC PROFESSIONNEL;BAC PRO SERV;BAC PRO 31206 VENTE (PROSPECT.NEGO.SUIV.CLIENT;1;1;1;0;0;0;0;1;0;0;1;0;0;0
4470.0;2021;11;MONTPELLIER;MASCULIN;ENSEIGNEMENT A DISTANCE;BAC TECHNOLOGIQUE;BAC ST2S;BAC ST2S SCIENCES & TECHNO. SANTE & SOCIAL;1;1;1;0;0;0;0;1;0;0;0;1;0;0
4482.0;2021;11;MONTPELLIER;MASCULIN;FORMATION CONTINUE;BAC PROFESSIONNEL;BAC PRO PROD;BAC PRO 25509 TECHNIC. FROID CONDITIONNEMT AIR;7;7;4;2;1;1;0;5;0;0;3;0;2;2
4483.0;2021;11;MONTPELLIER;MASCULIN;FORMATION CONTINUE;BAC PROFESSIONNEL;BAC PRO PROD;BAC PRO 25510 METIERS ELECT. ENVIRON. CONNECTES;24;24;20;3;1;1;0;21;0;8;8;2;3;3
4496.0;2021;11;MONTPELLIER;MASCULIN;INDIVIDUEL;BAC PROFESSIONNEL;BAC PRO PROD;BAC PRO 25411 TECH.CHAUDRONNERIE INDUSTRIELLE;1;1;1;0;0;0;0;1;0;0;0;1;0;0
4500.0;2021;11;MONTPELLIER;MASCULIN;INDIVIDUEL;BAC PROFESSIONNEL;BAC PRO PROD;BAC PRO AG 21114 CONDUITE PRODUCTIONS HORTICOLES;4;3;3;0;0;0;0;3;0;0;0;0;3;0
4502.0;2021;11;MONTPELLIER;MASCULIN;INDIVIDUEL;BAC PROFESSIONNEL;BAC PRO SERV;BAC PRO 30001 GESTION-ADMINISTRATION;7;4;2;2;0;0;0;2;0;0;0;0;2;2
4506.0;2021;11;MONTPELLIER;MASCULIN;INDIVIDUEL;BAC PROFESSIONNEL;BAC PRO SERV;BAC PRO 33102 PROTHESE DENTAIRE;1;1;0;1;0;0;0;0;0;0;0;0;0;1
4509.0;2021;11;MONTPELLIER;MASCULIN;INDIVIDUEL;BAC TECHNOLOGIQUE;BAC S2TMD;BAC S2TMD MUSIQUE;1;1;1;0;0;0;0;1;0;0;0;1;0;0
4513.0;2021;11;MONTPELLIER;MASCULIN;INDIVIDUEL;BAC TECHNOLOGIQUE;BAC STI2D;BAC STI2D ENERGIES  ET ENVIRONNEMENT;2;0;0;0;0;0;0;0;0;0;0;0;0;0
4514.0;2021;11;MONTPELLIER;MASCULIN;INDIVIDUEL;BAC TECHNOLOGIQUE;BAC STI2D;BAC STI2D INNOVATION TECHNO.  ET ECO CONCEPTION;1;1;0;1;0;0;0;0;0;0;0;0;0;1
4524.0;2021;11;MONTPELLIER;MASCULIN;SCOLAIRE;BAC PROFESSIONNEL;BAC PRO PROD;BAC PRO 22004 PROC. CHIMIE EAU PAPIERS-CARTONS;26;26;24;2;0;0;0;24;0;2;6;7;9;2
4534.0;2021;11;MONTPELLIER;MASCULIN;SCOLAIRE;BAC PROFESSIONNEL;BAC PRO PROD;BAC PRO 23102 TRAVAUX PUBLICS;37;37;30;5;2;1;1;31;0;2;2;14;13;6
4541.0;2021;11;MONTPELLIER;MASCULIN;SCOLAIRE;BAC PROFESSIONNEL;BAC PRO PROD;BAC PRO 23404 TECHNICIEN CONSTRUCTEUR BOIS;26;26;17;5;4;1;3;18;0;0;1;8;9;8
4544.0;2021;11;MONTPELLIER;MASCULIN;SCOLAIRE;BAC PROFESSIONNEL;BAC PRO PROD;BAC PRO 24202 ARTIS.& MET.ART : TAPIS.D'AMEUBL;2;2;2;0;0;0;0;2;0;0;0;0;2;0
4556.0;2021;11;MONTPELLIER;MASCULIN;SCOLAIRE;BAC PROFESSIONNEL;BAC PRO PROD;BAC PRO 25220 MAINT.MATERIELS OPT.B TP MANUT.;22;22;18;1;3;3;0;21;0;0;3;8;10;1
4560.0;2021;11;MONTPELLIER;MASCULIN;SCOLAIRE;BAC PROFESSIONNEL;BAC PRO PROD;BAC PRO 25408 REPARATION DES CARROSSERIES;29;29;22;4;3;0;3;22;0;1;4;3;14;7
4568.0;2021;11;MONTPELLIER;MASCULIN;SCOLAIRE;BAC PROFESSIONNEL;BAC PRO PROD;BAC PRO AG 21004 CGEA;44;44;41;3;0;0;0;41;0;1;3;18;19;3
4588.0;2021;11;MONTPELLIER;MASCULIN;SCOLAIRE;BAC PROFESSIONNEL;BAC PRO SERV;BAC PRO 32207 REAL.PR.IMPR.PLURI.OPTA.PR.GRAPH.;8;8;7;1;0;0;0;7;0;0;1;4;2;1
4593.0;2021;11;MONTPELLIER;MASCULIN;SCOLAIRE;BAC PROFESSIONNEL;BAC PRO SERV;BAC PRO 33003 ACC.SOINS-S.PERS. OPT.A DOMICILE;13;13;11;1;1;1;0;12;0;1;2;3;6;1
4599.0;2021;11;MONTPELLIER;MASCULIN;SCOLAIRE;BAC PROFESSIONNEL;BAC PRO SERV;BAC PRO 34403 METIERS DE LA SECURITE;141;141;132;5;4;3;1;135;0;6;32;51;46;6
4601.0;2021;11;MONTPELLIER;MASCULIN;SCOLAIRE;BAC TECHNOLOGIQUE;BAC S2TMD;BAC S2TMD MUSIQUE;4;4;4;0;0;0;0;4;0;0;1;1;2;0
4603.0;2021;11;MONTPELLIER;MASCULIN;SCOLAIRE;BAC TECHNOLOGIQUE;BAC STAV;BAC STAV AGRONOMIE ALIM ENV TERRITOI;129;129;127;2;0;0;0;127;0;1;18;68;40;2
4608.0;2021;11;MONTPELLIER;MASCULIN;SCOLAIRE;BAC TECHNOLOGIQUE;BAC STI2D;BAC STI2D INNOVATION TECHNO.  ET ECO CONCEPTION;253;253;228;7;18;10;8;238;0;5;43;72;118;15
4611.0;2021;11;MONTPELLIER;MASCULIN;SCOLAIRE;BAC TECHNOLOGIQUE;BAC STL;BAC STL SCIENCES PHYSIQUES CHIMIQUES  EN LABORAT.;57;57;51;3;3;1;2;52;1;3;6;22;20;5
4612.0;2021;11;MONTPELLIER;MASCULIN;SCOLAIRE;BAC TECHNOLOGIQUE;BAC STMG;BAC STMG GESTION ET FINANCE;386;386;326;22;38;18;20;344;0;5;43;118;178;42
4616.0;2021;12;NANCY-METZ;FEMININ;APPRENTISSAGE;BAC PROFESSIONNEL;BAC PRO PROD;BAC PRO 20102 PILOTE DE LIGNE DE PRODUCTION;2;1;1;0;0;0;0;1;0;0;0;1;0;0
4620.0;2021;12;NANCY-METZ;FEMININ;APPRENTISSAGE;BAC PROFESSIONNEL;BAC PRO PROD;BAC PRO 25107 TECHNICIEN OUTILLEUR;1;1;1;0;0;0;0;1;0;0;0;1;0;0
4630.0;2021;12;NANCY-METZ;FEMININ;APPRENTISSAGE;BAC PROFESSIONNEL;BAC PRO PROD;BAC PRO AG 21303 FORET;2;2;2;0;0;0;0;2;0;0;0;2;0;0
4632.0;2021;12;NANCY-METZ;FEMININ;APPRENTISSAGE;BAC PROFESSIONNEL;BAC PRO PROD;BAC PRO AG 22107 TEC CONS VTE ALIMENTATION P.ALIM;1;1;1;0;0;0;0;1;0;0;1;0;0;0
4634.0;2021;12;NANCY-METZ;FEMININ;APPRENTISSAGE;BAC PROFESSIONNEL;BAC PRO SERV;BAC PRO 31106 LOGISTIQUE;1;1;1;0;0;0;0;1;0;0;1;0;0;0
4645.0;2021;12;NANCY-METZ;FEMININ;FORMATION CONTINUE;BAC PROFESSIONNEL;BAC PRO PROD;BAC PRO 24202 ARTIS.& MET.ART : TAPIS.D'AMEUBL;1;1;1;0;0;0;0;1;0;1;0;0;0;0
4648.0;2021;12;NANCY-METZ;FEMININ;FORMATION CONTINUE;BAC PROFESSIONNEL;BAC PRO PROD;BAC PRO 25214 MAINT.VEHIC.OPTA VOIT.PARTICUL.;2;2;2;0;0;0;0;2;0;1;1;0;0;0
4650.0;2021;12;NANCY-METZ;FEMININ;FORMATION CONTINUE;BAC PROFESSIONNEL;BAC PRO PROD;BAC PRO AG 22107 TEC CONS VTE ALIMENTATION P.ALIM;9;8;7;1;0;0;0;7;0;2;1;2;2;1
4657.0;2021;12;NANCY-METZ;FEMININ;FORMATION CONTINUE;BAC PROFESSIONNEL;BAC PRO SERV;BAC PRO 33102 PROTHESE DENTAIRE;8;8;8;0;0;0;0;8;0;1;3;2;2;0
4660.0;2021;12;NANCY-METZ;FEMININ;INDIVIDUEL;BAC GENERAL;BAC GENERAL;BAC GENE 10019 BAC GENERAL;47;33;10;14;9;5;4;15;0;1;0;3;11;18
4662.0;2021;12;NANCY-METZ;FEMININ;INDIVIDUEL;BAC PROFESSIONNEL;BAC PRO PROD;BAC PRO 24203 METIERS DE LA MODE - VÊTEMENT;1;0;0;0;0;0;0;0;0;0;0;0;0;0
4664.0;2021;12;NANCY-METZ;FEMININ;INDIVIDUEL;BAC PROFESSIONNEL;BAC PRO PROD;BAC PRO AG 21211 COND GEST ENTR HIPPIQUE;1;1;1;0;0;0;0;1;0;0;0;0;1;0
4665.0;2021;12;NANCY-METZ;FEMININ;INDIVIDUEL;BAC PROFESSIONNEL;BAC PRO SERV;BAC PRO 30001 GESTION-ADMINISTRATION;10;8;3;2;3;2;1;5;0;1;0;1;3;3
4669.0;2021;12;NANCY-METZ;FEMININ;INDIVIDUEL;BAC PROFESSIONNEL;BAC PRO SERV;BAC PRO 33004 ACC.SOINS-S.PERS. OPT.EN STRUCTUR;6;3;1;2;0;0;0;1;0;0;0;1;0;2
4680.0;2021;12;NANCY-METZ;FEMININ;SCOLAIRE;BAC PROFESSIONNEL;BAC PRO PROD;BAC PRO 20102 PILOTE DE LIGNE DE PRODUCTION;3;3;2;1;0;0;0;2;0;0;1;0;1;1
4690.0;2021;12;NANCY-METZ;FEMININ;SCOLAIRE;BAC PROFESSIONNEL;BAC PRO PROD;BAC PRO 23208 METIERS ET ARTS DE LA PIERRE;2;2;2;0;0;0;0;2;0;0;0;1;1;0
4693.0;2021;12;NANCY-METZ;FEMININ;SCOLAIRE;BAC PROFESSIONNEL;BAC PRO PROD;BAC PRO 23407 TECHNIC.FAB.BOIS ET MATERX ASSOC;2;2;2;0;0;0;0;2;0;0;2;0;0;0
4698.0;2021;12;NANCY-METZ;FEMININ;SCOLAIRE;BAC PROFESSIONNEL;BAC PRO PROD;BAC PRO 25214 MAINT.VEHIC.OPTA VOIT.PARTICUL.;7;7;6;1;0;0;0;6;0;0;2;3;1;1
4703.0;2021;12;NANCY-METZ;FEMININ;SCOLAIRE;BAC PROFESSIONNEL;BAC PRO PROD;BAC PRO 25411 TECH.CHAUDRONNERIE INDUSTRIELLE;3;3;2;1;0;0;0;2;0;0;0;2;0;1
4708.0;2021;12;NANCY-METZ;FEMININ;SCOLAIRE;BAC PROFESSIONNEL;BAC PRO PROD;BAC PRO AG 21001 AGRO-EQUIPEMENT;1;1;1;0;0;0;0;1;0;0;0;0;1;0
4709.0;2021;12;NANCY-METZ;FEMININ;SCOLAIRE;BAC PROFESSIONNEL;BAC PRO PROD;BAC PRO AG 21004 CGEA;21;20;18;2;0;0;0;18;0;0;1;8;9;2
4713.0;2021;12;NANCY-METZ;FEMININ;SCOLAIRE;BAC PROFESSIONNEL;BAC PRO PROD;BAC PRO AG 21302 GEST MILIEUX NATURELS FAUNE;13;12;12;0;0;0;0;12;0;0;3;3;6;0
4726.0;2021;12;NANCY-METZ;FEMININ;SCOLAIRE;BAC PROFESSIONNEL;BAC PRO SERV;BAC PRO 32303 ART.& MET.ART:COM.VIS.VIS.PLURI-M;15;15;15;0;0;0;0;15;0;0;2;10;3;0
4727.0;2021;12;NANCY-METZ;FEMININ;SCOLAIRE;BAC PROFESSIONNEL;BAC PRO SERV;BAC PRO 32304 PHOTOGRAPHIE;10;10;10;0;0;0;0;10;0;2;2;3;3;0
4746.0;2021;12;NANCY-METZ;FEMININ;SCOLAIRE;BAC TECHNOLOGIQUE;BAC STI2D;BAC STI2D INNOVATION TECHNO.  ET ECO CONCEPTION;33;33;31;0;2;0;2;31;0;1;8;12;10;2
4749.0;2021;12;NANCY-METZ;FEMININ;SCOLAIRE;BAC TECHNOLOGIQUE;BAC STL;BAC STL SCIENCES PHYSIQUES CHIMIQUES  EN LABORAT.;104;104;101;2;1;0;1;101;0;5;16;44;36;3
4752.0;2021;12;NANCY-METZ;FEMININ;SCOLAIRE;BAC TECHNOLOGIQUE;BAC STMG;BAC STMG RESSOURCES HUMAINES ET COMMUNICATION;423;423;376;4;43;25;18;401;0;4;63;166;168;22
4754.0;2021;12;NANCY-METZ;MASCULIN;APPRENTISSAGE;BAC PROFESSIONNEL;BAC PRO PROD;BAC PRO 20102 PILOTE DE LIGNE DE PRODUCTION;11;11;9;2;0;0;0;9;0;1;5;2;1;2
4760.0;2021;12;NANCY-METZ;MASCULIN;APPRENTISSAGE;BAC PROFESSIONNEL;BAC PRO PROD;BAC PRO 23102 TRAVAUX PUBLICS;10;10;10;0;0;0;0;10;0;0;2;7;1;0
4769.0;2021;12;NANCY-METZ;MASCULIN;APPRENTISSAGE;BAC PROFESSIONNEL;BAC PRO PROD;BAC PRO 25107 TECHNICIEN OUTILLEUR;5;5;5;0;0;0;0;5;0;0;2;3;0;0
4778.0;2021;12;NANCY-METZ;MASCULIN;APPRENTISSAGE;BAC PROFESSIONNEL;BAC PRO PROD;BAC PRO 25406 OUVRAGES DU BATIMENT METALLERIE;2;2;0;0;2;1;1;1;0;0;0;0;1;1
4779.0;2021;12;NANCY-METZ;MASCULIN;APPRENTISSAGE;BAC PROFESSIONNEL;BAC PRO PROD;BAC PRO 25408 REPARATION DES CARROSSERIES;12;12;8;1;3;1;2;9;0;2;2;2;3;3
4783.0;2021;12;NANCY-METZ;MASCULIN;APPRENTISSAGE;BAC PROFESSIONNEL;BAC PRO PROD;BAC PRO AG 21001 AGRO-EQUIPEMENT;11;11;7;4;0;0;0;7;0;0;0;2;5;4
4787.0;2021;12;NANCY-METZ;MASCULIN;APPRENTISSAGE;BAC PROFESSIONNEL;BAC PRO PROD;BAC PRO AG 21302 GEST MILIEUX NATURELS FAUNE;2;2;2;0;0;0;0;2;0;0;0;1;1;0
4788.0;2021;12;NANCY-METZ;MASCULIN;APPRENTISSAGE;BAC PROFESSIONNEL;BAC PRO PROD;BAC PRO AG 21303 FORET;13;13;13;0;0;0;0;13;0;0;1;5;7;0
4794.0;2021;12;NANCY-METZ;MASCULIN;APPRENTISSAGE;BAC PROFESSIONNEL;BAC PRO SERV;BAC PRO 31210 ACCUEIL -RELATION CLIENTS USAGERS;3;3;2;1;0;0;0;2;0;0;1;0;1;1
4801.0;2021;12;NANCY-METZ;MASCULIN;FORMATION CONTINUE;BAC PROFESSIONNEL;BAC PRO PROD;BACPRO 20002 ETUD.DEFINITION PRDTS INDUSTRIEL;1;1;1;0;0;0;0;1;0;0;0;1;0;0
4802.0;2021;12;NANCY-METZ;MASCULIN;FORMATION CONTINUE;BAC PROFESSIONNEL;BAC PRO PROD;BAC PRO 22703 TECHN.INSTALL.SYST.ENERG.CLIMATI;7;7;7;0;0;0;0;7;0;1;4;2;0;0
4807.0;2021;12;NANCY-METZ;MASCULIN;FORMATION CONTINUE;BAC PROFESSIONNEL;BAC PRO PROD;BAC PRO 25106 TECHNICIEN D'USINAGE;7;7;6;1;0;0;0;6;0;0;2;1;3;1
4808.0;2021;12;NANCY-METZ;MASCULIN;FORMATION CONTINUE;BAC PROFESSIONNEL;BAC PRO PROD;BAC PRO 25214 MAINT.VEHIC.OPTA VOIT.PARTICUL.;6;5;4;1;0;0;0;4;0;1;2;1;0;1
4809.0;2021;12;NANCY-METZ;MASCULIN;FORMATION CONTINUE;BAC PROFESSIONNEL;BAC PRO PROD;BAC PRO 25216 MAINT.VEHIC.OPTC MOTOCYCLES;1;1;1;0;0;0;0;1;0;1;0;0;0;0
4820.0;2021;12;NANCY-METZ;MASCULIN;FORMATION CONTINUE;BAC PROFESSIONNEL;BAC PRO SERV;BAC PRO 34403 METIERS DE LA SECURITE;12;11;8;3;0;0;0;8;0;1;1;3;3;3
4823.0;2021;12;NANCY-METZ;MASCULIN;INDIVIDUEL;BAC PROFESSIONNEL;BAC PRO PROD;BAC PRO 22703 TECHN.INSTALL.SYST.ENERG.CLIMATI;1;1;0;1;0;0;0;0;0;0;0;0;0;1
4825.0;2021;12;NANCY-METZ;MASCULIN;INDIVIDUEL;BAC PROFESSIONNEL;BAC PRO PROD;BAC PRO 23004 TECHN. ETUDES BAT.A ETUDES & ECO.;1;1;0;1;0;0;0;0;0;0;0;0;0;1
4827.0;2021;12;NANCY-METZ;MASCULIN;INDIVIDUEL;BAC PROFESSIONNEL;BAC PRO PROD;BAC PRO 25007 MAINTENANCE EQUIPEMENTS INDUST.;1;1;0;1;0;0;0;0;0;0;0;0;0;1
4829.0;2021;12;NANCY-METZ;MASCULIN;INDIVIDUEL;BAC PROFESSIONNEL;BAC PRO PROD;BAC PRO 25408 REPARATION DES CARROSSERIES;1;1;0;1;0;0;0;0;0;0;0;0;0;1
4832.0;2021;12;NANCY-METZ;MASCULIN;INDIVIDUEL;BAC PROFESSIONNEL;BAC PRO PROD;BAC PRO AG 21405 AMENAGEMENTS PAYSAGERS;1;1;1;0;0;0;0;1;0;0;0;0;1;0
4839.0;2021;12;NANCY-METZ;MASCULIN;INDIVIDUEL;BAC TECHNOLOGIQUE;BAC S2TMD;BAC S2TMD MUSIQUE;1;1;0;1;0;0;0;0;0;0;0;0;0;1
4847.0;2021;12;NANCY-METZ;MASCULIN;INDIVIDUEL;BAC TECHNOLOGIQUE;BAC STMG;BAC STMG SYSTEMES D'INFORMATION DE GESTION;1;0;0;0;0;0;0;0;0;0;0;0;0;0
4848.0;2021;12;NANCY-METZ;MASCULIN;SCOLAIRE;BAC GENERAL;BAC GENERAL;BAC GENE 10019 BAC GENERAL;4916;4915;4623;34;258;151;107;4774;81;505;1001;1657;1530;141
4850.0;2021;12;NANCY-METZ;MASCULIN;SCOLAIRE;BAC PROFESSIONNEL;BAC PRO PROD;BAC PRO 22003 BIO-INDUSTRIES DE TRANSFORMATION;6;6;2;2;2;1;1;3;0;0;1;0;2;3
4856.0;2021;12;NANCY-METZ;MASCULIN;SCOLAIRE;BAC PROFESSIONNEL;BAC PRO PROD;BAC PRO 22503 PLASTIQUES ET COMPOSITES;9;9;6;3;0;0;0;6;0;0;0;2;4;3
4858.0;2021;12;NANCY-METZ;MASCULIN;SCOLAIRE;BAC PROFESSIONNEL;BAC PRO PROD;BAC PRO 22704 TECHN. MAINT. SYST.ENERG.CLIMATI;52;50;40;3;7;3;4;43;0;1;7;19;16;7
4861.0;2021;12;NANCY-METZ;MASCULIN;SCOLAIRE;BAC PROFESSIONNEL;BAC PRO PROD;BAC PRO 23005 TECHN. ETUDES BAT B ASSIST.ARCHI.;22;22;21;1;0;0;0;21;0;0;6;12;3;1
4863.0;2021;12;NANCY-METZ;MASCULIN;SCOLAIRE;BAC PROFESSIONNEL;BAC PRO PROD;BAC PRO 23203 TECHNICIEN BAT. : ORG.REAL.GROS O;22;22;12;9;1;1;0;13;0;0;3;3;7;9
4865.0;2021;12;NANCY-METZ;MASCULIN;SCOLAIRE;BAC PROFESSIONNEL;BAC PRO PROD;BAC PRO 23303 MENUISERIE ALUMINIUM-VERRE;2;2;0;0;2;0;2;0;0;0;0;0;0;2
4866.0;2021;12;NANCY-METZ;MASCULIN;SCOLAIRE;BAC PROFESSIONNEL;BAC PRO PROD;BAC PRO 23304 AMENAGEMENT FINITION BATIMENT;17;16;11;3;2;1;1;12;0;0;1;7;4;4
4875.0;2021;12;NANCY-METZ;MASCULIN;SCOLAIRE;BAC PROFESSIONNEL;BAC PRO PROD;BAC PRO 25107 TECHNICIEN OUTILLEUR;6;6;6;0;0;0;0;6;0;1;0;2;3;0
4882.0;2021;12;NANCY-METZ;MASCULIN;SCOLAIRE;BAC PROFESSIONNEL;BAC PRO PROD;BAC PRO 25302 AERONAUTIQUE OPTION AVIONIQUE;8;8;8;0;0;0;0;8;0;1;0;6;1;0
4886.0;2021;12;NANCY-METZ;MASCULIN;SCOLAIRE;BAC PROFESSIONNEL;BAC PRO PROD;BAC PRO 25410 CONSTRUCTION DES CARROSSERIES;5;5;3;2;0;0;0;3;0;0;1;0;2;2
4893.0;2021;12;NANCY-METZ;MASCULIN;SCOLAIRE;BAC PROFESSIONNEL;BAC PRO PROD;BAC PRO AG 21001 AGRO-EQUIPEMENT;33;33;25;8;0;0;0;25;0;0;2;10;13;8
4895.0;2021;12;NANCY-METZ;MASCULIN;SCOLAIRE;BAC PROFESSIONNEL;BAC PRO PROD;BAC PRO AG 21114 CONDUITE PRODUCTIONS HORTICOLES;4;4;4;0;0;0;0;4;0;0;1;0;3;0
4913.0;2021;12;NANCY-METZ;MASCULIN;SCOLAIRE;BAC PROFESSIONNEL;BAC PRO SERV;BAC PRO 33002 SERVICES DE PROXIMITE  VIE LOCAL;32;32;27;2;3;3;0;30;0;0;8;9;13;2
4916.0;2021;12;NANCY-METZ;MASCULIN;SCOLAIRE;BAC PROFESSIONNEL;BAC PRO SERV;BAC PRO 33101 OPTIQUE LUNETTERIE;9;9;9;0;0;0;0;9;0;0;3;3;3;0
4918.0;2021;12;NANCY-METZ;MASCULIN;SCOLAIRE;BAC PROFESSIONNEL;BAC PRO SERV;BAC PRO 33403 COMMERC. SERVICES EN RESTAURATION;91;91;79;9;3;2;1;81;0;0;15;32;34;10
4926.0;2021;12;NANCY-METZ;MASCULIN;SCOLAIRE;BAC TECHNOLOGIQUE;BAC STD2A;BAC STD2A SCIENCES & TECHNO. DESIGN-ARTS APPLIQUES;7;7;7;0;0;0;0;7;1;0;0;6;0;0
4930.0;2021;12;NANCY-METZ;MASCULIN;SCOLAIRE;BAC TECHNOLOGIQUE;BAC STI2D;BAC STI2D INNOVATION TECHNO.  ET ECO CONCEPTION;391;391;357;4;30;15;15;372;0;4;48;163;157;19
4932.0;2021;12;NANCY-METZ;MASCULIN;SCOLAIRE;BAC TECHNOLOGIQUE;BAC STL;BAC STL BIOCHIM.-BIOLOGIE-BIOTECHNOL.;57;57;48;3;6;3;3;51;0;2;6;18;25;6
4946.0;2021;17;NANTES;FEMININ;APPRENTISSAGE;BAC PROFESSIONNEL;BAC PRO PROD;BAC PRO 25007 MAINTENANCE EQUIPEMENTS INDUST.;2;2;2;0;0;0;0;2;0;1;1;0;0;0
4954.0;2021;17;NANTES;FEMININ;APPRENTISSAGE;BAC PROFESSIONNEL;BAC PRO PROD;BAC PRO 25408 REPARATION DES CARROSSERIES;2;2;2;0;0;0;0;2;0;0;0;2;0;0
4962.0;2021;17;NANTES;FEMININ;APPRENTISSAGE;BAC PROFESSIONNEL;BAC PRO PROD;BAC PRO AG 21203 TECHN CONSEIL DE VENTE ANIMAL;2;2;2;0;0;0;0;2;0;0;0;1;1;0
4967.0;2021;17;NANTES;FEMININ;APPRENTISSAGE;BAC PROFESSIONNEL;BAC PRO SERV;BAC PRO 31106 LOGISTIQUE;2;2;0;0;2;1;1;1;0;0;0;0;1;1
4970.0;2021;17;NANTES;FEMININ;APPRENTISSAGE;BAC PROFESSIONNEL;BAC PRO SERV;BAC PRO 31210 ACCUEIL -RELATION CLIENTS USAGERS;13;13;13;0;0;0;0;13;0;2;3;4;4;0
4975.0;2021;17;NANTES;FEMININ;APPRENTISSAGE;BAC PROFESSIONNEL;BAC PRO SERV;BAC PRO 33403 COMMERC. SERVICES EN RESTAURATION;34;34;30;1;3;0;3;30;0;2;4;12;12;4
4978.0;2021;17;NANTES;FEMININ;ENSEIGNEMENT A DISTANCE;BAC PROFESSIONNEL;BAC PRO PROD;BAC PRO AG 21004 CGEA;8;8;8;0;0;0;0;8;0;0;0;1;7;0
4988.0;2021;17;NANTES;FEMININ;FORMATION CONTINUE;BAC PROFESSIONNEL;BAC PRO PROD;BAC PRO 25214 MAINT.VEHIC.OPTA VOIT.PARTICUL.;1;1;1;0;0;0;0;1;0;1;0;0;0;0
4991.0;2021;17;NANTES;FEMININ;FORMATION CONTINUE;BAC PROFESSIONNEL;BAC PRO SERV;BAC PRO 31106 LOGISTIQUE;6;6;6;0;0;0;0;6;0;1;1;2;2;0
4994.0;2021;17;NANTES;FEMININ;FORMATION CONTINUE;BAC PROFESSIONNEL;BAC PRO SERV;BAC PRO 33102 PROTHESE DENTAIRE;7;7;7;0;0;0;0;7;0;0;1;4;2;0
4996.0;2021;17;NANTES;FEMININ;INDIVIDUEL;BAC PROFESSIONNEL;BAC PRO PROD;BAC PRO 24203 METIERS DE LA MODE - VÊTEMENT;1;1;0;1;0;0;0;0;0;0;0;0;0;1
5000.0;2021;17;NANTES;FEMININ;INDIVIDUEL;BAC PROFESSIONNEL;BAC PRO PROD;BAC PRO AG 21114 CONDUITE PRODUCTIONS HORTICOLES;3;2;2;0;0;0;0;2;0;0;0;0;2;0
5001.0;2021;17;NANTES;FEMININ;INDIVIDUEL;BAC PROFESSIONNEL;BAC PRO PROD;BAC PRO AG 21203 TECHN CONSEIL DE VENTE ANIMAL;2;1;0;1;0;0;0;0;0;0;0;0;0;1
5003.0;2021;17;NANTES;FEMININ;INDIVIDUEL;BAC PROFESSIONNEL;BAC PRO PROD;BAC PRO AG 22107 TEC CONS VTE ALIMENTATION P.ALIM;1;1;0;1;0;0;0;0;0;0;0;0;0;1
5006.0;2021;17;NANTES;FEMININ;INDIVIDUEL;BAC PROFESSIONNEL;BAC PRO SERV;BAC PRO 31206 VENTE (PROSPECT.NEGO.SUIV.CLIENT;1;0;0;0;0;0;0;0;0;0;0;0;0;0
5007.0;2021;17;NANTES;FEMININ;INDIVIDUEL;BAC PROFESSIONNEL;BAC PRO SERV;BAC PRO 32303 ART.& MET.ART:COM.VIS.VIS.PLURI-M;1;1;1;0;0;0;0;1;0;0;0;1;0;0
5012.0;2021;17;NANTES;FEMININ;INDIVIDUEL;BAC TECHNOLOGIQUE;BAC STAV;BAC STAV AGRONOMIE ALIM ENV TERRITOI;1;1;0;1;0;0;0;0;0;0;0;0;0;1
5018.0;2021;17;NANTES;FEMININ;SCOLAIRE;BAC PROFESSIONNEL;BAC PRO PROD;BAC PRO 22004 PROC. CHIMIE EAU PAPIERS-CARTONS;3;3;3;0;0;0;0;3;0;0;2;0;1;0
5021.0;2021;17;NANTES;FEMININ;SCOLAIRE;BAC PROFESSIONNEL;BAC PRO PROD;BAC PRO 22403 ARTS.& MET.ART:MET.ENSEIGN SIGNA;9;9;9;0;0;0;0;9;0;2;2;3;2;0
5023.0;2021;17;NANTES;FEMININ;SCOLAIRE;BAC PROFESSIONNEL;BAC PRO PROD;BAC PRO 22703 TECHN.INSTALL.SYST.ENERG.CLIMATI;1;1;1;0;0;0;0;1;0;0;0;0;1;0
5027.0;2021;17;NANTES;FEMININ;SCOLAIRE;BAC PROFESSIONNEL;BAC PRO PROD;BAC PRO 23102 TRAVAUX PUBLICS;1;1;1;0;0;0;0;1;0;0;1;0;0;0
5036.0;2021;17;NANTES;FEMININ;SCOLAIRE;BAC PROFESSIONNEL;BAC PRO PROD;BAC PRO 25006 MICROTECHNIQUES;1;1;1;0;0;0;0;1;0;0;0;0;1;0
5041.0;2021;17;NANTES;FEMININ;SCOLAIRE;BAC PROFESSIONNEL;BAC PRO PROD;BAC PRO 25216 MAINT.VEHIC.OPTC MOTOCYCLES;1;1;0;1;0;0;0;0;0;0;0;0;0;1
5043.0;2021;17;NANTES;FEMININ;SCOLAIRE;BAC PROFESSIONNEL;BAC PRO PROD;BAC PRO 25408 REPARATION DES CARROSSERIES;1;1;1;0;0;0;0;1;0;0;1;0;0;0
5044.0;2021;17;NANTES;FEMININ;SCOLAIRE;BAC PROFESSIONNEL;BAC PRO PROD;BAC PRO 25411 TECH.CHAUDRONNERIE INDUSTRIELLE;2;2;2;0;0;0;0;2;0;0;1;1;0;0
5046.0;2021;17;NANTES;FEMININ;SCOLAIRE;BAC PROFESSIONNEL;BAC PRO PROD;BAC PRO 25513 SYST.NUM.OPT.A SURETE SECURITE;3;3;2;1;0;0;0;2;0;0;0;1;1;1
5047.0;2021;17;NANTES;FEMININ;SCOLAIRE;BAC PROFESSIONNEL;BAC PRO PROD;BAC PRO 25514 SYST.NUM.OPT.B AUD.RES.EQUIP.DOM.;4;4;4;0;0;0;0;4;0;2;1;1;0;0
5058.0;2021;17;NANTES;FEMININ;SCOLAIRE;BAC PROFESSIONNEL;BAC PRO PROD;BAC PRO AG 22105 LABORATOIRE CONTROLE QUALITE;16;16;16;0;0;0;0;16;0;1;1;7;7;0
5060.0;2021;17;NANTES;FEMININ;SCOLAIRE;BAC PROFESSIONNEL;BAC PRO SERV;BAC PRO 30001 GESTION-ADMINISTRATION;642;641;549;61;31;22;9;571;0;21;117;237;196;70
5063.0;2021;17;NANTES;FEMININ;SCOLAIRE;BAC PROFESSIONNEL;BAC PRO SERV;BAC PRO 31108 TRANSPORT;5;5;5;0;0;0;0;5;0;0;2;1;2;0
5088.0;2021;17;NANTES;FEMININ;SCOLAIRE;BAC TECHNOLOGIQUE;BAC STI2D;BAC STI2D ARCHITECTURE ET CONSTRUCTION;52;52;50;0;2;0;2;50;0;4;7;25;14;2
5099.0;2021;17;NANTES;MASCULIN;APPRENTISSAGE;BAC PROFESSIONNEL;BAC PRO PROD;BAC PRO 22105 BOULANGER-PÂTISSIER;14;14;13;1;0;0;0;13;0;1;5;6;1;1
5102.0;2021;17;NANTES;MASCULIN;APPRENTISSAGE;BAC PROFESSIONNEL;BAC PRO PROD;BAC PRO 22503 PLASTIQUES ET COMPOSITES;5;5;5;0;0;0;0;5;0;0;1;2;2;0
5110.0;2021;17;NANTES;MASCULIN;APPRENTISSAGE;BAC PROFESSIONNEL;BAC PRO PROD;BAC PRO 23303 MENUISERIE ALUMINIUM-VERRE;23;23;14;7;2;2;0;16;0;2;4;5;5;7
5113.0;2021;17;NANTES;MASCULIN;APPRENTISSAGE;BAC PROFESSIONNEL;BAC PRO PROD;BAC PRO 24203 METIERS DE LA MODE - VÊTEMENT;1;1;1;0;0;0;0;1;0;0;0;1;0;0
5131.0;2021;17;NANTES;MASCULIN;APPRENTISSAGE;BAC PROFESSIONNEL;BAC PRO PROD;BAC PRO 25509 TECHNIC. FROID CONDITIONNEMT AIR;13;13;11;2;0;0;0;11;0;1;4;3;3;2
5139.0;2021;17;NANTES;MASCULIN;APPRENTISSAGE;BAC PROFESSIONNEL;BAC PRO PROD;BAC PRO AG 21203 TECHN CONSEIL DE VENTE ANIMAL;2;2;1;1;0;0;0;1;0;0;0;1;0;1
5144.0;2021;17;NANTES;MASCULIN;APPRENTISSAGE;BAC PROFESSIONNEL;BAC PRO PROD;BAC PRO AG 22107 TEC CONS VTE ALIMENTATION P.ALIM;3;3;3;0;0;0;0;3;0;0;0;0;3;0
5154.0;2021;17;NANTES;MASCULIN;APPRENTISSAGE;BAC PROFESSIONNEL;BAC PRO SERV;BAC PRO 33403 COMMERC. SERVICES EN RESTAURATION;31;31;26;3;2;1;1;27;0;0;5;12;10;4
5162.0;2021;17;NANTES;MASCULIN;ENSEIGNEMENT A DISTANCE;BAC TECHNOLOGIQUE;BAC STMG;BAC STMG SYSTEMES D'INFORMATION DE GESTION;1;1;1;0;0;0;0;1;0;0;1;0;0;0
5166.0;2021;17;NANTES;MASCULIN;FORMATION CONTINUE;BAC PROFESSIONNEL;BAC PRO PROD;BAC PRO 22704 TECHN. MAINT. SYST.ENERG.CLIMATI;1;1;1;0;0;0;0;1;0;1;0;0;0;0
5175.0;2021;17;NANTES;MASCULIN;FORMATION CONTINUE;BAC PROFESSIONNEL;BAC PRO PROD;BAC PRO 25509 TECHNIC. FROID CONDITIONNEMT AIR;1;1;1;0;0;0;0;1;0;0;1;0;0;0
5181.0;2021;17;NANTES;MASCULIN;FORMATION CONTINUE;BAC PROFESSIONNEL;BAC PRO SERV;BAC PRO 31202 COMMERCE;11;10;9;0;1;1;0;10;0;0;4;3;3;0
5187.0;2021;17;NANTES;MASCULIN;INDIVIDUEL;BAC PROFESSIONNEL;BAC PRO PROD;BAC PRO 25007 MAINTENANCE EQUIPEMENTS INDUST.;1;1;0;1;0;0;0;0;0;0;0;0;0;1
5192.0;2021;17;NANTES;MASCULIN;INDIVIDUEL;BAC PROFESSIONNEL;BAC PRO PROD;BAC PRO 25515 SYST.NUM.OPT.C RES.INF.SYST.COMM.;5;4;3;1;0;0;0;3;0;0;0;0;3;1
5195.0;2021;17;NANTES;MASCULIN;INDIVIDUEL;BAC PROFESSIONNEL;BAC PRO PROD;BAC PRO AG 21114 CONDUITE PRODUCTIONS HORTICOLES;5;5;5;0;0;0;0;5;0;0;0;0;5;0
5196.0;2021;17;NANTES;MASCULIN;INDIVIDUEL;BAC PROFESSIONNEL;BAC PRO PROD;BAC PRO AG 21211 COND GEST ENTR HIPPIQUE;1;1;0;1;0;0;0;0;0;0;0;0;0;1
5197.0;2021;17;NANTES;MASCULIN;INDIVIDUEL;BAC PROFESSIONNEL;BAC PRO PROD;BAC PRO AG 21405 AMENAGEMENTS PAYSAGERS;1;1;0;1;0;0;0;0;0;0;0;0;0;1
5210.0;2021;17;NANTES;MASCULIN;INDIVIDUEL;BAC TECHNOLOGIQUE;BAC STL;BAC STL SCIENCES PHYSIQUES CHIMIQUES  EN LABORAT.;1;1;0;1;0;0;0;0;0;0;0;0;0;1
5212.0;2021;17;NANTES;MASCULIN;INDIVIDUEL;BAC TECHNOLOGIQUE;BAC STMG;BAC STMG MERCATIQUE (MARKETING);15;9;3;3;3;2;1;5;0;0;0;0;5;4
5217.0;2021;17;NANTES;MASCULIN;SCOLAIRE;BAC PROFESSIONNEL;BAC PRO PROD;BAC PRO 20102 PILOTE DE LIGNE DE PRODUCTION;32;32;26;4;2;1;1;27;0;2;2;12;11;5
5223.0;2021;17;NANTES;MASCULIN;SCOLAIRE;BAC PROFESSIONNEL;BAC PRO PROD;BAC PRO 22703 TECHN.INSTALL.SYST.ENERG.CLIMATI;47;47;24;15;8;1;7;25;0;0;2;14;9;22
5225.0;2021;17;NANTES;MASCULIN;SCOLAIRE;BAC PROFESSIONNEL;BAC PRO PROD;BAC PRO 23003 ARTIS. & M.ART:MARCHANDISAGE VIS.;6;6;6;0;0;0;0;6;0;0;1;3;2;0
5231.0;2021;17;NANTES;MASCULIN;SCOLAIRE;BAC PROFESSIONNEL;BAC PRO PROD;BAC PRO 23205 INTERV. SUR PATRIMOINE BATI OPT.A;3;3;2;1;0;0;0;2;0;0;0;2;0;1
5236.0;2021;17;NANTES;MASCULIN;SCOLAIRE;BAC PROFESSIONNEL;BAC PRO PROD;BAC PRO 23407 TECHNIC.FAB.BOIS ET MATERX ASSOC;26;26;18;5;3;2;1;20;0;1;4;7;8;6
5249.0;2021;17;NANTES;MASCULIN;SCOLAIRE;BAC PROFESSIONNEL;BAC PRO PROD;BAC PRO 25219 MAINT.MATERIELS OPT.A AGRICOLES;39;39;36;1;2;0;2;36;0;7;10;12;7;3
5256.0;2021;17;NANTES;MASCULIN;SCOLAIRE;BAC PROFESSIONNEL;BAC PRO PROD;BAC PRO 25509 TECHNIC. FROID CONDITIONNEMT AIR;46;46;36;8;2;2;0;38;0;3;7;13;15;8
5257.0;2021;17;NANTES;MASCULIN;SCOLAIRE;BAC PROFESSIONNEL;BAC PRO PROD;BAC PRO 25510 METIERS ELECT. ENVIRON. CONNECTES;437;435;371;50;14;8;6;379;0;20;103;135;121;56
5262.0;2021;17;NANTES;MASCULIN;SCOLAIRE;BAC PROFESSIONNEL;BAC PRO PROD;BAC PRO AG 21004 CGEA;314;309;283;26;0;0;0;283;0;3;37;112;131;26
5264.0;2021;17;NANTES;MASCULIN;SCOLAIRE;BAC PROFESSIONNEL;BAC PRO PROD;BAC PRO AG 21114 CONDUITE PRODUCTIONS HORTICOLES;26;24;24;0;0;0;0;24;0;0;5;13;6;0
5284.0;2021;17;NANTES;MASCULIN;SCOLAIRE;BAC PROFESSIONNEL;BAC PRO SERV;BAC PRO 32303 ART.& MET.ART:COM.VIS.VIS.PLURI-M;41;41;40;1;0;0;0;40;0;4;11;17;8;1
5285.0;2021;17;NANTES;MASCULIN;SCOLAIRE;BAC PROFESSIONNEL;BAC PRO SERV;BAC PRO 32304 PHOTOGRAPHIE;10;10;10;0;0;0;0;10;0;2;4;3;1;0
5289.0;2021;17;NANTES;MASCULIN;SCOLAIRE;BAC PROFESSIONNEL;BAC PRO SERV;BAC PRO 33101 OPTIQUE LUNETTERIE;4;4;4;0;0;0;0;4;0;0;1;2;1;0
5296.0;2021;17;NANTES;MASCULIN;SCOLAIRE;BAC PROFESSIONNEL;BAC PRO SERV;BAC PRO 34403 METIERS DE LA SECURITE;91;90;90;0;0;0;0;90;0;6;28;45;11;0
5298.0;2021;17;NANTES;MASCULIN;SCOLAIRE;BAC TECHNOLOGIQUE;BAC S2TMD;BAC S2TMD DANSE;2;2;2;0;0;0;0;2;0;0;0;2;0;0
5318.0;2021;23;NICE;FEMININ;APPRENTISSAGE;BAC PROFESSIONNEL;BAC PRO PROD;BAC PRO AG 21113 CGEVV;2;2;2;0;0;0;0;2;0;1;1;0;0;0
5319.0;2021;23;NICE;FEMININ;APPRENTISSAGE;BAC PROFESSIONNEL;BAC PRO PROD;BAC PRO AG 21302 GEST MILIEUX NATURELS FAUNE;2;2;2;0;0;0;0;2;0;0;1;0;1;0
5321.0;2021;23;NICE;FEMININ;APPRENTISSAGE;BAC PROFESSIONNEL;BAC PRO SERV;BAC PRO 30001 GESTION-ADMINISTRATION;18;18;15;1;2;1;1;16;0;3;4;6;3;2
5327.0;2021;23;NICE;FEMININ;APPRENTISSAGE;BAC PROFESSIONNEL;BAC PRO SERV;BAC PRO 33403 COMMERC. SERVICES EN RESTAURATION;5;5;5;0;0;0;0;5;0;0;0;3;2;0
5330.0;2021;23;NICE;FEMININ;ENSEIGNEMENT A DISTANCE;BAC PROFESSIONNEL;BAC PRO SERV;BAC PRO 30001 GESTION-ADMINISTRATION;3;1;0;1;0;0;0;0;0;0;0;0;0;1
5332.0;2021;23;NICE;FEMININ;ENSEIGNEMENT A DISTANCE;BAC PROFESSIONNEL;BAC PRO SERV;BAC PRO 32304 PHOTOGRAPHIE;1;1;1;0;0;0;0;1;0;0;0;1;0;0
5333.0;2021;23;NICE;FEMININ;ENSEIGNEMENT A DISTANCE;BAC PROFESSIONNEL;BAC PRO SERV;BAC PRO 33004 ACC.SOINS-S.PERS. OPT.EN STRUCTUR;6;5;4;1;0;0;0;4;0;0;1;3;0;1
5335.0;2021;23;NICE;FEMININ;ENSEIGNEMENT A DISTANCE;BAC TECHNOLOGIQUE;BAC ST2S;BAC ST2S SCIENCES & TECHNO. SANTE & SOCIAL;5;5;3;1;1;0;1;3;0;0;1;2;0;2
5339.0;2021;23;NICE;FEMININ;FORMATION CONTINUE;BAC PROFESSIONNEL;BAC PRO PROD;BAC PRO 22106 CUISINE;2;2;2;0;0;0;0;2;0;0;0;2;0;0
5340.0;2021;23;NICE;FEMININ;FORMATION CONTINUE;BAC PROFESSIONNEL;BAC PRO PROD;BAC PRO 25510 METIERS ELECT. ENVIRON. CONNECTES;2;2;2;0;0;0;0;2;0;1;1;0;0;0
5360.0;2021;23;NICE;FEMININ;INDIVIDUEL;BAC TECHNOLOGIQUE;BAC STMG;BAC STMG GESTION ET FINANCE;3;2;2;0;0;0;0;2;0;0;0;0;2;0
5364.0;2021;23;NICE;FEMININ;SCOLAIRE;BAC PROFESSIONNEL;BAC PRO PROD;BAC PRO 22105 BOULANGER-PÂTISSIER;17;17;13;1;3;3;0;16;0;5;2;3;6;1
5374.0;2021;23;NICE;FEMININ;SCOLAIRE;BAC PROFESSIONNEL;BAC PRO PROD;BAC PRO 23405 TECHNICIEN MENUISIER AGENCEUR;3;3;2;1;0;0;0;2;0;0;0;1;1;1
5377.0;2021;23;NICE;FEMININ;SCOLAIRE;BAC PROFESSIONNEL;BAC PRO PROD;BAC PRO 24203 METIERS DE LA MODE - VÊTEMENT;67;67;61;5;1;1;0;62;0;7;15;19;21;5
5378.0;2021;23;NICE;FEMININ;SCOLAIRE;BAC PROFESSIONNEL;BAC PRO PROD;BAC PRO 24302 METIERS DU CUIR : MAROQUINERIE;10;10;8;1;1;0;1;8;0;0;1;4;3;2
5381.0;2021;23;NICE;FEMININ;SCOLAIRE;BAC PROFESSIONNEL;BAC PRO PROD;BAC PRO 25106 TECHNICIEN D'USINAGE;1;1;1;0;0;0;0;1;0;0;0;0;1;0
5384.0;2021;23;NICE;FEMININ;SCOLAIRE;BAC PROFESSIONNEL;BAC PRO PROD;BAC PRO 25216 MAINT.VEHIC.OPTC MOTOCYCLES;2;2;2;0;0;0;0;2;0;0;0;0;2;0
5390.0;2021;23;NICE;FEMININ;SCOLAIRE;BAC PROFESSIONNEL;BAC PRO PROD;BAC PRO 25515 SYST.NUM.OPT.C RES.INF.SYST.COMM.;3;3;2;1;0;0;0;2;0;0;0;2;0;1
5393.0;2021;23;NICE;FEMININ;SCOLAIRE;BAC PROFESSIONNEL;BAC PRO PROD;BAC PRO AG 21114 CONDUITE PRODUCTIONS HORTICOLES;5;5;3;2;0;0;0;3;0;0;0;1;2;2
5394.0;2021;23;NICE;FEMININ;SCOLAIRE;BAC PROFESSIONNEL;BAC PRO PROD;BAC PRO AG 21303 FORET;2;2;2;0;0;0;0;2;0;0;0;1;1;0
5397.0;2021;23;NICE;FEMININ;SCOLAIRE;BAC PROFESSIONNEL;BAC PRO SERV;BAC PRO 30001 GESTION-ADMINISTRATION;424;424;346;56;22;15;7;361;0;9;67;122;163;63
5406.0;2021;23;NICE;FEMININ;SCOLAIRE;BAC PROFESSIONNEL;BAC PRO SERV;BAC PRO 32303 ART.& MET.ART:COM.VIS.VIS.PLURI-M;4;4;4;0;0;0;0;4;0;0;2;1;1;0
5411.0;2021;23;NICE;FEMININ;SCOLAIRE;BAC PROFESSIONNEL;BAC PRO SERV;BAC PRO 33403 COMMERC. SERVICES EN RESTAURATION;85;85;74;7;4;2;2;76;0;6;20;26;24;9
5418.0;2021;23;NICE;FEMININ;SCOLAIRE;BAC TECHNOLOGIQUE;BAC ST2S;BAC ST2S SCIENCES & TECHNO. SANTE & SOCIAL;392;392;371;4;17;5;12;376;0;20;75;150;131;16
5422.0;2021;23;NICE;FEMININ;SCOLAIRE;BAC TECHNOLOGIQUE;BAC STI2D;BAC STI2D ARCHITECTURE ET CONSTRUCTION;17;17;17;0;0;0;0;17;0;1;3;13;0;0
5433.0;2021;23;NICE;MASCULIN;APPRENTISSAGE;BAC PROFESSIONNEL;BAC PRO PROD;BAC PRO 22403 ARTS.& MET.ART:MET.ENSEIGN SIGNA;2;2;2;0;0;0;0;2;0;0;0;1;1;0
5434.0;2021;23;NICE;MASCULIN;APPRENTISSAGE;BAC PROFESSIONNEL;BAC PRO PROD;BAC PRO 22703 TECHN.INSTALL.SYST.ENERG.CLIMATI;2;2;1;1;0;0;0;1;0;0;0;0;1;1
5443.0;2021;23;NICE;MASCULIN;APPRENTISSAGE;BAC PROFESSIONNEL;BAC PRO PROD;BAC PRO 25214 MAINT.VEHIC.OPTA VOIT.PARTICUL.;87;84;67;12;5;4;1;71;0;4;15;24;28;13
5459.0;2021;23;NICE;MASCULIN;APPRENTISSAGE;BAC PROFESSIONNEL;BAC PRO SERV;BAC PRO 33403 COMMERC. SERVICES EN RESTAURATION;4;4;4;0;0;0;0;4;0;0;2;2;0;0
5461.0;2021;23;NICE;MASCULIN;ENSEIGNEMENT A DISTANCE;BAC PROFESSIONNEL;BAC PRO SERV;BAC PRO 30001 GESTION-ADMINISTRATION;3;2;1;1;0;0;0;1;0;0;0;0;1;1
5463.0;2021;23;NICE;MASCULIN;ENSEIGNEMENT A DISTANCE;BAC PROFESSIONNEL;BAC PRO SERV;BAC PRO 31206 VENTE (PROSPECT.NEGO.SUIV.CLIENT;1;1;1;0;0;0;0;1;0;0;0;0;1;0
5484.0;2021;23;NICE;MASCULIN;INDIVIDUEL;BAC PROFESSIONNEL;BAC PRO PROD;BAC PRO 25214 MAINT.VEHIC.OPTA VOIT.PARTICUL.;1;1;1;0;0;0;0;1;0;0;0;1;0;0
5487.0;2021;23;NICE;MASCULIN;INDIVIDUEL;BAC PROFESSIONNEL;BAC PRO PROD;BAC PRO 25514 SYST.NUM.OPT.B AUD.RES.EQUIP.DOM.;1;0;0;0;0;0;0;0;0;0;0;0;0;0
5494.0;2021;23;NICE;MASCULIN;INDIVIDUEL;BAC PROFESSIONNEL;BAC PRO SERV;BAC PRO 32304 PHOTOGRAPHIE;1;1;1;0;0;0;0;1;0;0;1;0;0;0
5503.0;2021;23;NICE;MASCULIN;INDIVIDUEL;BAC TECHNOLOGIQUE;BAC STMG;BAC STMG MERCATIQUE (MARKETING);24;22;17;5;0;0;0;17;0;0;1;8;8;5
5504.0;2021;23;NICE;MASCULIN;INDIVIDUEL;BAC TECHNOLOGIQUE;BAC STMG;BAC STMG RESSOURCES HUMAINES ET COMMUNICATION;4;3;1;1;1;1;0;2;0;0;0;0;2;1
5506.0;2021;23;NICE;MASCULIN;SCOLAIRE;BAC GENERAL;BAC GENERAL;BAC GENE 10019 BAC GENERAL;5241;5241;4913;65;263;139;124;5052;105;510;1238;1794;1405;189
5509.0;2021;23;NICE;MASCULIN;SCOLAIRE;BAC PROFESSIONNEL;BAC PRO PROD;BAC PRO 22105 BOULANGER-PÂTISSIER;29;29;29;0;0;0;0;29;0;0;11;11;7;0
5513.0;2021;23;NICE;MASCULIN;SCOLAIRE;BAC PROFESSIONNEL;BAC PRO PROD;BAC PRO 22704 TECHN. MAINT. SYST.ENERG.CLIMATI;75;74;63;8;3;2;1;65;0;2;12;24;27;9
5515.0;2021;23;NICE;MASCULIN;SCOLAIRE;BAC PROFESSIONNEL;BAC PRO PROD;BAC PRO 23004 TECHN. ETUDES BAT.A ETUDES & ECO.;27;27;16;8;3;3;0;19;0;0;1;12;6;8
5516.0;2021;23;NICE;MASCULIN;SCOLAIRE;BAC PROFESSIONNEL;BAC PRO PROD;BAC PRO 23005 TECHN. ETUDES BAT B ASSIST.ARCHI.;26;26;17;7;2;2;0;19;0;0;3;8;8;7
5520.0;2021;23;NICE;MASCULIN;SCOLAIRE;BAC PROFESSIONNEL;BAC PRO PROD;BAC PRO 23303 MENUISERIE ALUMINIUM-VERRE;11;11;6;3;2;1;1;7;0;0;0;2;5;4
5526.0;2021;23;NICE;MASCULIN;SCOLAIRE;BAC PROFESSIONNEL;BAC PRO PROD;BAC PRO 24203 METIERS DE LA MODE - VÊTEMENT;8;8;8;0;0;0;0;8;0;0;5;2;1;0
5529.0;2021;23;NICE;MASCULIN;SCOLAIRE;BAC PROFESSIONNEL;BAC PRO PROD;BAC PRO 25007 MAINTENANCE EQUIPEMENTS INDUST.;119;117;94;18;5;2;3;96;0;6;19;28;43;21
5533.0;2021;23;NICE;MASCULIN;SCOLAIRE;BAC PROFESSIONNEL;BAC PRO PROD;BAC PRO 25214 MAINT.VEHIC.OPTA VOIT.PARTICUL.;137;136;104;28;4;2;2;106;0;8;22;39;37;30
5535.0;2021;23;NICE;MASCULIN;SCOLAIRE;BAC PROFESSIONNEL;BAC PRO PROD;BAC PRO 25216 MAINT.VEHIC.OPTC MOTOCYCLES;28;27;22;5;0;0;0;22;0;0;4;4;14;5
5539.0;2021;23;NICE;MASCULIN;SCOLAIRE;BAC PROFESSIONNEL;BAC PRO PROD;BAC PRO 25411 TECH.CHAUDRONNERIE INDUSTRIELLE;22;22;16;6;0;0;0;16;0;0;5;7;4;6
5540.0;2021;23;NICE;MASCULIN;SCOLAIRE;BAC PROFESSIONNEL;BAC PRO PROD;BAC PRO 25509 TECHNIC. FROID CONDITIONNEMT AIR;33;33;28;5;0;0;0;28;0;0;4;13;11;5
5566.0;2021;23;NICE;MASCULIN;SCOLAIRE;BAC PROFESSIONNEL;BAC PRO SERV;BAC PRO 34304 HYGIENE PROPRETE STERILISATION;3;3;2;1;0;0;0;2;0;0;0;1;1;1
5571.0;2021;23;NICE;MASCULIN;SCOLAIRE;BAC TECHNOLOGIQUE;BAC ST2S;BAC ST2S SCIENCES & TECHNO. SANTE & SOCIAL;62;62;58;0;4;2;2;60;0;1;3;29;27;2
5572.0;2021;23;NICE;MASCULIN;SCOLAIRE;BAC TECHNOLOGIQUE;BAC STAV;BAC STAV AGRONOMIE ALIM ENV TERRITOI;42;42;39;3;0;0;0;39;0;3;4;17;15;3
5577.0;2021;23;NICE;MASCULIN;SCOLAIRE;BAC TECHNOLOGIQUE;BAC STI2D;BAC STI2D INNOVATION TECHNO.  ET ECO CONCEPTION;253;253;235;6;12;8;4;243;0;3;35;114;91;10
5581.0;2021;23;NICE;MASCULIN;SCOLAIRE;BAC TECHNOLOGIQUE;BAC STMG;BAC STMG GESTION ET FINANCE;274;274;239;7;28;14;14;253;0;3;41;107;102;21
5582.0;2021;23;NICE;MASCULIN;SCOLAIRE;BAC TECHNOLOGIQUE;BAC STMG;BAC STMG MERCATIQUE (MARKETING);508;508;424;28;56;32;24;456;0;2;40;154;260;52
5587.0;2021;70;NORMANDIE;FEMININ;APPRENTISSAGE;BAC PROFESSIONNEL;BAC PRO PROD;BAC PRO 22004 PROC. CHIMIE EAU PAPIERS-CARTONS;4;4;4;0;0;0;0;4;0;2;2;0;0;0
5608.0;2021;70;NORMANDIE;FEMININ;APPRENTISSAGE;BAC PROFESSIONNEL;BAC PRO SERV;BAC PRO 31202 COMMERCE;122;121;111;6;4;3;1;114;0;5;29;56;24;7
5612.0;2021;70;NORMANDIE;FEMININ;APPRENTISSAGE;BAC PROFESSIONNEL;BAC PRO SERV;BAC PRO 33403 COMMERC. SERVICES EN RESTAURATION;11;11;9;1;1;0;1;9;0;0;4;3;2;2
5625.0;2021;70;NORMANDIE;FEMININ;FORMATION CONTINUE;BAC PROFESSIONNEL;BAC PRO PROD;BAC PRO 20102 PILOTE DE LIGNE DE PRODUCTION;14;14;14;0;0;0;0;14;0;3;5;5;1;0
5647.0;2021;70;NORMANDIE;FEMININ;INDIVIDUEL;BAC PROFESSIONNEL;BAC PRO SERV;BAC PRO 33403 COMMERC. SERVICES EN RESTAURATION;1;0;0;0;0;0;0;0;0;0;0;0;0;0
5648.0;2021;70;NORMANDIE;FEMININ;INDIVIDUEL;BAC PROFESSIONNEL;BAC PRO SERV;BAC PRO 33603 ESTHETIQUE COSMETIQUE PARFUMERIE;1;1;1;0;0;0;0;1;0;1;0;0;0;0
5653.0;2021;70;NORMANDIE;FEMININ;INDIVIDUEL;BAC TECHNOLOGIQUE;BAC STMG;BAC STMG GESTION ET FINANCE;5;5;3;1;1;0;1;3;0;0;1;2;0;2
5657.0;2021;70;NORMANDIE;FEMININ;SCOLAIRE;BAC PROFESSIONNEL;BAC PRO PROD;BACPRO 20002 ETUD.DEFINITION PRDTS INDUSTRIEL;2;2;2;0;0;0;0;2;0;0;0;2;0;0
5659.0;2021;70;NORMANDIE;FEMININ;SCOLAIRE;BAC PROFESSIONNEL;BAC PRO PROD;BAC PRO 22004 PROC. CHIMIE EAU PAPIERS-CARTONS;9;9;8;1;0;0;0;8;0;0;1;4;3;1
5664.0;2021;70;NORMANDIE;FEMININ;SCOLAIRE;BAC PROFESSIONNEL;BAC PRO PROD;BAC PRO 22704 TECHN. MAINT. SYST.ENERG.CLIMATI;1;1;1;0;0;0;0;1;0;1;0;0;0;0
5674.0;2021;70;NORMANDIE;FEMININ;SCOLAIRE;BAC PROFESSIONNEL;BAC PRO PROD;BAC PRO 24202 ARTIS.& MET.ART : TAPIS.D'AMEUBL;8;8;8;0;0;0;0;8;0;0;0;3;5;0
5676.0;2021;70;NORMANDIE;FEMININ;SCOLAIRE;BAC PROFESSIONNEL;BAC PRO PROD;BAC PRO 24302 METIERS DU CUIR : MAROQUINERIE;10;10;10;0;0;0;0;10;0;0;1;4;5;0
5681.0;2021;70;NORMANDIE;FEMININ;SCOLAIRE;BAC PROFESSIONNEL;BAC PRO PROD;BAC PRO 25215 MAINT.VEHIC.OPTB VEHIC.TRANS.ROUT;2;2;2;0;0;0;0;2;0;0;1;1;0;0
5686.0;2021;70;NORMANDIE;FEMININ;SCOLAIRE;BAC PROFESSIONNEL;BAC PRO PROD;BAC PRO 25510 METIERS ELECT. ENVIRON. CONNECTES;11;11;10;1;0;0;0;10;0;1;3;4;2;1
5689.0;2021;70;NORMANDIE;FEMININ;SCOLAIRE;BAC PROFESSIONNEL;BAC PRO PROD;BAC PRO AG 21001 AGRO-EQUIPEMENT;5;5;3;2;0;0;0;3;0;0;0;1;2;2
5692.0;2021;70;NORMANDIE;FEMININ;SCOLAIRE;BAC PROFESSIONNEL;BAC PRO PROD;BAC PRO AG 21203 TECHN CONSEIL DE VENTE ANIMAL;7;7;7;0;0;0;0;7;0;1;2;3;1;0
5697.0;2021;70;NORMANDIE;FEMININ;SCOLAIRE;BAC PROFESSIONNEL;BAC PRO PROD;BAC PRO AG 21405 AMENAGEMENTS PAYSAGERS;9;9;6;3;0;0;0;6;0;0;0;6;0;3
5704.0;2021;70;NORMANDIE;FEMININ;SCOLAIRE;BAC PROFESSIONNEL;BAC PRO SERV;BAC PRO 31108 TRANSPORT;21;21;15;3;3;3;0;18;0;0;2;8;8;3
5706.0;2021;70;NORMANDIE;FEMININ;SCOLAIRE;BAC PROFESSIONNEL;BAC PRO SERV;BAC PRO 31206 VENTE (PROSPECT.NEGO.SUIV.CLIENT;79;79;73;5;1;0;1;73;0;2;16;28;27;6
5709.0;2021;70;NORMANDIE;FEMININ;SCOLAIRE;BAC PROFESSIONNEL;BAC PRO SERV;BAC PRO 32208 REAL.PR.IMPR.PLURI.OPTB.PR.IMPR.;8;8;7;0;1;1;0;8;0;0;1;2;5;0
5711.0;2021;70;NORMANDIE;FEMININ;SCOLAIRE;BAC PROFESSIONNEL;BAC PRO SERV;BAC PRO 32304 PHOTOGRAPHIE;19;19;17;2;0;0;0;17;0;4;3;2;8;2
5716.0;2021;70;NORMANDIE;FEMININ;SCOLAIRE;BAC PROFESSIONNEL;BAC PRO SERV;BAC PRO 33102 PROTHESE DENTAIRE;3;3;2;1;0;0;0;2;0;0;1;0;1;1
5717.0;2021;70;NORMANDIE;FEMININ;SCOLAIRE;BAC PROFESSIONNEL;BAC PRO SERV;BAC PRO 33403 COMMERC. SERVICES EN RESTAURATION;97;97;87;7;3;3;0;90;0;4;16;32;38;7
5722.0;2021;70;NORMANDIE;FEMININ;SCOLAIRE;BAC PROFESSIONNEL;BAC PRO SERV;BAC PRO 34403 METIERS DE LA SECURITE;34;34;34;0;0;0;0;34;0;0;12;13;9;0
5729.0;2021;70;NORMANDIE;FEMININ;SCOLAIRE;BAC TECHNOLOGIQUE;BAC STHR;BAC STHR SC.&TEC. HOTELLERIE-RESTAURATION;61;61;58;0;3;2;1;60;0;4;16;30;10;1
5735.0;2021;70;NORMANDIE;FEMININ;SCOLAIRE;BAC TECHNOLOGIQUE;BAC STL;BAC STL SCIENCES PHYSIQUES CHIMIQUES  EN LABORAT.;61;61;50;2;9;5;4;55;0;3;5;20;27;6
5738.0;2021;70;NORMANDIE;FEMININ;SCOLAIRE;BAC TECHNOLOGIQUE;BAC STMG;BAC STMG RESSOURCES HUMAINES ET COMMUNICATION;799;799;700;18;81;53;28;753;0;7;83;285;378;46
5741.0;2021;70;NORMANDIE;MASCULIN;APPRENTISSAGE;BAC PROFESSIONNEL;BAC PRO PROD;BAC PRO 22003 BIO-INDUSTRIES DE TRANSFORMATION;7;7;7;0;0;0;0;7;0;0;4;0;3;0
5743.0;2021;70;NORMANDIE;MASCULIN;APPRENTISSAGE;BAC PROFESSIONNEL;BAC PRO PROD;BAC PRO 22104 BOUCHER CHARCUTIER TRAITEUR;3;3;3;0;0;0;0;3;0;0;1;1;1;0
5746.0;2021;70;NORMANDIE;MASCULIN;APPRENTISSAGE;BAC PROFESSIONNEL;BAC PRO PROD;BAC PRO 22503 PLASTIQUES ET COMPOSITES;1;1;1;0;0;0;0;1;0;0;0;0;1;0
5747.0;2021;70;NORMANDIE;MASCULIN;APPRENTISSAGE;BAC PROFESSIONNEL;BAC PRO PROD;BAC PRO 22703 TECHN.INSTALL.SYST.ENERG.CLIMATI;14;14;13;1;0;0;0;13;0;1;5;2;5;1
5764.0;2021;70;NORMANDIE;MASCULIN;APPRENTISSAGE;BAC PROFESSIONNEL;BAC PRO PROD;BAC PRO 25408 REPARATION DES CARROSSERIES;49;48;45;2;1;1;0;46;0;5;12;21;8;2
5773.0;2021;70;NORMANDIE;MASCULIN;APPRENTISSAGE;BAC PROFESSIONNEL;BAC PRO PROD;BAC PRO AG 21114 CONDUITE PRODUCTIONS HORTICOLES;7;6;5;1;0;0;0;5;0;0;0;2;3;1
5774.0;2021;70;NORMANDIE;MASCULIN;APPRENTISSAGE;BAC PROFESSIONNEL;BAC PRO PROD;BAC PRO AG 21203 TECHN CONSEIL DE VENTE ANIMAL;4;4;4;0;0;0;0;4;0;0;0;2;2;0
5776.0;2021;70;NORMANDIE;MASCULIN;APPRENTISSAGE;BAC PROFESSIONNEL;BAC PRO PROD;BAC PRO AG 21211 COND GEST ENTR HIPPIQUE;16;16;14;2;0;0;0;14;0;0;3;3;8;2
5785.0;2021;70;NORMANDIE;MASCULIN;APPRENTISSAGE;BAC PROFESSIONNEL;BAC PRO SERV;BAC PRO 31210 ACCUEIL -RELATION CLIENTS USAGERS;2;2;2;0;0;0;0;2;0;0;0;1;1;0
5792.0;2021;70;NORMANDIE;MASCULIN;ENSEIGNEMENT A DISTANCE;BAC PROFESSIONNEL;BAC PRO SERV;BAC PRO 33004 ACC.SOINS-S.PERS. OPT.EN STRUCTUR;2;2;1;1;0;0;0;1;0;0;0;0;1;1
5793.0;2021;70;NORMANDIE;MASCULIN;ENSEIGNEMENT A DISTANCE;BAC TECHNOLOGIQUE;BAC ST2S;BAC ST2S SCIENCES & TECHNO. SANTE & SOCIAL;1;1;1;0;0;0;0;1;0;0;1;0;0;0
5795.0;2021;70;NORMANDIE;MASCULIN;ENSEIGNEMENT A DISTANCE;BAC TECHNOLOGIQUE;BAC STMG;BAC STMG MERCATIQUE (MARKETING);3;2;2;0;0;0;0;2;0;0;2;0;0;0
5797.0;2021;70;NORMANDIE;MASCULIN;ENSEIGNEMENT A DISTANCE;BAC TECHNOLOGIQUE;BAC STMG;BAC STMG SYSTEMES D'INFORMATION DE GESTION;1;1;1;0;0;0;0;1;0;0;0;1;0;0
5798.0;2021;70;NORMANDIE;MASCULIN;FORMATION CONTINUE;BAC PROFESSIONNEL;BAC PRO PROD;BAC PRO 20102 PILOTE DE LIGNE DE PRODUCTION;7;7;6;1;0;0;0;6;0;1;4;1;0;1
5802.0;2021;70;NORMANDIE;MASCULIN;FORMATION CONTINUE;BAC PROFESSIONNEL;BAC PRO PROD;BAC PRO 23203 TECHNICIEN BAT. : ORG.REAL.GROS O;1;1;1;0;0;0;0;1;0;1;0;0;0;0
5805.0;2021;70;NORMANDIE;MASCULIN;FORMATION CONTINUE;BAC PROFESSIONNEL;BAC PRO PROD;BAC PRO 25007 MAINTENANCE EQUIPEMENTS INDUST.;32;29;27;2;0;0;0;27;0;5;11;8;3;2
5817.0;2021;70;NORMANDIE;MASCULIN;FORMATION CONTINUE;BAC PROFESSIONNEL;BAC PRO SERV;BAC PRO 32207 REAL.PR.IMPR.PLURI.OPTA.PR.GRAPH.;5;5;2;3;0;0;0;2;0;0;0;2;0;3
5819.0;2021;70;NORMANDIE;MASCULIN;FORMATION CONTINUE;BAC PROFESSIONNEL;BAC PRO SERV;BAC PRO 34304 HYGIENE PROPRETE STERILISATION;5;4;4;0;0;0;0;4;0;2;2;0;0;0
5836.0;2021;70;NORMANDIE;MASCULIN;INDIVIDUEL;BAC PROFESSIONNEL;BAC PRO SERV;BAC PRO 30001 GESTION-ADMINISTRATION;5;2;1;1;0;0;0;1;0;0;0;0;1;1
5837.0;2021;70;NORMANDIE;MASCULIN;INDIVIDUEL;BAC PROFESSIONNEL;BAC PRO SERV;BAC PRO 31106 LOGISTIQUE;4;1;0;0;1;1;0;1;0;0;0;0;1;0
5845.0;2021;70;NORMANDIE;MASCULIN;INDIVIDUEL;BAC TECHNOLOGIQUE;BAC STMG;BAC STMG GESTION ET FINANCE;2;2;1;1;0;0;0;1;0;0;0;0;1;1
5858.0;2021;70;NORMANDIE;MASCULIN;SCOLAIRE;BAC PROFESSIONNEL;BAC PRO PROD;BAC PRO 22703 TECHN.INSTALL.SYST.ENERG.CLIMATI;41;40;29;6;5;4;1;33;0;0;4;10;19;7
5860.0;2021;70;NORMANDIE;MASCULIN;SCOLAIRE;BAC PROFESSIONNEL;BAC PRO PROD;BAC PRO 23003 ARTIS. & M.ART:MARCHANDISAGE VIS.;5;5;5;0;0;0;0;5;0;0;0;2;3;0
5862.0;2021;70;NORMANDIE;MASCULIN;SCOLAIRE;BAC PROFESSIONNEL;BAC PRO PROD;BAC PRO 23005 TECHN. ETUDES BAT B ASSIST.ARCHI.;18;18;13;4;1;0;1;13;0;1;3;5;4;5
5872.0;2021;70;NORMANDIE;MASCULIN;SCOLAIRE;BAC PROFESSIONNEL;BAC PRO PROD;BAC PRO 23407 TECHNIC.FAB.BOIS ET MATERX ASSOC;22;22;18;0;4;3;1;21;0;3;5;5;8;1
5875.0;2021;70;NORMANDIE;MASCULIN;SCOLAIRE;BAC PROFESSIONNEL;BAC PRO PROD;BAC PRO 24302 METIERS DU CUIR : MAROQUINERIE;2;2;2;0;0;0;0;2;0;0;1;1;0;0
5877.0;2021;70;NORMANDIE;MASCULIN;SCOLAIRE;BAC PROFESSIONNEL;BAC PRO PROD;BAC PRO 25007 MAINTENANCE EQUIPEMENTS INDUST.;351;351;278;54;19;11;8;289;0;10;56;102;121;62
5881.0;2021;70;NORMANDIE;MASCULIN;SCOLAIRE;BAC PROFESSIONNEL;BAC PRO PROD;BAC PRO 25214 MAINT.VEHIC.OPTA VOIT.PARTICUL.;208;206;171;31;4;3;1;174;0;12;53;59;50;32
5882.0;2021;70;NORMANDIE;MASCULIN;SCOLAIRE;BAC PROFESSIONNEL;BAC PRO PROD;BAC PRO 25215 MAINT.VEHIC.OPTB VEHIC.TRANS.ROUT;29;29;21;7;1;1;0;22;0;3;7;5;7;7
5884.0;2021;70;NORMANDIE;MASCULIN;SCOLAIRE;BAC PROFESSIONNEL;BAC PRO PROD;BAC PRO 25219 MAINT.MATERIELS OPT.A AGRICOLES;70;70;67;3;0;0;0;67;0;8;31;23;5;3
5886.0;2021;70;NORMANDIE;MASCULIN;SCOLAIRE;BAC PROFESSIONNEL;BAC PRO PROD;BAC PRO 25221 MAINT.MATERIELS OPT.C ESP. VERTS;14;14;12;2;0;0;0;12;0;0;4;6;2;2
5890.0;2021;70;NORMANDIE;MASCULIN;SCOLAIRE;BAC PROFESSIONNEL;BAC PRO PROD;BAC PRO 25509 TECHNIC. FROID CONDITIONNEMT AIR;84;84;67;12;5;4;1;71;0;0;16;20;35;13
5906.0;2021;70;NORMANDIE;MASCULIN;SCOLAIRE;BAC PROFESSIONNEL;BAC PRO PROD;BAC PRO AG 22105 LABORATOIRE CONTROLE QUALITE;11;11;10;1;0;0;0;10;0;0;1;4;5;1
5912.0;2021;70;NORMANDIE;MASCULIN;SCOLAIRE;BAC PROFESSIONNEL;BAC PRO SERV;BAC PRO 31202 COMMERCE;457;456;392;23;41;23;18;415;0;25;77;167;146;41
5921.0;2021;70;NORMANDIE;MASCULIN;SCOLAIRE;BAC PROFESSIONNEL;BAC PRO SERV;BAC PRO 33004 ACC.SOINS-S.PERS. OPT.EN STRUCTUR;33;33;27;3;3;2;1;29;0;1;9;12;7;4
5923.0;2021;70;NORMANDIE;MASCULIN;SCOLAIRE;BAC PROFESSIONNEL;BAC PRO SERV;BAC PRO 33102 PROTHESE DENTAIRE;6;6;6;0;0;0;0;6;0;0;1;2;3;0
5926.0;2021;70;NORMANDIE;MASCULIN;SCOLAIRE;BAC PROFESSIONNEL;BAC PRO SERV;BAC PRO 34304 HYGIENE PROPRETE STERILISATION;9;9;8;0;1;1;0;9;0;1;4;0;4;0
5944.0;2021;70;NORMANDIE;MASCULIN;SCOLAIRE;BAC TECHNOLOGIQUE;BAC STMG;BAC STMG RESSOURCES HUMAINES ET COMMUNICATION;335;334;258;21;55;29;26;287;0;1;18;89;179;47
5946.0;2021;18;ORLEANS-TOURS;FEMININ;APPRENTISSAGE;BAC PROFESSIONNEL;BAC PRO PROD;BAC PRO 22104 BOUCHER CHARCUTIER TRAITEUR;2;2;2;0;0;0;0;2;0;0;0;2;0;0
5953.0;2021;18;ORLEANS-TOURS;FEMININ;APPRENTISSAGE;BAC PROFESSIONNEL;BAC PRO PROD;BAC PRO 25410 CONSTRUCTION DES CARROSSERIES;1;1;1;0;0;0;0;1;0;0;1;0;0;0
5959.0;2021;18;ORLEANS-TOURS;FEMININ;APPRENTISSAGE;BAC PROFESSIONNEL;BAC PRO PROD;BAC PRO AG 21211 COND GEST ENTR HIPPIQUE;7;7;6;1;0;0;0;6;0;0;0;4;2;1
5974.0;2021;18;ORLEANS-TOURS;FEMININ;ENSEIGNEMENT A DISTANCE;BAC TECHNOLOGIQUE;BAC ST2S;BAC ST2S SCIENCES & TECHNO. SANTE & SOCIAL;4;4;4;0;0;0;0;4;0;0;2;2;0;0
5976.0;2021;18;ORLEANS-TOURS;FEMININ;FORMATION CONTINUE;BAC PROFESSIONNEL;BAC PRO PROD;BAC PRO 24302 METIERS DU CUIR : MAROQUINERIE;2;2;2;0;0;0;0;2;0;1;1;0;0;0
5979.0;2021;18;ORLEANS-TOURS;FEMININ;FORMATION CONTINUE;BAC PROFESSIONNEL;BAC PRO PROD;BAC PRO 25303 AERONAUTIQUE OPTION SYSTEMES;3;3;3;0;0;0;0;3;0;1;1;1;0;0
5982.0;2021;18;ORLEANS-TOURS;FEMININ;FORMATION CONTINUE;BAC PROFESSIONNEL;BAC PRO SERV;BAC PRO 30001 GESTION-ADMINISTRATION;21;20;19;0;1;1;0;20;0;2;4;7;7;0
5983.0;2021;18;ORLEANS-TOURS;FEMININ;FORMATION CONTINUE;BAC PROFESSIONNEL;BAC PRO SERV;BAC PRO 31202 COMMERCE;5;4;3;0;1;1;0;4;0;1;0;1;2;0
5988.0;2021;18;ORLEANS-TOURS;FEMININ;INDIVIDUEL;BAC PROFESSIONNEL;BAC PRO PROD;BAC PRO AG 21211 COND GEST ENTR HIPPIQUE;5;5;4;1;0;0;0;4;0;0;0;0;4;1
5990.0;2021;18;ORLEANS-TOURS;FEMININ;INDIVIDUEL;BAC PROFESSIONNEL;BAC PRO SERV;BAC PRO 30001 GESTION-ADMINISTRATION;15;12;7;5;0;0;0;7;0;0;0;1;6;5
5991.0;2021;18;ORLEANS-TOURS;FEMININ;INDIVIDUEL;BAC PROFESSIONNEL;BAC PRO SERV;BAC PRO 31106 LOGISTIQUE;1;1;0;1;0;0;0;0;0;0;0;0;0;1
5992.0;2021;18;ORLEANS-TOURS;FEMININ;INDIVIDUEL;BAC PROFESSIONNEL;BAC PRO SERV;BAC PRO 31202 COMMERCE;4;2;0;1;1;0;1;0;0;0;0;0;0;2
5998.0;2021;18;ORLEANS-TOURS;FEMININ;INDIVIDUEL;BAC TECHNOLOGIQUE;BAC ST2S;BAC ST2S SCIENCES & TECHNO. SANTE & SOCIAL;18;12;3;7;2;1;1;4;0;0;0;0;4;8
5999.0;2021;18;ORLEANS-TOURS;FEMININ;INDIVIDUEL;BAC TECHNOLOGIQUE;BAC STI2D;BAC STI2D ARCHITECTURE ET CONSTRUCTION;1;1;0;1;0;0;0;0;0;0;0;0;0;1
6004.0;2021;18;ORLEANS-TOURS;FEMININ;INDIVIDUEL;BAC TECHNOLOGIQUE;BAC STMG;BAC STMG RESSOURCES HUMAINES ET COMMUNICATION;14;8;3;5;0;0;0;3;0;0;0;0;3;5
6006.0;2021;18;ORLEANS-TOURS;FEMININ;SCOLAIRE;BAC GENERAL;BAC GENERAL;BAC GENE 10019 BAC GENERAL;7553;7553;7324;22;207;133;74;7457;165;1028;2087;2592;1585;96
6007.0;2021;18;ORLEANS-TOURS;FEMININ;SCOLAIRE;BAC PROFESSIONNEL;BAC PRO PROD;BACPRO 20002 ETUD.DEFINITION PRDTS INDUSTRIEL;1;1;0;1;0;0;0;0;0;0;0;0;0;1
6014.0;2021;18;ORLEANS-TOURS;FEMININ;SCOLAIRE;BAC PROFESSIONNEL;BAC PRO PROD;BAC PRO 23004 TECHN. ETUDES BAT.A ETUDES & ECO.;10;10;7;0;3;2;1;9;0;0;0;3;6;1
6021.0;2021;18;ORLEANS-TOURS;FEMININ;SCOLAIRE;BAC PROFESSIONNEL;BAC PRO PROD;BAC PRO 24203 METIERS DE LA MODE - VÊTEMENT;84;84;77;4;3;2;1;79;0;8;27;25;19;5
6026.0;2021;18;ORLEANS-TOURS;FEMININ;SCOLAIRE;BAC PROFESSIONNEL;BAC PRO PROD;BAC PRO 25214 MAINT.VEHIC.OPTA VOIT.PARTICUL.;9;9;7;2;0;0;0;7;0;0;2;2;3;2
6027.0;2021;18;ORLEANS-TOURS;FEMININ;SCOLAIRE;BAC PROFESSIONNEL;BAC PRO PROD;BAC PRO 25215 MAINT.VEHIC.OPTB VEHIC.TRANS.ROUT;2;2;2;0;0;0;0;2;0;0;0;2;0;0
6031.0;2021;18;ORLEANS-TOURS;FEMININ;SCOLAIRE;BAC PROFESSIONNEL;BAC PRO PROD;BAC PRO 25410 CONSTRUCTION DES CARROSSERIES;1;1;1;0;0;0;0;1;0;0;0;1;0;0
6035.0;2021;18;ORLEANS-TOURS;FEMININ;SCOLAIRE;BAC PROFESSIONNEL;BAC PRO PROD;BAC PRO 25515 SYST.NUM.OPT.C RES.INF.SYST.COMM.;9;9;6;3;0;0;0;6;0;1;0;2;3;3
6039.0;2021;18;ORLEANS-TOURS;FEMININ;SCOLAIRE;BAC PROFESSIONNEL;BAC PRO PROD;BAC PRO AG 21203 TECHN CONSEIL DE VENTE ANIMAL;42;42;39;3;0;0;0;39;0;1;4;13;21;3
6049.0;2021;18;ORLEANS-TOURS;FEMININ;SCOLAIRE;BAC PROFESSIONNEL;BAC PRO SERV;BAC PRO 31106 LOGISTIQUE;19;19;11;6;2;1;1;12;0;0;3;3;6;7
6057.0;2021;18;ORLEANS-TOURS;FEMININ;SCOLAIRE;BAC PROFESSIONNEL;BAC PRO SERV;BAC PRO 32303 ART.& MET.ART:COM.VIS.VIS.PLURI-M;20;20;20;0;0;0;0;20;0;2;11;3;4;0
6062.0;2021;18;ORLEANS-TOURS;FEMININ;SCOLAIRE;BAC PROFESSIONNEL;BAC PRO SERV;BAC PRO 33102 PROTHESE DENTAIRE;5;5;5;0;0;0;0;5;0;0;1;2;2;0
6063.0;2021;18;ORLEANS-TOURS;FEMININ;SCOLAIRE;BAC PROFESSIONNEL;BAC PRO SERV;BAC PRO 33403 COMMERC. SERVICES EN RESTAURATION;66;66;56;3;7;3;4;59;0;4;16;24;15;7
6067.0;2021;18;ORLEANS-TOURS;FEMININ;SCOLAIRE;BAC PROFESSIONNEL;BAC PRO SERV;BAC PRO 34403 METIERS DE LA SECURITE;19;19;18;0;1;0;1;18;0;0;3;9;6;1
6068.0;2021;18;ORLEANS-TOURS;FEMININ;SCOLAIRE;BAC PROFESSIONNEL;BAC PRO SERV;BAC PRO AG 33002 SERV PERS TERRIT;317;311;302;9;0;0;0;302;0;7;54;123;118;9
6069.0;2021;18;ORLEANS-TOURS;FEMININ;SCOLAIRE;BAC TECHNOLOGIQUE;BAC S2TMD;BAC S2TMD DANSE;5;5;5;0;0;0;0;5;0;1;3;0;1;0
6072.0;2021;18;ORLEANS-TOURS;FEMININ;SCOLAIRE;BAC TECHNOLOGIQUE;BAC STAV;BAC STAV AGRONOMIE ALIM ENV TERRITOI;148;148;143;5;0;0;0;143;0;2;22;63;56;5
6079.0;2021;18;ORLEANS-TOURS;FEMININ;SCOLAIRE;BAC TECHNOLOGIQUE;BAC STL;BAC STL BIOCHIM.-BIOLOGIE-BIOTECHNOL.;133;133;124;0;9;5;4;129;0;6;31;47;45;4
6084.0;2021;18;ORLEANS-TOURS;FEMININ;SCOLAIRE;BAC TECHNOLOGIQUE;BAC STMG;BAC STMG SYSTEMES D'INFORMATION DE GESTION;5;5;4;0;1;0;1;4;0;0;1;2;1;1
6087.0;2021;18;ORLEANS-TOURS;MASCULIN;APPRENTISSAGE;BAC PROFESSIONNEL;BAC PRO PROD;BAC PRO 22704 TECHN. MAINT. SYST.ENERG.CLIMATI;5;5;2;2;1;1;0;3;0;0;0;2;1;2
6088.0;2021;18;ORLEANS-TOURS;MASCULIN;APPRENTISSAGE;BAC PROFESSIONNEL;BAC PRO PROD;BAC PRO 23102 TRAVAUX PUBLICS;29;29;25;1;3;2;1;27;0;1;6;12;8;2
6094.0;2021;18;ORLEANS-TOURS;MASCULIN;APPRENTISSAGE;BAC PROFESSIONNEL;BAC PRO PROD;BAC PRO 23405 TECHNICIEN MENUISIER AGENCEUR;3;3;2;1;0;0;0;2;0;0;0;1;1;1
6097.0;2021;18;ORLEANS-TOURS;MASCULIN;APPRENTISSAGE;BAC PROFESSIONNEL;BAC PRO PROD;BAC PRO 25107 TECHNICIEN OUTILLEUR;3;3;3;0;0;0;0;3;0;0;1;2;0;0
6113.0;2021;18;ORLEANS-TOURS;MASCULIN;APPRENTISSAGE;BAC PROFESSIONNEL;BAC PRO PROD;BAC PRO AG 21004 CGEA;64;59;52;7;0;0;0;52;0;1;4;15;32;7
6118.0;2021;18;ORLEANS-TOURS;MASCULIN;APPRENTISSAGE;BAC PROFESSIONNEL;BAC PRO SERV;BAC PRO 30001 GESTION-ADMINISTRATION;4;4;3;1;0;0;0;3;0;1;1;0;1;1
6121.0;2021;18;ORLEANS-TOURS;MASCULIN;APPRENTISSAGE;BAC PROFESSIONNEL;BAC PRO SERV;BAC PRO 31206 VENTE (PROSPECT.NEGO.SUIV.CLIENT;10;10;9;0;1;0;1;9;0;1;3;4;1;1
6129.0;2021;18;ORLEANS-TOURS;MASCULIN;ENSEIGNEMENT A DISTANCE;BAC TECHNOLOGIQUE;BAC ST2S;BAC ST2S SCIENCES & TECHNO. SANTE & SOCIAL;1;1;1;0;0;0;0;1;0;0;0;1;0;0
6131.0;2021;18;ORLEANS-TOURS;MASCULIN;ENSEIGNEMENT A DISTANCE;BAC TECHNOLOGIQUE;BAC STMG;BAC STMG MERCATIQUE (MARKETING);1;1;1;0;0;0;0;1;0;0;0;1;0;0
6134.0;2021;18;ORLEANS-TOURS;MASCULIN;FORMATION CONTINUE;BAC PROFESSIONNEL;BAC PRO PROD;BAC PRO 22703 TECHN.INSTALL.SYST.ENERG.CLIMATI;2;2;1;1;0;0;0;1;0;0;0;1;0;1
6136.0;2021;18;ORLEANS-TOURS;MASCULIN;FORMATION CONTINUE;BAC PROFESSIONNEL;BAC PRO PROD;BAC PRO 23102 TRAVAUX PUBLICS;3;3;3;0;0;0;0;3;0;0;1;1;1;0
6140.0;2021;18;ORLEANS-TOURS;MASCULIN;FORMATION CONTINUE;BAC PROFESSIONNEL;BAC PRO PROD;BAC PRO 25106 TECHNICIEN D'USINAGE;9;7;6;1;0;0;0;6;0;1;3;1;1;1
6147.0;2021;18;ORLEANS-TOURS;MASCULIN;FORMATION CONTINUE;BAC PROFESSIONNEL;BAC PRO PROD;BAC PRO 25509 TECHNIC. FROID CONDITIONNEMT AIR;5;5;5;0;0;0;0;5;0;0;3;2;0;0
6153.0;2021;18;ORLEANS-TOURS;MASCULIN;FORMATION CONTINUE;BAC PROFESSIONNEL;BAC PRO SERV;BAC PRO 31202 COMMERCE;4;4;4;0;0;0;0;4;0;1;0;0;3;0
6162.0;2021;18;ORLEANS-TOURS;MASCULIN;INDIVIDUEL;BAC PROFESSIONNEL;BAC PRO PROD;BAC PRO 25509 TECHNIC. FROID CONDITIONNEMT AIR;2;1;1;0;0;0;0;1;0;0;0;0;1;0
6163.0;2021;18;ORLEANS-TOURS;MASCULIN;INDIVIDUEL;BAC PROFESSIONNEL;BAC PRO PROD;BAC PRO 25510 METIERS ELECT. ENVIRON. CONNECTES;8;4;3;1;0;0;0;3;0;1;0;1;1;1
6164.0;2021;18;ORLEANS-TOURS;MASCULIN;INDIVIDUEL;BAC PROFESSIONNEL;BAC PRO PROD;BAC PRO 25515 SYST.NUM.OPT.C RES.INF.SYST.COMM.;1;0;0;0;0;0;0;0;0;0;0;0;0;0
6166.0;2021;18;ORLEANS-TOURS;MASCULIN;INDIVIDUEL;BAC PROFESSIONNEL;BAC PRO PROD;BAC PRO AG 21113 CGEVV;2;2;2;0;0;0;0;2;0;0;0;0;2;0
6167.0;2021;18;ORLEANS-TOURS;MASCULIN;INDIVIDUEL;BAC PROFESSIONNEL;BAC PRO PROD;BAC PRO AG 21114 CONDUITE PRODUCTIONS HORTICOLES;6;5;5;0;0;0;0;5;0;0;0;0;5;0
6172.0;2021;18;ORLEANS-TOURS;MASCULIN;INDIVIDUEL;BAC PROFESSIONNEL;BAC PRO SERV;BAC PRO 31202 COMMERCE;7;4;2;2;0;0;0;2;0;0;0;0;2;2
6175.0;2021;18;ORLEANS-TOURS;MASCULIN;INDIVIDUEL;BAC PROFESSIONNEL;BAC PRO SERV;BAC PRO 33002 SERVICES DE PROXIMITE  VIE LOCAL;1;1;0;1;0;0;0;0;0;0;0;0;0;1
6176.0;2021;18;ORLEANS-TOURS;MASCULIN;INDIVIDUEL;BAC TECHNOLOGIQUE;BAC ST2S;BAC ST2S SCIENCES & TECHNO. SANTE & SOCIAL;1;1;0;1;0;0;0;0;0;0;0;0;0;1
6177.0;2021;18;ORLEANS-TOURS;MASCULIN;INDIVIDUEL;BAC TECHNOLOGIQUE;BAC STAV;BAC STAV AGRONOMIE ALIM ENV TERRITOI;2;2;2;0;0;0;0;2;0;0;0;1;1;0
6179.0;2021;18;ORLEANS-TOURS;MASCULIN;INDIVIDUEL;BAC TECHNOLOGIQUE;BAC STI2D;BAC STI2D ARCHITECTURE ET CONSTRUCTION;1;1;0;1;0;0;0;0;0;0;0;0;0;1
6185.0;2021;18;ORLEANS-TOURS;MASCULIN;INDIVIDUEL;BAC TECHNOLOGIQUE;BAC STMG;BAC STMG RESSOURCES HUMAINES ET COMMUNICATION;7;2;1;1;0;0;0;1;0;0;0;0;1;1
6187.0;2021;18;ORLEANS-TOURS;MASCULIN;SCOLAIRE;BAC PROFESSIONNEL;BAC PRO PROD;BACPRO 20002 ETUD.DEFINITION PRDTS INDUSTRIEL;35;35;20;9;6;5;1;25;0;1;5;8;11;10
6190.0;2021;18;ORLEANS-TOURS;MASCULIN;SCOLAIRE;BAC PROFESSIONNEL;BAC PRO PROD;BAC PRO 22105 BOULANGER-PÂTISSIER;15;15;15;0;0;0;0;15;0;0;1;11;3;0
6193.0;2021;18;ORLEANS-TOURS;MASCULIN;SCOLAIRE;BAC PROFESSIONNEL;BAC PRO PROD;BAC PRO 22403 ARTS.& MET.ART:MET.ENSEIGN SIGNA;5;5;5;0;0;0;0;5;0;0;2;2;1;0
6198.0;2021;18;ORLEANS-TOURS;MASCULIN;SCOLAIRE;BAC PROFESSIONNEL;BAC PRO PROD;BAC PRO 23004 TECHN. ETUDES BAT.A ETUDES & ECO.;34;34;23;7;4;3;1;26;0;1;0;10;15;8
6208.0;2021;18;ORLEANS-TOURS;MASCULIN;SCOLAIRE;BAC PROFESSIONNEL;BAC PRO PROD;BAC PRO 23405 TECHNICIEN MENUISIER AGENCEUR;78;78;60;12;6;6;0;66;0;2;10;24;30;12
6225.0;2021;18;ORLEANS-TOURS;MASCULIN;SCOLAIRE;BAC PROFESSIONNEL;BAC PRO PROD;BAC PRO 25406 OUVRAGES DU BATIMENT METALLERIE;15;15;13;2;0;0;0;13;0;0;4;6;3;2
6238.0;2021;18;ORLEANS-TOURS;MASCULIN;SCOLAIRE;BAC PROFESSIONNEL;BAC PRO PROD;BAC PRO AG 21203 TECHN CONSEIL DE VENTE ANIMAL;19;19;18;1;0;0;0;18;0;0;2;7;9;1
6240.0;2021;18;ORLEANS-TOURS;MASCULIN;SCOLAIRE;BAC PROFESSIONNEL;BAC PRO PROD;BAC PRO AG 21212 TECH EXPE ANIMALE;12;12;11;1;0;0;0;11;0;1;1;9;0;1
6241.0;2021;18;ORLEANS-TOURS;MASCULIN;SCOLAIRE;BAC PROFESSIONNEL;BAC PRO PROD;BAC PRO AG 21302 GEST MILIEUX NATURELS FAUNE;27;27;27;0;0;0;0;27;0;0;3;9;15;0
6245.0;2021;18;ORLEANS-TOURS;MASCULIN;SCOLAIRE;BAC PROFESSIONNEL;BAC PRO PROD;BAC PRO AG 22105 LABORATOIRE CONTROLE QUALITE;7;7;6;1;0;0;0;6;0;0;1;1;4;1
6246.0;2021;18;ORLEANS-TOURS;MASCULIN;SCOLAIRE;BAC PROFESSIONNEL;BAC PRO PROD;BAC PRO AG 22106 TEC CONS VTE ALIMENTATION VINS SP;4;4;3;1;0;0;0;3;0;0;0;0;3;1
6248.0;2021;18;ORLEANS-TOURS;MASCULIN;SCOLAIRE;BAC PROFESSIONNEL;BAC PRO SERV;BAC PRO 30001 GESTION-ADMINISTRATION;211;211;158;36;17;13;4;171;0;2;15;63;91;40
6249.0;2021;18;ORLEANS-TOURS;MASCULIN;SCOLAIRE;BAC PROFESSIONNEL;BAC PRO SERV;BAC PRO 31106 LOGISTIQUE;111;111;73;28;10;7;3;80;0;1;8;37;34;31
6251.0;2021;18;ORLEANS-TOURS;MASCULIN;SCOLAIRE;BAC PROFESSIONNEL;BAC PRO SERV;BAC PRO 31108 TRANSPORT;35;35;26;4;5;4;1;30;0;1;3;9;17;5
6255.0;2021;18;ORLEANS-TOURS;MASCULIN;SCOLAIRE;BAC PROFESSIONNEL;BAC PRO SERV;BAC PRO 32207 REAL.PR.IMPR.PLURI.OPTA.PR.GRAPH.;20;20;18;2;0;0;0;18;0;1;5;8;4;2
6262.0;2021;18;ORLEANS-TOURS;MASCULIN;SCOLAIRE;BAC PROFESSIONNEL;BAC PRO SERV;BAC PRO 33102 PROTHESE DENTAIRE;5;5;5;0;0;0;0;5;0;0;2;2;1;0
6271.0;2021;18;ORLEANS-TOURS;MASCULIN;SCOLAIRE;BAC TECHNOLOGIQUE;BAC STD2A;BAC STD2A SCIENCES & TECHNO. DESIGN-ARTS APPLIQUES;57;57;56;0;1;0;1;56;1;2;14;28;11;1
6292.0;2021;01;PARIS;FEMININ;APPRENTISSAGE;BAC PROFESSIONNEL;BAC PRO PROD;BAC PRO 25510 METIERS ELECT. ENVIRON. CONNECTES;3;3;3;0;0;0;0;3;0;2;1;0;0;0
6294.0;2021;01;PARIS;FEMININ;APPRENTISSAGE;BAC PROFESSIONNEL;BAC PRO SERV;BAC PRO 31202 COMMERCE;55;51;38;8;5;3;2;41;0;1;13;4;23;10
6295.0;2021;01;PARIS;FEMININ;APPRENTISSAGE;BAC PROFESSIONNEL;BAC PRO SERV;BAC PRO 31209 POISSONIER ECAILLER TRAITEUR;2;2;0;2;0;0;0;0;0;0;0;0;0;2
6304.0;2021;01;PARIS;FEMININ;APPRENTISSAGE;BAC PROFESSIONNEL;BAC PRO SERV;BAC PRO 34403 METIERS DE LA SECURITE;5;5;5;0;0;0;0;5;0;1;0;3;1;0
6306.0;2021;01;PARIS;FEMININ;ENSEIGNEMENT A DISTANCE;BAC PROFESSIONNEL;BAC PRO SERV;BAC PRO 31202 COMMERCE;1;1;1;0;0;0;0;1;0;0;0;1;0;0
6312.0;2021;01;PARIS;FEMININ;FORMATION CONTINUE;BAC PROFESSIONNEL;BAC PRO PROD;BAC PRO 25510 METIERS ELECT. ENVIRON. CONNECTES;2;2;2;0;0;0;0;2;0;1;1;0;0;0
6314.0;2021;01;PARIS;FEMININ;FORMATION CONTINUE;BAC PROFESSIONNEL;BAC PRO PROD;BAC PRO AG 21405 AMENAGEMENTS PAYSAGERS;6;6;6;0;0;0;0;6;0;0;0;0;6;0
6315.0;2021;01;PARIS;FEMININ;FORMATION CONTINUE;BAC PROFESSIONNEL;BAC PRO SERV;BAC PRO 30001 GESTION-ADMINISTRATION;33;27;19;4;4;4;0;23;0;1;3;8;11;4
6320.0;2021;01;PARIS;FEMININ;INDIVIDUEL;BAC PROFESSIONNEL;BAC PRO PROD;BAC PRO 25214 MAINT.VEHIC.OPTA VOIT.PARTICUL.;1;1;1;0;0;0;0;1;0;1;0;0;0;0
6321.0;2021;01;PARIS;FEMININ;INDIVIDUEL;BAC PROFESSIONNEL;BAC PRO PROD;BAC PRO AG 21004 CGEA;10;7;6;1;0;0;0;6;0;0;0;0;6;1
6324.0;2021;01;PARIS;FEMININ;INDIVIDUEL;BAC PROFESSIONNEL;BAC PRO PROD;BAC PRO AG 21211 COND GEST ENTR HIPPIQUE;2;2;2;0;0;0;0;2;0;0;0;0;2;0
6333.0;2021;01;PARIS;FEMININ;INDIVIDUEL;BAC PROFESSIONNEL;BAC PRO SERV;BAC PRO 33603 ESTHETIQUE COSMETIQUE PARFUMERIE;1;1;0;1;0;0;0;0;0;0;0;0;0;1
6334.0;2021;01;PARIS;FEMININ;INDIVIDUEL;BAC TECHNOLOGIQUE;BAC ST2S;BAC ST2S SCIENCES & TECHNO. SANTE & SOCIAL;10;3;2;0;1;1;0;3;0;0;0;0;3;0
6336.0;2021;01;PARIS;FEMININ;INDIVIDUEL;BAC TECHNOLOGIQUE;BAC STD2A;BAC STD2A SCIENCES & TECHNO. DESIGN-ARTS APPLIQUES;24;24;22;1;1;1;0;23;0;0;2;5;16;1
6342.0;2021;01;PARIS;FEMININ;SCOLAIRE;BAC PROFESSIONNEL;BAC PRO PROD;BAC PRO 22004 PROC. CHIMIE EAU PAPIERS-CARTONS;2;2;2;0;0;0;0;2;0;0;1;1;0;0
6352.0;2021;01;PARIS;FEMININ;SCOLAIRE;BAC PROFESSIONNEL;BAC PRO PROD;BAC PRO 24203 METIERS DE LA MODE - VÊTEMENT;139;139;124;13;2;2;0;126;0;13;29;44;40;13
6360.0;2021;01;PARIS;FEMININ;SCOLAIRE;BAC PROFESSIONNEL;BAC PRO SERV;BAC PRO 30001 GESTION-ADMINISTRATION;356;356;292;36;28;26;2;318;0;12;69;117;120;38
6365.0;2021;01;PARIS;FEMININ;SCOLAIRE;BAC PROFESSIONNEL;BAC PRO SERV;BAC PRO 31210 ACCUEIL -RELATION CLIENTS USAGERS;209;207;168;27;12;12;0;180;0;14;37;66;63;27
6366.0;2021;01;PARIS;FEMININ;SCOLAIRE;BAC PROFESSIONNEL;BAC PRO SERV;BAC PRO 32206 FACONNAGE PRODTS IMPRIMES ROUTAGE;3;3;3;0;0;0;0;3;0;0;2;1;0;0
6367.0;2021;01;PARIS;FEMININ;SCOLAIRE;BAC PROFESSIONNEL;BAC PRO SERV;BAC PRO 32207 REAL.PR.IMPR.PLURI.OPTA.PR.GRAPH.;8;8;4;4;0;0;0;4;0;0;0;2;2;4
6383.0;2021;01;PARIS;FEMININ;SCOLAIRE;BAC TECHNOLOGIQUE;BAC S2TMD;BAC S2TMD MUSIQUE;12;12;12;0;0;0;0;12;1;0;6;5;0;0
6389.0;2021;01;PARIS;FEMININ;SCOLAIRE;BAC TECHNOLOGIQUE;BAC STI2D;BAC STI2D INNOVATION TECHNO.  ET ECO CONCEPTION;21;21;20;0;1;0;1;20;0;0;7;9;4;1
6399.0;2021;01;PARIS;MASCULIN;APPRENTISSAGE;BAC PROFESSIONNEL;BAC PRO PROD;BAC PRO 22106 CUISINE;107;107;99;6;2;1;1;100;0;6;30;41;23;7
6407.0;2021;01;PARIS;MASCULIN;APPRENTISSAGE;BAC PROFESSIONNEL;BAC PRO PROD;BAC PRO 25509 TECHNIC. FROID CONDITIONNEMT AIR;14;14;10;2;2;2;0;12;0;0;2;4;6;2
6409.0;2021;01;PARIS;MASCULIN;APPRENTISSAGE;BAC PROFESSIONNEL;BAC PRO PROD;BAC PRO 25515 SYST.NUM.OPT.C RES.INF.SYST.COMM.;6;6;5;0;1;1;0;6;0;0;2;3;1;0
6416.0;2021;01;PARIS;MASCULIN;APPRENTISSAGE;BAC PROFESSIONNEL;BAC PRO SERV;BAC PRO 32303 ART.& MET.ART:COM.VIS.VIS.PLURI-M;8;7;7;0;0;0;0;7;0;0;3;2;2;0
6420.0;2021;01;PARIS;MASCULIN;ENSEIGNEMENT A DISTANCE;BAC GENERAL;BAC GENERAL;BAC GENE 10019 BAC GENERAL;34;32;31;1;0;0;0;31;1;7;10;6;7;1
6421.0;2021;01;PARIS;MASCULIN;ENSEIGNEMENT A DISTANCE;BAC PROFESSIONNEL;BAC PRO SERV;BAC PRO 30001 GESTION-ADMINISTRATION;2;1;0;1;0;0;0;0;0;0;0;0;0;1
6429.0;2021;01;PARIS;MASCULIN;FORMATION CONTINUE;BAC PROFESSIONNEL;BAC PRO PROD;BAC PRO 24203 METIERS DE LA MODE - VÊTEMENT;2;1;1;0;0;0;0;1;0;0;0;1;0;0
6438.0;2021;01;PARIS;MASCULIN;FORMATION CONTINUE;BAC PROFESSIONNEL;BAC PRO SERV;BAC PRO 33003 ACC.SOINS-S.PERS. OPT.A DOMICILE;1;1;1;0;0;0;0;1;0;0;0;0;1;0
6443.0;2021;01;PARIS;MASCULIN;INDIVIDUEL;BAC PROFESSIONNEL;BAC PRO PROD;BAC PRO 23004 TECHN. ETUDES BAT.A ETUDES & ECO.;1;1;0;1;0;0;0;0;0;0;0;0;0;1
6444.0;2021;01;PARIS;MASCULIN;INDIVIDUEL;BAC PROFESSIONNEL;BAC PRO PROD;BAC PRO 23408 Etude et réalisation d'agencement;1;1;0;1;0;0;0;0;0;0;0;0;0;1
6446.0;2021;01;PARIS;MASCULIN;INDIVIDUEL;BAC PROFESSIONNEL;BAC PRO PROD;BAC PRO 25214 MAINT.VEHIC.OPTA VOIT.PARTICUL.;12;7;7;0;0;0;0;7;0;1;2;3;1;0
6450.0;2021;01;PARIS;MASCULIN;INDIVIDUEL;BAC PROFESSIONNEL;BAC PRO PROD;BAC PRO AG 21113 CGEVV;5;2;0;2;0;0;0;0;0;0;0;0;0;2
6455.0;2021;01;PARIS;MASCULIN;INDIVIDUEL;BAC PROFESSIONNEL;BAC PRO SERV;BAC PRO 31106 LOGISTIQUE;1;1;0;1;0;0;0;0;0;0;0;0;0;1
6458.0;2021;01;PARIS;MASCULIN;INDIVIDUEL;BAC PROFESSIONNEL;BAC PRO SERV;BAC PRO 31210 ACCUEIL -RELATION CLIENTS USAGERS;2;2;1;1;0;0;0;1;0;0;0;0;1;1
6467.0;2021;01;PARIS;MASCULIN;INDIVIDUEL;BAC TECHNOLOGIQUE;BAC STMG;BAC STMG GESTION ET FINANCE;19;17;11;2;4;4;0;15;0;0;1;3;11;2
6469.0;2021;01;PARIS;MASCULIN;INDIVIDUEL;BAC TECHNOLOGIQUE;BAC STMG;BAC STMG RESSOURCES HUMAINES ET COMMUNICATION;16;13;13;0;0;0;0;13;0;0;1;5;7;0
6485.0;2021;01;PARIS;MASCULIN;SCOLAIRE;BAC PROFESSIONNEL;BAC PRO PROD;BAC PRO 23203 TECHNICIEN BAT. : ORG.REAL.GROS O;5;5;3;0;2;1;1;4;0;0;1;1;2;1
6487.0;2021;01;PARIS;MASCULIN;SCOLAIRE;BAC PROFESSIONNEL;BAC PRO PROD;BAC PRO 23304 AMENAGEMENT FINITION BATIMENT;8;8;4;3;1;1;0;5;0;0;0;2;3;3
6492.0;2021;01;PARIS;MASCULIN;SCOLAIRE;BAC PROFESSIONNEL;BAC PRO PROD;BAC PRO 24203 METIERS DE LA MODE - VÊTEMENT;26;26;21;4;1;1;0;22;0;2;4;9;7;4
6500.0;2021;01;PARIS;MASCULIN;SCOLAIRE;BAC PROFESSIONNEL;BAC PRO PROD;BAC PRO 25216 MAINT.VEHIC.OPTC MOTOCYCLES;5;5;4;1;0;0;0;4;0;0;0;1;3;1
6505.0;2021;01;PARIS;MASCULIN;SCOLAIRE;BAC PROFESSIONNEL;BAC PRO PROD;BAC PRO 25513 SYST.NUM.OPT.A SURETE SECURITE;46;46;38;6;2;2;0;40;0;2;3;14;21;6
6511.0;2021;01;PARIS;MASCULIN;SCOLAIRE;BAC PROFESSIONNEL;BAC PRO SERV;BAC PRO 31106 LOGISTIQUE;24;23;17;2;4;4;0;21;0;1;5;5;10;2
6515.0;2021;01;PARIS;MASCULIN;SCOLAIRE;BAC PROFESSIONNEL;BAC PRO SERV;BAC PRO 31210 ACCUEIL -RELATION CLIENTS USAGERS;65;65;40;17;8;8;0;48;0;4;6;15;23;17
6516.0;2021;01;PARIS;MASCULIN;SCOLAIRE;BAC PROFESSIONNEL;BAC PRO SERV;BAC PRO 32206 FACONNAGE PRODTS IMPRIMES ROUTAGE;9;9;7;2;0;0;0;7;0;0;0;3;4;2
6522.0;2021;01;PARIS;MASCULIN;SCOLAIRE;BAC PROFESSIONNEL;BAC PRO SERV;BAC PRO 33003 ACC.SOINS-S.PERS. OPT.A DOMICILE;1;1;1;0;0;0;0;1;0;0;0;0;1;0
6524.0;2021;01;PARIS;MASCULIN;SCOLAIRE;BAC PROFESSIONNEL;BAC PRO SERV;BAC PRO 33101 OPTIQUE LUNETTERIE;7;7;7;0;0;0;0;7;0;1;0;2;4;0
6530.0;2021;01;PARIS;MASCULIN;SCOLAIRE;BAC TECHNOLOGIQUE;BAC S2TMD;BAC S2TMD DANSE;5;5;5;0;0;0;0;5;0;1;4;0;0;0
6536.0;2021;01;PARIS;MASCULIN;SCOLAIRE;BAC TECHNOLOGIQUE;BAC STI2D;BAC STI2D ENERGIES  ET ENVIRONNEMENT;34;34;32;0;2;2;0;34;0;1;2;15;16;0
6538.0;2021;01;PARIS;MASCULIN;SCOLAIRE;BAC TECHNOLOGIQUE;BAC STI2D;BAC STI2D SYSTÈME D'INFORMATION  ET NUMERIQUE;306;306;273;6;27;15;12;288;0;5;51;117;115;18
6542.0;2021;01;PARIS;MASCULIN;SCOLAIRE;BAC TECHNOLOGIQUE;BAC STMG;BAC STMG MERCATIQUE (MARKETING);356;356;323;8;25;22;3;345;0;0;38;147;160;11
6543.0;2021;01;PARIS;MASCULIN;SCOLAIRE;BAC TECHNOLOGIQUE;BAC STMG;BAC STMG RESSOURCES HUMAINES ET COMMUNICATION;179;179;165;12;2;1;1;166;0;2;9;74;81;13
6544.0;2021;01;PARIS;MASCULIN;SCOLAIRE;BAC TECHNOLOGIQUE;BAC STMG;BAC STMG SYSTEMES D'INFORMATION DE GESTION;115;115;105;4;6;4;2;109;0;0;11;47;51;6
6551.0;2021;13;POITIERS;FEMININ;APPRENTISSAGE;BAC PROFESSIONNEL;BAC PRO PROD;BAC PRO 25219 MAINT.MATERIELS OPT.A AGRICOLES;1;1;1;0;0;0;0;1;0;0;1;0;0;0
6555.0;2021;13;POITIERS;FEMININ;APPRENTISSAGE;BAC PROFESSIONNEL;BAC PRO PROD;BAC PRO AG 21004 CGEA;4;4;4;0;0;0;0;4;0;0;1;3;0;0
6558.0;2021;13;POITIERS;FEMININ;APPRENTISSAGE;BAC PROFESSIONNEL;BAC PRO PROD;BAC PRO AG 22107 TEC CONS VTE ALIMENTATION P.ALIM;16;16;15;1;0;0;0;15;0;1;3;6;5;1
6574.0;2021;13;POITIERS;FEMININ;ENSEIGNEMENT A DISTANCE;BAC PROFESSIONNEL;BAC PRO SERV;BAC PRO 33603 ESTHETIQUE COSMETIQUE PARFUMERIE;2;1;1;0;0;0;0;1;0;0;0;0;1;0
6579.0;2021;13;POITIERS;FEMININ;FORMATION CONTINUE;BAC PROFESSIONNEL;BAC PRO PROD;BAC PRO 22106 CUISINE;1;1;1;0;0;0;0;1;0;1;0;0;0;0
6588.0;2021;13;POITIERS;FEMININ;INDIVIDUEL;BAC PROFESSIONNEL;BAC PRO SERV;BAC PRO 31210 ACCUEIL -RELATION CLIENTS USAGERS;1;0;0;0;0;0;0;0;0;0;0;0;0;0
6596.0;2021;13;POITIERS;FEMININ;INDIVIDUEL;BAC TECHNOLOGIQUE;BAC STMG;BAC STMG MERCATIQUE (MARKETING);5;3;1;0;2;1;1;2;0;0;0;0;2;1
6598.0;2021;13;POITIERS;FEMININ;SCOLAIRE;BAC GENERAL;BAC GENERAL;BAC GENE 10019 BAC GENERAL;5178;5178;5006;26;146;91;55;5097;96;626;1453;1763;1159;81
6600.0;2021;13;POITIERS;FEMININ;SCOLAIRE;BAC PROFESSIONNEL;BAC PRO PROD;BAC PRO 20102 PILOTE DE LIGNE DE PRODUCTION;4;4;4;0;0;0;0;4;0;0;1;1;2;0
6602.0;2021;13;POITIERS;FEMININ;SCOLAIRE;BAC PROFESSIONNEL;BAC PRO PROD;BAC PRO 22004 PROC. CHIMIE EAU PAPIERS-CARTONS;1;1;1;0;0;0;0;1;0;0;0;1;0;0
6611.0;2021;13;POITIERS;FEMININ;SCOLAIRE;BAC PROFESSIONNEL;BAC PRO PROD;BAC PRO 24203 METIERS DE LA MODE - VÊTEMENT;60;60;55;5;0;0;0;55;0;7;23;11;14;5
6621.0;2021;13;POITIERS;FEMININ;SCOLAIRE;BAC PROFESSIONNEL;BAC PRO PROD;BAC PRO 25411 TECH.CHAUDRONNERIE INDUSTRIELLE;1;1;1;0;0;0;0;1;0;0;1;0;0;0
6622.0;2021;13;POITIERS;FEMININ;SCOLAIRE;BAC PROFESSIONNEL;BAC PRO PROD;BAC PRO 25509 TECHNIC. FROID CONDITIONNEMT AIR;1;1;1;0;0;0;0;1;0;1;0;0;0;0
6626.0;2021;13;POITIERS;FEMININ;SCOLAIRE;BAC PROFESSIONNEL;BAC PRO PROD;BAC PRO AG 21004 CGEA;52;52;46;6;0;0;0;46;0;0;4;15;27;6
6631.0;2021;13;POITIERS;FEMININ;SCOLAIRE;BAC PROFESSIONNEL;BAC PRO PROD;BAC PRO AG 21210 COND GEST ENTR CANIN ET FELIN;22;22;19;3;0;0;0;19;0;1;5;6;7;3
6633.0;2021;13;POITIERS;FEMININ;SCOLAIRE;BAC PROFESSIONNEL;BAC PRO PROD;BAC PRO AG 21302 GEST MILIEUX NATURELS FAUNE;18;18;17;1;0;0;0;17;0;0;3;4;10;1
6646.0;2021;13;POITIERS;FEMININ;SCOLAIRE;BAC PROFESSIONNEL;BAC PRO SERV;BAC PRO 31210 ACCUEIL -RELATION CLIENTS USAGERS;47;47;37;3;7;5;2;42;0;1;9;14;18;5
6647.0;2021;13;POITIERS;FEMININ;SCOLAIRE;BAC PROFESSIONNEL;BAC PRO SERV;BAC PRO 32207 REAL.PR.IMPR.PLURI.OPTA.PR.GRAPH.;4;4;4;0;0;0;0;4;0;1;0;2;1;0
6656.0;2021;13;POITIERS;FEMININ;SCOLAIRE;BAC PROFESSIONNEL;BAC PRO SERV;BAC PRO 34303 GEST. POLLUTIONS PROTEC. ENVIRON.;2;2;2;0;0;0;0;2;0;0;1;1;0;0
6660.0;2021;13;POITIERS;FEMININ;SCOLAIRE;BAC TECHNOLOGIQUE;BAC STAV;BAC STAV AGRONOMIE ALIM ENV TERRITOI;69;69;67;2;0;0;0;67;0;0;8;37;22;2
6666.0;2021;13;POITIERS;FEMININ;SCOLAIRE;BAC TECHNOLOGIQUE;BAC STI2D;BAC STI2D SYSTÈME D'INFORMATION  ET NUMERIQUE;16;16;14;1;1;0;1;14;0;1;3;7;3;2
6688.0;2021;13;POITIERS;MASCULIN;APPRENTISSAGE;BAC PROFESSIONNEL;BAC PRO PROD;BAC PRO 25215 MAINT.VEHIC.OPTB VEHIC.TRANS.ROUT;36;36;23;9;4;3;1;26;0;1;5;8;12;10
6692.0;2021;13;POITIERS;MASCULIN;APPRENTISSAGE;BAC PROFESSIONNEL;BAC PRO PROD;BAC PRO 25304 AERONAUTIQUE OPTION STRUCTURE;5;5;5;0;0;0;0;5;0;0;1;3;1;0
6694.0;2021;13;POITIERS;MASCULIN;APPRENTISSAGE;BAC PROFESSIONNEL;BAC PRO PROD;BAC PRO 25408 REPARATION DES CARROSSERIES;11;11;10;1;0;0;0;10;0;0;1;3;6;1
6698.0;2021;13;POITIERS;MASCULIN;APPRENTISSAGE;BAC PROFESSIONNEL;BAC PRO PROD;BAC PRO 25513 SYST.NUM.OPT.A SURETE SECURITE;2;2;2;0;0;0;0;2;0;0;0;1;1;0
6705.0;2021;13;POITIERS;MASCULIN;APPRENTISSAGE;BAC PROFESSIONNEL;BAC PRO PROD;BAC PRO AG 22107 TEC CONS VTE ALIMENTATION P.ALIM;7;7;7;0;0;0;0;7;0;0;0;0;7;0
6706.0;2021;13;POITIERS;MASCULIN;APPRENTISSAGE;BAC PROFESSIONNEL;BAC PRO SERV;BAC PRO 30001 GESTION-ADMINISTRATION;1;1;1;0;0;0;0;1;0;0;1;0;0;0
6708.0;2021;13;POITIERS;MASCULIN;APPRENTISSAGE;BAC PROFESSIONNEL;BAC PRO SERV;BAC PRO 31202 COMMERCE;71;68;53;8;7;5;2;58;0;1;10;21;26;10
6717.0;2021;13;POITIERS;MASCULIN;ENSEIGNEMENT A DISTANCE;BAC PROFESSIONNEL;BAC PRO SERV;BAC PRO 31202 COMMERCE;1;1;1;0;0;0;0;1;0;0;1;0;0;0
6730.0;2021;13;POITIERS;MASCULIN;INDIVIDUEL;BAC PROFESSIONNEL;BAC PRO PROD;BAC PRO AG 21113 CGEVV;1;1;1;0;0;0;0;1;0;0;0;0;1;0
6734.0;2021;13;POITIERS;MASCULIN;INDIVIDUEL;BAC TECHNOLOGIQUE;BAC ST2S;BAC ST2S SCIENCES & TECHNO. SANTE & SOCIAL;4;3;1;2;0;0;0;1;0;0;0;0;1;2
6736.0;2021;13;POITIERS;MASCULIN;INDIVIDUEL;BAC TECHNOLOGIQUE;BAC STMG;BAC STMG GESTION ET FINANCE;1;0;0;0;0;0;0;0;0;0;0;0;0;0
6738.0;2021;13;POITIERS;MASCULIN;INDIVIDUEL;BAC TECHNOLOGIQUE;BAC STMG;BAC STMG RESSOURCES HUMAINES ET COMMUNICATION;3;2;1;0;1;0;1;1;0;0;0;1;0;1
6740.0;2021;13;POITIERS;MASCULIN;SCOLAIRE;BAC GENERAL;BAC GENERAL;BAC GENE 10019 BAC GENERAL;4015;4012;3810;34;168;95;73;3905;60;379;835;1408;1223;107
6745.0;2021;13;POITIERS;MASCULIN;SCOLAIRE;BAC PROFESSIONNEL;BAC PRO PROD;BAC PRO 22105 BOULANGER-PÂTISSIER;10;10;9;1;0;0;0;9;0;0;1;6;2;1
6746.0;2021;13;POITIERS;MASCULIN;SCOLAIRE;BAC PROFESSIONNEL;BAC PRO PROD;BAC PRO 22106 CUISINE;72;72;68;1;3;1;2;69;0;8;12;20;29;3
6755.0;2021;13;POITIERS;MASCULIN;SCOLAIRE;BAC PROFESSIONNEL;BAC PRO PROD;BAC PRO 23205 INTERV. SUR PATRIMOINE BATI OPT.A;8;8;4;2;2;1;1;5;0;0;0;3;2;3
6757.0;2021;13;POITIERS;MASCULIN;SCOLAIRE;BAC PROFESSIONNEL;BAC PRO PROD;BAC PRO 23304 AMENAGEMENT FINITION BATIMENT;14;14;11;1;2;1;1;12;0;0;3;5;4;2
6759.0;2021;13;POITIERS;MASCULIN;SCOLAIRE;BAC PROFESSIONNEL;BAC PRO PROD;BAC PRO 23405 TECHNICIEN MENUISIER AGENCEUR;58;57;43;7;7;5;2;48;0;0;6;18;24;9
6766.0;2021;13;POITIERS;MASCULIN;SCOLAIRE;BAC PROFESSIONNEL;BAC PRO PROD;BAC PRO 25106 TECHNICIEN D'USINAGE;68;68;49;12;7;6;1;55;0;3;12;17;23;13
6773.0;2021;13;POITIERS;MASCULIN;SCOLAIRE;BAC PROFESSIONNEL;BAC PRO PROD;BAC PRO 25221 MAINT.MATERIELS OPT.C ESP. VERTS;5;5;4;0;1;0;1;4;0;0;0;3;1;1
6779.0;2021;13;POITIERS;MASCULIN;SCOLAIRE;BAC PROFESSIONNEL;BAC PRO PROD;BAC PRO 25509 TECHNIC. FROID CONDITIONNEMT AIR;6;6;5;1;0;0;0;5;0;0;0;4;1;1
6781.0;2021;13;POITIERS;MASCULIN;SCOLAIRE;BAC PROFESSIONNEL;BAC PRO PROD;BAC PRO 25513 SYST.NUM.OPT.A SURETE SECURITE;22;22;21;1;0;0;0;21;0;1;7;6;7;1
6795.0;2021;13;POITIERS;MASCULIN;SCOLAIRE;BAC PROFESSIONNEL;BAC PRO PROD;BAC PRO AG 21406 TEC CONS VTE PROD DES JARDINS;3;2;1;1;0;0;0;1;0;0;0;0;1;1
6805.0;2021;13;POITIERS;MASCULIN;SCOLAIRE;BAC PROFESSIONNEL;BAC PRO SERV;BAC PRO 31210 ACCUEIL -RELATION CLIENTS USAGERS;10;10;8;2;0;0;0;8;0;0;0;3;5;2
6809.0;2021;13;POITIERS;MASCULIN;SCOLAIRE;BAC PROFESSIONNEL;BAC PRO SERV;BAC PRO 33002 SERVICES DE PROXIMITE  VIE LOCAL;33;33;24;6;3;3;0;27;0;1;4;10;12;6
6823.0;2021;13;POITIERS;MASCULIN;SCOLAIRE;BAC TECHNOLOGIQUE;BAC STI2D;BAC STI2D SYSTÈME D'INFORMATION  ET NUMERIQUE;228;228;205;6;17;8;9;213;0;4;34;94;81;15
6829.0;2021;13;POITIERS;MASCULIN;SCOLAIRE;BAC TECHNOLOGIQUE;BAC STMG;BAC STMG SYSTEMES D'INFORMATION DE GESTION;24;24;23;0;1;1;0;24;0;0;2;8;14;0
6830.0;2021;19;REIMS;FEMININ;APPRENTISSAGE;BAC PROFESSIONNEL;BAC PRO PROD;BAC PRO 20102 PILOTE DE LIGNE DE PRODUCTION;1;1;1;0;0;0;0;1;0;0;1;0;0;0
6837.0;2021;19;REIMS;FEMININ;APPRENTISSAGE;BAC PROFESSIONNEL;BAC PRO PROD;BAC PRO AG 21113 CGEVV;5;5;5;0;0;0;0;5;0;0;1;1;3;0
6848.0;2021;19;REIMS;FEMININ;ENSEIGNEMENT A DISTANCE;BAC PROFESSIONNEL;BAC PRO SERV;BAC PRO 31206 VENTE (PROSPECT.NEGO.SUIV.CLIENT;1;1;1;0;0;0;0;1;0;0;0;1;0;0
6857.0;2021;19;REIMS;FEMININ;FORMATION CONTINUE;BAC PROFESSIONNEL;BAC PRO PROD;BAC PRO 23405 TECHNICIEN MENUISIER AGENCEUR;2;1;1;0;0;0;0;1;0;0;1;0;0;0
6861.0;2021;19;REIMS;FEMININ;FORMATION CONTINUE;BAC PROFESSIONNEL;BAC PRO SERV;BAC PRO 30001 GESTION-ADMINISTRATION;13;13;13;0;0;0;0;13;0;6;2;4;1;0
6863.0;2021;19;REIMS;FEMININ;FORMATION CONTINUE;BAC PROFESSIONNEL;BAC PRO SERV;BAC PRO 31210 ACCUEIL -RELATION CLIENTS USAGERS;4;4;4;0;0;0;0;4;0;1;2;1;0;0
6864.0;2021;19;REIMS;FEMININ;FORMATION CONTINUE;BAC PROFESSIONNEL;BAC PRO SERV;BAC PRO 34403 METIERS DE LA SECURITE;2;2;2;0;0;0;0;2;0;0;0;1;1;0
6867.0;2021;19;REIMS;FEMININ;INDIVIDUEL;BAC PROFESSIONNEL;BAC PRO PROD;BAC PRO AG 21211 COND GEST ENTR HIPPIQUE;2;2;2;0;0;0;0;2;0;0;0;1;1;0
6871.0;2021;19;REIMS;FEMININ;INDIVIDUEL;BAC PROFESSIONNEL;BAC PRO SERV;BAC PRO 33004 ACC.SOINS-S.PERS. OPT.EN STRUCTUR;2;0;0;0;0;0;0;0;0;0;0;0;0;0
6873.0;2021;19;REIMS;FEMININ;INDIVIDUEL;BAC PROFESSIONNEL;BAC PRO SERV;BAC PRO 33603 ESTHETIQUE COSMETIQUE PARFUMERIE;1;1;1;0;0;0;0;1;0;0;0;0;1;0
6876.0;2021;19;REIMS;FEMININ;INDIVIDUEL;BAC TECHNOLOGIQUE;BAC STI2D;BAC STI2D SYSTÈME D'INFORMATION  ET NUMERIQUE;1;1;0;1;0;0;0;0;0;0;0;0;0;1
6880.0;2021;19;REIMS;FEMININ;INDIVIDUEL;BAC TECHNOLOGIQUE;BAC STMG;BAC STMG RESSOURCES HUMAINES ET COMMUNICATION;5;4;1;2;1;0;1;1;0;0;0;0;1;3
6888.0;2021;19;REIMS;FEMININ;SCOLAIRE;BAC PROFESSIONNEL;BAC PRO PROD;BACPRO 23103 TECHNICIEN GEOMETRE-TOPOGRAPHE;2;2;2;0;0;0;0;2;0;0;2;0;0;0
6893.0;2021;19;REIMS;FEMININ;SCOLAIRE;BAC PROFESSIONNEL;BAC PRO PROD;BAC PRO 24203 METIERS DE LA MODE - VÊTEMENT;63;63;44;15;4;3;1;47;0;4;15;16;12;16
6901.0;2021;19;REIMS;FEMININ;SCOLAIRE;BAC PROFESSIONNEL;BAC PRO PROD;BAC PRO 25411 TECH.CHAUDRONNERIE INDUSTRIELLE;1;1;1;0;0;0;0;1;0;0;0;0;1;0
6912.0;2021;19;REIMS;FEMININ;SCOLAIRE;BAC PROFESSIONNEL;BAC PRO PROD;BAC PRO AG 21302 GEST MILIEUX NATURELS FAUNE;5;4;3;1;0;0;0;3;0;0;0;1;2;1
6934.0;2021;19;REIMS;FEMININ;SCOLAIRE;BAC PROFESSIONNEL;BAC PRO SERV;BAC PRO 34304 HYGIENE PROPRETE STERILISATION;10;10;6;1;3;2;1;8;0;0;0;3;5;2
6935.0;2021;19;REIMS;FEMININ;SCOLAIRE;BAC PROFESSIONNEL;BAC PRO SERV;BAC PRO 34305 TECHN.D'INTERV.SUR INSTALL. NUCL.;2;2;2;0;0;0;0;2;0;0;1;1;0;0
6938.0;2021;19;REIMS;FEMININ;SCOLAIRE;BAC TECHNOLOGIQUE;BAC S2TMD;BAC S2TMD DANSE;9;9;9;0;0;0;0;9;1;2;2;3;1;0
6939.0;2021;19;REIMS;FEMININ;SCOLAIRE;BAC TECHNOLOGIQUE;BAC S2TMD;BAC S2TMD MUSIQUE;1;1;1;0;0;0;0;1;0;1;0;0;0;0
6942.0;2021;19;REIMS;FEMININ;SCOLAIRE;BAC TECHNOLOGIQUE;BAC STD2A;BAC STD2A SCIENCES & TECHNO. DESIGN-ARTS APPLIQUES;77;77;77;0;0;0;0;77;1;6;19;33;18;0
6944.0;2021;19;REIMS;FEMININ;SCOLAIRE;BAC TECHNOLOGIQUE;BAC STI2D;BAC STI2D ARCHITECTURE ET CONSTRUCTION;24;24;22;0;2;2;0;24;0;2;5;8;9;0
6945.0;2021;19;REIMS;FEMININ;SCOLAIRE;BAC TECHNOLOGIQUE;BAC STI2D;BAC STI2D ENERGIES  ET ENVIRONNEMENT;7;7;7;0;0;0;0;7;0;0;2;1;4;0
6946.0;2021;19;REIMS;FEMININ;SCOLAIRE;BAC TECHNOLOGIQUE;BAC STI2D;BAC STI2D INNOVATION TECHNO.  ET ECO CONCEPTION;6;6;5;0;1;0;1;5;0;0;2;2;1;1
6951.0;2021;19;REIMS;FEMININ;SCOLAIRE;BAC TECHNOLOGIQUE;BAC STMG;BAC STMG MERCATIQUE (MARKETING);273;273;237;13;23;13;10;250;0;6;39;104;101;23
6958.0;2021;19;REIMS;MASCULIN;APPRENTISSAGE;BAC PROFESSIONNEL;BAC PRO PROD;BAC PRO 22703 TECHN.INSTALL.SYST.ENERG.CLIMATI;4;4;4;0;0;0;0;4;0;1;0;3;0;0
6971.0;2021;19;REIMS;MASCULIN;APPRENTISSAGE;BAC PROFESSIONNEL;BAC PRO PROD;BAC PRO 25219 MAINT.MATERIELS OPT.A AGRICOLES;8;8;7;1;0;0;0;7;0;0;0;1;6;1
6976.0;2021;19;REIMS;MASCULIN;APPRENTISSAGE;BAC PROFESSIONNEL;BAC PRO PROD;BAC PRO 25510 METIERS ELECT. ENVIRON. CONNECTES;41;41;35;5;1;1;0;36;0;2;13;8;13;5
6984.0;2021;19;REIMS;MASCULIN;APPRENTISSAGE;BAC PROFESSIONNEL;BAC PRO SERV;BAC PRO 31202 COMMERCE;18;18;14;3;1;1;0;15;0;1;1;10;3;3
6986.0;2021;19;REIMS;MASCULIN;APPRENTISSAGE;BAC PROFESSIONNEL;BAC PRO SERV;BAC PRO 34305 TECHN.D'INTERV.SUR INSTALL. NUCL.;4;4;4;0;0;0;0;4;0;1;1;1;1;0
6987.0;2021;19;REIMS;MASCULIN;ENSEIGNEMENT A DISTANCE;BAC GENERAL;BAC GENERAL;BAC GENE 10019 BAC GENERAL;8;8;7;0;1;1;0;8;0;0;3;2;3;0
6990.0;2021;19;REIMS;MASCULIN;ENSEIGNEMENT A DISTANCE;BAC PROFESSIONNEL;BAC PRO SERV;BAC PRO 31210 ACCUEIL -RELATION CLIENTS USAGERS;1;1;1;0;0;0;0;1;0;0;0;0;1;0
6991.0;2021;19;REIMS;MASCULIN;ENSEIGNEMENT A DISTANCE;BAC TECHNOLOGIQUE;BAC STMG;BAC STMG MERCATIQUE (MARKETING);1;1;1;0;0;0;0;1;0;0;0;1;0;0
6996.0;2021;19;REIMS;MASCULIN;FORMATION CONTINUE;BAC PROFESSIONNEL;BAC PRO PROD;BAC PRO 25219 MAINT.MATERIELS OPT.A AGRICOLES;2;2;2;0;0;0;0;2;0;0;0;2;0;0
7000.0;2021;19;REIMS;MASCULIN;FORMATION CONTINUE;BAC PROFESSIONNEL;BAC PRO SERV;BAC PRO 33403 COMMERC. SERVICES EN RESTAURATION;1;1;0;1;0;0;0;0;0;0;0;0;0;1
7004.0;2021;19;REIMS;MASCULIN;INDIVIDUEL;BAC PROFESSIONNEL;BAC PRO PROD;BAC PRO 25220 MAINT.MATERIELS OPT.B TP MANUT.;1;0;0;0;0;0;0;0;0;0;0;0;0;0
7005.0;2021;19;REIMS;MASCULIN;INDIVIDUEL;BAC PROFESSIONNEL;BAC PRO PROD;BAC PRO 25510 METIERS ELECT. ENVIRON. CONNECTES;1;1;0;1;0;0;0;0;0;0;0;0;0;1
7010.0;2021;19;REIMS;MASCULIN;INDIVIDUEL;BAC TECHNOLOGIQUE;BAC STI2D;BAC STI2D ENERGIES  ET ENVIRONNEMENT;2;1;0;0;1;0;1;0;0;0;0;0;0;1
7014.0;2021;19;REIMS;MASCULIN;INDIVIDUEL;BAC TECHNOLOGIQUE;BAC STMG;BAC STMG RESSOURCES HUMAINES ET COMMUNICATION;9;9;1;5;3;2;1;3;0;0;0;0;3;6
7026.0;2021;19;REIMS;MASCULIN;SCOLAIRE;BAC PROFESSIONNEL;BAC PRO PROD;BAC PRO 23004 TECHN. ETUDES BAT.A ETUDES & ECO.;14;14;11;2;1;1;0;12;0;0;3;4;5;2
7029.0;2021;19;REIMS;MASCULIN;SCOLAIRE;BAC PROFESSIONNEL;BAC PRO PROD;BACPRO 23103 TECHNICIEN GEOMETRE-TOPOGRAPHE;8;8;6;2;0;0;0;6;0;0;1;2;3;2
7033.0;2021;19;REIMS;MASCULIN;SCOLAIRE;BAC PROFESSIONNEL;BAC PRO PROD;BAC PRO 23404 TECHNICIEN CONSTRUCTEUR BOIS;12;12;8;3;1;1;0;9;0;0;3;2;4;3
7036.0;2021;19;REIMS;MASCULIN;SCOLAIRE;BAC PROFESSIONNEL;BAC PRO PROD;BAC PRO 24203 METIERS DE LA MODE - VÊTEMENT;4;4;2;2;0;0;0;2;0;0;2;0;0;2
7039.0;2021;19;REIMS;MASCULIN;SCOLAIRE;BAC PROFESSIONNEL;BAC PRO PROD;BAC PRO 25214 MAINT.VEHIC.OPTA VOIT.PARTICUL.;109;108;81;21;6;5;1;86;0;5;16;36;29;22
7045.0;2021;19;REIMS;MASCULIN;SCOLAIRE;BAC PROFESSIONNEL;BAC PRO PROD;BAC PRO 25408 REPARATION DES CARROSSERIES;28;28;16;9;3;3;0;19;0;1;0;5;13;9
7050.0;2021;19;REIMS;MASCULIN;SCOLAIRE;BAC PROFESSIONNEL;BAC PRO PROD;BAC PRO 25514 SYST.NUM.OPT.B AUD.RES.EQUIP.DOM.;64;64;51;9;4;1;3;52;0;2;11;22;17;12
7055.0;2021;19;REIMS;MASCULIN;SCOLAIRE;BAC PROFESSIONNEL;BAC PRO PROD;BAC PRO AG 21114 CONDUITE PRODUCTIONS HORTICOLES;3;3;3;0;0;0;0;3;0;0;0;1;2;0
7059.0;2021;19;REIMS;MASCULIN;SCOLAIRE;BAC PROFESSIONNEL;BAC PRO PROD;BAC PRO AG 21303 FORET;26;26;25;1;0;0;0;25;0;2;1;11;11;1
7062.0;2021;19;REIMS;MASCULIN;SCOLAIRE;BAC PROFESSIONNEL;BAC PRO PROD;BAC PRO AG 22106 TEC CONS VTE ALIMENTATION VINS SP;4;4;4;0;0;0;0;4;0;0;0;1;3;0
7069.0;2021;19;REIMS;MASCULIN;SCOLAIRE;BAC PROFESSIONNEL;BAC PRO SERV;BAC PRO 31206 VENTE (PROSPECT.NEGO.SUIV.CLIENT;88;88;56;26;6;2;4;58;0;0;11;22;25;30
7070.0;2021;19;REIMS;MASCULIN;SCOLAIRE;BAC PROFESSIONNEL;BAC PRO SERV;BAC PRO 31210 ACCUEIL -RELATION CLIENTS USAGERS;12;12;5;4;3;3;0;8;0;0;1;1;6;4
7073.0;2021;19;REIMS;MASCULIN;SCOLAIRE;BAC PROFESSIONNEL;BAC PRO SERV;BAC PRO 32303 ART.& MET.ART:COM.VIS.VIS.PLURI-M;22;22;21;1;0;0;0;21;0;1;6;6;8;1
7080.0;2021;19;REIMS;MASCULIN;SCOLAIRE;BAC PROFESSIONNEL;BAC PRO SERV;BAC PRO 34304 HYGIENE PROPRETE STERILISATION;3;3;3;0;0;0;0;3;0;0;1;1;1;0
7083.0;2021;19;REIMS;MASCULIN;SCOLAIRE;BAC PROFESSIONNEL;BAC PRO SERV;BAC PRO AG 33002 SERV PERS TERRIT;18;16;14;2;0;0;0;14;0;0;0;4;10;2
7084.0;2021;19;REIMS;MASCULIN;SCOLAIRE;BAC TECHNOLOGIQUE;BAC S2TMD;BAC S2TMD MUSIQUE;5;5;5;0;0;0;0;5;0;0;0;3;2;0
7090.0;2021;19;REIMS;MASCULIN;SCOLAIRE;BAC TECHNOLOGIQUE;BAC STI2D;BAC STI2D ENERGIES  ET ENVIRONNEMENT;85;85;73;2;10;5;5;78;0;2;10;27;39;7
7093.0;2021;19;REIMS;MASCULIN;SCOLAIRE;BAC TECHNOLOGIQUE;BAC STL;BAC STL BIOCHIM.-BIOLOGIE-BIOTECHNOL.;20;20;17;0;3;2;1;19;0;0;4;6;9;1
7094.0;2021;19;REIMS;MASCULIN;SCOLAIRE;BAC TECHNOLOGIQUE;BAC STL;BAC STL SCIENCES PHYSIQUES CHIMIQUES  EN LABORAT.;19;19;16;0;3;1;2;17;0;0;2;5;10;2
7096.0;2021;19;REIMS;MASCULIN;SCOLAIRE;BAC TECHNOLOGIQUE;BAC STMG;BAC STMG MERCATIQUE (MARKETING);312;312;252;16;44;26;18;278;0;2;22;95;159;34
7101.0;2021;14;RENNES;FEMININ;APPRENTISSAGE;BAC PROFESSIONNEL;BAC PRO PROD;BAC PRO 22106 CUISINE;14;14;13;1;0;0;0;13;0;1;5;4;3;1
7102.0;2021;14;RENNES;FEMININ;APPRENTISSAGE;BAC PROFESSIONNEL;BAC PRO PROD;BAC PRO 25007 MAINTENANCE EQUIPEMENTS INDUST.;2;1;1;0;0;0;0;1;0;0;1;0;0;0
7127.0;2021;14;RENNES;FEMININ;ENSEIGNEMENT A DISTANCE;BAC PROFESSIONNEL;BAC PRO SERV;BAC PRO 31202 COMMERCE;1;1;0;1;0;0;0;0;0;0;0;0;0;1
7129.0;2021;14;RENNES;FEMININ;ENSEIGNEMENT A DISTANCE;BAC PROFESSIONNEL;BAC PRO SERV;BAC PRO 33004 ACC.SOINS-S.PERS. OPT.EN STRUCTUR;3;2;1;1;0;0;0;1;0;1;0;0;0;1
7139.0;2021;14;RENNES;FEMININ;FORMATION CONTINUE;BAC PROFESSIONNEL;BAC PRO SERV;BAC PRO 30001 GESTION-ADMINISTRATION;2;2;1;1;0;0;0;1;0;0;0;0;1;1
7142.0;2021;14;RENNES;FEMININ;INDIVIDUEL;BAC GENERAL;BAC GENERAL;BAC GENE 10019 BAC GENERAL;84;66;45;12;9;4;5;49;0;2;13;17;17;17
7143.0;2021;14;RENNES;FEMININ;INDIVIDUEL;BAC PROFESSIONNEL;BAC PRO PROD;BAC PRO 24203 METIERS DE LA MODE - VÊTEMENT;1;1;0;1;0;0;0;0;0;0;0;0;0;1
7146.0;2021;14;RENNES;FEMININ;INDIVIDUEL;BAC PROFESSIONNEL;BAC PRO PROD;BAC PRO AG 21210 COND GEST ENTR CANIN ET FELIN;1;1;1;0;0;0;0;1;0;0;0;0;1;0
7154.0;2021;14;RENNES;FEMININ;INDIVIDUEL;BAC PROFESSIONNEL;BAC PRO SERV;BAC PRO 31210 ACCUEIL -RELATION CLIENTS USAGERS;3;2;2;0;0;0;0;2;0;0;0;1;1;0
7155.0;2021;14;RENNES;FEMININ;INDIVIDUEL;BAC PROFESSIONNEL;BAC PRO SERV;BAC PRO 33002 SERVICES DE PROXIMITE  VIE LOCAL;1;1;1;0;0;0;0;1;0;0;0;0;1;0
7156.0;2021;14;RENNES;FEMININ;INDIVIDUEL;BAC PROFESSIONNEL;BAC PRO SERV;BAC PRO 33003 ACC.SOINS-S.PERS. OPT.A DOMICILE;1;1;0;0;1;1;0;1;0;0;0;0;1;0
7158.0;2021;14;RENNES;FEMININ;INDIVIDUEL;BAC PROFESSIONNEL;BAC PRO SERV;BAC PRO AG 33002 SERV PERS TERRIT;6;3;2;1;0;0;0;2;0;0;1;0;1;1
7167.0;2021;14;RENNES;FEMININ;SCOLAIRE;BAC PROFESSIONNEL;BAC PRO PROD;BAC PRO 22105 BOULANGER-PÂTISSIER;49;49;48;0;1;0;1;48;0;14;15;14;5;1
7169.0;2021;14;RENNES;FEMININ;SCOLAIRE;BAC PROFESSIONNEL;BAC PRO PROD;BAC PRO 22403 ARTS.& MET.ART:MET.ENSEIGN SIGNA;6;6;6;0;0;0;0;6;0;0;3;3;0;0
7187.0;2021;14;RENNES;FEMININ;SCOLAIRE;BAC PROFESSIONNEL;BAC PRO PROD;BAC PRO 25214 MAINT.VEHIC.OPTA VOIT.PARTICUL.;11;11;10;1;0;0;0;10;0;1;1;5;3;1
7188.0;2021;14;RENNES;FEMININ;SCOLAIRE;BAC PROFESSIONNEL;BAC PRO PROD;BAC PRO 25215 MAINT.VEHIC.OPTB VEHIC.TRANS.ROUT;1;1;1;0;0;0;0;1;0;0;0;1;0;0
7199.0;2021;14;RENNES;FEMININ;SCOLAIRE;BAC PROFESSIONNEL;BAC PRO PROD;BAC PRO 25515 SYST.NUM.OPT.C RES.INF.SYST.COMM.;6;6;6;0;0;0;0;6;0;0;2;2;2;0
7201.0;2021;14;RENNES;FEMININ;SCOLAIRE;BAC PROFESSIONNEL;BAC PRO PROD;BAC PRO AG 21004 CGEA;126;126;113;13;0;0;0;113;0;1;10;38;64;13
7202.0;2021;14;RENNES;FEMININ;SCOLAIRE;BAC PROFESSIONNEL;BAC PRO PROD;BAC PRO AG 21114 CONDUITE PRODUCTIONS HORTICOLES;17;16;11;5;0;0;0;11;0;0;1;6;4;5
7216.0;2021;14;RENNES;FEMININ;SCOLAIRE;BAC PROFESSIONNEL;BAC PRO SERV;BAC PRO 31202 COMMERCE;548;548;511;11;26;17;9;528;0;32;143;228;125;20
7220.0;2021;14;RENNES;FEMININ;SCOLAIRE;BAC PROFESSIONNEL;BAC PRO SERV;BAC PRO 32208 REAL.PR.IMPR.PLURI.OPTB.PR.IMPR.;10;10;10;0;0;0;0;10;0;0;4;2;4;0
7222.0;2021;14;RENNES;FEMININ;SCOLAIRE;BAC PROFESSIONNEL;BAC PRO SERV;BAC PRO 33002 SERVICES DE PROXIMITE  VIE LOCAL;71;71;63;5;3;3;0;66;0;1;14;36;15;5
7231.0;2021;14;RENNES;FEMININ;SCOLAIRE;BAC TECHNOLOGIQUE;BAC S2TMD;BAC S2TMD DANSE;4;4;4;0;0;0;0;4;0;0;1;2;1;0
7237.0;2021;14;RENNES;FEMININ;SCOLAIRE;BAC TECHNOLOGIQUE;BAC STI2D;BAC STI2D ARCHITECTURE ET CONSTRUCTION;47;47;44;1;2;1;1;45;0;2;12;20;11;2
7244.0;2021;14;RENNES;FEMININ;SCOLAIRE;BAC TECHNOLOGIQUE;BAC STMG;BAC STMG MERCATIQUE (MARKETING);1104;1103;1056;10;37;24;13;1080;0;15;210;537;318;23
7246.0;2021;14;RENNES;FEMININ;SCOLAIRE;BAC TECHNOLOGIQUE;BAC STMG;BAC STMG SYSTEMES D'INFORMATION DE GESTION;7;7;4;1;2;1;1;5;0;0;0;2;3;2
7255.0;2021;14;RENNES;MASCULIN;APPRENTISSAGE;BAC PROFESSIONNEL;BAC PRO PROD;BAC PRO 23404 TECHNICIEN CONSTRUCTEUR BOIS;6;6;6;0;0;0;0;6;0;1;2;2;1;0
7256.0;2021;14;RENNES;MASCULIN;APPRENTISSAGE;BAC PROFESSIONNEL;BAC PRO PROD;BAC PRO 23405 TECHNICIEN MENUISIER AGENCEUR;16;16;14;1;1;1;0;15;0;1;1;7;6;1
7260.0;2021;14;RENNES;MASCULIN;APPRENTISSAGE;BAC PROFESSIONNEL;BAC PRO PROD;BAC PRO 25106 TECHNICIEN D'USINAGE;3;3;3;0;0;0;0;3;0;0;0;3;0;0
7274.0;2021;14;RENNES;MASCULIN;APPRENTISSAGE;BAC PROFESSIONNEL;BAC PRO PROD;BAC PRO 25515 SYST.NUM.OPT.C RES.INF.SYST.COMM.;6;6;5;1;0;0;0;5;0;0;1;3;1;1
7279.0;2021;14;RENNES;MASCULIN;APPRENTISSAGE;BAC PROFESSIONNEL;BAC PRO PROD;BAC PRO AG 21210 COND GEST ENTR CANIN ET FELIN;5;5;4;1;0;0;0;4;0;0;0;3;1;1
7284.0;2021;14;RENNES;MASCULIN;APPRENTISSAGE;BAC PROFESSIONNEL;BAC PRO SERV;BAC PRO 30001 GESTION-ADMINISTRATION;2;2;2;0;0;0;0;2;0;1;1;0;0;0
7285.0;2021;14;RENNES;MASCULIN;APPRENTISSAGE;BAC PROFESSIONNEL;BAC PRO SERV;BAC PRO 31106 LOGISTIQUE;25;25;23;1;1;1;0;24;0;2;7;6;9;1
7306.0;2021;14;RENNES;MASCULIN;FORMATION CONTINUE;BAC PROFESSIONNEL;BAC PRO SERV;BAC PRO 31202 COMMERCE;7;7;3;4;0;0;0;3;0;0;0;3;0;4
7310.0;2021;14;RENNES;MASCULIN;INDIVIDUEL;BAC PROFESSIONNEL;BAC PRO PROD;BAC PRO 23005 TECHN. ETUDES BAT B ASSIST.ARCHI.;2;1;0;1;0;0;0;0;0;0;0;0;0;1
7320.0;2021;14;RENNES;MASCULIN;INDIVIDUEL;BAC PROFESSIONNEL;BAC PRO PROD;BAC PRO AG 21113 CGEVV;3;1;1;0;0;0;0;1;0;0;0;0;1;0
7322.0;2021;14;RENNES;MASCULIN;INDIVIDUEL;BAC PROFESSIONNEL;BAC PRO PROD;BAC PRO AG 21211 COND GEST ENTR HIPPIQUE;2;2;2;0;0;0;0;2;0;0;0;1;1;0
7328.0;2021;14;RENNES;MASCULIN;INDIVIDUEL;BAC PROFESSIONNEL;BAC PRO SERV;BAC PRO AG 33002 SERV PERS TERRIT;2;0;0;0;0;0;0;0;0;0;0;0;0;0
7334.0;2021;14;RENNES;MASCULIN;INDIVIDUEL;BAC TECHNOLOGIQUE;BAC STI2D;BAC STI2D SYSTÈME D'INFORMATION  ET NUMERIQUE;2;1;1;0;0;0;0;1;0;0;0;0;1;0
7339.0;2021;14;RENNES;MASCULIN;SCOLAIRE;BAC GENERAL;BAC GENERAL;BAC GENE 10019 BAC GENERAL;8093;8093;7824;34;235;149;86;7973;98;772;1921;3054;2128;120
7341.0;2021;14;RENNES;MASCULIN;SCOLAIRE;BAC PROFESSIONNEL;BAC PRO PROD;BAC PRO 22105 BOULANGER-PÂTISSIER;54;54;51;3;0;0;0;51;0;3;15;25;8;3
7348.0;2021;14;RENNES;MASCULIN;SCOLAIRE;BAC PROFESSIONNEL;BAC PRO PROD;BAC PRO 23004 TECHN. ETUDES BAT.A ETUDES & ECO.;79;79;69;5;5;3;2;72;0;4;7;33;28;7
7354.0;2021;14;RENNES;MASCULIN;SCOLAIRE;BAC PROFESSIONNEL;BAC PRO PROD;BAC PRO 23304 AMENAGEMENT FINITION BATIMENT;37;37;32;1;4;0;4;32;0;1;7;13;11;5
7355.0;2021;14;RENNES;MASCULIN;SCOLAIRE;BAC PROFESSIONNEL;BAC PRO PROD;BAC PRO 23404 TECHNICIEN CONSTRUCTEUR BOIS;62;62;55;2;5;2;3;57;0;1;8;28;20;5
7364.0;2021;14;RENNES;MASCULIN;SCOLAIRE;BAC PROFESSIONNEL;BAC PRO PROD;BAC PRO 25009 MAINTENANCE NAUTIQUE;44;44;39;3;2;1;1;40;0;4;8;13;15;4
7369.0;2021;14;RENNES;MASCULIN;SCOLAIRE;BAC PROFESSIONNEL;BAC PRO PROD;BAC PRO 25216 MAINT.VEHIC.OPTC MOTOCYCLES;39;39;33;6;0;0;0;33;0;0;10;13;10;6
7373.0;2021;14;RENNES;MASCULIN;SCOLAIRE;BAC PROFESSIONNEL;BAC PRO PROD;BAC PRO 25302 AERONAUTIQUE OPTION AVIONIQUE;11;11;11;0;0;0;0;11;0;4;5;0;2;0
7379.0;2021;14;RENNES;MASCULIN;SCOLAIRE;BAC PROFESSIONNEL;BAC PRO PROD;BAC PRO 25509 TECHNIC. FROID CONDITIONNEMT AIR;42;42;34;6;2;1;1;35;0;0;6;15;14;7
7383.0;2021;14;RENNES;MASCULIN;SCOLAIRE;BAC PROFESSIONNEL;BAC PRO PROD;BAC PRO 25515 SYST.NUM.OPT.C RES.INF.SYST.COMM.;216;215;199;10;6;4;2;203;0;18;65;81;39;12
7391.0;2021;14;RENNES;MASCULIN;SCOLAIRE;BAC PROFESSIONNEL;BAC PRO PROD;BAC PRO AG 21302 GEST MILIEUX NATURELS FAUNE;49;49;49;0;0;0;0;49;0;0;4;26;19;0
7394.0;2021;14;RENNES;MASCULIN;SCOLAIRE;BAC PROFESSIONNEL;BAC PRO PROD;BAC PRO AG 21406 TEC CONS VTE PROD DES JARDINS;12;12;11;1;0;0;0;11;0;0;1;7;3;1
7395.0;2021;14;RENNES;MASCULIN;SCOLAIRE;BAC PROFESSIONNEL;BAC PRO PROD;BAC PRO AG 22105 LABORATOIRE CONTROLE QUALITE;16;15;13;2;0;0;0;13;0;0;3;7;3;2
7399.0;2021;14;RENNES;MASCULIN;SCOLAIRE;BAC PROFESSIONNEL;BAC PRO SERV;BAC PRO 31107 CONDUCT. TRANSP.ROUT.MARCHANDISES;108;107;97;10;0;0;0;97;0;10;31;39;17;10
7400.0;2021;14;RENNES;MASCULIN;SCOLAIRE;BAC PROFESSIONNEL;BAC PRO SERV;BAC PRO 31108 TRANSPORT;4;4;4;0;0;0;0;4;0;1;0;0;3;0
7403.0;2021;14;RENNES;MASCULIN;SCOLAIRE;BAC PROFESSIONNEL;BAC PRO SERV;BAC PRO 31210 ACCUEIL -RELATION CLIENTS USAGERS;58;58;46;7;5;5;0;51;0;1;8;13;29;7
7416.0;2021;14;RENNES;MASCULIN;SCOLAIRE;BAC TECHNOLOGIQUE;BAC ST2S;BAC ST2S SCIENCES & TECHNO. SANTE & SOCIAL;138;138;127;1;10;9;1;136;0;2;14;48;72;2
7417.0;2021;14;RENNES;MASCULIN;SCOLAIRE;BAC TECHNOLOGIQUE;BAC STAV;BAC STAV AGRONOMIE ALIM ENV TERRITOI;224;223;220;3;0;0;0;220;0;3;36;97;84;3
7418.0;2021;14;RENNES;MASCULIN;SCOLAIRE;BAC TECHNOLOGIQUE;BAC STD2A;BAC STD2A SCIENCES & TECHNO. DESIGN-ARTS APPLIQUES;39;39;38;0;1;1;0;39;0;7;10;15;7;0
7421.0;2021;14;RENNES;MASCULIN;SCOLAIRE;BAC TECHNOLOGIQUE;BAC STI2D;BAC STI2D ENERGIES  ET ENVIRONNEMENT;291;291;281;2;8;7;1;288;0;5;57;139;87;3
7423.0;2021;14;RENNES;MASCULIN;SCOLAIRE;BAC TECHNOLOGIQUE;BAC STI2D;BAC STI2D SYSTÈME D'INFORMATION  ET NUMERIQUE;487;487;462;2;23;14;9;476;1;10;86;208;171;11
7426.0;2021;14;RENNES;MASCULIN;SCOLAIRE;BAC TECHNOLOGIQUE;BAC STMG;BAC STMG GESTION ET FINANCE;497;497;469;5;23;16;7;485;0;3;82;207;193;12
7429.0;2021;14;RENNES;MASCULIN;SCOLAIRE;BAC TECHNOLOGIQUE;BAC STMG;BAC STMG SYSTEMES D'INFORMATION DE GESTION;37;36;33;1;2;2;0;35;0;1;4;15;15;1
7442.0;2021;15;STRASBOURG;FEMININ;APPRENTISSAGE;BAC PROFESSIONNEL;BAC PRO PROD;BAC PRO AG 21203 TECHN CONSEIL DE VENTE ANIMAL;6;6;6;0;0;0;0;6;0;0;1;3;2;0
7450.0;2021;15;STRASBOURG;FEMININ;APPRENTISSAGE;BAC PROFESSIONNEL;BAC PRO SERV;BAC PRO 32208 REAL.PR.IMPR.PLURI.OPTB.PR.IMPR.;1;1;1;0;0;0;0;1;0;1;0;0;0;0
7451.0;2021;15;STRASBOURG;FEMININ;APPRENTISSAGE;BAC PROFESSIONNEL;BAC PRO SERV;BAC PRO 33403 COMMERC. SERVICES EN RESTAURATION;11;11;10;1;0;0;0;10;0;1;3;3;3;1
7453.0;2021;15;STRASBOURG;FEMININ;ENSEIGNEMENT A DISTANCE;BAC GENERAL;BAC GENERAL;BAC GENE 10019 BAC GENERAL;20;20;20;0;0;0;0;20;3;6;6;2;3;0
7457.0;2021;15;STRASBOURG;FEMININ;ENSEIGNEMENT A DISTANCE;BAC PROFESSIONNEL;BAC PRO SERV;BAC PRO 33603 ESTHETIQUE COSMETIQUE PARFUMERIE;1;0;0;0;0;0;0;0;0;0;0;0;0;0
7464.0;2021;15;STRASBOURG;FEMININ;FORMATION CONTINUE;BAC PROFESSIONNEL;BAC PRO SERV;BAC PRO 30001 GESTION-ADMINISTRATION;1;1;1;0;0;0;0;1;0;0;1;0;0;0
7475.0;2021;15;STRASBOURG;FEMININ;INDIVIDUEL;BAC TECHNOLOGIQUE;BAC ST2S;BAC ST2S SCIENCES & TECHNO. SANTE & SOCIAL;11;6;2;3;1;0;1;2;0;0;0;0;2;4
7477.0;2021;15;STRASBOURG;FEMININ;INDIVIDUEL;BAC TECHNOLOGIQUE;BAC STHR;BAC STHR SC.&TEC. HOTELLERIE-RESTAURATION;1;1;1;0;0;0;0;1;0;0;0;0;1;0
7480.0;2021;15;STRASBOURG;FEMININ;INDIVIDUEL;BAC TECHNOLOGIQUE;BAC STMG;BAC STMG GESTION ET FINANCE;2;1;1;0;0;0;0;1;0;0;0;0;1;0
7486.0;2021;15;STRASBOURG;FEMININ;SCOLAIRE;BAC PROFESSIONNEL;BAC PRO PROD;BAC PRO 22105 BOULANGER-PÂTISSIER;15;15;15;0;0;0;0;15;0;4;5;6;0;0
7488.0;2021;15;STRASBOURG;FEMININ;SCOLAIRE;BAC PROFESSIONNEL;BAC PRO PROD;BAC PRO 22503 PLASTIQUES ET COMPOSITES;2;2;1;1;0;0;0;1;0;0;0;1;0;1
7490.0;2021;15;STRASBOURG;FEMININ;SCOLAIRE;BAC PROFESSIONNEL;BAC PRO PROD;BAC PRO 23005 TECHN. ETUDES BAT B ASSIST.ARCHI.;9;9;8;0;1;1;0;9;0;0;1;4;4;0
7491.0;2021;15;STRASBOURG;FEMININ;SCOLAIRE;BAC PROFESSIONNEL;BAC PRO PROD;BAC PRO 23203 TECHNICIEN BAT. : ORG.REAL.GROS O;1;1;1;0;0;0;0;1;0;0;1;0;0;0
7495.0;2021;15;STRASBOURG;FEMININ;SCOLAIRE;BAC PROFESSIONNEL;BAC PRO PROD;BAC PRO 25006 MICROTECHNIQUES;2;2;1;1;0;0;0;1;0;0;0;1;0;1
7496.0;2021;15;STRASBOURG;FEMININ;SCOLAIRE;BAC PROFESSIONNEL;BAC PRO PROD;BAC PRO 25007 MAINTENANCE EQUIPEMENTS INDUST.;1;1;1;0;0;0;0;1;0;0;0;1;0;0
7497.0;2021;15;STRASBOURG;FEMININ;SCOLAIRE;BAC PROFESSIONNEL;BAC PRO PROD;BAC PRO 25106 TECHNICIEN D'USINAGE;4;4;4;0;0;0;0;4;0;0;0;0;4;0
7498.0;2021;15;STRASBOURG;FEMININ;SCOLAIRE;BAC PROFESSIONNEL;BAC PRO PROD;BAC PRO 25214 MAINT.VEHIC.OPTA VOIT.PARTICUL.;3;3;3;0;0;0;0;3;0;0;2;0;1;0
7499.0;2021;15;STRASBOURG;FEMININ;SCOLAIRE;BAC PROFESSIONNEL;BAC PRO PROD;BAC PRO 25216 MAINT.VEHIC.OPTC MOTOCYCLES;1;1;1;0;0;0;0;1;0;0;0;1;0;0
7501.0;2021;15;STRASBOURG;FEMININ;SCOLAIRE;BAC PROFESSIONNEL;BAC PRO PROD;BAC PRO 25408 REPARATION DES CARROSSERIES;1;1;1;0;0;0;0;1;0;0;0;1;0;0
7510.0;2021;15;STRASBOURG;FEMININ;SCOLAIRE;BAC PROFESSIONNEL;BAC PRO PROD;BAC PRO AG 21405 AMENAGEMENTS PAYSAGERS;5;5;5;0;0;0;0;5;0;0;2;1;2;0
7511.0;2021;15;STRASBOURG;FEMININ;SCOLAIRE;BAC PROFESSIONNEL;BAC PRO PROD;BAC PRO AG 22105 LABORATOIRE CONTROLE QUALITE;9;9;9;0;0;0;0;9;0;0;2;4;3;0
7513.0;2021;15;STRASBOURG;FEMININ;SCOLAIRE;BAC PROFESSIONNEL;BAC PRO SERV;BAC PRO 30001 GESTION-ADMINISTRATION;427;427;331;63;33;14;19;345;0;4;53;139;149;82
7520.0;2021;15;STRASBOURG;FEMININ;SCOLAIRE;BAC PROFESSIONNEL;BAC PRO SERV;BAC PRO 32208 REAL.PR.IMPR.PLURI.OPTB.PR.IMPR.;3;3;3;0;0;0;0;3;0;0;1;0;2;0
7531.0;2021;15;STRASBOURG;FEMININ;SCOLAIRE;BAC TECHNOLOGIQUE;BAC ST2S;BAC ST2S SCIENCES & TECHNO. SANTE & SOCIAL;545;545;521;5;19;5;14;526;0;25;117;248;136;19
7533.0;2021;15;STRASBOURG;FEMININ;SCOLAIRE;BAC TECHNOLOGIQUE;BAC STD2A;BAC STD2A SCIENCES & TECHNO. DESIGN-ARTS APPLIQUES;75;75;73;1;1;0;1;73;6;11;34;16;6;2
7546.0;2021;15;STRASBOURG;MASCULIN;APPRENTISSAGE;BAC PROFESSIONNEL;BAC PRO PROD;BAC PRO 22106 CUISINE;19;19;19;0;0;0;0;19;0;3;4;7;5;0
7549.0;2021;15;STRASBOURG;MASCULIN;APPRENTISSAGE;BAC PROFESSIONNEL;BAC PRO PROD;BAC PRO 22703 TECHN.INSTALL.SYST.ENERG.CLIMATI;13;13;7;2;4;2;2;9;0;0;1;1;7;4
7551.0;2021;15;STRASBOURG;MASCULIN;APPRENTISSAGE;BAC PROFESSIONNEL;BAC PRO PROD;BAC PRO 23102 TRAVAUX PUBLICS;24;23;15;6;2;0;2;15;0;1;8;3;3;8
7567.0;2021;15;STRASBOURG;MASCULIN;APPRENTISSAGE;BAC PROFESSIONNEL;BAC PRO PROD;BAC PRO 25408 REPARATION DES CARROSSERIES;14;14;12;2;0;0;0;12;0;1;5;5;1;2
7585.0;2021;15;STRASBOURG;MASCULIN;APPRENTISSAGE;BAC PROFESSIONNEL;BAC PRO SERV;BAC PRO 32208 REAL.PR.IMPR.PLURI.OPTB.PR.IMPR.;1;1;1;0;0;0;0;1;0;0;1;0;0;0
7590.0;2021;15;STRASBOURG;MASCULIN;ENSEIGNEMENT A DISTANCE;BAC TECHNOLOGIQUE;BAC STMG;BAC STMG MERCATIQUE (MARKETING);3;3;2;0;1;1;0;3;0;1;0;0;2;0
7593.0;2021;15;STRASBOURG;MASCULIN;FORMATION CONTINUE;BAC PROFESSIONNEL;BAC PRO PROD;BAC PRO 22304 ART.MET.ART-FACT.ORG. OPT.ORGAN.;1;0;0;0;0;0;0;0;0;0;0;0;0;0
7611.0;2021;15;STRASBOURG;MASCULIN;INDIVIDUEL;BAC PROFESSIONNEL;BAC PRO PROD;BAC PRO 23405 TECHNICIEN MENUISIER AGENCEUR;2;1;0;1;0;0;0;0;0;0;0;0;0;1
7612.0;2021;15;STRASBOURG;MASCULIN;INDIVIDUEL;BAC PROFESSIONNEL;BAC PRO PROD;BAC PRO 25106 TECHNICIEN D'USINAGE;1;1;0;1;0;0;0;0;0;0;0;0;0;1
7614.0;2021;15;STRASBOURG;MASCULIN;INDIVIDUEL;BAC PROFESSIONNEL;BAC PRO PROD;BAC PRO 25408 REPARATION DES CARROSSERIES;2;0;0;0;0;0;0;0;0;0;0;0;0;0
7630.0;2021;15;STRASBOURG;MASCULIN;INDIVIDUEL;BAC TECHNOLOGIQUE;BAC STMG;BAC STMG RESSOURCES HUMAINES ET COMMUNICATION;9;6;3;1;2;0;2;3;0;0;0;1;2;3
7636.0;2021;15;STRASBOURG;MASCULIN;SCOLAIRE;BAC PROFESSIONNEL;BAC PRO PROD;BAC PRO 22106 CUISINE;61;61;55;5;1;0;1;55;0;5;23;15;12;6
7646.0;2021;15;STRASBOURG;MASCULIN;SCOLAIRE;BAC PROFESSIONNEL;BAC PRO PROD;BAC PRO 23404 TECHNICIEN CONSTRUCTEUR BOIS;21;21;17;0;4;4;0;21;0;0;3;1;17;0
7647.0;2021;15;STRASBOURG;MASCULIN;SCOLAIRE;BAC PROFESSIONNEL;BAC PRO PROD;BAC PRO 23405 TECHNICIEN MENUISIER AGENCEUR;42;42;37;4;1;1;0;38;0;3;5;17;13;4
7653.0;2021;15;STRASBOURG;MASCULIN;SCOLAIRE;BAC PROFESSIONNEL;BAC PRO PROD;BAC PRO 25107 TECHNICIEN OUTILLEUR;11;11;10;1;0;0;0;10;0;0;3;6;1;1
7654.0;2021;15;STRASBOURG;MASCULIN;SCOLAIRE;BAC PROFESSIONNEL;BAC PRO PROD;BAC PRO 25214 MAINT.VEHIC.OPTA VOIT.PARTICUL.;119;119;92;23;4;0;4;92;0;14;22;27;29;27
7657.0;2021;15;STRASBOURG;MASCULIN;SCOLAIRE;BAC PROFESSIONNEL;BAC PRO PROD;BAC PRO 25219 MAINT.MATERIELS OPT.A AGRICOLES;9;9;8;1;0;0;0;8;0;3;1;4;0;1
7665.0;2021;15;STRASBOURG;MASCULIN;SCOLAIRE;BAC PROFESSIONNEL;BAC PRO PROD;BAC PRO 25513 SYST.NUM.OPT.A SURETE SECURITE;29;29;23;4;2;2;0;25;0;0;5;8;12;4
7668.0;2021;15;STRASBOURG;MASCULIN;SCOLAIRE;BAC PROFESSIONNEL;BAC PRO PROD;BAC PRO AG 21004 CGEA;24;24;22;2;0;0;0;22;0;0;7;10;5;2
7675.0;2021;15;STRASBOURG;MASCULIN;SCOLAIRE;BAC PROFESSIONNEL;BAC PRO PROD;BAC PRO AG 22107 TEC CONS VTE ALIMENTATION P.ALIM;6;5;3;2;0;0;0;3;0;0;0;3;0;2
7677.0;2021;15;STRASBOURG;MASCULIN;SCOLAIRE;BAC PROFESSIONNEL;BAC PRO SERV;BAC PRO 31106 LOGISTIQUE;23;23;19;2;2;2;0;21;0;2;1;7;11;2
7678.0;2021;15;STRASBOURG;MASCULIN;SCOLAIRE;BAC PROFESSIONNEL;BAC PRO SERV;BAC PRO 31107 CONDUCT. TRANSP.ROUT.MARCHANDISES;37;37;29;7;1;1;0;30;0;4;10;7;9;7
7688.0;2021;15;STRASBOURG;MASCULIN;SCOLAIRE;BAC PROFESSIONNEL;BAC PRO SERV;BAC PRO 33004 ACC.SOINS-S.PERS. OPT.EN STRUCTUR;26;26;20;2;4;4;0;24;0;1;7;7;9;2
7691.0;2021;15;STRASBOURG;MASCULIN;SCOLAIRE;BAC PROFESSIONNEL;BAC PRO SERV;BAC PRO 33403 COMMERC. SERVICES EN RESTAURATION;32;32;25;5;2;0;2;25;0;1;5;11;8;7
7693.0;2021;15;STRASBOURG;MASCULIN;SCOLAIRE;BAC PROFESSIONNEL;BAC PRO SERV;BAC PRO 34403 METIERS DE LA SECURITE;22;22;20;2;0;0;0;20;0;2;4;9;5;2
7699.0;2021;15;STRASBOURG;MASCULIN;SCOLAIRE;BAC TECHNOLOGIQUE;BAC STI2D;BAC STI2D ARCHITECTURE ET CONSTRUCTION;144;144;134;1;9;3;6;137;0;1;23;56;57;7
7701.0;2021;15;STRASBOURG;MASCULIN;SCOLAIRE;BAC TECHNOLOGIQUE;BAC STI2D;BAC STI2D INNOVATION TECHNO.  ET ECO CONCEPTION;259;259;232;8;19;10;9;242;0;11;51;95;85;17
7702.0;2021;15;STRASBOURG;MASCULIN;SCOLAIRE;BAC TECHNOLOGIQUE;BAC STI2D;BAC STI2D SYSTÈME D'INFORMATION  ET NUMERIQUE;254;254;228;7;19;12;7;240;0;1;37;96;106;14
7705.0;2021;15;STRASBOURG;MASCULIN;SCOLAIRE;BAC TECHNOLOGIQUE;BAC STMG;BAC STMG GESTION ET FINANCE;223;223;187;11;25;13;12;200;0;2;24;75;99;23
7709.0;2021;16;TOULOUSE;FEMININ;APPRENTISSAGE;BAC PROFESSIONNEL;BAC PRO PROD;BAC PRO 22003 BIO-INDUSTRIES DE TRANSFORMATION;1;1;1;0;0;0;0;1;0;0;1;0;0;0
7714.0;2021;16;TOULOUSE;FEMININ;APPRENTISSAGE;BAC PROFESSIONNEL;BAC PRO PROD;BAC PRO 23005 TECHN. ETUDES BAT B ASSIST.ARCHI.;3;3;3;0;0;0;0;3;0;1;1;1;0;0
7715.0;2021;16;TOULOUSE;FEMININ;APPRENTISSAGE;BAC PROFESSIONNEL;BAC PRO PROD;BAC PRO 23102 TRAVAUX PUBLICS;1;1;1;0;0;0;0;1;0;0;0;1;0;0
7718.0;2021;16;TOULOUSE;FEMININ;APPRENTISSAGE;BAC PROFESSIONNEL;BAC PRO PROD;BAC PRO 24302 METIERS DU CUIR : MAROQUINERIE;1;1;0;0;1;1;0;1;0;0;0;0;1;0
7721.0;2021;16;TOULOUSE;FEMININ;APPRENTISSAGE;BAC PROFESSIONNEL;BAC PRO PROD;BAC PRO 25214 MAINT.VEHIC.OPTA VOIT.PARTICUL.;6;6;5;1;0;0;0;5;0;1;1;2;1;1
7723.0;2021;16;TOULOUSE;FEMININ;APPRENTISSAGE;BAC PROFESSIONNEL;BAC PRO PROD;BAC PRO 25302 AERONAUTIQUE OPTION AVIONIQUE;2;2;1;0;1;1;0;2;0;0;1;0;1;0
7726.0;2021;16;TOULOUSE;FEMININ;APPRENTISSAGE;BAC PROFESSIONNEL;BAC PRO PROD;BAC PRO 25411 TECH.CHAUDRONNERIE INDUSTRIELLE;3;3;3;0;0;0;0;3;0;1;1;1;0;0
7731.0;2021;16;TOULOUSE;FEMININ;APPRENTISSAGE;BAC PROFESSIONNEL;BAC PRO SERV;BAC PRO 30001 GESTION-ADMINISTRATION;12;12;11;1;0;0;0;11;0;0;6;2;3;1
7744.0;2021;16;TOULOUSE;FEMININ;ENSEIGNEMENT A DISTANCE;BAC PROFESSIONNEL;BAC PRO SERV;BAC PRO 30001 GESTION-ADMINISTRATION;5;5;4;1;0;0;0;4;0;1;0;3;0;1
7746.0;2021;16;TOULOUSE;FEMININ;ENSEIGNEMENT A DISTANCE;BAC PROFESSIONNEL;BAC PRO SERV;BAC PRO 31210 ACCUEIL -RELATION CLIENTS USAGERS;5;0;0;0;0;0;0;0;0;0;0;0;0;0
7755.0;2021;16;TOULOUSE;FEMININ;FORMATION CONTINUE;BAC PROFESSIONNEL;BAC PRO PROD;BAC PRO 23005 TECHN. ETUDES BAT B ASSIST.ARCHI.;3;3;3;0;0;0;0;3;0;1;0;2;0;0
7761.0;2021;16;TOULOUSE;FEMININ;INDIVIDUEL;BAC GENERAL;BAC GENERAL;BAC GENE 10019 BAC GENERAL;71;47;27;10;10;5;5;32;0;0;5;10;17;15
7764.0;2021;16;TOULOUSE;FEMININ;INDIVIDUEL;BAC PROFESSIONNEL;BAC PRO PROD;BAC PRO AG 21114 CONDUITE PRODUCTIONS HORTICOLES;8;6;6;0;0;0;0;6;0;0;0;0;6;0
7765.0;2021;16;TOULOUSE;FEMININ;INDIVIDUEL;BAC PROFESSIONNEL;BAC PRO PROD;BAC PRO AG 21203 TECHN CONSEIL DE VENTE ANIMAL;1;1;0;1;0;0;0;0;0;0;0;0;0;1
7797.0;2021;16;TOULOUSE;FEMININ;SCOLAIRE;BAC PROFESSIONNEL;BAC PRO PROD;BAC PRO 23304 AMENAGEMENT FINITION BATIMENT;9;9;6;1;2;2;0;8;0;1;1;1;5;1
7799.0;2021;16;TOULOUSE;FEMININ;SCOLAIRE;BAC PROFESSIONNEL;BAC PRO PROD;BAC PRO 23408 Etude et réalisation d'agencement;11;11;9;2;0;0;0;9;0;0;3;2;4;2
7802.0;2021;16;TOULOUSE;FEMININ;SCOLAIRE;BAC PROFESSIONNEL;BAC PRO PROD;BAC PRO 24302 METIERS DU CUIR : MAROQUINERIE;6;6;5;1;0;0;0;5;0;1;3;1;0;1
7816.0;2021;16;TOULOUSE;FEMININ;SCOLAIRE;BAC PROFESSIONNEL;BAC PRO PROD;BAC PRO 25509 TECHNIC. FROID CONDITIONNEMT AIR;1;1;1;0;0;0;0;1;0;0;0;0;1;0
7818.0;2021;16;TOULOUSE;FEMININ;SCOLAIRE;BAC PROFESSIONNEL;BAC PRO PROD;BAC PRO 25514 SYST.NUM.OPT.B AUD.RES.EQUIP.DOM.;1;1;1;0;0;0;0;1;0;0;0;1;0;0
7820.0;2021;16;TOULOUSE;FEMININ;SCOLAIRE;BAC PROFESSIONNEL;BAC PRO PROD;BAC PRO AG 21004 CGEA;119;117;109;8;0;0;0;109;0;4;17;41;47;8
7823.0;2021;16;TOULOUSE;FEMININ;SCOLAIRE;BAC PROFESSIONNEL;BAC PRO PROD;BAC PRO AG 21203 TECHN CONSEIL DE VENTE ANIMAL;49;48;41;7;0;0;0;41;0;3;4;11;23;7
7825.0;2021;16;TOULOUSE;FEMININ;SCOLAIRE;BAC PROFESSIONNEL;BAC PRO PROD;BAC PRO AG 21211 COND GEST ENTR HIPPIQUE;47;47;45;2;0;0;0;45;0;3;6;16;20;2
7828.0;2021;16;TOULOUSE;FEMININ;SCOLAIRE;BAC PROFESSIONNEL;BAC PRO PROD;BAC PRO AG 21405 AMENAGEMENTS PAYSAGERS;10;10;10;0;0;0;0;10;0;0;1;3;6;0
7829.0;2021;16;TOULOUSE;FEMININ;SCOLAIRE;BAC PROFESSIONNEL;BAC PRO PROD;BAC PRO AG 21406 TEC CONS VTE PROD DES JARDINS;7;7;7;0;0;0;0;7;0;0;2;3;2;0
7831.0;2021;16;TOULOUSE;FEMININ;SCOLAIRE;BAC PROFESSIONNEL;BAC PRO PROD;BAC PRO AG 22107 TEC CONS VTE ALIMENTATION P.ALIM;10;9;6;3;0;0;0;6;0;0;1;2;3;3
7832.0;2021;16;TOULOUSE;FEMININ;SCOLAIRE;BAC PROFESSIONNEL;BAC PRO SERV;BAC PRO 30001 GESTION-ADMINISTRATION;475;475;367;82;26;19;7;386;0;14;78;129;165;89
7835.0;2021;16;TOULOUSE;FEMININ;SCOLAIRE;BAC PROFESSIONNEL;BAC PRO SERV;BAC PRO 31108 TRANSPORT;7;7;7;0;0;0;0;7;0;0;2;3;2;0
7858.0;2021;16;TOULOUSE;FEMININ;SCOLAIRE;BAC TECHNOLOGIQUE;BAC STD2A;BAC STD2A SCIENCES & TECHNO. DESIGN-ARTS APPLIQUES;125;125;124;0;1;1;0;125;3;9;45;51;17;0
7868.0;2021;16;TOULOUSE;FEMININ;SCOLAIRE;BAC TECHNOLOGIQUE;BAC STMG;BAC STMG RESSOURCES HUMAINES ET COMMUNICATION;415;415;367;12;36;18;18;385;0;7;51;150;177;30
7876.0;2021;16;TOULOUSE;MASCULIN;APPRENTISSAGE;BAC PROFESSIONNEL;BAC PRO PROD;BAC PRO 22704 TECHN. MAINT. SYST.ENERG.CLIMATI;1;1;1;0;0;0;0;1;0;0;0;0;1;0
7879.0;2021;16;TOULOUSE;MASCULIN;APPRENTISSAGE;BAC PROFESSIONNEL;BAC PRO PROD;BAC PRO 23005 TECHN. ETUDES BAT B ASSIST.ARCHI.;5;4;4;0;0;0;0;4;0;1;1;1;1;0
7882.0;2021;16;TOULOUSE;MASCULIN;APPRENTISSAGE;BAC PROFESSIONNEL;BAC PRO PROD;BAC PRO 23205 INTERV. SUR PATRIMOINE BATI OPT.A;3;2;2;0;0;0;0;2;0;1;0;0;1;0
7883.0;2021;16;TOULOUSE;MASCULIN;APPRENTISSAGE;BAC PROFESSIONNEL;BAC PRO PROD;BAC PRO 23206 INTERV. SUR PATRIMOINE BATI OPT.B;3;3;3;0;0;0;0;3;0;0;1;2;0;0
7884.0;2021;16;TOULOUSE;MASCULIN;APPRENTISSAGE;BAC PROFESSIONNEL;BAC PRO PROD;BAC PRO 23303 MENUISERIE ALUMINIUM-VERRE;3;3;3;0;0;0;0;3;0;1;1;1;0;0
7893.0;2021;16;TOULOUSE;MASCULIN;APPRENTISSAGE;BAC PROFESSIONNEL;BAC PRO PROD;BAC PRO 25216 MAINT.VEHIC.OPTC MOTOCYCLES;10;10;9;0;1;1;0;10;0;0;1;5;4;0
7897.0;2021;16;TOULOUSE;MASCULIN;APPRENTISSAGE;BAC PROFESSIONNEL;BAC PRO PROD;BAC PRO 25302 AERONAUTIQUE OPTION AVIONIQUE;1;1;1;0;0;0;0;1;0;0;1;0;0;0
7907.0;2021;16;TOULOUSE;MASCULIN;APPRENTISSAGE;BAC PROFESSIONNEL;BAC PRO PROD;BAC PRO AG 21405 AMENAGEMENTS PAYSAGERS;21;20;19;1;0;0;0;19;0;1;2;4;12;1
7910.0;2021;16;TOULOUSE;MASCULIN;APPRENTISSAGE;BAC PROFESSIONNEL;BAC PRO SERV;BAC PRO 31106 LOGISTIQUE;14;14;12;1;1;1;0;13;0;2;1;6;4;1
7918.0;2021;16;TOULOUSE;MASCULIN;APPRENTISSAGE;BAC PROFESSIONNEL;BAC PRO SERV;BAC PRO 34403 METIERS DE LA SECURITE;1;1;0;0;1;1;0;1;0;0;0;0;1;0
7919.0;2021;16;TOULOUSE;MASCULIN;ENSEIGNEMENT A DISTANCE;BAC GENERAL;BAC GENERAL;BAC GENE 10019 BAC GENERAL;37;36;31;4;1;0;1;31;0;5;18;5;3;5
7923.0;2021;16;TOULOUSE;MASCULIN;ENSEIGNEMENT A DISTANCE;BAC PROFESSIONNEL;BAC PRO SERV;BAC PRO 31206 VENTE (PROSPECT.NEGO.SUIV.CLIENT;2;2;1;1;0;0;0;1;0;0;0;0;1;1
7931.0;2021;16;TOULOUSE;MASCULIN;FORMATION CONTINUE;BAC PROFESSIONNEL;BAC PRO PROD;BAC PRO 23005 TECHN. ETUDES BAT B ASSIST.ARCHI.;10;6;6;0;0;0;0;6;0;2;2;2;0;0
7936.0;2021;16;TOULOUSE;MASCULIN;FORMATION CONTINUE;BAC PROFESSIONNEL;BAC PRO PROD;BAC PRO AG 21004 CGEA;6;6;5;1;0;0;0;5;0;1;1;2;1;1
7938.0;2021;16;TOULOUSE;MASCULIN;FORMATION CONTINUE;BAC PROFESSIONNEL;BAC PRO SERV;BAC PRO 33403 COMMERC. SERVICES EN RESTAURATION;1;1;0;0;1;1;0;1;0;0;0;0;1;0
7944.0;2021;16;TOULOUSE;MASCULIN;INDIVIDUEL;BAC PROFESSIONNEL;BAC PRO PROD;BAC PRO 25215 MAINT.VEHIC.OPTB VEHIC.TRANS.ROUT;1;1;0;1;0;0;0;0;0;0;0;0;0;1
7946.0;2021;16;TOULOUSE;MASCULIN;INDIVIDUEL;BAC PROFESSIONNEL;BAC PRO PROD;BAC PRO 25510 METIERS ELECT. ENVIRON. CONNECTES;4;2;1;1;0;0;0;1;0;0;0;1;0;1
7955.0;2021;16;TOULOUSE;MASCULIN;INDIVIDUEL;BAC PROFESSIONNEL;BAC PRO SERV;BAC PRO 31202 COMMERCE;5;3;1;1;1;1;0;2;0;0;0;1;1;1
7961.0;2021;16;TOULOUSE;MASCULIN;INDIVIDUEL;BAC TECHNOLOGIQUE;BAC STHR;BAC STHR SC.&TEC. HOTELLERIE-RESTAURATION;1;0;0;0;0;0;0;0;0;0;0;0;0;0
7977.0;2021;16;TOULOUSE;MASCULIN;SCOLAIRE;BAC PROFESSIONNEL;BAC PRO PROD;BAC PRO 22403 ARTS.& MET.ART:MET.ENSEIGN SIGNA;9;9;9;0;0;0;0;9;0;0;1;6;2;0
7978.0;2021;16;TOULOUSE;MASCULIN;SCOLAIRE;BAC PROFESSIONNEL;BAC PRO PROD;BAC PRO 22503 PLASTIQUES ET COMPOSITES;14;14;13;1;0;0;0;13;0;0;3;5;5;1
7982.0;2021;16;TOULOUSE;MASCULIN;SCOLAIRE;BAC PROFESSIONNEL;BAC PRO PROD;BAC PRO 23004 TECHN. ETUDES BAT.A ETUDES & ECO.;53;53;38;10;5;3;2;41;0;2;10;10;19;12
7990.0;2021;16;TOULOUSE;MASCULIN;SCOLAIRE;BAC PROFESSIONNEL;BAC PRO PROD;BAC PRO 23404 TECHNICIEN CONSTRUCTEUR BOIS;30;30;22;5;3;1;2;23;0;0;3;6;14;7
7991.0;2021;16;TOULOUSE;MASCULIN;SCOLAIRE;BAC PROFESSIONNEL;BAC PRO PROD;BAC PRO 23405 TECHNICIEN MENUISIER AGENCEUR;52;52;50;2;0;0;0;50;0;2;10;28;10;2
8009.0;2021;16;TOULOUSE;MASCULIN;SCOLAIRE;BAC PROFESSIONNEL;BAC PRO PROD;BAC PRO 25303 AERONAUTIQUE OPTION SYSTEMES;23;23;22;1;0;0;0;22;0;2;5;9;6;1
8019.0;2021;16;TOULOUSE;MASCULIN;SCOLAIRE;BAC PROFESSIONNEL;BAC PRO PROD;BAC PRO AG 21001 AGRO-EQUIPEMENT;26;26;23;3;0;0;0;23;0;1;5;8;9;3
8021.0;2021;16;TOULOUSE;MASCULIN;SCOLAIRE;BAC PROFESSIONNEL;BAC PRO PROD;BAC PRO AG 21113 CGEVV;5;5;5;0;0;0;0;5;0;0;2;2;1;0
8022.0;2021;16;TOULOUSE;MASCULIN;SCOLAIRE;BAC PROFESSIONNEL;BAC PRO PROD;BAC PRO AG 21114 CONDUITE PRODUCTIONS HORTICOLES;18;17;15;2;0;0;0;15;0;0;5;4;6;2
8023.0;2021;16;TOULOUSE;MASCULIN;SCOLAIRE;BAC PROFESSIONNEL;BAC PRO PROD;BAC PRO AG 21203 TECHN CONSEIL DE VENTE ANIMAL;18;18;15;3;0;0;0;15;0;0;0;5;10;3
8025.0;2021;16;TOULOUSE;MASCULIN;SCOLAIRE;BAC PROFESSIONNEL;BAC PRO PROD;BAC PRO AG 21211 COND GEST ENTR HIPPIQUE;3;3;2;1;0;0;0;2;0;0;0;0;2;1
8026.0;2021;16;TOULOUSE;MASCULIN;SCOLAIRE;BAC PROFESSIONNEL;BAC PRO PROD;BAC PRO AG 21302 GEST MILIEUX NATURELS FAUNE;82;80;78;2;0;0;0;78;0;0;14;33;31;2
8028.0;2021;16;TOULOUSE;MASCULIN;SCOLAIRE;BAC PROFESSIONNEL;BAC PRO PROD;BAC PRO AG 21405 AMENAGEMENTS PAYSAGERS;77;77;75;2;0;0;0;75;0;2;18;26;29;2
8033.0;2021;16;TOULOUSE;MASCULIN;SCOLAIRE;BAC PROFESSIONNEL;BAC PRO SERV;BAC PRO 31106 LOGISTIQUE;40;40;25;9;6;6;0;31;0;2;3;15;11;9
8036.0;2021;16;TOULOUSE;MASCULIN;SCOLAIRE;BAC PROFESSIONNEL;BAC PRO SERV;BAC PRO 31202 COMMERCE;497;496;403;34;59;48;11;451;0;20;89;164;178;45
8050.0;2021;16;TOULOUSE;MASCULIN;SCOLAIRE;BAC PROFESSIONNEL;BAC PRO SERV;BAC PRO 34403 METIERS DE LA SECURITE;57;57;53;3;1;0;1;53;0;3;13;23;14;4
8051.0;2021;16;TOULOUSE;MASCULIN;SCOLAIRE;BAC PROFESSIONNEL;BAC PRO SERV;BAC PRO AG 33002 SERV PERS TERRIT;43;42;41;1;0;0;0;41;0;0;11;22;8;1
8058.0;2021;16;TOULOUSE;MASCULIN;SCOLAIRE;BAC TECHNOLOGIQUE;BAC STI2D;BAC STI2D ARCHITECTURE ET CONSTRUCTION;229;229;219;2;8;6;2;225;0;8;45;87;85;4
8060.0;2021;16;TOULOUSE;MASCULIN;SCOLAIRE;BAC TECHNOLOGIQUE;BAC STI2D;BAC STI2D INNOVATION TECHNO.  ET ECO CONCEPTION;420;420;391;7;22;11;11;402;0;10;63;161;168;18
8061.0;2021;16;TOULOUSE;MASCULIN;SCOLAIRE;BAC TECHNOLOGIQUE;BAC STI2D;BAC STI2D SYSTÈME D'INFORMATION  ET NUMERIQUE;435;435;402;5;28;20;8;422;0;15;78;162;167;13
8065.0;2021;16;TOULOUSE;MASCULIN;SCOLAIRE;BAC TECHNOLOGIQUE;BAC STMG;BAC STMG MERCATIQUE (MARKETING);767;766;664;25;77;43;34;707;0;9;75;273;350;59
8080.0;2021;25;VERSAILLES;FEMININ;APPRENTISSAGE;BAC PROFESSIONNEL;BAC PRO PROD;BAC PRO AG 21203 TECHN CONSEIL DE VENTE ANIMAL;9;9;8;1;0;0;0;8;0;0;0;2;6;1
8082.0;2021;25;VERSAILLES;FEMININ;APPRENTISSAGE;BAC PROFESSIONNEL;BAC PRO PROD;BAC PRO AG 21211 COND GEST ENTR HIPPIQUE;41;38;37;1;0;0;0;37;0;0;12;13;12;1
8084.0;2021;25;VERSAILLES;FEMININ;APPRENTISSAGE;BAC PROFESSIONNEL;BAC PRO SERV;BAC PRO 30001 GESTION-ADMINISTRATION;69;64;47;11;6;4;2;51;0;3;13;21;14;13
8086.0;2021;25;VERSAILLES;FEMININ;APPRENTISSAGE;BAC PROFESSIONNEL;BAC PRO SERV;BAC PRO 31109 TRANSPORT FLUVIAL;1;1;1;0;0;0;0;1;0;0;1;0;0;0
8087.0;2021;25;VERSAILLES;FEMININ;APPRENTISSAGE;BAC PROFESSIONNEL;BAC PRO SERV;BAC PRO 31202 COMMERCE;103;94;79;8;7;5;2;84;0;10;14;31;29;10
8088.0;2021;25;VERSAILLES;FEMININ;APPRENTISSAGE;BAC PROFESSIONNEL;BAC PRO SERV;BAC PRO 31206 VENTE (PROSPECT.NEGO.SUIV.CLIENT;1;1;1;0;0;0;0;1;0;1;0;0;0;0
8090.0;2021;25;VERSAILLES;FEMININ;APPRENTISSAGE;BAC PROFESSIONNEL;BAC PRO SERV;BAC PRO 33403 COMMERC. SERVICES EN RESTAURATION;26;26;23;2;1;1;0;24;0;3;7;11;3;2
8095.0;2021;25;VERSAILLES;FEMININ;ENSEIGNEMENT A DISTANCE;BAC PROFESSIONNEL;BAC PRO SERV;BAC PRO 31202 COMMERCE;4;3;2;1;0;0;0;2;0;0;0;1;1;1
8099.0;2021;25;VERSAILLES;FEMININ;ENSEIGNEMENT A DISTANCE;BAC PROFESSIONNEL;BAC PRO SERV;BAC PRO 33603 ESTHETIQUE COSMETIQUE PARFUMERIE;5;2;0;2;0;0;0;0;0;0;0;0;0;2
8101.0;2021;25;VERSAILLES;FEMININ;ENSEIGNEMENT A DISTANCE;BAC TECHNOLOGIQUE;BAC STMG;BAC STMG GESTION ET FINANCE;5;5;3;1;1;1;0;4;0;3;0;0;1;1
8102.0;2021;25;VERSAILLES;FEMININ;ENSEIGNEMENT A DISTANCE;BAC TECHNOLOGIQUE;BAC STMG;BAC STMG MERCATIQUE (MARKETING);6;6;6;0;0;0;0;6;0;0;3;1;2;0
8106.0;2021;25;VERSAILLES;FEMININ;FORMATION CONTINUE;BAC PROFESSIONNEL;BAC PRO PROD;BAC PRO 23004 TECHN. ETUDES BAT.A ETUDES & ECO.;3;3;2;0;1;1;0;3;0;1;0;1;1;0
8109.0;2021;25;VERSAILLES;FEMININ;FORMATION CONTINUE;BAC PROFESSIONNEL;BAC PRO SERV;BAC PRO 30001 GESTION-ADMINISTRATION;14;12;10;1;1;1;0;11;0;1;3;3;4;1
8110.0;2021;25;VERSAILLES;FEMININ;FORMATION CONTINUE;BAC PROFESSIONNEL;BAC PRO SERV;BAC PRO 31202 COMMERCE;5;5;4;1;0;0;0;4;0;1;1;1;1;1
8122.0;2021;25;VERSAILLES;FEMININ;INDIVIDUEL;BAC PROFESSIONNEL;BAC PRO PROD;BAC PRO AG 21203 TECHN CONSEIL DE VENTE ANIMAL;1;0;0;0;0;0;0;0;0;0;0;0;0;0
8130.0;2021;25;VERSAILLES;FEMININ;INDIVIDUEL;BAC PROFESSIONNEL;BAC PRO SERV;BAC PRO 33003 ACC.SOINS-S.PERS. OPT.A DOMICILE;4;2;1;1;0;0;0;1;0;0;0;0;1;1
8139.0;2021;25;VERSAILLES;FEMININ;INDIVIDUEL;BAC TECHNOLOGIQUE;BAC STL;BAC STL BIOCHIM.-BIOLOGIE-BIOTECHNOL.;5;1;0;1;0;0;0;0;0;0;0;0;0;1
8151.0;2021;25;VERSAILLES;FEMININ;SCOLAIRE;BAC PROFESSIONNEL;BAC PRO PROD;BAC PRO 22703 TECHN.INSTALL.SYST.ENERG.CLIMATI;1;1;0;0;1;0;1;0;0;0;0;0;0;1
8158.0;2021;25;VERSAILLES;FEMININ;SCOLAIRE;BAC PROFESSIONNEL;BAC PRO PROD;BAC PRO 23408 Etude et réalisation d'agencement;22;21;17;4;0;0;0;17;0;0;3;9;5;4
8160.0;2021;25;VERSAILLES;FEMININ;SCOLAIRE;BAC PROFESSIONNEL;BAC PRO PROD;BAC PRO 24203 METIERS DE LA MODE - VÊTEMENT;131;129;105;22;2;1;1;106;0;11;25;33;37;23
8167.0;2021;25;VERSAILLES;FEMININ;SCOLAIRE;BAC PROFESSIONNEL;BAC PRO PROD;BAC PRO 25216 MAINT.VEHIC.OPTC MOTOCYCLES;3;3;3;0;0;0;0;3;0;0;2;1;0;0
8172.0;2021;25;VERSAILLES;FEMININ;SCOLAIRE;BAC PROFESSIONNEL;BAC PRO PROD;BAC PRO 25514 SYST.NUM.OPT.B AUD.RES.EQUIP.DOM.;10;10;10;0;0;0;0;10;0;0;2;6;2;0
8174.0;2021;25;VERSAILLES;FEMININ;SCOLAIRE;BAC PROFESSIONNEL;BAC PRO PROD;BAC PRO AG 21004 CGEA;12;12;12;0;0;0;0;12;0;0;0;5;7;0
8185.0;2021;25;VERSAILLES;FEMININ;SCOLAIRE;BAC PROFESSIONNEL;BAC PRO SERV;BAC PRO 31210 ACCUEIL -RELATION CLIENTS USAGERS;514;514;383;92;39;31;8;414;0;17;79;157;161;100
8190.0;2021;25;VERSAILLES;FEMININ;SCOLAIRE;BAC PROFESSIONNEL;BAC PRO SERV;BAC PRO 32304 PHOTOGRAPHIE;13;13;10;3;0;0;0;10;0;0;5;4;1;3
8193.0;2021;25;VERSAILLES;FEMININ;SCOLAIRE;BAC PROFESSIONNEL;BAC PRO SERV;BAC PRO 33004 ACC.SOINS-S.PERS. OPT.EN STRUCTUR;1181;1178;1043;67;68;28;40;1071;0;56;294;413;308;107
8196.0;2021;25;VERSAILLES;FEMININ;SCOLAIRE;BAC PROFESSIONNEL;BAC PRO SERV;BAC PRO 33403 COMMERC. SERVICES EN RESTAURATION;54;54;38;11;5;1;4;39;0;4;6;14;15;15
8209.0;2021;25;VERSAILLES;FEMININ;SCOLAIRE;BAC TECHNOLOGIQUE;BAC STI2D;BAC STI2D INNOVATION TECHNO.  ET ECO CONCEPTION;72;72;67;3;2;1;1;68;0;5;13;23;27;4
8210.0;2021;25;VERSAILLES;FEMININ;SCOLAIRE;BAC TECHNOLOGIQUE;BAC STI2D;BAC STI2D SYSTÈME D'INFORMATION  ET NUMERIQUE;45;45;40;3;2;2;0;42;0;2;15;14;11;3
8212.0;2021;25;VERSAILLES;FEMININ;SCOLAIRE;BAC TECHNOLOGIQUE;BAC STL;BAC STL SCIENCES PHYSIQUES CHIMIQUES  EN LABORAT.;63;63;59;2;2;0;2;59;0;3;11;19;26;4
8224.0;2021;25;VERSAILLES;MASCULIN;APPRENTISSAGE;BAC PROFESSIONNEL;BAC PRO PROD;BAC PRO 25106 TECHNICIEN D'USINAGE;14;12;10;1;1;1;0;11;0;0;3;3;5;1
8228.0;2021;25;VERSAILLES;MASCULIN;APPRENTISSAGE;BAC PROFESSIONNEL;BAC PRO PROD;BAC PRO 25220 MAINT.MATERIELS OPT.B TP MANUT.;15;15;13;2;0;0;0;13;0;0;2;5;6;2
8231.0;2021;25;VERSAILLES;MASCULIN;APPRENTISSAGE;BAC PROFESSIONNEL;BAC PRO PROD;BAC PRO 25303 AERONAUTIQUE OPTION SYSTEMES;74;74;70;2;2;0;2;70;0;14;24;26;6;4
8238.0;2021;25;VERSAILLES;MASCULIN;APPRENTISSAGE;BAC PROFESSIONNEL;BAC PRO PROD;BAC PRO 25515 SYST.NUM.OPT.C RES.INF.SYST.COMM.;13;13;12;1;0;0;0;12;0;0;1;5;6;1
8242.0;2021;25;VERSAILLES;MASCULIN;APPRENTISSAGE;BAC PROFESSIONNEL;BAC PRO SERV;BAC PRO 30001 GESTION-ADMINISTRATION;29;24;21;3;0;0;0;21;0;0;6;9;6;3
8243.0;2021;25;VERSAILLES;MASCULIN;APPRENTISSAGE;BAC PROFESSIONNEL;BAC PRO SERV;BAC PRO 31106 LOGISTIQUE;40;38;26;5;7;7;0;33;0;2;5;6;20;5
8252.0;2021;25;VERSAILLES;MASCULIN;ENSEIGNEMENT A DISTANCE;BAC GENERAL;BAC GENERAL;BAC GENE 10019 BAC GENERAL;74;68;63;4;1;0;1;63;0;8;28;17;10;5
8253.0;2021;25;VERSAILLES;MASCULIN;ENSEIGNEMENT A DISTANCE;BAC PROFESSIONNEL;BAC PRO SERV;BAC PRO 30001 GESTION-ADMINISTRATION;6;5;1;3;1;0;1;1;0;0;0;1;0;4
8255.0;2021;25;VERSAILLES;MASCULIN;ENSEIGNEMENT A DISTANCE;BAC PROFESSIONNEL;BAC PRO SERV;BAC PRO 31210 ACCUEIL -RELATION CLIENTS USAGERS;1;0;0;0;0;0;0;0;0;0;0;0;0;0
8258.0;2021;25;VERSAILLES;MASCULIN;ENSEIGNEMENT A DISTANCE;BAC TECHNOLOGIQUE;BAC STMG;BAC STMG GESTION ET FINANCE;5;5;5;0;0;0;0;5;0;1;1;0;3;0
8259.0;2021;25;VERSAILLES;MASCULIN;ENSEIGNEMENT A DISTANCE;BAC TECHNOLOGIQUE;BAC STMG;BAC STMG MERCATIQUE (MARKETING);18;18;17;1;0;0;0;17;0;0;4;11;2;1
8274.0;2021;25;VERSAILLES;MASCULIN;FORMATION CONTINUE;BAC PROFESSIONNEL;BAC PRO SERV;BAC PRO 34403 METIERS DE LA SECURITE;15;14;11;3;0;0;0;11;0;0;1;5;5;3
8275.0;2021;25;VERSAILLES;MASCULIN;INDIVIDUEL;BAC GENERAL;BAC GENERAL;BAC GENE 10019 BAC GENERAL;360;269;164;66;39;29;10;193;3;18;31;40;101;76
8288.0;2021;25;VERSAILLES;MASCULIN;INDIVIDUEL;BAC PROFESSIONNEL;BAC PRO PROD;BAC PRO 25513 SYST.NUM.OPT.A SURETE SECURITE;4;3;2;1;0;0;0;2;0;0;0;0;2;1
8304.0;2021;25;VERSAILLES;MASCULIN;INDIVIDUEL;BAC PROFESSIONNEL;BAC PRO SERV;BAC PRO 33002 SERVICES DE PROXIMITE  VIE LOCAL;3;2;2;0;0;0;0;2;0;0;0;1;1;0
8316.0;2021;25;VERSAILLES;MASCULIN;INDIVIDUEL;BAC TECHNOLOGIQUE;BAC STI2D;BAC STI2D SYSTÈME D'INFORMATION  ET NUMERIQUE;10;3;1;1;1;0;1;1;0;0;0;0;1;2
8317.0;2021;25;VERSAILLES;MASCULIN;INDIVIDUEL;BAC TECHNOLOGIQUE;BAC STMG;BAC STMG GESTION ET FINANCE;49;28;12;4;12;9;3;21;0;0;1;2;18;7
8323.0;2021;25;VERSAILLES;MASCULIN;SCOLAIRE;BAC PROFESSIONNEL;BAC PRO PROD;BAC PRO 20102 PILOTE DE LIGNE DE PRODUCTION;15;15;13;1;1;1;0;14;0;5;3;3;3;1
8327.0;2021;25;VERSAILLES;MASCULIN;SCOLAIRE;BAC PROFESSIONNEL;BAC PRO PROD;BAC PRO 22503 PLASTIQUES ET COMPOSITES;18;18;13;5;0;0;0;13;0;0;4;5;4;5
8330.0;2021;25;VERSAILLES;MASCULIN;SCOLAIRE;BAC PROFESSIONNEL;BAC PRO PROD;BAC PRO 23003 ARTIS. & M.ART:MARCHANDISAGE VIS.;12;11;8;3;0;0;0;8;0;1;1;4;2;3
8334.0;2021;25;VERSAILLES;MASCULIN;SCOLAIRE;BAC PROFESSIONNEL;BAC PRO PROD;BACPRO 23103 TECHNICIEN GEOMETRE-TOPOGRAPHE;25;25;18;4;3;2;1;20;0;1;2;8;9;5
8343.0;2021;25;VERSAILLES;MASCULIN;SCOLAIRE;BAC PROFESSIONNEL;BAC PRO PROD;BAC PRO 25006 MICROTECHNIQUES;137;137;102;26;9;9;0;111;0;6;22;40;43;26
8353.0;2021;25;VERSAILLES;MASCULIN;SCOLAIRE;BAC PROFESSIONNEL;BAC PRO PROD;BAC PRO 25221 MAINT.MATERIELS OPT.C ESP. VERTS;4;4;3;1;0;0;0;3;0;0;0;2;1;1
8356.0;2021;25;VERSAILLES;MASCULIN;SCOLAIRE;BAC PROFESSIONNEL;BAC PRO PROD;BAC PRO 25305 AVIATION GENERALE;12;12;11;1;0;0;0;11;0;0;4;2;5;1
8364.0;2021;25;VERSAILLES;MASCULIN;SCOLAIRE;BAC PROFESSIONNEL;BAC PRO PROD;BAC PRO 25514 SYST.NUM.OPT.B AUD.RES.EQUIP.DOM.;216;215;172;34;9;7;2;179;0;3;39;82;55;36
8369.0;2021;25;VERSAILLES;MASCULIN;SCOLAIRE;BAC PROFESSIONNEL;BAC PRO PROD;BAC PRO AG 21302 GEST MILIEUX NATURELS FAUNE;28;28;28;0;0;0;0;28;0;3;4;13;8;0
8370.0;2021;25;VERSAILLES;MASCULIN;SCOLAIRE;BAC PROFESSIONNEL;BAC PRO PROD;BAC PRO AG 21303 FORET;6;6;6;0;0;0;0;6;0;0;1;3;2;0
8376.0;2021;25;VERSAILLES;MASCULIN;SCOLAIRE;BAC PROFESSIONNEL;BAC PRO SERV;BAC PRO 31202 COMMERCE;1053;1053;800;154;99;64;35;864;0;32;151;338;343;189
8378.0;2021;25;VERSAILLES;MASCULIN;SCOLAIRE;BAC PROFESSIONNEL;BAC PRO SERV;BAC PRO 31210 ACCUEIL -RELATION CLIENTS USAGERS;238;238;157;59;22;21;1;178;0;5;23;61;89;60
8379.0;2021;25;VERSAILLES;MASCULIN;SCOLAIRE;BAC PROFESSIONNEL;BAC PRO SERV;BAC PRO 32206 FACONNAGE PRODTS IMPRIMES ROUTAGE;4;4;3;1;0;0;0;3;0;0;1;2;0;1
8381.0;2021;25;VERSAILLES;MASCULIN;SCOLAIRE;BAC PROFESSIONNEL;BAC PRO SERV;BAC PRO 32208 REAL.PR.IMPR.PLURI.OPTB.PR.IMPR.;17;17;14;3;0;0;0;14;0;0;6;2;6;3
8382.0;2021;25;VERSAILLES;MASCULIN;SCOLAIRE;BAC PROFESSIONNEL;BAC PRO SERV;BAC PRO 32303 ART.& MET.ART:COM.VIS.VIS.PLURI-M;55;55;46;9;0;0;0;46;0;3;5;22;16;9
8384.0;2021;25;VERSAILLES;MASCULIN;SCOLAIRE;BAC PROFESSIONNEL;BAC PRO SERV;BAC PRO 33002 SERVICES DE PROXIMITE  VIE LOCAL;67;67;50;10;7;4;3;54;0;0;7;20;27;13
8395.0;2021;25;VERSAILLES;MASCULIN;SCOLAIRE;BAC TECHNOLOGIQUE;BAC STAV;BAC STAV AGRONOMIE ALIM ENV TERRITOI;38;38;36;2;0;0;0;36;0;0;4;16;16;2
8398.0;2021;25;VERSAILLES;MASCULIN;SCOLAIRE;BAC TECHNOLOGIQUE;BAC STI2D;BAC STI2D ARCHITECTURE ET CONSTRUCTION;202;202;171;5;26;9;17;180;0;3;24;67;86;22
8399.0;2021;25;VERSAILLES;MASCULIN;SCOLAIRE;BAC TECHNOLOGIQUE;BAC STI2D;BAC STI2D ENERGIES  ET ENVIRONNEMENT;630;630;524;23;83;43;40;567;0;9;77;169;312;63
8405.0;2021;25;VERSAILLES;MASCULIN;SCOLAIRE;BAC TECHNOLOGIQUE;BAC STMG;BAC STMG MERCATIQUE (MARKETING);1529;1528;1353;43;132;93;39;1446;0;16;176;560;694;82
8413.0;2022;02;AIX-MARSEILLE;FEMININ;APPRENTISSAGE;BAC PROFESSIONNEL;BAC PRO PROD;BAC PRO 25303 AERONAUTIQUE OPTION SYSTEMES;2;2;2;0;0;0;0;2;0;0;1;0;1;0
8418.0;2022;02;AIX-MARSEILLE;FEMININ;APPRENTISSAGE;BAC PROFESSIONNEL;BAC PRO PROD;BAC PRO AG 21113 CGEVV;2;2;2;0;0;0;0;2;0;0;0;0;2;0
8425.0;2022;02;AIX-MARSEILLE;FEMININ;APPRENTISSAGE;BAC PROFESSIONNEL;BAC PRO PROD;BAC PRO AG 22105 LABORATOIRE CONTROLE QUALITE;1;1;1;0;0;0;0;1;0;0;0;0;1;0
8426.0;2022;02;AIX-MARSEILLE;FEMININ;APPRENTISSAGE;BAC PROFESSIONNEL;BAC PRO PROD;BAC PRO AG 22107 TEC CONS VTE ALIMENTATION P.ALIM;5;4;4;0;0;0;0;4;0;0;0;2;2;0
8441.0;2022;02;AIX-MARSEILLE;FEMININ;ENSEIGNEMENT A DISTANCE;BAC PROFESSIONNEL;BAC PRO SERV;BAC PRO 31213 MET.COM.VEN.OP.A ANI.GES.ESP.COM.;4;3;1;1;1;0;1;1;0;0;1;0;0;2
8444.0;2022;02;AIX-MARSEILLE;FEMININ;ENSEIGNEMENT A DISTANCE;BAC TECHNOLOGIQUE;BAC ST2S;BAC ST2S SCIENCES & TECHNO. SANTE & SOCIAL;8;7;1;4;2;1;1;2;0;0;0;0;2;5
8446.0;2022;02;AIX-MARSEILLE;FEMININ;ENSEIGNEMENT A DISTANCE;BAC TECHNOLOGIQUE;BAC STMG;BAC STMG MERCATIQUE (MARKETING);6;6;6;0;0;0;0;6;0;0;1;1;4;0
8448.0;2022;02;AIX-MARSEILLE;FEMININ;ENSEIGNEMENT A DISTANCE;BAC TECHNOLOGIQUE;BAC STMG;BAC STMG SYSTEMES D'INFORMATION DE GESTION;2;2;2;0;0;0;0;2;0;0;1;0;1;0
8461.0;2022;02;AIX-MARSEILLE;FEMININ;INDIVIDUEL;BAC PROFESSIONNEL;BAC PRO PROD;BAC PRO 23304 AMENAGEMENT FINITION BATIMENT;1;1;0;1;0;0;0;0;0;0;0;0;0;1
8469.0;2022;02;AIX-MARSEILLE;FEMININ;INDIVIDUEL;BAC PROFESSIONNEL;BAC PRO SERV;BAC PRO 33003 ACC.SOINS-S.PERS. OPT.A DOMICILE;4;1;0;1;0;0;0;0;0;0;0;0;0;1
8470.0;2022;02;AIX-MARSEILLE;FEMININ;INDIVIDUEL;BAC PROFESSIONNEL;BAC PRO SERV;BAC PRO 33004 ACC.SOINS-S.PERS. OPT.EN STRUCTUR;6;4;2;2;0;0;0;2;0;0;0;1;1;2
8474.0;2022;02;AIX-MARSEILLE;FEMININ;INDIVIDUEL;BAC TECHNOLOGIQUE;BAC STD2A;BAC STD2A SCIENCES & TECHNO. DESIGN-ARTS APPLIQUES;2;1;0;1;0;0;0;0;0;0;0;0;0;1
8493.0;2022;02;AIX-MARSEILLE;FEMININ;SCOLAIRE;BAC PROFESSIONNEL;BAC PRO PROD;BACPRO 23103 TECHNICIEN GEOMETRE-TOPOGRAPHE;1;1;0;1;0;0;0;0;0;0;0;0;0;1
8499.0;2022;02;AIX-MARSEILLE;FEMININ;SCOLAIRE;BAC PROFESSIONNEL;BAC PRO PROD;BAC PRO 25006 MICROTECHNIQUES;2;2;2;0;0;0;0;2;0;0;0;2;0;0
8501.0;2022;02;AIX-MARSEILLE;FEMININ;SCOLAIRE;BAC PROFESSIONNEL;BAC PRO PROD;BAC PRO 25009 MAINTENANCE NAUTIQUE;1;1;1;0;0;0;0;1;0;0;0;1;0;0
8519.0;2022;02;AIX-MARSEILLE;FEMININ;SCOLAIRE;BAC PROFESSIONNEL;BAC PRO PROD;BAC PRO AG 21302 GEST MILIEUX NATURELS FAUNE;16;16;14;2;0;0;0;14;0;0;5;5;4;2
8521.0;2022;02;AIX-MARSEILLE;FEMININ;SCOLAIRE;BAC PROFESSIONNEL;BAC PRO PROD;BAC PRO AG 21405 AMENAGEMENTS PAYSAGERS;5;5;5;0;0;0;0;5;0;0;0;2;3;0
8522.0;2022;02;AIX-MARSEILLE;FEMININ;SCOLAIRE;BAC PROFESSIONNEL;BAC PRO PROD;BAC PRO AG 22105 LABORATOIRE CONTROLE QUALITE;4;4;4;0;0;0;0;4;0;0;0;4;0;0
8536.0;2022;02;AIX-MARSEILLE;FEMININ;SCOLAIRE;BAC PROFESSIONNEL;BAC PRO SERV;BAC PRO 33002 SERVICES DE PROXIMITE  VIE LOCAL;71;71;61;7;3;3;0;64;0;1;17;22;24;7
8549.0;2022;02;AIX-MARSEILLE;FEMININ;SCOLAIRE;BAC TECHNOLOGIQUE;BAC STAV;BAC STAV AGRONOMIE ALIM ENV TERRITOI;98;96;94;2;0;0;0;94;0;0;12;33;49;2
8551.0;2022;02;AIX-MARSEILLE;FEMININ;SCOLAIRE;BAC TECHNOLOGIQUE;BAC STHR;BAC STHR SC.&TEC. HOTELLERIE-RESTAURATION;33;33;33;0;0;0;0;33;0;0;5;11;17;0
8561.0;2022;02;AIX-MARSEILLE;FEMININ;SCOLAIRE;BAC TECHNOLOGIQUE;BAC STMG;BAC STMG SYSTEMES D'INFORMATION DE GESTION;22;22;15;0;7;6;1;21;0;0;0;5;16;1
8562.0;2022;02;AIX-MARSEILLE;MASCULIN;APPRENTISSAGE;BAC PROFESSIONNEL;BAC PRO PROD;BAC PRO 22004 PROC. CHIMIE EAU PAPIERS-CARTONS;4;4;4;0;0;0;0;4;0;3;1;0;0;0
8565.0;2022;02;AIX-MARSEILLE;MASCULIN;APPRENTISSAGE;BAC PROFESSIONNEL;BAC PRO PROD;BAC PRO 22106 CUISINE;33;30;25;5;0;0;0;25;0;0;2;12;11;5
8571.0;2022;02;AIX-MARSEILLE;MASCULIN;APPRENTISSAGE;BAC PROFESSIONNEL;BAC PRO PROD;BAC PRO 23205 INTERV. SUR PATRIMOINE BATI OPT.A;1;1;1;0;0;0;0;1;0;0;0;0;1;0
8587.0;2022;02;AIX-MARSEILLE;MASCULIN;APPRENTISSAGE;BAC PROFESSIONNEL;BAC PRO PROD;BAC PRO 25510 METIERS ELECT. ENVIRON. CONNECTES;66;66;50;6;10;7;3;57;0;5;15;12;25;9
8589.0;2022;02;AIX-MARSEILLE;MASCULIN;APPRENTISSAGE;BAC PROFESSIONNEL;BAC PRO PROD;BAC PRO 25515 SYST.NUM.OPT.C RES.INF.SYST.COMM.;1;1;1;0;0;0;0;1;0;0;1;0;0;0
8595.0;2022;02;AIX-MARSEILLE;MASCULIN;APPRENTISSAGE;BAC PROFESSIONNEL;BAC PRO PROD;BAC PRO AG 21211 COND GEST ENTR HIPPIQUE;5;5;5;0;0;0;0;5;0;0;0;0;5;0
8597.0;2022;02;AIX-MARSEILLE;MASCULIN;APPRENTISSAGE;BAC PROFESSIONNEL;BAC PRO PROD;BAC PRO AG 21405 AMENAGEMENTS PAYSAGERS;50;45;40;5;0;0;0;40;0;0;3;6;31;5
8602.0;2022;02;AIX-MARSEILLE;MASCULIN;APPRENTISSAGE;BAC PROFESSIONNEL;BAC PRO SERV;BAC PRO 31213 MET.COM.VEN.OP.A ANI.GES.ESP.COM.;75;69;53;14;2;2;0;55;0;1;10;16;28;14
8604.0;2022;02;AIX-MARSEILLE;MASCULIN;APPRENTISSAGE;BAC PROFESSIONNEL;BAC PRO SERV;BAC PRO 32207 REAL.PR.IMPR.PLURI.OPTA.PR.GRAPH.;1;1;1;0;0;0;0;1;0;0;0;1;0;0
8606.0;2022;02;AIX-MARSEILLE;MASCULIN;APPRENTISSAGE;BAC PROFESSIONNEL;BAC PRO SERV;BAC PRO 32303 ART.& MET.ART:COM.VIS.VIS.PLURI-M;4;4;0;4;0;0;0;0;0;0;0;0;0;4
8614.0;2022;02;AIX-MARSEILLE;MASCULIN;ENSEIGNEMENT A DISTANCE;BAC PROFESSIONNEL;BAC PRO SERV;BAC PRO 31213 MET.COM.VEN.OP.A ANI.GES.ESP.COM.;2;2;2;0;0;0;0;2;0;0;2;0;0;0
8618.0;2022;02;AIX-MARSEILLE;MASCULIN;ENSEIGNEMENT A DISTANCE;BAC TECHNOLOGIQUE;BAC STMG;BAC STMG RESSOURCES HUMAINES ET COMMUNICATION;3;3;3;0;0;0;0;3;0;0;0;2;1;0
8621.0;2022;02;AIX-MARSEILLE;MASCULIN;FORMATION CONTINUE;BAC PROFESSIONNEL;BAC PRO PROD;BAC PRO 22703 TECHN.INSTALL.SYST.ENERG.CLIMATI;2;2;2;0;0;0;0;2;0;0;0;1;1;0
8623.0;2022;02;AIX-MARSEILLE;MASCULIN;FORMATION CONTINUE;BAC PROFESSIONNEL;BAC PRO PROD;BAC PRO 22705 TECHNICIEN GAZ;4;4;4;0;0;0;0;4;0;1;1;2;0;0
8626.0;2022;02;AIX-MARSEILLE;MASCULIN;FORMATION CONTINUE;BAC PROFESSIONNEL;BAC PRO PROD;BAC PRO 25515 SYST.NUM.OPT.C RES.INF.SYST.COMM.;4;3;2;1;0;0;0;2;0;0;0;2;0;1
8627.0;2022;02;AIX-MARSEILLE;MASCULIN;FORMATION CONTINUE;BAC PROFESSIONNEL;BAC PRO SERV;BAC PRO 30001 GESTION-ADMINISTRATION;7;6;5;1;0;0;0;5;0;0;0;4;1;1
8642.0;2022;02;AIX-MARSEILLE;MASCULIN;INDIVIDUEL;BAC PROFESSIONNEL;BAC PRO PROD;BAC PRO AG 21203 TECHN CONSEIL DE VENTE ANIMAL;1;1;0;1;0;0;0;0;0;0;0;0;0;1
8646.0;2022;02;AIX-MARSEILLE;MASCULIN;INDIVIDUEL;BAC PROFESSIONNEL;BAC PRO SERV;BAC PRO 31212 METIERS DE L'ACCUEIL;1;0;0;0;0;0;0;0;0;0;0;0;0;0
8657.0;2022;02;AIX-MARSEILLE;MASCULIN;INDIVIDUEL;BAC TECHNOLOGIQUE;BAC STI2D;BAC STI2D ENERGIES  ET ENVIRONNEMENT;2;0;0;0;0;0;0;0;0;0;0;0;0;0
8660.0;2022;02;AIX-MARSEILLE;MASCULIN;INDIVIDUEL;BAC TECHNOLOGIQUE;BAC STL;BAC STL SCIENCES PHYSIQUES CHIMIQUES  EN LABORAT.;1;1;0;1;0;0;0;0;0;0;0;0;0;1
8668.0;2022;02;AIX-MARSEILLE;MASCULIN;SCOLAIRE;BAC PROFESSIONNEL;BAC PRO PROD;BAC PRO 22003 BIO-INDUSTRIES DE TRANSFORMATION;3;3;3;0;0;0;0;3;0;0;1;1;1;0
8670.0;2022;02;AIX-MARSEILLE;MASCULIN;SCOLAIRE;BAC PROFESSIONNEL;BAC PRO PROD;BAC PRO 22105 BOULANGER-PÂTISSIER;13;13;13;0;0;0;0;13;0;1;2;4;6;0
8673.0;2022;02;AIX-MARSEILLE;MASCULIN;SCOLAIRE;BAC PROFESSIONNEL;BAC PRO PROD;BAC PRO 22503 PLASTIQUES ET COMPOSITES;5;5;3;1;1;1;0;4;0;0;0;2;2;1
8677.0;2022;02;AIX-MARSEILLE;MASCULIN;SCOLAIRE;BAC PROFESSIONNEL;BAC PRO PROD;BAC PRO 23005 TECHN. ETUDES BAT B ASSIST.ARCHI.;32;32;18;13;1;1;0;19;0;0;2;2;15;13
8684.0;2022;02;AIX-MARSEILLE;MASCULIN;SCOLAIRE;BAC PROFESSIONNEL;BAC PRO PROD;BAC PRO 23404 TECHNICIEN CONSTRUCTEUR BOIS;24;23;16;7;0;0;0;16;0;0;2;9;5;7
8689.0;2022;02;AIX-MARSEILLE;MASCULIN;SCOLAIRE;BAC PROFESSIONNEL;BAC PRO PROD;BAC PRO 25007 MAINTENANCE EQUIPEMENTS INDUST.;249;245;160;73;12;11;1;171;0;3;26;61;81;74
8690.0;2022;02;AIX-MARSEILLE;MASCULIN;SCOLAIRE;BAC PROFESSIONNEL;BAC PRO PROD;BAC PRO 25009 MAINTENANCE NAUTIQUE;43;43;29;13;1;1;0;30;0;1;3;14;12;13
8692.0;2022;02;AIX-MARSEILLE;MASCULIN;SCOLAIRE;BAC PROFESSIONNEL;BAC PRO PROD;BAC PRO 25107 TECHNICIEN OUTILLEUR;11;11;4;7;0;0;0;4;0;0;1;2;1;7
8698.0;2022;02;AIX-MARSEILLE;MASCULIN;SCOLAIRE;BAC PROFESSIONNEL;BAC PRO PROD;BAC PRO 25221 MAINT.MATERIELS OPT.C ESP. VERTS;2;2;2;0;0;0;0;2;0;0;0;1;1;0
8699.0;2022;02;AIX-MARSEILLE;MASCULIN;SCOLAIRE;BAC PROFESSIONNEL;BAC PRO PROD;BAC PRO 25302 AERONAUTIQUE OPTION AVIONIQUE;13;13;10;3;0;0;0;10;0;0;0;6;4;3
8701.0;2022;02;AIX-MARSEILLE;MASCULIN;SCOLAIRE;BAC PROFESSIONNEL;BAC PRO PROD;BAC PRO 25304 AERONAUTIQUE OPTION STRUCTURE;9;9;7;2;0;0;0;7;0;0;0;4;3;2
8719.0;2022;02;AIX-MARSEILLE;MASCULIN;SCOLAIRE;BAC PROFESSIONNEL;BAC PRO PROD;BAC PRO AG 22105 LABORATOIRE CONTROLE QUALITE;4;4;3;1;0;0;0;3;0;0;1;1;1;1
8724.0;2022;02;AIX-MARSEILLE;MASCULIN;SCOLAIRE;BAC PROFESSIONNEL;BAC PRO SERV;BAC PRO 31107 CONDUCT. TRANSP.ROUT.MARCHANDISES;87;87;73;11;3;2;1;75;0;3;15;35;22;12
8728.0;2022;02;AIX-MARSEILLE;MASCULIN;SCOLAIRE;BAC PROFESSIONNEL;BAC PRO SERV;BAC PRO 31214 MET.COM.VEN.OP.B PR.CL.VA.OF.COM.;265;264;203;54;7;5;2;208;0;5;29;77;97;56
8733.0;2022;02;AIX-MARSEILLE;MASCULIN;SCOLAIRE;BAC PROFESSIONNEL;BAC PRO SERV;BAC PRO 33002 SERVICES DE PROXIMITE  VIE LOCAL;37;37;28;6;3;3;0;31;0;0;5;13;13;6
8734.0;2022;02;AIX-MARSEILLE;MASCULIN;SCOLAIRE;BAC PROFESSIONNEL;BAC PRO SERV;BAC PRO 33003 ACC.SOINS-S.PERS. OPT.A DOMICILE;7;7;3;4;0;0;0;3;0;0;0;2;1;4
8753.0;2022;02;AIX-MARSEILLE;MASCULIN;SCOLAIRE;BAC TECHNOLOGIQUE;BAC STL;BAC STL SCIENCES PHYSIQUES CHIMIQUES  EN LABORAT.;79;79;66;4;9;7;2;73;0;0;10;24;39;6
8754.0;2022;02;AIX-MARSEILLE;MASCULIN;SCOLAIRE;BAC TECHNOLOGIQUE;BAC STMG;BAC STMG GESTION ET FINANCE;367;367;292;19;56;38;18;330;0;2;32;107;189;37
8755.0;2022;02;AIX-MARSEILLE;MASCULIN;SCOLAIRE;BAC TECHNOLOGIQUE;BAC STMG;BAC STMG MERCATIQUE (MARKETING);856;856;661;50;145;100;45;761;0;7;55;218;481;95
8763.0;2022;20;AMIENS;FEMININ;APPRENTISSAGE;BAC PROFESSIONNEL;BAC PRO PROD;BAC PRO 25214 MAINT.VEHIC.OPTA VOIT.PARTICUL.;3;3;2;0;1;0;1;2;0;0;1;0;1;1
8766.0;2022;20;AMIENS;FEMININ;APPRENTISSAGE;BAC PROFESSIONNEL;BAC PRO PROD;BAC PRO 25411 TECH.CHAUDRONNERIE INDUSTRIELLE;4;4;3;1;0;0;0;3;0;1;2;0;0;1
8770.0;2022;20;AMIENS;FEMININ;APPRENTISSAGE;BAC PROFESSIONNEL;BAC PRO PROD;BAC PRO AG 21211 COND GEST ENTR HIPPIQUE;26;24;23;1;0;0;0;23;0;2;2;10;9;1
8772.0;2022;20;AMIENS;FEMININ;APPRENTISSAGE;BAC PROFESSIONNEL;BAC PRO PROD;BAC PRO AG 22107 TEC CONS VTE ALIMENTATION P.ALIM;13;13;10;3;0;0;0;10;0;0;0;2;8;3
8775.0;2022;20;AMIENS;FEMININ;APPRENTISSAGE;BAC PROFESSIONNEL;BAC PRO SERV;BAC PRO 31213 MET.COM.VEN.OP.A ANI.GES.ESP.COM.;55;53;46;5;2;1;1;47;0;6;12;16;13;6
8776.0;2022;20;AMIENS;FEMININ;APPRENTISSAGE;BAC PROFESSIONNEL;BAC PRO SERV;BAC PRO 31214 MET.COM.VEN.OP.B PR.CL.VA.OF.COM.;1;1;1;0;0;0;0;1;0;0;1;0;0;0
8789.0;2022;20;AMIENS;FEMININ;INDIVIDUEL;BAC PROFESSIONNEL;BAC PRO PROD;BAC PRO AG 21211 COND GEST ENTR HIPPIQUE;2;0;0;0;0;0;0;0;0;0;0;0;0;0
8793.0;2022;20;AMIENS;FEMININ;INDIVIDUEL;BAC PROFESSIONNEL;BAC PRO SERV;BAC PRO 31213 MET.COM.VEN.OP.A ANI.GES.ESP.COM.;5;3;1;2;0;0;0;1;0;0;0;1;0;2
8797.0;2022;20;AMIENS;FEMININ;INDIVIDUEL;BAC PROFESSIONNEL;BAC PRO SERV;BAC PRO 33603 ESTHETIQUE COSMETIQUE PARFUMERIE;1;0;0;0;0;0;0;0;0;0;0;0;0;0
8800.0;2022;20;AMIENS;FEMININ;INDIVIDUEL;BAC TECHNOLOGIQUE;BAC STHR;BAC STHR SC.&TEC. HOTELLERIE-RESTAURATION;2;2;0;1;1;1;0;1;0;0;0;0;1;1
8807.0;2022;20;AMIENS;FEMININ;SCOLAIRE;BAC PROFESSIONNEL;BAC PRO PROD;BAC PRO 22004 PROC. CHIMIE EAU PAPIERS-CARTONS;2;2;2;0;0;0;0;2;0;0;0;1;1;0
8811.0;2022;20;AMIENS;FEMININ;SCOLAIRE;BAC PROFESSIONNEL;BAC PRO PROD;BAC PRO 22503 PLASTIQUES ET COMPOSITES;1;1;1;0;0;0;0;1;0;1;0;0;0;0
8814.0;2022;20;AMIENS;FEMININ;SCOLAIRE;BAC PROFESSIONNEL;BAC PRO PROD;BAC PRO 23005 TECHN. ETUDES BAT B ASSIST.ARCHI.;5;5;3;2;0;0;0;3;0;1;1;1;0;2
8815.0;2022;20;AMIENS;FEMININ;SCOLAIRE;BAC PROFESSIONNEL;BAC PRO PROD;BAC PRO 23208 METIERS ET ARTS DE LA PIERRE;2;2;2;0;0;0;0;2;0;0;0;1;1;0
8817.0;2022;20;AMIENS;FEMININ;SCOLAIRE;BAC PROFESSIONNEL;BAC PRO PROD;BAC PRO 23404 TECHNICIEN CONSTRUCTEUR BOIS;1;1;1;0;0;0;0;1;0;0;0;0;1;0
8818.0;2022;20;AMIENS;FEMININ;SCOLAIRE;BAC PROFESSIONNEL;BAC PRO PROD;BAC PRO 23405 TECHNICIEN MENUISIER AGENCEUR;1;1;0;1;0;0;0;0;0;0;0;0;0;1
8830.0;2022;20;AMIENS;FEMININ;SCOLAIRE;BAC PROFESSIONNEL;BAC PRO PROD;BAC PRO 25513 SYST.NUM.OPT.A SURETE SECURITE;1;1;0;1;0;0;0;0;0;0;0;0;0;1
8831.0;2022;20;AMIENS;FEMININ;SCOLAIRE;BAC PROFESSIONNEL;BAC PRO PROD;BAC PRO 25514 SYST.NUM.OPT.B AUD.RES.EQUIP.DOM.;3;3;2;1;0;0;0;2;0;0;1;1;0;1
8839.0;2022;20;AMIENS;FEMININ;SCOLAIRE;BAC PROFESSIONNEL;BAC PRO PROD;BAC PRO AG 21405 AMENAGEMENTS PAYSAGERS;3;3;3;0;0;0;0;3;0;0;1;1;1;0
8850.0;2022;20;AMIENS;FEMININ;SCOLAIRE;BAC PROFESSIONNEL;BAC PRO SERV;BAC PRO 32303 ART.& MET.ART:COM.VIS.VIS.PLURI-M;35;35;32;3;0;0;0;32;0;5;10;12;5;3
8853.0;2022;20;AMIENS;FEMININ;SCOLAIRE;BAC PROFESSIONNEL;BAC PRO SERV;BAC PRO 33004 ACC.SOINS-S.PERS. OPT.EN STRUCTUR;490;489;445;29;15;10;5;455;0;33;152;173;97;34
8855.0;2022;20;AMIENS;FEMININ;SCOLAIRE;BAC PROFESSIONNEL;BAC PRO SERV;BAC PRO 33403 COMMERC. SERVICES EN RESTAURATION;51;50;36;12;2;0;2;36;0;3;4;13;16;14
8856.0;2022;20;AMIENS;FEMININ;SCOLAIRE;BAC PROFESSIONNEL;BAC PRO SERV;BAC PRO 33603 ESTHETIQUE COSMETIQUE PARFUMERIE;68;68;57;11;0;0;0;57;0;1;11;28;17;11
8861.0;2022;20;AMIENS;FEMININ;SCOLAIRE;BAC TECHNOLOGIQUE;BAC STAV;BAC STAV AGRONOMIE ALIM ENV TERRITOI;71;71;64;7;0;0;0;64;0;1;4;22;37;7
8862.0;2022;20;AMIENS;FEMININ;SCOLAIRE;BAC TECHNOLOGIQUE;BAC STD2A;BAC STD2A SCIENCES & TECHNO. DESIGN-ARTS APPLIQUES;71;71;69;1;1;1;0;70;3;7;19;26;15;1
8864.0;2022;20;AMIENS;FEMININ;SCOLAIRE;BAC TECHNOLOGIQUE;BAC STI2D;BAC STI2D ARCHITECTURE ET CONSTRUCTION;13;13;9;1;3;3;0;12;0;0;2;5;5;1
8865.0;2022;20;AMIENS;FEMININ;SCOLAIRE;BAC TECHNOLOGIQUE;BAC STI2D;BAC STI2D ENERGIES  ET ENVIRONNEMENT;8;8;4;1;3;1;2;5;0;0;1;1;3;3
8872.0;2022;20;AMIENS;FEMININ;SCOLAIRE;BAC TECHNOLOGIQUE;BAC STMG;BAC STMG RESSOURCES HUMAINES ET COMMUNICATION;395;395;282;30;83;64;19;346;0;2;27;93;224;49
8901.0;2022;20;AMIENS;MASCULIN;APPRENTISSAGE;BAC PROFESSIONNEL;BAC PRO PROD;BAC PRO AG 21004 CGEA;15;15;11;4;0;0;0;11;0;1;0;0;10;4
8904.0;2022;20;AMIENS;MASCULIN;APPRENTISSAGE;BAC PROFESSIONNEL;BAC PRO PROD;BAC PRO AG 21405 AMENAGEMENTS PAYSAGERS;36;36;34;2;0;0;0;34;0;1;3;12;18;2
8905.0;2022;20;AMIENS;MASCULIN;APPRENTISSAGE;BAC PROFESSIONNEL;BAC PRO PROD;BAC PRO AG 22107 TEC CONS VTE ALIMENTATION P.ALIM;11;11;9;2;0;0;0;9;0;0;0;5;4;2
8906.0;2022;20;AMIENS;MASCULIN;APPRENTISSAGE;BAC PROFESSIONNEL;BAC PRO SERV;BAC PRO 31106 LOGISTIQUE;60;58;40;17;1;1;0;41;0;4;3;17;17;17
8910.0;2022;20;AMIENS;MASCULIN;APPRENTISSAGE;BAC PROFESSIONNEL;BAC PRO SERV;BAC PRO AG 33002 SERV PERS TERRIT;1;0;0;0;0;0;0;0;0;0;0;0;0;0
8916.0;2022;20;AMIENS;MASCULIN;FORMATION CONTINUE;BAC PROFESSIONNEL;BAC PRO PROD;BAC PRO 22703 TECHN.INSTALL.SYST.ENERG.CLIMATI;1;1;1;0;0;0;0;1;0;1;0;0;0;0
8922.0;2022;20;AMIENS;MASCULIN;FORMATION CONTINUE;BAC PROFESSIONNEL;BAC PRO SERV;BAC PRO 31106 LOGISTIQUE;1;1;1;0;0;0;0;1;0;1;0;0;0;0
8929.0;2022;20;AMIENS;MASCULIN;INDIVIDUEL;BAC PROFESSIONNEL;BAC PRO PROD;BAC PRO 25509 TECHNIC. FROID CONDITIONNEMT AIR;1;1;0;1;0;0;0;0;0;0;0;0;0;1
8932.0;2022;20;AMIENS;MASCULIN;INDIVIDUEL;BAC PROFESSIONNEL;BAC PRO PROD;BAC PRO AG 21004 CGEA;4;3;1;2;0;0;0;1;0;0;0;0;1;2
8933.0;2022;20;AMIENS;MASCULIN;INDIVIDUEL;BAC PROFESSIONNEL;BAC PRO PROD;BAC PRO AG 21114 CONDUITE PRODUCTIONS HORTICOLES;1;1;1;0;0;0;0;1;0;0;0;0;1;0
8942.0;2022;20;AMIENS;MASCULIN;INDIVIDUEL;BAC TECHNOLOGIQUE;BAC STMG;BAC STMG GESTION ET FINANCE;5;2;1;1;0;0;0;1;0;0;0;0;1;1
8944.0;2022;20;AMIENS;MASCULIN;INDIVIDUEL;BAC TECHNOLOGIQUE;BAC STMG;BAC STMG RESSOURCES HUMAINES ET COMMUNICATION;3;1;0;0;1;0;1;0;0;0;0;0;0;1
8953.0;2022;20;AMIENS;MASCULIN;SCOLAIRE;BAC PROFESSIONNEL;BAC PRO PROD;BAC PRO 22303 FONDERIE;9;9;8;0;1;1;0;9;0;0;0;3;6;0
8967.0;2022;20;AMIENS;MASCULIN;SCOLAIRE;BAC PROFESSIONNEL;BAC PRO PROD;BAC PRO 23407 TECHNIC.FAB.BOIS ET MATERX ASSOC;7;7;6;1;0;0;0;6;0;0;1;2;3;1
8975.0;2022;20;AMIENS;MASCULIN;SCOLAIRE;BAC PROFESSIONNEL;BAC PRO PROD;BAC PRO 25108 TECHNICIEN MODELEUR;15;15;10;5;0;0;0;10;0;1;4;1;4;5
8976.0;2022;20;AMIENS;MASCULIN;SCOLAIRE;BAC PROFESSIONNEL;BAC PRO PROD;BAC PRO 25214 MAINT.VEHIC.OPTA VOIT.PARTICUL.;157;157;131;21;5;5;0;136;0;8;23;50;55;21
8984.0;2022;20;AMIENS;MASCULIN;SCOLAIRE;BAC PROFESSIONNEL;BAC PRO PROD;BAC PRO 25408 REPARATION DES CARROSSERIES;35;35;22;9;4;0;4;22;0;0;4;7;11;13
8985.0;2022;20;AMIENS;MASCULIN;SCOLAIRE;BAC PROFESSIONNEL;BAC PRO PROD;BAC PRO 25411 TECH.CHAUDRONNERIE INDUSTRIELLE;31;31;24;5;2;1;1;25;0;0;5;11;9;6
8986.0;2022;20;AMIENS;MASCULIN;SCOLAIRE;BAC PROFESSIONNEL;BAC PRO PROD;BAC PRO 25509 TECHNIC. FROID CONDITIONNEMT AIR;28;27;17;10;0;0;0;17;0;0;1;13;3;10
8995.0;2022;20;AMIENS;MASCULIN;SCOLAIRE;BAC PROFESSIONNEL;BAC PRO PROD;BAC PRO AG 21203 TECHN CONSEIL DE VENTE ANIMAL;13;13;10;3;0;0;0;10;0;1;0;5;4;3
8997.0;2022;20;AMIENS;MASCULIN;SCOLAIRE;BAC PROFESSIONNEL;BAC PRO PROD;BAC PRO AG 21211 COND GEST ENTR HIPPIQUE;8;8;7;1;0;0;0;7;0;0;0;2;5;1
9002.0;2022;20;AMIENS;MASCULIN;SCOLAIRE;BAC PROFESSIONNEL;BAC PRO SERV;BAC PRO 30001 GESTION-ADMINISTRATION;150;149;106;38;5;4;1;110;0;8;16;44;42;39
9006.0;2022;20;AMIENS;MASCULIN;SCOLAIRE;BAC PROFESSIONNEL;BAC PRO SERV;BAC PRO 31212 METIERS DE L'ACCUEIL;48;48;36;12;0;0;0;36;0;0;9;17;10;12
9009.0;2022;20;AMIENS;MASCULIN;SCOLAIRE;BAC PROFESSIONNEL;BAC PRO SERV;BAC PRO 32207 REAL.PR.IMPR.PLURI.OPTA.PR.GRAPH.;10;10;6;2;2;1;1;7;0;0;1;1;5;3
9010.0;2022;20;AMIENS;MASCULIN;SCOLAIRE;BAC PROFESSIONNEL;BAC PRO SERV;BAC PRO 32303 ART.& MET.ART:COM.VIS.VIS.PLURI-M;22;22;22;0;0;0;0;22;0;2;3;11;6;0
9037.0;2022;03;BESANCON;FEMININ;APPRENTISSAGE;BAC PROFESSIONNEL;BAC PRO PROD;BAC PRO 22703 TECHN.INSTALL.SYST.ENERG.CLIMATI;1;1;1;0;0;0;0;1;0;0;0;1;0;0
9039.0;2022;03;BESANCON;FEMININ;APPRENTISSAGE;BAC PROFESSIONNEL;BAC PRO PROD;BAC PRO 23102 TRAVAUX PUBLICS;1;1;1;0;0;0;0;1;0;0;0;1;0;0
9049.0;2022;03;BESANCON;FEMININ;APPRENTISSAGE;BAC PROFESSIONNEL;BAC PRO PROD;BAC PRO AG 21203 TECHN CONSEIL DE VENTE ANIMAL;5;5;5;0;0;0;0;5;0;0;1;2;2;0
9066.0;2022;03;BESANCON;FEMININ;APPRENTISSAGE;BAC PROFESSIONNEL;BAC PRO SERV;BAC PRO AG 33002 SERV PERS TERRIT;15;15;13;2;0;0;0;13;0;0;3;0;10;2
9071.0;2022;03;BESANCON;FEMININ;ENSEIGNEMENT A DISTANCE;BAC TECHNOLOGIQUE;BAC ST2S;BAC ST2S SCIENCES & TECHNO. SANTE & SOCIAL;2;2;2;0;0;0;0;2;0;0;0;1;1;0
9075.0;2022;03;BESANCON;FEMININ;FORMATION CONTINUE;BAC PROFESSIONNEL;BAC PRO SERV;BAC PRO 33101 OPTIQUE LUNETTERIE;6;6;6;0;0;0;0;6;0;1;4;1;0;0
9082.0;2022;03;BESANCON;FEMININ;INDIVIDUEL;BAC TECHNOLOGIQUE;BAC STMG;BAC STMG RESSOURCES HUMAINES ET COMMUNICATION;2;0;0;0;0;0;0;0;0;0;0;0;0;0
9083.0;2022;03;BESANCON;FEMININ;SCOLAIRE;BAC GENERAL;BAC GENERAL;BAC GENE 10019 BAC GENERAL;3290;3290;3038;47;205;154;51;3192;47;393;790;1049;913;98
9085.0;2022;03;BESANCON;FEMININ;SCOLAIRE;BAC PROFESSIONNEL;BAC PRO PROD;BAC PRO 22106 CUISINE;41;41;36;2;3;3;0;39;0;4;6;14;15;2
9087.0;2022;03;BESANCON;FEMININ;SCOLAIRE;BAC PROFESSIONNEL;BAC PRO PROD;BAC PRO 23102 TRAVAUX PUBLICS;1;1;1;0;0;0;0;1;0;0;0;1;0;0
9092.0;2022;03;BESANCON;FEMININ;SCOLAIRE;BAC PROFESSIONNEL;BAC PRO PROD;BAC PRO 24203 METIERS DE LA MODE - VÊTEMENT;34;34;31;3;0;0;0;31;0;3;5;14;9;3
9095.0;2022;03;BESANCON;FEMININ;SCOLAIRE;BAC PROFESSIONNEL;BAC PRO PROD;BAC PRO 25007 MAINTENANCE EQUIPEMENTS INDUST.;3;3;1;1;1;1;0;2;0;0;0;1;1;1
9097.0;2022;03;BESANCON;FEMININ;SCOLAIRE;BAC PROFESSIONNEL;BAC PRO PROD;BAC PRO 25214 MAINT.VEHIC.OPTA VOIT.PARTICUL.;2;2;2;0;0;0;0;2;0;0;0;0;2;0
9117.0;2022;03;BESANCON;FEMININ;SCOLAIRE;BAC PROFESSIONNEL;BAC PRO SERV;BAC PRO 31214 MET.COM.VEN.OP.B PR.CL.VA.OF.COM.;51;51;41;7;3;2;1;43;0;3;4;23;13;8
9118.0;2022;03;BESANCON;FEMININ;SCOLAIRE;BAC PROFESSIONNEL;BAC PRO SERV;BAC PRO 33002 SERVICES DE PROXIMITE  VIE LOCAL;19;19;17;2;0;0;0;17;0;0;6;4;7;2
9120.0;2022;03;BESANCON;FEMININ;SCOLAIRE;BAC PROFESSIONNEL;BAC PRO SERV;BAC PRO 33004 ACC.SOINS-S.PERS. OPT.EN STRUCTUR;255;254;219;26;9;3;6;222;0;7;64;90;61;32
9124.0;2022;03;BESANCON;FEMININ;SCOLAIRE;BAC PROFESSIONNEL;BAC PRO SERV;BAC PRO 34304 HYGIENE PROPRETE STERILISATION;14;14;11;1;2;2;0;13;0;0;1;4;8;1
9141.0;2022;03;BESANCON;FEMININ;SCOLAIRE;BAC TECHNOLOGIQUE;BAC STMG;BAC STMG RESSOURCES HUMAINES ET COMMUNICATION;255;255;207;13;35;28;7;235;0;3;30;74;128;20
9146.0;2022;03;BESANCON;MASCULIN;APPRENTISSAGE;BAC PROFESSIONNEL;BAC PRO PROD;BAC PRO 22703 TECHN.INSTALL.SYST.ENERG.CLIMATI;14;14;10;3;1;0;1;10;0;2;4;2;2;4
9150.0;2022;03;BESANCON;MASCULIN;APPRENTISSAGE;BAC PROFESSIONNEL;BAC PRO PROD;BAC PRO 23102 TRAVAUX PUBLICS;16;14;12;2;0;0;0;12;0;0;2;6;4;2
9156.0;2022;03;BESANCON;MASCULIN;APPRENTISSAGE;BAC PROFESSIONNEL;BAC PRO PROD;BAC PRO 23407 TECHNIC.FAB.BOIS ET MATERX ASSOC;5;5;5;0;0;0;0;5;0;0;1;2;2;0
9165.0;2022;03;BESANCON;MASCULIN;APPRENTISSAGE;BAC PROFESSIONNEL;BAC PRO PROD;BAC PRO 25219 MAINT.MATERIELS OPT.A AGRICOLES;24;24;24;0;0;0;0;24;0;1;6;13;4;0
9171.0;2022;03;BESANCON;MASCULIN;APPRENTISSAGE;BAC PROFESSIONNEL;BAC PRO PROD;BAC PRO 25509 TECHNIC. FROID CONDITIONNEMT AIR;3;3;3;0;0;0;0;3;0;0;0;2;1;0
9189.0;2022;03;BESANCON;MASCULIN;APPRENTISSAGE;BAC PROFESSIONNEL;BAC PRO SERV;BAC PRO 33403 COMMERC. SERVICES EN RESTAURATION;2;2;2;0;0;0;0;2;0;0;0;0;2;0
9191.0;2022;03;BESANCON;MASCULIN;APPRENTISSAGE;BAC PROFESSIONNEL;BAC PRO SERV;BAC PRO AG 33002 SERV PERS TERRIT;3;3;1;2;0;0;0;1;0;0;0;0;1;2
9197.0;2022;03;BESANCON;MASCULIN;FORMATION CONTINUE;BAC PROFESSIONNEL;BAC PRO SERV;BAC PRO 33101 OPTIQUE LUNETTERIE;1;1;1;0;0;0;0;1;0;1;0;0;0;0
9202.0;2022;03;BESANCON;MASCULIN;INDIVIDUEL;BAC PROFESSIONNEL;BAC PRO PROD;BAC PRO 25510 METIERS ELECT. ENVIRON. CONNECTES;1;1;1;0;0;0;0;1;0;0;0;1;0;0
9207.0;2022;03;BESANCON;MASCULIN;INDIVIDUEL;BAC PROFESSIONNEL;BAC PRO SERV;BAC PRO 31107 CONDUCT. TRANSP.ROUT.MARCHANDISES;1;1;0;1;0;0;0;0;0;0;0;0;0;1
9208.0;2022;03;BESANCON;MASCULIN;INDIVIDUEL;BAC PROFESSIONNEL;BAC PRO SERV;BAC PRO 31214 MET.COM.VEN.OP.B PR.CL.VA.OF.COM.;1;1;1;0;0;0;0;1;0;0;0;0;1;0
9209.0;2022;03;BESANCON;MASCULIN;INDIVIDUEL;BAC TECHNOLOGIQUE;BAC STAV;BAC STAV AGRONOMIE ALIM ENV TERRITOI;1;1;1;0;0;0;0;1;0;0;0;0;1;0
9211.0;2022;03;BESANCON;MASCULIN;INDIVIDUEL;BAC TECHNOLOGIQUE;BAC STI2D;BAC STI2D SYSTÈME D'INFORMATION  ET NUMERIQUE;1;0;0;0;0;0;0;0;0;0;0;0;0;0
9215.0;2022;03;BESANCON;MASCULIN;SCOLAIRE;BAC GENERAL;BAC GENERAL;BAC GENE 10019 BAC GENERAL;2536;2536;2298;31;207;132;75;2430;47;274;515;798;796;106
9222.0;2022;03;BESANCON;MASCULIN;SCOLAIRE;BAC PROFESSIONNEL;BAC PRO PROD;BAC PRO 23005 TECHN. ETUDES BAT B ASSIST.ARCHI.;16;16;14;2;0;0;0;14;0;0;1;5;8;2
9229.0;2022;03;BESANCON;MASCULIN;SCOLAIRE;BAC PROFESSIONNEL;BAC PRO PROD;BAC PRO 23405 TECHNICIEN MENUISIER AGENCEUR;55;55;46;6;3;1;2;47;0;4;14;17;12;8
9234.0;2022;03;BESANCON;MASCULIN;SCOLAIRE;BAC PROFESSIONNEL;BAC PRO PROD;BAC PRO 25005 PRODUCTIQ.MECA. OPT.DECOLLETAGE;4;4;3;1;0;0;0;3;0;0;0;1;2;1
9244.0;2022;03;BESANCON;MASCULIN;SCOLAIRE;BAC PROFESSIONNEL;BAC PRO PROD;BAC PRO 25411 TECH.CHAUDRONNERIE INDUSTRIELLE;32;31;24;7;0;0;0;24;0;3;4;8;9;7
9254.0;2022;03;BESANCON;MASCULIN;SCOLAIRE;BAC PROFESSIONNEL;BAC PRO PROD;BAC PRO AG 21302 GEST MILIEUX NATURELS FAUNE;38;38;38;0;0;0;0;38;0;1;3;21;13;0
9257.0;2022;03;BESANCON;MASCULIN;SCOLAIRE;BAC PROFESSIONNEL;BAC PRO PROD;BAC PRO AG 21407 TEC CONS VTE UNIVERS JARDINERIE;3;3;3;0;0;0;0;3;0;0;0;2;1;0
9258.0;2022;03;BESANCON;MASCULIN;SCOLAIRE;BAC PROFESSIONNEL;BAC PRO PROD;BAC PRO AG 22107 TEC CONS VTE ALIMENTATION P.ALIM;15;13;11;2;0;0;0;11;0;0;2;4;5;2
9268.0;2022;03;BESANCON;MASCULIN;SCOLAIRE;BAC PROFESSIONNEL;BAC PRO SERV;BAC PRO 33101 OPTIQUE LUNETTERIE;10;10;8;1;1;1;0;9;0;1;0;4;4;1
9271.0;2022;03;BESANCON;MASCULIN;SCOLAIRE;BAC PROFESSIONNEL;BAC PRO SERV;BAC PRO 34304 HYGIENE PROPRETE STERILISATION;4;4;3;1;0;0;0;3;0;0;0;2;1;1
9283.0;2022;03;BESANCON;MASCULIN;SCOLAIRE;BAC TECHNOLOGIQUE;BAC STL;BAC STL BIOCHIM.-BIOLOGIE-BIOTECHNOL.;22;22;19;1;2;1;1;20;0;1;4;7;8;2
9296.0;2022;04;BORDEAUX;FEMININ;APPRENTISSAGE;BAC PROFESSIONNEL;BAC PRO PROD;BAC PRO 25106 TECHNICIEN D'USINAGE;3;3;3;0;0;0;0;3;0;2;0;1;0;0
9299.0;2022;04;BORDEAUX;FEMININ;APPRENTISSAGE;BAC PROFESSIONNEL;BAC PRO PROD;BAC PRO 25302 AERONAUTIQUE OPTION AVIONIQUE;5;5;5;0;0;0;0;5;0;3;0;2;0;0
9302.0;2022;04;BORDEAUX;FEMININ;APPRENTISSAGE;BAC PROFESSIONNEL;BAC PRO PROD;BAC PRO 25411 TECH.CHAUDRONNERIE INDUSTRIELLE;2;2;2;0;0;0;0;2;0;0;0;1;1;0
9305.0;2022;04;BORDEAUX;FEMININ;APPRENTISSAGE;BAC PROFESSIONNEL;BAC PRO PROD;BAC PRO AG 21113 CGEVV;1;1;1;0;0;0;0;1;0;0;0;0;1;0
9313.0;2022;04;BORDEAUX;FEMININ;APPRENTISSAGE;BAC PROFESSIONNEL;BAC PRO SERV;BAC PRO 31209 POISSONIER ECAILLER TRAITEUR;2;2;2;0;0;0;0;2;0;0;2;0;0;0
9314.0;2022;04;BORDEAUX;FEMININ;APPRENTISSAGE;BAC PROFESSIONNEL;BAC PRO SERV;BAC PRO 31212 METIERS DE L'ACCUEIL;18;18;17;1;0;0;0;17;0;4;5;5;3;1
9315.0;2022;04;BORDEAUX;FEMININ;APPRENTISSAGE;BAC PROFESSIONNEL;BAC PRO SERV;BAC PRO 31213 MET.COM.VEN.OP.A ANI.GES.ESP.COM.;108;102;87;13;2;2;0;89;0;3;20;28;38;13
9322.0;2022;04;BORDEAUX;FEMININ;APPRENTISSAGE;BAC PROFESSIONNEL;BAC PRO SERV;BAC PRO 34304 HYGIENE PROPRETE STERILISATION;13;13;12;0;1;0;1;12;0;3;4;4;1;1
9325.0;2022;04;BORDEAUX;FEMININ;ENSEIGNEMENT A DISTANCE;BAC PROFESSIONNEL;BAC PRO SERV;BAC PRO 30001 GESTION-ADMINISTRATION;4;2;1;1;0;0;0;1;0;0;0;0;1;1
9326.0;2022;04;BORDEAUX;FEMININ;ENSEIGNEMENT A DISTANCE;BAC PROFESSIONNEL;BAC PRO SERV;BAC PRO 31213 MET.COM.VEN.OP.A ANI.GES.ESP.COM.;5;5;3;2;0;0;0;3;0;0;1;1;1;2
9329.0;2022;04;BORDEAUX;FEMININ;ENSEIGNEMENT A DISTANCE;BAC PROFESSIONNEL;BAC PRO SERV;BAC PRO 33603 ESTHETIQUE COSMETIQUE PARFUMERIE;1;1;0;1;0;0;0;0;0;0;0;0;0;1
9336.0;2022;04;BORDEAUX;FEMININ;FORMATION CONTINUE;BAC PROFESSIONNEL;BAC PRO PROD;BAC PRO AG 21114 CONDUITE PRODUCTIONS HORTICOLES;4;4;4;0;0;0;0;4;0;0;0;2;2;0
9339.0;2022;04;BORDEAUX;FEMININ;FORMATION CONTINUE;BAC PROFESSIONNEL;BAC PRO SERV;BAC PRO 33102 PROTHESE DENTAIRE;1;1;1;0;0;0;0;1;0;0;0;0;1;0
9342.0;2022;04;BORDEAUX;FEMININ;INDIVIDUEL;BAC PROFESSIONNEL;BAC PRO PROD;BAC PRO 24203 METIERS DE LA MODE - VÊTEMENT;1;0;0;0;0;0;0;0;0;0;0;0;0;0
9347.0;2022;04;BORDEAUX;FEMININ;INDIVIDUEL;BAC PROFESSIONNEL;BAC PRO PROD;BAC PRO AG 21211 COND GEST ENTR HIPPIQUE;6;6;6;0;0;0;0;6;0;0;0;1;5;0
9357.0;2022;04;BORDEAUX;FEMININ;INDIVIDUEL;BAC TECHNOLOGIQUE;BAC STL;BAC STL SCIENCES PHYSIQUES CHIMIQUES  EN LABORAT.;1;0;0;0;0;0;0;0;0;0;0;0;0;0
9358.0;2022;04;BORDEAUX;FEMININ;INDIVIDUEL;BAC TECHNOLOGIQUE;BAC STMG;BAC STMG GESTION ET FINANCE;3;2;0;2;0;0;0;0;0;0;0;0;0;2
9364.0;2022;04;BORDEAUX;FEMININ;SCOLAIRE;BAC PROFESSIONNEL;BAC PRO PROD;BAC PRO 22004 PROC. CHIMIE EAU PAPIERS-CARTONS;4;4;3;1;0;0;0;3;0;0;1;1;1;1
9366.0;2022;04;BORDEAUX;FEMININ;SCOLAIRE;BAC PROFESSIONNEL;BAC PRO PROD;BAC PRO 22106 CUISINE;69;69;64;4;1;0;1;64;0;6;25;15;18;5
9368.0;2022;04;BORDEAUX;FEMININ;SCOLAIRE;BAC PROFESSIONNEL;BAC PRO PROD;BAC PRO 23003 ARTIS. & M.ART:MARCHANDISAGE VIS.;13;13;10;3;0;0;0;10;0;0;3;4;3;3
9372.0;2022;04;BORDEAUX;FEMININ;SCOLAIRE;BAC PROFESSIONNEL;BAC PRO PROD;BAC PRO 23208 METIERS ET ARTS DE LA PIERRE;1;1;1;0;0;0;0;1;0;0;0;1;0;0
9383.0;2022;04;BORDEAUX;FEMININ;SCOLAIRE;BAC PROFESSIONNEL;BAC PRO PROD;BAC PRO 25214 MAINT.VEHIC.OPTA VOIT.PARTICUL.;9;9;7;2;0;0;0;7;0;1;2;3;1;2
9396.0;2022;04;BORDEAUX;FEMININ;SCOLAIRE;BAC PROFESSIONNEL;BAC PRO PROD;BAC PRO AG 21114 CONDUITE PRODUCTIONS HORTICOLES;12;11;9;2;0;0;0;9;0;2;1;0;6;2
9399.0;2022;04;BORDEAUX;FEMININ;SCOLAIRE;BAC PROFESSIONNEL;BAC PRO PROD;BAC PRO AG 21210 COND GEST ENTR CANIN ET FELIN;23;20;16;4;0;0;0;16;0;0;1;6;9;4
9411.0;2022;04;BORDEAUX;FEMININ;SCOLAIRE;BAC PROFESSIONNEL;BAC PRO SERV;BAC PRO 31108 TRANSPORT;13;13;12;1;0;0;0;12;0;0;0;6;6;1
9415.0;2022;04;BORDEAUX;FEMININ;SCOLAIRE;BAC PROFESSIONNEL;BAC PRO SERV;BAC PRO 32207 REAL.PR.IMPR.PLURI.OPTA.PR.GRAPH.;12;12;11;1;0;0;0;11;0;0;1;3;7;1
9417.0;2022;04;BORDEAUX;FEMININ;SCOLAIRE;BAC PROFESSIONNEL;BAC PRO SERV;BAC PRO 32303 ART.& MET.ART:COM.VIS.VIS.PLURI-M;41;41;39;2;0;0;0;39;0;5;12;13;9;2
9425.0;2022;04;BORDEAUX;FEMININ;SCOLAIRE;BAC PROFESSIONNEL;BAC PRO SERV;BAC PRO 33603 ESTHETIQUE COSMETIQUE PARFUMERIE;222;222;196;21;5;3;2;199;0;9;37;79;74;23
9426.0;2022;04;BORDEAUX;FEMININ;SCOLAIRE;BAC PROFESSIONNEL;BAC PRO SERV;BAC PRO 34304 HYGIENE PROPRETE STERILISATION;6;6;6;0;0;0;0;6;0;0;1;1;4;0
9439.0;2022;04;BORDEAUX;FEMININ;SCOLAIRE;BAC TECHNOLOGIQUE;BAC STI2D;BAC STI2D SYSTÈME D'INFORMATION  ET NUMERIQUE;28;28;22;2;4;4;0;26;0;1;1;10;14;2
9440.0;2022;04;BORDEAUX;FEMININ;SCOLAIRE;BAC TECHNOLOGIQUE;BAC STL;BAC STL BIOCHIM.-BIOLOGIE-BIOTECHNOL.;126;126;110;2;14;10;4;120;0;9;14;42;55;6
9445.0;2022;04;BORDEAUX;FEMININ;SCOLAIRE;BAC TECHNOLOGIQUE;BAC STMG;BAC STMG SYSTEMES D'INFORMATION DE GESTION;8;8;7;0;1;1;0;8;0;0;1;4;3;0
9457.0;2022;04;BORDEAUX;MASCULIN;APPRENTISSAGE;BAC PROFESSIONNEL;BAC PRO PROD;BAC PRO 23304 AMENAGEMENT FINITION BATIMENT;6;6;4;1;1;1;0;5;0;0;0;1;4;1
9470.0;2022;04;BORDEAUX;MASCULIN;APPRENTISSAGE;BAC PROFESSIONNEL;BAC PRO PROD;BAC PRO 25220 MAINT.MATERIELS OPT.B TP MANUT.;2;2;1;1;0;0;0;1;0;0;0;1;0;1
9475.0;2022;04;BORDEAUX;MASCULIN;APPRENTISSAGE;BAC PROFESSIONNEL;BAC PRO PROD;BAC PRO 25411 TECH.CHAUDRONNERIE INDUSTRIELLE;70;68;61;4;3;2;1;63;0;11;20;14;18;5
9478.0;2022;04;BORDEAUX;MASCULIN;APPRENTISSAGE;BAC PROFESSIONNEL;BAC PRO PROD;BAC PRO 25513 SYST.NUM.OPT.A SURETE SECURITE;3;3;3;0;0;0;0;3;0;0;0;3;0;0
9483.0;2022;04;BORDEAUX;MASCULIN;APPRENTISSAGE;BAC PROFESSIONNEL;BAC PRO PROD;BAC PRO AG 21114 CONDUITE PRODUCTIONS HORTICOLES;12;11;10;1;0;0;0;10;0;0;0;1;9;1
9488.0;2022;04;BORDEAUX;MASCULIN;APPRENTISSAGE;BAC PROFESSIONNEL;BAC PRO PROD;BAC PRO AG 22107 TEC CONS VTE ALIMENTATION P.ALIM;2;2;2;0;0;0;0;2;0;0;0;1;1;0
9489.0;2022;04;BORDEAUX;MASCULIN;APPRENTISSAGE;BAC PROFESSIONNEL;BAC PRO SERV;BAC PRO 30001 GESTION-ADMINISTRATION;4;4;3;1;0;0;0;3;0;1;1;0;1;1
9491.0;2022;04;BORDEAUX;MASCULIN;APPRENTISSAGE;BAC PROFESSIONNEL;BAC PRO SERV;BAC PRO 31209 POISSONIER ECAILLER TRAITEUR;4;4;4;0;0;0;0;4;0;0;0;1;3;0
9496.0;2022;04;BORDEAUX;MASCULIN;APPRENTISSAGE;BAC PROFESSIONNEL;BAC PRO SERV;BAC PRO 33004 ACC.SOINS-S.PERS. OPT.EN STRUCTUR;1;1;1;0;0;0;0;1;0;0;0;1;0;0
9500.0;2022;04;BORDEAUX;MASCULIN;APPRENTISSAGE;BAC PROFESSIONNEL;BAC PRO SERV;BAC PRO 34303 GEST. POLLUTIONS PROTEC. ENVIRON.;1;1;1;0;0;0;0;1;0;0;0;1;0;0
9512.0;2022;04;BORDEAUX;MASCULIN;FORMATION CONTINUE;BAC PROFESSIONNEL;BAC PRO PROD;BAC PRO 25007 MAINTENANCE EQUIPEMENTS INDUST.;1;0;0;0;0;0;0;0;0;0;0;0;0;0
9518.0;2022;04;BORDEAUX;MASCULIN;INDIVIDUEL;BAC GENERAL;BAC GENERAL;BAC GENE 10019 BAC GENERAL;115;77;42;26;9;8;1;50;0;1;2;15;32;27
9522.0;2022;04;BORDEAUX;MASCULIN;INDIVIDUEL;BAC PROFESSIONNEL;BAC PRO PROD;BAC PRO 25214 MAINT.VEHIC.OPTA VOIT.PARTICUL.;1;1;1;0;0;0;0;1;0;0;1;0;0;0
9525.0;2022;04;BORDEAUX;MASCULIN;INDIVIDUEL;BAC PROFESSIONNEL;BAC PRO PROD;BAC PRO 25515 SYST.NUM.OPT.C RES.INF.SYST.COMM.;3;3;2;1;0;0;0;2;0;0;0;0;2;1
9544.0;2022;04;BORDEAUX;MASCULIN;INDIVIDUEL;BAC TECHNOLOGIQUE;BAC STMG;BAC STMG MERCATIQUE (MARKETING);23;17;11;3;3;1;2;12;0;0;0;1;11;5
9555.0;2022;04;BORDEAUX;MASCULIN;SCOLAIRE;BAC PROFESSIONNEL;BAC PRO PROD;BAC PRO 22703 TECHN.INSTALL.SYST.ENERG.CLIMATI;68;68;50;17;1;1;0;51;0;2;12;19;18;17
9561.0;2022;04;BORDEAUX;MASCULIN;SCOLAIRE;BAC PROFESSIONNEL;BAC PRO PROD;BACPRO 23103 TECHNICIEN GEOMETRE-TOPOGRAPHE;12;12;11;0;1;1;0;12;0;1;3;4;4;0
9566.0;2022;04;BORDEAUX;MASCULIN;SCOLAIRE;BAC PROFESSIONNEL;BAC PRO PROD;BAC PRO 23405 TECHNICIEN MENUISIER AGENCEUR;102;102;87;9;6;5;1;92;0;4;29;36;23;10
9567.0;2022;04;BORDEAUX;MASCULIN;SCOLAIRE;BAC PROFESSIONNEL;BAC PRO PROD;BAC PRO 23407 TECHNIC.FAB.BOIS ET MATERX ASSOC;13;13;11;1;1;1;0;12;0;0;2;6;4;1
9569.0;2022;04;BORDEAUX;MASCULIN;SCOLAIRE;BAC PROFESSIONNEL;BAC PRO PROD;BAC PRO 24202 ARTIS.& MET.ART : TAPIS.D'AMEUBL;6;6;6;0;0;0;0;6;0;1;2;2;1;0
9570.0;2022;04;BORDEAUX;MASCULIN;SCOLAIRE;BAC PROFESSIONNEL;BAC PRO PROD;BAC PRO 24203 METIERS DE LA MODE - VÊTEMENT;13;12;11;1;0;0;0;11;0;3;1;4;3;1
9583.0;2022;04;BORDEAUX;MASCULIN;SCOLAIRE;BAC PROFESSIONNEL;BAC PRO PROD;BAC PRO 25304 AERONAUTIQUE OPTION STRUCTURE;32;31;22;8;1;1;0;23;0;0;3;8;12;8
9601.0;2022;04;BORDEAUX;MASCULIN;SCOLAIRE;BAC PROFESSIONNEL;BAC PRO PROD;BAC PRO AG 21303 FORET;32;31;27;4;0;0;0;27;0;0;2;8;17;4
9602.0;2022;04;BORDEAUX;MASCULIN;SCOLAIRE;BAC PROFESSIONNEL;BAC PRO PROD;BAC PRO AG 21405 AMENAGEMENTS PAYSAGERS;93;91;75;16;0;0;0;75;0;2;7;31;35;16
9606.0;2022;04;BORDEAUX;MASCULIN;SCOLAIRE;BAC PROFESSIONNEL;BAC PRO PROD;BAC PRO AG 22107 TEC CONS VTE ALIMENTATION P.ALIM;3;3;3;0;0;0;0;3;0;0;1;2;0;0
9618.0;2022;04;BORDEAUX;MASCULIN;SCOLAIRE;BAC PROFESSIONNEL;BAC PRO SERV;BAC PRO 33002 SERVICES DE PROXIMITE  VIE LOCAL;68;67;57;6;4;4;0;61;0;1;15;26;19;6
9625.0;2022;04;BORDEAUX;MASCULIN;SCOLAIRE;BAC PROFESSIONNEL;BAC PRO SERV;BAC PRO 34304 HYGIENE PROPRETE STERILISATION;3;3;3;0;0;0;0;3;0;0;1;0;2;0
9630.0;2022;04;BORDEAUX;MASCULIN;SCOLAIRE;BAC TECHNOLOGIQUE;BAC S2TMD;BAC S2TMD MUSIQUE;5;5;5;0;0;0;0;5;0;0;2;2;1;0
9652.0;2022;06;CLERMONT-FERRAND;FEMININ;APPRENTISSAGE;BAC PROFESSIONNEL;BAC PRO PROD;BAC PRO 25106 TECHNICIEN D'USINAGE;1;1;1;0;0;0;0;1;0;1;0;0;0;0
9655.0;2022;06;CLERMONT-FERRAND;FEMININ;APPRENTISSAGE;BAC PROFESSIONNEL;BAC PRO PROD;BAC PRO 25302 AERONAUTIQUE OPTION AVIONIQUE;1;1;1;0;0;0;0;1;0;1;0;0;0;0
9656.0;2022;06;CLERMONT-FERRAND;FEMININ;APPRENTISSAGE;BAC PROFESSIONNEL;BAC PRO PROD;BAC PRO AG 21004 CGEA;7;7;5;2;0;0;0;5;0;0;0;0;5;2
9657.0;2022;06;CLERMONT-FERRAND;FEMININ;APPRENTISSAGE;BAC PROFESSIONNEL;BAC PRO PROD;BAC PRO AG 21203 TECHN CONSEIL DE VENTE ANIMAL;1;1;0;1;0;0;0;0;0;0;0;0;0;1
9658.0;2022;06;CLERMONT-FERRAND;FEMININ;APPRENTISSAGE;BAC PROFESSIONNEL;BAC PRO PROD;BAC PRO AG 21210 COND GEST ENTR CANIN ET FELIN;11;10;10;0;0;0;0;10;0;0;2;1;7;0
9659.0;2022;06;CLERMONT-FERRAND;FEMININ;APPRENTISSAGE;BAC PROFESSIONNEL;BAC PRO PROD;BAC PRO AG 21405 AMENAGEMENTS PAYSAGERS;1;1;1;0;0;0;0;1;0;0;0;0;1;0
9661.0;2022;06;CLERMONT-FERRAND;FEMININ;APPRENTISSAGE;BAC PROFESSIONNEL;BAC PRO SERV;BAC PRO 30001 GESTION-ADMINISTRATION;4;4;4;0;0;0;0;4;0;2;0;1;1;0
9665.0;2022;06;CLERMONT-FERRAND;FEMININ;APPRENTISSAGE;BAC PROFESSIONNEL;BAC PRO SERV;BAC PRO 31214 MET.COM.VEN.OP.B PR.CL.VA.OF.COM.;1;1;1;0;0;0;0;1;0;0;0;1;0;0
9670.0;2022;06;CLERMONT-FERRAND;FEMININ;ENSEIGNEMENT A DISTANCE;BAC PROFESSIONNEL;BAC PRO PROD;BAC PRO AG 21004 CGEA;59;47;40;7;0;0;0;40;0;0;0;0;40;7
9672.0;2022;06;CLERMONT-FERRAND;FEMININ;ENSEIGNEMENT A DISTANCE;BAC PROFESSIONNEL;BAC PRO SERV;BAC PRO 33004 ACC.SOINS-S.PERS. OPT.EN STRUCTUR;2;2;1;1;0;0;0;1;0;0;0;0;1;1
9695.0;2022;06;CLERMONT-FERRAND;FEMININ;INDIVIDUEL;BAC TECHNOLOGIQUE;BAC STMG;BAC STMG GESTION ET FINANCE;1;0;0;0;0;0;0;0;0;0;0;0;0;0
9702.0;2022;06;CLERMONT-FERRAND;FEMININ;SCOLAIRE;BAC PROFESSIONNEL;BAC PRO PROD;BAC PRO 22403 ARTS.& MET.ART:MET.ENSEIGN SIGNA;8;8;8;0;0;0;0;8;0;0;1;5;2;0
9705.0;2022;06;CLERMONT-FERRAND;FEMININ;SCOLAIRE;BAC PROFESSIONNEL;BAC PRO PROD;BAC PRO 23004 TECHN. ETUDES BAT.A ETUDES & ECO.;6;6;4;2;0;0;0;4;0;0;0;1;3;2
9707.0;2022;06;CLERMONT-FERRAND;FEMININ;SCOLAIRE;BAC PROFESSIONNEL;BAC PRO PROD;BAC PRO 23102 TRAVAUX PUBLICS;1;1;1;0;0;0;0;1;0;0;0;0;1;0
9711.0;2022;06;CLERMONT-FERRAND;FEMININ;SCOLAIRE;BAC PROFESSIONNEL;BAC PRO PROD;BAC PRO 24202 ARTIS.& MET.ART : TAPIS.D'AMEUBL;7;7;4;1;2;1;1;5;0;0;1;1;3;2
9720.0;2022;06;CLERMONT-FERRAND;FEMININ;SCOLAIRE;BAC PROFESSIONNEL;BAC PRO PROD;BAC PRO 25510 METIERS ELECT. ENVIRON. CONNECTES;2;2;1;1;0;0;0;1;0;0;0;0;1;1
9727.0;2022;06;CLERMONT-FERRAND;FEMININ;SCOLAIRE;BAC PROFESSIONNEL;BAC PRO PROD;BAC PRO AG 21302 GEST MILIEUX NATURELS FAUNE;4;4;3;1;0;0;0;3;0;0;0;0;3;1
9728.0;2022;06;CLERMONT-FERRAND;FEMININ;SCOLAIRE;BAC PROFESSIONNEL;BAC PRO PROD;BAC PRO AG 21303 FORET;1;1;1;0;0;0;0;1;0;0;0;0;1;0
9729.0;2022;06;CLERMONT-FERRAND;FEMININ;SCOLAIRE;BAC PROFESSIONNEL;BAC PRO PROD;BAC PRO AG 21405 AMENAGEMENTS PAYSAGERS;3;3;3;0;0;0;0;3;0;0;0;2;1;0
9735.0;2022;06;CLERMONT-FERRAND;FEMININ;SCOLAIRE;BAC PROFESSIONNEL;BAC PRO SERV;BAC PRO 31108 TRANSPORT;6;6;5;1;0;0;0;5;0;0;0;3;2;1
9742.0;2022;06;CLERMONT-FERRAND;FEMININ;SCOLAIRE;BAC PROFESSIONNEL;BAC PRO SERV;BAC PRO 32304 PHOTOGRAPHIE;13;13;11;1;1;1;0;12;0;1;2;3;6;1
9743.0;2022;06;CLERMONT-FERRAND;FEMININ;SCOLAIRE;BAC PROFESSIONNEL;BAC PRO SERV;BAC PRO 33002 SERVICES DE PROXIMITE  VIE LOCAL;25;25;18;4;3;2;1;20;0;1;3;7;9;5
9744.0;2022;06;CLERMONT-FERRAND;FEMININ;SCOLAIRE;BAC PROFESSIONNEL;BAC PRO SERV;BAC PRO 33003 ACC.SOINS-S.PERS. OPT.A DOMICILE;39;38;30;8;0;0;0;30;0;0;5;14;11;8
9745.0;2022;06;CLERMONT-FERRAND;FEMININ;SCOLAIRE;BAC PROFESSIONNEL;BAC PRO SERV;BAC PRO 33004 ACC.SOINS-S.PERS. OPT.EN STRUCTUR;293;293;267;22;4;2;2;269;0;5;57;128;79;24
9747.0;2022;06;CLERMONT-FERRAND;FEMININ;SCOLAIRE;BAC PROFESSIONNEL;BAC PRO SERV;BAC PRO 33102 PROTHESE DENTAIRE;7;7;6;1;0;0;0;6;0;0;1;3;2;1
9748.0;2022;06;CLERMONT-FERRAND;FEMININ;SCOLAIRE;BAC PROFESSIONNEL;BAC PRO SERV;BAC PRO 33403 COMMERC. SERVICES EN RESTAURATION;48;48;36;12;0;0;0;36;0;1;8;14;13;12
9751.0;2022;06;CLERMONT-FERRAND;FEMININ;SCOLAIRE;BAC PROFESSIONNEL;BAC PRO SERV;BAC PRO 34403 METIERS DE LA SECURITE;18;18;18;0;0;0;0;18;0;2;5;7;4;0
9754.0;2022;06;CLERMONT-FERRAND;FEMININ;SCOLAIRE;BAC TECHNOLOGIQUE;BAC STAV;BAC STAV AGRONOMIE ALIM ENV TERRITOI;103;103;101;2;0;0;0;101;0;1;16;42;42;2
9761.0;2022;06;CLERMONT-FERRAND;FEMININ;SCOLAIRE;BAC TECHNOLOGIQUE;BAC STL;BAC STL BIOCHIM.-BIOLOGIE-BIOTECHNOL.;61;61;56;2;3;3;0;59;0;2;6;18;33;2
9764.0;2022;06;CLERMONT-FERRAND;FEMININ;SCOLAIRE;BAC TECHNOLOGIQUE;BAC STMG;BAC STMG MERCATIQUE (MARKETING);211;211;174;6;31;15;16;189;0;0;16;67;106;22
9771.0;2022;06;CLERMONT-FERRAND;MASCULIN;APPRENTISSAGE;BAC PROFESSIONNEL;BAC PRO PROD;BAC PRO 22703 TECHN.INSTALL.SYST.ENERG.CLIMATI;12;12;5;4;3;1;2;6;0;0;0;3;3;6
9773.0;2022;06;CLERMONT-FERRAND;MASCULIN;APPRENTISSAGE;BAC PROFESSIONNEL;BAC PRO PROD;BAC PRO 22705 TECHNICIEN GAZ;2;2;2;0;0;0;0;2;0;1;1;0;0;0
9776.0;2022;06;CLERMONT-FERRAND;MASCULIN;APPRENTISSAGE;BAC PROFESSIONNEL;BAC PRO PROD;BAC PRO 23404 TECHNICIEN CONSTRUCTEUR BOIS;6;6;6;0;0;0;0;6;0;0;1;1;4;0
9777.0;2022;06;CLERMONT-FERRAND;MASCULIN;APPRENTISSAGE;BAC PROFESSIONNEL;BAC PRO PROD;BAC PRO 23405 TECHNICIEN MENUISIER AGENCEUR;18;18;16;2;0;0;0;16;0;1;4;6;5;2
9782.0;2022;06;CLERMONT-FERRAND;MASCULIN;APPRENTISSAGE;BAC PROFESSIONNEL;BAC PRO PROD;BAC PRO 25214 MAINT.VEHIC.OPTA VOIT.PARTICUL.;63;63;42;15;6;4;2;46;0;2;8;11;25;17
9789.0;2022;06;CLERMONT-FERRAND;MASCULIN;APPRENTISSAGE;BAC PROFESSIONNEL;BAC PRO PROD;BAC PRO 25303 AERONAUTIQUE OPTION SYSTEMES;10;10;9;1;0;0;0;9;0;0;4;5;0;1
9791.0;2022;06;CLERMONT-FERRAND;MASCULIN;APPRENTISSAGE;BAC PROFESSIONNEL;BAC PRO PROD;BAC PRO 25408 REPARATION DES CARROSSERIES;16;16;12;2;2;1;1;13;0;0;3;5;5;3
9797.0;2022;06;CLERMONT-FERRAND;MASCULIN;APPRENTISSAGE;BAC PROFESSIONNEL;BAC PRO PROD;BAC PRO AG 21004 CGEA;22;22;16;6;0;0;0;16;0;0;1;6;9;6
9798.0;2022;06;CLERMONT-FERRAND;MASCULIN;APPRENTISSAGE;BAC PROFESSIONNEL;BAC PRO PROD;BAC PRO AG 21203 TECHN CONSEIL DE VENTE ANIMAL;2;2;2;0;0;0;0;2;0;1;0;1;0;0
9799.0;2022;06;CLERMONT-FERRAND;MASCULIN;APPRENTISSAGE;BAC PROFESSIONNEL;BAC PRO PROD;BAC PRO AG 21210 COND GEST ENTR CANIN ET FELIN;7;7;4;3;0;0;0;4;0;0;0;1;3;3
9801.0;2022;06;CLERMONT-FERRAND;MASCULIN;APPRENTISSAGE;BAC PROFESSIONNEL;BAC PRO PROD;BAC PRO AG 21405 AMENAGEMENTS PAYSAGERS;19;19;16;3;0;0;0;16;0;0;2;5;9;3
9802.0;2022;06;CLERMONT-FERRAND;MASCULIN;APPRENTISSAGE;BAC PROFESSIONNEL;BAC PRO SERV;BAC PRO 30001 GESTION-ADMINISTRATION;1;1;1;0;0;0;0;1;0;0;0;0;1;0
9805.0;2022;06;CLERMONT-FERRAND;MASCULIN;APPRENTISSAGE;BAC PROFESSIONNEL;BAC PRO SERV;BAC PRO 31213 MET.COM.VEN.OP.A ANI.GES.ESP.COM.;49;47;33;9;5;4;1;37;0;1;5;12;19;10
9806.0;2022;06;CLERMONT-FERRAND;MASCULIN;APPRENTISSAGE;BAC PROFESSIONNEL;BAC PRO SERV;BAC PRO 31214 MET.COM.VEN.OP.B PR.CL.VA.OF.COM.;4;4;3;1;0;0;0;3;0;0;1;2;0;1
9807.0;2022;06;CLERMONT-FERRAND;MASCULIN;APPRENTISSAGE;BAC PROFESSIONNEL;BAC PRO SERV;BAC PRO 32208 REAL.PR.IMPR.PLURI.OPTB.PR.IMPR.;3;3;3;0;0;0;0;3;0;0;1;1;1;0
9809.0;2022;06;CLERMONT-FERRAND;MASCULIN;APPRENTISSAGE;BAC PROFESSIONNEL;BAC PRO SERV;BAC PRO 33004 ACC.SOINS-S.PERS. OPT.EN STRUCTUR;2;2;2;0;0;0;0;2;0;0;0;1;1;0
9813.0;2022;06;CLERMONT-FERRAND;MASCULIN;ENSEIGNEMENT A DISTANCE;BAC PROFESSIONNEL;BAC PRO PROD;BAC PRO AG 21004 CGEA;65;47;35;12;0;0;0;35;0;0;0;0;35;12
9817.0;2022;06;CLERMONT-FERRAND;MASCULIN;ENSEIGNEMENT A DISTANCE;BAC TECHNOLOGIQUE;BAC STAV;BAC STAV AGRONOMIE ALIM ENV TERRITOI;15;14;14;0;0;0;0;14;0;0;1;0;13;0
9821.0;2022;06;CLERMONT-FERRAND;MASCULIN;FORMATION CONTINUE;BAC PROFESSIONNEL;BAC PRO PROD;BAC PRO 23404 TECHNICIEN CONSTRUCTEUR BOIS;1;1;1;0;0;0;0;1;0;1;0;0;0;0
9826.0;2022;06;CLERMONT-FERRAND;MASCULIN;INDIVIDUEL;BAC GENERAL;BAC GENERAL;BAC GENE 10019 BAC GENERAL;27;12;5;5;2;0;2;5;0;1;0;1;3;7
9827.0;2022;06;CLERMONT-FERRAND;MASCULIN;INDIVIDUEL;BAC PROFESSIONNEL;BAC PRO PROD;BAC PRO 25510 METIERS ELECT. ENVIRON. CONNECTES;1;1;1;0;0;0;0;1;0;1;0;0;0;0
9830.0;2022;06;CLERMONT-FERRAND;MASCULIN;INDIVIDUEL;BAC PROFESSIONNEL;BAC PRO PROD;BAC PRO AG 21113 CGEVV;2;2;2;0;0;0;0;2;0;0;0;0;2;0
9831.0;2022;06;CLERMONT-FERRAND;MASCULIN;INDIVIDUEL;BAC PROFESSIONNEL;BAC PRO PROD;BAC PRO AG 21114 CONDUITE PRODUCTIONS HORTICOLES;2;1;1;0;0;0;0;1;0;0;0;0;1;0
9834.0;2022;06;CLERMONT-FERRAND;MASCULIN;INDIVIDUEL;BAC PROFESSIONNEL;BAC PRO SERV;BAC PRO 30001 GESTION-ADMINISTRATION;1;0;0;0;0;0;0;0;0;0;0;0;0;0
9856.0;2022;06;CLERMONT-FERRAND;MASCULIN;SCOLAIRE;BAC PROFESSIONNEL;BAC PRO PROD;BAC PRO 23404 TECHNICIEN CONSTRUCTEUR BOIS;22;22;18;4;0;0;0;18;0;0;2;7;9;4
9859.0;2022;06;CLERMONT-FERRAND;MASCULIN;SCOLAIRE;BAC PROFESSIONNEL;BAC PRO PROD;BAC PRO 24203 METIERS DE LA MODE - VÊTEMENT;1;1;1;0;0;0;0;1;0;0;1;0;0;0
9871.0;2022;06;CLERMONT-FERRAND;MASCULIN;SCOLAIRE;BAC PROFESSIONNEL;BAC PRO PROD;BAC PRO 25408 REPARATION DES CARROSSERIES;17;17;14;2;1;0;1;14;0;1;4;3;6;3
9872.0;2022;06;CLERMONT-FERRAND;MASCULIN;SCOLAIRE;BAC PROFESSIONNEL;BAC PRO PROD;BAC PRO 25410 CONSTRUCTION DES CARROSSERIES;8;8;7;1;0;0;0;7;0;0;1;3;3;1
9877.0;2022;06;CLERMONT-FERRAND;MASCULIN;SCOLAIRE;BAC PROFESSIONNEL;BAC PRO PROD;BAC PRO 25514 SYST.NUM.OPT.B AUD.RES.EQUIP.DOM.;21;21;21;0;0;0;0;21;0;0;5;12;4;0
9883.0;2022;06;CLERMONT-FERRAND;MASCULIN;SCOLAIRE;BAC PROFESSIONNEL;BAC PRO PROD;BAC PRO AG 21210 COND GEST ENTR CANIN ET FELIN;9;9;9;0;0;0;0;9;0;1;0;3;5;0
9885.0;2022;06;CLERMONT-FERRAND;MASCULIN;SCOLAIRE;BAC PROFESSIONNEL;BAC PRO PROD;BAC PRO AG 21302 GEST MILIEUX NATURELS FAUNE;27;27;27;0;0;0;0;27;0;2;4;11;10;0
9895.0;2022;06;CLERMONT-FERRAND;MASCULIN;SCOLAIRE;BAC PROFESSIONNEL;BAC PRO SERV;BAC PRO 31212 METIERS DE L'ACCUEIL;27;27;21;5;1;1;0;22;0;1;5;7;9;5
9896.0;2022;06;CLERMONT-FERRAND;MASCULIN;SCOLAIRE;BAC PROFESSIONNEL;BAC PRO SERV;BAC PRO 31213 MET.COM.VEN.OP.A ANI.GES.ESP.COM.;135;135;99;29;7;3;4;102;0;1;14;38;49;33
9911.0;2022;06;CLERMONT-FERRAND;MASCULIN;SCOLAIRE;BAC PROFESSIONNEL;BAC PRO SERV;BAC PRO AG 33002 SERV PERS TERRIT;16;16;15;1;0;0;0;15;0;0;0;4;11;1
9917.0;2022;06;CLERMONT-FERRAND;MASCULIN;SCOLAIRE;BAC TECHNOLOGIQUE;BAC STI2D;BAC STI2D ENERGIES  ET ENVIRONNEMENT;60;60;45;6;9;8;1;53;0;0;4;21;28;7
9920.0;2022;06;CLERMONT-FERRAND;MASCULIN;SCOLAIRE;BAC TECHNOLOGIQUE;BAC STL;BAC STL BIOCHIM.-BIOLOGIE-BIOTECHNOL.;26;26;22;0;4;2;2;24;0;0;2;7;15;2
9931.0;2022;27;CORSE;FEMININ;ENSEIGNEMENT A DISTANCE;BAC PROFESSIONNEL;BAC PRO SERV;BAC PRO 30001 GESTION-ADMINISTRATION;1;1;0;1;0;0;0;0;0;0;0;0;0;1
9938.0;2022;27;CORSE;FEMININ;INDIVIDUEL;BAC PROFESSIONNEL;BAC PRO PROD;BAC PRO AG 21113 CGEVV;2;2;2;0;0;0;0;2;0;0;0;0;2;0
9949.0;2022;27;CORSE;FEMININ;SCOLAIRE;BAC PROFESSIONNEL;BAC PRO PROD;BAC PRO 24203 METIERS DE LA MODE - VÊTEMENT;10;10;9;0;1;1;0;10;0;1;3;2;4;0
9954.0;2022;27;CORSE;FEMININ;SCOLAIRE;BAC PROFESSIONNEL;BAC PRO SERV;BAC PRO 31107 CONDUCT. TRANSP.ROUT.MARCHANDISES;1;1;0;1;0;0;0;0;0;0;0;0;0;1
9955.0;2022;27;CORSE;FEMININ;SCOLAIRE;BAC PROFESSIONNEL;BAC PRO SERV;BAC PRO 31212 METIERS DE L'ACCUEIL;9;9;9;0;0;0;0;9;0;1;1;4;3;0
9959.0;2022;27;CORSE;FEMININ;SCOLAIRE;BAC PROFESSIONNEL;BAC PRO SERV;BAC PRO 33004 ACC.SOINS-S.PERS. OPT.EN STRUCTUR;67;67;55;10;2;2;0;57;0;3;23;16;15;10
9963.0;2022;27;CORSE;FEMININ;SCOLAIRE;BAC TECHNOLOGIQUE;BAC ST2S;BAC ST2S SCIENCES & TECHNO. SANTE & SOCIAL;84;84;67;1;16;12;4;79;1;3;11;21;43;5
9964.0;2022;27;CORSE;FEMININ;SCOLAIRE;BAC TECHNOLOGIQUE;BAC STAV;BAC STAV AGRONOMIE ALIM ENV TERRITOI;1;1;1;0;0;0;0;1;0;0;0;1;0;0
9965.0;2022;27;CORSE;FEMININ;SCOLAIRE;BAC TECHNOLOGIQUE;BAC STHR;BAC STHR SC.&TEC. HOTELLERIE-RESTAURATION;4;4;4;0;0;0;0;4;0;0;0;3;1;0
9974.0;2022;27;CORSE;MASCULIN;APPRENTISSAGE;BAC PROFESSIONNEL;BAC PRO PROD;BAC PRO 22703 TECHN.INSTALL.SYST.ENERG.CLIMATI;2;2;1;1;0;0;0;1;0;0;0;1;0;1
9978.0;2022;27;CORSE;MASCULIN;APPRENTISSAGE;BAC PROFESSIONNEL;BAC PRO PROD;BAC PRO 25513 SYST.NUM.OPT.A SURETE SECURITE;1;1;0;0;1;1;0;1;0;0;0;0;1;0
9982.0;2022;27;CORSE;MASCULIN;APPRENTISSAGE;BAC PROFESSIONNEL;BAC PRO SERV;BAC PRO 31213 MET.COM.VEN.OP.A ANI.GES.ESP.COM.;9;7;2;3;2;2;0;4;0;0;0;1;3;3
9987.0;2022;27;CORSE;MASCULIN;INDIVIDUEL;BAC GENERAL;BAC GENERAL;BAC GENE 10019 BAC GENERAL;6;5;2;2;1;1;0;3;0;1;0;0;2;2
9994.0;2022;27;CORSE;MASCULIN;INDIVIDUEL;BAC TECHNOLOGIQUE;BAC STMG;BAC STMG MERCATIQUE (MARKETING);1;1;0;0;1;1;0;1;0;0;0;0;1;0
9996.0;2022;27;CORSE;MASCULIN;SCOLAIRE;BAC PROFESSIONNEL;BAC PRO PROD;BAC PRO 22106 CUISINE;33;33;30;2;1;1;0;31;0;4;8;10;9;2
10000.0;2022;27;CORSE;MASCULIN;SCOLAIRE;BAC PROFESSIONNEL;BAC PRO PROD;BAC PRO 25007 MAINTENANCE EQUIPEMENTS INDUST.;16;16;12;3;1;1;0;13;0;0;2;4;7;3
20001.0;2023;28;LA REUNION;FEMININ;SCOLAIRE;BAC TECHNOLOGIQUE;BAC STMG;BAC STMG RESSOURCES HUMAINES ET COMMUNICATION;370;370;270;21;79;66;13;336;0;2;14;83;237;34
20002.0;2023;28;LA REUNION;FEMININ;SCOLAIRE;BAC TECHNOLOGIQUE;BAC STMG;BAC STMG SYSTEMES D'INFORMATION DE GESTION;23;23;12;5;6;4;2;16;0;0;0;3;13;7
20006.0;2023;28;LA REUNION;MASCULIN;APPRENTISSAGE;BAC PROFESSIONNEL;BAC PRO PROD;BAC PRO 23203 TECHNICIEN BAT. : ORG.REAL.GROS O;1;1;1;0;0;0;0;1;0;0;0;0;1;0
20015.0;2023;28;LA REUNION;MASCULIN;APPRENTISSAGE;BAC PROFESSIONNEL;BAC PRO PROD;BAC PRO 25510 METIERS ELECT. ENVIRON. CONNECTES;8;8;8;0;0;0;0;8;0;2;1;2;3;0
20019.0;2023;28;LA REUNION;MASCULIN;APPRENTISSAGE;BAC PROFESSIONNEL;BAC PRO SERV;BAC PRO 32208 REAL.PR.IMPR.PLURI.OPTB.PR.IMPR.;1;1;1;0;0;0;0;1;0;0;0;0;1;0
20031.0;2023;28;LA REUNION;MASCULIN;INDIVIDUEL;BAC PROFESSIONNEL;BAC PRO SERV;BAC PRO 34403 METIERS DE LA SECURITE;1;1;0;0;1;1;0;1;0;0;0;0;1;0
20032.0;2023;28;LA REUNION;MASCULIN;INDIVIDUEL;BAC TECHNOLOGIQUE;BAC ST2S;BAC ST2S SCIENCES & TECHNO. SANTE & SOCIAL;1;1;0;1;0;0;0;0;0;0;0;0;0;1
20038.0;2023;28;LA REUNION;MASCULIN;SCOLAIRE;BAC PROFESSIONNEL;BAC PRO PROD;BAC PRO 20102 PILOTE DE LIGNE DE PRODUCTION;7;7;6;1;0;0;0;6;0;0;1;3;2;1
20045.0;2023;28;LA REUNION;MASCULIN;SCOLAIRE;BAC PROFESSIONNEL;BAC PRO PROD;BAC PRO 22704 TECHN. MAINT. SYST.ENERG.CLIMATI;17;17;4;10;3;3;0;7;0;0;1;1;5;10
20065.0;2023;28;LA REUNION;MASCULIN;SCOLAIRE;BAC PROFESSIONNEL;BAC PRO PROD;BAC PRO 25216 MAINT.VEHIC.OPTC MOTOCYCLES;17;17;12;2;3;3;0;15;0;0;3;5;7;2
20067.0;2023;28;LA REUNION;MASCULIN;SCOLAIRE;BAC PROFESSIONNEL;BAC PRO PROD;BAC PRO 25220 MAINT.MATERIELS OPT.B TP MANUT.;10;10;6;4;0;0;0;6;0;0;1;0;5;4
20069.0;2023;28;LA REUNION;MASCULIN;SCOLAIRE;BAC PROFESSIONNEL;BAC PRO PROD;BAC PRO 25303 AERONAUTIQUE OPTION SYSTEMES;23;23;19;4;0;0;0;19;0;0;8;2;9;4
20082.0;2023;28;LA REUNION;MASCULIN;SCOLAIRE;BAC PROFESSIONNEL;BAC PRO PROD;BAC PRO AG 21405 AMENAGEMENTS PAYSAGERS;6;4;3;1;0;0;0;3;0;0;0;0;3;1
20088.0;2023;28;LA REUNION;MASCULIN;SCOLAIRE;BAC PROFESSIONNEL;BAC PRO SERV;BAC PRO 31212 METIERS DE L'ACCUEIL;37;37;26;8;3;3;0;29;0;4;2;5;18;8
20096.0;2023;28;LA REUNION;MASCULIN;SCOLAIRE;BAC PROFESSIONNEL;BAC PRO SERV;BAC PRO 33101 OPTIQUE LUNETTERIE;7;7;7;0;0;0;0;7;0;0;1;2;4;0
20101.0;2023;28;LA REUNION;MASCULIN;SCOLAIRE;BAC PROFESSIONNEL;BAC PRO SERV;BAC PRO AG 33002 SERV PERS TERRIT;4;4;3;1;0;0;0;3;0;0;1;1;1;1
20102.0;2023;28;LA REUNION;MASCULIN;SCOLAIRE;BAC TECHNOLOGIQUE;BAC ST2S;BAC ST2S SCIENCES & TECHNO. SANTE & SOCIAL;85;85;62;4;19;15;4;77;0;1;7;21;48;8
20105.0;2023;28;LA REUNION;MASCULIN;SCOLAIRE;BAC TECHNOLOGIQUE;BAC STHR;BAC STHR SC.&TEC. HOTELLERIE-RESTAURATION;10;10;7;2;1;1;0;8;0;0;3;1;4;2
20106.0;2023;28;LA REUNION;MASCULIN;SCOLAIRE;BAC TECHNOLOGIQUE;BAC STI2D;BAC STI2D ARCHITECTURE ET CONSTRUCTION;107;107;88;4;15;14;1;102;0;2;8;33;59;5
20108.0;2023;28;LA REUNION;MASCULIN;SCOLAIRE;BAC TECHNOLOGIQUE;BAC STI2D;BAC STI2D INNOVATION TECHNO.  ET ECO CONCEPTION;97;97;79;7;11;8;3;87;1;1;10;23;52;10
20109.0;2023;28;LA REUNION;MASCULIN;SCOLAIRE;BAC TECHNOLOGIQUE;BAC STI2D;BAC STI2D SYSTÈME D'INFORMATION  ET NUMERIQUE;147;147;117;6;24;12;12;129;0;2;24;37;66;18
20110.0;2023;28;LA REUNION;MASCULIN;SCOLAIRE;BAC TECHNOLOGIQUE;BAC STL;BAC STL BIOCHIM.-BIOLOGIE-BIOTECHNOL.;47;47;37;3;7;4;3;41;0;2;5;8;26;6
20117.0;2023;09;LILLE;FEMININ;APPRENTISSAGE;BAC PROFESSIONNEL;BAC PRO PROD;BAC PRO 22105 BOULANGER-PÂTISSIER;3;3;3;0;0;0;0;3;0;1;2;0;0;0
20118.0;2023;09;LILLE;FEMININ;APPRENTISSAGE;BAC PROFESSIONNEL;BAC PRO PROD;BAC PRO 22106 CUISINE;24;23;12;9;2;2;0;14;0;0;2;2;10;9
20123.0;2023;09;LILLE;FEMININ;APPRENTISSAGE;BAC PROFESSIONNEL;BAC PRO PROD;BAC PRO 25007 MAINTENANCE EQUIPEMENTS INDUST.;1;1;1;0;0;0;0;1;0;0;0;0;1;0
20127.0;2023;09;LILLE;FEMININ;APPRENTISSAGE;BAC PROFESSIONNEL;BAC PRO PROD;BAC PRO 25408 REPARATION DES CARROSSERIES;2;1;1;0;0;0;0;1;0;0;1;0;0;0
20130.0;2023;09;LILLE;FEMININ;APPRENTISSAGE;BAC PROFESSIONNEL;BAC PRO PROD;BAC PRO AG 21001 AGRO-EQUIPEMENT;3;3;3;0;0;0;0;3;0;0;1;1;1;0
20131.0;2023;09;LILLE;FEMININ;APPRENTISSAGE;BAC PROFESSIONNEL;BAC PRO PROD;BAC PRO AG 21004 CGEA;14;14;13;1;0;0;0;13;0;0;1;4;8;1
20134.0;2023;09;LILLE;FEMININ;APPRENTISSAGE;BAC PROFESSIONNEL;BAC PRO PROD;BAC PRO AG 21211 COND GEST ENTR HIPPIQUE;21;21;15;6;0;0;0;15;0;1;1;7;6;6
20152.0;2023;09;LILLE;FEMININ;ENSEIGNEMENT A DISTANCE;BAC PROFESSIONNEL;BAC PRO SERV;BAC PRO 31214 MET.COM.VEN.OP.B PR.CL.VA.OF.COM.;1;0;0;0;0;0;0;0;0;0;0;0;0;0
20153.0;2023;09;LILLE;FEMININ;ENSEIGNEMENT A DISTANCE;BAC PROFESSIONNEL;BAC PRO SERV;BAC PRO 32304 PHOTOGRAPHIE;1;1;1;0;0;0;0;1;0;1;0;0;0;0
20155.0;2023;09;LILLE;FEMININ;ENSEIGNEMENT A DISTANCE;BAC PROFESSIONNEL;BAC PRO SERV;BAC PRO 33004 ACC.SOINS-S.PERS. OPT.EN STRUCTUR;7;4;3;1;0;0;0;3;0;0;0;2;1;1
20164.0;2023;09;LILLE;FEMININ;FORMATION CONTINUE;BAC PROFESSIONNEL;BAC PRO SERV;BAC PRO 31213 MET.COM.VEN.OP.A ANI.GES.ESP.COM.;13;11;4;7;0;0;0;4;0;0;0;1;3;7
20165.0;2023;09;LILLE;FEMININ;INDIVIDUEL;BAC GENERAL;BAC GENERAL;BAC GENE 10019 BAC GENERAL;81;80;22;50;8;6;2;28;1;0;4;5;18;52
20166.0;2023;09;LILLE;FEMININ;INDIVIDUEL;BAC PROFESSIONNEL;BAC PRO PROD;BAC PRO AG 21004 CGEA;2;2;1;1;0;0;0;1;0;0;0;0;1;1
20168.0;2023;09;LILLE;FEMININ;INDIVIDUEL;BAC PROFESSIONNEL;BAC PRO PROD;BAC PRO AG 21203 TECHN CONSEIL DE VENTE ANIMAL;2;2;0;2;0;0;0;0;0;0;0;0;0;2
20169.0;2023;09;LILLE;FEMININ;INDIVIDUEL;BAC PROFESSIONNEL;BAC PRO PROD;BAC PRO AG 21211 COND GEST ENTR HIPPIQUE;2;2;1;1;0;0;0;1;0;0;0;0;1;1
20172.0;2023;09;LILLE;FEMININ;INDIVIDUEL;BAC PROFESSIONNEL;BAC PRO SERV;BAC PRO 31212 METIERS DE L'ACCUEIL;1;1;0;0;1;0;1;0;0;0;0;0;0;1
20174.0;2023;09;LILLE;FEMININ;INDIVIDUEL;BAC PROFESSIONNEL;BAC PRO SERV;BAC PRO 31214 MET.COM.VEN.OP.B PR.CL.VA.OF.COM.;1;1;0;1;0;0;0;0;0;0;0;0;0;1
20175.0;2023;09;LILLE;FEMININ;INDIVIDUEL;BAC PROFESSIONNEL;BAC PRO SERV;BAC PRO 33002 SERVICES DE PROXIMITE  VIE LOCAL;1;0;0;0;0;0;0;0;0;0;0;0;0;0
20179.0;2023;09;LILLE;FEMININ;INDIVIDUEL;BAC PROFESSIONNEL;BAC PRO SERV;BAC PRO 33602 PERRUQUIER POSTICHEUR;1;1;1;0;0;0;0;1;0;0;0;1;0;0
20183.0;2023;09;LILLE;FEMININ;INDIVIDUEL;BAC TECHNOLOGIQUE;BAC STAV;BAC STAV AGRONOMIE ALIM ENV TERRITOI;1;1;1;0;0;0;0;1;0;0;0;0;1;0
20184.0;2023;09;LILLE;FEMININ;INDIVIDUEL;BAC TECHNOLOGIQUE;BAC STMG;BAC STMG GESTION ET FINANCE;5;5;2;3;0;0;0;2;0;0;1;0;1;3
20187.0;2023;09;LILLE;FEMININ;SCOLAIRE;BAC GENERAL;BAC GENERAL;BAC GENE 10019 BAC GENERAL;12443;12443;11625;171;647;448;199;12073;483;1933;3242;3537;2878;370
20190.0;2023;09;LILLE;FEMININ;SCOLAIRE;BAC PROFESSIONNEL;BAC PRO PROD;BAC PRO 22004 PROC. CHIMIE EAU PAPIERS-CARTONS;5;5;4;1;0;0;0;4;0;0;1;2;1;1
20193.0;2023;09;LILLE;FEMININ;SCOLAIRE;BAC PROFESSIONNEL;BAC PRO PROD;BAC PRO 22106 CUISINE;112;112;89;18;5;2;3;91;0;6;19;27;39;21
20197.0;2023;09;LILLE;FEMININ;SCOLAIRE;BAC PROFESSIONNEL;BAC PRO PROD;BAC PRO 23003 ARTIS. & M.ART:MARCHANDISAGE VIS.;10;10;8;2;0;0;0;8;0;2;1;5;0;2
20203.0;2023;09;LILLE;FEMININ;SCOLAIRE;BAC PROFESSIONNEL;BAC PRO PROD;BAC PRO 23303 MENUISERIE ALUMINIUM-VERRE;1;1;1;0;0;0;0;1;0;0;0;1;0;0
20205.0;2023;09;LILLE;FEMININ;SCOLAIRE;BAC PROFESSIONNEL;BAC PRO PROD;BAC PRO 23405 TECHNICIEN MENUISIER AGENCEUR;9;9;7;1;1;1;0;8;0;1;4;1;2;1
20218.0;2023;09;LILLE;FEMININ;SCOLAIRE;BAC PROFESSIONNEL;BAC PRO PROD;BAC PRO 25514 SYST.NUM.OPT.B AUD.RES.EQUIP.DOM.;4;4;4;0;0;0;0;4;0;0;0;4;0;0
20223.0;2023;09;LILLE;FEMININ;SCOLAIRE;BAC PROFESSIONNEL;BAC PRO PROD;BAC PRO AG 21210 COND GEST ENTR CANIN ET FELIN;18;18;16;2;0;0;0;16;0;0;3;6;7;2
20228.0;2023;09;LILLE;FEMININ;SCOLAIRE;BAC PROFESSIONNEL;BAC PRO PROD;BAC PRO AG 21407 TEC CONS VTE UNIVERS JARDINERIE;16;13;11;2;0;0;0;11;0;2;1;4;4;2
20231.0;2023;09;LILLE;FEMININ;SCOLAIRE;BAC PROFESSIONNEL;BAC PRO SERV;BAC PRO 30004 ASSISTANC.GEST.ORGANIS.ACTIVITES;527;524;391;107;26;20;6;411;0;15;77;141;178;113
20235.0;2023;09;LILLE;FEMININ;SCOLAIRE;BAC PROFESSIONNEL;BAC PRO SERV;BAC PRO 31209 POISSONIER ECAILLER TRAITEUR;1;1;1;0;0;0;0;1;0;0;0;1;0;0
20236.0;2023;09;LILLE;FEMININ;SCOLAIRE;BAC PROFESSIONNEL;BAC PRO SERV;BAC PRO 31212 METIERS DE L'ACCUEIL;253;251;204;36;11;9;2;213;0;17;52;82;62;38
20237.0;2023;09;LILLE;FEMININ;SCOLAIRE;BAC PROFESSIONNEL;BAC PRO SERV;BAC PRO 31213 MET.COM.VEN.OP.A ANI.GES.ESP.COM.;1164;1147;894;192;61;38;23;932;0;52;176;319;385;215
20243.0;2023;09;LILLE;FEMININ;SCOLAIRE;BAC PROFESSIONNEL;BAC PRO SERV;BAC PRO 33004 ACC.SOINS-S.PERS. OPT.EN STRUCTUR;1255;1253;1065;128;60;44;16;1109;0;34;229;438;408;144
20247.0;2023;09;LILLE;FEMININ;SCOLAIRE;BAC PROFESSIONNEL;BAC PRO SERV;BAC PRO 33104 TECHNICIEN EN PROTHESE DENTAIRE;11;11;10;1;0;0;0;10;0;2;4;1;3;1
20248.0;2023;09;LILLE;FEMININ;SCOLAIRE;BAC PROFESSIONNEL;BAC PRO SERV;BAC PRO 33403 COMMERC. SERVICES EN RESTAURATION;97;97;75;19;3;2;1;77;0;1;12;30;34;20
20260.0;2023;09;LILLE;FEMININ;SCOLAIRE;BAC TECHNOLOGIQUE;BAC STHR;BAC STHR SC.&TEC. HOTELLERIE-RESTAURATION;49;49;47;0;2;1;1;48;1;8;9;19;11;1
20278.0;2023;09;LILLE;MASCULIN;APPRENTISSAGE;BAC PROFESSIONNEL;BAC PRO PROD;BAC PRO 23102 TRAVAUX PUBLICS;56;56;53;2;1;1;0;54;0;2;10;25;17;2
20282.0;2023;09;LILLE;MASCULIN;APPRENTISSAGE;BAC PROFESSIONNEL;BAC PRO PROD;BAC PRO 23404 TECHNICIEN CONSTRUCTEUR BOIS;3;3;2;0;1;1;0;3;0;0;1;0;2;0
20288.0;2023;09;LILLE;MASCULIN;APPRENTISSAGE;BAC PROFESSIONNEL;BAC PRO PROD;BAC PRO 25214 MAINT.VEHIC.OPTA VOIT.PARTICUL.;150;145;120;15;10;6;4;126;0;8;27;55;36;19
20291.0;2023;09;LILLE;MASCULIN;APPRENTISSAGE;BAC PROFESSIONNEL;BAC PRO PROD;BAC PRO 25219 MAINT.MATERIELS OPT.A AGRICOLES;26;26;17;5;4;3;1;20;0;0;1;5;14;6
20306.0;2023;09;LILLE;MASCULIN;APPRENTISSAGE;BAC PROFESSIONNEL;BAC PRO PROD;BAC PRO AG 21302 GEST MILIEUX NATURELS FAUNE;2;2;2;0;0;0;0;2;0;0;1;0;1;0
20307.0;2023;09;LILLE;MASCULIN;APPRENTISSAGE;BAC PROFESSIONNEL;BAC PRO PROD;BAC PRO AG 21405 AMENAGEMENTS PAYSAGERS;70;67;63;4;0;0;0;63;0;0;2;15;46;4
20313.0;2023;09;LILLE;MASCULIN;APPRENTISSAGE;BAC PROFESSIONNEL;BAC PRO SERV;BAC PRO 31213 MET.COM.VEN.OP.A ANI.GES.ESP.COM.;107;93;57;33;3;3;0;60;0;3;13;18;26;33
20317.0;2023;09;LILLE;MASCULIN;APPRENTISSAGE;BAC PROFESSIONNEL;BAC PRO SERV;BAC PRO 33604 METIERS DE LA COIFFURE;3;2;2;0;0;0;0;2;0;0;0;0;2;0
20323.0;2023;09;LILLE;MASCULIN;ENSEIGNEMENT A DISTANCE;BAC PROFESSIONNEL;BAC PRO SERV;BAC PRO 32304 PHOTOGRAPHIE;1;0;0;0;0;0;0;0;0;0;0;0;0;0
20335.0;2023;09;LILLE;MASCULIN;FORMATION CONTINUE;BAC PROFESSIONNEL;BAC PRO SERV;BAC PRO 31213 MET.COM.VEN.OP.A ANI.GES.ESP.COM.;6;5;3;2;0;0;0;3;0;1;0;1;1;2
20337.0;2023;09;LILLE;MASCULIN;INDIVIDUEL;BAC GENERAL;BAC GENERAL;BAC GENE 10019 BAC GENERAL;104;104;47;47;10;7;3;54;0;7;10;13;24;50
20341.0;2023;09;LILLE;MASCULIN;INDIVIDUEL;BAC PROFESSIONNEL;BAC PRO PROD;BAC PRO 23203 TECHNICIEN BAT. : ORG.REAL.GROS O;1;1;0;1;0;0;0;0;0;0;0;0;0;1
20358.0;2023;09;LILLE;MASCULIN;INDIVIDUEL;BAC PROFESSIONNEL;BAC PRO SERV;BAC PRO 33003 ACC.SOINS-S.PERS. OPT.A DOMICILE;1;1;1;0;0;0;0;1;0;0;0;0;1;0
20361.0;2023;09;LILLE;MASCULIN;INDIVIDUEL;BAC TECHNOLOGIQUE;BAC ST2S;BAC ST2S SCIENCES & TECHNO. SANTE & SOCIAL;9;9;3;6;0;0;0;3;0;0;0;0;3;6
20385.0;2023;09;LILLE;MASCULIN;SCOLAIRE;BAC PROFESSIONNEL;BAC PRO PROD;BAC PRO 23005 TECHN. ETUDES BAT B ASSIST.ARCHI.;24;24;20;3;1;1;0;21;0;0;1;10;10;3
20392.0;2023;09;LILLE;MASCULIN;SCOLAIRE;BAC PROFESSIONNEL;BAC PRO PROD;BAC PRO 23404 TECHNICIEN CONSTRUCTEUR BOIS;19;19;13;4;2;1;1;14;0;0;2;8;4;5
20393.0;2023;09;LILLE;MASCULIN;SCOLAIRE;BAC PROFESSIONNEL;BAC PRO PROD;BAC PRO 23405 TECHNICIEN MENUISIER AGENCEUR;88;85;65;14;6;6;0;71;0;4;14;21;32;14
20396.0;2023;09;LILLE;MASCULIN;SCOLAIRE;BAC PROFESSIONNEL;BAC PRO PROD;BAC PRO 24203 METIERS DE LA MODE - VÊTEMENT;11;11;9;2;0;0;0;9;0;1;4;1;3;2
20397.0;2023;09;LILLE;MASCULIN;SCOLAIRE;BAC PROFESSIONNEL;BAC PRO PROD;BAC PRO 24302 METIERS DU CUIR : MAROQUINERIE;1;1;1;0;0;0;0;1;0;0;0;0;1;0
20398.0;2023;09;LILLE;MASCULIN;SCOLAIRE;BAC PROFESSIONNEL;BAC PRO PROD;BAC PRO 25007 MAINTENANCE EQUIPEMENTS INDUST.;355;354;251;87;16;14;2;265;0;12;34;107;112;89
20402.0;2023;09;LILLE;MASCULIN;SCOLAIRE;BAC PROFESSIONNEL;BAC PRO PROD;BAC PRO 25216 MAINT.VEHIC.OPTC MOTOCYCLES;28;28;20;8;0;0;0;20;0;3;8;4;5;8
20405.0;2023;09;LILLE;MASCULIN;SCOLAIRE;BAC PROFESSIONNEL;BAC PRO PROD;BAC PRO 25303 AERONAUTIQUE OPTION SYSTEMES;11;11;11;0;0;0;0;11;0;1;4;6;0;0
20406.0;2023;09;LILLE;MASCULIN;SCOLAIRE;BAC PROFESSIONNEL;BAC PRO PROD;BAC PRO 25406 OUVRAGES DU BATIMENT METALLERIE;47;44;32;8;4;3;1;35;0;1;7;13;14;9
20415.0;2023;09;LILLE;MASCULIN;SCOLAIRE;BAC PROFESSIONNEL;BAC PRO PROD;BAC PRO AG 21001 AGRO-EQUIPEMENT;29;29;29;0;0;0;0;29;0;0;4;14;11;0
20417.0;2023;09;LILLE;MASCULIN;SCOLAIRE;BAC PROFESSIONNEL;BAC PRO PROD;BAC PRO AG 21114 CONDUITE PRODUCTIONS HORTICOLES;8;8;8;0;0;0;0;8;0;1;1;1;5;0
20421.0;2023;09;LILLE;MASCULIN;SCOLAIRE;BAC PROFESSIONNEL;BAC PRO PROD;BAC PRO AG 21211 COND GEST ENTR HIPPIQUE;3;3;3;0;0;0;0;3;0;0;1;2;0;0
20433.0;2023;09;LILLE;MASCULIN;SCOLAIRE;BAC PROFESSIONNEL;BAC PRO SERV;BAC PRO 31212 METIERS DE L'ACCUEIL;103;103;74;20;9;4;5;78;0;4;20;26;28;25
20447.0;2023;09;LILLE;MASCULIN;SCOLAIRE;BAC PROFESSIONNEL;BAC PRO SERV;BAC PRO 33602 PERRUQUIER POSTICHEUR;1;1;1;0;0;0;0;1;0;0;0;1;0;0
20450.0;2023;09;LILLE;MASCULIN;SCOLAIRE;BAC PROFESSIONNEL;BAC PRO SERV;BAC PRO 34403 METIERS DE LA SECURITE;215;214;182;26;6;5;1;187;0;2;33;77;75;27
20454.0;2023;09;LILLE;MASCULIN;SCOLAIRE;BAC TECHNOLOGIQUE;BAC STAV;BAC STAV AGRONOMIE ALIM ENV TERRITOI;209;209;202;7;0;0;0;202;0;3;25;77;97;7
20461.0;2023;09;LILLE;MASCULIN;SCOLAIRE;BAC TECHNOLOGIQUE;BAC STL;BAC STL BIOCHIM.-BIOLOGIE-BIOTECHNOL.;117;117;94;4;19;15;4;109;1;3;19;34;52;8
20469.0;2023;22;LIMOGES;FEMININ;APPRENTISSAGE;BAC PROFESSIONNEL;BAC PRO PROD;BAC PRO AG 21004 CGEA;1;1;1;0;0;0;0;1;0;0;0;0;1;0
20470.0;2023;22;LIMOGES;FEMININ;APPRENTISSAGE;BAC PROFESSIONNEL;BAC PRO PROD;BAC PRO AG 21211 COND GEST ENTR HIPPIQUE;1;1;1;0;0;0;0;1;0;0;0;0;1;0
20475.0;2023;22;LIMOGES;FEMININ;APPRENTISSAGE;BAC PROFESSIONNEL;BAC PRO SERV;BAC PRO 31214 MET.COM.VEN.OP.B PR.CL.VA.OF.COM.;1;1;1;0;0;0;0;1;0;0;1;0;0;0
20478.0;2023;22;LIMOGES;FEMININ;APPRENTISSAGE;BAC PROFESSIONNEL;BAC PRO SERV;BAC PRO 33403 COMMERC. SERVICES EN RESTAURATION;1;1;1;0;0;0;0;1;0;0;0;0;1;0
20480.0;2023;22;LIMOGES;FEMININ;APPRENTISSAGE;BAC PROFESSIONNEL;BAC PRO SERV;BAC PRO AG 33002 SERV PERS TERRIT;3;3;3;0;0;0;0;3;0;0;0;2;1;0
20481.0;2023;22;LIMOGES;FEMININ;ENSEIGNEMENT A DISTANCE;BAC GENERAL;BAC GENERAL;BAC GENE 10019 BAC GENERAL;11;11;8;0;3;3;0;11;0;2;3;2;4;0
20488.0;2023;22;LIMOGES;FEMININ;INDIVIDUEL;BAC PROFESSIONNEL;BAC PRO PROD;BAC PRO AG 21004 CGEA;1;1;1;0;0;0;0;1;0;0;0;0;1;0
20491.0;2023;22;LIMOGES;FEMININ;INDIVIDUEL;BAC PROFESSIONNEL;BAC PRO SERV;BAC PRO 30004 ASSISTANC.GEST.ORGANIS.ACTIVITES;3;2;1;1;0;0;0;1;0;0;0;0;1;1
20494.0;2023;22;LIMOGES;FEMININ;INDIVIDUEL;BAC PROFESSIONNEL;BAC PRO SERV;BAC PRO 33004 ACC.SOINS-S.PERS. OPT.EN STRUCTUR;2;1;0;1;0;0;0;0;0;0;0;0;0;1
20495.0;2023;22;LIMOGES;FEMININ;INDIVIDUEL;BAC PROFESSIONNEL;BAC PRO SERV;BAC PRO 33603 ESTHETIQUE COSMETIQUE PARFUMERIE;2;1;0;1;0;0;0;0;0;0;0;0;0;1
20500.0;2023;22;LIMOGES;FEMININ;SCOLAIRE;BAC GENERAL;BAC GENERAL;BAC GENE 10019 BAC GENERAL;2025;2025;1868;12;145;100;45;1968;46;238;479;633;572;57
20508.0;2023;22;LIMOGES;FEMININ;SCOLAIRE;BAC PROFESSIONNEL;BAC PRO PROD;BAC PRO 25108 TECHNICIEN MODELEUR;4;4;3;1;0;0;0;3;0;0;0;3;0;1
20516.0;2023;22;LIMOGES;FEMININ;SCOLAIRE;BAC PROFESSIONNEL;BAC PRO PROD;BAC PRO AG 21114 CONDUITE PRODUCTIONS HORTICOLES;4;4;4;0;0;0;0;4;0;1;1;1;1;0
20518.0;2023;22;LIMOGES;FEMININ;SCOLAIRE;BAC PROFESSIONNEL;BAC PRO PROD;BAC PRO AG 21211 COND GEST ENTR HIPPIQUE;17;17;12;5;0;0;0;12;0;0;3;2;7;5
20521.0;2023;22;LIMOGES;FEMININ;SCOLAIRE;BAC PROFESSIONNEL;BAC PRO PROD;BAC PRO AG 21407 TEC CONS VTE UNIVERS JARDINERIE;5;5;4;1;0;0;0;4;0;0;0;4;0;1
20522.0;2023;22;LIMOGES;FEMININ;SCOLAIRE;BAC PROFESSIONNEL;BAC PRO SERV;BAC PRO 30004 ASSISTANC.GEST.ORGANIS.ACTIVITES;69;69;44;18;7;6;1;50;0;1;8;16;25;19
20534.0;2023;22;LIMOGES;FEMININ;SCOLAIRE;BAC PROFESSIONNEL;BAC PRO SERV;BAC PRO 33101 OPTIQUE LUNETTERIE;10;10;10;0;0;0;0;10;0;0;4;4;2;0
20555.0;2023;22;LIMOGES;MASCULIN;APPRENTISSAGE;BAC PROFESSIONNEL;BAC PRO PROD;BAC PRO 22704 TECHN. MAINT. SYST.ENERG.CLIMATI;7;7;7;0;0;0;0;7;0;1;4;0;2;0
20559.0;2023;22;LIMOGES;MASCULIN;APPRENTISSAGE;BAC PROFESSIONNEL;BAC PRO PROD;BAC PRO 23205 INTERV. SUR PATRIMOINE BATI OPT.A;3;3;3;0;0;0;0;3;0;0;2;0;1;0
20561.0;2023;22;LIMOGES;MASCULIN;APPRENTISSAGE;BAC PROFESSIONNEL;BAC PRO PROD;BAC PRO 23304 AMENAGEMENT FINITION BATIMENT;4;4;2;2;0;0;0;2;0;0;1;1;0;2
20563.0;2023;22;LIMOGES;MASCULIN;APPRENTISSAGE;BAC PROFESSIONNEL;BAC PRO PROD;BAC PRO 23405 TECHNICIEN MENUISIER AGENCEUR;5;5;4;1;0;0;0;4;0;0;1;2;1;1
20565.0;2023;22;LIMOGES;MASCULIN;APPRENTISSAGE;BAC PROFESSIONNEL;BAC PRO PROD;BAC PRO 25007 MAINTENANCE EQUIPEMENTS INDUST.;20;20;13;4;3;2;1;15;0;0;4;7;4;5
20568.0;2023;22;LIMOGES;MASCULIN;APPRENTISSAGE;BAC PROFESSIONNEL;BAC PRO PROD;BAC PRO 25214 MAINT.VEHIC.OPTA VOIT.PARTICUL.;41;41;28;9;4;3;1;31;0;1;4;13;13;10
20574.0;2023;22;LIMOGES;MASCULIN;APPRENTISSAGE;BAC PROFESSIONNEL;BAC PRO PROD;BAC PRO 25408 REPARATION DES CARROSSERIES;3;3;3;0;0;0;0;3;0;1;0;1;1;0
20577.0;2023;22;LIMOGES;MASCULIN;APPRENTISSAGE;BAC PROFESSIONNEL;BAC PRO PROD;BAC PRO 25510 METIERS ELECT. ENVIRON. CONNECTES;27;27;23;1;3;2;1;25;0;1;7;9;8;2
20582.0;2023;22;LIMOGES;MASCULIN;APPRENTISSAGE;BAC PROFESSIONNEL;BAC PRO SERV;BAC PRO 31106 LOGISTIQUE;2;2;1;0;1;1;0;2;0;1;0;0;1;0
20584.0;2023;22;LIMOGES;MASCULIN;APPRENTISSAGE;BAC PROFESSIONNEL;BAC PRO SERV;BAC PRO 31214 MET.COM.VEN.OP.B PR.CL.VA.OF.COM.;4;4;3;0;1;0;1;3;0;1;0;1;1;1
20587.0;2023;22;LIMOGES;MASCULIN;APPRENTISSAGE;BAC PROFESSIONNEL;BAC PRO SERV;BAC PRO 34403 METIERS DE LA SECURITE;1;1;0;0;1;1;0;1;0;0;0;0;1;0
20588.0;2023;22;LIMOGES;MASCULIN;ENSEIGNEMENT A DISTANCE;BAC GENERAL;BAC GENERAL;BAC GENE 10019 BAC GENERAL;4;4;3;0;1;1;0;4;0;0;1;1;2;0
20589.0;2023;22;LIMOGES;MASCULIN;FORMATION CONTINUE;BAC PROFESSIONNEL;BAC PRO PROD;BAC PRO 23102 TRAVAUX PUBLICS;71;71;70;1;0;0;0;70;0;0;14;30;26;1
20602.0;2023;22;LIMOGES;MASCULIN;INDIVIDUEL;BAC PROFESSIONNEL;BAC PRO SERV;BAC PRO 34403 METIERS DE LA SECURITE;1;1;1;0;0;0;0;1;0;0;0;0;1;0
20604.0;2023;22;LIMOGES;MASCULIN;INDIVIDUEL;BAC TECHNOLOGIQUE;BAC STMG;BAC STMG GESTION ET FINANCE;1;1;1;0;0;0;0;1;0;0;0;0;1;0
20605.0;2023;22;LIMOGES;MASCULIN;INDIVIDUEL;BAC TECHNOLOGIQUE;BAC STMG;BAC STMG MERCATIQUE (MARKETING);4;4;0;2;2;2;0;2;0;0;0;0;2;2
20612.0;2023;22;LIMOGES;MASCULIN;SCOLAIRE;BAC PROFESSIONNEL;BAC PRO PROD;BAC PRO 22106 CUISINE;31;31;24;5;2;1;1;25;0;3;4;11;7;6
20634.0;2023;22;LIMOGES;MASCULIN;SCOLAIRE;BAC PROFESSIONNEL;BAC PRO PROD;BAC PRO 25410 CONSTRUCTION DES CARROSSERIES;3;3;1;1;1;0;1;1;0;0;0;1;0;2
20638.0;2023;22;LIMOGES;MASCULIN;SCOLAIRE;BAC PROFESSIONNEL;BAC PRO PROD;BAC PRO 25514 SYST.NUM.OPT.B AUD.RES.EQUIP.DOM.;34;34;23;6;5;2;3;25;0;0;4;11;10;9
20640.0;2023;22;LIMOGES;MASCULIN;SCOLAIRE;BAC PROFESSIONNEL;BAC PRO PROD;BAC PRO AG 21001 AGRO-EQUIPEMENT;18;18;18;0;0;0;0;18;0;1;3;10;4;0
20647.0;2023;22;LIMOGES;MASCULIN;SCOLAIRE;BAC PROFESSIONNEL;BAC PRO PROD;BAC PRO AG 21405 AMENAGEMENTS PAYSAGERS;19;19;19;0;0;0;0;19;0;0;0;6;13;0
20662.0;2023;22;LIMOGES;MASCULIN;SCOLAIRE;BAC PROFESSIONNEL;BAC PRO SERV;BAC PRO 33101 OPTIQUE LUNETTERIE;3;3;3;0;0;0;0;3;0;0;1;2;0;0
20665.0;2023;22;LIMOGES;MASCULIN;SCOLAIRE;BAC PROFESSIONNEL;BAC PRO SERV;BAC PRO 34304 HYGIENE PROPRETE STERILISATION;1;1;1;0;0;0;0;1;0;0;0;0;1;0
20667.0;2023;22;LIMOGES;MASCULIN;SCOLAIRE;BAC PROFESSIONNEL;BAC PRO SERV;BAC PRO AG 33002 SERV PERS TERRIT;8;8;6;2;0;0;0;6;0;0;0;1;5;2
20668.0;2023;22;LIMOGES;MASCULIN;SCOLAIRE;BAC TECHNOLOGIQUE;BAC ST2S;BAC ST2S SCIENCES & TECHNO. SANTE & SOCIAL;34;34;30;0;4;2;2;32;0;0;1;13;18;2
20674.0;2023;22;LIMOGES;MASCULIN;SCOLAIRE;BAC TECHNOLOGIQUE;BAC STI2D;BAC STI2D INNOVATION TECHNO.  ET ECO CONCEPTION;70;70;56;2;12;10;2;66;0;2;9;18;37;4
20678.0;2023;22;LIMOGES;MASCULIN;SCOLAIRE;BAC TECHNOLOGIQUE;BAC STMG;BAC STMG GESTION ET FINANCE;61;61;45;3;13;9;4;54;0;0;1;12;41;7
20680.0;2023;22;LIMOGES;MASCULIN;SCOLAIRE;BAC TECHNOLOGIQUE;BAC STMG;BAC STMG RESSOURCES HUMAINES ET COMMUNICATION;50;50;28;6;16;12;4;40;0;1;0;7;32;10
20684.0;2023;10;LYON;FEMININ;APPRENTISSAGE;BAC PROFESSIONNEL;BAC PRO PROD;BAC PRO 22105 BOULANGER-PÂTISSIER;3;3;3;0;0;0;0;3;0;1;0;1;1;0
20689.0;2023;10;LYON;FEMININ;APPRENTISSAGE;BAC PROFESSIONNEL;BAC PRO PROD;BAC PRO 23205 INTERV. SUR PATRIMOINE BATI OPT.A;1;1;1;0;0;0;0;1;0;0;0;1;0;0
20694.0;2023;10;LYON;FEMININ;APPRENTISSAGE;BAC PROFESSIONNEL;BAC PRO PROD;BAC PRO 25007 MAINTENANCE EQUIPEMENTS INDUST.;3;3;3;0;0;0;0;3;0;2;1;0;0;0
20696.0;2023;10;LYON;FEMININ;APPRENTISSAGE;BAC PROFESSIONNEL;BAC PRO PROD;BAC PRO 25214 MAINT.VEHIC.OPTA VOIT.PARTICUL.;6;6;6;0;0;0;0;6;0;1;3;2;0;0
20697.0;2023;10;LYON;FEMININ;APPRENTISSAGE;BAC PROFESSIONNEL;BAC PRO PROD;BAC PRO 25216 MAINT.VEHIC.OPTC MOTOCYCLES;1;1;0;1;0;0;0;0;0;0;0;0;0;1
20698.0;2023;10;LYON;FEMININ;APPRENTISSAGE;BAC PROFESSIONNEL;BAC PRO PROD;BAC PRO 25220 MAINT.MATERIELS OPT.B TP MANUT.;1;1;1;0;0;0;0;1;0;0;0;1;0;0
20712.0;2023;10;LYON;FEMININ;APPRENTISSAGE;BAC PROFESSIONNEL;BAC PRO SERV;BAC PRO 31212 METIERS DE L'ACCUEIL;11;11;11;0;0;0;0;11;0;1;1;5;4;0
20713.0;2023;10;LYON;FEMININ;APPRENTISSAGE;BAC PROFESSIONNEL;BAC PRO SERV;BAC PRO 31213 MET.COM.VEN.OP.A ANI.GES.ESP.COM.;111;107;90;9;8;5;3;95;0;6;31;31;27;12
20714.0;2023;10;LYON;FEMININ;APPRENTISSAGE;BAC PROFESSIONNEL;BAC PRO SERV;BAC PRO 31214 MET.COM.VEN.OP.B PR.CL.VA.OF.COM.;7;7;7;0;0;0;0;7;0;0;1;4;2;0
20722.0;2023;10;LYON;FEMININ;APPRENTISSAGE;BAC PROFESSIONNEL;BAC PRO SERV;BAC PRO 34304 HYGIENE PROPRETE STERILISATION;11;11;7;2;2;1;1;8;0;0;2;3;3;3
20726.0;2023;10;LYON;FEMININ;ENSEIGNEMENT A DISTANCE;BAC TECHNOLOGIQUE;BAC STMG;BAC STMG GESTION ET FINANCE;4;4;2;2;0;0;0;2;0;0;1;1;0;2
20728.0;2023;10;LYON;FEMININ;ENSEIGNEMENT A DISTANCE;BAC TECHNOLOGIQUE;BAC STMG;BAC STMG RESSOURCES HUMAINES ET COMMUNICATION;2;2;2;0;0;0;0;2;0;0;0;0;2;0
20730.0;2023;10;LYON;FEMININ;FORMATION CONTINUE;BAC PROFESSIONNEL;BAC PRO PROD;BAC PRO 24302 METIERS DU CUIR : MAROQUINERIE;6;5;5;0;0;0;0;5;0;0;3;2;0;0
20733.0;2023;10;LYON;FEMININ;FORMATION CONTINUE;BAC PROFESSIONNEL;BAC PRO SERV;BAC PRO 33104 TECHNICIEN EN PROTHESE DENTAIRE;2;2;1;1;0;0;0;1;0;0;1;0;0;1
20739.0;2023;10;LYON;FEMININ;INDIVIDUEL;BAC PROFESSIONNEL;BAC PRO PROD;BAC PRO AG 22105 LABORATOIRE CONTROLE QUALITE;1;1;0;1;0;0;0;0;0;0;0;0;0;1
20756.0;2023;10;LYON;FEMININ;INDIVIDUEL;BAC TECHNOLOGIQUE;BAC STMG;BAC STMG RESSOURCES HUMAINES ET COMMUNICATION;13;13;3;9;1;0;1;3;0;0;1;1;1;10
20757.0;2023;10;LYON;FEMININ;SCOLAIRE;BAC GENERAL;BAC GENERAL;BAC GENE 10019 BAC GENERAL;11004;11004;10134;185;685;481;204;10615;165;1431;2773;3315;2931;389
20761.0;2023;10;LYON;FEMININ;SCOLAIRE;BAC PROFESSIONNEL;BAC PRO PROD;BAC PRO 22004 PROC. CHIMIE EAU PAPIERS-CARTONS;4;4;2;1;1;1;0;3;0;0;0;2;1;1
20764.0;2023;10;LYON;FEMININ;SCOLAIRE;BAC PROFESSIONNEL;BAC PRO PROD;BAC PRO 22106 CUISINE;38;38;34;3;1;1;0;35;0;7;6;11;11;3
20767.0;2023;10;LYON;FEMININ;SCOLAIRE;BAC PROFESSIONNEL;BAC PRO PROD;BAC PRO 23003 ARTIS. & M.ART:MARCHANDISAGE VIS.;17;17;13;4;0;0;0;13;0;0;2;6;5;4
20769.0;2023;10;LYON;FEMININ;SCOLAIRE;BAC PROFESSIONNEL;BAC PRO PROD;BAC PRO 23005 TECHN. ETUDES BAT B ASSIST.ARCHI.;13;13;10;3;0;0;0;10;0;1;1;3;5;3
20775.0;2023;10;LYON;FEMININ;SCOLAIRE;BAC PROFESSIONNEL;BAC PRO PROD;BAC PRO 23408 Etude et réalisation d'agencement;27;27;23;4;0;0;0;23;0;1;3;12;7;4
20780.0;2023;10;LYON;FEMININ;SCOLAIRE;BAC PROFESSIONNEL;BAC PRO PROD;BAC PRO 25006 MICROTECHNIQUES;1;1;1;0;0;0;0;1;0;0;1;0;0;0
20785.0;2023;10;LYON;FEMININ;SCOLAIRE;BAC PROFESSIONNEL;BAC PRO PROD;BAC PRO 25408 REPARATION DES CARROSSERIES;2;2;2;0;0;0;0;2;0;0;1;0;1;0
20789.0;2023;10;LYON;FEMININ;SCOLAIRE;BAC PROFESSIONNEL;BAC PRO PROD;BAC PRO 25514 SYST.NUM.OPT.B AUD.RES.EQUIP.DOM.;1;1;1;0;0;0;0;1;0;0;0;0;1;0
20803.0;2023;10;LYON;FEMININ;SCOLAIRE;BAC PROFESSIONNEL;BAC PRO SERV;BAC PRO 31106 LOGISTIQUE;29;29;23;5;1;1;0;24;0;1;2;7;14;5
20805.0;2023;10;LYON;FEMININ;SCOLAIRE;BAC PROFESSIONNEL;BAC PRO SERV;BAC PRO 31114 ORGANIS. TRANSPORT MARCHANDISES;22;22;16;6;0;0;0;16;0;1;0;10;5;6
20809.0;2023;10;LYON;FEMININ;SCOLAIRE;BAC PROFESSIONNEL;BAC PRO SERV;BAC PRO 32207 REAL.PR.IMPR.PLURI.OPTA.PR.GRAPH.;12;12;10;2;0;0;0;10;0;0;3;3;4;2
20818.0;2023;10;LYON;FEMININ;SCOLAIRE;BAC PROFESSIONNEL;BAC PRO SERV;BAC PRO 33104 TECHNICIEN EN PROTHESE DENTAIRE;30;30;25;5;0;0;0;25;0;1;7;7;10;5
20823.0;2023;10;LYON;FEMININ;SCOLAIRE;BAC PROFESSIONNEL;BAC PRO SERV;BAC PRO 34304 HYGIENE PROPRETE STERILISATION;25;25;18;5;2;1;1;19;0;0;7;6;6;6
20824.0;2023;10;LYON;FEMININ;SCOLAIRE;BAC PROFESSIONNEL;BAC PRO SERV;BAC PRO 34403 METIERS DE LA SECURITE;32;32;30;1;1;1;0;31;0;2;9;9;11;1
20828.0;2023;10;LYON;FEMININ;SCOLAIRE;BAC TECHNOLOGIQUE;BAC ST2S;BAC ST2S SCIENCES & TECHNO. SANTE & SOCIAL;928;928;744;53;131;93;38;837;0;25;120;281;411;91
20833.0;2023;10;LYON;FEMININ;SCOLAIRE;BAC TECHNOLOGIQUE;BAC STI2D;BAC STI2D ENERGIES  ET ENVIRONNEMENT;17;17;15;0;2;2;0;17;0;0;2;3;12;0
20834.0;2023;10;LYON;FEMININ;SCOLAIRE;BAC TECHNOLOGIQUE;BAC STI2D;BAC STI2D INNOVATION TECHNO.  ET ECO CONCEPTION;35;35;29;0;6;3;3;32;0;2;9;11;10;3
20837.0;2023;10;LYON;FEMININ;SCOLAIRE;BAC TECHNOLOGIQUE;BAC STL;BAC STL SCIENCES PHYSIQUES CHIMIQUES  EN LABORAT.;76;76;63;4;9;3;6;66;0;5;19;16;26;10
20843.0;2023;10;LYON;MASCULIN;APPRENTISSAGE;BAC PROFESSIONNEL;BAC PRO PROD;BAC PRO 22003 BIO-INDUSTRIES DE TRANSFORMATION;7;7;3;4;0;0;0;3;0;0;0;2;1;4
20845.0;2023;10;LYON;MASCULIN;APPRENTISSAGE;BAC PROFESSIONNEL;BAC PRO PROD;BAC PRO 22105 BOULANGER-PÂTISSIER;9;9;9;0;0;0;0;9;0;0;0;5;4;0
20846.0;2023;10;LYON;MASCULIN;APPRENTISSAGE;BAC PROFESSIONNEL;BAC PRO PROD;BAC PRO 22106 CUISINE;17;17;12;4;1;1;0;13;0;0;0;4;9;4
20865.0;2023;10;LYON;MASCULIN;APPRENTISSAGE;BAC PROFESSIONNEL;BAC PRO PROD;BAC PRO 25106 TECHNICIEN D'USINAGE;37;37;31;3;3;0;3;31;0;2;7;9;13;6
20895.0;2023;10;LYON;MASCULIN;APPRENTISSAGE;BAC PROFESSIONNEL;BAC PRO SERV;BAC PRO 31213 MET.COM.VEN.OP.A ANI.GES.ESP.COM.;117;110;91;13;6;5;1;96;0;7;21;36;32;14
20899.0;2023;10;LYON;MASCULIN;APPRENTISSAGE;BAC PROFESSIONNEL;BAC PRO SERV;BAC PRO 32303 ART.& MET.ART:COM.VIS.VIS.PLURI-M;8;7;7;0;0;0;0;7;0;1;2;3;1;0
20900.0;2023;10;LYON;MASCULIN;APPRENTISSAGE;BAC PROFESSIONNEL;BAC PRO SERV;BAC PRO 33104 TECHNICIEN EN PROTHESE DENTAIRE;3;3;3;0;0;0;0;3;0;0;1;1;1;0
20901.0;2023;10;LYON;MASCULIN;APPRENTISSAGE;BAC PROFESSIONNEL;BAC PRO SERV;BAC PRO 33403 COMMERC. SERVICES EN RESTAURATION;7;7;4;1;2;2;0;6;0;0;1;1;4;1
20903.0;2023;10;LYON;MASCULIN;APPRENTISSAGE;BAC PROFESSIONNEL;BAC PRO SERV;BAC PRO 34304 HYGIENE PROPRETE STERILISATION;12;12;5;5;2;2;0;7;0;0;0;1;6;5
20911.0;2023;10;LYON;MASCULIN;FORMATION CONTINUE;BAC PROFESSIONNEL;BAC PRO PROD;BAC PRO 25510 METIERS ELECT. ENVIRON. CONNECTES;3;3;3;0;0;0;0;3;0;0;1;1;1;0
20912.0;2023;10;LYON;MASCULIN;FORMATION CONTINUE;BAC PROFESSIONNEL;BAC PRO PROD;BAC PRO AG 21405 AMENAGEMENTS PAYSAGERS;1;1;1;0;0;0;0;1;0;0;0;0;1;0
20914.0;2023;10;LYON;MASCULIN;FORMATION CONTINUE;BAC PROFESSIONNEL;BAC PRO SERV;BAC PRO 31213 MET.COM.VEN.OP.A ANI.GES.ESP.COM.;6;5;3;1;1;0;1;3;0;0;0;0;3;2
20921.0;2023;10;LYON;MASCULIN;INDIVIDUEL;BAC PROFESSIONNEL;BAC PRO PROD;BAC PRO 23408 Etude et réalisation d'agencement;1;1;0;1;0;0;0;0;0;0;0;0;0;1
20924.0;2023;10;LYON;MASCULIN;INDIVIDUEL;BAC PROFESSIONNEL;BAC PRO PROD;BAC PRO 25106 TECHNICIEN D'USINAGE;6;4;0;4;0;0;0;0;0;0;0;0;0;4
20930.0;2023;10;LYON;MASCULIN;INDIVIDUEL;BAC PROFESSIONNEL;BAC PRO PROD;BAC PRO 25510 METIERS ELECT. ENVIRON. CONNECTES;9;5;1;3;1;0;1;1;0;0;0;0;1;4
20931.0;2023;10;LYON;MASCULIN;INDIVIDUEL;BAC PROFESSIONNEL;BAC PRO PROD;BAC PRO 25515 SYST.NUM.OPT.C RES.INF.SYST.COMM.;1;0;0;0;0;0;0;0;0;0;0;0;0;0
20941.0;2023;10;LYON;MASCULIN;INDIVIDUEL;BAC PROFESSIONNEL;BAC PRO SERV;BAC PRO 31214 MET.COM.VEN.OP.B PR.CL.VA.OF.COM.;8;6;1;4;1;1;0;2;0;0;0;0;2;4
20942.0;2023;10;LYON;MASCULIN;INDIVIDUEL;BAC PROFESSIONNEL;BAC PRO SERV;BAC PRO 33403 COMMERC. SERVICES EN RESTAURATION;1;1;0;1;0;0;0;0;0;0;0;0;0;1
20949.0;2023;10;LYON;MASCULIN;INDIVIDUEL;BAC TECHNOLOGIQUE;BAC STI2D;BAC STI2D ARCHITECTURE ET CONSTRUCTION;2;2;0;2;0;0;0;0;0;0;0;0;0;2
20950.0;2023;10;LYON;MASCULIN;INDIVIDUEL;BAC TECHNOLOGIQUE;BAC STI2D;BAC STI2D ENERGIES  ET ENVIRONNEMENT;3;3;1;2;0;0;0;1;0;0;0;0;1;2
20952.0;2023;10;LYON;MASCULIN;INDIVIDUEL;BAC TECHNOLOGIQUE;BAC STMG;BAC STMG GESTION ET FINANCE;15;15;2;10;3;2;1;4;0;0;1;1;2;11
20953.0;2023;10;LYON;MASCULIN;INDIVIDUEL;BAC TECHNOLOGIQUE;BAC STMG;BAC STMG MERCATIQUE (MARKETING);35;35;10;17;8;7;1;17;0;0;0;2;15;18
20966.0;2023;10;LYON;MASCULIN;SCOLAIRE;BAC PROFESSIONNEL;BAC PRO PROD;BAC PRO 22703 TECHN.INSTALL.SYST.ENERG.CLIMATI;78;77;54;19;4;2;2;56;0;1;6;18;31;21
20972.0;2023;10;LYON;MASCULIN;SCOLAIRE;BAC PROFESSIONNEL;BAC PRO PROD;BACPRO 23103 TECHNICIEN GEOMETRE-TOPOGRAPHE;16;16;11;5;0;0;0;11;0;2;2;2;5;5
20989.0;2023;10;LYON;MASCULIN;SCOLAIRE;BAC PROFESSIONNEL;BAC PRO PROD;BAC PRO 25107 TECHNICIEN OUTILLEUR;27;27;17;8;2;2;0;19;0;1;4;7;7;8
20996.0;2023;10;LYON;MASCULIN;SCOLAIRE;BAC PROFESSIONNEL;BAC PRO PROD;BAC PRO 25406 OUVRAGES DU BATIMENT METALLERIE;34;33;31;1;1;1;0;32;0;2;12;9;9;1
20998.0;2023;10;LYON;MASCULIN;SCOLAIRE;BAC PROFESSIONNEL;BAC PRO PROD;BAC PRO 25410 CONSTRUCTION DES CARROSSERIES;4;4;4;0;0;0;0;4;0;0;0;1;3;0
21001.0;2023;10;LYON;MASCULIN;SCOLAIRE;BAC PROFESSIONNEL;BAC PRO PROD;BAC PRO 25510 METIERS ELECT. ENVIRON. CONNECTES;487;486;339;115;32;21;11;360;0;18;50;128;164;126
21007.0;2023;10;LYON;MASCULIN;SCOLAIRE;BAC PROFESSIONNEL;BAC PRO PROD;BAC PRO AG 21114 CONDUITE PRODUCTIONS HORTICOLES;18;18;14;4;0;0;0;14;0;0;0;5;9;4
21008.0;2023;10;LYON;MASCULIN;SCOLAIRE;BAC PROFESSIONNEL;BAC PRO PROD;BAC PRO AG 21203 TECHN CONSEIL DE VENTE ANIMAL;18;18;16;2;0;0;0;16;0;1;1;5;9;2
21011.0;2023;10;LYON;MASCULIN;SCOLAIRE;BAC PROFESSIONNEL;BAC PRO PROD;BAC PRO AG 21211 COND GEST ENTR HIPPIQUE;5;5;2;3;0;0;0;2;0;0;1;1;0;3
21012.0;2023;10;LYON;MASCULIN;SCOLAIRE;BAC PROFESSIONNEL;BAC PRO PROD;BAC PRO AG 21212 TECH EXPE ANIMALE;6;6;6;0;0;0;0;6;0;0;0;2;4;0
21017.0;2023;10;LYON;MASCULIN;SCOLAIRE;BAC PROFESSIONNEL;BAC PRO PROD;BAC PRO AG 22105 LABORATOIRE CONTROLE QUALITE;23;23;19;4;0;0;0;19;0;1;1;9;8;4
21019.0;2023;10;LYON;MASCULIN;SCOLAIRE;BAC PROFESSIONNEL;BAC PRO SERV;BAC PRO 30004 ASSISTANC.GEST.ORGANIS.ACTIVITES;233;233;175;46;12;7;5;182;0;2;24;65;91;51
21020.0;2023;10;LYON;MASCULIN;SCOLAIRE;BAC PROFESSIONNEL;BAC PRO SERV;BAC PRO 31106 LOGISTIQUE;91;91;58;29;4;2;2;60;0;2;9;22;27;31
21035.0;2023;10;LYON;MASCULIN;SCOLAIRE;BAC PROFESSIONNEL;BAC PRO SERV;BAC PRO 33403 COMMERC. SERVICES EN RESTAURATION;58;58;54;2;2;1;1;55;0;7;7;18;23;3
21038.0;2023;10;LYON;MASCULIN;SCOLAIRE;BAC PROFESSIONNEL;BAC PRO SERV;BAC PRO 34304 HYGIENE PROPRETE STERILISATION;4;4;3;1;0;0;0;3;0;0;0;2;1;1
21039.0;2023;10;LYON;MASCULIN;SCOLAIRE;BAC PROFESSIONNEL;BAC PRO SERV;BAC PRO 34403 METIERS DE LA SECURITE;71;71;68;2;1;1;0;69;0;7;20;32;10;2
21046.0;2023;10;LYON;MASCULIN;SCOLAIRE;BAC TECHNOLOGIQUE;BAC STI2D;BAC STI2D ARCHITECTURE ET CONSTRUCTION;344;344;304;11;29;16;13;320;1;12;57;124;126;24
21048.0;2023;10;LYON;MASCULIN;SCOLAIRE;BAC TECHNOLOGIQUE;BAC STI2D;BAC STI2D INNOVATION TECHNO.  ET ECO CONCEPTION;550;550;466;17;67;46;21;512;0;12;93;178;229;38
21049.0;2023;10;LYON;MASCULIN;SCOLAIRE;BAC TECHNOLOGIQUE;BAC STI2D;BAC STI2D SYSTÈME D'INFORMATION  ET NUMERIQUE;558;558;472;26;60;23;37;495;3;22;97;184;189;63
21050.0;2023;10;LYON;MASCULIN;SCOLAIRE;BAC TECHNOLOGIQUE;BAC STL;BAC STL BIOCHIM.-BIOLOGIE-BIOTECHNOL.;74;74;57;5;12;6;6;63;1;3;8;21;30;11
21053.0;2023;10;LYON;MASCULIN;SCOLAIRE;BAC TECHNOLOGIQUE;BAC STMG;BAC STMG MERCATIQUE (MARKETING);975;975;654;109;212;152;60;806;0;5;44;196;561;169
21057.0;2023;31;MARTINIQUE;FEMININ;APPRENTISSAGE;BAC PROFESSIONNEL;BAC PRO PROD;BAC PRO 25214 MAINT.VEHIC.OPTA VOIT.PARTICUL.;1;1;1;0;0;0;0;1;0;1;0;0;0;0
21058.0;2023;31;MARTINIQUE;FEMININ;APPRENTISSAGE;BAC PROFESSIONNEL;BAC PRO PROD;BAC PRO 25408 REPARATION DES CARROSSERIES;1;1;1;0;0;0;0;1;0;0;1;0;0;0
21060.0;2023;31;MARTINIQUE;FEMININ;APPRENTISSAGE;BAC PROFESSIONNEL;BAC PRO SERV;BAC PRO 31212 METIERS DE L'ACCUEIL;2;2;1;1;0;0;0;1;0;1;0;0;0;1
21065.0;2023;31;MARTINIQUE;FEMININ;FORMATION CONTINUE;BAC PROFESSIONNEL;BAC PRO SERV;BAC PRO 33004 ACC.SOINS-S.PERS. OPT.EN STRUCTUR;1;1;0;1;0;0;0;0;0;0;0;0;0;1
21073.0;2023;31;MARTINIQUE;FEMININ;INDIVIDUEL;BAC PROFESSIONNEL;BAC PRO SERV;BAC PRO 34304 HYGIENE PROPRETE STERILISATION;1;1;0;1;0;0;0;0;0;0;0;0;0;1
21095.0;2023;31;MARTINIQUE;FEMININ;SCOLAIRE;BAC PROFESSIONNEL;BAC PRO PROD;BAC PRO AG 22108 TEC CONS VTE ALIMENTATION (PAB);2;2;1;1;0;0;0;1;0;0;0;0;1;1
21102.0;2023;31;MARTINIQUE;FEMININ;SCOLAIRE;BAC PROFESSIONNEL;BAC PRO SERV;BAC PRO 32303 ART.& MET.ART:COM.VIS.VIS.PLURI-M;5;5;4;0;1;1;0;5;0;0;2;1;2;0
21110.0;2023;31;MARTINIQUE;FEMININ;SCOLAIRE;BAC PROFESSIONNEL;BAC PRO SERV;BAC PRO 34303 GEST. POLLUTIONS PROTEC. ENVIRON.;3;3;2;1;0;0;0;2;0;0;0;0;2;1
21112.0;2023;31;MARTINIQUE;FEMININ;SCOLAIRE;BAC PROFESSIONNEL;BAC PRO SERV;BAC PRO 34403 METIERS DE LA SECURITE;6;6;5;1;0;0;0;5;0;0;0;1;4;1
21117.0;2023;31;MARTINIQUE;FEMININ;SCOLAIRE;BAC TECHNOLOGIQUE;BAC STHR;BAC STHR SC.&TEC. HOTELLERIE-RESTAURATION;8;8;8;0;0;0;0;8;0;0;2;4;2;0
21127.0;2023;31;MARTINIQUE;MASCULIN;APPRENTISSAGE;BAC PROFESSIONNEL;BAC PRO PROD;BAC PRO 22106 CUISINE;3;3;3;0;0;0;0;3;0;0;0;1;2;0
21133.0;2023;31;MARTINIQUE;MASCULIN;APPRENTISSAGE;BAC PROFESSIONNEL;BAC PRO PROD;BAC PRO 25214 MAINT.VEHIC.OPTA VOIT.PARTICUL.;9;7;4;3;0;0;0;4;0;0;1;2;1;3
21137.0;2023;31;MARTINIQUE;MASCULIN;APPRENTISSAGE;BAC PROFESSIONNEL;BAC PRO SERV;BAC PRO 31212 METIERS DE L'ACCUEIL;1;1;1;0;0;0;0;1;0;0;0;1;0;0
21139.0;2023;31;MARTINIQUE;MASCULIN;APPRENTISSAGE;BAC PROFESSIONNEL;BAC PRO SERV;BAC PRO 33403 COMMERC. SERVICES EN RESTAURATION;1;1;1;0;0;0;0;1;0;0;1;0;0;0
21160.0;2023;31;MARTINIQUE;MASCULIN;SCOLAIRE;BAC PROFESSIONNEL;BAC PRO PROD;BAC PRO 23005 TECHN. ETUDES BAT B ASSIST.ARCHI.;8;8;5;3;0;0;0;5;0;0;0;1;4;3
21162.0;2023;31;MARTINIQUE;MASCULIN;SCOLAIRE;BAC PROFESSIONNEL;BAC PRO PROD;BACPRO 23103 TECHNICIEN GEOMETRE-TOPOGRAPHE;5;5;2;3;0;0;0;2;0;0;1;0;1;3
21164.0;2023;31;MARTINIQUE;MASCULIN;SCOLAIRE;BAC PROFESSIONNEL;BAC PRO PROD;BAC PRO 23303 MENUISERIE ALUMINIUM-VERRE;10;10;6;0;4;3;1;9;0;0;1;4;4;1
21170.0;2023;31;MARTINIQUE;MASCULIN;SCOLAIRE;BAC PROFESSIONNEL;BAC PRO PROD;BAC PRO 25007 MAINTENANCE EQUIPEMENTS INDUST.;15;15;6;8;1;1;0;7;0;1;0;1;5;8
21177.0;2023;31;MARTINIQUE;MASCULIN;SCOLAIRE;BAC PROFESSIONNEL;BAC PRO PROD;BAC PRO 25408 REPARATION DES CARROSSERIES;12;12;10;2;0;0;0;10;0;1;0;7;2;2
21178.0;2023;31;MARTINIQUE;MASCULIN;SCOLAIRE;BAC PROFESSIONNEL;BAC PRO PROD;BAC PRO 25411 TECH.CHAUDRONNERIE INDUSTRIELLE;6;6;6;0;0;0;0;6;0;0;0;1;5;0
21180.0;2023;31;MARTINIQUE;MASCULIN;SCOLAIRE;BAC PROFESSIONNEL;BAC PRO PROD;BAC PRO 25510 METIERS ELECT. ENVIRON. CONNECTES;135;135;97;28;10;9;1;106;0;0;9;36;61;29
21184.0;2023;31;MARTINIQUE;MASCULIN;SCOLAIRE;BAC PROFESSIONNEL;BAC PRO PROD;BAC PRO AG 21001 AGRO-EQUIPEMENT;5;5;4;1;0;0;0;4;0;0;0;0;4;1
21186.0;2023;31;MARTINIQUE;MASCULIN;SCOLAIRE;BAC PROFESSIONNEL;BAC PRO PROD;BAC PRO AG 21114 CONDUITE PRODUCTIONS HORTICOLES;7;7;6;1;0;0;0;6;0;0;1;2;3;1
21187.0;2023;31;MARTINIQUE;MASCULIN;SCOLAIRE;BAC PROFESSIONNEL;BAC PRO PROD;BAC PRO AG 21405 AMENAGEMENTS PAYSAGERS;7;7;7;0;0;0;0;7;0;0;1;4;2;0
21197.0;2023;31;MARTINIQUE;MASCULIN;SCOLAIRE;BAC PROFESSIONNEL;BAC PRO SERV;BAC PRO 33004 ACC.SOINS-S.PERS. OPT.EN STRUCTUR;6;6;5;0;1;1;0;6;0;0;0;2;4;0
21208.0;2023;31;MARTINIQUE;MASCULIN;SCOLAIRE;BAC TECHNOLOGIQUE;BAC STHR;BAC STHR SC.&TEC. HOTELLERIE-RESTAURATION;10;10;8;0;2;2;0;10;0;0;1;4;5;0
21209.0;2023;31;MARTINIQUE;MASCULIN;SCOLAIRE;BAC TECHNOLOGIQUE;BAC STI2D;BAC STI2D ARCHITECTURE ET CONSTRUCTION;27;27;20;2;5;5;0;25;0;1;1;8;15;2
21218.0;2023;43;MAYOTTE;FEMININ;APPRENTISSAGE;BAC PROFESSIONNEL;BAC PRO PROD;BAC PRO 23203 TECHNICIEN BAT. : ORG.REAL.GROS O;2;2;2;0;0;0;0;2;0;0;1;1;0;0
21222.0;2023;43;MAYOTTE;FEMININ;APPRENTISSAGE;BAC PROFESSIONNEL;BAC PRO SERV;BAC PRO 34403 METIERS DE LA SECURITE;2;2;2;0;0;0;0;2;0;0;0;2;0;0
21228.0;2023;43;MAYOTTE;FEMININ;INDIVIDUEL;BAC PROFESSIONNEL;BAC PRO SERV;BAC PRO 31106 LOGISTIQUE;2;2;1;1;0;0;0;1;0;0;0;0;1;1
21232.0;2023;43;MAYOTTE;FEMININ;INDIVIDUEL;BAC PROFESSIONNEL;BAC PRO SERV;BAC PRO 33002 SERVICES DE PROXIMITE  VIE LOCAL;22;20;1;16;3;1;2;2;0;0;0;0;2;18
21239.0;2023;43;MAYOTTE;FEMININ;INDIVIDUEL;BAC TECHNOLOGIQUE;BAC STMG;BAC STMG GESTION ET FINANCE;8;8;1;5;2;2;0;3;0;0;0;0;3;5
21243.0;2023;43;MAYOTTE;FEMININ;SCOLAIRE;BAC PROFESSIONNEL;BAC PRO PROD;BAC PRO 22106 CUISINE;14;14;9;4;1;1;0;10;0;0;3;1;6;4
21249.0;2023;43;MAYOTTE;FEMININ;SCOLAIRE;BAC PROFESSIONNEL;BAC PRO PROD;BAC PRO 23404 TECHNICIEN CONSTRUCTEUR BOIS;1;1;0;1;0;0;0;0;0;0;0;0;0;1
21250.0;2023;43;MAYOTTE;FEMININ;SCOLAIRE;BAC PROFESSIONNEL;BAC PRO PROD;BAC PRO 23408 Etude et réalisation d'agencement;1;1;1;0;0;0;0;1;0;0;0;0;1;0
21258.0;2023;43;MAYOTTE;FEMININ;SCOLAIRE;BAC PROFESSIONNEL;BAC PRO PROD;BAC PRO 25515 SYST.NUM.OPT.C RES.INF.SYST.COMM.;5;5;3;2;0;0;0;3;0;0;0;0;3;2
21259.0;2023;43;MAYOTTE;FEMININ;SCOLAIRE;BAC PROFESSIONNEL;BAC PRO PROD;BAC PRO AG 21004 CGEA;3;3;2;1;0;0;0;2;0;0;0;1;1;1
21263.0;2023;43;MAYOTTE;FEMININ;SCOLAIRE;BAC PROFESSIONNEL;BAC PRO SERV;BAC PRO 31114 ORGANIS. TRANSPORT MARCHANDISES;30;30;16;8;6;5;1;21;0;0;0;4;17;9
21266.0;2023;43;MAYOTTE;FEMININ;SCOLAIRE;BAC PROFESSIONNEL;BAC PRO SERV;BAC PRO 31214 MET.COM.VEN.OP.B PR.CL.VA.OF.COM.;54;52;28;12;12;10;2;38;0;0;3;5;30;14
21270.0;2023;43;MAYOTTE;FEMININ;SCOLAIRE;BAC PROFESSIONNEL;BAC PRO SERV;BAC PRO 33006 ANIMAT. ENFANCE& PERSONNES AGEES;109;109;91;8;10;7;3;98;0;2;14;45;37;11
21278.0;2023;43;MAYOTTE;FEMININ;SCOLAIRE;BAC TECHNOLOGIQUE;BAC STI2D;BAC STI2D ARCHITECTURE ET CONSTRUCTION;20;20;4;6;10;10;0;14;0;0;1;1;12;6
21294.0;2023;43;MAYOTTE;MASCULIN;INDIVIDUEL;BAC PROFESSIONNEL;BAC PRO PROD;BAC PRO 23404 TECHNICIEN CONSTRUCTEUR BOIS;4;3;0;3;0;0;0;0;0;0;0;0;0;3
21298.0;2023;43;MAYOTTE;MASCULIN;INDIVIDUEL;BAC PROFESSIONNEL;BAC PRO PROD;BAC PRO 25509 TECHNIC. FROID CONDITIONNEMT AIR;1;0;0;0;0;0;0;0;0;0;0;0;0;0
21299.0;2023;43;MAYOTTE;MASCULIN;INDIVIDUEL;BAC PROFESSIONNEL;BAC PRO PROD;BAC PRO 25510 METIERS ELECT. ENVIRON. CONNECTES;1;1;0;1;0;0;0;0;0;0;0;0;0;1
21303.0;2023;43;MAYOTTE;MASCULIN;INDIVIDUEL;BAC PROFESSIONNEL;BAC PRO SERV;BAC PRO 31213 MET.COM.VEN.OP.A ANI.GES.ESP.COM.;4;4;0;3;1;0;1;0;0;0;0;0;0;4
21305.0;2023;43;MAYOTTE;MASCULIN;INDIVIDUEL;BAC PROFESSIONNEL;BAC PRO SERV;BAC PRO 32303 ART.& MET.ART:COM.VIS.VIS.PLURI-M;1;1;0;1;0;0;0;0;0;0;0;0;0;1
21311.0;2023;43;MAYOTTE;MASCULIN;INDIVIDUEL;BAC TECHNOLOGIQUE;BAC STI2D;BAC STI2D ENERGIES  ET ENVIRONNEMENT;1;1;0;1;0;0;0;0;0;0;0;0;0;1
21313.0;2023;43;MAYOTTE;MASCULIN;INDIVIDUEL;BAC TECHNOLOGIQUE;BAC STMG;BAC STMG GESTION ET FINANCE;5;5;0;3;2;2;0;2;0;0;0;0;2;3
21315.0;2023;43;MAYOTTE;MASCULIN;INDIVIDUEL;BAC TECHNOLOGIQUE;BAC STMG;BAC STMG RESSOURCES HUMAINES ET COMMUNICATION;3;3;0;3;0;0;0;0;0;0;0;0;0;3
21317.0;2023;43;MAYOTTE;MASCULIN;SCOLAIRE;BAC PROFESSIONNEL;BAC PRO PROD;BAC PRO 22106 CUISINE;10;10;6;1;3;3;0;9;0;0;1;0;8;1
21321.0;2023;43;MAYOTTE;MASCULIN;SCOLAIRE;BAC PROFESSIONNEL;BAC PRO PROD;BACPRO 23103 TECHNICIEN GEOMETRE-TOPOGRAPHE;16;16;2;12;2;2;0;4;0;0;0;0;4;12
21323.0;2023;43;MAYOTTE;MASCULIN;SCOLAIRE;BAC PROFESSIONNEL;BAC PRO PROD;BAC PRO 23304 AMENAGEMENT FINITION BATIMENT;14;14;6;1;7;6;1;12;0;0;0;1;11;2
21327.0;2023;43;MAYOTTE;MASCULIN;SCOLAIRE;BAC PROFESSIONNEL;BAC PRO PROD;BAC PRO 25007 MAINTENANCE EQUIPEMENTS INDUST.;31;31;13;12;6;6;0;19;0;0;0;5;14;12
21330.0;2023;43;MAYOTTE;MASCULIN;SCOLAIRE;BAC PROFESSIONNEL;BAC PRO PROD;BAC PRO 25216 MAINT.VEHIC.OPTC MOTOCYCLES;16;16;5;10;1;1;0;6;0;0;0;2;4;10
21332.0;2023;43;MAYOTTE;MASCULIN;SCOLAIRE;BAC PROFESSIONNEL;BAC PRO PROD;BAC PRO 25303 AERONAUTIQUE OPTION SYSTEMES;10;10;8;1;1;1;0;9;0;0;1;3;5;1
21336.0;2023;43;MAYOTTE;MASCULIN;SCOLAIRE;BAC PROFESSIONNEL;BAC PRO PROD;BAC PRO 25514 SYST.NUM.OPT.B AUD.RES.EQUIP.DOM.;17;17;8;3;6;5;1;13;0;0;1;3;9;4
21341.0;2023;43;MAYOTTE;MASCULIN;SCOLAIRE;BAC PROFESSIONNEL;BAC PRO SERV;BAC PRO 31106 LOGISTIQUE;54;54;29;14;11;5;6;34;0;1;2;8;23;20
21342.0;2023;43;MAYOTTE;MASCULIN;SCOLAIRE;BAC PROFESSIONNEL;BAC PRO SERV;BAC PRO 31114 ORGANIS. TRANSPORT MARCHANDISES;85;85;42;30;13;8;5;50;0;0;5;10;35;35
21347.0;2023;43;MAYOTTE;MASCULIN;SCOLAIRE;BAC PROFESSIONNEL;BAC PRO SERV;BAC PRO 33003 ACC.SOINS-S.PERS. OPT.A DOMICILE;6;6;4;0;2;2;0;6;0;0;0;2;4;0
21348.0;2023;43;MAYOTTE;MASCULIN;SCOLAIRE;BAC PROFESSIONNEL;BAC PRO SERV;BAC PRO 33004 ACC.SOINS-S.PERS. OPT.EN STRUCTUR;1;1;1;0;0;0;0;1;0;0;0;0;1;0
21359.0;2023;43;MAYOTTE;MASCULIN;SCOLAIRE;BAC TECHNOLOGIQUE;BAC STI2D;BAC STI2D INNOVATION TECHNO.  ET ECO CONCEPTION;32;32;7;14;11;10;1;17;0;0;1;1;15;15
21361.0;2023;43;MAYOTTE;MASCULIN;SCOLAIRE;BAC TECHNOLOGIQUE;BAC STL;BAC STL SCIENCES PHYSIQUES CHIMIQUES  EN LABORAT.;61;61;25;14;22;16;6;41;0;1;6;7;27;20
21367.0;2023;11;MONTPELLIER;FEMININ;APPRENTISSAGE;BAC PROFESSIONNEL;BAC PRO PROD;BAC PRO 25214 MAINT.VEHIC.OPTA VOIT.PARTICUL.;5;5;5;0;0;0;0;5;0;4;0;0;1;0
21368.0;2023;11;MONTPELLIER;FEMININ;APPRENTISSAGE;BAC PROFESSIONNEL;BAC PRO PROD;BAC PRO 25215 MAINT.VEHIC.OPTB VEHIC.TRANS.ROUT;1;1;1;0;0;0;0;1;0;0;0;0;1;0
21376.0;2023;11;MONTPELLIER;FEMININ;APPRENTISSAGE;BAC PROFESSIONNEL;BAC PRO PROD;BAC PRO AG 21405 AMENAGEMENTS PAYSAGERS;5;5;4;1;0;0;0;4;0;0;3;1;0;1
21385.0;2023;11;MONTPELLIER;FEMININ;APPRENTISSAGE;BAC PROFESSIONNEL;BAC PRO SERV;BAC PRO 33403 COMMERC. SERVICES EN RESTAURATION;2;2;2;0;0;0;0;2;0;0;0;1;1;0
21386.0;2023;11;MONTPELLIER;FEMININ;APPRENTISSAGE;BAC PROFESSIONNEL;BAC PRO SERV;BAC PRO 33603 ESTHETIQUE COSMETIQUE PARFUMERIE;5;5;2;3;0;0;0;2;0;0;0;2;0;3
21395.0;2023;11;MONTPELLIER;FEMININ;ENSEIGNEMENT A DISTANCE;BAC PROFESSIONNEL;BAC PRO SERV;BAC PRO 33004 ACC.SOINS-S.PERS. OPT.EN STRUCTUR;3;3;2;1;0;0;0;2;0;0;0;0;2;1
21397.0;2023;11;MONTPELLIER;FEMININ;ENSEIGNEMENT A DISTANCE;BAC TECHNOLOGIQUE;BAC ST2S;BAC ST2S SCIENCES & TECHNO. SANTE & SOCIAL;7;7;7;0;0;0;0;7;0;0;0;4;3;0
21402.0;2023;11;MONTPELLIER;FEMININ;FORMATION CONTINUE;BAC PROFESSIONNEL;BAC PRO SERV;BAC PRO 31213 MET.COM.VEN.OP.A ANI.GES.ESP.COM.;4;4;3;1;0;0;0;3;0;0;2;1;0;1
21403.0;2023;11;MONTPELLIER;FEMININ;FORMATION CONTINUE;BAC PROFESSIONNEL;BAC PRO SERV;BAC PRO 33603 ESTHETIQUE COSMETIQUE PARFUMERIE;1;1;1;0;0;0;0;1;0;0;0;0;1;0
21408.0;2023;11;MONTPELLIER;FEMININ;INDIVIDUEL;BAC PROFESSIONNEL;BAC PRO PROD;BAC PRO AG 21004 CGEA;2;2;1;1;0;0;0;1;0;0;0;0;1;1
21410.0;2023;11;MONTPELLIER;FEMININ;INDIVIDUEL;BAC PROFESSIONNEL;BAC PRO PROD;BAC PRO AG 21211 COND GEST ENTR HIPPIQUE;8;6;3;3;0;0;0;3;0;0;0;0;3;3
21414.0;2023;11;MONTPELLIER;FEMININ;INDIVIDUEL;BAC PROFESSIONNEL;BAC PRO SERV;BAC PRO 31213 MET.COM.VEN.OP.A ANI.GES.ESP.COM.;5;1;1;0;0;0;0;1;0;0;0;0;1;0
21417.0;2023;11;MONTPELLIER;FEMININ;INDIVIDUEL;BAC PROFESSIONNEL;BAC PRO SERV;BAC PRO 33003 ACC.SOINS-S.PERS. OPT.A DOMICILE;3;2;1;1;0;0;0;1;0;0;0;0;1;1
21422.0;2023;11;MONTPELLIER;FEMININ;INDIVIDUEL;BAC TECHNOLOGIQUE;BAC STAV;BAC STAV AGRONOMIE ALIM ENV TERRITOI;1;1;1;0;0;0;0;1;0;0;0;0;1;0
21423.0;2023;11;MONTPELLIER;FEMININ;INDIVIDUEL;BAC TECHNOLOGIQUE;BAC STL;BAC STL SCIENCES PHYSIQUES CHIMIQUES  EN LABORAT.;1;1;0;0;1;0;1;0;0;0;0;0;0;1
21425.0;2023;11;MONTPELLIER;FEMININ;INDIVIDUEL;BAC TECHNOLOGIQUE;BAC STMG;BAC STMG RESSOURCES HUMAINES ET COMMUNICATION;8;8;5;2;1;1;0;6;0;1;1;2;2;2
21445.0;2023;11;MONTPELLIER;FEMININ;SCOLAIRE;BAC PROFESSIONNEL;BAC PRO PROD;BAC PRO 24203 METIERS DE LA MODE - VÊTEMENT;110;110;85;23;2;0;2;85;0;9;22;34;20;25
21463.0;2023;11;MONTPELLIER;FEMININ;SCOLAIRE;BAC PROFESSIONNEL;BAC PRO PROD;BAC PRO AG 21211 COND GEST ENTR HIPPIQUE;47;47;43;4;0;0;0;43;0;0;7;15;21;4
21464.0;2023;11;MONTPELLIER;FEMININ;SCOLAIRE;BAC PROFESSIONNEL;BAC PRO PROD;BAC PRO AG 21302 GEST MILIEUX NATURELS FAUNE;2;2;2;0;0;0;0;2;0;0;0;1;1;0
21477.0;2023;11;MONTPELLIER;FEMININ;SCOLAIRE;BAC PROFESSIONNEL;BAC PRO SERV;BAC PRO 32207 REAL.PR.IMPR.PLURI.OPTA.PR.GRAPH.;4;4;4;0;0;0;0;4;0;0;1;3;0;0
21481.0;2023;11;MONTPELLIER;FEMININ;SCOLAIRE;BAC PROFESSIONNEL;BAC PRO SERV;BAC PRO 33003 ACC.SOINS-S.PERS. OPT.A DOMICILE;79;79;65;11;3;2;1;67;0;5;13;29;20;12
21484.0;2023;11;MONTPELLIER;FEMININ;SCOLAIRE;BAC PROFESSIONNEL;BAC PRO SERV;BAC PRO 33101 OPTIQUE LUNETTERIE;7;7;7;0;0;0;0;7;0;0;5;2;0;0
21485.0;2023;11;MONTPELLIER;FEMININ;SCOLAIRE;BAC PROFESSIONNEL;BAC PRO SERV;BAC PRO 33104 TECHNICIEN EN PROTHESE DENTAIRE;16;16;15;0;1;1;0;16;0;0;5;10;1;0
21489.0;2023;11;MONTPELLIER;FEMININ;SCOLAIRE;BAC PROFESSIONNEL;BAC PRO SERV;BAC PRO 34304 HYGIENE PROPRETE STERILISATION;3;3;3;0;0;0;0;3;0;0;0;1;2;0
21491.0;2023;11;MONTPELLIER;FEMININ;SCOLAIRE;BAC PROFESSIONNEL;BAC PRO SERV;BAC PRO AG 33002 SERV PERS TERRIT;297;291;257;34;0;0;0;257;0;8;34;75;140;34
21499.0;2023;11;MONTPELLIER;FEMININ;SCOLAIRE;BAC TECHNOLOGIQUE;BAC STI2D;BAC STI2D ENERGIES  ET ENVIRONNEMENT;13;13;12;0;1;1;0;13;0;1;2;5;5;0
21513.0;2023;11;MONTPELLIER;MASCULIN;APPRENTISSAGE;BAC PROFESSIONNEL;BAC PRO PROD;BAC PRO 22704 TECHN. MAINT. SYST.ENERG.CLIMATI;4;4;3;0;1;0;1;3;0;0;0;2;1;1
21540.0;2023;11;MONTPELLIER;MASCULIN;APPRENTISSAGE;BAC PROFESSIONNEL;BAC PRO PROD;BAC PRO AG 21405 AMENAGEMENTS PAYSAGERS;41;40;36;4;0;0;0;36;0;0;5;7;24;4
21544.0;2023;11;MONTPELLIER;MASCULIN;APPRENTISSAGE;BAC PROFESSIONNEL;BAC PRO SERV;BAC PRO 31214 MET.COM.VEN.OP.B PR.CL.VA.OF.COM.;4;4;3;1;0;0;0;3;0;0;0;1;2;1
21550.0;2023;11;MONTPELLIER;MASCULIN;ENSEIGNEMENT A DISTANCE;BAC PROFESSIONNEL;BAC PRO PROD;BAC PRO 25009 MAINTENANCE NAUTIQUE;1;1;1;0;0;0;0;1;0;0;0;0;1;0
21562.0;2023;11;MONTPELLIER;MASCULIN;INDIVIDUEL;BAC PROFESSIONNEL;BAC PRO PROD;BAC PRO 22106 CUISINE;1;1;1;0;0;0;0;1;0;0;0;0;1;0
21568.0;2023;11;MONTPELLIER;MASCULIN;INDIVIDUEL;BAC PROFESSIONNEL;BAC PRO PROD;BAC PRO 25009 MAINTENANCE NAUTIQUE;1;1;0;1;0;0;0;0;0;0;0;0;0;1
21573.0;2023;11;MONTPELLIER;MASCULIN;INDIVIDUEL;BAC PROFESSIONNEL;BAC PRO PROD;BAC PRO AG 21114 CONDUITE PRODUCTIONS HORTICOLES;1;1;1;0;0;0;0;1;0;0;0;0;1;0
21576.0;2023;11;MONTPELLIER;MASCULIN;INDIVIDUEL;BAC PROFESSIONNEL;BAC PRO PROD;BAC PRO AG 21405 AMENAGEMENTS PAYSAGERS;1;1;1;0;0;0;0;1;0;0;0;0;1;0
21578.0;2023;11;MONTPELLIER;MASCULIN;INDIVIDUEL;BAC PROFESSIONNEL;BAC PRO SERV;BAC PRO 31212 METIERS DE L'ACCUEIL;1;1;0;1;0;0;0;0;0;0;0;0;0;1
21586.0;2023;11;MONTPELLIER;MASCULIN;INDIVIDUEL;BAC TECHNOLOGIQUE;BAC STI2D;BAC STI2D ENERGIES  ET ENVIRONNEMENT;1;1;0;1;0;0;0;0;0;0;0;0;0;1
21588.0;2023;11;MONTPELLIER;MASCULIN;INDIVIDUEL;BAC TECHNOLOGIQUE;BAC STI2D;BAC STI2D SYSTÈME D'INFORMATION  ET NUMERIQUE;3;3;0;2;1;1;0;1;0;0;0;0;1;2
21590.0;2023;11;MONTPELLIER;MASCULIN;INDIVIDUEL;BAC TECHNOLOGIQUE;BAC STMG;BAC STMG GESTION ET FINANCE;16;16;12;3;1;1;0;13;0;2;5;3;3;3
21598.0;2023;11;MONTPELLIER;MASCULIN;SCOLAIRE;BAC PROFESSIONNEL;BAC PRO PROD;BAC PRO 22004 PROC. CHIMIE EAU PAPIERS-CARTONS;31;30;25;4;1;1;0;26;0;1;3;16;6;4
21599.0;2023;11;MONTPELLIER;MASCULIN;SCOLAIRE;BAC PROFESSIONNEL;BAC PRO PROD;BAC PRO 22105 BOULANGER-PÂTISSIER;17;17;16;1;0;0;0;16;0;1;5;6;4;1
21601.0;2023;11;MONTPELLIER;MASCULIN;SCOLAIRE;BAC PROFESSIONNEL;BAC PRO PROD;BAC PRO 22403 ARTS.& MET.ART:MET.ENSEIGN SIGNA;9;9;7;1;1;1;0;8;0;0;2;1;5;1
21602.0;2023;11;MONTPELLIER;MASCULIN;SCOLAIRE;BAC PROFESSIONNEL;BAC PRO PROD;BAC PRO 22503 PLASTIQUES ET COMPOSITES;15;15;13;2;0;0;0;13;0;0;1;5;7;2
21605.0;2023;11;MONTPELLIER;MASCULIN;SCOLAIRE;BAC PROFESSIONNEL;BAC PRO PROD;BAC PRO 23003 ARTIS. & M.ART:MARCHANDISAGE VIS.;3;3;2;0;1;1;0;3;0;0;0;2;1;0
21610.0;2023;11;MONTPELLIER;MASCULIN;SCOLAIRE;BAC PROFESSIONNEL;BAC PRO PROD;BAC PRO 23203 TECHNICIEN BAT. : ORG.REAL.GROS O;13;13;9;1;3;2;1;11;0;0;0;2;9;2
21612.0;2023;11;MONTPELLIER;MASCULIN;SCOLAIRE;BAC PROFESSIONNEL;BAC PRO PROD;BAC PRO 23208 METIERS ET ARTS DE LA PIERRE;3;3;3;0;0;0;0;3;0;0;0;1;2;0
21619.0;2023;11;MONTPELLIER;MASCULIN;SCOLAIRE;BAC PROFESSIONNEL;BAC PRO PROD;BAC PRO 24302 METIERS DU CUIR : MAROQUINERIE;1;1;1;0;0;0;0;1;0;0;0;1;0;0
21625.0;2023;11;MONTPELLIER;MASCULIN;SCOLAIRE;BAC PROFESSIONNEL;BAC PRO PROD;BAC PRO 25214 MAINT.VEHIC.OPTA VOIT.PARTICUL.;224;222;163;45;14;13;1;176;0;9;32;53;82;46
21646.0;2023;11;MONTPELLIER;MASCULIN;SCOLAIRE;BAC PROFESSIONNEL;BAC PRO PROD;BAC PRO AG 21210 COND GEST ENTR CANIN ET FELIN;16;16;14;2;0;0;0;14;0;0;0;6;8;2
21665.0;2023;11;MONTPELLIER;MASCULIN;SCOLAIRE;BAC PROFESSIONNEL;BAC PRO SERV;BAC PRO 33003 ACC.SOINS-S.PERS. OPT.A DOMICILE;5;4;4;0;0;0;0;4;0;0;1;0;3;0
21668.0;2023;11;MONTPELLIER;MASCULIN;SCOLAIRE;BAC PROFESSIONNEL;BAC PRO SERV;BAC PRO 33101 OPTIQUE LUNETTERIE;1;1;1;0;0;0;0;1;0;0;1;0;0;0
21669.0;2023;11;MONTPELLIER;MASCULIN;SCOLAIRE;BAC PROFESSIONNEL;BAC PRO SERV;BAC PRO 33104 TECHNICIEN EN PROTHESE DENTAIRE;8;8;5;2;1;1;0;6;0;0;1;2;3;2
21677.0;2023;11;MONTPELLIER;MASCULIN;SCOLAIRE;BAC TECHNOLOGIQUE;BAC STAV;BAC STAV AGRONOMIE ALIM ENV TERRITOI;122;122;117;5;0;0;0;117;0;0;11;49;57;5
21686.0;2023;11;MONTPELLIER;MASCULIN;SCOLAIRE;BAC TECHNOLOGIQUE;BAC STMG;BAC STMG GESTION ET FINANCE;405;405;332;22;51;39;12;371;0;4;32;130;205;34
21687.0;2023;11;MONTPELLIER;MASCULIN;SCOLAIRE;BAC TECHNOLOGIQUE;BAC STMG;BAC STMG MERCATIQUE (MARKETING);761;761;587;54;120;92;28;679;0;6;58;215;400;82
21692.0;2023;12;NANCY-METZ;FEMININ;APPRENTISSAGE;BAC PROFESSIONNEL;BAC PRO PROD;BAC PRO 22403 ARTS.& MET.ART:MET.ENSEIGN SIGNA;1;1;1;0;0;0;0;1;0;0;0;0;1;0
21694.0;2023;12;NANCY-METZ;FEMININ;APPRENTISSAGE;BAC PROFESSIONNEL;BAC PRO PROD;BAC PRO 23405 TECHNICIEN MENUISIER AGENCEUR;1;1;1;0;0;0;0;1;0;1;0;0;0;0
21700.0;2023;12;NANCY-METZ;FEMININ;APPRENTISSAGE;BAC PROFESSIONNEL;BAC PRO PROD;BAC PRO 25302 AERONAUTIQUE OPTION AVIONIQUE;1;1;1;0;0;0;0;1;0;1;0;0;0;0
21708.0;2023;12;NANCY-METZ;FEMININ;APPRENTISSAGE;BAC PROFESSIONNEL;BAC PRO PROD;BAC PRO AG 21203 TECHN CONSEIL DE VENTE ANIMAL;2;2;1;1;0;0;0;1;0;0;0;0;1;1
21712.0;2023;12;NANCY-METZ;FEMININ;APPRENTISSAGE;BAC PROFESSIONNEL;BAC PRO SERV;BAC PRO 30004 ASSISTANC.GEST.ORGANIS.ACTIVITES;15;14;13;1;0;0;0;13;0;5;1;7;0;1
21713.0;2023;12;NANCY-METZ;FEMININ;APPRENTISSAGE;BAC PROFESSIONNEL;BAC PRO SERV;BAC PRO 31106 LOGISTIQUE;3;3;2;0;1;1;0;3;0;2;0;0;1;0
21721.0;2023;12;NANCY-METZ;FEMININ;APPRENTISSAGE;BAC PROFESSIONNEL;BAC PRO SERV;BAC PRO 33104 TECHNICIEN EN PROTHESE DENTAIRE;5;5;5;0;0;0;0;5;0;3;1;1;0;0
21723.0;2023;12;NANCY-METZ;FEMININ;APPRENTISSAGE;BAC PROFESSIONNEL;BAC PRO SERV;BAC PRO 34303 GEST. POLLUTIONS PROTEC. ENVIRON.;1;1;1;0;0;0;0;1;0;1;0;0;0;0
21727.0;2023;12;NANCY-METZ;FEMININ;ENSEIGNEMENT A DISTANCE;BAC PROFESSIONNEL;BAC PRO SERV;BAC PRO 31213 MET.COM.VEN.OP.A ANI.GES.ESP.COM.;2;0;0;0;0;0;0;0;0;0;0;0;0;0
21729.0;2023;12;NANCY-METZ;FEMININ;ENSEIGNEMENT A DISTANCE;BAC PROFESSIONNEL;BAC PRO SERV;BAC PRO 33603 ESTHETIQUE COSMETIQUE PARFUMERIE;2;1;0;1;0;0;0;0;0;0;0;0;0;1
21730.0;2023;12;NANCY-METZ;FEMININ;ENSEIGNEMENT A DISTANCE;BAC TECHNOLOGIQUE;BAC ST2S;BAC ST2S SCIENCES & TECHNO. SANTE & SOCIAL;8;8;6;1;1;1;0;7;0;0;0;4;3;1
21739.0;2023;12;NANCY-METZ;FEMININ;FORMATION CONTINUE;BAC PROFESSIONNEL;BAC PRO PROD;BAC PRO 25515 SYST.NUM.OPT.C RES.INF.SYST.COMM.;1;1;1;0;0;0;0;1;0;0;0;1;0;0
21741.0;2023;12;NANCY-METZ;FEMININ;FORMATION CONTINUE;BAC PROFESSIONNEL;BAC PRO SERV;BAC PRO 30004 ASSISTANC.GEST.ORGANIS.ACTIVITES;39;38;36;2;0;0;0;36;0;8;15;7;6;2
21747.0;2023;12;NANCY-METZ;FEMININ;INDIVIDUEL;BAC PROFESSIONNEL;BAC PRO PROD;BAC PRO AG 21004 CGEA;2;2;2;0;0;0;0;2;0;0;0;0;2;0
21748.0;2023;12;NANCY-METZ;FEMININ;INDIVIDUEL;BAC PROFESSIONNEL;BAC PRO PROD;BAC PRO AG 21211 COND GEST ENTR HIPPIQUE;4;3;1;2;0;0;0;1;0;0;0;1;0;2
21749.0;2023;12;NANCY-METZ;FEMININ;INDIVIDUEL;BAC PROFESSIONNEL;BAC PRO PROD;BAC PRO AG 21302 GEST MILIEUX NATURELS FAUNE;1;1;1;0;0;0;0;1;0;1;0;0;0;0
21755.0;2023;12;NANCY-METZ;FEMININ;INDIVIDUEL;BAC PROFESSIONNEL;BAC PRO SERV;BAC PRO 33603 ESTHETIQUE COSMETIQUE PARFUMERIE;2;2;1;1;0;0;0;1;0;0;0;0;1;1
21760.0;2023;12;NANCY-METZ;FEMININ;INDIVIDUEL;BAC TECHNOLOGIQUE;BAC STMG;BAC STMG GESTION ET FINANCE;3;3;0;2;1;0;1;0;0;0;0;0;0;3
21774.0;2023;12;NANCY-METZ;FEMININ;SCOLAIRE;BAC PROFESSIONNEL;BAC PRO PROD;BAC PRO 23208 METIERS ET ARTS DE LA PIERRE;1;1;0;0;1;0;1;0;0;0;0;0;0;1
21776.0;2023;12;NANCY-METZ;FEMININ;SCOLAIRE;BAC PROFESSIONNEL;BAC PRO PROD;BAC PRO 23405 TECHNICIEN MENUISIER AGENCEUR;5;5;2;3;0;0;0;2;0;0;0;1;1;3
21788.0;2023;12;NANCY-METZ;FEMININ;SCOLAIRE;BAC PROFESSIONNEL;BAC PRO PROD;BAC PRO 25515 SYST.NUM.OPT.C RES.INF.SYST.COMM.;2;2;2;0;0;0;0;2;0;0;0;0;2;0
21789.0;2023;12;NANCY-METZ;FEMININ;SCOLAIRE;BAC PROFESSIONNEL;BAC PRO PROD;BAC PRO AG 21001 AGRO-EQUIPEMENT;1;1;1;0;0;0;0;1;0;0;0;1;0;0
21801.0;2023;12;NANCY-METZ;FEMININ;SCOLAIRE;BAC PROFESSIONNEL;BAC PRO SERV;BAC PRO 31212 METIERS DE L'ACCUEIL;107;107;95;5;7;6;1;101;0;10;24;35;32;6
21803.0;2023;12;NANCY-METZ;FEMININ;SCOLAIRE;BAC PROFESSIONNEL;BAC PRO SERV;BAC PRO 31214 MET.COM.VEN.OP.B PR.CL.VA.OF.COM.;143;143;120;14;9;8;1;128;0;15;38;40;35;15
21804.0;2023;12;NANCY-METZ;FEMININ;SCOLAIRE;BAC PROFESSIONNEL;BAC PRO SERV;BAC PRO 32207 REAL.PR.IMPR.PLURI.OPTA.PR.GRAPH.;12;12;9;3;0;0;0;9;0;0;3;4;2;3
21805.0;2023;12;NANCY-METZ;FEMININ;SCOLAIRE;BAC PROFESSIONNEL;BAC PRO SERV;BAC PRO 32208 REAL.PR.IMPR.PLURI.OPTB.PR.IMPR.;7;7;7;0;0;0;0;7;0;0;1;3;3;0
21806.0;2023;12;NANCY-METZ;FEMININ;SCOLAIRE;BAC PROFESSIONNEL;BAC PRO SERV;BAC PRO 32303 ART.& MET.ART:COM.VIS.VIS.PLURI-M;16;16;16;0;0;0;0;16;0;1;3;8;4;0
21807.0;2023;12;NANCY-METZ;FEMININ;SCOLAIRE;BAC PROFESSIONNEL;BAC PRO SERV;BAC PRO 32304 PHOTOGRAPHIE;11;11;9;2;0;0;0;9;0;0;4;1;4;2
21808.0;2023;12;NANCY-METZ;FEMININ;SCOLAIRE;BAC PROFESSIONNEL;BAC PRO SERV;BAC PRO 33003 ACC.SOINS-S.PERS. OPT.A DOMICILE;177;177;142;25;10;8;2;150;0;7;46;49;48;27
21810.0;2023;12;NANCY-METZ;FEMININ;SCOLAIRE;BAC PROFESSIONNEL;BAC PRO SERV;BAC PRO 33006 ANIMAT. ENFANCE& PERSONNES AGEES;78;78;70;8;0;0;0;70;0;12;25;25;8;8
21818.0;2023;12;NANCY-METZ;FEMININ;SCOLAIRE;BAC PROFESSIONNEL;BAC PRO SERV;BAC PRO 34403 METIERS DE LA SECURITE;33;33;25;2;6;6;0;31;0;1;6;7;17;2
21827.0;2023;12;NANCY-METZ;FEMININ;SCOLAIRE;BAC TECHNOLOGIQUE;BAC STI2D;BAC STI2D ARCHITECTURE ET CONSTRUCTION;23;23;18;0;5;2;3;20;0;0;3;9;8;3
21830.0;2023;12;NANCY-METZ;FEMININ;SCOLAIRE;BAC TECHNOLOGIQUE;BAC STI2D;BAC STI2D SYSTÈME D'INFORMATION  ET NUMERIQUE;12;12;11;1;0;0;0;11;0;1;2;5;3;1
21833.0;2023;12;NANCY-METZ;FEMININ;SCOLAIRE;BAC TECHNOLOGIQUE;BAC STMG;BAC STMG GESTION ET FINANCE;263;263;230;4;29;22;7;252;0;3;33;103;113;11
21835.0;2023;12;NANCY-METZ;FEMININ;SCOLAIRE;BAC TECHNOLOGIQUE;BAC STMG;BAC STMG RESSOURCES HUMAINES ET COMMUNICATION;495;495;394;25;76;58;18;452;0;3;36;131;282;43
21836.0;2023;12;NANCY-METZ;FEMININ;SCOLAIRE;BAC TECHNOLOGIQUE;BAC STMG;BAC STMG SYSTEMES D'INFORMATION DE GESTION;8;8;1;0;7;5;2;6;0;0;0;0;6;2
21841.0;2023;12;NANCY-METZ;MASCULIN;APPRENTISSAGE;BAC PROFESSIONNEL;BAC PRO PROD;BAC PRO 22704 TECHN. MAINT. SYST.ENERG.CLIMATI;8;8;6;2;0;0;0;6;0;0;3;1;2;2
21843.0;2023;12;NANCY-METZ;MASCULIN;APPRENTISSAGE;BAC PROFESSIONNEL;BAC PRO PROD;BAC PRO 23102 TRAVAUX PUBLICS;17;17;13;4;0;0;0;13;0;0;4;4;5;4
21850.0;2023;12;NANCY-METZ;MASCULIN;APPRENTISSAGE;BAC PROFESSIONNEL;BAC PRO PROD;BAC PRO 23407 TECHNIC.FAB.BOIS ET MATERX ASSOC;6;6;4;2;0;0;0;4;0;0;1;2;1;2
21857.0;2023;12;NANCY-METZ;MASCULIN;APPRENTISSAGE;BAC PROFESSIONNEL;BAC PRO PROD;BAC PRO 25219 MAINT.MATERIELS OPT.A AGRICOLES;13;13;11;2;0;0;0;11;0;1;1;5;4;2
21859.0;2023;12;NANCY-METZ;MASCULIN;APPRENTISSAGE;BAC PROFESSIONNEL;BAC PRO PROD;BAC PRO 25221 MAINT.MATERIELS OPT.C ESP. VERTS;4;4;3;0;1;0;1;3;0;0;1;2;0;1
21866.0;2023;12;NANCY-METZ;MASCULIN;APPRENTISSAGE;BAC PROFESSIONNEL;BAC PRO PROD;BAC PRO 25509 TECHNIC. FROID CONDITIONNEMT AIR;8;8;7;1;0;0;0;7;0;1;1;3;2;1
21870.0;2023;12;NANCY-METZ;MASCULIN;APPRENTISSAGE;BAC PROFESSIONNEL;BAC PRO PROD;BAC PRO AG 21001 AGRO-EQUIPEMENT;19;18;9;9;0;0;0;9;0;0;1;3;5;9
21874.0;2023;12;NANCY-METZ;MASCULIN;APPRENTISSAGE;BAC PROFESSIONNEL;BAC PRO PROD;BAC PRO AG 21210 COND GEST ENTR CANIN ET FELIN;2;2;1;1;0;0;0;1;0;0;0;0;1;1
21888.0;2023;12;NANCY-METZ;MASCULIN;ENSEIGNEMENT A DISTANCE;BAC GENERAL;BAC GENERAL;BAC GENE 10019 BAC GENERAL;10;10;3;6;1;0;1;3;0;1;1;0;1;7
21892.0;2023;12;NANCY-METZ;MASCULIN;ENSEIGNEMENT A DISTANCE;BAC PROFESSIONNEL;BAC PRO SERV;BAC PRO 33004 ACC.SOINS-S.PERS. OPT.EN STRUCTUR;1;0;0;0;0;0;0;0;0;0;0;0;0;0
21900.0;2023;12;NANCY-METZ;MASCULIN;FORMATION CONTINUE;BAC PROFESSIONNEL;BAC PRO PROD;BAC PRO 25411 TECH.CHAUDRONNERIE INDUSTRIELLE;1;1;1;0;0;0;0;1;0;1;0;0;0;0
21903.0;2023;12;NANCY-METZ;MASCULIN;FORMATION CONTINUE;BAC PROFESSIONNEL;BAC PRO SERV;BAC PRO 30004 ASSISTANC.GEST.ORGANIS.ACTIVITES;10;10;8;2;0;0;0;8;0;0;3;3;2;2
21904.0;2023;12;NANCY-METZ;MASCULIN;FORMATION CONTINUE;BAC PROFESSIONNEL;BAC PRO SERV;BAC PRO 31213 MET.COM.VEN.OP.A ANI.GES.ESP.COM.;16;13;8;5;0;0;0;8;0;0;2;4;2;5
21906.0;2023;12;NANCY-METZ;MASCULIN;FORMATION CONTINUE;BAC PROFESSIONNEL;BAC PRO SERV;BAC PRO 33104 TECHNICIEN EN PROTHESE DENTAIRE;5;5;5;0;0;0;0;5;0;3;1;1;0;0
21909.0;2023;12;NANCY-METZ;MASCULIN;INDIVIDUEL;BAC PROFESSIONNEL;BAC PRO PROD;BAC PRO 22106 CUISINE;1;1;1;0;0;0;0;1;0;0;0;1;0;0
21918.0;2023;12;NANCY-METZ;MASCULIN;INDIVIDUEL;BAC PROFESSIONNEL;BAC PRO SERV;BAC PRO 31213 MET.COM.VEN.OP.A ANI.GES.ESP.COM.;1;1;0;1;0;0;0;0;0;0;0;0;0;1
21931.0;2023;12;NANCY-METZ;MASCULIN;SCOLAIRE;BAC PROFESSIONNEL;BAC PRO PROD;BAC PRO 22003 BIO-INDUSTRIES DE TRANSFORMATION;6;6;5;0;1;1;0;6;0;0;1;2;3;0
21935.0;2023;12;NANCY-METZ;MASCULIN;SCOLAIRE;BAC PROFESSIONNEL;BAC PRO PROD;BAC PRO 22303 FONDERIE;1;1;1;0;0;0;0;1;0;0;1;0;0;0
21944.0;2023;12;NANCY-METZ;MASCULIN;SCOLAIRE;BAC PROFESSIONNEL;BAC PRO PROD;BAC PRO 23203 TECHNICIEN BAT. : ORG.REAL.GROS O;8;8;8;0;0;0;0;8;0;5;1;1;1;0
21950.0;2023;12;NANCY-METZ;MASCULIN;SCOLAIRE;BAC PROFESSIONNEL;BAC PRO PROD;BAC PRO 23407 TECHNIC.FAB.BOIS ET MATERX ASSOC;11;11;7;2;2;1;1;8;0;1;3;1;3;3
21959.0;2023;12;NANCY-METZ;MASCULIN;SCOLAIRE;BAC PROFESSIONNEL;BAC PRO PROD;BAC PRO 25219 MAINT.MATERIELS OPT.A AGRICOLES;7;7;7;0;0;0;0;7;0;0;1;3;3;0
21960.0;2023;12;NANCY-METZ;MASCULIN;SCOLAIRE;BAC PROFESSIONNEL;BAC PRO PROD;BAC PRO 25220 MAINT.MATERIELS OPT.B TP MANUT.;22;22;16;5;1;0;1;16;0;0;7;6;3;6
21964.0;2023;12;NANCY-METZ;MASCULIN;SCOLAIRE;BAC PROFESSIONNEL;BAC PRO PROD;BAC PRO 25406 OUVRAGES DU BATIMENT METALLERIE;9;9;7;1;1;1;0;8;0;1;4;2;1;1
21973.0;2023;12;NANCY-METZ;MASCULIN;SCOLAIRE;BAC PROFESSIONNEL;BAC PRO PROD;BAC PRO AG 21001 AGRO-EQUIPEMENT;37;37;29;8;0;0;0;29;0;1;1;14;13;8
21975.0;2023;12;NANCY-METZ;MASCULIN;SCOLAIRE;BAC PROFESSIONNEL;BAC PRO PROD;BAC PRO AG 21114 CONDUITE PRODUCTIONS HORTICOLES;5;5;4;1;0;0;0;4;0;0;1;0;3;1
21976.0;2023;12;NANCY-METZ;MASCULIN;SCOLAIRE;BAC PROFESSIONNEL;BAC PRO PROD;BAC PRO AG 21203 TECHN CONSEIL DE VENTE ANIMAL;6;6;5;1;0;0;0;5;0;0;1;0;4;1
21984.0;2023;12;NANCY-METZ;MASCULIN;SCOLAIRE;BAC PROFESSIONNEL;BAC PRO SERV;BAC PRO 31106 LOGISTIQUE;113;113;82;11;20;14;6;96;0;3;16;28;49;17
21988.0;2023;12;NANCY-METZ;MASCULIN;SCOLAIRE;BAC PROFESSIONNEL;BAC PRO SERV;BAC PRO 31213 MET.COM.VEN.OP.A ANI.GES.ESP.COM.;377;377;304;46;27;22;5;326;0;10;62;127;127;51
21991.0;2023;12;NANCY-METZ;MASCULIN;SCOLAIRE;BAC PROFESSIONNEL;BAC PRO SERV;BAC PRO 32208 REAL.PR.IMPR.PLURI.OPTB.PR.IMPR.;4;4;4;0;0;0;0;4;0;0;1;2;1;0
22004.0;2023;12;NANCY-METZ;MASCULIN;SCOLAIRE;BAC PROFESSIONNEL;BAC PRO SERV;BAC PRO 34403 METIERS DE LA SECURITE;69;69;61;5;3;3;0;64;0;2;13;22;27;5
22005.0;2023;12;NANCY-METZ;MASCULIN;SCOLAIRE;BAC PROFESSIONNEL;BAC PRO SERV;BAC PRO AG 33002 SERV PERS TERRIT;7;7;6;1;0;0;0;6;0;1;1;2;2;1
22008.0;2023;12;NANCY-METZ;MASCULIN;SCOLAIRE;BAC TECHNOLOGIQUE;BAC S2TMD;BAC S2TMD THEATRE;3;3;3;0;0;0;0;3;0;0;1;1;1;0
22009.0;2023;12;NANCY-METZ;MASCULIN;SCOLAIRE;BAC TECHNOLOGIQUE;BAC ST2S;BAC ST2S SCIENCES & TECHNO. SANTE & SOCIAL;118;118;94;4;20;18;2;112;0;4;12;29;67;6
22011.0;2023;12;NANCY-METZ;MASCULIN;SCOLAIRE;BAC TECHNOLOGIQUE;BAC STD2A;BAC STD2A SCIENCES & TECHNO. DESIGN-ARTS APPLIQUES;12;12;10;0;2;2;0;12;1;2;2;2;5;0
22012.0;2023;12;NANCY-METZ;MASCULIN;SCOLAIRE;BAC TECHNOLOGIQUE;BAC STHR;BAC STHR SC.&TEC. HOTELLERIE-RESTAURATION;43;43;42;1;0;0;0;42;0;3;13;19;7;1
22013.0;2023;12;NANCY-METZ;MASCULIN;SCOLAIRE;BAC TECHNOLOGIQUE;BAC STI2D;BAC STI2D ARCHITECTURE ET CONSTRUCTION;73;73;56;2;15;9;6;65;1;0;8;17;39;8
22019.0;2023;12;NANCY-METZ;MASCULIN;SCOLAIRE;BAC TECHNOLOGIQUE;BAC STMG;BAC STMG GESTION ET FINANCE;365;365;275;19;71;50;21;325;0;1;25;96;203;40
22021.0;2023;12;NANCY-METZ;MASCULIN;SCOLAIRE;BAC TECHNOLOGIQUE;BAC STMG;BAC STMG RESSOURCES HUMAINES ET COMMUNICATION;199;199;135;16;48;37;11;172;0;0;8;42;122;27
22022.0;2023;12;NANCY-METZ;MASCULIN;SCOLAIRE;BAC TECHNOLOGIQUE;BAC STMG;BAC STMG SYSTEMES D'INFORMATION DE GESTION;27;27;19;2;6;4;2;23;0;0;0;6;17;4
22031.0;2023;17;NANTES;FEMININ;APPRENTISSAGE;BAC PROFESSIONNEL;BAC PRO PROD;BAC PRO 23304 AMENAGEMENT FINITION BATIMENT;3;3;3;0;0;0;0;3;0;0;1;1;1;0
22032.0;2023;17;NANTES;FEMININ;APPRENTISSAGE;BAC PROFESSIONNEL;BAC PRO PROD;BAC PRO 24203 METIERS DE LA MODE - VÊTEMENT;9;9;9;0;0;0;0;9;0;1;6;2;0;0
22039.0;2023;17;NANTES;FEMININ;APPRENTISSAGE;BAC PROFESSIONNEL;BAC PRO PROD;BAC PRO 25220 MAINT.MATERIELS OPT.B TP MANUT.;2;2;2;0;0;0;0;2;0;0;0;1;1;0
22043.0;2023;17;NANTES;FEMININ;APPRENTISSAGE;BAC PROFESSIONNEL;BAC PRO PROD;BAC PRO 25408 REPARATION DES CARROSSERIES;1;1;1;0;0;0;0;1;0;0;0;0;1;0
22046.0;2023;17;NANTES;FEMININ;APPRENTISSAGE;BAC PROFESSIONNEL;BAC PRO PROD;BAC PRO AG 21001 AGRO-EQUIPEMENT;1;1;1;0;0;0;0;1;0;0;1;0;0;0
22049.0;2023;17;NANTES;FEMININ;APPRENTISSAGE;BAC PROFESSIONNEL;BAC PRO PROD;BAC PRO AG 21114 CONDUITE PRODUCTIONS HORTICOLES;7;7;7;0;0;0;0;7;0;0;1;3;3;0
22056.0;2023;17;NANTES;FEMININ;APPRENTISSAGE;BAC PROFESSIONNEL;BAC PRO PROD;BAC PRO AG 22108 TEC CONS VTE ALIMENTATION (PAB);9;9;9;0;0;0;0;9;0;1;0;3;5;0
22066.0;2023;17;NANTES;FEMININ;APPRENTISSAGE;BAC PROFESSIONNEL;BAC PRO SERV;BAC PRO 33003 ACC.SOINS-S.PERS. OPT.A DOMICILE;5;5;3;1;1;1;0;4;0;0;0;2;2;1
22072.0;2023;17;NANTES;FEMININ;APPRENTISSAGE;BAC PROFESSIONNEL;BAC PRO SERV;BAC PRO AG 33002 SERV PERS TERRIT;83;82;78;4;0;0;0;78;0;2;6;24;46;4
22073.0;2023;17;NANTES;FEMININ;ENSEIGNEMENT A DISTANCE;BAC GENERAL;BAC GENERAL;BAC GENE 10019 BAC GENERAL;88;88;54;23;11;7;4;61;0;3;9;14;35;27
22085.0;2023;17;NANTES;FEMININ;FORMATION CONTINUE;BAC PROFESSIONNEL;BAC PRO PROD;BAC PRO 23004 TECHN. ETUDES BAT.A ETUDES & ECO.;2;2;2;0;0;0;0;2;0;0;1;0;1;0
22087.0;2023;17;NANTES;FEMININ;FORMATION CONTINUE;BAC PROFESSIONNEL;BAC PRO PROD;BAC PRO AG 21004 CGEA;3;3;3;0;0;0;0;3;0;0;0;0;3;0
22089.0;2023;17;NANTES;FEMININ;FORMATION CONTINUE;BAC PROFESSIONNEL;BAC PRO PROD;BAC PRO AG 21114 CONDUITE PRODUCTIONS HORTICOLES;7;7;7;0;0;0;0;7;0;0;0;0;7;0
22097.0;2023;17;NANTES;FEMININ;INDIVIDUEL;BAC PROFESSIONNEL;BAC PRO PROD;BAC PRO AG 21211 COND GEST ENTR HIPPIQUE;9;7;4;3;0;0;0;4;0;0;1;1;2;3
22098.0;2023;17;NANTES;FEMININ;INDIVIDUEL;BAC PROFESSIONNEL;BAC PRO PROD;BAC PRO AG 21302 GEST MILIEUX NATURELS FAUNE;1;0;0;0;0;0;0;0;0;0;0;0;0;0
22101.0;2023;17;NANTES;FEMININ;INDIVIDUEL;BAC PROFESSIONNEL;BAC PRO SERV;BAC PRO 31212 METIERS DE L'ACCUEIL;3;1;0;1;0;0;0;0;0;0;0;0;0;1
22106.0;2023;17;NANTES;FEMININ;INDIVIDUEL;BAC PROFESSIONNEL;BAC PRO SERV;BAC PRO 33603 ESTHETIQUE COSMETIQUE PARFUMERIE;7;6;1;5;0;0;0;1;0;0;0;0;1;5
22110.0;2023;17;NANTES;FEMININ;INDIVIDUEL;BAC TECHNOLOGIQUE;BAC STHR;BAC STHR SC.&TEC. HOTELLERIE-RESTAURATION;1;1;0;1;0;0;0;0;0;0;0;0;0;1
22112.0;2023;17;NANTES;FEMININ;INDIVIDUEL;BAC TECHNOLOGIQUE;BAC STMG;BAC STMG MERCATIQUE (MARKETING);25;25;2;16;7;5;2;7;0;0;0;0;7;18
22129.0;2023;17;NANTES;FEMININ;SCOLAIRE;BAC PROFESSIONNEL;BAC PRO PROD;BAC PRO 23405 TECHNICIEN MENUISIER AGENCEUR;7;7;6;1;0;0;0;6;0;3;1;0;2;1
22130.0;2023;17;NANTES;FEMININ;SCOLAIRE;BAC PROFESSIONNEL;BAC PRO PROD;BAC PRO 23407 TECHNIC.FAB.BOIS ET MATERX ASSOC;1;1;1;0;0;0;0;1;0;0;0;1;0;0
22139.0;2023;17;NANTES;FEMININ;SCOLAIRE;BAC PROFESSIONNEL;BAC PRO PROD;BAC PRO 25215 MAINT.VEHIC.OPTB VEHIC.TRANS.ROUT;1;1;1;0;0;0;0;1;0;0;0;1;0;0
22141.0;2023;17;NANTES;FEMININ;SCOLAIRE;BAC PROFESSIONNEL;BAC PRO PROD;BAC PRO 25221 MAINT.MATERIELS OPT.C ESP. VERTS;1;1;0;1;0;0;0;0;0;0;0;0;0;1
22142.0;2023;17;NANTES;FEMININ;SCOLAIRE;BAC PROFESSIONNEL;BAC PRO PROD;BAC PRO 25411 TECH.CHAUDRONNERIE INDUSTRIELLE;2;2;2;0;0;0;0;2;0;0;0;0;2;0
22143.0;2023;17;NANTES;FEMININ;SCOLAIRE;BAC PROFESSIONNEL;BAC PRO PROD;BAC PRO 25509 TECHNIC. FROID CONDITIONNEMT AIR;2;2;2;0;0;0;0;2;0;1;0;1;0;0
22145.0;2023;17;NANTES;FEMININ;SCOLAIRE;BAC PROFESSIONNEL;BAC PRO PROD;BAC PRO 25513 SYST.NUM.OPT.A SURETE SECURITE;1;1;1;0;0;0;0;1;0;0;0;0;1;0
22148.0;2023;17;NANTES;FEMININ;SCOLAIRE;BAC PROFESSIONNEL;BAC PRO PROD;BAC PRO AG 21001 AGRO-EQUIPEMENT;4;4;2;2;0;0;0;2;0;0;0;0;2;2
22151.0;2023;17;NANTES;FEMININ;SCOLAIRE;BAC PROFESSIONNEL;BAC PRO PROD;BAC PRO AG 21114 CONDUITE PRODUCTIONS HORTICOLES;37;37;31;6;0;0;0;31;0;1;3;10;17;6
22152.0;2023;17;NANTES;FEMININ;SCOLAIRE;BAC PROFESSIONNEL;BAC PRO PROD;BAC PRO AG 21203 TECHN CONSEIL DE VENTE ANIMAL;70;70;61;9;0;0;0;61;0;0;5;16;40;9
22153.0;2023;17;NANTES;FEMININ;SCOLAIRE;BAC PROFESSIONNEL;BAC PRO PROD;BAC PRO AG 21204 PROD-AQUACOLES;1;1;0;1;0;0;0;0;0;0;0;0;0;1
22157.0;2023;17;NANTES;FEMININ;SCOLAIRE;BAC PROFESSIONNEL;BAC PRO PROD;BAC PRO AG 21405 AMENAGEMENTS PAYSAGERS;8;8;6;2;0;0;0;6;0;0;0;2;4;2
22163.0;2023;17;NANTES;FEMININ;SCOLAIRE;BAC PROFESSIONNEL;BAC PRO SERV;BAC PRO 31107 CONDUCT. TRANSP.ROUT.MARCHANDISES;13;13;12;1;0;0;0;12;0;1;4;6;1;1
22164.0;2023;17;NANTES;FEMININ;SCOLAIRE;BAC PROFESSIONNEL;BAC PRO SERV;BAC PRO 31114 ORGANIS. TRANSPORT MARCHANDISES;12;12;12;0;0;0;0;12;0;1;1;7;3;0
22166.0;2023;17;NANTES;FEMININ;SCOLAIRE;BAC PROFESSIONNEL;BAC PRO SERV;BAC PRO 31213 MET.COM.VEN.OP.A ANI.GES.ESP.COM.;610;609;547;37;25;16;9;563;0;30;152;222;159;46
22167.0;2023;17;NANTES;FEMININ;SCOLAIRE;BAC PROFESSIONNEL;BAC PRO SERV;BAC PRO 31214 MET.COM.VEN.OP.B PR.CL.VA.OF.COM.;160;160;147;6;7;7;0;154;0;6;50;46;52;6
22171.0;2023;17;NANTES;FEMININ;SCOLAIRE;BAC PROFESSIONNEL;BAC PRO SERV;BAC PRO 33003 ACC.SOINS-S.PERS. OPT.A DOMICILE;133;133;115;15;3;3;0;118;0;4;26;45;43;15
22172.0;2023;17;NANTES;FEMININ;SCOLAIRE;BAC PROFESSIONNEL;BAC PRO SERV;BAC PRO 33004 ACC.SOINS-S.PERS. OPT.EN STRUCTUR;723;721;658;49;14;11;3;669;0;44;183;261;181;52
22174.0;2023;17;NANTES;FEMININ;SCOLAIRE;BAC PROFESSIONNEL;BAC PRO SERV;BAC PRO 33101 OPTIQUE LUNETTERIE;16;16;16;0;0;0;0;16;0;2;5;8;1;0
22191.0;2023;17;NANTES;FEMININ;SCOLAIRE;BAC TECHNOLOGIQUE;BAC STI2D;BAC STI2D ENERGIES  ET ENVIRONNEMENT;19;19;15;1;3;2;1;17;1;1;1;6;8;2
22213.0;2023;17;NANTES;MASCULIN;APPRENTISSAGE;BAC PROFESSIONNEL;BAC PRO PROD;BAC PRO 23304 AMENAGEMENT FINITION BATIMENT;4;4;3;0;1;1;0;4;0;0;0;1;3;0
22235.0;2023;17;NANTES;MASCULIN;APPRENTISSAGE;BAC PROFESSIONNEL;BAC PRO PROD;BAC PRO 25411 TECH.CHAUDRONNERIE INDUSTRIELLE;140;140;119;17;4;2;2;121;0;10;25;37;49;19
22239.0;2023;17;NANTES;MASCULIN;APPRENTISSAGE;BAC PROFESSIONNEL;BAC PRO PROD;BAC PRO 25514 SYST.NUM.OPT.B AUD.RES.EQUIP.DOM.;14;14;13;1;0;0;0;13;0;1;5;5;2;1
22243.0;2023;17;NANTES;MASCULIN;APPRENTISSAGE;BAC PROFESSIONNEL;BAC PRO PROD;BAC PRO AG 21113 CGEVV;13;13;11;2;0;0;0;11;0;0;2;2;7;2
22245.0;2023;17;NANTES;MASCULIN;APPRENTISSAGE;BAC PROFESSIONNEL;BAC PRO PROD;BAC PRO AG 21203 TECHN CONSEIL DE VENTE ANIMAL;2;1;1;0;0;0;0;1;0;0;0;0;1;0
22249.0;2023;17;NANTES;MASCULIN;APPRENTISSAGE;BAC PROFESSIONNEL;BAC PRO PROD;BAC PRO AG 21303 FORET;7;7;6;1;0;0;0;6;0;0;1;3;2;1
22250.0;2023;17;NANTES;MASCULIN;APPRENTISSAGE;BAC PROFESSIONNEL;BAC PRO PROD;BAC PRO AG 21405 AMENAGEMENTS PAYSAGERS;166;163;157;6;0;0;0;157;0;2;13;63;79;6
22252.0;2023;17;NANTES;MASCULIN;APPRENTISSAGE;BAC PROFESSIONNEL;BAC PRO PROD;BAC PRO AG 22108 TEC CONS VTE ALIMENTATION (PAB);20;20;19;1;0;0;0;19;0;0;2;8;9;1
22253.0;2023;17;NANTES;MASCULIN;APPRENTISSAGE;BAC PROFESSIONNEL;BAC PRO SERV;BAC PRO 30004 ASSISTANC.GEST.ORGANIS.ACTIVITES;8;8;8;0;0;0;0;8;0;0;1;5;2;0
22254.0;2023;17;NANTES;MASCULIN;APPRENTISSAGE;BAC PROFESSIONNEL;BAC PRO SERV;BAC PRO 31106 LOGISTIQUE;45;45;29;13;3;3;0;32;0;1;8;8;15;13
22255.0;2023;17;NANTES;MASCULIN;APPRENTISSAGE;BAC PROFESSIONNEL;BAC PRO SERV;BAC PRO 31114 ORGANIS. TRANSPORT MARCHANDISES;1;1;0;1;0;0;0;0;0;0;0;0;0;1
22264.0;2023;17;NANTES;MASCULIN;APPRENTISSAGE;BAC PROFESSIONNEL;BAC PRO SERV;BAC PRO 33403 COMMERC. SERVICES EN RESTAURATION;24;24;18;3;3;2;1;20;0;1;1;6;12;4
22265.0;2023;17;NANTES;MASCULIN;APPRENTISSAGE;BAC PROFESSIONNEL;BAC PRO SERV;BAC PRO 34304 HYGIENE PROPRETE STERILISATION;1;1;1;0;0;0;0;1;0;0;0;0;1;0
22274.0;2023;17;NANTES;MASCULIN;ENSEIGNEMENT A DISTANCE;BAC TECHNOLOGIQUE;BAC STMG;BAC STMG GESTION ET FINANCE;1;1;1;0;0;0;0;1;0;0;0;0;1;0
22277.0;2023;17;NANTES;MASCULIN;FORMATION CONTINUE;BAC PROFESSIONNEL;BAC PRO PROD;BAC PRO 22703 TECHN.INSTALL.SYST.ENERG.CLIMATI;2;2;1;1;0;0;0;1;0;1;0;0;0;1
22285.0;2023;17;NANTES;MASCULIN;FORMATION CONTINUE;BAC PROFESSIONNEL;BAC PRO PROD;BAC PRO 25515 SYST.NUM.OPT.C RES.INF.SYST.COMM.;8;8;8;0;0;0;0;8;0;2;0;3;3;0
22286.0;2023;17;NANTES;MASCULIN;FORMATION CONTINUE;BAC PROFESSIONNEL;BAC PRO PROD;BAC PRO AG 21004 CGEA;3;3;3;0;0;0;0;3;0;0;0;0;3;0
22289.0;2023;17;NANTES;MASCULIN;FORMATION CONTINUE;BAC PROFESSIONNEL;BAC PRO PROD;BAC PRO AG 21405 AMENAGEMENTS PAYSAGERS;1;1;1;0;0;0;0;1;0;0;0;0;1;0
22294.0;2023;17;NANTES;MASCULIN;INDIVIDUEL;BAC PROFESSIONNEL;BAC PRO PROD;BAC PRO 22106 CUISINE;1;1;0;0;1;1;0;1;0;0;0;0;1;0
22296.0;2023;17;NANTES;MASCULIN;INDIVIDUEL;BAC PROFESSIONNEL;BAC PRO PROD;BAC PRO 22704 TECHN. MAINT. SYST.ENERG.CLIMATI;1;0;0;0;0;0;0;0;0;0;0;0;0;0
22304.0;2023;17;NANTES;MASCULIN;INDIVIDUEL;BAC PROFESSIONNEL;BAC PRO PROD;BAC PRO 25408 REPARATION DES CARROSSERIES;1;1;1;0;0;0;0;1;0;0;0;0;1;0
22306.0;2023;17;NANTES;MASCULIN;INDIVIDUEL;BAC PROFESSIONNEL;BAC PRO PROD;BAC PRO 25513 SYST.NUM.OPT.A SURETE SECURITE;2;2;1;1;0;0;0;1;0;0;0;0;1;1
22322.0;2023;17;NANTES;MASCULIN;INDIVIDUEL;BAC TECHNOLOGIQUE;BAC STI2D;BAC STI2D ENERGIES  ET ENVIRONNEMENT;1;1;0;1;0;0;0;0;0;0;0;0;0;1
22326.0;2023;17;NANTES;MASCULIN;INDIVIDUEL;BAC TECHNOLOGIQUE;BAC STMG;BAC STMG GESTION ET FINANCE;15;15;3;7;5;4;1;7;0;0;0;2;5;8
22330.0;2023;17;NANTES;MASCULIN;SCOLAIRE;BAC PROFESSIONNEL;BAC PRO PROD;BACPRO 20002 ETUD.DEFINITION PRDTS INDUSTRIEL;23;23;20;3;0;0;0;20;0;0;5;8;7;3
22332.0;2023;17;NANTES;MASCULIN;SCOLAIRE;BAC PROFESSIONNEL;BAC PRO PROD;BAC PRO 22004 PROC. CHIMIE EAU PAPIERS-CARTONS;17;17;17;0;0;0;0;17;0;0;3;8;6;0
22336.0;2023;17;NANTES;MASCULIN;SCOLAIRE;BAC PROFESSIONNEL;BAC PRO PROD;BAC PRO 22503 PLASTIQUES ET COMPOSITES;29;29;23;3;3;1;2;24;0;0;6;11;7;5
22337.0;2023;17;NANTES;MASCULIN;SCOLAIRE;BAC PROFESSIONNEL;BAC PRO PROD;BAC PRO 22703 TECHN.INSTALL.SYST.ENERG.CLIMATI;46;46;36;5;5;4;1;40;0;4;3;7;26;6
22351.0;2023;17;NANTES;MASCULIN;SCOLAIRE;BAC PROFESSIONNEL;BAC PRO PROD;BAC PRO 23408 Etude et réalisation d'agencement;8;8;4;4;0;0;0;4;0;1;2;0;1;4
22353.0;2023;17;NANTES;MASCULIN;SCOLAIRE;BAC PROFESSIONNEL;BAC PRO PROD;BAC PRO 25006 MICROTECHNIQUES;20;20;19;0;1;0;1;19;0;0;2;9;8;1
22361.0;2023;17;NANTES;MASCULIN;SCOLAIRE;BAC PROFESSIONNEL;BAC PRO PROD;BAC PRO 25219 MAINT.MATERIELS OPT.A AGRICOLES;30;30;29;1;0;0;0;29;0;2;10;15;2;1
22370.0;2023;17;NANTES;MASCULIN;SCOLAIRE;BAC PROFESSIONNEL;BAC PRO PROD;BAC PRO 25513 SYST.NUM.OPT.A SURETE SECURITE;84;84;60;22;2;0;2;60;0;2;12;22;24;24
22379.0;2023;17;NANTES;MASCULIN;SCOLAIRE;BAC PROFESSIONNEL;BAC PRO PROD;BAC PRO AG 21210 COND GEST ENTR CANIN ET FELIN;11;11;8;3;0;0;0;8;0;0;0;1;7;3
22387.0;2023;17;NANTES;MASCULIN;SCOLAIRE;BAC PROFESSIONNEL;BAC PRO SERV;BAC PRO 31106 LOGISTIQUE;111;111;98;7;6;3;3;101;0;3;12;46;40;10
22397.0;2023;17;NANTES;MASCULIN;SCOLAIRE;BAC PROFESSIONNEL;BAC PRO SERV;BAC PRO 33003 ACC.SOINS-S.PERS. OPT.A DOMICILE;10;10;8;1;1;1;0;9;0;0;0;3;6;1
22411.0;2023;17;NANTES;MASCULIN;SCOLAIRE;BAC TECHNOLOGIQUE;BAC ST2S;BAC ST2S SCIENCES & TECHNO. SANTE & SOCIAL;169;169;140;7;22;14;8;154;0;1;15;45;93;15
22418.0;2023;17;NANTES;MASCULIN;SCOLAIRE;BAC TECHNOLOGIQUE;BAC STI2D;BAC STI2D SYSTÈME D'INFORMATION  ET NUMERIQUE;448;448;413;3;32;19;13;432;0;27;81;166;158;16
22423.0;2023;17;NANTES;MASCULIN;SCOLAIRE;BAC TECHNOLOGIQUE;BAC STMG;BAC STMG RESSOURCES HUMAINES ET COMMUNICATION;341;341;207;36;98;69;29;276;0;0;8;42;226;65
22424.0;2023;17;NANTES;MASCULIN;SCOLAIRE;BAC TECHNOLOGIQUE;BAC STMG;BAC STMG SYSTEMES D'INFORMATION DE GESTION;12;12;8;1;3;2;1;10;0;0;2;4;4;2
22425.0;2023;23;NICE;FEMININ;APPRENTISSAGE;BAC PROFESSIONNEL;BAC PRO PROD;BAC PRO 22106 CUISINE;2;2;2;0;0;0;0;2;0;0;0;1;1;0
22433.0;2023;23;NICE;FEMININ;APPRENTISSAGE;BAC PROFESSIONNEL;BAC PRO SERV;BAC PRO 31106 LOGISTIQUE;1;1;1;0;0;0;0;1;0;0;0;1;0;0
22439.0;2023;23;NICE;FEMININ;ENSEIGNEMENT A DISTANCE;BAC GENERAL;BAC GENERAL;BAC GENE 10019 BAC GENERAL;98;98;76;9;13;7;6;83;2;4;19;22;36;15
22443.0;2023;23;NICE;FEMININ;ENSEIGNEMENT A DISTANCE;BAC PROFESSIONNEL;BAC PRO SERV;BAC PRO 33004 ACC.SOINS-S.PERS. OPT.EN STRUCTUR;3;2;1;1;0;0;0;1;0;0;0;0;1;1
22446.0;2023;23;NICE;FEMININ;ENSEIGNEMENT A DISTANCE;BAC TECHNOLOGIQUE;BAC STMG;BAC STMG MERCATIQUE (MARKETING);4;4;2;1;1;1;0;3;0;0;0;2;1;1
22454.0;2023;23;NICE;FEMININ;FORMATION CONTINUE;BAC PROFESSIONNEL;BAC PRO SERV;BAC PRO AG 33002 SERV PERS TERRIT;6;5;5;0;0;0;0;5;0;0;2;3;0;0
22461.0;2023;23;NICE;FEMININ;INDIVIDUEL;BAC PROFESSIONNEL;BAC PRO PROD;BAC PRO AG 21211 COND GEST ENTR HIPPIQUE;3;3;2;1;0;0;0;2;0;0;1;0;1;1
22471.0;2023;23;NICE;FEMININ;INDIVIDUEL;BAC TECHNOLOGIQUE;BAC STD2A;BAC STD2A SCIENCES & TECHNO. DESIGN-ARTS APPLIQUES;1;1;1;0;0;0;0;1;0;0;0;0;1;0
22472.0;2023;23;NICE;FEMININ;INDIVIDUEL;BAC TECHNOLOGIQUE;BAC STL;BAC STL BIOCHIM.-BIOLOGIE-BIOTECHNOL.;1;1;0;1;0;0;0;0;0;0;0;0;0;1
22473.0;2023;23;NICE;FEMININ;INDIVIDUEL;BAC TECHNOLOGIQUE;BAC STMG;BAC STMG GESTION ET FINANCE;4;4;0;4;0;0;0;0;0;0;0;0;0;4
22481.0;2023;23;NICE;FEMININ;SCOLAIRE;BAC PROFESSIONNEL;BAC PRO PROD;BAC PRO 23003 ARTIS. & M.ART:MARCHANDISAGE VIS.;11;11;7;3;1;1;0;8;0;0;1;3;4;3
22485.0;2023;23;NICE;FEMININ;SCOLAIRE;BAC PROFESSIONNEL;BAC PRO PROD;BACPRO 23103 TECHNICIEN GEOMETRE-TOPOGRAPHE;3;3;2;1;0;0;0;2;0;0;0;0;2;1
22491.0;2023;23;NICE;FEMININ;SCOLAIRE;BAC PROFESSIONNEL;BAC PRO PROD;BAC PRO 24302 METIERS DU CUIR : MAROQUINERIE;7;7;6;1;0;0;0;6;0;1;1;1;3;1
22492.0;2023;23;NICE;FEMININ;SCOLAIRE;BAC PROFESSIONNEL;BAC PRO PROD;BAC PRO 25007 MAINTENANCE EQUIPEMENTS INDUST.;2;2;2;0;0;0;0;2;0;0;0;1;1;0
22493.0;2023;23;NICE;FEMININ;SCOLAIRE;BAC PROFESSIONNEL;BAC PRO PROD;BAC PRO 25009 MAINTENANCE NAUTIQUE;2;2;1;1;0;0;0;1;0;1;0;0;0;1
22502.0;2023;23;NICE;FEMININ;SCOLAIRE;BAC PROFESSIONNEL;BAC PRO PROD;BAC PRO AG 21113 CGEVV;8;8;7;1;0;0;0;7;0;0;1;1;5;1
22505.0;2023;23;NICE;FEMININ;SCOLAIRE;BAC PROFESSIONNEL;BAC PRO PROD;BAC PRO AG 22105 LABORATOIRE CONTROLE QUALITE;6;6;5;1;0;0;0;5;0;0;0;2;3;1
22522.0;2023;23;NICE;FEMININ;SCOLAIRE;BAC PROFESSIONNEL;BAC PRO SERV;BAC PRO 34304 HYGIENE PROPRETE STERILISATION;18;18;16;2;0;0;0;16;0;1;3;8;4;2
22525.0;2023;23;NICE;FEMININ;SCOLAIRE;BAC TECHNOLOGIQUE;BAC S2TMD;BAC S2TMD DANSE;5;5;3;1;1;1;0;4;0;0;1;2;1;1
22529.0;2023;23;NICE;FEMININ;SCOLAIRE;BAC TECHNOLOGIQUE;BAC STD2A;BAC STD2A SCIENCES & TECHNO. DESIGN-ARTS APPLIQUES;102;102;100;1;1;1;0;101;1;9;27;48;16;1
22534.0;2023;23;NICE;FEMININ;SCOLAIRE;BAC TECHNOLOGIQUE;BAC STI2D;BAC STI2D SYSTÈME D'INFORMATION  ET NUMERIQUE;12;12;9;1;2;2;0;11;0;1;1;5;4;1
22536.0;2023;23;NICE;FEMININ;SCOLAIRE;BAC TECHNOLOGIQUE;BAC STL;BAC STL SCIENCES PHYSIQUES CHIMIQUES  EN LABORAT.;64;64;56;1;7;4;3;60;0;2;11;23;24;4
22537.0;2023;23;NICE;FEMININ;SCOLAIRE;BAC TECHNOLOGIQUE;BAC STMG;BAC STMG GESTION ET FINANCE;198;198;176;6;16;15;1;191;1;7;43;67;73;7
22556.0;2023;23;NICE;MASCULIN;APPRENTISSAGE;BAC PROFESSIONNEL;BAC PRO PROD;BAC PRO 25408 REPARATION DES CARROSSERIES;19;17;11;6;0;0;0;11;0;0;0;3;8;6
22557.0;2023;23;NICE;MASCULIN;APPRENTISSAGE;BAC PROFESSIONNEL;BAC PRO PROD;BAC PRO 25411 TECH.CHAUDRONNERIE INDUSTRIELLE;8;8;8;0;0;0;0;8;0;1;2;3;2;0
22558.0;2023;23;NICE;MASCULIN;APPRENTISSAGE;BAC PROFESSIONNEL;BAC PRO PROD;BAC PRO 25509 TECHNIC. FROID CONDITIONNEMT AIR;15;15;11;1;3;2;1;13;0;3;2;2;6;2
22562.0;2023;23;NICE;MASCULIN;APPRENTISSAGE;BAC PROFESSIONNEL;BAC PRO PROD;BAC PRO AG 21302 GEST MILIEUX NATURELS FAUNE;5;5;4;1;0;0;0;4;0;0;1;0;3;1
22566.0;2023;23;NICE;MASCULIN;APPRENTISSAGE;BAC PROFESSIONNEL;BAC PRO SERV;BAC PRO 31213 MET.COM.VEN.OP.A ANI.GES.ESP.COM.;61;58;38;18;2;0;2;38;0;3;11;7;17;20
22567.0;2023;23;NICE;MASCULIN;APPRENTISSAGE;BAC PROFESSIONNEL;BAC PRO SERV;BAC PRO 31214 MET.COM.VEN.OP.B PR.CL.VA.OF.COM.;4;4;4;0;0;0;0;4;0;1;0;0;3;0
22573.0;2023;23;NICE;MASCULIN;ENSEIGNEMENT A DISTANCE;BAC TECHNOLOGIQUE;BAC STMG;BAC STMG GESTION ET FINANCE;2;2;0;1;1;0;1;0;0;0;0;0;0;2
22575.0;2023;23;NICE;MASCULIN;ENSEIGNEMENT A DISTANCE;BAC TECHNOLOGIQUE;BAC STMG;BAC STMG RESSOURCES HUMAINES ET COMMUNICATION;1;1;1;0;0;0;0;1;0;0;0;1;0;0
22576.0;2023;23;NICE;MASCULIN;ENSEIGNEMENT A DISTANCE;BAC TECHNOLOGIQUE;BAC STMG;BAC STMG SYSTEMES D'INFORMATION DE GESTION;1;1;0;1;0;0;0;0;0;0;0;0;0;1
22580.0;2023;23;NICE;MASCULIN;FORMATION CONTINUE;BAC PROFESSIONNEL;BAC PRO SERV;BAC PRO 31213 MET.COM.VEN.OP.A ANI.GES.ESP.COM.;5;5;4;1;0;0;0;4;0;0;0;2;2;1
22583.0;2023;23;NICE;MASCULIN;INDIVIDUEL;BAC PROFESSIONNEL;BAC PRO PROD;BAC PRO 22106 CUISINE;2;2;1;1;0;0;0;1;0;0;0;0;1;1
22590.0;2023;23;NICE;MASCULIN;INDIVIDUEL;BAC PROFESSIONNEL;BAC PRO PROD;BAC PRO 25509 TECHNIC. FROID CONDITIONNEMT AIR;2;1;1;0;0;0;0;1;0;0;1;0;0;0
22601.0;2023;23;NICE;MASCULIN;INDIVIDUEL;BAC TECHNOLOGIQUE;BAC ST2S;BAC ST2S SCIENCES & TECHNO. SANTE & SOCIAL;1;1;0;1;0;0;0;0;0;0;0;0;0;1
22603.0;2023;23;NICE;MASCULIN;INDIVIDUEL;BAC TECHNOLOGIQUE;BAC STI2D;BAC STI2D SYSTÈME D'INFORMATION  ET NUMERIQUE;1;1;0;1;0;0;0;0;0;0;0;0;0;1
22604.0;2023;23;NICE;MASCULIN;INDIVIDUEL;BAC TECHNOLOGIQUE;BAC STL;BAC STL SCIENCES PHYSIQUES CHIMIQUES  EN LABORAT.;1;1;0;1;0;0;0;0;0;0;0;0;0;1
22606.0;2023;23;NICE;MASCULIN;INDIVIDUEL;BAC TECHNOLOGIQUE;BAC STMG;BAC STMG MERCATIQUE (MARKETING);23;23;9;10;4;3;1;12;0;0;1;3;8;11
22612.0;2023;23;NICE;MASCULIN;SCOLAIRE;BAC PROFESSIONNEL;BAC PRO PROD;BAC PRO 22106 CUISINE;143;140;120;15;5;3;2;123;0;5;28;51;39;17
22613.0;2023;23;NICE;MASCULIN;SCOLAIRE;BAC PROFESSIONNEL;BAC PRO PROD;BAC PRO 22403 ARTS.& MET.ART:MET.ENSEIGN SIGNA;5;5;5;0;0;0;0;5;0;0;0;3;2;0
22617.0;2023;23;NICE;MASCULIN;SCOLAIRE;BAC PROFESSIONNEL;BAC PRO PROD;BAC PRO 23005 TECHN. ETUDES BAT B ASSIST.ARCHI.;25;25;16;8;1;1;0;17;0;1;6;2;8;8
22625.0;2023;23;NICE;MASCULIN;SCOLAIRE;BAC PROFESSIONNEL;BAC PRO PROD;BAC PRO 23405 TECHNICIEN MENUISIER AGENCEUR;24;24;20;4;0;0;0;20;0;1;0;13;6;4
22629.0;2023;23;NICE;MASCULIN;SCOLAIRE;BAC PROFESSIONNEL;BAC PRO PROD;BAC PRO 24203 METIERS DE LA MODE - VÊTEMENT;5;5;5;0;0;0;0;5;0;0;1;3;1;0
22630.0;2023;23;NICE;MASCULIN;SCOLAIRE;BAC PROFESSIONNEL;BAC PRO PROD;BAC PRO 24302 METIERS DU CUIR : MAROQUINERIE;3;3;2;0;1;1;0;3;0;0;0;1;2;0
22633.0;2023;23;NICE;MASCULIN;SCOLAIRE;BAC PROFESSIONNEL;BAC PRO PROD;BAC PRO 25009 MAINTENANCE NAUTIQUE;48;48;37;11;0;0;0;37;0;1;6;10;20;11
22645.0;2023;23;NICE;MASCULIN;SCOLAIRE;BAC PROFESSIONNEL;BAC PRO PROD;BAC PRO 25513 SYST.NUM.OPT.A SURETE SECURITE;29;29;25;4;0;0;0;25;0;2;4;10;9;4
22647.0;2023;23;NICE;MASCULIN;SCOLAIRE;BAC PROFESSIONNEL;BAC PRO PROD;BAC PRO 25515 SYST.NUM.OPT.C RES.INF.SYST.COMM.;110;110;90;17;3;2;1;92;0;9;18;40;25;18
22651.0;2023;23;NICE;MASCULIN;SCOLAIRE;BAC PROFESSIONNEL;BAC PRO PROD;BAC PRO AG 21405 AMENAGEMENTS PAYSAGERS;47;46;44;2;0;0;0;44;0;1;8;15;20;2
22652.0;2023;23;NICE;MASCULIN;SCOLAIRE;BAC PROFESSIONNEL;BAC PRO PROD;BAC PRO AG 22105 LABORATOIRE CONTROLE QUALITE;12;11;10;1;0;0;0;10;0;0;0;3;7;1
22659.0;2023;23;NICE;MASCULIN;SCOLAIRE;BAC PROFESSIONNEL;BAC PRO SERV;BAC PRO 31214 MET.COM.VEN.OP.B PR.CL.VA.OF.COM.;181;181;148;24;9;7;2;155;0;4;23;62;66;26
22665.0;2023;23;NICE;MASCULIN;SCOLAIRE;BAC PROFESSIONNEL;BAC PRO SERV;BAC PRO 33006 ANIMAT. ENFANCE& PERSONNES AGEES;1;1;1;0;0;0;0;1;0;0;0;0;1;0
22667.0;2023;23;NICE;MASCULIN;SCOLAIRE;BAC PROFESSIONNEL;BAC PRO SERV;BAC PRO 33403 COMMERC. SERVICES EN RESTAURATION;70;69;53;13;3;3;0;56;0;2;6;21;27;13
22671.0;2023;23;NICE;MASCULIN;SCOLAIRE;BAC PROFESSIONNEL;BAC PRO SERV;BAC PRO AG 33002 SERV PERS TERRIT;7;7;6;1;0;0;0;6;0;1;0;3;2;1
22674.0;2023;23;NICE;MASCULIN;SCOLAIRE;BAC TECHNOLOGIQUE;BAC STAV;BAC STAV AGRONOMIE ALIM ENV TERRITOI;33;33;31;2;0;0;0;31;0;0;3;6;22;2
22675.0;2023;23;NICE;MASCULIN;SCOLAIRE;BAC TECHNOLOGIQUE;BAC STD2A;BAC STD2A SCIENCES & TECHNO. DESIGN-ARTS APPLIQUES;24;24;24;0;0;0;0;24;0;1;5;10;8;0
22678.0;2023;23;NICE;MASCULIN;SCOLAIRE;BAC TECHNOLOGIQUE;BAC STI2D;BAC STI2D ENERGIES  ET ENVIRONNEMENT;129;129;107;2;20;15;5;122;0;2;15;41;64;7
22680.0;2023;23;NICE;MASCULIN;SCOLAIRE;BAC TECHNOLOGIQUE;BAC STI2D;BAC STI2D SYSTÈME D'INFORMATION  ET NUMERIQUE;186;186;166;6;14;9;5;175;1;3;45;61;65;11
22686.0;2023;23;NICE;MASCULIN;SCOLAIRE;BAC TECHNOLOGIQUE;BAC STMG;BAC STMG SYSTEMES D'INFORMATION DE GESTION;15;15;14;1;0;0;0;14;0;0;1;9;4;1
22690.0;2023;70;NORMANDIE;FEMININ;APPRENTISSAGE;BAC PROFESSIONNEL;BAC PRO PROD;BAC PRO 22106 CUISINE;7;7;6;1;0;0;0;6;0;0;2;3;1;1
22696.0;2023;70;NORMANDIE;FEMININ;APPRENTISSAGE;BAC PROFESSIONNEL;BAC PRO PROD;BAC PRO 23404 TECHNICIEN CONSTRUCTEUR BOIS;2;2;2;0;0;0;0;2;0;0;2;0;0;0
22699.0;2023;70;NORMANDIE;FEMININ;APPRENTISSAGE;BAC PROFESSIONNEL;BAC PRO PROD;BAC PRO 24203 METIERS DE LA MODE - VÊTEMENT;2;2;1;1;0;0;0;1;0;0;1;0;0;1
22714.0;2023;70;NORMANDIE;FEMININ;APPRENTISSAGE;BAC PROFESSIONNEL;BAC PRO PROD;BAC PRO AG 21211 COND GEST ENTR HIPPIQUE;48;46;37;9;0;0;0;37;0;0;5;7;25;9
22723.0;2023;70;NORMANDIE;FEMININ;APPRENTISSAGE;BAC PROFESSIONNEL;BAC PRO SERV;BAC PRO 33403 COMMERC. SERVICES EN RESTAURATION;13;13;10;3;0;0;0;10;0;0;2;5;3;3
22724.0;2023;70;NORMANDIE;FEMININ;APPRENTISSAGE;BAC PROFESSIONNEL;BAC PRO SERV;BAC PRO 33603 ESTHETIQUE COSMETIQUE PARFUMERIE;1;1;1;0;0;0;0;1;0;0;1;0;0;0
22728.0;2023;70;NORMANDIE;FEMININ;ENSEIGNEMENT A DISTANCE;BAC GENERAL;BAC GENERAL;BAC GENE 10019 BAC GENERAL;98;98;62;18;18;12;6;74;0;2;10;22;40;24
22731.0;2023;70;NORMANDIE;FEMININ;ENSEIGNEMENT A DISTANCE;BAC PROFESSIONNEL;BAC PRO SERV;BAC PRO 31213 MET.COM.VEN.OP.A ANI.GES.ESP.COM.;7;3;2;1;0;0;0;2;0;0;0;2;0;1
22733.0;2023;70;NORMANDIE;FEMININ;ENSEIGNEMENT A DISTANCE;BAC PROFESSIONNEL;BAC PRO SERV;BAC PRO 33003 ACC.SOINS-S.PERS. OPT.A DOMICILE;2;1;0;1;0;0;0;0;0;0;0;0;0;1
22735.0;2023;70;NORMANDIE;FEMININ;ENSEIGNEMENT A DISTANCE;BAC PROFESSIONNEL;BAC PRO SERV;BAC PRO 33603 ESTHETIQUE COSMETIQUE PARFUMERIE;1;1;0;1;0;0;0;0;0;0;0;0;0;1
22757.0;2023;70;NORMANDIE;FEMININ;INDIVIDUEL;BAC PROFESSIONNEL;BAC PRO SERV;BAC PRO 31212 METIERS DE L'ACCUEIL;1;1;0;0;1;0;1;0;0;0;0;0;0;1
22765.0;2023;70;NORMANDIE;FEMININ;INDIVIDUEL;BAC PROFESSIONNEL;BAC PRO SERV;BAC PRO AG 33002 SERV PERS TERRIT;2;1;1;0;0;0;0;1;0;0;0;0;1;0
22779.0;2023;70;NORMANDIE;FEMININ;SCOLAIRE;BAC PROFESSIONNEL;BAC PRO PROD;BAC PRO 22503 PLASTIQUES ET COMPOSITES;2;2;0;1;1;1;0;1;0;0;0;0;1;1
22781.0;2023;70;NORMANDIE;FEMININ;SCOLAIRE;BAC PROFESSIONNEL;BAC PRO PROD;BAC PRO 23004 TECHN. ETUDES BAT.A ETUDES & ECO.;12;12;8;4;0;0;0;8;0;0;1;2;5;4
22787.0;2023;70;NORMANDIE;FEMININ;SCOLAIRE;BAC PROFESSIONNEL;BAC PRO PROD;BAC PRO 23406 TECHNICIEN DE SCIERIE;1;1;0;1;0;0;0;0;0;0;0;0;0;1
22792.0;2023;70;NORMANDIE;FEMININ;SCOLAIRE;BAC PROFESSIONNEL;BAC PRO PROD;BAC PRO 25006 MICROTECHNIQUES;2;2;2;0;0;0;0;2;0;1;1;0;0;0
22794.0;2023;70;NORMANDIE;FEMININ;SCOLAIRE;BAC PROFESSIONNEL;BAC PRO PROD;BAC PRO 25106 TECHNICIEN D'USINAGE;2;2;2;0;0;0;0;2;0;0;1;0;1;0
22795.0;2023;70;NORMANDIE;FEMININ;SCOLAIRE;BAC PROFESSIONNEL;BAC PRO PROD;BAC PRO 25107 TECHNICIEN OUTILLEUR;1;1;1;0;0;0;0;1;0;0;0;1;0;0
22797.0;2023;70;NORMANDIE;FEMININ;SCOLAIRE;BAC PROFESSIONNEL;BAC PRO PROD;BAC PRO 25215 MAINT.VEHIC.OPTB VEHIC.TRANS.ROUT;1;1;0;1;0;0;0;0;0;0;0;0;0;1
22799.0;2023;70;NORMANDIE;FEMININ;SCOLAIRE;BAC PROFESSIONNEL;BAC PRO PROD;BAC PRO 25219 MAINT.MATERIELS OPT.A AGRICOLES;4;4;4;0;0;0;0;4;0;0;0;3;1;0
22810.0;2023;70;NORMANDIE;FEMININ;SCOLAIRE;BAC PROFESSIONNEL;BAC PRO PROD;BAC PRO AG 21114 CONDUITE PRODUCTIONS HORTICOLES;15;14;12;2;0;0;0;12;0;0;3;2;7;2
22813.0;2023;70;NORMANDIE;FEMININ;SCOLAIRE;BAC PROFESSIONNEL;BAC PRO PROD;BAC PRO AG 21211 COND GEST ENTR HIPPIQUE;38;37;32;5;0;0;0;32;0;0;3;12;17;5
22814.0;2023;70;NORMANDIE;FEMININ;SCOLAIRE;BAC PROFESSIONNEL;BAC PRO PROD;BAC PRO AG 21302 GEST MILIEUX NATURELS FAUNE;13;13;11;2;0;0;0;11;0;0;0;3;8;2
22818.0;2023;70;NORMANDIE;FEMININ;SCOLAIRE;BAC PROFESSIONNEL;BAC PRO PROD;BAC PRO AG 22105 LABORATOIRE CONTROLE QUALITE;17;17;16;1;0;0;0;16;0;0;2;9;5;1
22839.0;2023;70;NORMANDIE;FEMININ;SCOLAIRE;BAC PROFESSIONNEL;BAC PRO SERV;BAC PRO 33604 METIERS DE LA COIFFURE;87;87;53;28;6;5;1;58;0;1;11;12;34;29
22850.0;2023;70;NORMANDIE;FEMININ;SCOLAIRE;BAC TECHNOLOGIQUE;BAC STI2D;BAC STI2D ARCHITECTURE ET CONSTRUCTION;38;38;36;1;1;1;0;37;0;3;9;13;12;1
22854.0;2023;70;NORMANDIE;FEMININ;SCOLAIRE;BAC TECHNOLOGIQUE;BAC STL;BAC STL BIOCHIM.-BIOLOGIE-BIOTECHNOL.;136;136;113;2;21;11;10;124;0;5;27;38;54;12
22861.0;2023;70;NORMANDIE;MASCULIN;APPRENTISSAGE;BAC PROFESSIONNEL;BAC PRO PROD;BAC PRO 22003 BIO-INDUSTRIES DE TRANSFORMATION;2;2;2;0;0;0;0;2;0;0;1;0;1;0
22866.0;2023;70;NORMANDIE;MASCULIN;APPRENTISSAGE;BAC PROFESSIONNEL;BAC PRO PROD;BAC PRO 23004 TECHN. ETUDES BAT.A ETUDES & ECO.;17;17;13;4;0;0;0;13;0;0;3;4;6;4
22879.0;2023;70;NORMANDIE;MASCULIN;APPRENTISSAGE;BAC PROFESSIONNEL;BAC PRO PROD;BAC PRO 25106 TECHNICIEN D'USINAGE;33;33;25;7;1;1;0;26;0;1;4;12;9;7
22883.0;2023;70;NORMANDIE;MASCULIN;APPRENTISSAGE;BAC PROFESSIONNEL;BAC PRO PROD;BAC PRO 25216 MAINT.VEHIC.OPTC MOTOCYCLES;21;20;17;2;1;0;1;17;0;2;1;6;8;3
22892.0;2023;70;NORMANDIE;MASCULIN;APPRENTISSAGE;BAC PROFESSIONNEL;BAC PRO PROD;BAC PRO 25510 METIERS ELECT. ENVIRON. CONNECTES;112;112;92;13;7;6;1;98;0;15;15;35;33;14
22906.0;2023;70;NORMANDIE;MASCULIN;APPRENTISSAGE;BAC PROFESSIONNEL;BAC PRO SERV;BAC PRO 31212 METIERS DE L'ACCUEIL;1;1;1;0;0;0;0;1;0;0;0;1;0;0
22907.0;2023;70;NORMANDIE;MASCULIN;APPRENTISSAGE;BAC PROFESSIONNEL;BAC PRO SERV;BAC PRO 31213 MET.COM.VEN.OP.A ANI.GES.ESP.COM.;121;117;85;19;13;8;5;93;0;4;22;24;43;24
22925.0;2023;70;NORMANDIE;MASCULIN;FORMATION CONTINUE;BAC PROFESSIONNEL;BAC PRO PROD;BAC PRO 22704 TECHN. MAINT. SYST.ENERG.CLIMATI;3;1;1;0;0;0;0;1;0;1;0;0;0;0
22933.0;2023;70;NORMANDIE;MASCULIN;FORMATION CONTINUE;BAC PROFESSIONNEL;BAC PRO SERV;BAC PRO 30004 ASSISTANC.GEST.ORGANIS.ACTIVITES;4;4;3;1;0;0;0;3;0;0;1;2;0;1
22934.0;2023;70;NORMANDIE;MASCULIN;FORMATION CONTINUE;BAC PROFESSIONNEL;BAC PRO SERV;BAC PRO 31114 ORGANIS. TRANSPORT MARCHANDISES;1;1;1;0;0;0;0;1;0;1;0;0;0;0
22957.0;2023;70;NORMANDIE;MASCULIN;INDIVIDUEL;BAC PROFESSIONNEL;BAC PRO SERV;BAC PRO 32303 ART.& MET.ART:COM.VIS.VIS.PLURI-M;1;0;0;0;0;0;0;0;0;0;0;0;0;0
22960.0;2023;70;NORMANDIE;MASCULIN;INDIVIDUEL;BAC PROFESSIONNEL;BAC PRO SERV;BAC PRO 33403 COMMERC. SERVICES EN RESTAURATION;1;1;0;1;0;0;0;0;0;0;0;0;0;1
22962.0;2023;70;NORMANDIE;MASCULIN;INDIVIDUEL;BAC PROFESSIONNEL;BAC PRO SERV;BAC PRO 34403 METIERS DE LA SECURITE;1;0;0;0;0;0;0;0;0;0;0;0;0;0
22964.0;2023;70;NORMANDIE;MASCULIN;INDIVIDUEL;BAC TECHNOLOGIQUE;BAC STI2D;BAC STI2D ARCHITECTURE ET CONSTRUCTION;2;2;0;1;1;0;1;0;0;0;0;0;0;2
22972.0;2023;70;NORMANDIE;MASCULIN;SCOLAIRE;BAC PROFESSIONNEL;BAC PRO PROD;BACPRO 20002 ETUD.DEFINITION PRDTS INDUSTRIEL;42;42;33;9;0;0;0;33;0;3;4;12;14;9
22984.0;2023;70;NORMANDIE;MASCULIN;SCOLAIRE;BAC PROFESSIONNEL;BAC PRO PROD;BAC PRO 23005 TECHN. ETUDES BAT B ASSIST.ARCHI.;25;25;21;3;1;0;1;21;0;0;6;4;11;4
22996.0;2023;70;NORMANDIE;MASCULIN;SCOLAIRE;BAC PROFESSIONNEL;BAC PRO PROD;BAC PRO 24203 METIERS DE LA MODE - VÊTEMENT;11;11;10;1;0;0;0;10;0;3;1;5;1;1
23000.0;2023;70;NORMANDIE;MASCULIN;SCOLAIRE;BAC PROFESSIONNEL;BAC PRO PROD;BAC PRO 25106 TECHNICIEN D'USINAGE;112;112;78;31;3;1;2;79;0;4;25;27;23;33
23005.0;2023;70;NORMANDIE;MASCULIN;SCOLAIRE;BAC PROFESSIONNEL;BAC PRO PROD;BAC PRO 25219 MAINT.MATERIELS OPT.A AGRICOLES;67;67;61;4;2;1;1;62;0;9;14;23;16;5
23011.0;2023;70;NORMANDIE;MASCULIN;SCOLAIRE;BAC PROFESSIONNEL;BAC PRO PROD;BAC PRO 25411 TECH.CHAUDRONNERIE INDUSTRIELLE;180;180;152;15;13;9;4;161;0;20;41;46;54;19
23014.0;2023;70;NORMANDIE;MASCULIN;SCOLAIRE;BAC PROFESSIONNEL;BAC PRO PROD;BAC PRO 25513 SYST.NUM.OPT.A SURETE SECURITE;55;55;43;7;5;5;0;48;0;1;11;16;20;7
23025.0;2023;70;NORMANDIE;MASCULIN;SCOLAIRE;BAC PROFESSIONNEL;BAC PRO PROD;BAC PRO AG 21303 FORET;40;40;35;5;0;0;0;35;0;0;2;10;23;5
23033.0;2023;70;NORMANDIE;MASCULIN;SCOLAIRE;BAC PROFESSIONNEL;BAC PRO SERV;BAC PRO 31114 ORGANIS. TRANSPORT MARCHANDISES;45;45;23;20;2;2;0;25;0;2;3;12;8;20
23051.0;2023;70;NORMANDIE;MASCULIN;SCOLAIRE;BAC PROFESSIONNEL;BAC PRO SERV;BAC PRO 34403 METIERS DE LA SECURITE;93;93;80;9;4;4;0;84;0;5;15;32;32;9
23054.0;2023;70;NORMANDIE;MASCULIN;SCOLAIRE;BAC TECHNOLOGIQUE;BAC S2TMD;BAC S2TMD MUSIQUE;14;14;13;0;1;1;0;14;0;2;4;4;4;0
23058.0;2023;70;NORMANDIE;MASCULIN;SCOLAIRE;BAC TECHNOLOGIQUE;BAC STHR;BAC STHR SC.&TEC. HOTELLERIE-RESTAURATION;49;49;47;0;2;1;1;48;0;3;11;21;13;1
23062.0;2023;70;NORMANDIE;MASCULIN;SCOLAIRE;BAC TECHNOLOGIQUE;BAC STI2D;BAC STI2D SYSTÈME D'INFORMATION  ET NUMERIQUE;405;405;364;9;32;14;18;378;1;20;68;152;137;27
23069.0;2023;18;ORLEANS-TOURS;FEMININ;APPRENTISSAGE;BAC PROFESSIONNEL;BAC PRO PROD;BAC PRO 22106 CUISINE;1;1;1;0;0;0;0;1;0;0;0;0;1;0
23070.0;2023;18;ORLEANS-TOURS;FEMININ;APPRENTISSAGE;BAC PROFESSIONNEL;BAC PRO PROD;BAC PRO 22704 TECHN. MAINT. SYST.ENERG.CLIMATI;1;1;0;1;0;0;0;0;0;0;0;0;0;1
23071.0;2023;18;ORLEANS-TOURS;FEMININ;APPRENTISSAGE;BAC PROFESSIONNEL;BAC PRO PROD;BAC PRO 23303 MENUISERIE ALUMINIUM-VERRE;1;1;0;1;0;0;0;0;0;0;0;0;0;1
23073.0;2023;18;ORLEANS-TOURS;FEMININ;APPRENTISSAGE;BAC PROFESSIONNEL;BAC PRO PROD;BAC PRO 25007 MAINTENANCE EQUIPEMENTS INDUST.;2;2;1;1;0;0;0;1;0;0;0;1;0;1
23076.0;2023;18;ORLEANS-TOURS;FEMININ;APPRENTISSAGE;BAC PROFESSIONNEL;BAC PRO PROD;BAC PRO 25215 MAINT.VEHIC.OPTB VEHIC.TRANS.ROUT;1;1;1;0;0;0;0;1;0;0;0;1;0;0
23103.0;2023;18;ORLEANS-TOURS;FEMININ;FORMATION CONTINUE;BAC PROFESSIONNEL;BAC PRO PROD;BAC PRO 25007 MAINTENANCE EQUIPEMENTS INDUST.;1;1;1;0;0;0;0;1;0;0;0;1;0;0
23110.0;2023;18;ORLEANS-TOURS;FEMININ;FORMATION CONTINUE;BAC PROFESSIONNEL;BAC PRO SERV;BAC PRO 31213 MET.COM.VEN.OP.A ANI.GES.ESP.COM.;2;2;1;1;0;0;0;1;0;0;0;0;1;1
23122.0;2023;18;ORLEANS-TOURS;FEMININ;INDIVIDUEL;BAC PROFESSIONNEL;BAC PRO SERV;BAC PRO 31213 MET.COM.VEN.OP.A ANI.GES.ESP.COM.;9;4;1;1;2;0;2;1;0;0;0;0;1;3
23125.0;2023;18;ORLEANS-TOURS;FEMININ;INDIVIDUEL;BAC PROFESSIONNEL;BAC PRO SERV;BAC PRO 33004 ACC.SOINS-S.PERS. OPT.EN STRUCTUR;6;4;3;1;0;0;0;3;0;0;0;1;2;1
23127.0;2023;18;ORLEANS-TOURS;FEMININ;INDIVIDUEL;BAC PROFESSIONNEL;BAC PRO SERV;BAC PRO 33603 ESTHETIQUE COSMETIQUE PARFUMERIE;3;3;0;3;0;0;0;0;0;0;0;0;0;3
23130.0;2023;18;ORLEANS-TOURS;FEMININ;INDIVIDUEL;BAC TECHNOLOGIQUE;BAC STI2D;BAC STI2D INNOVATION TECHNO.  ET ECO CONCEPTION;1;1;0;1;0;0;0;0;0;0;0;0;0;1
23135.0;2023;18;ORLEANS-TOURS;FEMININ;SCOLAIRE;BAC PROFESSIONNEL;BAC PRO PROD;BACPRO 20002 ETUD.DEFINITION PRDTS INDUSTRIEL;2;2;0;2;0;0;0;0;0;0;0;0;0;2
23138.0;2023;18;ORLEANS-TOURS;FEMININ;SCOLAIRE;BAC PROFESSIONNEL;BAC PRO PROD;BAC PRO 22105 BOULANGER-PÂTISSIER;14;14;13;1;0;0;0;13;0;2;4;3;4;1
23150.0;2023;18;ORLEANS-TOURS;FEMININ;SCOLAIRE;BAC PROFESSIONNEL;BAC PRO PROD;BAC PRO 23408 Etude et réalisation d'agencement;19;19;17;1;1;1;0;18;0;0;7;6;5;1
23158.0;2023;18;ORLEANS-TOURS;FEMININ;SCOLAIRE;BAC PROFESSIONNEL;BAC PRO PROD;BAC PRO 25108 TECHNICIEN MODELEUR;1;1;1;0;0;0;0;1;0;0;0;1;0;0
23159.0;2023;18;ORLEANS-TOURS;FEMININ;SCOLAIRE;BAC PROFESSIONNEL;BAC PRO PROD;BAC PRO 25214 MAINT.VEHIC.OPTA VOIT.PARTICUL.;12;12;11;0;1;1;0;12;0;1;3;5;3;0
23160.0;2023;18;ORLEANS-TOURS;FEMININ;SCOLAIRE;BAC PROFESSIONNEL;BAC PRO PROD;BAC PRO 25216 MAINT.VEHIC.OPTC MOTOCYCLES;1;1;1;0;0;0;0;1;0;1;0;0;0;0
23168.0;2023;18;ORLEANS-TOURS;FEMININ;SCOLAIRE;BAC PROFESSIONNEL;BAC PRO PROD;BAC PRO AG 21001 AGRO-EQUIPEMENT;1;1;1;0;0;0;0;1;0;0;0;1;0;0
23176.0;2023;18;ORLEANS-TOURS;FEMININ;SCOLAIRE;BAC PROFESSIONNEL;BAC PRO PROD;BAC PRO AG 21303 FORET;2;2;2;0;0;0;0;2;0;0;1;1;0;0
23180.0;2023;18;ORLEANS-TOURS;FEMININ;SCOLAIRE;BAC PROFESSIONNEL;BAC PRO PROD;BAC PRO AG 22108 TEC CONS VTE ALIMENTATION (PAB);16;15;11;4;0;0;0;11;0;0;0;5;6;4
23186.0;2023;18;ORLEANS-TOURS;FEMININ;SCOLAIRE;BAC PROFESSIONNEL;BAC PRO SERV;BAC PRO 31213 MET.COM.VEN.OP.A ANI.GES.ESP.COM.;378;378;325;36;17;14;3;339;0;12;58;134;135;39
23188.0;2023;18;ORLEANS-TOURS;FEMININ;SCOLAIRE;BAC PROFESSIONNEL;BAC PRO SERV;BAC PRO 32207 REAL.PR.IMPR.PLURI.OPTA.PR.GRAPH.;15;15;14;1;0;0;0;14;0;2;7;4;1;1
23191.0;2023;18;ORLEANS-TOURS;FEMININ;SCOLAIRE;BAC PROFESSIONNEL;BAC PRO SERV;BAC PRO 32304 PHOTOGRAPHIE;13;13;10;3;0;0;0;10;0;0;0;3;7;3
23195.0;2023;18;ORLEANS-TOURS;FEMININ;SCOLAIRE;BAC PROFESSIONNEL;BAC PRO SERV;BAC PRO 33104 TECHNICIEN EN PROTHESE DENTAIRE;10;10;10;0;0;0;0;10;0;1;3;6;0;0
23202.0;2023;18;ORLEANS-TOURS;FEMININ;SCOLAIRE;BAC TECHNOLOGIQUE;BAC S2TMD;BAC S2TMD DANSE;9;9;9;0;0;0;0;9;0;3;2;2;2;0
23220.0;2023;18;ORLEANS-TOURS;MASCULIN;APPRENTISSAGE;BAC PROFESSIONNEL;BAC PRO PROD;BAC PRO 22503 PLASTIQUES ET COMPOSITES;1;1;1;0;0;0;0;1;0;0;0;0;1;0
23228.0;2023;18;ORLEANS-TOURS;MASCULIN;APPRENTISSAGE;BAC PROFESSIONNEL;BAC PRO PROD;BAC PRO 23304 AMENAGEMENT FINITION BATIMENT;2;2;1;0;1;1;0;2;0;0;0;1;1;0
23235.0;2023;18;ORLEANS-TOURS;MASCULIN;APPRENTISSAGE;BAC PROFESSIONNEL;BAC PRO PROD;BAC PRO 25214 MAINT.VEHIC.OPTA VOIT.PARTICUL.;149;148;123;13;12;8;4;131;0;12;18;46;55;17
23237.0;2023;18;ORLEANS-TOURS;MASCULIN;APPRENTISSAGE;BAC PROFESSIONNEL;BAC PRO PROD;BAC PRO 25219 MAINT.MATERIELS OPT.A AGRICOLES;54;54;41;8;5;3;2;44;0;3;12;15;14;10
23262.0;2023;18;ORLEANS-TOURS;MASCULIN;APPRENTISSAGE;BAC PROFESSIONNEL;BAC PRO SERV;BAC PRO 32208 REAL.PR.IMPR.PLURI.OPTB.PR.IMPR.;3;3;3;0;0;0;0;3;0;0;1;1;1;0
23271.0;2023;18;ORLEANS-TOURS;MASCULIN;FORMATION CONTINUE;BAC PROFESSIONNEL;BAC PRO PROD;BAC PRO 23102 TRAVAUX PUBLICS;1;1;1;0;0;0;0;1;0;0;1;0;0;0
23279.0;2023;18;ORLEANS-TOURS;MASCULIN;FORMATION CONTINUE;BAC PROFESSIONNEL;BAC PRO PROD;BAC PRO 25302 AERONAUTIQUE OPTION AVIONIQUE;12;12;12;0;0;0;0;12;0;0;7;4;1;0
23282.0;2023;18;ORLEANS-TOURS;MASCULIN;FORMATION CONTINUE;BAC PROFESSIONNEL;BAC PRO PROD;BAC PRO 25509 TECHNIC. FROID CONDITIONNEMT AIR;1;1;1;0;0;0;0;1;0;0;0;0;1;0
23289.0;2023;18;ORLEANS-TOURS;MASCULIN;INDIVIDUEL;BAC PROFESSIONNEL;BAC PRO PROD;BAC PRO 23004 TECHN. ETUDES BAT.A ETUDES & ECO.;1;0;0;0;0;0;0;0;0;0;0;0;0;0
23301.0;2023;18;ORLEANS-TOURS;MASCULIN;INDIVIDUEL;BAC PROFESSIONNEL;BAC PRO PROD;BAC PRO AG 21405 AMENAGEMENTS PAYSAGERS;4;4;3;1;0;0;0;3;0;0;1;2;0;1
23316.0;2023;18;ORLEANS-TOURS;MASCULIN;INDIVIDUEL;BAC TECHNOLOGIQUE;BAC STMG;BAC STMG RESSOURCES HUMAINES ET COMMUNICATION;6;6;1;4;1;1;0;2;0;0;0;0;2;4
23317.0;2023;18;ORLEANS-TOURS;MASCULIN;SCOLAIRE;BAC GENERAL;BAC GENERAL;BAC GENE 10019 BAC GENERAL;5779;5779;5282;80;417;279;138;5561;102;606;1239;1802;1812;218
23323.0;2023;18;ORLEANS-TOURS;MASCULIN;SCOLAIRE;BAC PROFESSIONNEL;BAC PRO PROD;BAC PRO 22303 FONDERIE;4;4;3;0;1;0;1;3;0;0;0;2;1;1
23334.0;2023;18;ORLEANS-TOURS;MASCULIN;SCOLAIRE;BAC PROFESSIONNEL;BAC PRO PROD;BAC PRO 23205 INTERV. SUR PATRIMOINE BATI OPT.A;1;1;1;0;0;0;0;1;0;0;0;0;1;0
23343.0;2023;18;ORLEANS-TOURS;MASCULIN;SCOLAIRE;BAC PROFESSIONNEL;BAC PRO PROD;BAC PRO 24302 METIERS DU CUIR : MAROQUINERIE;3;3;2;1;0;0;0;2;0;0;0;1;1;1
23348.0;2023;18;ORLEANS-TOURS;MASCULIN;SCOLAIRE;BAC PROFESSIONNEL;BAC PRO PROD;BAC PRO 25107 TECHNICIEN OUTILLEUR;7;7;4;2;1;1;0;5;0;0;0;1;4;2
23355.0;2023;18;ORLEANS-TOURS;MASCULIN;SCOLAIRE;BAC PROFESSIONNEL;BAC PRO PROD;BAC PRO 25221 MAINT.MATERIELS OPT.C ESP. VERTS;9;9;2;6;1;1;0;3;0;0;1;0;2;6
23358.0;2023;18;ORLEANS-TOURS;MASCULIN;SCOLAIRE;BAC PROFESSIONNEL;BAC PRO PROD;BAC PRO 25410 CONSTRUCTION DES CARROSSERIES;4;4;4;0;0;0;0;4;0;0;0;2;2;0
23359.0;2023;18;ORLEANS-TOURS;MASCULIN;SCOLAIRE;BAC PROFESSIONNEL;BAC PRO PROD;BAC PRO 25411 TECH.CHAUDRONNERIE INDUSTRIELLE;80;80;67;9;4;3;1;70;0;8;19;14;29;10
23362.0;2023;18;ORLEANS-TOURS;MASCULIN;SCOLAIRE;BAC PROFESSIONNEL;BAC PRO PROD;BAC PRO 25513 SYST.NUM.OPT.A SURETE SECURITE;33;33;32;1;0;0;0;32;0;2;5;17;8;1
23366.0;2023;18;ORLEANS-TOURS;MASCULIN;SCOLAIRE;BAC PROFESSIONNEL;BAC PRO PROD;BAC PRO AG 21004 CGEA;166;165;135;30;0;0;0;135;0;1;17;46;71;30
23367.0;2023;18;ORLEANS-TOURS;MASCULIN;SCOLAIRE;BAC PROFESSIONNEL;BAC PRO PROD;BAC PRO AG 21113 CGEVV;8;8;7;1;0;0;0;7;0;2;1;3;1;1
23371.0;2023;18;ORLEANS-TOURS;MASCULIN;SCOLAIRE;BAC PROFESSIONNEL;BAC PRO PROD;BAC PRO AG 21212 TECH EXPE ANIMALE;8;8;8;0;0;0;0;8;0;0;3;3;2;0
23373.0;2023;18;ORLEANS-TOURS;MASCULIN;SCOLAIRE;BAC PROFESSIONNEL;BAC PRO PROD;BAC PRO AG 21303 FORET;16;16;16;0;0;0;0;16;0;0;1;7;8;0
23376.0;2023;18;ORLEANS-TOURS;MASCULIN;SCOLAIRE;BAC PROFESSIONNEL;BAC PRO PROD;BAC PRO AG 22105 LABORATOIRE CONTROLE QUALITE;6;6;6;0;0;0;0;6;0;0;0;2;4;0
23381.0;2023;18;ORLEANS-TOURS;MASCULIN;SCOLAIRE;BAC PROFESSIONNEL;BAC PRO SERV;BAC PRO 31114 ORGANIS. TRANSPORT MARCHANDISES;19;19;16;1;2;2;0;18;0;1;1;7;9;1
23386.0;2023;18;ORLEANS-TOURS;MASCULIN;SCOLAIRE;BAC PROFESSIONNEL;BAC PRO SERV;BAC PRO 32208 REAL.PR.IMPR.PLURI.OPTB.PR.IMPR.;12;12;11;1;0;0;0;11;0;0;0;3;8;1
23392.0;2023;18;ORLEANS-TOURS;MASCULIN;SCOLAIRE;BAC PROFESSIONNEL;BAC PRO SERV;BAC PRO 33006 ANIMAT. ENFANCE& PERSONNES AGEES;34;34;27;4;3;2;1;29;0;2;7;12;8;5
23394.0;2023;18;ORLEANS-TOURS;MASCULIN;SCOLAIRE;BAC PROFESSIONNEL;BAC PRO SERV;BAC PRO 33403 COMMERC. SERVICES EN RESTAURATION;84;84;63;15;6;5;1;68;0;2;11;26;29;16
23398.0;2023;18;ORLEANS-TOURS;MASCULIN;SCOLAIRE;BAC PROFESSIONNEL;BAC PRO SERV;BAC PRO 34403 METIERS DE LA SECURITE;51;51;46;5;0;0;0;46;0;5;13;14;14;5
23403.0;2023;18;ORLEANS-TOURS;MASCULIN;SCOLAIRE;BAC TECHNOLOGIQUE;BAC STAV;BAC STAV AGRONOMIE ALIM ENV TERRITOI;107;107;101;6;0;0;0;101;0;0;10;40;51;6
23405.0;2023;18;ORLEANS-TOURS;MASCULIN;SCOLAIRE;BAC TECHNOLOGIQUE;BAC STHR;BAC STHR SC.&TEC. HOTELLERIE-RESTAURATION;50;50;49;0;1;0;1;49;1;4;3;23;18;1
23409.0;2023;18;ORLEANS-TOURS;MASCULIN;SCOLAIRE;BAC TECHNOLOGIQUE;BAC STI2D;BAC STI2D SYSTÈME D'INFORMATION  ET NUMERIQUE;389;389;348;9;32;20;12;368;2;9;75;132;150;21
23417.0;2023;01;PARIS;FEMININ;APPRENTISSAGE;BAC PROFESSIONNEL;BAC PRO PROD;BAC PRO 22105 BOULANGER-PÂTISSIER;26;26;24;0;2;0;2;24;0;5;9;7;3;2
23418.0;2023;01;PARIS;FEMININ;APPRENTISSAGE;BAC PROFESSIONNEL;BAC PRO PROD;BAC PRO 22106 CUISINE;29;29;26;3;0;0;0;26;0;5;8;9;4;3
23419.0;2023;01;PARIS;FEMININ;APPRENTISSAGE;BAC PROFESSIONNEL;BAC PRO PROD;BAC PRO 22704 TECHN. MAINT. SYST.ENERG.CLIMATI;1;1;1;0;0;0;0;1;0;1;0;0;0;0
23420.0;2023;01;PARIS;FEMININ;APPRENTISSAGE;BAC PROFESSIONNEL;BAC PRO PROD;BAC PRO 23004 TECHN. ETUDES BAT.A ETUDES & ECO.;2;2;2;0;0;0;0;2;0;0;0;1;1;0
23421.0;2023;01;PARIS;FEMININ;APPRENTISSAGE;BAC PROFESSIONNEL;BAC PRO PROD;BAC PRO 23005 TECHN. ETUDES BAT B ASSIST.ARCHI.;3;3;2;1;0;0;0;2;0;0;1;1;0;1
23422.0;2023;01;PARIS;FEMININ;APPRENTISSAGE;BAC PROFESSIONNEL;BAC PRO PROD;BAC PRO 25510 METIERS ELECT. ENVIRON. CONNECTES;2;2;0;2;0;0;0;0;0;0;0;0;0;2
23425.0;2023;01;PARIS;FEMININ;APPRENTISSAGE;BAC PROFESSIONNEL;BAC PRO SERV;BAC PRO 31212 METIERS DE L'ACCUEIL;18;18;14;3;1;0;1;14;0;2;2;7;3;4
23436.0;2023;01;PARIS;FEMININ;ENSEIGNEMENT A DISTANCE;BAC PROFESSIONNEL;BAC PRO SERV;BAC PRO 30004 ASSISTANC.GEST.ORGANIS.ACTIVITES;2;2;2;0;0;0;0;2;0;0;0;1;1;0
23444.0;2023;01;PARIS;FEMININ;FORMATION CONTINUE;BAC PROFESSIONNEL;BAC PRO SERV;BAC PRO 33003 ACC.SOINS-S.PERS. OPT.A DOMICILE;3;3;2;0;1;1;0;3;0;0;0;1;2;0
23447.0;2023;01;PARIS;FEMININ;INDIVIDUEL;BAC PROFESSIONNEL;BAC PRO PROD;BAC PRO 25214 MAINT.VEHIC.OPTA VOIT.PARTICUL.;2;1;1;0;0;0;0;1;0;0;1;0;0;0
23453.0;2023;01;PARIS;FEMININ;INDIVIDUEL;BAC PROFESSIONNEL;BAC PRO PROD;BAC PRO AG 21405 AMENAGEMENTS PAYSAGERS;1;1;1;0;0;0;0;1;0;0;0;0;1;0
23454.0;2023;01;PARIS;FEMININ;INDIVIDUEL;BAC PROFESSIONNEL;BAC PRO SERV;BAC PRO 30004 ASSISTANC.GEST.ORGANIS.ACTIVITES;4;2;1;1;0;0;0;1;0;0;0;1;0;1
23455.0;2023;01;PARIS;FEMININ;INDIVIDUEL;BAC PROFESSIONNEL;BAC PRO SERV;BAC PRO 31212 METIERS DE L'ACCUEIL;5;3;1;1;1;0;1;1;0;0;0;0;1;2
23463.0;2023;01;PARIS;FEMININ;INDIVIDUEL;BAC PROFESSIONNEL;BAC PRO SERV;BAC PRO 33603 ESTHETIQUE COSMETIQUE PARFUMERIE;2;1;0;1;0;0;0;0;0;0;0;0;0;1
23468.0;2023;01;PARIS;FEMININ;INDIVIDUEL;BAC TECHNOLOGIQUE;BAC STL;BAC STL SCIENCES PHYSIQUES CHIMIQUES  EN LABORAT.;1;1;0;1;0;0;0;0;0;0;0;0;0;1
23472.0;2023;01;PARIS;FEMININ;INDIVIDUEL;BAC TECHNOLOGIQUE;BAC STMG;BAC STMG SYSTEMES D'INFORMATION DE GESTION;1;1;0;1;0;0;0;0;0;0;0;0;0;1
23473.0;2023;01;PARIS;FEMININ;SCOLAIRE;BAC GENERAL;BAC GENERAL;BAC GENE 10019 BAC GENERAL;8523;8523;8118;104;301;225;76;8343;259;1857;2615;2179;1433;180
23476.0;2023;01;PARIS;FEMININ;SCOLAIRE;BAC PROFESSIONNEL;BAC PRO PROD;BAC PRO 22003 BIO-INDUSTRIES DE TRANSFORMATION;14;14;10;3;1;0;1;10;0;0;2;4;4;4
23479.0;2023;01;PARIS;FEMININ;SCOLAIRE;BAC PROFESSIONNEL;BAC PRO PROD;BAC PRO 22402 ARTIS.& MET.ART:VERR.SCIENT.TECH;6;6;5;1;0;0;0;5;0;1;1;2;1;1
23482.0;2023;01;PARIS;FEMININ;SCOLAIRE;BAC PROFESSIONNEL;BAC PRO PROD;BAC PRO 23004 TECHN. ETUDES BAT.A ETUDES & ECO.;2;2;2;0;0;0;0;2;0;0;0;1;1;0
23483.0;2023;01;PARIS;FEMININ;SCOLAIRE;BAC PROFESSIONNEL;BAC PRO PROD;BAC PRO 23005 TECHN. ETUDES BAT B ASSIST.ARCHI.;5;5;4;1;0;0;0;4;0;0;2;1;1;1
23489.0;2023;01;PARIS;FEMININ;SCOLAIRE;BAC PROFESSIONNEL;BAC PRO PROD;BAC PRO 24203 METIERS DE LA MODE - VÊTEMENT;122;122;101;19;2;2;0;103;0;17;33;28;25;19
23492.0;2023;01;PARIS;FEMININ;SCOLAIRE;BAC PROFESSIONNEL;BAC PRO PROD;BAC PRO 25007 MAINTENANCE EQUIPEMENTS INDUST.;1;1;0;1;0;0;0;0;0;0;0;0;0;1
23500.0;2023;01;PARIS;FEMININ;SCOLAIRE;BAC PROFESSIONNEL;BAC PRO SERV;BAC PRO 31114 ORGANIS. TRANSPORT MARCHANDISES;3;3;3;0;0;0;0;3;0;0;0;1;2;0
23501.0;2023;01;PARIS;FEMININ;SCOLAIRE;BAC PROFESSIONNEL;BAC PRO SERV;BAC PRO 31212 METIERS DE L'ACCUEIL;145;145;98;34;13;5;8;103;0;10;19;29;45;42
23503.0;2023;01;PARIS;FEMININ;SCOLAIRE;BAC PROFESSIONNEL;BAC PRO SERV;BAC PRO 31214 MET.COM.VEN.OP.B PR.CL.VA.OF.COM.;57;57;49;4;4;2;2;51;0;0;9;25;17;6
23513.0;2023;01;PARIS;FEMININ;SCOLAIRE;BAC PROFESSIONNEL;BAC PRO SERV;BAC PRO 33103 TECHNICIEN APPAREIL. ORTHOPEDIQUE;8;8;5;3;0;0;0;5;0;0;1;3;1;3
23516.0;2023;01;PARIS;FEMININ;SCOLAIRE;BAC PROFESSIONNEL;BAC PRO SERV;BAC PRO 33602 PERRUQUIER POSTICHEUR;7;7;5;2;0;0;0;5;0;3;0;1;1;2
23523.0;2023;01;PARIS;FEMININ;SCOLAIRE;BAC TECHNOLOGIQUE;BAC S2TMD;BAC S2TMD THEATRE;6;6;6;0;0;0;0;6;1;0;2;1;2;0
23525.0;2023;01;PARIS;FEMININ;SCOLAIRE;BAC TECHNOLOGIQUE;BAC STD2A;BAC STD2A SCIENCES & TECHNO. DESIGN-ARTS APPLIQUES;188;188;186;1;1;1;0;187;0;15;61;77;34;1
23528.0;2023;01;PARIS;FEMININ;SCOLAIRE;BAC TECHNOLOGIQUE;BAC STI2D;BAC STI2D ENERGIES  ET ENVIRONNEMENT;4;4;0;1;3;3;0;3;0;0;0;0;3;1
23537.0;2023;01;PARIS;MASCULIN;APPRENTISSAGE;BAC PROFESSIONNEL;BAC PRO PROD;BAC PRO 22004 PROC. CHIMIE EAU PAPIERS-CARTONS;6;6;6;0;0;0;0;6;0;0;0;2;4;0
23549.0;2023;01;PARIS;MASCULIN;APPRENTISSAGE;BAC PROFESSIONNEL;BAC PRO SERV;BAC PRO 30004 ASSISTANC.GEST.ORGANIS.ACTIVITES;16;16;10;4;2;1;1;11;0;1;0;5;5;5
23558.0;2023;01;PARIS;MASCULIN;APPRENTISSAGE;BAC PROFESSIONNEL;BAC PRO SERV;BAC PRO 33104 TECHNICIEN EN PROTHESE DENTAIRE;2;2;2;0;0;0;0;2;0;0;1;1;0;0
23559.0;2023;01;PARIS;MASCULIN;APPRENTISSAGE;BAC PROFESSIONNEL;BAC PRO SERV;BAC PRO 33403 COMMERC. SERVICES EN RESTAURATION;59;59;42;13;4;3;1;45;0;3;7;17;18;14
23561.0;2023;01;PARIS;MASCULIN;ENSEIGNEMENT A DISTANCE;BAC GENERAL;BAC GENERAL;BAC GENE 10019 BAC GENERAL;32;32;16;8;8;6;2;22;0;0;2;8;12;10
23577.0;2023;01;PARIS;MASCULIN;INDIVIDUEL;BAC PROFESSIONNEL;BAC PRO PROD;BACPRO 20002 ETUD.DEFINITION PRDTS INDUSTRIEL;1;1;0;1;0;0;0;0;0;0;0;0;0;1
23585.0;2023;01;PARIS;MASCULIN;INDIVIDUEL;BAC PROFESSIONNEL;BAC PRO SERV;BAC PRO 30004 ASSISTANC.GEST.ORGANIS.ACTIVITES;7;5;2;2;1;0;1;2;0;0;0;0;2;3
23589.0;2023;01;PARIS;MASCULIN;INDIVIDUEL;BAC PROFESSIONNEL;BAC PRO SERV;BAC PRO 32303 ART.& MET.ART:COM.VIS.VIS.PLURI-M;2;0;0;0;0;0;0;0;0;0;0;0;0;0
23593.0;2023;01;PARIS;MASCULIN;INDIVIDUEL;BAC TECHNOLOGIQUE;BAC STI2D;BAC STI2D ARCHITECTURE ET CONSTRUCTION;1;1;0;1;0;0;0;0;0;0;0;0;0;1
23597.0;2023;01;PARIS;MASCULIN;INDIVIDUEL;BAC TECHNOLOGIQUE;BAC STL;BAC STL SCIENCES PHYSIQUES CHIMIQUES  EN LABORAT.;1;1;0;1;0;0;0;0;0;0;0;0;0;1
23598.0;2023;01;PARIS;MASCULIN;INDIVIDUEL;BAC TECHNOLOGIQUE;BAC STMG;BAC STMG GESTION ET FINANCE;20;20;9;5;6;6;0;15;0;1;1;4;9;5
23601.0;2023;01;PARIS;MASCULIN;INDIVIDUEL;BAC TECHNOLOGIQUE;BAC STMG;BAC STMG SYSTEMES D'INFORMATION DE GESTION;12;12;6;4;2;2;0;8;0;1;0;4;3;4
23607.0;2023;01;PARIS;MASCULIN;SCOLAIRE;BAC PROFESSIONNEL;BAC PRO PROD;BAC PRO 22105 BOULANGER-PÂTISSIER;2;2;2;0;0;0;0;2;0;0;0;0;2;0
23608.0;2023;01;PARIS;MASCULIN;SCOLAIRE;BAC PROFESSIONNEL;BAC PRO PROD;BAC PRO 22106 CUISINE;62;62;54;6;2;2;0;56;0;1;5;24;26;6
23612.0;2023;01;PARIS;MASCULIN;SCOLAIRE;BAC PROFESSIONNEL;BAC PRO PROD;BAC PRO 22704 TECHN. MAINT. SYST.ENERG.CLIMATI;14;14;4;10;0;0;0;4;0;0;0;1;3;10
23613.0;2023;01;PARIS;MASCULIN;SCOLAIRE;BAC PROFESSIONNEL;BAC PRO PROD;BAC PRO 23003 ARTIS. & M.ART:MARCHANDISAGE VIS.;1;1;0;1;0;0;0;0;0;0;0;0;0;1
23619.0;2023;01;PARIS;MASCULIN;SCOLAIRE;BAC PROFESSIONNEL;BAC PRO PROD;BAC PRO 23303 MENUISERIE ALUMINIUM-VERRE;9;9;5;2;2;1;1;6;0;0;0;2;4;3
23623.0;2023;01;PARIS;MASCULIN;SCOLAIRE;BAC PROFESSIONNEL;BAC PRO PROD;BAC PRO 23408 Etude et réalisation d'agencement;5;5;4;1;0;0;0;4;0;0;1;3;0;1
23629.0;2023;01;PARIS;MASCULIN;SCOLAIRE;BAC PROFESSIONNEL;BAC PRO PROD;BAC PRO 25007 MAINTENANCE EQUIPEMENTS INDUST.;23;23;19;2;2;1;1;20;0;2;3;7;8;3
23631.0;2023;01;PARIS;MASCULIN;SCOLAIRE;BAC PROFESSIONNEL;BAC PRO PROD;BAC PRO 25107 TECHNICIEN OUTILLEUR;4;4;4;0;0;0;0;4;0;0;1;1;2;0
23640.0;2023;01;PARIS;MASCULIN;SCOLAIRE;BAC PROFESSIONNEL;BAC PRO PROD;BAC PRO 25515 SYST.NUM.OPT.C RES.INF.SYST.COMM.;176;175;142;25;8;6;2;148;0;8;30;51;59;27
23646.0;2023;01;PARIS;MASCULIN;SCOLAIRE;BAC PROFESSIONNEL;BAC PRO SERV;BAC PRO 31212 METIERS DE L'ACCUEIL;113;113;67;34;12;7;5;74;0;4;9;21;40;39
23647.0;2023;01;PARIS;MASCULIN;SCOLAIRE;BAC PROFESSIONNEL;BAC PRO SERV;BAC PRO 31213 MET.COM.VEN.OP.A ANI.GES.ESP.COM.;305;305;223;63;19;14;5;237;0;7;35;90;105;68
23650.0;2023;01;PARIS;MASCULIN;SCOLAIRE;BAC PROFESSIONNEL;BAC PRO SERV;BAC PRO 32207 REAL.PR.IMPR.PLURI.OPTA.PR.GRAPH.;15;15;11;4;0;0;0;11;0;0;1;3;7;4
23655.0;2023;01;PARIS;MASCULIN;SCOLAIRE;BAC PROFESSIONNEL;BAC PRO SERV;BAC PRO 33004 ACC.SOINS-S.PERS. OPT.EN STRUCTUR;8;8;6;2;0;0;0;6;0;0;2;1;3;2
23657.0;2023;01;PARIS;MASCULIN;SCOLAIRE;BAC PROFESSIONNEL;BAC PRO SERV;BAC PRO 33101 OPTIQUE LUNETTERIE;8;8;6;2;0;0;0;6;0;0;1;4;1;2
23660.0;2023;01;PARIS;MASCULIN;SCOLAIRE;BAC PROFESSIONNEL;BAC PRO SERV;BAC PRO 33403 COMMERC. SERVICES EN RESTAURATION;35;35;25;8;2;1;1;26;0;3;4;13;6;9
23667.0;2023;01;PARIS;MASCULIN;SCOLAIRE;BAC TECHNOLOGIQUE;BAC S2TMD;BAC S2TMD THEATRE;5;5;5;0;0;0;0;5;0;0;3;0;2;0
23673.0;2023;01;PARIS;MASCULIN;SCOLAIRE;BAC TECHNOLOGIQUE;BAC STI2D;BAC STI2D INNOVATION TECHNO.  ET ECO CONCEPTION;177;177;135;10;32;24;8;159;0;6;24;50;79;18
23683.0;2023;13;POITIERS;FEMININ;APPRENTISSAGE;BAC PROFESSIONNEL;BAC PRO PROD;BAC PRO 22106 CUISINE;5;5;4;1;0;0;0;4;0;1;0;1;2;1
23684.0;2023;13;POITIERS;FEMININ;APPRENTISSAGE;BAC PROFESSIONNEL;BAC PRO PROD;BAC PRO 23408 Etude et réalisation d'agencement;4;4;4;0;0;0;0;4;0;0;2;2;0;0
23685.0;2023;13;POITIERS;FEMININ;APPRENTISSAGE;BAC PROFESSIONNEL;BAC PRO PROD;BAC PRO 24302 METIERS DU CUIR : MAROQUINERIE;1;1;1;0;0;0;0;1;0;0;1;0;0;0
23687.0;2023;13;POITIERS;FEMININ;APPRENTISSAGE;BAC PROFESSIONNEL;BAC PRO PROD;BAC PRO 25214 MAINT.VEHIC.OPTA VOIT.PARTICUL.;7;7;7;0;0;0;0;7;0;1;3;0;3;0
23688.0;2023;13;POITIERS;FEMININ;APPRENTISSAGE;BAC PROFESSIONNEL;BAC PRO PROD;BAC PRO 25215 MAINT.VEHIC.OPTB VEHIC.TRANS.ROUT;2;2;1;0;1;1;0;2;0;0;1;0;1;0
23695.0;2023;13;POITIERS;FEMININ;APPRENTISSAGE;BAC PROFESSIONNEL;BAC PRO PROD;BAC PRO AG 21210 COND GEST ENTR CANIN ET FELIN;4;4;3;1;0;0;0;3;0;0;0;1;2;1
23696.0;2023;13;POITIERS;FEMININ;APPRENTISSAGE;BAC PROFESSIONNEL;BAC PRO PROD;BAC PRO AG 21405 AMENAGEMENTS PAYSAGERS;3;3;3;0;0;0;0;3;0;0;0;2;1;0
23714.0;2023;13;POITIERS;FEMININ;ENSEIGNEMENT A DISTANCE;BAC TECHNOLOGIQUE;BAC STMG;BAC STMG GESTION ET FINANCE;1;1;0;0;1;1;0;1;0;0;0;0;1;0
23727.0;2023;13;POITIERS;FEMININ;INDIVIDUEL;BAC PROFESSIONNEL;BAC PRO SERV;BAC PRO 33002 SERVICES DE PROXIMITE  VIE LOCAL;1;0;0;0;0;0;0;0;0;0;0;0;0;0
23728.0;2023;13;POITIERS;FEMININ;INDIVIDUEL;BAC PROFESSIONNEL;BAC PRO SERV;BAC PRO 33004 ACC.SOINS-S.PERS. OPT.EN STRUCTUR;1;0;0;0;0;0;0;0;0;0;0;0;0;0
23729.0;2023;13;POITIERS;FEMININ;INDIVIDUEL;BAC PROFESSIONNEL;BAC PRO SERV;BAC PRO 33603 ESTHETIQUE COSMETIQUE PARFUMERIE;2;1;0;1;0;0;0;0;0;0;0;0;0;1
23736.0;2023;13;POITIERS;FEMININ;SCOLAIRE;BAC PROFESSIONNEL;BAC PRO PROD;BACPRO 20002 ETUD.DEFINITION PRDTS INDUSTRIEL;1;1;1;0;0;0;0;1;0;0;0;0;1;0
23741.0;2023;13;POITIERS;FEMININ;SCOLAIRE;BAC PROFESSIONNEL;BAC PRO PROD;BAC PRO 22106 CUISINE;38;38;35;3;0;0;0;35;0;3;9;16;7;3
23744.0;2023;13;POITIERS;FEMININ;SCOLAIRE;BAC PROFESSIONNEL;BAC PRO PROD;BAC PRO 23005 TECHN. ETUDES BAT B ASSIST.ARCHI.;22;22;20;1;1;1;0;21;0;0;4;10;7;1
23747.0;2023;13;POITIERS;FEMININ;SCOLAIRE;BAC PROFESSIONNEL;BAC PRO PROD;BAC PRO 23304 AMENAGEMENT FINITION BATIMENT;12;12;12;0;0;0;0;12;0;0;3;6;3;0
23751.0;2023;13;POITIERS;FEMININ;SCOLAIRE;BAC PROFESSIONNEL;BAC PRO PROD;BAC PRO 24302 METIERS DU CUIR : MAROQUINERIE;8;8;8;0;0;0;0;8;0;1;5;1;1;0
23753.0;2023;13;POITIERS;FEMININ;SCOLAIRE;BAC PROFESSIONNEL;BAC PRO PROD;BAC PRO 25007 MAINTENANCE EQUIPEMENTS INDUST.;2;2;1;1;0;0;0;1;0;0;0;0;1;1
23761.0;2023;13;POITIERS;FEMININ;SCOLAIRE;BAC PROFESSIONNEL;BAC PRO PROD;BAC PRO 25411 TECH.CHAUDRONNERIE INDUSTRIELLE;3;3;3;0;0;0;0;3;0;0;0;2;1;0
23768.0;2023;13;POITIERS;FEMININ;SCOLAIRE;BAC PROFESSIONNEL;BAC PRO PROD;BAC PRO AG 21203 TECHN CONSEIL DE VENTE ANIMAL;29;28;22;6;0;0;0;22;0;0;1;9;12;6
23771.0;2023;13;POITIERS;FEMININ;SCOLAIRE;BAC PROFESSIONNEL;BAC PRO PROD;BAC PRO AG 21211 COND GEST ENTR HIPPIQUE;70;68;62;6;0;0;0;62;0;2;8;21;31;6
23772.0;2023;13;POITIERS;FEMININ;SCOLAIRE;BAC PROFESSIONNEL;BAC PRO PROD;BAC PRO AG 21302 GEST MILIEUX NATURELS FAUNE;22;22;19;3;0;0;0;19;0;1;4;6;8;3
23773.0;2023;13;POITIERS;FEMININ;SCOLAIRE;BAC PROFESSIONNEL;BAC PRO PROD;BAC PRO AG 21303 FORET;1;1;1;0;0;0;0;1;0;0;0;0;1;0
23775.0;2023;13;POITIERS;FEMININ;SCOLAIRE;BAC PROFESSIONNEL;BAC PRO PROD;BAC PRO AG 21407 TEC CONS VTE UNIVERS JARDINERIE;21;21;20;1;0;0;0;20;0;0;1;6;13;1
23779.0;2023;13;POITIERS;FEMININ;SCOLAIRE;BAC PROFESSIONNEL;BAC PRO SERV;BAC PRO 31106 LOGISTIQUE;7;7;7;0;0;0;0;7;0;0;1;2;4;0
23785.0;2023;13;POITIERS;FEMININ;SCOLAIRE;BAC PROFESSIONNEL;BAC PRO SERV;BAC PRO 32207 REAL.PR.IMPR.PLURI.OPTA.PR.GRAPH.;6;6;6;0;0;0;0;6;0;2;2;1;1;0
23801.0;2023;13;POITIERS;FEMININ;SCOLAIRE;BAC TECHNOLOGIQUE;BAC STHR;BAC STHR SC.&TEC. HOTELLERIE-RESTAURATION;39;39;38;0;1;0;1;38;0;3;14;13;8;1
23811.0;2023;13;POITIERS;FEMININ;SCOLAIRE;BAC TECHNOLOGIQUE;BAC STMG;BAC STMG SYSTEMES D'INFORMATION DE GESTION;8;8;7;0;1;1;0;8;0;0;0;3;5;0
23813.0;2023;13;POITIERS;MASCULIN;APPRENTISSAGE;BAC PROFESSIONNEL;BAC PRO PROD;BAC PRO 22004 PROC. CHIMIE EAU PAPIERS-CARTONS;5;5;5;0;0;0;0;5;0;2;1;2;0;0
23815.0;2023;13;POITIERS;MASCULIN;APPRENTISSAGE;BAC PROFESSIONNEL;BAC PRO PROD;BAC PRO 22703 TECHN.INSTALL.SYST.ENERG.CLIMATI;6;6;5;1;0;0;0;5;0;1;1;1;2;1
23823.0;2023;13;POITIERS;MASCULIN;APPRENTISSAGE;BAC PROFESSIONNEL;BAC PRO PROD;BAC PRO 23407 TECHNIC.FAB.BOIS ET MATERX ASSOC;13;13;8;5;0;0;0;8;0;2;1;2;3;5
23825.0;2023;13;POITIERS;MASCULIN;APPRENTISSAGE;BAC PROFESSIONNEL;BAC PRO PROD;BAC PRO 25009 MAINTENANCE NAUTIQUE;9;9;9;0;0;0;0;9;0;0;1;5;3;0
23828.0;2023;13;POITIERS;MASCULIN;APPRENTISSAGE;BAC PROFESSIONNEL;BAC PRO PROD;BAC PRO 25215 MAINT.VEHIC.OPTB VEHIC.TRANS.ROUT;35;35;29;5;1;1;0;30;0;0;6;13;11;5
23833.0;2023;13;POITIERS;MASCULIN;APPRENTISSAGE;BAC PROFESSIONNEL;BAC PRO PROD;BAC PRO 25406 OUVRAGES DU BATIMENT METALLERIE;7;7;3;1;3;1;2;4;0;0;0;2;2;3
23835.0;2023;13;POITIERS;MASCULIN;APPRENTISSAGE;BAC PROFESSIONNEL;BAC PRO PROD;BAC PRO 25411 TECH.CHAUDRONNERIE INDUSTRIELLE;54;54;45;5;4;4;0;49;0;4;11;17;17;5
23838.0;2023;13;POITIERS;MASCULIN;APPRENTISSAGE;BAC PROFESSIONNEL;BAC PRO PROD;BAC PRO 25513 SYST.NUM.OPT.A SURETE SECURITE;6;6;6;0;0;0;0;6;0;1;4;0;1;0
23839.0;2023;13;POITIERS;MASCULIN;APPRENTISSAGE;BAC PROFESSIONNEL;BAC PRO PROD;BAC PRO 25515 SYST.NUM.OPT.C RES.INF.SYST.COMM.;3;3;2;1;0;0;0;2;0;0;1;1;0;1
23841.0;2023;13;POITIERS;MASCULIN;APPRENTISSAGE;BAC PROFESSIONNEL;BAC PRO PROD;BAC PRO AG 21004 CGEA;59;58;48;10;0;0;0;48;0;0;2;9;37;10
23843.0;2023;13;POITIERS;MASCULIN;APPRENTISSAGE;BAC PROFESSIONNEL;BAC PRO PROD;BAC PRO AG 21203 TECHN CONSEIL DE VENTE ANIMAL;5;5;5;0;0;0;0;5;0;0;0;3;2;0
23847.0;2023;13;POITIERS;MASCULIN;APPRENTISSAGE;BAC PROFESSIONNEL;BAC PRO PROD;BAC PRO AG 22108 TEC CONS VTE ALIMENTATION (PAB);18;18;15;3;0;0;0;15;0;0;1;6;8;3
23852.0;2023;13;POITIERS;MASCULIN;APPRENTISSAGE;BAC PROFESSIONNEL;BAC PRO SERV;BAC PRO 32207 REAL.PR.IMPR.PLURI.OPTA.PR.GRAPH.;6;6;5;1;0;0;0;5;0;1;1;1;2;1
23855.0;2023;13;POITIERS;MASCULIN;APPRENTISSAGE;BAC PROFESSIONNEL;BAC PRO SERV;BAC PRO 33006 ANIMAT. ENFANCE& PERSONNES AGEES;2;2;2;0;0;0;0;2;0;1;0;0;1;0
23856.0;2023;13;POITIERS;MASCULIN;APPRENTISSAGE;BAC PROFESSIONNEL;BAC PRO SERV;BAC PRO 33101 OPTIQUE LUNETTERIE;8;8;8;0;0;0;0;8;0;0;1;4;3;0
23862.0;2023;13;POITIERS;MASCULIN;ENSEIGNEMENT A DISTANCE;BAC PROFESSIONNEL;BAC PRO SERV;BAC PRO 33003 ACC.SOINS-S.PERS. OPT.A DOMICILE;1;1;1;0;0;0;0;1;0;0;0;0;1;0
23865.0;2023;13;POITIERS;MASCULIN;ENSEIGNEMENT A DISTANCE;BAC TECHNOLOGIQUE;BAC STMG;BAC STMG RESSOURCES HUMAINES ET COMMUNICATION;1;1;1;0;0;0;0;1;0;0;0;0;1;0
23866.0;2023;13;POITIERS;MASCULIN;FORMATION CONTINUE;BAC PROFESSIONNEL;BAC PRO PROD;BAC PRO 22004 PROC. CHIMIE EAU PAPIERS-CARTONS;2;2;2;0;0;0;0;2;0;1;0;1;0;0
23873.0;2023;13;POITIERS;MASCULIN;INDIVIDUEL;BAC PROFESSIONNEL;BAC PRO PROD;BAC PRO 25214 MAINT.VEHIC.OPTA VOIT.PARTICUL.;3;2;1;0;1;0;1;1;0;0;0;1;0;1
23877.0;2023;13;POITIERS;MASCULIN;INDIVIDUEL;BAC PROFESSIONNEL;BAC PRO PROD;BAC PRO 25514 SYST.NUM.OPT.B AUD.RES.EQUIP.DOM.;2;2;2;0;0;0;0;2;0;0;0;0;2;0
23881.0;2023;13;POITIERS;MASCULIN;INDIVIDUEL;BAC PROFESSIONNEL;BAC PRO SERV;BAC PRO 31106 LOGISTIQUE;1;1;0;1;0;0;0;0;0;0;0;0;0;1
23886.0;2023;13;POITIERS;MASCULIN;INDIVIDUEL;BAC PROFESSIONNEL;BAC PRO SERV;BAC PRO AG 33002 SERV PERS TERRIT;1;1;1;0;0;0;0;1;0;0;0;0;1;0
23889.0;2023;13;POITIERS;MASCULIN;INDIVIDUEL;BAC TECHNOLOGIQUE;BAC STL;BAC STL BIOCHIM.-BIOLOGIE-BIOTECHNOL.;1;1;0;1;0;0;0;0;0;0;0;0;0;1
23892.0;2023;13;POITIERS;MASCULIN;INDIVIDUEL;BAC TECHNOLOGIQUE;BAC STMG;BAC STMG SYSTEMES D'INFORMATION DE GESTION;2;2;2;0;0;0;0;2;0;0;1;1;0;0
23893.0;2023;13;POITIERS;MASCULIN;SCOLAIRE;BAC GENERAL;BAC GENERAL;BAC GENE 10019 BAC GENERAL;4061;4061;3666;58;337;241;96;3907;64;415;892;1235;1301;154
23907.0;2023;13;POITIERS;MASCULIN;SCOLAIRE;BAC PROFESSIONNEL;BAC PRO PROD;BAC PRO 23203 TECHNICIEN BAT. : ORG.REAL.GROS O;7;7;2;5;0;0;0;2;0;0;0;0;2;5
23908.0;2023;13;POITIERS;MASCULIN;SCOLAIRE;BAC PROFESSIONNEL;BAC PRO PROD;BAC PRO 23205 INTERV. SUR PATRIMOINE BATI OPT.A;7;7;2;5;0;0;0;2;0;0;0;1;1;5
23909.0;2023;13;POITIERS;MASCULIN;SCOLAIRE;BAC PROFESSIONNEL;BAC PRO PROD;BAC PRO 23303 MENUISERIE ALUMINIUM-VERRE;10;10;7;2;1;0;1;7;0;0;0;3;4;3
23912.0;2023;13;POITIERS;MASCULIN;SCOLAIRE;BAC PROFESSIONNEL;BAC PRO PROD;BAC PRO 23405 TECHNICIEN MENUISIER AGENCEUR;61;61;44;17;0;0;0;44;0;1;9;19;15;17
23918.0;2023;13;POITIERS;MASCULIN;SCOLAIRE;BAC PROFESSIONNEL;BAC PRO PROD;BAC PRO 25009 MAINTENANCE NAUTIQUE;13;13;8;3;2;0;2;8;0;0;0;5;3;5
23921.0;2023;13;POITIERS;MASCULIN;SCOLAIRE;BAC PROFESSIONNEL;BAC PRO PROD;BAC PRO 25214 MAINT.VEHIC.OPTA VOIT.PARTICUL.;110;110;81;17;12;8;4;89;0;5;22;30;32;21
23923.0;2023;13;POITIERS;MASCULIN;SCOLAIRE;BAC PROFESSIONNEL;BAC PRO PROD;BAC PRO 25216 MAINT.VEHIC.OPTC MOTOCYCLES;15;15;14;0;1;1;0;15;0;3;1;5;6;0
23927.0;2023;13;POITIERS;MASCULIN;SCOLAIRE;BAC PROFESSIONNEL;BAC PRO PROD;BAC PRO 25302 AERONAUTIQUE OPTION AVIONIQUE;36;36;36;0;0;0;0;36;0;13;14;8;1;0
23931.0;2023;13;POITIERS;MASCULIN;SCOLAIRE;BAC PROFESSIONNEL;BAC PRO PROD;BAC PRO 25411 TECH.CHAUDRONNERIE INDUSTRIELLE;46;46;30;12;4;4;0;34;0;0;8;13;13;12
23943.0;2023;13;POITIERS;MASCULIN;SCOLAIRE;BAC PROFESSIONNEL;BAC PRO PROD;BAC PRO AG 21210 COND GEST ENTR CANIN ET FELIN;7;7;7;0;0;0;0;7;0;0;1;2;4;0
23947.0;2023;13;POITIERS;MASCULIN;SCOLAIRE;BAC PROFESSIONNEL;BAC PRO PROD;BAC PRO AG 21405 AMENAGEMENTS PAYSAGERS;65;64;56;8;0;0;0;56;0;4;10;16;26;8
23948.0;2023;13;POITIERS;MASCULIN;SCOLAIRE;BAC PROFESSIONNEL;BAC PRO PROD;BAC PRO AG 21407 TEC CONS VTE UNIVERS JARDINERIE;9;8;8;0;0;0;0;8;0;0;0;0;8;0
23949.0;2023;13;POITIERS;MASCULIN;SCOLAIRE;BAC PROFESSIONNEL;BAC PRO PROD;BAC PRO AG 22105 LABORATOIRE CONTROLE QUALITE;19;19;18;1;0;0;0;18;0;2;5;1;10;1
23957.0;2023;13;POITIERS;MASCULIN;SCOLAIRE;BAC PROFESSIONNEL;BAC PRO SERV;BAC PRO 31214 MET.COM.VEN.OP.B PR.CL.VA.OF.COM.;145;145;133;6;6;4;2;137;0;4;27;61;45;8
23959.0;2023;13;POITIERS;MASCULIN;SCOLAIRE;BAC PROFESSIONNEL;BAC PRO SERV;BAC PRO 32208 REAL.PR.IMPR.PLURI.OPTB.PR.IMPR.;3;3;3;0;0;0;0;3;0;0;1;2;0;0
23969.0;2023;13;POITIERS;MASCULIN;SCOLAIRE;BAC PROFESSIONNEL;BAC PRO SERV;BAC PRO 34403 METIERS DE LA SECURITE;24;24;24;0;0;0;0;24;0;2;10;8;4;0
23970.0;2023;13;POITIERS;MASCULIN;SCOLAIRE;BAC PROFESSIONNEL;BAC PRO SERV;BAC PRO AG 33002 SERV PERS TERRIT;38;38;32;6;0;0;0;32;0;0;7;16;9;6
23973.0;2023;13;POITIERS;MASCULIN;SCOLAIRE;BAC TECHNOLOGIQUE;BAC STD2A;BAC STD2A SCIENCES & TECHNO. DESIGN-ARTS APPLIQUES;23;23;21;0;2;0;2;21;0;1;6;8;6;2
23974.0;2023;13;POITIERS;MASCULIN;SCOLAIRE;BAC TECHNOLOGIQUE;BAC STHR;BAC STHR SC.&TEC. HOTELLERIE-RESTAURATION;30;30;29;1;0;0;0;29;0;1;11;7;10;1
23976.0;2023;13;POITIERS;MASCULIN;SCOLAIRE;BAC TECHNOLOGIQUE;BAC STI2D;BAC STI2D ENERGIES  ET ENVIRONNEMENT;75;75;71;2;2;2;0;73;0;3;11;25;34;2
23981.0;2023;13;POITIERS;MASCULIN;SCOLAIRE;BAC TECHNOLOGIQUE;BAC STMG;BAC STMG GESTION ET FINANCE;171;171;140;6;25;19;6;159;0;2;19;45;93;12
23982.0;2023;13;POITIERS;MASCULIN;SCOLAIRE;BAC TECHNOLOGIQUE;BAC STMG;BAC STMG MERCATIQUE (MARKETING);549;549;382;43;124;102;22;484;0;4;24;120;336;65
23983.0;2023;13;POITIERS;MASCULIN;SCOLAIRE;BAC TECHNOLOGIQUE;BAC STMG;BAC STMG RESSOURCES HUMAINES ET COMMUNICATION;164;164;108;10;46;34;12;142;0;0;6;22;114;22
23984.0;2023;13;POITIERS;MASCULIN;SCOLAIRE;BAC TECHNOLOGIQUE;BAC STMG;BAC STMG SYSTEMES D'INFORMATION DE GESTION;21;21;13;2;6;5;1;18;0;0;2;3;13;3
23986.0;2023;19;REIMS;FEMININ;APPRENTISSAGE;BAC PROFESSIONNEL;BAC PRO PROD;BAC PRO 23102 TRAVAUX PUBLICS;1;1;1;0;0;0;0;1;0;0;0;1;0;0
23999.0;2023;19;REIMS;FEMININ;APPRENTISSAGE;BAC PROFESSIONNEL;BAC PRO SERV;BAC PRO 33603 ESTHETIQUE COSMETIQUE PARFUMERIE;22;21;17;4;0;0;0;17;0;0;2;8;7;4
24001.0;2023;19;REIMS;FEMININ;APPRENTISSAGE;BAC PROFESSIONNEL;BAC PRO SERV;BAC PRO 34305 TECHN.D'INTERV.SUR INSTALL. NUCL.;3;3;3;0;0;0;0;3;0;2;1;0;0;0
24003.0;2023;19;REIMS;FEMININ;ENSEIGNEMENT A DISTANCE;BAC GENERAL;BAC GENERAL;BAC GENE 10019 BAC GENERAL;32;32;16;8;8;3;5;19;0;2;3;0;14;13
24004.0;2023;19;REIMS;FEMININ;ENSEIGNEMENT A DISTANCE;BAC PROFESSIONNEL;BAC PRO SERV;BAC PRO 30004 ASSISTANC.GEST.ORGANIS.ACTIVITES;1;1;1;0;0;0;0;1;0;0;0;0;1;0
24011.0;2023;19;REIMS;FEMININ;ENSEIGNEMENT A DISTANCE;BAC TECHNOLOGIQUE;BAC STMG;BAC STMG RESSOURCES HUMAINES ET COMMUNICATION;2;2;1;0;1;1;0;2;0;0;0;1;1;0
24013.0;2023;19;REIMS;FEMININ;FORMATION CONTINUE;BAC PROFESSIONNEL;BAC PRO PROD;BAC PRO 23405 TECHNICIEN MENUISIER AGENCEUR;1;1;1;0;0;0;0;1;0;0;1;0;0;0
24015.0;2023;19;REIMS;FEMININ;FORMATION CONTINUE;BAC PROFESSIONNEL;BAC PRO SERV;BAC PRO 33403 COMMERC. SERVICES EN RESTAURATION;1;1;0;1;0;0;0;0;0;0;0;0;0;1
24016.0;2023;19;REIMS;FEMININ;FORMATION CONTINUE;BAC PROFESSIONNEL;BAC PRO SERV;BAC PRO 33603 ESTHETIQUE COSMETIQUE PARFUMERIE;1;1;1;0;0;0;0;1;0;0;0;1;0;0
24023.0;2023;19;REIMS;FEMININ;INDIVIDUEL;BAC PROFESSIONNEL;BAC PRO SERV;BAC PRO 31212 METIERS DE L'ACCUEIL;1;1;0;1;0;0;0;0;0;0;0;0;0;1
24025.0;2023;19;REIMS;FEMININ;INDIVIDUEL;BAC PROFESSIONNEL;BAC PRO SERV;BAC PRO 33002 SERVICES DE PROXIMITE  VIE LOCAL;1;1;1;0;0;0;0;1;0;0;0;0;1;0
24027.0;2023;19;REIMS;FEMININ;INDIVIDUEL;BAC PROFESSIONNEL;BAC PRO SERV;BAC PRO AG 33002 SERV PERS TERRIT;1;1;0;1;0;0;0;0;0;0;0;0;0;1
24029.0;2023;19;REIMS;FEMININ;INDIVIDUEL;BAC TECHNOLOGIQUE;BAC STL;BAC STL BIOCHIM.-BIOLOGIE-BIOTECHNOL.;1;1;0;0;1;1;0;1;0;0;0;0;1;0
24033.0;2023;19;REIMS;FEMININ;SCOLAIRE;BAC GENERAL;BAC GENERAL;BAC GENE 10019 BAC GENERAL;3674;3674;3375;56;243;164;79;3539;69;439;902;1068;1061;135
24042.0;2023;19;REIMS;FEMININ;SCOLAIRE;BAC PROFESSIONNEL;BAC PRO PROD;BAC PRO 23304 AMENAGEMENT FINITION BATIMENT;3;3;3;0;0;0;0;3;0;1;1;1;0;0
24046.0;2023;19;REIMS;FEMININ;SCOLAIRE;BAC PROFESSIONNEL;BAC PRO PROD;BAC PRO 24203 METIERS DE LA MODE - VÊTEMENT;49;49;31;14;4;4;0;35;0;3;6;12;14;14
24049.0;2023;19;REIMS;FEMININ;SCOLAIRE;BAC PROFESSIONNEL;BAC PRO PROD;BAC PRO 25215 MAINT.VEHIC.OPTB VEHIC.TRANS.ROUT;1;1;1;0;0;0;0;1;0;0;0;1;0;0
24052.0;2023;19;REIMS;FEMININ;SCOLAIRE;BAC PROFESSIONNEL;BAC PRO PROD;BAC PRO 25514 SYST.NUM.OPT.B AUD.RES.EQUIP.DOM.;6;6;5;1;0;0;0;5;0;0;0;4;1;1
24057.0;2023;19;REIMS;FEMININ;SCOLAIRE;BAC PROFESSIONNEL;BAC PRO PROD;BAC PRO AG 21203 TECHN CONSEIL DE VENTE ANIMAL;13;13;11;2;0;0;0;11;0;0;3;6;2;2
24070.0;2023;19;REIMS;FEMININ;SCOLAIRE;BAC PROFESSIONNEL;BAC PRO SERV;BAC PRO 32207 REAL.PR.IMPR.PLURI.OPTA.PR.GRAPH.;8;8;8;0;0;0;0;8;0;1;0;3;4;0
24071.0;2023;19;REIMS;FEMININ;SCOLAIRE;BAC PROFESSIONNEL;BAC PRO SERV;BAC PRO 32208 REAL.PR.IMPR.PLURI.OPTB.PR.IMPR.;2;2;1;0;1;1;0;2;0;0;0;0;2;0
24075.0;2023;19;REIMS;FEMININ;SCOLAIRE;BAC PROFESSIONNEL;BAC PRO SERV;BAC PRO 33004 ACC.SOINS-S.PERS. OPT.EN STRUCTUR;239;238;206;17;15;12;3;218;0;13;41;75;89;20
24083.0;2023;19;REIMS;FEMININ;SCOLAIRE;BAC PROFESSIONNEL;BAC PRO SERV;BAC PRO AG 33002 SERV PERS TERRIT;91;89;77;12;0;0;0;77;0;1;12;28;36;12
24093.0;2023;19;REIMS;FEMININ;SCOLAIRE;BAC TECHNOLOGIQUE;BAC STI2D;BAC STI2D SYSTÈME D'INFORMATION  ET NUMERIQUE;3;3;2;0;1;1;0;3;0;0;0;1;2;0
24101.0;2023;19;REIMS;MASCULIN;APPRENTISSAGE;BAC PROFESSIONNEL;BAC PRO PROD;BAC PRO 22104 BOUCHER CHARCUTIER TRAITEUR;2;2;2;0;0;0;0;2;0;0;0;1;1;0
24105.0;2023;19;REIMS;MASCULIN;APPRENTISSAGE;BAC PROFESSIONNEL;BAC PRO PROD;BAC PRO 22704 TECHN. MAINT. SYST.ENERG.CLIMATI;13;13;10;2;1;1;0;11;0;1;2;3;5;2
24117.0;2023;19;REIMS;MASCULIN;APPRENTISSAGE;BAC PROFESSIONNEL;BAC PRO PROD;BAC PRO 25216 MAINT.VEHIC.OPTC MOTOCYCLES;9;9;6;3;0;0;0;6;0;0;0;1;5;3
24119.0;2023;19;REIMS;MASCULIN;APPRENTISSAGE;BAC PROFESSIONNEL;BAC PRO PROD;BAC PRO 25220 MAINT.MATERIELS OPT.B TP MANUT.;8;8;5;2;1;0;1;5;0;0;1;1;3;3
24125.0;2023;19;REIMS;MASCULIN;APPRENTISSAGE;BAC PROFESSIONNEL;BAC PRO PROD;BAC PRO 25514 SYST.NUM.OPT.B AUD.RES.EQUIP.DOM.;3;3;3;0;0;0;0;3;0;0;2;0;1;0
24151.0;2023;19;REIMS;MASCULIN;INDIVIDUEL;BAC PROFESSIONNEL;BAC PRO PROD;BAC PRO 23405 TECHNICIEN MENUISIER AGENCEUR;1;1;0;1;0;0;0;0;0;0;0;0;0;1
24155.0;2023;19;REIMS;MASCULIN;INDIVIDUEL;BAC PROFESSIONNEL;BAC PRO PROD;BAC PRO 25514 SYST.NUM.OPT.B AUD.RES.EQUIP.DOM.;1;1;1;0;0;0;0;1;0;0;0;0;1;0
24157.0;2023;19;REIMS;MASCULIN;INDIVIDUEL;BAC PROFESSIONNEL;BAC PRO PROD;BAC PRO AG 21004 CGEA;4;4;2;2;0;0;0;2;0;0;0;0;2;2
24173.0;2023;19;REIMS;MASCULIN;SCOLAIRE;BAC PROFESSIONNEL;BAC PRO PROD;BAC PRO 22302 Traitement des matériaux;10;10;6;4;0;0;0;6;0;0;0;1;5;4
24176.0;2023;19;REIMS;MASCULIN;SCOLAIRE;BAC PROFESSIONNEL;BAC PRO PROD;BAC PRO 22703 TECHN.INSTALL.SYST.ENERG.CLIMATI;24;24;12;8;4;2;2;14;0;0;2;2;10;10
24177.0;2023;19;REIMS;MASCULIN;SCOLAIRE;BAC PROFESSIONNEL;BAC PRO PROD;BAC PRO 22704 TECHN. MAINT. SYST.ENERG.CLIMATI;13;13;10;1;2;1;1;11;0;0;1;2;8;2
24178.0;2023;19;REIMS;MASCULIN;SCOLAIRE;BAC PROFESSIONNEL;BAC PRO PROD;BAC PRO 23004 TECHN. ETUDES BAT.A ETUDES & ECO.;15;15;12;2;1;1;0;13;0;0;2;8;3;2
24179.0;2023;19;REIMS;MASCULIN;SCOLAIRE;BAC PROFESSIONNEL;BAC PRO PROD;BAC PRO 23005 TECHN. ETUDES BAT B ASSIST.ARCHI.;32;32;29;3;0;0;0;29;0;0;7;11;11;3
24182.0;2023;19;REIMS;MASCULIN;SCOLAIRE;BAC PROFESSIONNEL;BAC PRO PROD;BAC PRO 23203 TECHNICIEN BAT. : ORG.REAL.GROS O;13;13;10;1;2;0;2;10;0;0;1;3;6;3
24185.0;2023;19;REIMS;MASCULIN;SCOLAIRE;BAC PROFESSIONNEL;BAC PRO PROD;BAC PRO 23404 TECHNICIEN CONSTRUCTEUR BOIS;8;8;6;2;0;0;0;6;0;0;2;1;3;2
24189.0;2023;19;REIMS;MASCULIN;SCOLAIRE;BAC PROFESSIONNEL;BAC PRO PROD;BAC PRO 25007 MAINTENANCE EQUIPEMENTS INDUST.;117;117;70;40;7;7;0;77;0;2;14;26;35;40
24190.0;2023;19;REIMS;MASCULIN;SCOLAIRE;BAC PROFESSIONNEL;BAC PRO PROD;BAC PRO 25106 TECHNICIEN D'USINAGE;7;7;7;0;0;0;0;7;0;1;0;2;4;0
24194.0;2023;19;REIMS;MASCULIN;SCOLAIRE;BAC PROFESSIONNEL;BAC PRO PROD;BAC PRO 25219 MAINT.MATERIELS OPT.A AGRICOLES;18;18;10;7;1;1;0;11;0;0;4;5;2;7
24208.0;2023;19;REIMS;MASCULIN;SCOLAIRE;BAC PROFESSIONNEL;BAC PRO PROD;BAC PRO AG 21210 COND GEST ENTR CANIN ET FELIN;8;6;5;1;0;0;0;5;0;0;0;2;3;1
24213.0;2023;19;REIMS;MASCULIN;SCOLAIRE;BAC PROFESSIONNEL;BAC PRO SERV;BAC PRO 30004 ASSISTANC.GEST.ORGANIS.ACTIVITES;114;114;72;39;3;3;0;75;0;0;8;32;35;39
24214.0;2023;19;REIMS;MASCULIN;SCOLAIRE;BAC PROFESSIONNEL;BAC PRO SERV;BAC PRO 31106 LOGISTIQUE;33;33;23;8;2;1;1;24;0;1;3;10;10;9
24217.0;2023;19;REIMS;MASCULIN;SCOLAIRE;BAC PROFESSIONNEL;BAC PRO SERV;BAC PRO 31212 METIERS DE L'ACCUEIL;11;11;7;4;0;0;0;7;0;0;2;1;4;4
24228.0;2023;19;REIMS;MASCULIN;SCOLAIRE;BAC PROFESSIONNEL;BAC PRO SERV;BAC PRO 33403 COMMERC. SERVICES EN RESTAURATION;37;37;26;7;4;4;0;30;0;1;8;9;12;7
24232.0;2023;19;REIMS;MASCULIN;SCOLAIRE;BAC PROFESSIONNEL;BAC PRO SERV;BAC PRO 34403 METIERS DE LA SECURITE;77;77;71;6;0;0;0;71;0;4;8;41;18;6
24236.0;2023;19;REIMS;MASCULIN;SCOLAIRE;BAC TECHNOLOGIQUE;BAC STAV;BAC STAV AGRONOMIE ALIM ENV TERRITOI;88;88;88;0;0;0;0;88;0;1;8;38;41;0
24238.0;2023;19;REIMS;MASCULIN;SCOLAIRE;BAC TECHNOLOGIQUE;BAC STHR;BAC STHR SC.&TEC. HOTELLERIE-RESTAURATION;17;17;16;0;1;1;0;17;0;4;2;6;5;0
24244.0;2023;19;REIMS;MASCULIN;SCOLAIRE;BAC TECHNOLOGIQUE;BAC STL;BAC STL SCIENCES PHYSIQUES CHIMIQUES  EN LABORAT.;15;15;11;0;4;2;2;13;0;2;1;5;5;2
24245.0;2023;19;REIMS;MASCULIN;SCOLAIRE;BAC TECHNOLOGIQUE;BAC STMG;BAC STMG GESTION ET FINANCE;161;161;119;11;31;24;7;143;0;1;11;42;89;18
24248.0;2023;19;REIMS;MASCULIN;SCOLAIRE;BAC TECHNOLOGIQUE;BAC STMG;BAC STMG SYSTEMES D'INFORMATION DE GESTION;21;21;5;4;12;6;6;11;0;0;0;1;10;10
24249.0;2023;14;RENNES;FEMININ;APPRENTISSAGE;BAC PROFESSIONNEL;BAC PRO PROD;BAC PRO 22104 BOUCHER CHARCUTIER TRAITEUR;1;1;1;0;0;0;0;1;0;0;1;0;0;0
24251.0;2023;14;RENNES;FEMININ;APPRENTISSAGE;BAC PROFESSIONNEL;BAC PRO PROD;BAC PRO 22106 CUISINE;15;15;14;0;1;0;1;14;0;2;4;4;4;1
24252.0;2023;14;RENNES;FEMININ;APPRENTISSAGE;BAC PROFESSIONNEL;BAC PRO PROD;BAC PRO 23102 TRAVAUX PUBLICS;1;1;1;0;0;0;0;1;0;0;0;0;1;0
24261.0;2023;14;RENNES;FEMININ;APPRENTISSAGE;BAC PROFESSIONNEL;BAC PRO PROD;BAC PRO 25216 MAINT.VEHIC.OPTC MOTOCYCLES;1;1;1;0;0;0;0;1;0;0;1;0;0;0
24263.0;2023;14;RENNES;FEMININ;APPRENTISSAGE;BAC PROFESSIONNEL;BAC PRO PROD;BAC PRO 25408 REPARATION DES CARROSSERIES;1;1;1;0;0;0;0;1;0;0;0;1;0;0
24264.0;2023;14;RENNES;FEMININ;APPRENTISSAGE;BAC PROFESSIONNEL;BAC PRO PROD;BAC PRO 25411 TECH.CHAUDRONNERIE INDUSTRIELLE;4;4;3;1;0;0;0;3;0;1;1;1;0;1
24268.0;2023;14;RENNES;FEMININ;APPRENTISSAGE;BAC PROFESSIONNEL;BAC PRO PROD;BAC PRO AG 21114 CONDUITE PRODUCTIONS HORTICOLES;4;4;4;0;0;0;0;4;0;1;1;0;2;0
24269.0;2023;14;RENNES;FEMININ;APPRENTISSAGE;BAC PROFESSIONNEL;BAC PRO PROD;BAC PRO AG 21210 COND GEST ENTR CANIN ET FELIN;11;11;10;1;0;0;0;10;0;0;0;4;6;1
24287.0;2023;14;RENNES;FEMININ;ENSEIGNEMENT A DISTANCE;BAC TECHNOLOGIQUE;BAC ST2S;BAC ST2S SCIENCES & TECHNO. SANTE & SOCIAL;12;12;6;5;1;1;0;7;0;0;0;2;5;5
24295.0;2023;14;RENNES;FEMININ;INDIVIDUEL;BAC PROFESSIONNEL;BAC PRO PROD;BAC PRO AG 21114 CONDUITE PRODUCTIONS HORTICOLES;2;1;1;0;0;0;0;1;0;0;0;0;1;0
24311.0;2023;14;RENNES;FEMININ;SCOLAIRE;BAC GENERAL;BAC GENERAL;BAC GENE 10019 BAC GENERAL;10271;10271;9893;60;318;244;74;10137;171;1321;2886;3474;2285;134
24316.0;2023;14;RENNES;FEMININ;SCOLAIRE;BAC PROFESSIONNEL;BAC PRO PROD;BAC PRO 22704 TECHN. MAINT. SYST.ENERG.CLIMATI;1;1;1;0;0;0;0;1;0;0;0;1;0;0
24318.0;2023;14;RENNES;FEMININ;SCOLAIRE;BAC PROFESSIONNEL;BAC PRO PROD;BAC PRO 23004 TECHN. ETUDES BAT.A ETUDES & ECO.;20;20;18;2;0;0;0;18;0;2;5;4;7;2
24326.0;2023;14;RENNES;FEMININ;SCOLAIRE;BAC PROFESSIONNEL;BAC PRO PROD;BAC PRO 24202 ARTIS.& MET.ART : TAPIS.D'AMEUBL;18;18;16;2;0;0;0;16;0;1;5;7;3;2
24355.0;2023;14;RENNES;FEMININ;SCOLAIRE;BAC PROFESSIONNEL;BAC PRO PROD;BAC PRO AG 22108 TEC CONS VTE ALIMENTATION (PAB);75;75;65;10;0;0;0;65;0;1;14;17;33;10
24358.0;2023;14;RENNES;FEMININ;SCOLAIRE;BAC PROFESSIONNEL;BAC PRO SERV;BAC PRO 31107 CONDUCT. TRANSP.ROUT.MARCHANDISES;3;3;3;0;0;0;0;3;0;1;0;1;1;0
24359.0;2023;14;RENNES;FEMININ;SCOLAIRE;BAC PROFESSIONNEL;BAC PRO SERV;BAC PRO 31114 ORGANIS. TRANSPORT MARCHANDISES;2;2;2;0;0;0;0;2;0;1;0;1;0;0
24366.0;2023;14;RENNES;FEMININ;SCOLAIRE;BAC PROFESSIONNEL;BAC PRO SERV;BAC PRO 33003 ACC.SOINS-S.PERS. OPT.A DOMICILE;134;134;121;9;4;2;2;123;0;4;29;59;31;11
24372.0;2023;14;RENNES;FEMININ;SCOLAIRE;BAC PROFESSIONNEL;BAC PRO SERV;BAC PRO 33604 METIERS DE LA COIFFURE;48;48;44;3;1;1;0;45;0;1;6;21;17;3
24374.0;2023;14;RENNES;FEMININ;SCOLAIRE;BAC PROFESSIONNEL;BAC PRO SERV;BAC PRO 34304 HYGIENE PROPRETE STERILISATION;8;8;8;0;0;0;0;8;0;0;0;6;2;0
24376.0;2023;14;RENNES;FEMININ;SCOLAIRE;BAC PROFESSIONNEL;BAC PRO SERV;BAC PRO AG 33002 SERV PERS TERRIT;696;686;619;67;0;0;0;619;0;9;74;194;342;67
24377.0;2023;14;RENNES;FEMININ;SCOLAIRE;BAC TECHNOLOGIQUE;BAC S2TMD;BAC S2TMD DANSE;10;10;10;0;0;0;0;10;0;4;2;4;0;0
24385.0;2023;14;RENNES;FEMININ;SCOLAIRE;BAC TECHNOLOGIQUE;BAC STI2D;BAC STI2D ENERGIES  ET ENVIRONNEMENT;13;13;12;1;0;0;0;12;0;2;1;7;2;1
24392.0;2023;14;RENNES;FEMININ;SCOLAIRE;BAC TECHNOLOGIQUE;BAC STMG;BAC STMG RESSOURCES HUMAINES ET COMMUNICATION;652;652;535;15;102;76;26;611;0;3;39;202;367;41
24407.0;2023;14;RENNES;MASCULIN;APPRENTISSAGE;BAC PROFESSIONNEL;BAC PRO PROD;BAC PRO 25106 TECHNICIEN D'USINAGE;8;8;7;1;0;0;0;7;0;1;1;2;3;1
24416.0;2023;14;RENNES;MASCULIN;APPRENTISSAGE;BAC PROFESSIONNEL;BAC PRO PROD;BAC PRO 25408 REPARATION DES CARROSSERIES;24;24;19;4;1;1;0;20;0;1;5;8;6;4
24417.0;2023;14;RENNES;MASCULIN;APPRENTISSAGE;BAC PROFESSIONNEL;BAC PRO PROD;BAC PRO 25411 TECH.CHAUDRONNERIE INDUSTRIELLE;81;81;70;7;4;2;2;72;0;12;23;18;19;9
24418.0;2023;14;RENNES;MASCULIN;APPRENTISSAGE;BAC PROFESSIONNEL;BAC PRO PROD;BAC PRO 25509 TECHNIC. FROID CONDITIONNEMT AIR;2;2;2;0;0;0;0;2;0;0;0;1;1;0
24419.0;2023;14;RENNES;MASCULIN;APPRENTISSAGE;BAC PROFESSIONNEL;BAC PRO PROD;BAC PRO 25510 METIERS ELECT. ENVIRON. CONNECTES;87;87;69;13;5;3;2;72;0;7;22;24;19;15
24421.0;2023;14;RENNES;MASCULIN;APPRENTISSAGE;BAC PROFESSIONNEL;BAC PRO PROD;BAC PRO AG 21001 AGRO-EQUIPEMENT;89;87;69;18;0;0;0;69;0;0;2;11;56;18
24424.0;2023;14;RENNES;MASCULIN;APPRENTISSAGE;BAC PROFESSIONNEL;BAC PRO PROD;BAC PRO AG 21210 COND GEST ENTR CANIN ET FELIN;7;7;6;1;0;0;0;6;0;0;0;0;6;1
24427.0;2023;14;RENNES;MASCULIN;APPRENTISSAGE;BAC PROFESSIONNEL;BAC PRO PROD;BAC PRO AG 22108 TEC CONS VTE ALIMENTATION (PAB);7;6;4;2;0;0;0;4;0;0;0;1;3;2
24437.0;2023;14;RENNES;MASCULIN;ENSEIGNEMENT A DISTANCE;BAC GENERAL;BAC GENERAL;BAC GENE 10019 BAC GENERAL;34;34;25;6;3;1;2;26;0;0;6;3;17;8
24445.0;2023;14;RENNES;MASCULIN;FORMATION CONTINUE;BAC PROFESSIONNEL;BAC PRO PROD;BAC PRO 25303 AERONAUTIQUE OPTION SYSTEMES;10;10;10;0;0;0;0;10;0;2;3;4;1;0
24447.0;2023;14;RENNES;MASCULIN;FORMATION CONTINUE;BAC PROFESSIONNEL;BAC PRO PROD;BAC PRO 25510 METIERS ELECT. ENVIRON. CONNECTES;2;2;1;1;0;0;0;1;0;0;1;0;0;1
24448.0;2023;14;RENNES;MASCULIN;INDIVIDUEL;BAC GENERAL;BAC GENERAL;BAC GENE 10019 BAC GENERAL;58;58;34;19;5;1;4;35;1;3;6;11;14;23
24449.0;2023;14;RENNES;MASCULIN;INDIVIDUEL;BAC PROFESSIONNEL;BAC PRO PROD;BAC PRO 22703 TECHN.INSTALL.SYST.ENERG.CLIMATI;1;0;0;0;0;0;0;0;0;0;0;0;0;0
24456.0;2023;14;RENNES;MASCULIN;INDIVIDUEL;BAC PROFESSIONNEL;BAC PRO PROD;BAC PRO 25510 METIERS ELECT. ENVIRON. CONNECTES;2;2;2;0;0;0;0;2;0;0;0;0;2;0
24457.0;2023;14;RENNES;MASCULIN;INDIVIDUEL;BAC PROFESSIONNEL;BAC PRO PROD;BAC PRO 25514 SYST.NUM.OPT.B AUD.RES.EQUIP.DOM.;2;1;0;0;1;1;0;1;0;0;0;0;1;0
24458.0;2023;14;RENNES;MASCULIN;INDIVIDUEL;BAC PROFESSIONNEL;BAC PRO PROD;BAC PRO AG 21004 CGEA;4;3;2;1;0;0;0;2;0;0;0;0;2;1
24460.0;2023;14;RENNES;MASCULIN;INDIVIDUEL;BAC PROFESSIONNEL;BAC PRO PROD;BAC PRO AG 21114 CONDUITE PRODUCTIONS HORTICOLES;2;2;2;0;0;0;0;2;0;0;0;0;2;0
24464.0;2023;14;RENNES;MASCULIN;INDIVIDUEL;BAC PROFESSIONNEL;BAC PRO SERV;BAC PRO 31114 ORGANIS. TRANSPORT MARCHANDISES;1;1;0;1;0;0;0;0;0;0;0;0;0;1
24469.0;2023;14;RENNES;MASCULIN;INDIVIDUEL;BAC TECHNOLOGIQUE;BAC STI2D;BAC STI2D ENERGIES  ET ENVIRONNEMENT;1;1;1;0;0;0;0;1;1;0;0;0;0;0
24480.0;2023;14;RENNES;MASCULIN;SCOLAIRE;BAC PROFESSIONNEL;BAC PRO PROD;BAC PRO 22703 TECHN.INSTALL.SYST.ENERG.CLIMATI;56;56;44;9;3;1;2;45;0;1;4;21;19;11
24482.0;2023;14;RENNES;MASCULIN;SCOLAIRE;BAC PROFESSIONNEL;BAC PRO PROD;BAC PRO 23003 ARTIS. & M.ART:MARCHANDISAGE VIS.;4;4;2;0;2;1;1;3;0;0;1;1;1;1
24489.0;2023;14;RENNES;MASCULIN;SCOLAIRE;BAC PROFESSIONNEL;BAC PRO PROD;BAC PRO 23304 AMENAGEMENT FINITION BATIMENT;34;34;27;4;3;2;1;29;0;0;2;14;13;5
24492.0;2023;14;RENNES;MASCULIN;SCOLAIRE;BAC PROFESSIONNEL;BAC PRO PROD;BAC PRO 23407 TECHNIC.FAB.BOIS ET MATERX ASSOC;13;13;13;0;0;0;0;13;0;2;4;6;1;0
24496.0;2023;14;RENNES;MASCULIN;SCOLAIRE;BAC PROFESSIONNEL;BAC PRO PROD;BAC PRO 24302 METIERS DU CUIR : MAROQUINERIE;1;1;0;1;0;0;0;0;0;0;0;0;0;1
24497.0;2023;14;RENNES;MASCULIN;SCOLAIRE;BAC PROFESSIONNEL;BAC PRO PROD;BAC PRO 25006 MICROTECHNIQUES;30;30;29;1;0;0;0;29;0;5;7;12;5;1
24502.0;2023;14;RENNES;MASCULIN;SCOLAIRE;BAC PROFESSIONNEL;BAC PRO PROD;BAC PRO 25214 MAINT.VEHIC.OPTA VOIT.PARTICUL.;249;249;224;14;11;9;2;233;0;12;71;86;64;16
24508.0;2023;14;RENNES;MASCULIN;SCOLAIRE;BAC PROFESSIONNEL;BAC PRO PROD;BAC PRO 25302 AERONAUTIQUE OPTION AVIONIQUE;12;12;12;0;0;0;0;12;0;2;6;4;0;0
24512.0;2023;14;RENNES;MASCULIN;SCOLAIRE;BAC PROFESSIONNEL;BAC PRO PROD;BAC PRO 25408 REPARATION DES CARROSSERIES;22;22;20;2;0;0;0;20;0;0;6;7;7;2
24518.0;2023;14;RENNES;MASCULIN;SCOLAIRE;BAC PROFESSIONNEL;BAC PRO PROD;BAC PRO 25515 SYST.NUM.OPT.C RES.INF.SYST.COMM.;217;217;192;18;7;7;0;199;0;18;59;62;60;18
24523.0;2023;14;RENNES;MASCULIN;SCOLAIRE;BAC PROFESSIONNEL;BAC PRO PROD;BAC PRO AG 21204 PROD-AQUACOLES;13;13;9;4;0;0;0;9;0;0;0;2;7;4
24530.0;2023;14;RENNES;MASCULIN;SCOLAIRE;BAC PROFESSIONNEL;BAC PRO PROD;BAC PRO AG 22105 LABORATOIRE CONTROLE QUALITE;20;20;19;1;0;0;0;19;0;1;4;5;9;1
24534.0;2023;14;RENNES;MASCULIN;SCOLAIRE;BAC PROFESSIONNEL;BAC PRO SERV;BAC PRO 31107 CONDUCT. TRANSP.ROUT.MARCHANDISES;96;96;82;12;2;2;0;84;0;5;22;31;26;12
24543.0;2023;14;RENNES;MASCULIN;SCOLAIRE;BAC PROFESSIONNEL;BAC PRO SERV;BAC PRO 33004 ACC.SOINS-S.PERS. OPT.EN STRUCTUR;45;45;37;7;1;1;0;38;0;1;3;18;16;7
24551.0;2023;14;RENNES;MASCULIN;SCOLAIRE;BAC PROFESSIONNEL;BAC PRO SERV;BAC PRO AG 33002 SERV PERS TERRIT;99;99;86;13;0;0;0;86;0;2;10;30;44;13
24554.0;2023;14;RENNES;MASCULIN;SCOLAIRE;BAC TECHNOLOGIQUE;BAC ST2S;BAC ST2S SCIENCES & TECHNO. SANTE & SOCIAL;153;153;132;0;21;15;6;147;0;2;18;47;80;6
24555.0;2023;14;RENNES;MASCULIN;SCOLAIRE;BAC TECHNOLOGIQUE;BAC STAV;BAC STAV AGRONOMIE ALIM ENV TERRITOI;192;191;186;5;0;0;0;186;0;1;18;71;96;5
24560.0;2023;14;RENNES;MASCULIN;SCOLAIRE;BAC TECHNOLOGIQUE;BAC STI2D;BAC STI2D INNOVATION TECHNO.  ET ECO CONCEPTION;456;456;432;8;16;11;5;443;2;19;94;182;146;13
24564.0;2023;14;RENNES;MASCULIN;SCOLAIRE;BAC TECHNOLOGIQUE;BAC STMG;BAC STMG GESTION ET FINANCE;539;539;486;3;50;44;6;530;0;3;48;194;285;9
24567.0;2023;14;RENNES;MASCULIN;SCOLAIRE;BAC TECHNOLOGIQUE;BAC STMG;BAC STMG SYSTEMES D'INFORMATION DE GESTION;23;23;20;1;2;2;0;22;0;0;1;4;17;1
24576.0;2023;15;STRASBOURG;FEMININ;APPRENTISSAGE;BAC PROFESSIONNEL;BAC PRO PROD;BAC PRO 25214 MAINT.VEHIC.OPTA VOIT.PARTICUL.;6;6;6;0;0;0;0;6;0;3;0;2;1;0
24580.0;2023;15;STRASBOURG;FEMININ;APPRENTISSAGE;BAC PROFESSIONNEL;BAC PRO PROD;BAC PRO 25515 SYST.NUM.OPT.C RES.INF.SYST.COMM.;1;1;1;0;0;0;0;1;0;0;1;0;0;0
24587.0;2023;15;STRASBOURG;FEMININ;APPRENTISSAGE;BAC PROFESSIONNEL;BAC PRO SERV;BAC PRO 31106 LOGISTIQUE;5;5;5;0;0;0;0;5;0;1;3;1;0;0
24602.0;2023;15;STRASBOURG;FEMININ;ENSEIGNEMENT A DISTANCE;BAC TECHNOLOGIQUE;BAC STMG;BAC STMG RESSOURCES HUMAINES ET COMMUNICATION;6;6;3;2;1;0;1;3;0;0;0;2;1;3
24603.0;2023;15;STRASBOURG;FEMININ;FORMATION CONTINUE;BAC PROFESSIONNEL;BAC PRO PROD;BAC PRO 22704 TECHN. MAINT. SYST.ENERG.CLIMATI;1;1;0;1;0;0;0;0;0;0;0;0;0;1
24612.0;2023;15;STRASBOURG;FEMININ;INDIVIDUEL;BAC PROFESSIONNEL;BAC PRO PROD;BAC PRO AG 21211 COND GEST ENTR HIPPIQUE;1;1;1;0;0;0;0;1;0;0;0;1;0;0
24614.0;2023;15;STRASBOURG;FEMININ;INDIVIDUEL;BAC PROFESSIONNEL;BAC PRO SERV;BAC PRO 31212 METIERS DE L'ACCUEIL;2;1;1;0;0;0;0;1;0;0;0;0;1;0
24622.0;2023;15;STRASBOURG;FEMININ;INDIVIDUEL;BAC TECHNOLOGIQUE;BAC ST2S;BAC ST2S SCIENCES & TECHNO. SANTE & SOCIAL;8;8;3;2;3;3;0;6;0;0;1;0;5;2
24635.0;2023;15;STRASBOURG;FEMININ;SCOLAIRE;BAC PROFESSIONNEL;BAC PRO PROD;BAC PRO 23005 TECHN. ETUDES BAT B ASSIST.ARCHI.;8;8;7;1;0;0;0;7;0;0;2;3;2;1
24638.0;2023;15;STRASBOURG;FEMININ;SCOLAIRE;BAC PROFESSIONNEL;BAC PRO PROD;BAC PRO 23407 TECHNIC.FAB.BOIS ET MATERX ASSOC;1;1;1;0;0;0;0;1;0;0;1;0;0;0
24640.0;2023;15;STRASBOURG;FEMININ;SCOLAIRE;BAC PROFESSIONNEL;BAC PRO PROD;BAC PRO 25007 MAINTENANCE EQUIPEMENTS INDUST.;4;4;3;1;0;0;0;3;0;0;1;1;1;1
24641.0;2023;15;STRASBOURG;FEMININ;SCOLAIRE;BAC PROFESSIONNEL;BAC PRO PROD;BAC PRO 25106 TECHNICIEN D'USINAGE;3;3;3;0;0;0;0;3;0;0;0;1;2;0
24644.0;2023;15;STRASBOURG;FEMININ;SCOLAIRE;BAC PROFESSIONNEL;BAC PRO PROD;BAC PRO 25219 MAINT.MATERIELS OPT.A AGRICOLES;1;1;0;1;0;0;0;0;0;0;0;0;0;1
24645.0;2023;15;STRASBOURG;FEMININ;SCOLAIRE;BAC PROFESSIONNEL;BAC PRO PROD;BAC PRO 25408 REPARATION DES CARROSSERIES;1;1;0;0;1;0;1;0;0;0;0;0;0;1
24652.0;2023;15;STRASBOURG;FEMININ;SCOLAIRE;BAC PROFESSIONNEL;BAC PRO PROD;BAC PRO AG 21114 CONDUITE PRODUCTIONS HORTICOLES;11;11;8;3;0;0;0;8;0;0;0;2;6;3
24653.0;2023;15;STRASBOURG;FEMININ;SCOLAIRE;BAC PROFESSIONNEL;BAC PRO PROD;BAC PRO AG 21302 GEST MILIEUX NATURELS FAUNE;9;8;7;1;0;0;0;7;0;0;1;4;2;1
24655.0;2023;15;STRASBOURG;FEMININ;SCOLAIRE;BAC PROFESSIONNEL;BAC PRO PROD;BAC PRO AG 22108 TEC CONS VTE ALIMENTATION (PAB);1;1;1;0;0;0;0;1;0;0;0;0;1;0
24665.0;2023;15;STRASBOURG;FEMININ;SCOLAIRE;BAC PROFESSIONNEL;BAC PRO SERV;BAC PRO 32208 REAL.PR.IMPR.PLURI.OPTB.PR.IMPR.;8;8;5;3;0;0;0;5;0;0;2;2;1;3
24678.0;2023;15;STRASBOURG;FEMININ;SCOLAIRE;BAC TECHNOLOGIQUE;BAC STAV;BAC STAV AGRONOMIE ALIM ENV TERRITOI;51;51;50;1;0;0;0;50;0;2;4;18;26;1
24680.0;2023;15;STRASBOURG;FEMININ;SCOLAIRE;BAC TECHNOLOGIQUE;BAC STHR;BAC STHR SC.&TEC. HOTELLERIE-RESTAURATION;69;69;65;1;3;2;1;67;0;11;17;23;16;2
24695.0;2023;15;STRASBOURG;MASCULIN;APPRENTISSAGE;BAC PROFESSIONNEL;BAC PRO PROD;BAC PRO 22403 ARTS.& MET.ART:MET.ENSEIGN SIGNA;2;2;2;0;0;0;0;2;0;0;0;1;1;0
24706.0;2023;15;STRASBOURG;MASCULIN;APPRENTISSAGE;BAC PROFESSIONNEL;BAC PRO PROD;BAC PRO 25106 TECHNICIEN D'USINAGE;38;38;33;2;3;3;0;36;0;9;8;10;9;2
24709.0;2023;15;STRASBOURG;MASCULIN;APPRENTISSAGE;BAC PROFESSIONNEL;BAC PRO PROD;BAC PRO 25215 MAINT.VEHIC.OPTB VEHIC.TRANS.ROUT;19;19;18;1;0;0;0;18;0;4;5;4;5;1
24720.0;2023;15;STRASBOURG;MASCULIN;APPRENTISSAGE;BAC PROFESSIONNEL;BAC PRO PROD;BAC PRO 25514 SYST.NUM.OPT.B AUD.RES.EQUIP.DOM.;4;4;4;0;0;0;0;4;0;3;0;1;0;0
24723.0;2023;15;STRASBOURG;MASCULIN;APPRENTISSAGE;BAC PROFESSIONNEL;BAC PRO PROD;BAC PRO AG 21004 CGEA;8;8;7;1;0;0;0;7;0;0;1;1;5;1
24731.0;2023;15;STRASBOURG;MASCULIN;APPRENTISSAGE;BAC PROFESSIONNEL;BAC PRO SERV;BAC PRO 31106 LOGISTIQUE;32;32;23;7;2;1;1;24;0;4;3;5;12;8
24732.0;2023;15;STRASBOURG;MASCULIN;APPRENTISSAGE;BAC PROFESSIONNEL;BAC PRO SERV;BAC PRO 31212 METIERS DE L'ACCUEIL;3;3;3;0;0;0;0;3;0;1;0;1;1;0
24735.0;2023;15;STRASBOURG;MASCULIN;APPRENTISSAGE;BAC PROFESSIONNEL;BAC PRO SERV;BAC PRO 32207 REAL.PR.IMPR.PLURI.OPTA.PR.GRAPH.;3;3;1;2;0;0;0;1;0;0;0;1;0;2
24739.0;2023;15;STRASBOURG;MASCULIN;ENSEIGNEMENT A DISTANCE;BAC PROFESSIONNEL;BAC PRO SERV;BAC PRO 30004 ASSISTANC.GEST.ORGANIS.ACTIVITES;1;1;1;0;0;0;0;1;0;0;0;0;1;0
24741.0;2023;15;STRASBOURG;MASCULIN;ENSEIGNEMENT A DISTANCE;BAC TECHNOLOGIQUE;BAC STMG;BAC STMG GESTION ET FINANCE;1;1;0;1;0;0;0;0;0;0;0;0;0;1
24742.0;2023;15;STRASBOURG;MASCULIN;ENSEIGNEMENT A DISTANCE;BAC TECHNOLOGIQUE;BAC STMG;BAC STMG MERCATIQUE (MARKETING);2;2;0;2;0;0;0;0;0;0;0;0;0;2
24743.0;2023;15;STRASBOURG;MASCULIN;ENSEIGNEMENT A DISTANCE;BAC TECHNOLOGIQUE;BAC STMG;BAC STMG SYSTEMES D'INFORMATION DE GESTION;1;1;1;0;0;0;0;1;0;0;0;1;0;0
24746.0;2023;15;STRASBOURG;MASCULIN;FORMATION CONTINUE;BAC PROFESSIONNEL;BAC PRO PROD;BAC PRO 22703 TECHN.INSTALL.SYST.ENERG.CLIMATI;10;10;10;0;0;0;0;10;0;3;4;2;1;0
24748.0;2023;15;STRASBOURG;MASCULIN;FORMATION CONTINUE;BAC PROFESSIONNEL;BAC PRO PROD;BAC PRO 23404 TECHNICIEN CONSTRUCTEUR BOIS;1;1;1;0;0;0;0;1;0;1;0;0;0;0
24750.0;2023;15;STRASBOURG;MASCULIN;FORMATION CONTINUE;BAC PROFESSIONNEL;BAC PRO PROD;BAC PRO 25007 MAINTENANCE EQUIPEMENTS INDUST.;1;1;1;0;0;0;0;1;0;0;1;0;0;0
24752.0;2023;15;STRASBOURG;MASCULIN;FORMATION CONTINUE;BAC PROFESSIONNEL;BAC PRO PROD;BAC PRO 25214 MAINT.VEHIC.OPTA VOIT.PARTICUL.;9;9;9;0;0;0;0;9;0;1;6;1;1;0
24754.0;2023;15;STRASBOURG;MASCULIN;FORMATION CONTINUE;BAC PROFESSIONNEL;BAC PRO PROD;BAC PRO 25411 TECH.CHAUDRONNERIE INDUSTRIELLE;4;4;3;1;0;0;0;3;0;1;1;1;0;1
24757.0;2023;15;STRASBOURG;MASCULIN;FORMATION CONTINUE;BAC PROFESSIONNEL;BAC PRO SERV;BAC PRO 31213 MET.COM.VEN.OP.A ANI.GES.ESP.COM.;2;1;1;0;0;0;0;1;0;0;0;0;1;0
24758.0;2023;15;STRASBOURG;MASCULIN;INDIVIDUEL;BAC GENERAL;BAC GENERAL;BAC GENE 10019 BAC GENERAL;63;62;30;22;10;6;4;36;0;2;10;10;14;26
24769.0;2023;15;STRASBOURG;MASCULIN;INDIVIDUEL;BAC PROFESSIONNEL;BAC PRO PROD;BAC PRO AG 21211 COND GEST ENTR HIPPIQUE;1;0;0;0;0;0;0;0;0;0;0;0;0;0
24773.0;2023;15;STRASBOURG;MASCULIN;INDIVIDUEL;BAC PROFESSIONNEL;BAC PRO SERV;BAC PRO 31212 METIERS DE L'ACCUEIL;1;1;0;0;1;1;0;1;0;0;0;0;1;0
24777.0;2023;15;STRASBOURG;MASCULIN;INDIVIDUEL;BAC TECHNOLOGIQUE;BAC STAV;BAC STAV AGRONOMIE ALIM ENV TERRITOI;1;1;1;0;0;0;0;1;0;0;0;0;1;0
24780.0;2023;15;STRASBOURG;MASCULIN;INDIVIDUEL;BAC TECHNOLOGIQUE;BAC STMG;BAC STMG GESTION ET FINANCE;2;2;0;2;0;0;0;0;0;0;0;0;0;2
24786.0;2023;15;STRASBOURG;MASCULIN;SCOLAIRE;BAC PROFESSIONNEL;BAC PRO PROD;BAC PRO 22105 BOULANGER-PÂTISSIER;6;6;6;0;0;0;0;6;0;2;2;2;0;0
24794.0;2023;15;STRASBOURG;MASCULIN;SCOLAIRE;BAC PROFESSIONNEL;BAC PRO PROD;BAC PRO 23203 TECHNICIEN BAT. : ORG.REAL.GROS O;7;7;7;0;0;0;0;7;0;0;3;2;2;0
24807.0;2023;15;STRASBOURG;MASCULIN;SCOLAIRE;BAC PROFESSIONNEL;BAC PRO PROD;BAC PRO 25216 MAINT.VEHIC.OPTC MOTOCYCLES;18;18;15;2;1;0;1;15;0;5;5;4;1;3
24812.0;2023;15;STRASBOURG;MASCULIN;SCOLAIRE;BAC PROFESSIONNEL;BAC PRO PROD;BAC PRO 25408 REPARATION DES CARROSSERIES;20;20;15;3;2;1;1;16;0;0;1;4;11;4
24820.0;2023;15;STRASBOURG;MASCULIN;SCOLAIRE;BAC PROFESSIONNEL;BAC PRO PROD;BAC PRO AG 21113 CGEVV;12;12;11;1;0;0;0;11;0;2;3;1;5;1
24822.0;2023;15;STRASBOURG;MASCULIN;SCOLAIRE;BAC PROFESSIONNEL;BAC PRO PROD;BAC PRO AG 21302 GEST MILIEUX NATURELS FAUNE;17;17;14;3;0;0;0;14;0;0;3;8;3;3
24831.0;2023;15;STRASBOURG;MASCULIN;SCOLAIRE;BAC PROFESSIONNEL;BAC PRO SERV;BAC PRO 31114 ORGANIS. TRANSPORT MARCHANDISES;22;22;8;14;0;0;0;8;0;1;1;3;3;14
24833.0;2023;15;STRASBOURG;MASCULIN;SCOLAIRE;BAC PROFESSIONNEL;BAC PRO SERV;BAC PRO 31213 MET.COM.VEN.OP.A ANI.GES.ESP.COM.;351;351;264;48;39;28;11;292;0;13;50;86;143;59
24835.0;2023;15;STRASBOURG;MASCULIN;SCOLAIRE;BAC PROFESSIONNEL;BAC PRO SERV;BAC PRO 32207 REAL.PR.IMPR.PLURI.OPTA.PR.GRAPH.;10;10;8;1;1;0;1;8;0;1;2;4;1;2
24838.0;2023;15;STRASBOURG;MASCULIN;SCOLAIRE;BAC PROFESSIONNEL;BAC PRO SERV;BAC PRO 33004 ACC.SOINS-S.PERS. OPT.EN STRUCTUR;24;24;22;2;0;0;0;22;0;1;4;8;9;2
24846.0;2023;15;STRASBOURG;MASCULIN;SCOLAIRE;BAC PROFESSIONNEL;BAC PRO SERV;BAC PRO AG 33002 SERV PERS TERRIT;8;8;6;2;0;0;0;6;0;0;0;3;3;2
24849.0;2023;15;STRASBOURG;MASCULIN;SCOLAIRE;BAC TECHNOLOGIQUE;BAC STD2A;BAC STD2A SCIENCES & TECHNO. DESIGN-ARTS APPLIQUES;17;17;16;0;1;1;0;17;2;2;6;3;4;0
24853.0;2023;15;STRASBOURG;MASCULIN;SCOLAIRE;BAC TECHNOLOGIQUE;BAC STI2D;BAC STI2D INNOVATION TECHNO.  ET ECO CONCEPTION;267;267;225;9;33;22;11;247;0;11;42;72;122;20
24859.0;2023;15;STRASBOURG;MASCULIN;SCOLAIRE;BAC TECHNOLOGIQUE;BAC STMG;BAC STMG RESSOURCES HUMAINES ET COMMUNICATION;146;146;102;11;33;24;9;126;0;0;3;36;87;20
24875.0;2023;16;TOULOUSE;FEMININ;APPRENTISSAGE;BAC PROFESSIONNEL;BAC PRO PROD;BAC PRO 25411 TECH.CHAUDRONNERIE INDUSTRIELLE;1;1;1;0;0;0;0;1;0;0;0;1;0;0
24893.0;2023;16;TOULOUSE;FEMININ;APPRENTISSAGE;BAC PROFESSIONNEL;BAC PRO SERV;BAC PRO 34304 HYGIENE PROPRETE STERILISATION;12;11;11;0;0;0;0;11;0;0;1;6;4;0
24910.0;2023;16;TOULOUSE;FEMININ;FORMATION CONTINUE;BAC PROFESSIONNEL;BAC PRO PROD;BAC PRO AG 21114 CONDUITE PRODUCTIONS HORTICOLES;9;9;9;0;0;0;0;9;0;3;4;2;0;0
24914.0;2023;16;TOULOUSE;FEMININ;INDIVIDUEL;BAC PROFESSIONNEL;BAC PRO PROD;BAC PRO 25406 OUVRAGES DU BATIMENT METALLERIE;1;1;1;0;0;0;0;1;0;0;0;0;1;0
24930.0;2023;16;TOULOUSE;FEMININ;INDIVIDUEL;BAC TECHNOLOGIQUE;BAC STMG;BAC STMG GESTION ET FINANCE;6;6;0;6;0;0;0;0;0;0;0;0;0;6
24937.0;2023;16;TOULOUSE;FEMININ;SCOLAIRE;BAC PROFESSIONNEL;BAC PRO PROD;BAC PRO 22004 PROC. CHIMIE EAU PAPIERS-CARTONS;3;3;1;1;1;1;0;2;0;0;0;1;1;1
24940.0;2023;16;TOULOUSE;FEMININ;SCOLAIRE;BAC PROFESSIONNEL;BAC PRO PROD;BAC PRO 22106 CUISINE;65;65;56;7;2;1;1;57;0;6;18;20;13;8
24960.0;2023;16;TOULOUSE;FEMININ;SCOLAIRE;BAC PROFESSIONNEL;BAC PRO PROD;BAC PRO 25220 MAINT.MATERIELS OPT.B TP MANUT.;1;1;1;0;0;0;0;1;0;0;0;0;1;0
24970.0;2023;16;TOULOUSE;FEMININ;SCOLAIRE;BAC PROFESSIONNEL;BAC PRO PROD;BAC PRO AG 21113 CGEVV;1;1;1;0;0;0;0;1;0;0;0;0;1;0
24972.0;2023;16;TOULOUSE;FEMININ;SCOLAIRE;BAC PROFESSIONNEL;BAC PRO PROD;BAC PRO AG 21203 TECHN CONSEIL DE VENTE ANIMAL;45;45;38;7;0;0;0;38;0;0;3;15;20;7
24979.0;2023;16;TOULOUSE;FEMININ;SCOLAIRE;BAC PROFESSIONNEL;BAC PRO PROD;BAC PRO AG 22108 TEC CONS VTE ALIMENTATION (PAB);9;9;6;3;0;0;0;6;0;0;0;3;3;3
24991.0;2023;16;TOULOUSE;FEMININ;SCOLAIRE;BAC PROFESSIONNEL;BAC PRO SERV;BAC PRO 33003 ACC.SOINS-S.PERS. OPT.A DOMICILE;61;61;57;3;1;0;1;57;0;2;8;16;31;4
24993.0;2023;16;TOULOUSE;FEMININ;SCOLAIRE;BAC PROFESSIONNEL;BAC PRO SERV;BAC PRO 33006 ANIMAT. ENFANCE& PERSONNES AGEES;15;15;14;0;1;1;0;15;0;3;6;3;3;0
24995.0;2023;16;TOULOUSE;FEMININ;SCOLAIRE;BAC PROFESSIONNEL;BAC PRO SERV;BAC PRO 33103 TECHNICIEN APPAREIL. ORTHOPEDIQUE;6;6;6;0;0;0;0;6;0;1;3;1;1;0
25004.0;2023;16;TOULOUSE;FEMININ;SCOLAIRE;BAC TECHNOLOGIQUE;BAC S2TMD;BAC S2TMD DANSE;7;7;7;0;0;0;0;7;1;0;3;3;0;0
25005.0;2023;16;TOULOUSE;FEMININ;SCOLAIRE;BAC TECHNOLOGIQUE;BAC S2TMD;BAC S2TMD MUSIQUE;8;8;8;0;0;0;0;8;5;0;3;0;0;0
25007.0;2023;16;TOULOUSE;FEMININ;SCOLAIRE;BAC TECHNOLOGIQUE;BAC ST2S;BAC ST2S SCIENCES & TECHNO. SANTE & SOCIAL;797;797;690;29;78;53;25;743;2;28;133;267;313;54
25008.0;2023;16;TOULOUSE;FEMININ;SCOLAIRE;BAC TECHNOLOGIQUE;BAC STAV;BAC STAV AGRONOMIE ALIM ENV TERRITOI;193;192;189;3;0;0;0;189;0;5;37;79;68;3
25011.0;2023;16;TOULOUSE;FEMININ;SCOLAIRE;BAC TECHNOLOGIQUE;BAC STI2D;BAC STI2D ARCHITECTURE ET CONSTRUCTION;53;53;48;2;3;2;1;50;0;5;10;17;18;3
25013.0;2023;16;TOULOUSE;FEMININ;SCOLAIRE;BAC TECHNOLOGIQUE;BAC STI2D;BAC STI2D INNOVATION TECHNO.  ET ECO CONCEPTION;25;25;24;0;1;1;0;25;0;3;4;8;10;0
25015.0;2023;16;TOULOUSE;FEMININ;SCOLAIRE;BAC TECHNOLOGIQUE;BAC STL;BAC STL BIOCHIM.-BIOLOGIE-BIOTECHNOL.;120;120;107;0;13;5;8;112;1;4;23;41;43;8
25017.0;2023;16;TOULOUSE;FEMININ;SCOLAIRE;BAC TECHNOLOGIQUE;BAC STMG;BAC STMG GESTION ET FINANCE;296;296;265;6;25;19;6;284;1;7;55;110;111;12
25018.0;2023;16;TOULOUSE;FEMININ;SCOLAIRE;BAC TECHNOLOGIQUE;BAC STMG;BAC STMG MERCATIQUE (MARKETING);763;763;647;26;90;64;26;711;0;18;99;274;320;52
25020.0;2023;16;TOULOUSE;FEMININ;SCOLAIRE;BAC TECHNOLOGIQUE;BAC STMG;BAC STMG SYSTEMES D'INFORMATION DE GESTION;9;9;8;0;1;1;0;9;0;1;2;1;5;0
25028.0;2023;16;TOULOUSE;MASCULIN;APPRENTISSAGE;BAC PROFESSIONNEL;BAC PRO PROD;BAC PRO 22705 TECHNICIEN GAZ;5;5;5;0;0;0;0;5;0;2;0;3;0;0
25031.0;2023;16;TOULOUSE;MASCULIN;APPRENTISSAGE;BAC PROFESSIONNEL;BAC PRO PROD;BAC PRO 23102 TRAVAUX PUBLICS;11;10;8;2;0;0;0;8;0;0;1;3;4;2
25033.0;2023;16;TOULOUSE;MASCULIN;APPRENTISSAGE;BAC PROFESSIONNEL;BAC PRO PROD;BAC PRO 23203 TECHNICIEN BAT. : ORG.REAL.GROS O;7;7;5;1;1;1;0;6;0;0;2;2;2;1
25036.0;2023;16;TOULOUSE;MASCULIN;APPRENTISSAGE;BAC PROFESSIONNEL;BAC PRO PROD;BAC PRO 23303 MENUISERIE ALUMINIUM-VERRE;8;8;7;0;1;1;0;8;0;1;0;4;3;0
25041.0;2023;16;TOULOUSE;MASCULIN;APPRENTISSAGE;BAC PROFESSIONNEL;BAC PRO PROD;BAC PRO 23407 TECHNIC.FAB.BOIS ET MATERX ASSOC;5;5;3;1;1;1;0;4;0;0;1;2;1;1
25045.0;2023;16;TOULOUSE;MASCULIN;APPRENTISSAGE;BAC PROFESSIONNEL;BAC PRO PROD;BAC PRO 25214 MAINT.VEHIC.OPTA VOIT.PARTICUL.;144;143;112;16;15;8;7;120;0;14;31;36;39;23
25046.0;2023;16;TOULOUSE;MASCULIN;APPRENTISSAGE;BAC PROFESSIONNEL;BAC PRO PROD;BAC PRO 25215 MAINT.VEHIC.OPTB VEHIC.TRANS.ROUT;26;26;22;2;2;2;0;24;0;3;5;8;8;2
25047.0;2023;16;TOULOUSE;MASCULIN;APPRENTISSAGE;BAC PROFESSIONNEL;BAC PRO PROD;BAC PRO 25216 MAINT.VEHIC.OPTC MOTOCYCLES;20;20;19;1;0;0;0;19;0;4;9;3;3;1
25057.0;2023;16;TOULOUSE;MASCULIN;APPRENTISSAGE;BAC PROFESSIONNEL;BAC PRO PROD;BAC PRO 25509 TECHNIC. FROID CONDITIONNEMT AIR;19;19;17;2;0;0;0;17;0;2;4;9;2;2
25060.0;2023;16;TOULOUSE;MASCULIN;APPRENTISSAGE;BAC PROFESSIONNEL;BAC PRO PROD;BAC PRO AG 21004 CGEA;36;36;36;0;0;0;0;36;0;1;4;15;16;0
25063.0;2023;16;TOULOUSE;MASCULIN;APPRENTISSAGE;BAC PROFESSIONNEL;BAC PRO SERV;BAC PRO 30004 ASSISTANC.GEST.ORGANIS.ACTIVITES;7;7;5;1;1;0;1;5;0;0;2;2;1;2
25064.0;2023;16;TOULOUSE;MASCULIN;APPRENTISSAGE;BAC PROFESSIONNEL;BAC PRO SERV;BAC PRO 31106 LOGISTIQUE;17;17;13;2;2;0;2;13;0;2;3;3;5;4
25066.0;2023;16;TOULOUSE;MASCULIN;APPRENTISSAGE;BAC PROFESSIONNEL;BAC PRO SERV;BAC PRO 31213 MET.COM.VEN.OP.A ANI.GES.ESP.COM.;95;95;58;27;10;5;5;63;0;3;6;23;31;32
25071.0;2023;16;TOULOUSE;MASCULIN;APPRENTISSAGE;BAC PROFESSIONNEL;BAC PRO SERV;BAC PRO 32304 PHOTOGRAPHIE;4;4;4;0;0;0;0;4;0;2;2;0;0;0
25076.0;2023;16;TOULOUSE;MASCULIN;ENSEIGNEMENT A DISTANCE;BAC PROFESSIONNEL;BAC PRO PROD;BAC PRO 25408 REPARATION DES CARROSSERIES;1;0;0;0;0;0;0;0;0;0;0;0;0;0
25083.0;2023;16;TOULOUSE;MASCULIN;ENSEIGNEMENT A DISTANCE;BAC TECHNOLOGIQUE;BAC STMG;BAC STMG MERCATIQUE (MARKETING);3;3;3;0;0;0;0;3;0;0;0;2;1;0
25086.0;2023;16;TOULOUSE;MASCULIN;FORMATION CONTINUE;BAC PROFESSIONNEL;BAC PRO PROD;BAC PRO 22705 TECHNICIEN GAZ;1;1;1;0;0;0;0;1;0;0;0;0;1;0
25093.0;2023;16;TOULOUSE;MASCULIN;FORMATION CONTINUE;BAC PROFESSIONNEL;BAC PRO PROD;BAC PRO 25510 METIERS ELECT. ENVIRON. CONNECTES;2;2;2;0;0;0;0;2;0;2;0;0;0;0
25108.0;2023;16;TOULOUSE;MASCULIN;INDIVIDUEL;BAC PROFESSIONNEL;BAC PRO PROD;BAC PRO 25406 OUVRAGES DU BATIMENT METALLERIE;1;0;0;0;0;0;0;0;0;0;0;0;0;0
25113.0;2023;16;TOULOUSE;MASCULIN;INDIVIDUEL;BAC PROFESSIONNEL;BAC PRO PROD;BAC PRO AG 21114 CONDUITE PRODUCTIONS HORTICOLES;2;1;1;0;0;0;0;1;0;0;0;0;1;0
25117.0;2023;16;TOULOUSE;MASCULIN;INDIVIDUEL;BAC PROFESSIONNEL;BAC PRO SERV;BAC PRO 31106 LOGISTIQUE;1;1;1;0;0;0;0;1;0;0;0;1;0;0
25122.0;2023;16;TOULOUSE;MASCULIN;INDIVIDUEL;BAC TECHNOLOGIQUE;BAC STI2D;BAC STI2D ARCHITECTURE ET CONSTRUCTION;1;1;0;1;0;0;0;0;0;0;0;0;0;1
25128.0;2023;16;TOULOUSE;MASCULIN;SCOLAIRE;BAC GENERAL;BAC GENERAL;BAC GENE 10019 BAC GENERAL;7123;7123;6608;96;419;289;130;6897;131;904;1617;2124;2121;226
25129.0;2023;16;TOULOUSE;MASCULIN;SCOLAIRE;BAC PROFESSIONNEL;BAC PRO PROD;BACPRO 20002 ETUD.DEFINITION PRDTS INDUSTRIEL;20;20;14;5;1;1;0;15;0;1;3;5;6;5
25131.0;2023;16;TOULOUSE;MASCULIN;SCOLAIRE;BAC PROFESSIONNEL;BAC PRO PROD;BAC PRO 22003 BIO-INDUSTRIES DE TRANSFORMATION;14;14;12;2;0;0;0;12;0;1;2;6;3;2
25139.0;2023;16;TOULOUSE;MASCULIN;SCOLAIRE;BAC PROFESSIONNEL;BAC PRO PROD;BAC PRO 22704 TECHN. MAINT. SYST.ENERG.CLIMATI;28;28;21;5;2;0;2;21;0;1;1;7;12;7
25143.0;2023;16;TOULOUSE;MASCULIN;SCOLAIRE;BAC PROFESSIONNEL;BAC PRO PROD;BAC PRO 23102 TRAVAUX PUBLICS;41;41;28;9;4;4;0;32;0;0;2;16;14;9
25146.0;2023;16;TOULOUSE;MASCULIN;SCOLAIRE;BAC PROFESSIONNEL;BAC PRO PROD;BAC PRO 23205 INTERV. SUR PATRIMOINE BATI OPT.A;11;11;4;5;2;2;0;6;0;1;0;1;4;5
25148.0;2023;16;TOULOUSE;MASCULIN;SCOLAIRE;BAC PROFESSIONNEL;BAC PRO PROD;BAC PRO 23304 AMENAGEMENT FINITION BATIMENT;8;8;3;4;1;0;1;3;0;0;2;1;0;5
25149.0;2023;16;TOULOUSE;MASCULIN;SCOLAIRE;BAC PROFESSIONNEL;BAC PRO PROD;BAC PRO 23404 TECHNICIEN CONSTRUCTEUR BOIS;34;34;25;9;0;0;0;25;0;1;3;10;11;9
25153.0;2023;16;TOULOUSE;MASCULIN;SCOLAIRE;BAC PROFESSIONNEL;BAC PRO PROD;BAC PRO 23408 Etude et réalisation d'agencement;2;2;0;2;0;0;0;0;0;0;0;0;0;2
25157.0;2023;16;TOULOUSE;MASCULIN;SCOLAIRE;BAC PROFESSIONNEL;BAC PRO PROD;BAC PRO 25006 MICROTECHNIQUES;13;13;13;0;0;0;0;13;0;1;8;4;0;0
25158.0;2023;16;TOULOUSE;MASCULIN;SCOLAIRE;BAC PROFESSIONNEL;BAC PRO PROD;BAC PRO 25007 MAINTENANCE EQUIPEMENTS INDUST.;246;246;171;68;7;6;1;177;0;8;30;67;72;69
25162.0;2023;16;TOULOUSE;MASCULIN;SCOLAIRE;BAC PROFESSIONNEL;BAC PRO PROD;BAC PRO 25214 MAINT.VEHIC.OPTA VOIT.PARTICUL.;205;205;157;38;10;6;4;163;0;15;26;57;65;42
25169.0;2023;16;TOULOUSE;MASCULIN;SCOLAIRE;BAC PROFESSIONNEL;BAC PRO PROD;BAC PRO 25303 AERONAUTIQUE OPTION SYSTEMES;41;41;40;1;0;0;0;40;0;5;14;14;7;1
25176.0;2023;16;TOULOUSE;MASCULIN;SCOLAIRE;BAC PROFESSIONNEL;BAC PRO PROD;BAC PRO 25513 SYST.NUM.OPT.A SURETE SECURITE;34;34;30;4;0;0;0;30;0;0;3;16;11;4
25186.0;2023;16;TOULOUSE;MASCULIN;SCOLAIRE;BAC PROFESSIONNEL;BAC PRO PROD;BAC PRO AG 21302 GEST MILIEUX NATURELS FAUNE;105;105;98;7;0;0;0;98;0;3;12;47;36;7
25191.0;2023;16;TOULOUSE;MASCULIN;SCOLAIRE;BAC PROFESSIONNEL;BAC PRO PROD;BAC PRO AG 22108 TEC CONS VTE ALIMENTATION (PAB);22;22;19;3;0;0;0;19;0;1;2;5;11;3
25202.0;2023;16;TOULOUSE;MASCULIN;SCOLAIRE;BAC PROFESSIONNEL;BAC PRO SERV;BAC PRO 32304 PHOTOGRAPHIE;5;5;5;0;0;0;0;5;0;0;1;2;2;0
25205.0;2023;16;TOULOUSE;MASCULIN;SCOLAIRE;BAC PROFESSIONNEL;BAC PRO SERV;BAC PRO 33006 ANIMAT. ENFANCE& PERSONNES AGEES;15;15;15;0;0;0;0;15;0;1;5;6;3;0
25209.0;2023;16;TOULOUSE;MASCULIN;SCOLAIRE;BAC PROFESSIONNEL;BAC PRO SERV;BAC PRO 33403 COMMERC. SERVICES EN RESTAURATION;104;103;88;11;4;4;0;92;0;3;21;38;30;11
25212.0;2023;16;TOULOUSE;MASCULIN;SCOLAIRE;BAC PROFESSIONNEL;BAC PRO SERV;BAC PRO 33604 METIERS DE LA COIFFURE;2;2;1;1;0;0;0;1;0;0;1;0;0;1
25216.0;2023;16;TOULOUSE;MASCULIN;SCOLAIRE;BAC TECHNOLOGIQUE;BAC S2TMD;BAC S2TMD MUSIQUE;10;10;10;0;0;0;0;10;1;1;5;2;1;0
25223.0;2023;16;TOULOUSE;MASCULIN;SCOLAIRE;BAC TECHNOLOGIQUE;BAC STI2D;BAC STI2D ENERGIES  ET ENVIRONNEMENT;142;142;119;4;19;9;10;128;0;4;24;42;58;14
25231.0;2023;16;TOULOUSE;MASCULIN;SCOLAIRE;BAC TECHNOLOGIQUE;BAC STMG;BAC STMG SYSTEMES D'INFORMATION DE GESTION;25;25;18;1;6;6;0;24;0;0;0;6;18;1
25232.0;2023;25;VERSAILLES;FEMININ;APPRENTISSAGE;BAC PROFESSIONNEL;BAC PRO PROD;BAC PRO 22105 BOULANGER-PÂTISSIER;14;14;14;0;0;0;0;14;0;0;4;7;3;0
25237.0;2023;25;VERSAILLES;FEMININ;APPRENTISSAGE;BAC PROFESSIONNEL;BAC PRO PROD;BAC PRO 25216 MAINT.VEHIC.OPTC MOTOCYCLES;4;4;4;0;0;0;0;4;0;1;2;1;0;0
25241.0;2023;25;VERSAILLES;FEMININ;APPRENTISSAGE;BAC PROFESSIONNEL;BAC PRO PROD;BAC PRO 25510 METIERS ELECT. ENVIRON. CONNECTES;4;4;4;0;0;0;0;4;0;2;2;0;0;0
25244.0;2023;25;VERSAILLES;FEMININ;APPRENTISSAGE;BAC PROFESSIONNEL;BAC PRO PROD;BAC PRO AG 21211 COND GEST ENTR HIPPIQUE;37;35;26;9;0;0;0;26;0;1;5;3;17;9
25259.0;2023;25;VERSAILLES;FEMININ;ENSEIGNEMENT A DISTANCE;BAC PROFESSIONNEL;BAC PRO SERV;BAC PRO 30004 ASSISTANC.GEST.ORGANIS.ACTIVITES;12;7;5;2;0;0;0;5;0;0;1;2;2;2
25269.0;2023;25;VERSAILLES;FEMININ;ENSEIGNEMENT A DISTANCE;BAC TECHNOLOGIQUE;BAC STMG;BAC STMG RESSOURCES HUMAINES ET COMMUNICATION;11;11;8;2;1;0;1;8;0;0;1;2;5;3
25271.0;2023;25;VERSAILLES;FEMININ;FORMATION CONTINUE;BAC PROFESSIONNEL;BAC PRO PROD;BAC PRO 20102 PILOTE DE LIGNE DE PRODUCTION;1;1;1;0;0;0;0;1;0;1;0;0;0;0
25277.0;2023;25;VERSAILLES;FEMININ;FORMATION CONTINUE;BAC PROFESSIONNEL;BAC PRO SERV;BAC PRO 33603 ESTHETIQUE COSMETIQUE PARFUMERIE;1;0;0;0;0;0;0;0;0;0;0;0;0;0
25287.0;2023;25;VERSAILLES;FEMININ;INDIVIDUEL;BAC PROFESSIONNEL;BAC PRO SERV;BAC PRO 31212 METIERS DE L'ACCUEIL;12;8;4;2;2;2;0;6;0;0;0;1;5;2
25290.0;2023;25;VERSAILLES;FEMININ;INDIVIDUEL;BAC PROFESSIONNEL;BAC PRO SERV;BAC PRO 33003 ACC.SOINS-S.PERS. OPT.A DOMICILE;2;2;0;2;0;0;0;0;0;0;0;0;0;2
25296.0;2023;25;VERSAILLES;FEMININ;INDIVIDUEL;BAC TECHNOLOGIQUE;BAC STI2D;BAC STI2D ENERGIES  ET ENVIRONNEMENT;1;1;0;1;0;0;0;0;0;0;0;0;0;1
25299.0;2023;25;VERSAILLES;FEMININ;INDIVIDUEL;BAC TECHNOLOGIQUE;BAC STMG;BAC STMG GESTION ET FINANCE;12;12;0;9;3;2;1;2;0;0;0;0;2;10
25300.0;2023;25;VERSAILLES;FEMININ;INDIVIDUEL;BAC TECHNOLOGIQUE;BAC STMG;BAC STMG MERCATIQUE (MARKETING);31;28;4;18;6;3;3;7;0;0;0;0;7;21
25302.0;2023;25;VERSAILLES;FEMININ;INDIVIDUEL;BAC TECHNOLOGIQUE;BAC STMG;BAC STMG SYSTEMES D'INFORMATION DE GESTION;3;2;2;0;0;0;0;2;0;0;0;1;1;0
25308.0;2023;25;VERSAILLES;FEMININ;SCOLAIRE;BAC PROFESSIONNEL;BAC PRO PROD;BAC PRO 23004 TECHN. ETUDES BAT.A ETUDES & ECO.;9;9;5;3;1;1;0;6;0;0;1;2;3;3
25312.0;2023;25;VERSAILLES;FEMININ;SCOLAIRE;BAC PROFESSIONNEL;BAC PRO PROD;BAC PRO 23304 AMENAGEMENT FINITION BATIMENT;3;3;3;0;0;0;0;3;0;0;0;2;1;0
25323.0;2023;25;VERSAILLES;FEMININ;SCOLAIRE;BAC PROFESSIONNEL;BAC PRO PROD;BAC PRO 25214 MAINT.VEHIC.OPTA VOIT.PARTICUL.;7;7;7;0;0;0;0;7;0;2;2;2;1;0
25326.0;2023;25;VERSAILLES;FEMININ;SCOLAIRE;BAC PROFESSIONNEL;BAC PRO PROD;BAC PRO 25303 AERONAUTIQUE OPTION SYSTEMES;2;2;2;0;0;0;0;2;0;0;1;1;0;0
25328.0;2023;25;VERSAILLES;FEMININ;SCOLAIRE;BAC PROFESSIONNEL;BAC PRO PROD;BAC PRO 25510 METIERS ELECT. ENVIRON. CONNECTES;6;6;4;2;0;0;0;4;0;1;0;0;3;2
25335.0;2023;25;VERSAILLES;FEMININ;SCOLAIRE;BAC PROFESSIONNEL;BAC PRO PROD;BAC PRO AG 21302 GEST MILIEUX NATURELS FAUNE;11;11;11;0;0;0;0;11;0;0;3;3;5;0
25336.0;2023;25;VERSAILLES;FEMININ;SCOLAIRE;BAC PROFESSIONNEL;BAC PRO PROD;BAC PRO AG 21303 FORET;1;1;1;0;0;0;0;1;0;0;0;0;1;0
25340.0;2023;25;VERSAILLES;FEMININ;SCOLAIRE;BAC PROFESSIONNEL;BAC PRO SERV;BAC PRO 31107 CONDUCT. TRANSP.ROUT.MARCHANDISES;4;4;2;2;0;0;0;2;0;0;1;1;0;2
25341.0;2023;25;VERSAILLES;FEMININ;SCOLAIRE;BAC PROFESSIONNEL;BAC PRO SERV;BAC PRO 31114 ORGANIS. TRANSPORT MARCHANDISES;5;5;4;1;0;0;0;4;0;0;1;1;2;1
25343.0;2023;25;VERSAILLES;FEMININ;SCOLAIRE;BAC PROFESSIONNEL;BAC PRO SERV;BAC PRO 31213 MET.COM.VEN.OP.A ANI.GES.ESP.COM.;824;824;640;128;56;43;13;683;0;27;115;253;288;141
25344.0;2023;25;VERSAILLES;FEMININ;SCOLAIRE;BAC PROFESSIONNEL;BAC PRO SERV;BAC PRO 31214 MET.COM.VEN.OP.B PR.CL.VA.OF.COM.;386;386;334;39;13;11;2;345;0;22;85;127;111;41
25345.0;2023;25;VERSAILLES;FEMININ;SCOLAIRE;BAC PROFESSIONNEL;BAC PRO SERV;BAC PRO 32206 FACONNAGE PRODTS IMPRIMES ROUTAGE;2;2;2;0;0;0;0;2;0;1;0;1;0;0
25346.0;2023;25;VERSAILLES;FEMININ;SCOLAIRE;BAC PROFESSIONNEL;BAC PRO SERV;BAC PRO 32207 REAL.PR.IMPR.PLURI.OPTA.PR.GRAPH.;16;16;15;1;0;0;0;15;0;3;6;3;3;1
25350.0;2023;25;VERSAILLES;FEMININ;SCOLAIRE;BAC PROFESSIONNEL;BAC PRO SERV;BAC PRO 33002 SERVICES DE PROXIMITE  VIE LOCAL;4;4;2;0;2;1;1;3;0;0;0;0;3;1
25353.0;2023;25;VERSAILLES;FEMININ;SCOLAIRE;BAC PROFESSIONNEL;BAC PRO SERV;BAC PRO 33006 ANIMAT. ENFANCE& PERSONNES AGEES;99;99;77;19;3;2;1;79;0;6;18;35;20;20
25357.0;2023;25;VERSAILLES;FEMININ;SCOLAIRE;BAC PROFESSIONNEL;BAC PRO SERV;BAC PRO 33604 METIERS DE LA COIFFURE;43;43;35;7;1;1;0;36;0;2;5;14;15;7
25360.0;2023;25;VERSAILLES;FEMININ;SCOLAIRE;BAC PROFESSIONNEL;BAC PRO SERV;BAC PRO AG 33002 SERV PERS TERRIT;49;49;39;10;0;0;0;39;0;0;5;12;22;10
25376.0;2023;25;VERSAILLES;FEMININ;SCOLAIRE;BAC TECHNOLOGIQUE;BAC STMG;BAC STMG SYSTEMES D'INFORMATION DE GESTION;143;143;79;18;46;32;14;111;0;2;7;28;74;32
25380.0;2023;25;VERSAILLES;MASCULIN;APPRENTISSAGE;BAC PROFESSIONNEL;BAC PRO PROD;BAC PRO 22704 TECHN. MAINT. SYST.ENERG.CLIMATI;57;57;18;36;3;2;1;20;0;2;4;4;10;37
25382.0;2023;25;VERSAILLES;MASCULIN;APPRENTISSAGE;BAC PROFESSIONNEL;BAC PRO PROD;BAC PRO 23203 TECHNICIEN BAT. : ORG.REAL.GROS O;31;31;16;7;8;5;3;21;0;2;3;2;14;10
25384.0;2023;25;VERSAILLES;MASCULIN;APPRENTISSAGE;BAC PROFESSIONNEL;BAC PRO PROD;BAC PRO 23303 MENUISERIE ALUMINIUM-VERRE;1;1;0;1;0;0;0;0;0;0;0;0;0;1
25388.0;2023;25;VERSAILLES;MASCULIN;APPRENTISSAGE;BAC PROFESSIONNEL;BAC PRO PROD;BAC PRO 25106 TECHNICIEN D'USINAGE;17;17;13;4;0;0;0;13;0;0;3;5;5;4
25395.0;2023;25;VERSAILLES;MASCULIN;APPRENTISSAGE;BAC PROFESSIONNEL;BAC PRO PROD;BAC PRO 25303 AERONAUTIQUE OPTION SYSTEMES;69;69;67;2;0;0;0;67;0;23;20;16;8;2
25410.0;2023;25;VERSAILLES;MASCULIN;APPRENTISSAGE;BAC PROFESSIONNEL;BAC PRO SERV;BAC PRO 31107 CONDUCT. TRANSP.ROUT.MARCHANDISES;11;11;11;0;0;0;0;11;0;1;5;5;0;0
25412.0;2023;25;VERSAILLES;MASCULIN;APPRENTISSAGE;BAC PROFESSIONNEL;BAC PRO SERV;BAC PRO 31114 ORGANIS. TRANSPORT MARCHANDISES;1;1;1;0;0;0;0;1;0;1;0;0;0;0
25415.0;2023;25;VERSAILLES;MASCULIN;APPRENTISSAGE;BAC PROFESSIONNEL;BAC PRO SERV;BAC PRO 33003 ACC.SOINS-S.PERS. OPT.A DOMICILE;1;1;0;1;0;0;0;0;0;0;0;0;0;1
25426.0;2023;25;VERSAILLES;MASCULIN;ENSEIGNEMENT A DISTANCE;BAC PROFESSIONNEL;BAC PRO SERV;BAC PRO 33004 ACC.SOINS-S.PERS. OPT.EN STRUCTUR;3;0;0;0;0;0;0;0;0;0;0;0;0;0
25434.0;2023;25;VERSAILLES;MASCULIN;FORMATION CONTINUE;BAC PROFESSIONNEL;BAC PRO PROD;BAC PRO 23005 TECHN. ETUDES BAT B ASSIST.ARCHI.;2;2;2;0;0;0;0;2;0;0;1;1;0;0
25437.0;2023;25;VERSAILLES;MASCULIN;FORMATION CONTINUE;BAC PROFESSIONNEL;BAC PRO PROD;BAC PRO 25007 MAINTENANCE EQUIPEMENTS INDUST.;8;8;7;1;0;0;0;7;0;1;2;0;4;1
25439.0;2023;25;VERSAILLES;MASCULIN;FORMATION CONTINUE;BAC PROFESSIONNEL;BAC PRO PROD;BAC PRO 25304 AERONAUTIQUE OPTION STRUCTURE;1;1;1;0;0;0;0;1;0;1;0;0;0;0
25442.0;2023;25;VERSAILLES;MASCULIN;FORMATION CONTINUE;BAC PROFESSIONNEL;BAC PRO SERV;BAC PRO 31106 LOGISTIQUE;1;1;0;1;0;0;0;0;0;0;0;0;0;1
25447.0;2023;25;VERSAILLES;MASCULIN;INDIVIDUEL;BAC GENERAL;BAC GENERAL;BAC GENE 10019 BAC GENERAL;397;392;169;172;51;32;19;201;2;21;40;46;92;191
25451.0;2023;25;VERSAILLES;MASCULIN;INDIVIDUEL;BAC PROFESSIONNEL;BAC PRO PROD;BAC PRO 23408 Etude et réalisation d'agencement;1;1;0;1;0;0;0;0;0;0;0;0;0;1
25454.0;2023;25;VERSAILLES;MASCULIN;INDIVIDUEL;BAC PROFESSIONNEL;BAC PRO PROD;BAC PRO 25007 MAINTENANCE EQUIPEMENTS INDUST.;2;1;0;0;1;0;1;0;0;0;0;0;0;1
25456.0;2023;25;VERSAILLES;MASCULIN;INDIVIDUEL;BAC PROFESSIONNEL;BAC PRO PROD;BAC PRO 25214 MAINT.VEHIC.OPTA VOIT.PARTICUL.;3;2;1;1;0;0;0;1;0;0;0;0;1;1
25458.0;2023;25;VERSAILLES;MASCULIN;INDIVIDUEL;BAC PROFESSIONNEL;BAC PRO PROD;BAC PRO 25220 MAINT.MATERIELS OPT.B TP MANUT.;1;1;0;0;1;1;0;1;0;0;0;0;1;0
25464.0;2023;25;VERSAILLES;MASCULIN;INDIVIDUEL;BAC PROFESSIONNEL;BAC PRO PROD;BAC PRO 25514 SYST.NUM.OPT.B AUD.RES.EQUIP.DOM.;3;2;0;1;1;0;1;0;0;0;0;0;0;2
25465.0;2023;25;VERSAILLES;MASCULIN;INDIVIDUEL;BAC PROFESSIONNEL;BAC PRO PROD;BAC PRO 25515 SYST.NUM.OPT.C RES.INF.SYST.COMM.;2;1;0;1;0;0;0;0;0;0;0;0;0;1
25467.0;2023;25;VERSAILLES;MASCULIN;INDIVIDUEL;BAC PROFESSIONNEL;BAC PRO PROD;BAC PRO AG 21113 CGEVV;1;1;1;0;0;0;0;1;0;0;0;0;1;0
25470.0;2023;25;VERSAILLES;MASCULIN;INDIVIDUEL;BAC PROFESSIONNEL;BAC PRO SERV;BAC PRO 31106 LOGISTIQUE;3;2;0;1;1;0;1;0;0;0;0;0;0;2
25481.0;2023;25;VERSAILLES;MASCULIN;INDIVIDUEL;BAC PROFESSIONNEL;BAC PRO SERV;BAC PRO 33403 COMMERC. SERVICES EN RESTAURATION;2;2;0;2;0;0;0;0;0;0;0;0;0;2
25492.0;2023;25;VERSAILLES;MASCULIN;INDIVIDUEL;BAC TECHNOLOGIQUE;BAC STMG;BAC STMG MERCATIQUE (MARKETING);51;49;11;31;7;5;2;16;0;0;0;1;15;33
25495.0;2023;25;VERSAILLES;MASCULIN;SCOLAIRE;BAC GENERAL;BAC GENERAL;BAC GENE 10019 BAC GENERAL;18436;18436;16271;464;1701;1206;495;17477;230;2055;4118;5241;5833;959
25502.0;2023;25;VERSAILLES;MASCULIN;SCOLAIRE;BAC PROFESSIONNEL;BAC PRO PROD;BAC PRO 22704 TECHN. MAINT. SYST.ENERG.CLIMATI;103;103;54;38;11;11;0;65;0;1;6;18;40;38
25509.0;2023;25;VERSAILLES;MASCULIN;SCOLAIRE;BAC PROFESSIONNEL;BAC PRO PROD;BAC PRO 23303 MENUISERIE ALUMINIUM-VERRE;17;17;12;3;2;2;0;14;0;0;1;4;9;3
25515.0;2023;25;VERSAILLES;MASCULIN;SCOLAIRE;BAC PROFESSIONNEL;BAC PRO PROD;BAC PRO 24203 METIERS DE LA MODE - VÊTEMENT;11;11;10;1;0;0;0;10;0;3;3;0;4;1
25516.0;2023;25;VERSAILLES;MASCULIN;SCOLAIRE;BAC PROFESSIONNEL;BAC PRO PROD;BAC PRO 25006 MICROTECHNIQUES;138;138;105;27;6;5;1;110;0;5;21;32;52;28
25523.0;2023;25;VERSAILLES;MASCULIN;SCOLAIRE;BAC PROFESSIONNEL;BAC PRO PROD;BAC PRO 25216 MAINT.VEHIC.OPTC MOTOCYCLES;29;29;23;5;1;1;0;24;0;1;8;9;6;5
25529.0;2023;25;VERSAILLES;MASCULIN;SCOLAIRE;BAC PROFESSIONNEL;BAC PRO PROD;BAC PRO 25305 AVIATION GENERALE;9;9;9;0;0;0;0;9;0;0;5;4;0;0
25532.0;2023;25;VERSAILLES;MASCULIN;SCOLAIRE;BAC PROFESSIONNEL;BAC PRO PROD;BAC PRO 25410 CONSTRUCTION DES CARROSSERIES;15;15;15;0;0;0;0;15;0;2;5;7;1;0
25533.0;2023;25;VERSAILLES;MASCULIN;SCOLAIRE;BAC PROFESSIONNEL;BAC PRO PROD;BAC PRO 25411 TECH.CHAUDRONNERIE INDUSTRIELLE;61;60;44;14;2;1;1;45;0;1;5;19;20;15
25534.0;2023;25;VERSAILLES;MASCULIN;SCOLAIRE;BAC PROFESSIONNEL;BAC PRO PROD;BAC PRO 25509 TECHNIC. FROID CONDITIONNEMT AIR;64;64;28;33;3;2;1;30;0;1;1;15;13;34
25538.0;2023;25;VERSAILLES;MASCULIN;SCOLAIRE;BAC PROFESSIONNEL;BAC PRO PROD;BAC PRO 25515 SYST.NUM.OPT.C RES.INF.SYST.COMM.;311;311;260;33;18;14;4;274;0;17;50;98;109;37
25541.0;2023;25;VERSAILLES;MASCULIN;SCOLAIRE;BAC PROFESSIONNEL;BAC PRO PROD;BAC PRO AG 21114 CONDUITE PRODUCTIONS HORTICOLES;10;8;5;3;0;0;0;5;0;0;1;1;3;3
25546.0;2023;25;VERSAILLES;MASCULIN;SCOLAIRE;BAC PROFESSIONNEL;BAC PRO SERV;BAC PRO 30004 ASSISTANC.GEST.ORGANIS.ACTIVITES;991;990;644;286;60;47;13;691;0;6;77;217;391;299
25548.0;2023;25;VERSAILLES;MASCULIN;SCOLAIRE;BAC PROFESSIONNEL;BAC PRO SERV;BAC PRO 31107 CONDUCT. TRANSP.ROUT.MARCHANDISES;42;42;28;11;3;3;0;31;0;0;3;10;18;11
25556.0;2023;25;VERSAILLES;MASCULIN;SCOLAIRE;BAC PROFESSIONNEL;BAC PRO SERV;BAC PRO 32303 ART.& MET.ART:COM.VIS.VIS.PLURI-M;52;52;46;4;2;2;0;48;0;6;12;20;10;4
25557.0;2023;25;VERSAILLES;MASCULIN;SCOLAIRE;BAC PROFESSIONNEL;BAC PRO SERV;BAC PRO 32304 PHOTOGRAPHIE;8;8;6;2;0;0;0;6;0;0;1;1;4;2
25564.0;2023;25;VERSAILLES;MASCULIN;SCOLAIRE;BAC PROFESSIONNEL;BAC PRO SERV;BAC PRO 33604 METIERS DE LA COIFFURE;1;1;1;0;0;0;0;1;0;0;0;0;1;0
25572.0;2023;25;VERSAILLES;MASCULIN;SCOLAIRE;BAC TECHNOLOGIQUE;BAC STHR;BAC STHR SC.&TEC. HOTELLERIE-RESTAURATION;40;40;31;2;7;2;5;33;1;1;8;11;12;7
25578.0;2023;25;VERSAILLES;MASCULIN;SCOLAIRE;BAC TECHNOLOGIQUE;BAC STL;BAC STL SCIENCES PHYSIQUES CHIMIQUES  EN LABORAT.;71;71;59;5;7;4;3;63;0;5;14;18;26;8
10001.0;2022;27;CORSE;MASCULIN;SCOLAIRE;BAC PROFESSIONNEL;BAC PRO PROD;BAC PRO 25009 MAINTENANCE NAUTIQUE;11;11;11;0;0;0;0;11;0;1;2;6;2;0
10005.0;2022;27;CORSE;MASCULIN;SCOLAIRE;BAC PROFESSIONNEL;BAC PRO PROD;BAC PRO 25510 METIERS ELECT. ENVIRON. CONNECTES;38;38;30;4;4;4;0;34;0;1;8;12;13;4
10009.0;2022;27;CORSE;MASCULIN;SCOLAIRE;BAC PROFESSIONNEL;BAC PRO PROD;BAC PRO AG 21004 CGEA;8;8;8;0;0;0;0;8;0;0;0;3;5;0
10023.0;2022;27;CORSE;MASCULIN;SCOLAIRE;BAC TECHNOLOGIQUE;BAC STAV;BAC STAV AGRONOMIE ALIM ENV TERRITOI;6;6;6;0;0;0;0;6;0;0;0;2;4;0
10024.0;2022;27;CORSE;MASCULIN;SCOLAIRE;BAC TECHNOLOGIQUE;BAC STHR;BAC STHR SC.&TEC. HOTELLERIE-RESTAURATION;3;3;2;1;0;0;0;2;0;0;0;1;1;1
10025.0;2022;27;CORSE;MASCULIN;SCOLAIRE;BAC TECHNOLOGIQUE;BAC STI2D;BAC STI2D ARCHITECTURE ET CONSTRUCTION;14;14;13;1;0;0;0;13;0;0;3;4;6;1
10038.0;2022;24;CRETEIL;FEMININ;APPRENTISSAGE;BAC PROFESSIONNEL;BAC PRO PROD;BAC PRO 25007 MAINTENANCE EQUIPEMENTS INDUST.;4;4;4;0;0;0;0;4;0;1;2;0;1;0
10040.0;2022;24;CRETEIL;FEMININ;APPRENTISSAGE;BAC PROFESSIONNEL;BAC PRO PROD;BAC PRO 25216 MAINT.VEHIC.OPTC MOTOCYCLES;1;1;1;0;0;0;0;1;0;0;0;1;0;0
10042.0;2022;24;CRETEIL;FEMININ;APPRENTISSAGE;BAC PROFESSIONNEL;BAC PRO PROD;BAC PRO 25411 TECH.CHAUDRONNERIE INDUSTRIELLE;1;0;0;0;0;0;0;0;0;0;0;0;0;0
10047.0;2022;24;CRETEIL;FEMININ;APPRENTISSAGE;BAC PROFESSIONNEL;BAC PRO SERV;BAC PRO 31213 MET.COM.VEN.OP.A ANI.GES.ESP.COM.;15;14;13;0;1;0;1;13;0;1;2;3;7;1
10049.0;2022;24;CRETEIL;FEMININ;APPRENTISSAGE;BAC PROFESSIONNEL;BAC PRO SERV;BAC PRO 32303 ART.& MET.ART:COM.VIS.VIS.PLURI-M;7;7;5;0;2;0;2;5;0;0;0;3;2;2
10050.0;2022;24;CRETEIL;FEMININ;APPRENTISSAGE;BAC PROFESSIONNEL;BAC PRO SERV;BAC PRO 33102 PROTHESE DENTAIRE;5;5;4;1;0;0;0;4;0;0;1;2;1;1
10051.0;2022;24;CRETEIL;FEMININ;APPRENTISSAGE;BAC PROFESSIONNEL;BAC PRO SERV;BAC PRO 33403 COMMERC. SERVICES EN RESTAURATION;33;32;26;6;0;0;0;26;0;0;7;10;9;6
10063.0;2022;24;CRETEIL;FEMININ;ENSEIGNEMENT A DISTANCE;BAC TECHNOLOGIQUE;BAC STMG;BAC STMG MERCATIQUE (MARKETING);10;9;6;3;0;0;0;6;0;0;2;1;3;3
10066.0;2022;24;CRETEIL;FEMININ;FORMATION CONTINUE;BAC PROFESSIONNEL;BAC PRO PROD;BAC PRO 24302 METIERS DU CUIR : MAROQUINERIE;16;11;11;0;0;0;0;11;0;3;4;2;2;0
10069.0;2022;24;CRETEIL;FEMININ;FORMATION CONTINUE;BAC PROFESSIONNEL;BAC PRO SERV;BAC PRO 31212 METIERS DE L'ACCUEIL;1;1;1;0;0;0;0;1;0;0;1;0;0;0
10073.0;2022;24;CRETEIL;FEMININ;FORMATION CONTINUE;BAC PROFESSIONNEL;BAC PRO SERV;BAC PRO 33603 ESTHETIQUE COSMETIQUE PARFUMERIE;17;16;3;13;0;0;0;3;0;0;0;1;2;13
10078.0;2022;24;CRETEIL;FEMININ;INDIVIDUEL;BAC PROFESSIONNEL;BAC PRO PROD;BAC PRO AG 21114 CONDUITE PRODUCTIONS HORTICOLES;4;3;3;0;0;0;0;3;0;0;0;0;3;0
10081.0;2022;24;CRETEIL;FEMININ;INDIVIDUEL;BAC PROFESSIONNEL;BAC PRO SERV;BAC PRO 30001 GESTION-ADMINISTRATION;28;19;6;11;2;1;1;7;0;0;0;0;7;12
10086.0;2022;24;CRETEIL;FEMININ;INDIVIDUEL;BAC PROFESSIONNEL;BAC PRO SERV;BAC PRO 33004 ACC.SOINS-S.PERS. OPT.EN STRUCTUR;13;8;4;3;1;1;0;5;0;0;0;2;3;3
10094.0;2022;24;CRETEIL;FEMININ;INDIVIDUEL;BAC TECHNOLOGIQUE;BAC STL;BAC STL SCIENCES PHYSIQUES CHIMIQUES  EN LABORAT.;2;1;0;0;1;1;0;1;0;0;0;0;1;0
10098.0;2022;24;CRETEIL;FEMININ;SCOLAIRE;BAC GENERAL;BAC GENERAL;BAC GENE 10019 BAC GENERAL;14744;14744;13255;345;1144;800;344;14055;203;1561;3499;4551;4241;689
10109.0;2022;24;CRETEIL;FEMININ;SCOLAIRE;BAC PROFESSIONNEL;BAC PRO PROD;BAC PRO 23405 TECHNICIEN MENUISIER AGENCEUR;5;5;3;2;0;0;0;3;0;0;0;1;2;2
10118.0;2022;24;CRETEIL;FEMININ;SCOLAIRE;BAC PROFESSIONNEL;BAC PRO PROD;BAC PRO 25214 MAINT.VEHIC.OPTA VOIT.PARTICUL.;2;2;2;0;0;0;0;2;0;0;0;1;1;0
10128.0;2022;24;CRETEIL;FEMININ;SCOLAIRE;BAC PROFESSIONNEL;BAC PRO PROD;BAC PRO AG 21004 CGEA;22;22;18;4;0;0;0;18;0;0;1;8;9;4
10131.0;2022;24;CRETEIL;FEMININ;SCOLAIRE;BAC PROFESSIONNEL;BAC PRO PROD;BAC PRO AG 21407 TEC CONS VTE UNIVERS JARDINERIE;6;6;3;3;0;0;0;3;0;0;0;0;3;3
10134.0;2022;24;CRETEIL;FEMININ;SCOLAIRE;BAC PROFESSIONNEL;BAC PRO SERV;BAC PRO 30001 GESTION-ADMINISTRATION;1197;1196;912;246;38;28;10;940;0;48;161;354;377;256
10136.0;2022;24;CRETEIL;FEMININ;SCOLAIRE;BAC PROFESSIONNEL;BAC PRO SERV;BAC PRO 31108 TRANSPORT;8;8;7;1;0;0;0;7;0;0;0;3;4;1
10138.0;2022;24;CRETEIL;FEMININ;SCOLAIRE;BAC PROFESSIONNEL;BAC PRO SERV;BAC PRO 31213 MET.COM.VEN.OP.A ANI.GES.ESP.COM.;687;686;550;102;34;21;13;571;0;24;125;232;190;115
10141.0;2022;24;CRETEIL;FEMININ;SCOLAIRE;BAC PROFESSIONNEL;BAC PRO SERV;BAC PRO 32207 REAL.PR.IMPR.PLURI.OPTA.PR.GRAPH.;13;13;12;1;0;0;0;12;0;1;5;4;2;1
10142.0;2022;24;CRETEIL;FEMININ;SCOLAIRE;BAC PROFESSIONNEL;BAC PRO SERV;BAC PRO 32208 REAL.PR.IMPR.PLURI.OPTB.PR.IMPR.;1;1;1;0;0;0;0;1;0;0;1;0;0;0
10163.0;2022;24;CRETEIL;FEMININ;SCOLAIRE;BAC TECHNOLOGIQUE;BAC STL;BAC STL SCIENCES PHYSIQUES CHIMIQUES  EN LABORAT.;56;56;42;2;12;6;6;48;0;1;7;17;23;8
10169.0;2022;24;CRETEIL;MASCULIN;APPRENTISSAGE;BAC PROFESSIONNEL;BAC PRO PROD;BAC PRO 22106 CUISINE;113;111;86;24;1;0;1;86;0;4;17;31;34;25
10177.0;2022;24;CRETEIL;MASCULIN;APPRENTISSAGE;BAC PROFESSIONNEL;BAC PRO PROD;BAC PRO 25214 MAINT.VEHIC.OPTA VOIT.PARTICUL.;144;131;107;18;6;5;1;112;0;8;22;41;41;19
10179.0;2022;24;CRETEIL;MASCULIN;APPRENTISSAGE;BAC PROFESSIONNEL;BAC PRO PROD;BAC PRO 25216 MAINT.VEHIC.OPTC MOTOCYCLES;67;67;58;8;1;1;0;59;0;6;18;17;18;8
10182.0;2022;24;CRETEIL;MASCULIN;APPRENTISSAGE;BAC PROFESSIONNEL;BAC PRO PROD;BAC PRO 25221 MAINT.MATERIELS OPT.C ESP. VERTS;2;2;2;0;0;0;0;2;0;0;0;1;1;0
10183.0;2022;24;CRETEIL;MASCULIN;APPRENTISSAGE;BAC PROFESSIONNEL;BAC PRO PROD;BAC PRO 25408 REPARATION DES CARROSSERIES;34;31;27;3;1;0;1;27;0;1;6;13;7;4
10186.0;2022;24;CRETEIL;MASCULIN;APPRENTISSAGE;BAC PROFESSIONNEL;BAC PRO PROD;BAC PRO 25509 TECHNIC. FROID CONDITIONNEMT AIR;26;24;19;4;1;0;1;19;0;2;2;6;9;5
10191.0;2022;24;CRETEIL;MASCULIN;APPRENTISSAGE;BAC PROFESSIONNEL;BAC PRO PROD;BAC PRO AG 21405 AMENAGEMENTS PAYSAGERS;29;27;24;3;0;0;0;24;0;0;2;6;16;3
10194.0;2022;24;CRETEIL;MASCULIN;APPRENTISSAGE;BAC PROFESSIONNEL;BAC PRO SERV;BAC PRO 31213 MET.COM.VEN.OP.A ANI.GES.ESP.COM.;36;33;21;9;3;3;0;24;0;1;4;6;13;9
10197.0;2022;24;CRETEIL;MASCULIN;APPRENTISSAGE;BAC PROFESSIONNEL;BAC PRO SERV;BAC PRO 33102 PROTHESE DENTAIRE;8;7;5;2;0;0;0;5;0;0;1;4;0;2
10199.0;2022;24;CRETEIL;MASCULIN;APPRENTISSAGE;BAC PROFESSIONNEL;BAC PRO SERV;BAC PRO 34304 HYGIENE PROPRETE STERILISATION;23;22;9;12;1;1;0;10;0;0;3;1;6;12
10202.0;2022;24;CRETEIL;MASCULIN;ENSEIGNEMENT A DISTANCE;BAC PROFESSIONNEL;BAC PRO PROD;BAC PRO 22704 TECHN. MAINT. SYST.ENERG.CLIMATI;1;0;0;0;0;0;0;0;0;0;0;0;0;0
10206.0;2022;24;CRETEIL;MASCULIN;ENSEIGNEMENT A DISTANCE;BAC PROFESSIONNEL;BAC PRO SERV;BAC PRO 31214 MET.COM.VEN.OP.B PR.CL.VA.OF.COM.;2;2;0;1;1;0;1;0;0;0;0;0;0;2
10208.0;2022;24;CRETEIL;MASCULIN;ENSEIGNEMENT A DISTANCE;BAC TECHNOLOGIQUE;BAC STMG;BAC STMG GESTION ET FINANCE;2;2;1;0;1;0;1;1;0;0;0;1;0;1
10219.0;2022;24;CRETEIL;MASCULIN;FORMATION CONTINUE;BAC PROFESSIONNEL;BAC PRO PROD;BAC PRO AG 21405 AMENAGEMENTS PAYSAGERS;1;1;1;0;0;0;0;1;0;0;0;1;0;0
10225.0;2022;24;CRETEIL;MASCULIN;INDIVIDUEL;BAC PROFESSIONNEL;BAC PRO PROD;BAC PRO 23003 ARTIS. & M.ART:MARCHANDISAGE VIS.;1;1;0;1;0;0;0;0;0;0;0;0;0;1
10226.0;2022;24;CRETEIL;MASCULIN;INDIVIDUEL;BAC PROFESSIONNEL;BAC PRO PROD;BAC PRO 23005 TECHN. ETUDES BAT B ASSIST.ARCHI.;1;1;0;1;0;0;0;0;0;0;0;0;0;1
10234.0;2022;24;CRETEIL;MASCULIN;INDIVIDUEL;BAC PROFESSIONNEL;BAC PRO PROD;BAC PRO 25408 REPARATION DES CARROSSERIES;2;2;1;1;0;0;0;1;0;0;0;1;0;1
10252.0;2022;24;CRETEIL;MASCULIN;INDIVIDUEL;BAC PROFESSIONNEL;BAC PRO SERV;BAC PRO 33004 ACC.SOINS-S.PERS. OPT.EN STRUCTUR;1;1;1;0;0;0;0;1;0;0;0;1;0;0
10257.0;2022;24;CRETEIL;MASCULIN;INDIVIDUEL;BAC TECHNOLOGIQUE;BAC STI2D;BAC STI2D SYSTÈME D'INFORMATION  ET NUMERIQUE;3;0;0;0;0;0;0;0;0;0;0;0;0;0
10261.0;2022;24;CRETEIL;MASCULIN;INDIVIDUEL;BAC TECHNOLOGIQUE;BAC STMG;BAC STMG RESSOURCES HUMAINES ET COMMUNICATION;18;16;7;6;3;2;1;9;0;0;1;0;8;7
10268.0;2022;24;CRETEIL;MASCULIN;SCOLAIRE;BAC PROFESSIONNEL;BAC PRO PROD;BAC PRO 22703 TECHN.INSTALL.SYST.ENERG.CLIMATI;139;137;88;45;4;2;2;90;0;1;13;31;45;47
10271.0;2022;24;CRETEIL;MASCULIN;SCOLAIRE;BAC PROFESSIONNEL;BAC PRO PROD;BAC PRO 23004 TECHN. ETUDES BAT.A ETUDES & ECO.;46;46;34;11;1;0;1;34;0;1;2;15;16;12
10272.0;2022;24;CRETEIL;MASCULIN;SCOLAIRE;BAC PROFESSIONNEL;BAC PRO PROD;BAC PRO 23005 TECHN. ETUDES BAT B ASSIST.ARCHI.;39;39;33;6;0;0;0;33;0;0;7;16;10;6
10273.0;2022;24;CRETEIL;MASCULIN;SCOLAIRE;BAC PROFESSIONNEL;BAC PRO PROD;BAC PRO 23102 TRAVAUX PUBLICS;19;19;11;8;0;0;0;11;0;0;1;6;4;8
10283.0;2022;24;CRETEIL;MASCULIN;SCOLAIRE;BAC PROFESSIONNEL;BAC PRO PROD;BAC PRO 24203 METIERS DE LA MODE - VÊTEMENT;17;15;12;2;1;1;0;13;0;5;1;2;5;2
10284.0;2022;24;CRETEIL;MASCULIN;SCOLAIRE;BAC PROFESSIONNEL;BAC PRO PROD;BAC PRO 24302 METIERS DU CUIR : MAROQUINERIE;3;3;2;1;0;0;0;2;0;0;1;1;0;1
10288.0;2022;24;CRETEIL;MASCULIN;SCOLAIRE;BAC PROFESSIONNEL;BAC PRO PROD;BAC PRO 25107 TECHNICIEN OUTILLEUR;8;8;7;0;1;1;0;8;0;2;0;4;2;0
10290.0;2022;24;CRETEIL;MASCULIN;SCOLAIRE;BAC PROFESSIONNEL;BAC PRO PROD;BAC PRO 25215 MAINT.VEHIC.OPTB VEHIC.TRANS.ROUT;5;5;4;1;0;0;0;4;0;1;0;0;3;1
10304.0;2022;24;CRETEIL;MASCULIN;SCOLAIRE;BAC PROFESSIONNEL;BAC PRO PROD;BAC PRO 25513 SYST.NUM.OPT.A SURETE SECURITE;117;117;92;12;13;9;4;101;0;4;15;42;40;16
10307.0;2022;24;CRETEIL;MASCULIN;SCOLAIRE;BAC PROFESSIONNEL;BAC PRO PROD;BAC PRO AG 21004 CGEA;19;19;17;2;0;0;0;17;0;0;2;7;8;2
10312.0;2022;24;CRETEIL;MASCULIN;SCOLAIRE;BAC PROFESSIONNEL;BAC PRO PROD;BAC PRO AG 22107 TEC CONS VTE ALIMENTATION P.ALIM;13;13;6;7;0;0;0;6;0;0;0;1;5;7
10313.0;2022;24;CRETEIL;MASCULIN;SCOLAIRE;BAC PROFESSIONNEL;BAC PRO SERV;BAC PRO 30001 GESTION-ADMINISTRATION;1033;1030;615;364;51;39;12;654;0;12;62;219;361;376
10318.0;2022;24;CRETEIL;MASCULIN;SCOLAIRE;BAC PROFESSIONNEL;BAC PRO SERV;BAC PRO 31213 MET.COM.VEN.OP.A ANI.GES.ESP.COM.;1100;1095;723;294;78;54;24;777;0;9;105;285;378;318
10329.0;2022;24;CRETEIL;MASCULIN;SCOLAIRE;BAC PROFESSIONNEL;BAC PRO SERV;BAC PRO 33403 COMMERC. SERVICES EN RESTAURATION;72;72;54;16;2;1;1;55;0;2;6;19;28;17
10333.0;2022;24;CRETEIL;MASCULIN;SCOLAIRE;BAC PROFESSIONNEL;BAC PRO SERV;BAC PRO 34403 METIERS DE LA SECURITE;127;127;110;15;2;1;1;111;0;7;25;46;33;16
10334.0;2022;24;CRETEIL;MASCULIN;SCOLAIRE;BAC PROFESSIONNEL;BAC PRO SERV;BAC PRO AG 33002 SERV PERS TERRIT;5;5;4;1;0;0;0;4;0;0;0;1;3;1
10341.0;2022;24;CRETEIL;MASCULIN;SCOLAIRE;BAC TECHNOLOGIQUE;BAC STI2D;BAC STI2D INNOVATION TECHNO.  ET ECO CONCEPTION;476;476;347;44;85;52;33;399;0;4;24;146;225;77
10344.0;2022;24;CRETEIL;MASCULIN;SCOLAIRE;BAC TECHNOLOGIQUE;BAC STL;BAC STL SCIENCES PHYSIQUES CHIMIQUES  EN LABORAT.;88;88;61;11;16;9;7;70;0;0;3;22;45;18
10360.0;2022;07;DIJON;FEMININ;APPRENTISSAGE;BAC PROFESSIONNEL;BAC PRO PROD;BAC PRO AG 21004 CGEA;9;9;7;2;0;0;0;7;0;0;3;1;3;2
10361.0;2022;07;DIJON;FEMININ;APPRENTISSAGE;BAC PROFESSIONNEL;BAC PRO PROD;BAC PRO AG 21113 CGEVV;3;3;1;2;0;0;0;1;0;0;0;0;1;2
10371.0;2022;07;DIJON;FEMININ;APPRENTISSAGE;BAC PROFESSIONNEL;BAC PRO SERV;BAC PRO 32207 REAL.PR.IMPR.PLURI.OPTA.PR.GRAPH.;1;1;1;0;0;0;0;1;0;1;0;0;0;0
10374.0;2022;07;DIJON;FEMININ;APPRENTISSAGE;BAC PROFESSIONNEL;BAC PRO SERV;BAC PRO 34403 METIERS DE LA SECURITE;1;1;1;0;0;0;0;1;0;0;0;1;0;0
10376.0;2022;07;DIJON;FEMININ;ENSEIGNEMENT A DISTANCE;BAC GENERAL;BAC GENERAL;BAC GENE 10019 BAC GENERAL;40;39;30;5;4;2;2;32;0;3;7;13;9;7
10377.0;2022;07;DIJON;FEMININ;ENSEIGNEMENT A DISTANCE;BAC PROFESSIONNEL;BAC PRO SERV;BAC PRO 30001 GESTION-ADMINISTRATION;3;2;2;0;0;0;0;2;0;0;1;0;1;0
10381.0;2022;07;DIJON;FEMININ;ENSEIGNEMENT A DISTANCE;BAC TECHNOLOGIQUE;BAC ST2S;BAC ST2S SCIENCES & TECHNO. SANTE & SOCIAL;1;1;1;0;0;0;0;1;0;0;0;1;0;0
10388.0;2022;07;DIJON;FEMININ;INDIVIDUEL;BAC PROFESSIONNEL;BAC PRO PROD;BAC PRO AG 21114 CONDUITE PRODUCTIONS HORTICOLES;3;3;3;0;0;0;0;3;0;0;0;0;3;0
10392.0;2022;07;DIJON;FEMININ;INDIVIDUEL;BAC PROFESSIONNEL;BAC PRO SERV;BAC PRO 31213 MET.COM.VEN.OP.A ANI.GES.ESP.COM.;2;0;0;0;0;0;0;0;0;0;0;0;0;0
10400.0;2022;07;DIJON;FEMININ;SCOLAIRE;BAC PROFESSIONNEL;BAC PRO PROD;BAC PRO 20102 PILOTE DE LIGNE DE PRODUCTION;5;5;4;0;1;1;0;5;0;0;1;1;3;0
10403.0;2022;07;DIJON;FEMININ;SCOLAIRE;BAC PROFESSIONNEL;BAC PRO PROD;BAC PRO 22106 CUISINE;49;49;39;5;5;2;3;41;0;7;8;6;20;8
10407.0;2022;07;DIJON;FEMININ;SCOLAIRE;BAC PROFESSIONNEL;BAC PRO PROD;BAC PRO 23102 TRAVAUX PUBLICS;1;1;1;0;0;0;0;1;0;0;0;0;1;0
10408.0;2022;07;DIJON;FEMININ;SCOLAIRE;BAC PROFESSIONNEL;BAC PRO PROD;BAC PRO 23205 INTERV. SUR PATRIMOINE BATI OPT.A;1;1;1;0;0;0;0;1;0;0;0;0;1;0
10409.0;2022;07;DIJON;FEMININ;SCOLAIRE;BAC PROFESSIONNEL;BAC PRO PROD;BAC PRO 23208 METIERS ET ARTS DE LA PIERRE;2;2;2;0;0;0;0;2;0;0;0;2;0;0
10417.0;2022;07;DIJON;FEMININ;SCOLAIRE;BAC PROFESSIONNEL;BAC PRO PROD;BAC PRO 25107 TECHNICIEN OUTILLEUR;1;1;0;0;1;1;0;1;0;0;0;0;1;0
10429.0;2022;07;DIJON;FEMININ;SCOLAIRE;BAC PROFESSIONNEL;BAC PRO PROD;BAC PRO AG 21211 COND GEST ENTR HIPPIQUE;28;28;26;2;0;0;0;26;0;0;3;6;17;2
10436.0;2022;07;DIJON;FEMININ;SCOLAIRE;BAC PROFESSIONNEL;BAC PRO SERV;BAC PRO 31107 CONDUCT. TRANSP.ROUT.MARCHANDISES;3;3;1;2;0;0;0;1;0;0;0;1;0;2
10441.0;2022;07;DIJON;FEMININ;SCOLAIRE;BAC PROFESSIONNEL;BAC PRO SERV;BAC PRO 32208 REAL.PR.IMPR.PLURI.OPTB.PR.IMPR.;3;3;3;0;0;0;0;3;0;2;0;1;0;0
10454.0;2022;07;DIJON;FEMININ;SCOLAIRE;BAC TECHNOLOGIQUE;BAC S2TMD;BAC S2TMD DANSE;3;3;3;0;0;0;0;3;0;0;2;1;0;0
10469.0;2022;07;DIJON;FEMININ;SCOLAIRE;BAC TECHNOLOGIQUE;BAC STMG;BAC STMG SYSTEMES D'INFORMATION DE GESTION;5;5;4;0;1;1;0;5;0;0;0;2;3;0
10480.0;2022;07;DIJON;MASCULIN;APPRENTISSAGE;BAC PROFESSIONNEL;BAC PRO PROD;BAC PRO 23208 METIERS ET ARTS DE LA PIERRE;1;1;1;0;0;0;0;1;0;0;0;0;1;0
10487.0;2022;07;DIJON;MASCULIN;APPRENTISSAGE;BAC PROFESSIONNEL;BAC PRO PROD;BAC PRO 25009 MAINTENANCE NAUTIQUE;2;2;2;0;0;0;0;2;0;0;1;1;0;0
10491.0;2022;07;DIJON;MASCULIN;APPRENTISSAGE;BAC PROFESSIONNEL;BAC PRO PROD;BAC PRO 25215 MAINT.VEHIC.OPTB VEHIC.TRANS.ROUT;26;26;18;5;3;1;2;19;0;1;1;6;11;7
10495.0;2022;07;DIJON;MASCULIN;APPRENTISSAGE;BAC PROFESSIONNEL;BAC PRO PROD;BAC PRO 25411 TECH.CHAUDRONNERIE INDUSTRIELLE;56;55;49;4;2;1;1;50;0;3;11;25;11;5
10499.0;2022;07;DIJON;MASCULIN;APPRENTISSAGE;BAC PROFESSIONNEL;BAC PRO PROD;BAC PRO 25515 SYST.NUM.OPT.C RES.INF.SYST.COMM.;3;3;3;0;0;0;0;3;0;0;1;2;0;0
10513.0;2022;07;DIJON;MASCULIN;APPRENTISSAGE;BAC PROFESSIONNEL;BAC PRO SERV;BAC PRO 31214 MET.COM.VEN.OP.B PR.CL.VA.OF.COM.;4;4;1;3;0;0;0;1;0;0;0;1;0;3
10518.0;2022;07;DIJON;MASCULIN;APPRENTISSAGE;BAC PROFESSIONNEL;BAC PRO SERV;BAC PRO AG 33002 SERV PERS TERRIT;1;1;1;0;0;0;0;1;0;0;0;0;1;0
10521.0;2022;07;DIJON;MASCULIN;ENSEIGNEMENT A DISTANCE;BAC TECHNOLOGIQUE;BAC ST2S;BAC ST2S SCIENCES & TECHNO. SANTE & SOCIAL;1;1;1;0;0;0;0;1;0;0;0;1;0;0
10532.0;2022;07;DIJON;MASCULIN;INDIVIDUEL;BAC PROFESSIONNEL;BAC PRO PROD;BAC PRO 25220 MAINT.MATERIELS OPT.B TP MANUT.;1;1;1;0;0;0;0;1;0;0;0;0;1;0
10533.0;2022;07;DIJON;MASCULIN;INDIVIDUEL;BAC PROFESSIONNEL;BAC PRO PROD;BAC PRO 25510 METIERS ELECT. ENVIRON. CONNECTES;1;1;0;1;0;0;0;0;0;0;0;0;0;1
10536.0;2022;07;DIJON;MASCULIN;INDIVIDUEL;BAC PROFESSIONNEL;BAC PRO PROD;BAC PRO AG 21302 GEST MILIEUX NATURELS FAUNE;1;1;1;0;0;0;0;1;0;0;0;1;0;0
10548.0;2022;07;DIJON;MASCULIN;INDIVIDUEL;BAC TECHNOLOGIQUE;BAC STL;BAC STL BIOCHIM.-BIOLOGIE-BIOTECHNOL.;1;1;0;1;0;0;0;0;0;0;0;0;0;1
10551.0;2022;07;DIJON;MASCULIN;INDIVIDUEL;BAC TECHNOLOGIQUE;BAC STMG;BAC STMG RESSOURCES HUMAINES ET COMMUNICATION;5;3;1;1;1;0;1;1;0;0;0;0;1;2
10554.0;2022;07;DIJON;MASCULIN;SCOLAIRE;BAC PROFESSIONNEL;BAC PRO PROD;BAC PRO 20102 PILOTE DE LIGNE DE PRODUCTION;8;8;6;1;1;1;0;7;0;0;0;2;5;1
10559.0;2022;07;DIJON;MASCULIN;SCOLAIRE;BAC PROFESSIONNEL;BAC PRO PROD;BAC PRO 22503 PLASTIQUES ET COMPOSITES;18;18;13;1;4;3;1;16;0;0;2;5;9;2
10564.0;2022;07;DIJON;MASCULIN;SCOLAIRE;BAC PROFESSIONNEL;BAC PRO PROD;BAC PRO 23102 TRAVAUX PUBLICS;10;10;8;2;0;0;0;8;0;0;1;6;1;2
10565.0;2022;07;DIJON;MASCULIN;SCOLAIRE;BAC PROFESSIONNEL;BAC PRO PROD;BACPRO 23103 TECHNICIEN GEOMETRE-TOPOGRAPHE;7;7;7;0;0;0;0;7;0;0;2;2;3;0
10572.0;2022;07;DIJON;MASCULIN;SCOLAIRE;BAC PROFESSIONNEL;BAC PRO PROD;BAC PRO 23408 Etude et réalisation d'agencement;6;6;3;3;0;0;0;3;0;0;1;1;1;3
10573.0;2022;07;DIJON;MASCULIN;SCOLAIRE;BAC PROFESSIONNEL;BAC PRO PROD;BAC PRO 24202 ARTIS.& MET.ART : TAPIS.D'AMEUBL;1;1;1;0;0;0;0;1;0;0;0;1;0;0
10581.0;2022;07;DIJON;MASCULIN;SCOLAIRE;BAC PROFESSIONNEL;BAC PRO PROD;BAC PRO 25215 MAINT.VEHIC.OPTB VEHIC.TRANS.ROUT;5;5;4;0;1;1;0;5;0;1;0;2;2;0
10587.0;2022;07;DIJON;MASCULIN;SCOLAIRE;BAC PROFESSIONNEL;BAC PRO PROD;BAC PRO 25406 OUVRAGES DU BATIMENT METALLERIE;17;17;8;6;3;1;2;9;0;0;1;1;7;8
10589.0;2022;07;DIJON;MASCULIN;SCOLAIRE;BAC PROFESSIONNEL;BAC PRO PROD;BAC PRO 25411 TECH.CHAUDRONNERIE INDUSTRIELLE;56;56;46;4;6;3;3;49;0;5;12;17;15;7
10600.0;2022;07;DIJON;MASCULIN;SCOLAIRE;BAC PROFESSIONNEL;BAC PRO PROD;BAC PRO AG 21204 PROD-AQUACOLES;17;17;11;6;0;0;0;11;0;1;0;4;6;6
10604.0;2022;07;DIJON;MASCULIN;SCOLAIRE;BAC PROFESSIONNEL;BAC PRO PROD;BAC PRO AG 21303 FORET;11;11;11;0;0;0;0;11;0;1;3;5;2;0
10606.0;2022;07;DIJON;MASCULIN;SCOLAIRE;BAC PROFESSIONNEL;BAC PRO PROD;BAC PRO AG 22106 TEC CONS VTE ALIMENTATION VINS SP;8;8;7;1;0;0;0;7;0;0;0;2;5;1
10607.0;2022;07;DIJON;MASCULIN;SCOLAIRE;BAC PROFESSIONNEL;BAC PRO PROD;BAC PRO AG 22107 TEC CONS VTE ALIMENTATION P.ALIM;34;33;29;4;0;0;0;29;0;1;2;5;21;4
10611.0;2022;07;DIJON;MASCULIN;SCOLAIRE;BAC PROFESSIONNEL;BAC PRO SERV;BAC PRO 31108 TRANSPORT;8;8;7;1;0;0;0;7;0;0;2;3;2;1
10615.0;2022;07;DIJON;MASCULIN;SCOLAIRE;BAC PROFESSIONNEL;BAC PRO SERV;BAC PRO 32207 REAL.PR.IMPR.PLURI.OPTA.PR.GRAPH.;5;5;5;0;0;0;0;5;0;0;4;1;0;0
10616.0;2022;07;DIJON;MASCULIN;SCOLAIRE;BAC PROFESSIONNEL;BAC PRO SERV;BAC PRO 32208 REAL.PR.IMPR.PLURI.OPTB.PR.IMPR.;2;2;2;0;0;0;0;2;0;1;0;1;0;0
10619.0;2022;07;DIJON;MASCULIN;SCOLAIRE;BAC PROFESSIONNEL;BAC PRO SERV;BAC PRO 33004 ACC.SOINS-S.PERS. OPT.EN STRUCTUR;18;18;13;3;2;1;1;14;0;1;3;7;3;4
10622.0;2022;07;DIJON;MASCULIN;SCOLAIRE;BAC PROFESSIONNEL;BAC PRO SERV;BAC PRO 33103 TECHNICIEN APPAREIL. ORTHOPEDIQUE;5;5;5;0;0;0;0;5;0;0;2;0;3;0
10634.0;2022;07;DIJON;MASCULIN;SCOLAIRE;BAC TECHNOLOGIQUE;BAC STI2D;BAC STI2D ENERGIES  ET ENVIRONNEMENT;69;69;57;3;9;3;6;60;0;0;5;18;37;9
10636.0;2022;07;DIJON;MASCULIN;SCOLAIRE;BAC TECHNOLOGIQUE;BAC STI2D;BAC STI2D SYSTÈME D'INFORMATION  ET NUMERIQUE;151;151;129;1;21;13;8;142;0;3;20;51;68;9
10637.0;2022;07;DIJON;MASCULIN;SCOLAIRE;BAC TECHNOLOGIQUE;BAC STL;BAC STL BIOCHIM.-BIOLOGIE-BIOTECHNOL.;31;31;25;1;5;1;4;26;0;0;3;10;13;5
10638.0;2022;07;DIJON;MASCULIN;SCOLAIRE;BAC TECHNOLOGIQUE;BAC STL;BAC STL SCIENCES PHYSIQUES CHIMIQUES  EN LABORAT.;30;30;21;1;8;5;3;26;0;0;2;7;17;4
10639.0;2022;07;DIJON;MASCULIN;SCOLAIRE;BAC TECHNOLOGIQUE;BAC STMG;BAC STMG GESTION ET FINANCE;158;158;134;5;19;13;6;147;0;2;20;52;73;11
10648.0;2022;08;GRENOBLE;FEMININ;APPRENTISSAGE;BAC PROFESSIONNEL;BAC PRO PROD;BAC PRO 24302 METIERS DU CUIR : MAROQUINERIE;14;13;13;0;0;0;0;13;0;6;4;2;1;0
10653.0;2022;08;GRENOBLE;FEMININ;APPRENTISSAGE;BAC PROFESSIONNEL;BAC PRO PROD;BAC PRO 25215 MAINT.VEHIC.OPTB VEHIC.TRANS.ROUT;1;1;1;0;0;0;0;1;0;1;0;0;0;0
10663.0;2022;08;GRENOBLE;FEMININ;APPRENTISSAGE;BAC PROFESSIONNEL;BAC PRO SERV;BAC PRO 31106 LOGISTIQUE;4;4;2;2;0;0;0;2;0;0;1;1;0;2
10668.0;2022;08;GRENOBLE;FEMININ;APPRENTISSAGE;BAC PROFESSIONNEL;BAC PRO SERV;BAC PRO 33002 SERVICES DE PROXIMITE  VIE LOCAL;1;1;1;0;0;0;0;1;0;0;0;1;0;0
10669.0;2022;08;GRENOBLE;FEMININ;APPRENTISSAGE;BAC PROFESSIONNEL;BAC PRO SERV;BAC PRO 33003 ACC.SOINS-S.PERS. OPT.A DOMICILE;2;2;2;0;0;0;0;2;0;0;1;0;1;0
10679.0;2022;08;GRENOBLE;FEMININ;ENSEIGNEMENT A DISTANCE;BAC PROFESSIONNEL;BAC PRO SERV;BAC PRO 31214 MET.COM.VEN.OP.B PR.CL.VA.OF.COM.;2;1;1;0;0;0;0;1;0;0;0;1;0;0
10685.0;2022;08;GRENOBLE;FEMININ;ENSEIGNEMENT A DISTANCE;BAC TECHNOLOGIQUE;BAC STMG;BAC STMG RESSOURCES HUMAINES ET COMMUNICATION;7;7;7;0;0;0;0;7;0;0;1;3;3;0
10688.0;2022;08;GRENOBLE;FEMININ;FORMATION CONTINUE;BAC PROFESSIONNEL;BAC PRO PROD;BAC PRO AG 21114 CONDUITE PRODUCTIONS HORTICOLES;3;3;3;0;0;0;0;3;0;0;0;0;3;0
10691.0;2022;08;GRENOBLE;FEMININ;INDIVIDUEL;BAC PROFESSIONNEL;BAC PRO PROD;BAC PRO 22106 CUISINE;1;1;1;0;0;0;0;1;0;0;0;1;0;0
10693.0;2022;08;GRENOBLE;FEMININ;INDIVIDUEL;BAC PROFESSIONNEL;BAC PRO PROD;BAC PRO AG 21004 CGEA;6;6;5;1;0;0;0;5;0;0;0;0;5;1
10694.0;2022;08;GRENOBLE;FEMININ;INDIVIDUEL;BAC PROFESSIONNEL;BAC PRO PROD;BAC PRO AG 21113 CGEVV;1;1;1;0;0;0;0;1;0;0;0;0;1;0
10696.0;2022;08;GRENOBLE;FEMININ;INDIVIDUEL;BAC PROFESSIONNEL;BAC PRO PROD;BAC PRO AG 21211 COND GEST ENTR HIPPIQUE;5;4;3;1;0;0;0;3;0;0;0;0;3;1
10697.0;2022;08;GRENOBLE;FEMININ;INDIVIDUEL;BAC PROFESSIONNEL;BAC PRO PROD;BAC PRO AG 21407 TEC CONS VTE UNIVERS JARDINERIE;1;0;0;0;0;0;0;0;0;0;0;0;0;0
10701.0;2022;08;GRENOBLE;FEMININ;INDIVIDUEL;BAC PROFESSIONNEL;BAC PRO SERV;BAC PRO 31213 MET.COM.VEN.OP.A ANI.GES.ESP.COM.;1;0;0;0;0;0;0;0;0;0;0;0;0;0
10704.0;2022;08;GRENOBLE;FEMININ;INDIVIDUEL;BAC PROFESSIONNEL;BAC PRO SERV;BAC PRO AG 33002 SERV PERS TERRIT;3;2;0;2;0;0;0;0;0;0;0;0;0;2
10717.0;2022;08;GRENOBLE;FEMININ;SCOLAIRE;BAC PROFESSIONNEL;BAC PRO PROD;BAC PRO 22106 CUISINE;69;69;62;4;3;2;1;64;0;12;18;23;11;5
10723.0;2022;08;GRENOBLE;FEMININ;SCOLAIRE;BAC PROFESSIONNEL;BAC PRO PROD;BAC PRO 23303 MENUISERIE ALUMINIUM-VERRE;1;1;1;0;0;0;0;1;0;0;0;0;1;0
10724.0;2022;08;GRENOBLE;FEMININ;SCOLAIRE;BAC PROFESSIONNEL;BAC PRO PROD;BAC PRO 23304 AMENAGEMENT FINITION BATIMENT;3;3;2;1;0;0;0;2;0;0;1;0;1;1
10730.0;2022;08;GRENOBLE;FEMININ;SCOLAIRE;BAC PROFESSIONNEL;BAC PRO PROD;BAC PRO 24301 METIERS DU CUIR : CHAUSSURES;10;10;8;2;0;0;0;8;0;1;4;2;1;2
10738.0;2022;08;GRENOBLE;FEMININ;SCOLAIRE;BAC PROFESSIONNEL;BAC PRO PROD;BAC PRO 25408 REPARATION DES CARROSSERIES;1;1;0;1;0;0;0;0;0;0;0;0;0;1
10739.0;2022;08;GRENOBLE;FEMININ;SCOLAIRE;BAC PROFESSIONNEL;BAC PRO PROD;BAC PRO 25411 TECH.CHAUDRONNERIE INDUSTRIELLE;1;1;1;0;0;0;0;1;0;1;0;0;0;0
10746.0;2022;08;GRENOBLE;FEMININ;SCOLAIRE;BAC PROFESSIONNEL;BAC PRO PROD;BAC PRO AG 21114 CONDUITE PRODUCTIONS HORTICOLES;16;15;11;4;0;0;0;11;0;0;1;5;5;4
10753.0;2022;08;GRENOBLE;FEMININ;SCOLAIRE;BAC PROFESSIONNEL;BAC PRO PROD;BAC PRO AG 21405 AMENAGEMENTS PAYSAGERS;10;10;9;1;0;0;0;9;0;0;1;6;2;1
10754.0;2022;08;GRENOBLE;FEMININ;SCOLAIRE;BAC PROFESSIONNEL;BAC PRO PROD;BAC PRO AG 21407 TEC CONS VTE UNIVERS JARDINERIE;30;29;24;5;0;0;0;24;0;0;2;13;9;5
10755.0;2022;08;GRENOBLE;FEMININ;SCOLAIRE;BAC PROFESSIONNEL;BAC PRO PROD;BAC PRO AG 22105 LABORATOIRE CONTROLE QUALITE;13;13;12;1;0;0;0;12;0;0;6;3;3;1
10756.0;2022;08;GRENOBLE;FEMININ;SCOLAIRE;BAC PROFESSIONNEL;BAC PRO PROD;BAC PRO AG 22107 TEC CONS VTE ALIMENTATION P.ALIM;35;34;25;9;0;0;0;25;0;0;0;9;16;9
10767.0;2022;08;GRENOBLE;FEMININ;SCOLAIRE;BAC PROFESSIONNEL;BAC PRO SERV;BAC PRO 32303 ART.& MET.ART:COM.VIS.VIS.PLURI-M;44;44;40;4;0;0;0;40;0;5;10;23;2;4
10776.0;2022;08;GRENOBLE;FEMININ;SCOLAIRE;BAC PROFESSIONNEL;BAC PRO SERV;BAC PRO 34403 METIERS DE LA SECURITE;16;16;16;0;0;0;0;16;0;3;8;3;2;0
10782.0;2022;08;GRENOBLE;FEMININ;SCOLAIRE;BAC TECHNOLOGIQUE;BAC STD2A;BAC STD2A SCIENCES & TECHNO. DESIGN-ARTS APPLIQUES;118;118;116;1;1;1;0;117;1;15;33;46;22;1
10784.0;2022;08;GRENOBLE;FEMININ;SCOLAIRE;BAC TECHNOLOGIQUE;BAC STI2D;BAC STI2D ARCHITECTURE ET CONSTRUCTION;63;63;59;2;2;2;0;61;0;2;6;23;30;2
10789.0;2022;08;GRENOBLE;FEMININ;SCOLAIRE;BAC TECHNOLOGIQUE;BAC STL;BAC STL SCIENCES PHYSIQUES CHIMIQUES  EN LABORAT.;59;59;50;2;7;4;3;54;1;4;7;23;19;5
10790.0;2022;08;GRENOBLE;FEMININ;SCOLAIRE;BAC TECHNOLOGIQUE;BAC STMG;BAC STMG GESTION ET FINANCE;423;423;365;20;38;28;10;393;0;17;75;149;152;30
10798.0;2022;08;GRENOBLE;MASCULIN;APPRENTISSAGE;BAC PROFESSIONNEL;BAC PRO PROD;BAC PRO 22106 CUISINE;17;17;14;2;1;1;0;15;0;1;4;8;2;2
10799.0;2022;08;GRENOBLE;MASCULIN;APPRENTISSAGE;BAC PROFESSIONNEL;BAC PRO PROD;BAC PRO 22503 PLASTIQUES ET COMPOSITES;2;2;2;0;0;0;0;2;0;0;0;1;1;0
10800.0;2022;08;GRENOBLE;MASCULIN;APPRENTISSAGE;BAC PROFESSIONNEL;BAC PRO PROD;BAC PRO 22703 TECHN.INSTALL.SYST.ENERG.CLIMATI;25;25;21;4;0;0;0;21;0;0;4;4;13;4
10802.0;2022;08;GRENOBLE;MASCULIN;APPRENTISSAGE;BAC PROFESSIONNEL;BAC PRO PROD;BAC PRO 23004 TECHN. ETUDES BAT.A ETUDES & ECO.;1;1;1;0;0;0;0;1;0;0;0;1;0;0
10812.0;2022;08;GRENOBLE;MASCULIN;APPRENTISSAGE;BAC PROFESSIONNEL;BAC PRO PROD;BAC PRO 25007 MAINTENANCE EQUIPEMENTS INDUST.;63;63;55;7;1;1;0;56;0;7;13;18;18;7
10829.0;2022;08;GRENOBLE;MASCULIN;APPRENTISSAGE;BAC PROFESSIONNEL;BAC PRO PROD;BAC PRO AG 21004 CGEA;18;16;13;3;0;0;0;13;0;0;0;7;6;3
10834.0;2022;08;GRENOBLE;MASCULIN;APPRENTISSAGE;BAC PROFESSIONNEL;BAC PRO PROD;BAC PRO AG 21405 AMENAGEMENTS PAYSAGERS;75;72;68;4;0;0;0;68;0;1;8;28;31;4
10836.0;2022;08;GRENOBLE;MASCULIN;APPRENTISSAGE;BAC PROFESSIONNEL;BAC PRO SERV;BAC PRO 30001 GESTION-ADMINISTRATION;7;7;7;0;0;0;0;7;0;0;4;2;1;0
10839.0;2022;08;GRENOBLE;MASCULIN;APPRENTISSAGE;BAC PROFESSIONNEL;BAC PRO SERV;BAC PRO 31108 TRANSPORT;1;1;1;0;0;0;0;1;0;0;0;1;0;0
10846.0;2022;08;GRENOBLE;MASCULIN;APPRENTISSAGE;BAC PROFESSIONNEL;BAC PRO SERV;BAC PRO AG 33002 SERV PERS TERRIT;2;2;2;0;0;0;0;2;0;0;0;1;1;0
10850.0;2022;08;GRENOBLE;MASCULIN;ENSEIGNEMENT A DISTANCE;BAC PROFESSIONNEL;BAC PRO SERV;BAC PRO 31214 MET.COM.VEN.OP.B PR.CL.VA.OF.COM.;3;2;2;0;0;0;0;2;0;0;0;1;1;0
10854.0;2022;08;GRENOBLE;MASCULIN;ENSEIGNEMENT A DISTANCE;BAC TECHNOLOGIQUE;BAC STMG;BAC STMG RESSOURCES HUMAINES ET COMMUNICATION;3;2;1;1;0;0;0;1;0;0;0;0;1;1
10862.0;2022;08;GRENOBLE;MASCULIN;INDIVIDUEL;BAC PROFESSIONNEL;BAC PRO PROD;BAC PRO 23004 TECHN. ETUDES BAT.A ETUDES & ECO.;1;1;0;1;0;0;0;0;0;0;0;0;0;1
10865.0;2022;08;GRENOBLE;MASCULIN;INDIVIDUEL;BAC PROFESSIONNEL;BAC PRO PROD;BAC PRO 25007 MAINTENANCE EQUIPEMENTS INDUST.;3;3;1;2;0;0;0;1;0;0;0;1;0;2
10873.0;2022;08;GRENOBLE;MASCULIN;INDIVIDUEL;BAC PROFESSIONNEL;BAC PRO PROD;BAC PRO AG 21405 AMENAGEMENTS PAYSAGERS;1;1;0;1;0;0;0;0;0;0;0;0;0;1
10879.0;2022;08;GRENOBLE;MASCULIN;INDIVIDUEL;BAC PROFESSIONNEL;BAC PRO SERV;BAC PRO 31214 MET.COM.VEN.OP.B PR.CL.VA.OF.COM.;3;1;1;0;0;0;0;1;0;0;0;1;0;0
10882.0;2022;08;GRENOBLE;MASCULIN;INDIVIDUEL;BAC TECHNOLOGIQUE;BAC STAV;BAC STAV AGRONOMIE ALIM ENV TERRITOI;1;1;1;0;0;0;0;1;0;0;0;0;1;0
10892.0;2022;08;GRENOBLE;MASCULIN;SCOLAIRE;BAC GENERAL;BAC GENERAL;BAC GENE 10019 BAC GENERAL;8171;8171;7562;106;503;359;144;7921;122;1055;2068;2532;2144;250
10896.0;2022;08;GRENOBLE;MASCULIN;SCOLAIRE;BAC PROFESSIONNEL;BAC PRO PROD;BAC PRO 22004 PROC. CHIMIE EAU PAPIERS-CARTONS;48;48;37;10;1;1;0;38;0;0;8;15;15;10
10898.0;2022;08;GRENOBLE;MASCULIN;SCOLAIRE;BAC PROFESSIONNEL;BAC PRO PROD;BAC PRO 22106 CUISINE;138;138;120;13;5;3;2;123;0;9;33;48;33;15
10901.0;2022;08;GRENOBLE;MASCULIN;SCOLAIRE;BAC PROFESSIONNEL;BAC PRO PROD;BAC PRO 22704 TECHN. MAINT. SYST.ENERG.CLIMATI;32;32;25;6;1;1;0;26;0;0;6;6;14;6
10903.0;2022;08;GRENOBLE;MASCULIN;SCOLAIRE;BAC PROFESSIONNEL;BAC PRO PROD;BAC PRO 23004 TECHN. ETUDES BAT.A ETUDES & ECO.;50;50;33;17;0;0;0;33;0;0;6;10;17;17
10904.0;2022;08;GRENOBLE;MASCULIN;SCOLAIRE;BAC PROFESSIONNEL;BAC PRO PROD;BAC PRO 23005 TECHN. ETUDES BAT B ASSIST.ARCHI.;20;20;20;0;0;0;0;20;0;2;2;10;6;0
10905.0;2022;08;GRENOBLE;MASCULIN;SCOLAIRE;BAC PROFESSIONNEL;BAC PRO PROD;BACPRO 23103 TECHNICIEN GEOMETRE-TOPOGRAPHE;18;18;17;1;0;0;0;17;0;2;4;7;4;1
10906.0;2022;08;GRENOBLE;MASCULIN;SCOLAIRE;BAC PROFESSIONNEL;BAC PRO PROD;BAC PRO 23203 TECHNICIEN BAT. : ORG.REAL.GROS O;56;56;39;12;5;5;0;44;0;1;14;13;16;12
10911.0;2022;08;GRENOBLE;MASCULIN;SCOLAIRE;BAC PROFESSIONNEL;BAC PRO PROD;BAC PRO 23407 TECHNIC.FAB.BOIS ET MATERX ASSOC;28;28;22;6;0;0;0;22;0;1;3;7;11;6
10915.0;2022;08;GRENOBLE;MASCULIN;SCOLAIRE;BAC PROFESSIONNEL;BAC PRO PROD;BAC PRO 24302 METIERS DU CUIR : MAROQUINERIE;1;1;1;0;0;0;0;1;0;0;0;1;0;0
10916.0;2022;08;GRENOBLE;MASCULIN;SCOLAIRE;BAC PROFESSIONNEL;BAC PRO PROD;BAC PRO 25005 PRODUCTIQ.MECA. OPT.DECOLLETAGE;7;7;3;4;0;0;0;3;0;0;0;1;2;4
10930.0;2022;08;GRENOBLE;MASCULIN;SCOLAIRE;BAC PROFESSIONNEL;BAC PRO PROD;BAC PRO 25513 SYST.NUM.OPT.A SURETE SECURITE;42;42;28;13;1;0;1;28;0;3;7;10;8;14
10939.0;2022;08;GRENOBLE;MASCULIN;SCOLAIRE;BAC PROFESSIONNEL;BAC PRO PROD;BAC PRO AG 21211 COND GEST ENTR HIPPIQUE;3;3;3;0;0;0;0;3;0;0;0;2;1;0
10943.0;2022;08;GRENOBLE;MASCULIN;SCOLAIRE;BAC PROFESSIONNEL;BAC PRO PROD;BAC PRO AG 21407 TEC CONS VTE UNIVERS JARDINERIE;15;14;13;1;0;0;0;13;0;1;1;5;6;1
10945.0;2022;08;GRENOBLE;MASCULIN;SCOLAIRE;BAC PROFESSIONNEL;BAC PRO PROD;BAC PRO AG 22107 TEC CONS VTE ALIMENTATION P.ALIM;47;44;33;11;0;0;0;33;0;0;2;12;19;11
10948.0;2022;08;GRENOBLE;MASCULIN;SCOLAIRE;BAC PROFESSIONNEL;BAC PRO SERV;BAC PRO 31107 CONDUCT. TRANSP.ROUT.MARCHANDISES;44;44;35;8;1;1;0;36;0;0;13;12;11;8
10951.0;2022;08;GRENOBLE;MASCULIN;SCOLAIRE;BAC PROFESSIONNEL;BAC PRO SERV;BAC PRO 31212 METIERS DE L'ACCUEIL;81;81;62;16;3;3;0;65;0;1;8;29;27;16
10953.0;2022;08;GRENOBLE;MASCULIN;SCOLAIRE;BAC PROFESSIONNEL;BAC PRO SERV;BAC PRO 31214 MET.COM.VEN.OP.B PR.CL.VA.OF.COM.;294;294;247;42;5;3;2;250;0;7;38;108;97;44
10957.0;2022;08;GRENOBLE;MASCULIN;SCOLAIRE;BAC PROFESSIONNEL;BAC PRO SERV;BAC PRO 33002 SERVICES DE PROXIMITE  VIE LOCAL;14;14;9;4;1;1;0;10;0;0;0;2;8;4
10961.0;2022;08;GRENOBLE;MASCULIN;SCOLAIRE;BAC PROFESSIONNEL;BAC PRO SERV;BAC PRO 33403 COMMERC. SERVICES EN RESTAURATION;79;79;64;12;3;1;2;65;0;7;11;28;19;14
10967.0;2022;08;GRENOBLE;MASCULIN;SCOLAIRE;BAC TECHNOLOGIQUE;BAC S2TMD;BAC S2TMD DANSE;1;1;1;0;0;0;0;1;0;1;0;0;0;0
10976.0;2022;08;GRENOBLE;MASCULIN;SCOLAIRE;BAC TECHNOLOGIQUE;BAC STI2D;BAC STI2D SYSTÈME D'INFORMATION  ET NUMERIQUE;531;531;467;14;50;28;22;495;0;18;108;191;178;36
10986.0;2022;32;GUADELOUPE;FEMININ;APPRENTISSAGE;BAC PROFESSIONNEL;BAC PRO SERV;BAC PRO AG 33002 SERV PERS TERRIT;9;8;7;1;0;0;0;7;0;0;0;3;4;1
10988.0;2022;32;GUADELOUPE;FEMININ;ENSEIGNEMENT A DISTANCE;BAC PROFESSIONNEL;BAC PRO SERV;BAC PRO 30001 GESTION-ADMINISTRATION;1;1;0;1;0;0;0;0;0;0;0;0;0;1
10999.0;2022;32;GUADELOUPE;FEMININ;INDIVIDUEL;BAC PROFESSIONNEL;BAC PRO PROD;BAC PRO AG 21114 CONDUITE PRODUCTIONS HORTICOLES;2;1;1;0;0;0;0;1;0;0;0;0;1;0
11000.0;2022;32;GUADELOUPE;FEMININ;INDIVIDUEL;BAC PROFESSIONNEL;BAC PRO SERV;BAC PRO 30001 GESTION-ADMINISTRATION;2;1;1;0;0;0;0;1;0;0;0;1;0;0
11001.0;2022;32;GUADELOUPE;FEMININ;INDIVIDUEL;BAC PROFESSIONNEL;BAC PRO SERV;BAC PRO 31108 TRANSPORT;1;1;0;1;0;0;0;0;0;0;0;0;0;1
11002.0;2022;32;GUADELOUPE;FEMININ;INDIVIDUEL;BAC PROFESSIONNEL;BAC PRO SERV;BAC PRO 31212 METIERS DE L'ACCUEIL;2;1;0;1;0;0;0;0;0;0;0;0;0;1
11006.0;2022;32;GUADELOUPE;FEMININ;INDIVIDUEL;BAC TECHNOLOGIQUE;BAC STMG;BAC STMG GESTION ET FINANCE;1;1;1;0;0;0;0;1;0;0;0;0;1;0
11016.0;2022;32;GUADELOUPE;FEMININ;SCOLAIRE;BAC PROFESSIONNEL;BAC PRO PROD;BAC PRO 23203 TECHNICIEN BAT. : ORG.REAL.GROS O;1;1;0;1;0;0;0;0;0;0;0;0;0;1
11017.0;2022;32;GUADELOUPE;FEMININ;SCOLAIRE;BAC PROFESSIONNEL;BAC PRO PROD;BAC PRO 23304 AMENAGEMENT FINITION BATIMENT;5;5;4;1;0;0;0;4;0;0;1;1;2;1
11026.0;2022;32;GUADELOUPE;FEMININ;SCOLAIRE;BAC PROFESSIONNEL;BAC PRO PROD;BAC PRO 25509 TECHNIC. FROID CONDITIONNEMT AIR;4;4;3;1;0;0;0;3;0;0;0;0;3;1
11034.0;2022;32;GUADELOUPE;FEMININ;SCOLAIRE;BAC PROFESSIONNEL;BAC PRO PROD;BAC PRO AG 22107 TEC CONS VTE ALIMENTATION P.ALIM;23;23;19;4;0;0;0;19;0;0;1;5;13;4
11048.0;2022;32;GUADELOUPE;FEMININ;SCOLAIRE;BAC PROFESSIONNEL;BAC PRO SERV;BAC PRO 34403 METIERS DE LA SECURITE;16;16;15;1;0;0;0;15;0;1;4;6;4;1
11053.0;2022;32;GUADELOUPE;FEMININ;SCOLAIRE;BAC TECHNOLOGIQUE;BAC STAV;BAC STAV AGRONOMIE ALIM ENV TERRITOI;8;8;8;0;0;0;0;8;0;0;0;2;6;0
11058.0;2022;32;GUADELOUPE;FEMININ;SCOLAIRE;BAC TECHNOLOGIQUE;BAC STI2D;BAC STI2D INNOVATION TECHNO.  ET ECO CONCEPTION;8;8;5;1;2;2;0;7;0;0;0;2;5;1
11071.0;2022;32;GUADELOUPE;MASCULIN;APPRENTISSAGE;BAC PROFESSIONNEL;BAC PRO PROD;BAC PRO 25510 METIERS ELECT. ENVIRON. CONNECTES;3;3;3;0;0;0;0;3;0;1;1;1;0;0
11072.0;2022;32;GUADELOUPE;MASCULIN;APPRENTISSAGE;BAC PROFESSIONNEL;BAC PRO PROD;BAC PRO AG 21004 CGEA;2;2;2;0;0;0;0;2;0;0;0;0;2;0
11073.0;2022;32;GUADELOUPE;MASCULIN;APPRENTISSAGE;BAC PROFESSIONNEL;BAC PRO SERV;BAC PRO 31213 MET.COM.VEN.OP.A ANI.GES.ESP.COM.;5;5;2;1;2;0;2;2;0;0;0;1;1;3
11089.0;2022;32;GUADELOUPE;MASCULIN;INDIVIDUEL;BAC PROFESSIONNEL;BAC PRO SERV;BAC PRO 31213 MET.COM.VEN.OP.A ANI.GES.ESP.COM.;1;1;1;0;0;0;0;1;0;0;0;1;0;0
11095.0;2022;32;GUADELOUPE;MASCULIN;INDIVIDUEL;BAC TECHNOLOGIQUE;BAC STMG;BAC STMG GESTION ET FINANCE;8;8;3;3;2;2;0;5;0;0;0;0;5;3
11100.0;2022;32;GUADELOUPE;MASCULIN;SCOLAIRE;BAC PROFESSIONNEL;BAC PRO PROD;BAC PRO 22106 CUISINE;24;24;21;3;0;0;0;21;0;0;5;9;7;3
11105.0;2022;32;GUADELOUPE;MASCULIN;SCOLAIRE;BAC PROFESSIONNEL;BAC PRO PROD;BAC PRO 23203 TECHNICIEN BAT. : ORG.REAL.GROS O;21;21;13;6;2;2;0;15;0;0;1;3;11;6
11108.0;2022;32;GUADELOUPE;MASCULIN;SCOLAIRE;BAC PROFESSIONNEL;BAC PRO PROD;BAC PRO 23404 TECHNICIEN CONSTRUCTEUR BOIS;6;6;4;2;0;0;0;4;0;0;0;0;4;2
11110.0;2022;32;GUADELOUPE;MASCULIN;SCOLAIRE;BAC PROFESSIONNEL;BAC PRO PROD;BAC PRO 23407 TECHNIC.FAB.BOIS ET MATERX ASSOC;14;12;8;4;0;0;0;8;0;0;0;0;8;4
11116.0;2022;32;GUADELOUPE;MASCULIN;SCOLAIRE;BAC PROFESSIONNEL;BAC PRO PROD;BAC PRO 25216 MAINT.VEHIC.OPTC MOTOCYCLES;7;7;2;4;1;1;0;3;0;0;0;2;1;4
11121.0;2022;32;GUADELOUPE;MASCULIN;SCOLAIRE;BAC PROFESSIONNEL;BAC PRO PROD;BAC PRO 25408 REPARATION DES CARROSSERIES;10;10;9;1;0;0;0;9;0;0;1;3;5;1
11126.0;2022;32;GUADELOUPE;MASCULIN;SCOLAIRE;BAC PROFESSIONNEL;BAC PRO PROD;BAC PRO 25514 SYST.NUM.OPT.B AUD.RES.EQUIP.DOM.;25;25;19;4;2;2;0;21;0;0;6;4;11;4
11128.0;2022;32;GUADELOUPE;MASCULIN;SCOLAIRE;BAC PROFESSIONNEL;BAC PRO PROD;BAC PRO AG 21004 CGEA;26;22;17;5;0;0;0;17;0;1;0;3;13;5
11129.0;2022;32;GUADELOUPE;MASCULIN;SCOLAIRE;BAC PROFESSIONNEL;BAC PRO PROD;BAC PRO AG 21114 CONDUITE PRODUCTIONS HORTICOLES;8;8;7;1;0;0;0;7;0;0;1;2;4;1
11132.0;2022;32;GUADELOUPE;MASCULIN;SCOLAIRE;BAC PROFESSIONNEL;BAC PRO SERV;BAC PRO 30001 GESTION-ADMINISTRATION;62;62;46;12;4;4;0;50;0;1;7;18;24;12
11136.0;2022;32;GUADELOUPE;MASCULIN;SCOLAIRE;BAC PROFESSIONNEL;BAC PRO SERV;BAC PRO 31213 MET.COM.VEN.OP.A ANI.GES.ESP.COM.;71;71;44;22;5;5;0;49;0;0;4;16;29;22
11137.0;2022;32;GUADELOUPE;MASCULIN;SCOLAIRE;BAC PROFESSIONNEL;BAC PRO SERV;BAC PRO 31214 MET.COM.VEN.OP.B PR.CL.VA.OF.COM.;58;58;35;17;6;6;0;41;0;1;2;13;25;17
11138.0;2022;32;GUADELOUPE;MASCULIN;SCOLAIRE;BAC PROFESSIONNEL;BAC PRO SERV;BAC PRO 32303 ART.& MET.ART:COM.VIS.VIS.PLURI-M;5;4;4;0;0;0;0;4;0;0;1;1;2;0
11145.0;2022;32;GUADELOUPE;MASCULIN;SCOLAIRE;BAC PROFESSIONNEL;BAC PRO SERV;BAC PRO AG 33002 SERV PERS TERRIT;19;19;17;2;0;0;0;17;0;0;3;1;13;2
11154.0;2022;32;GUADELOUPE;MASCULIN;SCOLAIRE;BAC TECHNOLOGIQUE;BAC STI2D;BAC STI2D ENERGIES  ET ENVIRONNEMENT;39;39;18;4;17;13;4;31;0;0;1;7;23;8
11159.0;2022;32;GUADELOUPE;MASCULIN;SCOLAIRE;BAC TECHNOLOGIQUE;BAC STMG;BAC STMG GESTION ET FINANCE;79;79;70;1;8;8;0;78;0;1;11;33;33;1
11184.0;2022;33;GUYANE;FEMININ;SCOLAIRE;BAC GENERAL;BAC GENERAL;BAC GENE 10019 BAC GENERAL;898;898;673;69;156;134;22;807;5;51;132;224;395;91
11185.0;2022;33;GUYANE;FEMININ;SCOLAIRE;BAC PROFESSIONNEL;BAC PRO PROD;BAC PRO 22004 PROC. CHIMIE EAU PAPIERS-CARTONS;5;5;4;1;0;0;0;4;0;0;0;1;3;1
11186.0;2022;33;GUYANE;FEMININ;SCOLAIRE;BAC PROFESSIONNEL;BAC PRO PROD;BAC PRO 22104 BOUCHER CHARCUTIER TRAITEUR;4;4;2;1;1;1;0;3;0;0;0;1;2;1
11189.0;2022;33;GUYANE;FEMININ;SCOLAIRE;BAC PROFESSIONNEL;BAC PRO PROD;BAC PRO 23004 TECHN. ETUDES BAT.A ETUDES & ECO.;5;5;3;2;0;0;0;3;0;0;0;0;3;2
11190.0;2022;33;GUYANE;FEMININ;SCOLAIRE;BAC PROFESSIONNEL;BAC PRO PROD;BAC PRO 23005 TECHN. ETUDES BAT B ASSIST.ARCHI.;3;3;0;3;0;0;0;0;0;0;0;0;0;3
11198.0;2022;33;GUYANE;FEMININ;SCOLAIRE;BAC PROFESSIONNEL;BAC PRO PROD;BAC PRO 25007 MAINTENANCE EQUIPEMENTS INDUST.;1;1;0;1;0;0;0;0;0;0;0;0;0;1
11201.0;2022;33;GUYANE;FEMININ;SCOLAIRE;BAC PROFESSIONNEL;BAC PRO PROD;BAC PRO AG 21004 CGEA;34;33;23;10;0;0;0;23;0;0;0;2;21;10
11206.0;2022;33;GUYANE;FEMININ;SCOLAIRE;BAC PROFESSIONNEL;BAC PRO SERV;BAC PRO 31106 LOGISTIQUE;8;8;2;6;0;0;0;2;0;0;0;0;2;6
11213.0;2022;33;GUYANE;FEMININ;SCOLAIRE;BAC PROFESSIONNEL;BAC PRO SERV;BAC PRO 33003 ACC.SOINS-S.PERS. OPT.A DOMICILE;39;39;32;6;1;1;0;33;0;1;8;12;12;6
11215.0;2022;33;GUYANE;FEMININ;SCOLAIRE;BAC PROFESSIONNEL;BAC PRO SERV;BAC PRO 33403 COMMERC. SERVICES EN RESTAURATION;14;14;7;6;1;0;1;7;0;0;2;2;3;7
11216.0;2022;33;GUYANE;FEMININ;SCOLAIRE;BAC PROFESSIONNEL;BAC PRO SERV;BAC PRO 34303 GEST. POLLUTIONS PROTEC. ENVIRON.;4;4;1;3;0;0;0;1;0;0;0;1;0;3
11219.0;2022;33;GUYANE;FEMININ;SCOLAIRE;BAC PROFESSIONNEL;BAC PRO SERV;BAC PRO AG 33002 SERV PERS TERRIT;27;25;23;2;0;0;0;23;0;0;1;7;15;2
11234.0;2022;33;GUYANE;MASCULIN;ENSEIGNEMENT A DISTANCE;BAC GENERAL;BAC GENERAL;BAC GENE 10019 BAC GENERAL;1;1;1;0;0;0;0;1;0;0;0;1;0;0
11236.0;2022;33;GUYANE;MASCULIN;FORMATION CONTINUE;BAC TECHNOLOGIQUE;BAC STAV;BAC STAV AGRONOMIE ALIM ENV TERRITOI;1;1;1;0;0;0;0;1;0;0;0;0;1;0
11245.0;2022;33;GUYANE;MASCULIN;INDIVIDUEL;BAC TECHNOLOGIQUE;BAC STMG;BAC STMG MERCATIQUE (MARKETING);1;1;0;1;0;0;0;0;0;0;0;0;0;1
11253.0;2022;33;GUYANE;MASCULIN;SCOLAIRE;BAC PROFESSIONNEL;BAC PRO PROD;BAC PRO 23004 TECHN. ETUDES BAT.A ETUDES & ECO.;34;34;7;24;3;3;0;10;0;0;0;1;9;24
11257.0;2022;33;GUYANE;MASCULIN;SCOLAIRE;BAC PROFESSIONNEL;BAC PRO PROD;BAC PRO 23205 INTERV. SUR PATRIMOINE BATI OPT.A;11;11;3;4;4;2;2;5;0;0;0;0;5;6
11259.0;2022;33;GUYANE;MASCULIN;SCOLAIRE;BAC PROFESSIONNEL;BAC PRO PROD;BAC PRO 23304 AMENAGEMENT FINITION BATIMENT;11;11;8;1;2;2;0;10;0;0;0;1;9;1
11262.0;2022;33;GUYANE;MASCULIN;SCOLAIRE;BAC PROFESSIONNEL;BAC PRO PROD;BAC PRO 24002 METIERS PRESSING BLANCHISSERIE;3;3;0;3;0;0;0;0;0;0;0;0;0;3
11269.0;2022;33;GUYANE;MASCULIN;SCOLAIRE;BAC PROFESSIONNEL;BAC PRO PROD;BAC PRO 25510 METIERS ELECT. ENVIRON. CONNECTES;83;83;44;32;7;3;4;47;0;2;4;11;30;36
11271.0;2022;33;GUYANE;MASCULIN;SCOLAIRE;BAC PROFESSIONNEL;BAC PRO PROD;BAC PRO 25515 SYST.NUM.OPT.C RES.INF.SYST.COMM.;12;12;8;3;1;0;1;8;0;1;4;2;1;4
11277.0;2022;33;GUYANE;MASCULIN;SCOLAIRE;BAC PROFESSIONNEL;BAC PRO SERV;BAC PRO 31106 LOGISTIQUE;16;16;6;9;1;1;0;7;0;0;1;2;4;9
11279.0;2022;33;GUYANE;MASCULIN;SCOLAIRE;BAC PROFESSIONNEL;BAC PRO SERV;BAC PRO 31212 METIERS DE L'ACCUEIL;8;8;4;3;1;1;0;5;0;0;1;2;2;3
11284.0;2022;33;GUYANE;MASCULIN;SCOLAIRE;BAC PROFESSIONNEL;BAC PRO SERV;BAC PRO 33003 ACC.SOINS-S.PERS. OPT.A DOMICILE;5;5;3;2;0;0;0;3;0;0;1;0;2;2
11295.0;2022;33;GUYANE;MASCULIN;SCOLAIRE;BAC TECHNOLOGIQUE;BAC STI2D;BAC STI2D ENERGIES  ET ENVIRONNEMENT;22;22;4;8;10;9;1;13;0;0;0;1;12;9
11297.0;2022;33;GUYANE;MASCULIN;SCOLAIRE;BAC TECHNOLOGIQUE;BAC STI2D;BAC STI2D SYSTÈME D'INFORMATION  ET NUMERIQUE;24;24;9;5;10;9;1;18;0;0;0;3;15;6
11301.0;2022;33;GUYANE;MASCULIN;SCOLAIRE;BAC TECHNOLOGIQUE;BAC STMG;BAC STMG MERCATIQUE (MARKETING);26;26;16;1;9;7;2;23;0;0;2;5;16;3
11306.0;2022;28;LA REUNION;FEMININ;APPRENTISSAGE;BAC PROFESSIONNEL;BAC PRO PROD;BAC PRO AG 22107 TEC CONS VTE ALIMENTATION P.ALIM;4;2;2;0;0;0;0;2;0;0;0;1;1;0
11314.0;2022;28;LA REUNION;FEMININ;INDIVIDUEL;BAC PROFESSIONNEL;BAC PRO PROD;BAC PRO AG 21114 CONDUITE PRODUCTIONS HORTICOLES;25;15;12;3;0;0;0;12;0;0;0;0;12;3
11315.0;2022;28;LA REUNION;FEMININ;INDIVIDUEL;BAC PROFESSIONNEL;BAC PRO PROD;BAC PRO AG 21211 COND GEST ENTR HIPPIQUE;1;1;1;0;0;0;0;1;0;0;0;0;1;0
11318.0;2022;28;LA REUNION;FEMININ;INDIVIDUEL;BAC PROFESSIONNEL;BAC PRO SERV;BAC PRO 33004 ACC.SOINS-S.PERS. OPT.EN STRUCTUR;1;1;1;0;0;0;0;1;0;0;0;1;0;0
11321.0;2022;28;LA REUNION;FEMININ;INDIVIDUEL;BAC TECHNOLOGIQUE;BAC STAV;BAC STAV AGRONOMIE ALIM ENV TERRITOI;1;1;0;1;0;0;0;0;0;0;0;0;0;1
11324.0;2022;28;LA REUNION;FEMININ;INDIVIDUEL;BAC TECHNOLOGIQUE;BAC STMG;BAC STMG MERCATIQUE (MARKETING);1;1;1;0;0;0;0;1;0;0;0;0;1;0
11327.0;2022;28;LA REUNION;FEMININ;SCOLAIRE;BAC PROFESSIONNEL;BAC PRO PROD;BACPRO 20002 ETUD.DEFINITION PRDTS INDUSTRIEL;1;1;1;0;0;0;0;1;0;0;0;1;0;0
11329.0;2022;28;LA REUNION;FEMININ;SCOLAIRE;BAC PROFESSIONNEL;BAC PRO PROD;BAC PRO 22003 BIO-INDUSTRIES DE TRANSFORMATION;19;19;15;4;0;0;0;15;0;2;1;5;7;4
11331.0;2022;28;LA REUNION;FEMININ;SCOLAIRE;BAC PROFESSIONNEL;BAC PRO PROD;BAC PRO 22105 BOULANGER-PÂTISSIER;11;11;11;0;0;0;0;11;0;0;2;4;5;0
11335.0;2022;28;LA REUNION;FEMININ;SCOLAIRE;BAC PROFESSIONNEL;BAC PRO PROD;BAC PRO 23004 TECHN. ETUDES BAT.A ETUDES & ECO.;8;8;6;2;0;0;0;6;0;0;0;5;1;2
11339.0;2022;28;LA REUNION;FEMININ;SCOLAIRE;BAC PROFESSIONNEL;BAC PRO PROD;BAC PRO 23207 INTERV. SUR PATRIMOINE BATI OPT.C;1;1;0;1;0;0;0;0;0;0;0;0;0;1
11345.0;2022;28;LA REUNION;FEMININ;SCOLAIRE;BAC PROFESSIONNEL;BAC PRO PROD;BAC PRO 25007 MAINTENANCE EQUIPEMENTS INDUST.;1;1;0;1;0;0;0;0;0;0;0;0;0;1
11347.0;2022;28;LA REUNION;FEMININ;SCOLAIRE;BAC PROFESSIONNEL;BAC PRO PROD;BAC PRO 25216 MAINT.VEHIC.OPTC MOTOCYCLES;2;2;2;0;0;0;0;2;0;0;0;1;1;0
11349.0;2022;28;LA REUNION;FEMININ;SCOLAIRE;BAC PROFESSIONNEL;BAC PRO PROD;BAC PRO 25408 REPARATION DES CARROSSERIES;12;12;10;2;0;0;0;10;0;1;5;3;1;2
11351.0;2022;28;LA REUNION;FEMININ;SCOLAIRE;BAC PROFESSIONNEL;BAC PRO PROD;BAC PRO 25514 SYST.NUM.OPT.B AUD.RES.EQUIP.DOM.;7;7;6;0;1;1;0;7;0;0;2;2;3;0
11354.0;2022;28;LA REUNION;FEMININ;SCOLAIRE;BAC PROFESSIONNEL;BAC PRO PROD;BAC PRO AG 21114 CONDUITE PRODUCTIONS HORTICOLES;2;2;2;0;0;0;0;2;0;0;0;0;2;0
11358.0;2022;28;LA REUNION;FEMININ;SCOLAIRE;BAC PROFESSIONNEL;BAC PRO SERV;BAC PRO 31106 LOGISTIQUE;16;16;10;5;1;1;0;11;0;1;2;4;4;5
11359.0;2022;28;LA REUNION;FEMININ;SCOLAIRE;BAC PROFESSIONNEL;BAC PRO SERV;BAC PRO 31108 TRANSPORT;12;12;9;2;1;1;0;10;0;0;3;3;4;2
11360.0;2022;28;LA REUNION;FEMININ;SCOLAIRE;BAC PROFESSIONNEL;BAC PRO SERV;BAC PRO 31212 METIERS DE L'ACCUEIL;169;167;140;16;11;9;2;149;0;11;27;53;58;18
11363.0;2022;28;LA REUNION;FEMININ;SCOLAIRE;BAC PROFESSIONNEL;BAC PRO SERV;BAC PRO 32208 REAL.PR.IMPR.PLURI.OPTB.PR.IMPR.;6;6;5;1;0;0;0;5;0;1;1;3;0;1
11365.0;2022;28;LA REUNION;FEMININ;SCOLAIRE;BAC PROFESSIONNEL;BAC PRO SERV;BAC PRO 33002 SERVICES DE PROXIMITE  VIE LOCAL;27;27;25;1;1;1;0;26;0;2;10;9;5;1
11366.0;2022;28;LA REUNION;FEMININ;SCOLAIRE;BAC PROFESSIONNEL;BAC PRO SERV;BAC PRO 33003 ACC.SOINS-S.PERS. OPT.A DOMICILE;27;27;22;3;2;2;0;24;0;1;11;6;6;3
11379.0;2022;28;LA REUNION;FEMININ;SCOLAIRE;BAC TECHNOLOGIQUE;BAC STI2D;BAC STI2D ARCHITECTURE ET CONSTRUCTION;34;34;25;3;6;5;1;30;0;0;3;6;21;4
11407.0;2022;28;LA REUNION;MASCULIN;FORMATION CONTINUE;BAC PROFESSIONNEL;BAC PRO PROD;BAC PRO 22003 BIO-INDUSTRIES DE TRANSFORMATION;2;0;0;0;0;0;0;0;0;0;0;0;0;0
11415.0;2022;28;LA REUNION;MASCULIN;INDIVIDUEL;BAC PROFESSIONNEL;BAC PRO PROD;BAC PRO AG 21114 CONDUITE PRODUCTIONS HORTICOLES;30;18;12;6;0;0;0;12;0;0;0;0;12;6
11417.0;2022;28;LA REUNION;MASCULIN;INDIVIDUEL;BAC PROFESSIONNEL;BAC PRO SERV;BAC PRO 30001 GESTION-ADMINISTRATION;1;0;0;0;0;0;0;0;0;0;0;0;0;0
11419.0;2022;28;LA REUNION;MASCULIN;INDIVIDUEL;BAC PROFESSIONNEL;BAC PRO SERV;BAC PRO 33004 ACC.SOINS-S.PERS. OPT.EN STRUCTUR;1;1;0;1;0;0;0;0;0;0;0;0;0;1
11422.0;2022;28;LA REUNION;MASCULIN;INDIVIDUEL;BAC TECHNOLOGIQUE;BAC STMG;BAC STMG MERCATIQUE (MARKETING);2;1;0;1;0;0;0;0;0;0;0;0;0;1
11423.0;2022;28;LA REUNION;MASCULIN;INDIVIDUEL;BAC TECHNOLOGIQUE;BAC STMG;BAC STMG RESSOURCES HUMAINES ET COMMUNICATION;1;1;1;0;0;0;0;1;0;0;0;0;1;0
11424.0;2022;28;LA REUNION;MASCULIN;SCOLAIRE;BAC GENERAL;BAC GENERAL;BAC GENE 10019 BAC GENERAL;2148;2148;1910;32;206;157;49;2067;56;272;478;609;652;81
11427.0;2022;28;LA REUNION;MASCULIN;SCOLAIRE;BAC PROFESSIONNEL;BAC PRO PROD;BAC PRO 22003 BIO-INDUSTRIES DE TRANSFORMATION;18;18;8;9;1;0;1;8;0;0;1;1;6;10
11430.0;2022;28;LA REUNION;MASCULIN;SCOLAIRE;BAC PROFESSIONNEL;BAC PRO PROD;BAC PRO 22106 CUISINE;15;15;14;1;0;0;0;14;0;5;5;3;1;1
11435.0;2022;28;LA REUNION;MASCULIN;SCOLAIRE;BAC PROFESSIONNEL;BAC PRO PROD;BAC PRO 23004 TECHN. ETUDES BAT.A ETUDES & ECO.;33;33;23;10;0;0;0;23;0;0;3;6;14;10
11439.0;2022;28;LA REUNION;MASCULIN;SCOLAIRE;BAC PROFESSIONNEL;BAC PRO PROD;BAC PRO 23203 TECHNICIEN BAT. : ORG.REAL.GROS O;40;40;30;6;4;4;0;34;0;0;6;7;21;6
11443.0;2022;28;LA REUNION;MASCULIN;SCOLAIRE;BAC PROFESSIONNEL;BAC PRO PROD;BAC PRO 23303 MENUISERIE ALUMINIUM-VERRE;25;25;16;4;5;2;3;18;0;1;4;8;5;7
11451.0;2022;28;LA REUNION;MASCULIN;SCOLAIRE;BAC PROFESSIONNEL;BAC PRO PROD;BAC PRO 25106 TECHNICIEN D'USINAGE;5;5;3;0;2;0;2;3;0;0;2;1;0;2
11458.0;2022;28;LA REUNION;MASCULIN;SCOLAIRE;BAC PROFESSIONNEL;BAC PRO PROD;BAC PRO 25406 OUVRAGES DU BATIMENT METALLERIE;35;35;21;7;7;3;4;24;0;0;5;7;12;11
11459.0;2022;28;LA REUNION;MASCULIN;SCOLAIRE;BAC PROFESSIONNEL;BAC PRO PROD;BAC PRO 25408 REPARATION DES CARROSSERIES;54;53;47;4;2;1;1;48;0;2;16;17;13;5
11460.0;2022;28;LA REUNION;MASCULIN;SCOLAIRE;BAC PROFESSIONNEL;BAC PRO PROD;BAC PRO 25411 TECH.CHAUDRONNERIE INDUSTRIELLE;23;23;19;2;2;1;1;20;0;0;6;6;8;3
11478.0;2022;28;LA REUNION;MASCULIN;SCOLAIRE;BAC PROFESSIONNEL;BAC PRO SERV;BAC PRO 31214 MET.COM.VEN.OP.B PR.CL.VA.OF.COM.;50;49;38;7;4;3;1;41;0;5;7;11;18;8
11481.0;2022;28;LA REUNION;MASCULIN;SCOLAIRE;BAC PROFESSIONNEL;BAC PRO SERV;BAC PRO 32303 ART.& MET.ART:COM.VIS.VIS.PLURI-M;13;13;8;4;1;1;0;9;0;0;3;2;4;4
11487.0;2022;28;LA REUNION;MASCULIN;SCOLAIRE;BAC PROFESSIONNEL;BAC PRO SERV;BAC PRO 34303 GEST. POLLUTIONS PROTEC. ENVIRON.;5;5;4;0;1;1;0;5;0;1;2;0;2;0
11491.0;2022;28;LA REUNION;MASCULIN;SCOLAIRE;BAC TECHNOLOGIQUE;BAC ST2S;BAC ST2S SCIENCES & TECHNO. SANTE & SOCIAL;78;78;59;2;17;13;4;72;0;2;6;23;41;6
11492.0;2022;28;LA REUNION;MASCULIN;SCOLAIRE;BAC TECHNOLOGIQUE;BAC STAV;BAC STAV AGRONOMIE ALIM ENV TERRITOI;12;12;10;2;0;0;0;10;0;0;0;3;7;2
11497.0;2022;28;LA REUNION;MASCULIN;SCOLAIRE;BAC TECHNOLOGIQUE;BAC STI2D;BAC STI2D INNOVATION TECHNO.  ET ECO CONCEPTION;103;103;77;7;19;17;2;94;0;1;9;21;63;9
11503.0;2022;28;LA REUNION;MASCULIN;SCOLAIRE;BAC TECHNOLOGIQUE;BAC STMG;BAC STMG RESSOURCES HUMAINES ET COMMUNICATION;142;142;91;16;35;31;4;122;0;2;6;28;86;20
11511.0;2022;09;LILLE;FEMININ;APPRENTISSAGE;BAC PROFESSIONNEL;BAC PRO PROD;BAC PRO 23304 AMENAGEMENT FINITION BATIMENT;3;3;3;0;0;0;0;3;0;1;1;1;0;0
11513.0;2022;09;LILLE;FEMININ;APPRENTISSAGE;BAC PROFESSIONNEL;BAC PRO PROD;BAC PRO 24203 METIERS DE LA MODE - VÊTEMENT;4;4;4;0;0;0;0;4;0;3;1;0;0;0
11514.0;2022;09;LILLE;FEMININ;APPRENTISSAGE;BAC PROFESSIONNEL;BAC PRO PROD;BAC PRO 25007 MAINTENANCE EQUIPEMENTS INDUST.;3;3;3;0;0;0;0;3;0;0;1;0;2;0
11519.0;2022;09;LILLE;FEMININ;APPRENTISSAGE;BAC PROFESSIONNEL;BAC PRO PROD;BAC PRO 25408 REPARATION DES CARROSSERIES;2;2;2;0;0;0;0;2;0;1;1;0;0;0
11522.0;2022;09;LILLE;FEMININ;APPRENTISSAGE;BAC PROFESSIONNEL;BAC PRO PROD;BAC PRO AG 21004 CGEA;7;7;5;2;0;0;0;5;0;0;0;2;3;2
11523.0;2022;09;LILLE;FEMININ;APPRENTISSAGE;BAC PROFESSIONNEL;BAC PRO PROD;BAC PRO AG 21114 CONDUITE PRODUCTIONS HORTICOLES;1;1;0;1;0;0;0;0;0;0;0;0;0;1
11524.0;2022;09;LILLE;FEMININ;APPRENTISSAGE;BAC PROFESSIONNEL;BAC PRO PROD;BAC PRO AG 21203 TECHN CONSEIL DE VENTE ANIMAL;2;2;1;1;0;0;0;1;0;0;1;0;0;1
11538.0;2022;09;LILLE;FEMININ;ENSEIGNEMENT A DISTANCE;BAC PROFESSIONNEL;BAC PRO SERV;BAC PRO 30001 GESTION-ADMINISTRATION;2;1;1;0;0;0;0;1;0;0;0;1;0;0
11543.0;2022;09;LILLE;FEMININ;ENSEIGNEMENT A DISTANCE;BAC TECHNOLOGIQUE;BAC ST2S;BAC ST2S SCIENCES & TECHNO. SANTE & SOCIAL;7;7;4;2;1;0;1;4;0;0;0;1;3;3
11551.0;2022;09;LILLE;FEMININ;FORMATION CONTINUE;BAC PROFESSIONNEL;BAC PRO SERV;BAC PRO 31212 METIERS DE L'ACCUEIL;1;1;1;0;0;0;0;1;0;1;0;0;0;0
11552.0;2022;09;LILLE;FEMININ;FORMATION CONTINUE;BAC PROFESSIONNEL;BAC PRO SERV;BAC PRO 31213 MET.COM.VEN.OP.A ANI.GES.ESP.COM.;6;4;2;2;0;0;0;2;0;0;2;0;0;2
11553.0;2022;09;LILLE;FEMININ;FORMATION CONTINUE;BAC PROFESSIONNEL;BAC PRO SERV;BAC PRO 33101 OPTIQUE LUNETTERIE;1;1;1;0;0;0;0;1;0;1;0;0;0;0
11563.0;2022;09;LILLE;FEMININ;INDIVIDUEL;BAC PROFESSIONNEL;BAC PRO SERV;BAC PRO 31213 MET.COM.VEN.OP.A ANI.GES.ESP.COM.;5;4;2;2;0;0;0;2;0;0;0;1;1;2
11568.0;2022;09;LILLE;FEMININ;INDIVIDUEL;BAC PROFESSIONNEL;BAC PRO SERV;BAC PRO 33403 COMMERC. SERVICES EN RESTAURATION;1;0;0;0;0;0;0;0;0;0;0;0;0;0
11575.0;2022;09;LILLE;FEMININ;SCOLAIRE;BAC GENERAL;BAC GENERAL;BAC GENE 10019 BAC GENERAL;12384;12384;11483;204;697;482;215;11965;404;1908;3271;3557;2825;419
11582.0;2022;09;LILLE;FEMININ;SCOLAIRE;BAC PROFESSIONNEL;BAC PRO PROD;BAC PRO 22503 PLASTIQUES ET COMPOSITES;1;1;1;0;0;0;0;1;0;0;0;0;1;0
11583.0;2022;09;LILLE;FEMININ;SCOLAIRE;BAC PROFESSIONNEL;BAC PRO PROD;BAC PRO 23003 ARTIS. & M.ART:MARCHANDISAGE VIS.;12;12;12;0;0;0;0;12;0;2;4;6;0;0
11591.0;2022;09;LILLE;FEMININ;SCOLAIRE;BAC PROFESSIONNEL;BAC PRO PROD;BAC PRO 23407 TECHNIC.FAB.BOIS ET MATERX ASSOC;2;2;1;1;0;0;0;1;0;0;0;1;0;1
11594.0;2022;09;LILLE;FEMININ;SCOLAIRE;BAC PROFESSIONNEL;BAC PRO PROD;BAC PRO 25007 MAINTENANCE EQUIPEMENTS INDUST.;11;11;7;3;1;1;0;8;0;0;0;6;2;3
11605.0;2022;09;LILLE;FEMININ;SCOLAIRE;BAC PROFESSIONNEL;BAC PRO PROD;BAC PRO 25515 SYST.NUM.OPT.C RES.INF.SYST.COMM.;3;3;3;0;0;0;0;3;0;1;1;0;1;0
11612.0;2022;09;LILLE;FEMININ;SCOLAIRE;BAC PROFESSIONNEL;BAC PRO PROD;BAC PRO AG 21303 FORET;2;2;2;0;0;0;0;2;0;0;1;0;1;0
11621.0;2022;09;LILLE;FEMININ;SCOLAIRE;BAC PROFESSIONNEL;BAC PRO SERV;BAC PRO 31212 METIERS DE L'ACCUEIL;260;254;205;37;12;6;6;211;0;13;49;59;90;43
11623.0;2022;09;LILLE;FEMININ;SCOLAIRE;BAC PROFESSIONNEL;BAC PRO SERV;BAC PRO 31214 MET.COM.VEN.OP.B PR.CL.VA.OF.COM.;132;131;111;17;3;2;1;113;0;7;28;39;39;18
11626.0;2022;09;LILLE;FEMININ;SCOLAIRE;BAC PROFESSIONNEL;BAC PRO SERV;BAC PRO 32303 ART.& MET.ART:COM.VIS.VIS.PLURI-M;49;47;43;3;1;1;0;44;0;3;11;18;12;3
11627.0;2022;09;LILLE;FEMININ;SCOLAIRE;BAC PROFESSIONNEL;BAC PRO SERV;BAC PRO 32304 PHOTOGRAPHIE;14;14;11;3;0;0;0;11;0;1;2;4;4;3
11630.0;2022;09;LILLE;FEMININ;SCOLAIRE;BAC PROFESSIONNEL;BAC PRO SERV;BAC PRO 33004 ACC.SOINS-S.PERS. OPT.EN STRUCTUR;1288;1284;1105;154;25;17;8;1122;0;52;212;471;387;162
11641.0;2022;09;LILLE;FEMININ;SCOLAIRE;BAC TECHNOLOGIQUE;BAC S2TMD;BAC S2TMD MUSIQUE;6;6;6;0;0;0;0;6;1;1;3;1;0;0
11642.0;2022;09;LILLE;FEMININ;SCOLAIRE;BAC TECHNOLOGIQUE;BAC ST2S;BAC ST2S SCIENCES & TECHNO. SANTE & SOCIAL;1667;1667;1378;71;218;133;85;1511;5;78;278;515;635;156
11647.0;2022;09;LILLE;FEMININ;SCOLAIRE;BAC TECHNOLOGIQUE;BAC STI2D;BAC STI2D ENERGIES  ET ENVIRONNEMENT;14;14;13;0;1;1;0;14;0;1;4;3;6;0
11649.0;2022;09;LILLE;FEMININ;SCOLAIRE;BAC TECHNOLOGIQUE;BAC STI2D;BAC STI2D SYSTÈME D'INFORMATION  ET NUMERIQUE;15;15;15;0;0;0;0;15;0;0;2;11;2;0
11650.0;2022;09;LILLE;FEMININ;SCOLAIRE;BAC TECHNOLOGIQUE;BAC STL;BAC STL BIOCHIM.-BIOLOGIE-BIOTECHNOL.;144;144;123;9;12;8;4;131;0;11;26;54;40;13
11656.0;2022;09;LILLE;MASCULIN;APPRENTISSAGE;BAC PROFESSIONNEL;BAC PRO PROD;BAC PRO 20102 PILOTE DE LIGNE DE PRODUCTION;19;18;16;2;0;0;0;16;0;3;3;6;4;2
11659.0;2022;09;LILLE;MASCULIN;APPRENTISSAGE;BAC PROFESSIONNEL;BAC PRO PROD;BAC PRO 22106 CUISINE;67;63;40;21;2;2;0;42;0;2;7;19;14;21
11670.0;2022;09;LILLE;MASCULIN;APPRENTISSAGE;BAC PROFESSIONNEL;BAC PRO PROD;BAC PRO 23407 TECHNIC.FAB.BOIS ET MATERX ASSOC;4;4;1;3;0;0;0;1;0;0;0;0;1;3
11671.0;2022;09;LILLE;MASCULIN;APPRENTISSAGE;BAC PROFESSIONNEL;BAC PRO PROD;BAC PRO 23408 Etude et réalisation d'agencement;1;1;1;0;0;0;0;1;0;0;0;1;0;0
11682.0;2022;09;LILLE;MASCULIN;APPRENTISSAGE;BAC PROFESSIONNEL;BAC PRO PROD;BAC PRO 25406 OUVRAGES DU BATIMENT METALLERIE;13;13;10;0;3;2;1;12;0;0;3;4;5;1
11685.0;2022;09;LILLE;MASCULIN;APPRENTISSAGE;BAC PROFESSIONNEL;BAC PRO PROD;BAC PRO 25411 TECH.CHAUDRONNERIE INDUSTRIELLE;87;84;64;12;8;3;5;67;0;10;19;15;23;17
11686.0;2022;09;LILLE;MASCULIN;APPRENTISSAGE;BAC PROFESSIONNEL;BAC PRO PROD;BAC PRO 25509 TECHNIC. FROID CONDITIONNEMT AIR;1;1;1;0;0;0;0;1;0;0;0;0;1;0
11688.0;2022;09;LILLE;MASCULIN;APPRENTISSAGE;BAC PROFESSIONNEL;BAC PRO PROD;BAC PRO 25514 SYST.NUM.OPT.B AUD.RES.EQUIP.DOM.;1;1;1;0;0;0;0;1;0;0;0;1;0;0
11689.0;2022;09;LILLE;MASCULIN;APPRENTISSAGE;BAC PROFESSIONNEL;BAC PRO PROD;BAC PRO AG 21001 AGRO-EQUIPEMENT;28;26;19;7;0;0;0;19;0;0;0;3;16;7
11696.0;2022;09;LILLE;MASCULIN;APPRENTISSAGE;BAC PROFESSIONNEL;BAC PRO SERV;BAC PRO 30001 GESTION-ADMINISTRATION;3;3;2;0;1;0;1;2;0;1;0;1;0;1
11697.0;2022;09;LILLE;MASCULIN;APPRENTISSAGE;BAC PROFESSIONNEL;BAC PRO SERV;BAC PRO 31106 LOGISTIQUE;23;23;20;3;0;0;0;20;0;5;4;6;5;3
11701.0;2022;09;LILLE;MASCULIN;APPRENTISSAGE;BAC PROFESSIONNEL;BAC PRO SERV;BAC PRO 33103 TECHNICIEN APPAREIL. ORTHOPEDIQUE;3;3;3;0;0;0;0;3;0;1;1;1;0;0
11705.0;2022;09;LILLE;MASCULIN;ENSEIGNEMENT A DISTANCE;BAC GENERAL;BAC GENERAL;BAC GENE 10019 BAC GENERAL;25;25;13;7;5;4;1;17;0;0;1;5;11;8
11709.0;2022;09;LILLE;MASCULIN;ENSEIGNEMENT A DISTANCE;BAC TECHNOLOGIQUE;BAC STMG;BAC STMG GESTION ET FINANCE;5;5;2;0;3;3;0;5;0;0;0;2;3;0
11710.0;2022;09;LILLE;MASCULIN;ENSEIGNEMENT A DISTANCE;BAC TECHNOLOGIQUE;BAC STMG;BAC STMG MERCATIQUE (MARKETING);5;5;4;1;0;0;0;4;0;0;2;0;2;1
11712.0;2022;09;LILLE;MASCULIN;ENSEIGNEMENT A DISTANCE;BAC TECHNOLOGIQUE;BAC STMG;BAC STMG SYSTEMES D'INFORMATION DE GESTION;1;1;1;0;0;0;0;1;0;0;0;1;0;0
11716.0;2022;09;LILLE;MASCULIN;FORMATION CONTINUE;BAC PROFESSIONNEL;BAC PRO PROD;BAC PRO 23404 TECHNICIEN CONSTRUCTEUR BOIS;1;1;0;1;0;0;0;0;0;0;0;0;0;1
11731.0;2022;09;LILLE;MASCULIN;INDIVIDUEL;BAC PROFESSIONNEL;BAC PRO PROD;BAC PRO 23102 TRAVAUX PUBLICS;2;2;1;1;0;0;0;1;0;0;0;0;1;1
11738.0;2022;09;LILLE;MASCULIN;INDIVIDUEL;BAC PROFESSIONNEL;BAC PRO PROD;BAC PRO 25510 METIERS ELECT. ENVIRON. CONNECTES;4;3;0;2;1;1;0;1;0;0;0;0;1;2
11751.0;2022;09;LILLE;MASCULIN;INDIVIDUEL;BAC PROFESSIONNEL;BAC PRO SERV;BAC PRO 33004 ACC.SOINS-S.PERS. OPT.EN STRUCTUR;2;1;0;1;0;0;0;0;0;0;0;0;0;1
11759.0;2022;09;LILLE;MASCULIN;SCOLAIRE;BAC GENERAL;BAC GENERAL;BAC GENE 10019 BAC GENERAL;10067;10067;8992;210;865;591;274;9583;294;1216;2155;2908;3010;484
11778.0;2022;09;LILLE;MASCULIN;SCOLAIRE;BAC PROFESSIONNEL;BAC PRO PROD;BAC PRO 23303 MENUISERIE ALUMINIUM-VERRE;20;20;18;2;0;0;0;18;0;1;2;9;6;2
11793.0;2022;09;LILLE;MASCULIN;SCOLAIRE;BAC PROFESSIONNEL;BAC PRO PROD;BAC PRO 25406 OUVRAGES DU BATIMENT METALLERIE;49;49;34;10;5;3;2;37;0;1;6;15;15;12
11795.0;2022;09;LILLE;MASCULIN;SCOLAIRE;BAC PROFESSIONNEL;BAC PRO PROD;BAC PRO 25410 CONSTRUCTION DES CARROSSERIES;7;7;6;0;1;1;0;7;0;0;1;1;5;0
11800.0;2022;09;LILLE;MASCULIN;SCOLAIRE;BAC PROFESSIONNEL;BAC PRO PROD;BAC PRO 25514 SYST.NUM.OPT.B AUD.RES.EQUIP.DOM.;132;132;115;9;8;7;1;122;0;2;15;55;50;10
11802.0;2022;09;LILLE;MASCULIN;SCOLAIRE;BAC PROFESSIONNEL;BAC PRO PROD;BAC PRO AG 21001 AGRO-EQUIPEMENT;32;30;26;4;0;0;0;26;0;0;4;11;11;4
11804.0;2022;09;LILLE;MASCULIN;SCOLAIRE;BAC PROFESSIONNEL;BAC PRO PROD;BAC PRO AG 21114 CONDUITE PRODUCTIONS HORTICOLES;6;6;6;0;0;0;0;6;0;0;1;2;3;0
11805.0;2022;09;LILLE;MASCULIN;SCOLAIRE;BAC PROFESSIONNEL;BAC PRO PROD;BAC PRO AG 21203 TECHN CONSEIL DE VENTE ANIMAL;35;35;32;3;0;0;0;32;0;2;0;14;16;3
11806.0;2022;09;LILLE;MASCULIN;SCOLAIRE;BAC PROFESSIONNEL;BAC PRO PROD;BAC PRO AG 21204 PROD-AQUACOLES;8;8;6;2;0;0;0;6;0;0;0;4;2;2
11815.0;2022;09;LILLE;MASCULIN;SCOLAIRE;BAC PROFESSIONNEL;BAC PRO SERV;BAC PRO 30001 GESTION-ADMINISTRATION;322;320;213;94;13;5;8;218;0;5;38;91;84;102
11816.0;2022;09;LILLE;MASCULIN;SCOLAIRE;BAC PROFESSIONNEL;BAC PRO SERV;BAC PRO 31106 LOGISTIQUE;176;175;130;37;8;7;1;137;0;9;28;51;49;38
11821.0;2022;09;LILLE;MASCULIN;SCOLAIRE;BAC PROFESSIONNEL;BAC PRO SERV;BAC PRO 31214 MET.COM.VEN.OP.B PR.CL.VA.OF.COM.;229;227;179;43;5;3;2;182;0;4;46;67;65;45
11822.0;2022;09;LILLE;MASCULIN;SCOLAIRE;BAC PROFESSIONNEL;BAC PRO SERV;BAC PRO 32207 REAL.PR.IMPR.PLURI.OPTA.PR.GRAPH.;23;22;20;2;0;0;0;20;0;1;2;14;3;2
11824.0;2022;09;LILLE;MASCULIN;SCOLAIRE;BAC PROFESSIONNEL;BAC PRO SERV;BAC PRO 32303 ART.& MET.ART:COM.VIS.VIS.PLURI-M;68;66;53;11;2;2;0;55;0;6;10;21;18;11
11826.0;2022;09;LILLE;MASCULIN;SCOLAIRE;BAC PROFESSIONNEL;BAC PRO SERV;BAC PRO 33002 SERVICES DE PROXIMITE  VIE LOCAL;33;33;25;6;2;2;0;27;0;0;5;10;12;6
11829.0;2022;09;LILLE;MASCULIN;SCOLAIRE;BAC PROFESSIONNEL;BAC PRO SERV;BAC PRO 33101 OPTIQUE LUNETTERIE;19;19;15;3;1;1;0;16;0;0;3;5;8;3
11830.0;2022;09;LILLE;MASCULIN;SCOLAIRE;BAC PROFESSIONNEL;BAC PRO SERV;BAC PRO 33102 PROTHESE DENTAIRE;7;7;5;2;0;0;0;5;0;0;1;1;3;2
11839.0;2022;09;LILLE;MASCULIN;SCOLAIRE;BAC TECHNOLOGIQUE;BAC ST2S;BAC ST2S SCIENCES & TECHNO. SANTE & SOCIAL;372;372;274;19;79;52;27;326;0;8;47;87;184;46
11842.0;2022;09;LILLE;MASCULIN;SCOLAIRE;BAC TECHNOLOGIQUE;BAC STHR;BAC STHR SC.&TEC. HOTELLERIE-RESTAURATION;56;56;54;0;2;1;1;55;0;1;15;18;21;1
11859.0;2022;22;LIMOGES;FEMININ;APPRENTISSAGE;BAC PROFESSIONNEL;BAC PRO PROD;BAC PRO AG 21405 AMENAGEMENTS PAYSAGERS;1;1;1;0;0;0;0;1;0;0;0;0;1;0
11861.0;2022;22;LIMOGES;FEMININ;APPRENTISSAGE;BAC PROFESSIONNEL;BAC PRO SERV;BAC PRO 31212 METIERS DE L'ACCUEIL;1;1;1;0;0;0;0;1;0;0;0;1;0;0
11862.0;2022;22;LIMOGES;FEMININ;APPRENTISSAGE;BAC PROFESSIONNEL;BAC PRO SERV;BAC PRO 31213 MET.COM.VEN.OP.A ANI.GES.ESP.COM.;22;22;16;6;0;0;0;16;0;2;6;3;5;6
11865.0;2022;22;LIMOGES;FEMININ;APPRENTISSAGE;BAC PROFESSIONNEL;BAC PRO SERV;BAC PRO AG 33002 SERV PERS TERRIT;6;6;6;0;0;0;0;6;0;0;1;4;1;0
11867.0;2022;22;LIMOGES;FEMININ;ENSEIGNEMENT A DISTANCE;BAC TECHNOLOGIQUE;BAC ST2S;BAC ST2S SCIENCES & TECHNO. SANTE & SOCIAL;1;1;1;0;0;0;0;1;0;0;0;0;1;0
11875.0;2022;22;LIMOGES;FEMININ;INDIVIDUEL;BAC PROFESSIONNEL;BAC PRO SERV;BAC PRO 30001 GESTION-ADMINISTRATION;2;0;0;0;0;0;0;0;0;0;0;0;0;0
11890.0;2022;22;LIMOGES;FEMININ;SCOLAIRE;BAC PROFESSIONNEL;BAC PRO PROD;BAC PRO 25007 MAINTENANCE EQUIPEMENTS INDUST.;2;2;1;1;0;0;0;1;0;0;0;0;1;1
11899.0;2022;22;LIMOGES;FEMININ;SCOLAIRE;BAC PROFESSIONNEL;BAC PRO PROD;BAC PRO AG 21114 CONDUITE PRODUCTIONS HORTICOLES;1;1;1;0;0;0;0;1;0;0;0;1;0;0
11904.0;2022;22;LIMOGES;FEMININ;SCOLAIRE;BAC PROFESSIONNEL;BAC PRO PROD;BAC PRO AG 22105 LABORATOIRE CONTROLE QUALITE;9;9;8;1;0;0;0;8;0;0;4;2;2;1
11909.0;2022;22;LIMOGES;FEMININ;SCOLAIRE;BAC PROFESSIONNEL;BAC PRO SERV;BAC PRO 31213 MET.COM.VEN.OP.A ANI.GES.ESP.COM.;46;45;38;3;4;4;0;42;0;0;9;14;19;3
11917.0;2022;22;LIMOGES;FEMININ;SCOLAIRE;BAC PROFESSIONNEL;BAC PRO SERV;BAC PRO 33101 OPTIQUE LUNETTERIE;5;5;5;0;0;0;0;5;0;1;3;0;1;0
11918.0;2022;22;LIMOGES;FEMININ;SCOLAIRE;BAC PROFESSIONNEL;BAC PRO SERV;BAC PRO 33403 COMMERC. SERVICES EN RESTAURATION;13;13;10;2;1;0;1;10;0;0;2;2;6;3
11923.0;2022;22;LIMOGES;FEMININ;SCOLAIRE;BAC TECHNOLOGIQUE;BAC ST2S;BAC ST2S SCIENCES & TECHNO. SANTE & SOCIAL;236;236;204;10;22;10;12;214;1;8;30;89;86;22
11924.0;2022;22;LIMOGES;FEMININ;SCOLAIRE;BAC TECHNOLOGIQUE;BAC STAV;BAC STAV AGRONOMIE ALIM ENV TERRITOI;37;37;36;1;0;0;0;36;0;1;2;14;19;1
11926.0;2022;22;LIMOGES;FEMININ;SCOLAIRE;BAC TECHNOLOGIQUE;BAC STHR;BAC STHR SC.&TEC. HOTELLERIE-RESTAURATION;10;10;9;0;1;1;0;10;0;0;0;4;6;0
11928.0;2022;22;LIMOGES;FEMININ;SCOLAIRE;BAC TECHNOLOGIQUE;BAC STI2D;BAC STI2D ENERGIES  ET ENVIRONNEMENT;1;1;0;0;1;1;0;1;0;0;0;0;1;0
11941.0;2022;22;LIMOGES;MASCULIN;APPRENTISSAGE;BAC PROFESSIONNEL;BAC PRO PROD;BAC PRO 23203 TECHNICIEN BAT. : ORG.REAL.GROS O;2;2;2;0;0;0;0;2;0;0;0;0;2;0
11944.0;2022;22;LIMOGES;MASCULIN;APPRENTISSAGE;BAC PROFESSIONNEL;BAC PRO PROD;BAC PRO 23208 METIERS ET ARTS DE LA PIERRE;2;2;2;0;0;0;0;2;0;1;0;0;1;0
11947.0;2022;22;LIMOGES;MASCULIN;APPRENTISSAGE;BAC PROFESSIONNEL;BAC PRO PROD;BAC PRO 23407 TECHNIC.FAB.BOIS ET MATERX ASSOC;1;1;1;0;0;0;0;1;0;0;0;0;1;0
11959.0;2022;22;LIMOGES;MASCULIN;APPRENTISSAGE;BAC PROFESSIONNEL;BAC PRO PROD;BAC PRO 25509 TECHNIC. FROID CONDITIONNEMT AIR;1;1;0;1;0;0;0;0;0;0;0;0;0;1
11960.0;2022;22;LIMOGES;MASCULIN;APPRENTISSAGE;BAC PROFESSIONNEL;BAC PRO PROD;BAC PRO 25510 METIERS ELECT. ENVIRON. CONNECTES;19;19;18;1;0;0;0;18;0;1;4;8;5;1
11965.0;2022;22;LIMOGES;MASCULIN;APPRENTISSAGE;BAC PROFESSIONNEL;BAC PRO SERV;BAC PRO 31213 MET.COM.VEN.OP.A ANI.GES.ESP.COM.;24;24;20;3;1;0;1;20;0;1;3;9;7;4
11969.0;2022;22;LIMOGES;MASCULIN;ENSEIGNEMENT A DISTANCE;BAC GENERAL;BAC GENERAL;BAC GENE 10019 BAC GENERAL;4;4;2;1;1;0;1;2;0;0;0;2;0;2
11978.0;2022;22;LIMOGES;MASCULIN;INDIVIDUEL;BAC PROFESSIONNEL;BAC PRO PROD;BAC PRO 25515 SYST.NUM.OPT.C RES.INF.SYST.COMM.;1;1;1;0;0;0;0;1;0;0;0;0;1;0
11986.0;2022;22;LIMOGES;MASCULIN;SCOLAIRE;BAC GENERAL;BAC GENERAL;BAC GENE 10019 BAC GENERAL;1391;1391;1241;21;129;82;47;1323;14;148;279;428;454;68
11990.0;2022;22;LIMOGES;MASCULIN;SCOLAIRE;BAC PROFESSIONNEL;BAC PRO PROD;BAC PRO 22105 BOULANGER-PÂTISSIER;8;8;7;1;0;0;0;7;0;2;0;4;1;1
11997.0;2022;22;LIMOGES;MASCULIN;SCOLAIRE;BAC PROFESSIONNEL;BAC PRO PROD;BAC PRO 23304 AMENAGEMENT FINITION BATIMENT;6;6;5;1;0;0;0;5;0;0;2;1;2;1
12000.0;2022;22;LIMOGES;MASCULIN;SCOLAIRE;BAC PROFESSIONNEL;BAC PRO PROD;BAC PRO 23407 TECHNIC.FAB.BOIS ET MATERX ASSOC;12;12;7;5;0;0;0;7;0;0;2;3;2;5
12011.0;2022;22;LIMOGES;MASCULIN;SCOLAIRE;BAC PROFESSIONNEL;BAC PRO PROD;BAC PRO 25408 REPARATION DES CARROSSERIES;11;11;9;1;1;0;1;9;0;0;3;2;4;2
12018.0;2022;22;LIMOGES;MASCULIN;SCOLAIRE;BAC PROFESSIONNEL;BAC PRO PROD;BAC PRO AG 21001 AGRO-EQUIPEMENT;16;15;11;4;0;0;0;11;0;0;1;7;3;4
12019.0;2022;22;LIMOGES;MASCULIN;SCOLAIRE;BAC PROFESSIONNEL;BAC PRO PROD;BAC PRO AG 21004 CGEA;67;67;59;8;0;0;0;59;0;1;10;23;25;8
12026.0;2022;22;LIMOGES;MASCULIN;SCOLAIRE;BAC PROFESSIONNEL;BAC PRO PROD;BAC PRO AG 22105 LABORATOIRE CONTROLE QUALITE;1;1;1;0;0;0;0;1;0;0;0;0;1;0
12029.0;2022;22;LIMOGES;MASCULIN;SCOLAIRE;BAC PROFESSIONNEL;BAC PRO SERV;BAC PRO 31107 CONDUCT. TRANSP.ROUT.MARCHANDISES;22;22;18;3;1;1;0;19;0;2;4;6;7;3
12037.0;2022;22;LIMOGES;MASCULIN;SCOLAIRE;BAC PROFESSIONNEL;BAC PRO SERV;BAC PRO 33002 SERVICES DE PROXIMITE  VIE LOCAL;11;11;11;0;0;0;0;11;0;1;1;6;3;0
12043.0;2022;22;LIMOGES;MASCULIN;SCOLAIRE;BAC PROFESSIONNEL;BAC PRO SERV;BAC PRO 34403 METIERS DE LA SECURITE;27;27;20;7;0;0;0;20;0;1;5;7;7;7
12050.0;2022;22;LIMOGES;MASCULIN;SCOLAIRE;BAC TECHNOLOGIQUE;BAC STI2D;BAC STI2D ENERGIES  ET ENVIRONNEMENT;48;48;34;2;12;3;9;37;0;3;6;11;17;11
12051.0;2022;22;LIMOGES;MASCULIN;SCOLAIRE;BAC TECHNOLOGIQUE;BAC STI2D;BAC STI2D INNOVATION TECHNO.  ET ECO CONCEPTION;53;53;35;3;15;8;7;43;0;2;3;14;24;10
12053.0;2022;22;LIMOGES;MASCULIN;SCOLAIRE;BAC TECHNOLOGIQUE;BAC STL;BAC STL BIOCHIM.-BIOLOGIE-BIOTECHNOL.;21;21;18;1;2;2;0;20;0;0;3;4;13;1
12066.0;2022;10;LYON;FEMININ;APPRENTISSAGE;BAC PROFESSIONNEL;BAC PRO PROD;BAC PRO 23405 TECHNICIEN MENUISIER AGENCEUR;1;1;1;0;0;0;0;1;0;1;0;0;0;0
12082.0;2022;10;LYON;FEMININ;APPRENTISSAGE;BAC PROFESSIONNEL;BAC PRO PROD;BAC PRO AG 21114 CONDUITE PRODUCTIONS HORTICOLES;1;1;1;0;0;0;0;1;0;0;0;0;1;0
12085.0;2022;10;LYON;FEMININ;APPRENTISSAGE;BAC PROFESSIONNEL;BAC PRO PROD;BAC PRO AG 21211 COND GEST ENTR HIPPIQUE;12;12;10;2;0;0;0;10;0;1;0;2;7;2
12090.0;2022;10;LYON;FEMININ;APPRENTISSAGE;BAC PROFESSIONNEL;BAC PRO SERV;BAC PRO 31106 LOGISTIQUE;5;5;5;0;0;0;0;5;0;0;1;1;3;0
12093.0;2022;10;LYON;FEMININ;APPRENTISSAGE;BAC PROFESSIONNEL;BAC PRO SERV;BAC PRO 31214 MET.COM.VEN.OP.B PR.CL.VA.OF.COM.;5;5;4;1;0;0;0;4;0;0;1;2;1;1
12103.0;2022;10;LYON;FEMININ;ENSEIGNEMENT A DISTANCE;BAC TECHNOLOGIQUE;BAC ST2S;BAC ST2S SCIENCES & TECHNO. SANTE & SOCIAL;7;7;7;0;0;0;0;7;0;0;2;2;3;0
12112.0;2022;10;LYON;FEMININ;INDIVIDUEL;BAC GENERAL;BAC GENERAL;BAC GENE 10019 BAC GENERAL;128;88;34;34;20;14;6;48;1;5;7;10;25;40
12116.0;2022;10;LYON;FEMININ;INDIVIDUEL;BAC PROFESSIONNEL;BAC PRO PROD;BAC PRO AG 21211 COND GEST ENTR HIPPIQUE;5;5;5;0;0;0;0;5;0;0;1;0;4;0
12120.0;2022;10;LYON;FEMININ;INDIVIDUEL;BAC PROFESSIONNEL;BAC PRO SERV;BAC PRO 31214 MET.COM.VEN.OP.B PR.CL.VA.OF.COM.;2;2;0;2;0;0;0;0;0;0;0;0;0;2
12122.0;2022;10;LYON;FEMININ;INDIVIDUEL;BAC PROFESSIONNEL;BAC PRO SERV;BAC PRO 33003 ACC.SOINS-S.PERS. OPT.A DOMICILE;2;1;0;1;0;0;0;0;0;0;0;0;0;1
12123.0;2022;10;LYON;FEMININ;INDIVIDUEL;BAC PROFESSIONNEL;BAC PRO SERV;BAC PRO 33004 ACC.SOINS-S.PERS. OPT.EN STRUCTUR;8;4;2;2;0;0;0;2;0;0;0;1;1;2
12134.0;2022;10;LYON;FEMININ;INDIVIDUEL;BAC TECHNOLOGIQUE;BAC STMG;BAC STMG RESSOURCES HUMAINES ET COMMUNICATION;8;6;1;3;2;1;1;2;0;0;1;0;1;4
12147.0;2022;10;LYON;FEMININ;SCOLAIRE;BAC PROFESSIONNEL;BAC PRO PROD;BAC PRO 23405 TECHNICIEN MENUISIER AGENCEUR;7;7;7;0;0;0;0;7;0;1;2;2;2;0
12151.0;2022;10;LYON;FEMININ;SCOLAIRE;BAC PROFESSIONNEL;BAC PRO PROD;BAC PRO 24202 ARTIS.& MET.ART : TAPIS.D'AMEUBL;11;11;8;3;0;0;0;8;0;0;2;1;5;3
12153.0;2022;10;LYON;FEMININ;SCOLAIRE;BAC PROFESSIONNEL;BAC PRO PROD;BAC PRO 24302 METIERS DU CUIR : MAROQUINERIE;8;8;3;5;0;0;0;3;0;0;0;2;1;5
12171.0;2022;10;LYON;FEMININ;SCOLAIRE;BAC PROFESSIONNEL;BAC PRO PROD;BAC PRO AG 21210 COND GEST ENTR CANIN ET FELIN;33;33;31;2;0;0;0;31;0;2;2;7;20;2
12181.0;2022;10;LYON;FEMININ;SCOLAIRE;BAC PROFESSIONNEL;BAC PRO SERV;BAC PRO 31107 CONDUCT. TRANSP.ROUT.MARCHANDISES;3;3;3;0;0;0;0;3;0;0;2;1;0;0
12185.0;2022;10;LYON;FEMININ;SCOLAIRE;BAC PROFESSIONNEL;BAC PRO SERV;BAC PRO 31214 MET.COM.VEN.OP.B PR.CL.VA.OF.COM.;156;156;139;11;6;4;2;143;0;7;32;66;38;13
12194.0;2022;10;LYON;FEMININ;SCOLAIRE;BAC PROFESSIONNEL;BAC PRO SERV;BAC PRO 33102 PROTHESE DENTAIRE;20;20;17;3;0;0;0;17;0;1;2;8;6;3
12195.0;2022;10;LYON;FEMININ;SCOLAIRE;BAC PROFESSIONNEL;BAC PRO SERV;BAC PRO 33403 COMMERC. SERVICES EN RESTAURATION;51;51;43;5;3;3;0;46;0;3;7;16;20;5
12200.0;2022;10;LYON;FEMININ;SCOLAIRE;BAC PROFESSIONNEL;BAC PRO SERV;BAC PRO AG 33002 SERV PERS TERRIT;348;336;286;50;0;0;0;286;0;1;22;112;151;50
12213.0;2022;10;LYON;FEMININ;SCOLAIRE;BAC TECHNOLOGIQUE;BAC STMG;BAC STMG GESTION ET FINANCE;455;455;399;19;37;20;17;419;0;13;80;155;171;36
12218.0;2022;10;LYON;MASCULIN;APPRENTISSAGE;BAC PROFESSIONNEL;BAC PRO PROD;BAC PRO 22003 BIO-INDUSTRIES DE TRANSFORMATION;2;2;2;0;0;0;0;2;0;0;0;1;1;0
12220.0;2022;10;LYON;MASCULIN;APPRENTISSAGE;BAC PROFESSIONNEL;BAC PRO PROD;BAC PRO 22105 BOULANGER-PÂTISSIER;8;8;8;0;0;0;0;8;0;0;2;6;0;0
12227.0;2022;10;LYON;MASCULIN;APPRENTISSAGE;BAC PROFESSIONNEL;BAC PRO PROD;BAC PRO 23102 TRAVAUX PUBLICS;24;24;21;3;0;0;0;21;0;1;6;12;2;3
12229.0;2022;10;LYON;MASCULIN;APPRENTISSAGE;BAC PROFESSIONNEL;BAC PRO PROD;BAC PRO 23203 TECHNICIEN BAT. : ORG.REAL.GROS O;18;18;15;1;2;2;0;17;0;2;4;5;6;1
12230.0;2022;10;LYON;MASCULIN;APPRENTISSAGE;BAC PROFESSIONNEL;BAC PRO PROD;BAC PRO 23205 INTERV. SUR PATRIMOINE BATI OPT.A;3;3;3;0;0;0;0;3;0;0;0;2;1;0
12232.0;2022;10;LYON;MASCULIN;APPRENTISSAGE;BAC PROFESSIONNEL;BAC PRO PROD;BAC PRO 23304 AMENAGEMENT FINITION BATIMENT;12;12;7;4;1;0;1;7;0;1;1;1;4;5
12238.0;2022;10;LYON;MASCULIN;APPRENTISSAGE;BAC PROFESSIONNEL;BAC PRO PROD;BAC PRO 24203 METIERS DE LA MODE - VÊTEMENT;1;1;0;1;0;0;0;0;0;0;0;0;0;1
12239.0;2022;10;LYON;MASCULIN;APPRENTISSAGE;BAC PROFESSIONNEL;BAC PRO PROD;BAC PRO 25006 MICROTECHNIQUES;1;1;1;0;0;0;0;1;0;0;0;0;1;0
12243.0;2022;10;LYON;MASCULIN;APPRENTISSAGE;BAC PROFESSIONNEL;BAC PRO PROD;BAC PRO 25214 MAINT.VEHIC.OPTA VOIT.PARTICUL.;156;155;123;27;5;3;2;126;0;8;25;47;46;29
12248.0;2022;10;LYON;MASCULIN;APPRENTISSAGE;BAC PROFESSIONNEL;BAC PRO PROD;BAC PRO 25221 MAINT.MATERIELS OPT.C ESP. VERTS;8;8;8;0;0;0;0;8;0;0;1;2;5;0
12257.0;2022;10;LYON;MASCULIN;APPRENTISSAGE;BAC PROFESSIONNEL;BAC PRO PROD;BAC PRO AG 21113 CGEVV;5;5;4;1;0;0;0;4;0;0;1;1;2;1
12259.0;2022;10;LYON;MASCULIN;APPRENTISSAGE;BAC PROFESSIONNEL;BAC PRO PROD;BAC PRO AG 21203 TECHN CONSEIL DE VENTE ANIMAL;1;1;1;0;0;0;0;1;0;0;0;1;0;0
12263.0;2022;10;LYON;MASCULIN;APPRENTISSAGE;BAC PROFESSIONNEL;BAC PRO PROD;BAC PRO AG 21212 TECH EXPE ANIMALE;4;4;3;1;0;0;0;3;0;0;0;2;1;1
12267.0;2022;10;LYON;MASCULIN;APPRENTISSAGE;BAC PROFESSIONNEL;BAC PRO SERV;BAC PRO 30001 GESTION-ADMINISTRATION;5;5;5;0;0;0;0;5;0;0;3;2;0;0
12280.0;2022;10;LYON;MASCULIN;ENSEIGNEMENT A DISTANCE;BAC TECHNOLOGIQUE;BAC STMG;BAC STMG MERCATIQUE (MARKETING);10;10;10;0;0;0;0;10;0;0;2;3;5;0
12286.0;2022;10;LYON;MASCULIN;FORMATION CONTINUE;BAC PROFESSIONNEL;BAC PRO PROD;BAC PRO 25510 METIERS ELECT. ENVIRON. CONNECTES;4;4;4;0;0;0;0;4;0;1;1;1;1;0
12305.0;2022;10;LYON;MASCULIN;INDIVIDUEL;BAC PROFESSIONNEL;BAC PRO PROD;BAC PRO AG 21211 COND GEST ENTR HIPPIQUE;3;2;2;0;0;0;0;2;0;1;0;1;0;0
12322.0;2022;10;LYON;MASCULIN;INDIVIDUEL;BAC TECHNOLOGIQUE;BAC STMG;BAC STMG GESTION ET FINANCE;11;4;0;3;1;0;1;0;0;0;0;0;0;4
12323.0;2022;10;LYON;MASCULIN;INDIVIDUEL;BAC TECHNOLOGIQUE;BAC STMG;BAC STMG MERCATIQUE (MARKETING);15;8;3;2;3;2;1;5;0;0;0;1;4;3
12330.0;2022;10;LYON;MASCULIN;SCOLAIRE;BAC PROFESSIONNEL;BAC PRO PROD;BAC PRO 22004 PROC. CHIMIE EAU PAPIERS-CARTONS;20;20;14;4;2;2;0;16;0;0;6;6;4;4
12331.0;2022;10;LYON;MASCULIN;SCOLAIRE;BAC PROFESSIONNEL;BAC PRO PROD;BAC PRO 22104 BOUCHER CHARCUTIER TRAITEUR;5;5;5;0;0;0;0;5;0;0;1;3;1;0
12334.0;2022;10;LYON;MASCULIN;SCOLAIRE;BAC PROFESSIONNEL;BAC PRO PROD;BAC PRO 22303 FONDERIE;10;10;8;1;1;1;0;9;0;0;2;1;6;1
12338.0;2022;10;LYON;MASCULIN;SCOLAIRE;BAC PROFESSIONNEL;BAC PRO PROD;BAC PRO 23003 ARTIS. & M.ART:MARCHANDISAGE VIS.;8;8;8;0;0;0;0;8;0;0;4;3;1;0
12345.0;2022;10;LYON;MASCULIN;SCOLAIRE;BAC PROFESSIONNEL;BAC PRO PROD;BAC PRO 23304 AMENAGEMENT FINITION BATIMENT;9;9;4;5;0;0;0;4;0;0;0;2;2;5
12353.0;2022;10;LYON;MASCULIN;SCOLAIRE;BAC PROFESSIONNEL;BAC PRO PROD;BAC PRO 25005 PRODUCTIQ.MECA. OPT.DECOLLETAGE;4;4;1;2;1;1;0;2;0;0;0;1;1;2
12354.0;2022;10;LYON;MASCULIN;SCOLAIRE;BAC PROFESSIONNEL;BAC PRO PROD;BAC PRO 25006 MICROTECHNIQUES;29;29;28;1;0;0;0;28;0;4;9;3;12;1
12360.0;2022;10;LYON;MASCULIN;SCOLAIRE;BAC PROFESSIONNEL;BAC PRO PROD;BAC PRO 25215 MAINT.VEHIC.OPTB VEHIC.TRANS.ROUT;21;21;14;6;1;1;0;15;0;1;3;5;6;6
12361.0;2022;10;LYON;MASCULIN;SCOLAIRE;BAC PROFESSIONNEL;BAC PRO PROD;BAC PRO 25216 MAINT.VEHIC.OPTC MOTOCYCLES;30;30;27;3;0;0;0;27;0;2;10;9;6;3
12362.0;2022;10;LYON;MASCULIN;SCOLAIRE;BAC PROFESSIONNEL;BAC PRO PROD;BAC PRO 25219 MAINT.MATERIELS OPT.A AGRICOLES;23;23;21;1;1;0;1;21;0;2;8;7;4;2
12365.0;2022;10;LYON;MASCULIN;SCOLAIRE;BAC PROFESSIONNEL;BAC PRO PROD;BAC PRO 25406 OUVRAGES DU BATIMENT METALLERIE;23;23;14;7;2;2;0;16;0;0;1;9;6;7
12366.0;2022;10;LYON;MASCULIN;SCOLAIRE;BAC PROFESSIONNEL;BAC PRO PROD;BAC PRO 25408 REPARATION DES CARROSSERIES;65;65;27;35;3;1;2;28;0;1;5;9;13;37
12371.0;2022;10;LYON;MASCULIN;SCOLAIRE;BAC PROFESSIONNEL;BAC PRO PROD;BAC PRO 25513 SYST.NUM.OPT.A SURETE SECURITE;25;25;21;3;1;0;1;21;0;2;3;10;6;4
12373.0;2022;10;LYON;MASCULIN;SCOLAIRE;BAC PROFESSIONNEL;BAC PRO PROD;BAC PRO 25515 SYST.NUM.OPT.C RES.INF.SYST.COMM.;319;319;271;45;3;3;0;274;0;22;65;97;90;45
12374.0;2022;10;LYON;MASCULIN;SCOLAIRE;BAC PROFESSIONNEL;BAC PRO PROD;BAC PRO AG 21001 AGRO-EQUIPEMENT;29;29;20;9;0;0;0;20;0;1;4;5;10;9
12383.0;2022;10;LYON;MASCULIN;SCOLAIRE;BAC PROFESSIONNEL;BAC PRO PROD;BAC PRO AG 21302 GEST MILIEUX NATURELS FAUNE;45;42;42;0;0;0;0;42;0;0;9;18;15;0
12384.0;2022;10;LYON;MASCULIN;SCOLAIRE;BAC PROFESSIONNEL;BAC PRO PROD;BAC PRO AG 21303 FORET;18;18;17;1;0;0;0;17;0;1;1;4;11;1
12395.0;2022;10;LYON;MASCULIN;SCOLAIRE;BAC PROFESSIONNEL;BAC PRO SERV;BAC PRO 31214 MET.COM.VEN.OP.B PR.CL.VA.OF.COM.;227;226;197;25;4;4;0;201;0;4;36;88;73;25
12397.0;2022;10;LYON;MASCULIN;SCOLAIRE;BAC PROFESSIONNEL;BAC PRO SERV;BAC PRO 32208 REAL.PR.IMPR.PLURI.OPTB.PR.IMPR.;15;15;15;0;0;0;0;15;0;1;1;6;7;0
12399.0;2022;10;LYON;MASCULIN;SCOLAIRE;BAC PROFESSIONNEL;BAC PRO SERV;BAC PRO 32304 PHOTOGRAPHIE;8;8;8;0;0;0;0;8;0;2;4;1;1;0
12402.0;2022;10;LYON;MASCULIN;SCOLAIRE;BAC PROFESSIONNEL;BAC PRO SERV;BAC PRO 33004 ACC.SOINS-S.PERS. OPT.EN STRUCTUR;42;42;38;4;0;0;0;38;0;1;7;19;11;4
12408.0;2022;10;LYON;MASCULIN;SCOLAIRE;BAC PROFESSIONNEL;BAC PRO SERV;BAC PRO 34403 METIERS DE LA SECURITE;67;67;66;1;0;0;0;66;0;4;16;36;10;1
12410.0;2022;10;LYON;MASCULIN;SCOLAIRE;BAC TECHNOLOGIQUE;BAC S2TMD;BAC S2TMD MUSIQUE;9;9;9;0;0;0;0;9;2;2;2;3;0;0
12413.0;2022;10;LYON;MASCULIN;SCOLAIRE;BAC TECHNOLOGIQUE;BAC STD2A;BAC STD2A SCIENCES & TECHNO. DESIGN-ARTS APPLIQUES;34;34;34;0;0;0;0;34;1;2;8;14;9;0
12416.0;2022;10;LYON;MASCULIN;SCOLAIRE;BAC TECHNOLOGIQUE;BAC STI2D;BAC STI2D ENERGIES  ET ENVIRONNEMENT;279;279;226;12;41;30;11;256;0;5;26;72;153;23
12420.0;2022;10;LYON;MASCULIN;SCOLAIRE;BAC TECHNOLOGIQUE;BAC STL;BAC STL SCIENCES PHYSIQUES CHIMIQUES  EN LABORAT.;76;76;68;2;6;4;2;72;0;2;18;22;30;4
12424.0;2022;10;LYON;MASCULIN;SCOLAIRE;BAC TECHNOLOGIQUE;BAC STMG;BAC STMG SYSTEMES D'INFORMATION DE GESTION;67;67;52;3;12;10;2;62;0;0;1;23;38;5
12435.0;2022;31;MARTINIQUE;FEMININ;INDIVIDUEL;BAC GENERAL;BAC GENERAL;BAC GENE 10019 BAC GENERAL;5;3;1;1;1;1;0;2;0;0;0;0;2;1
12436.0;2022;31;MARTINIQUE;FEMININ;INDIVIDUEL;BAC PROFESSIONNEL;BAC PRO SERV;BAC PRO 30001 GESTION-ADMINISTRATION;4;2;1;1;0;0;0;1;0;1;0;0;0;1
12438.0;2022;31;MARTINIQUE;FEMININ;INDIVIDUEL;BAC PROFESSIONNEL;BAC PRO SERV;BAC PRO 33003 ACC.SOINS-S.PERS. OPT.A DOMICILE;2;2;0;1;1;1;0;1;0;0;0;0;1;1
12447.0;2022;31;MARTINIQUE;FEMININ;SCOLAIRE;BAC PROFESSIONNEL;BAC PRO PROD;BAC PRO 22004 PROC. CHIMIE EAU PAPIERS-CARTONS;3;3;1;1;1;0;1;1;0;0;0;0;1;2
12451.0;2022;31;MARTINIQUE;FEMININ;SCOLAIRE;BAC PROFESSIONNEL;BAC PRO PROD;BAC PRO 23003 ARTIS. & M.ART:MARCHANDISAGE VIS.;10;10;9;1;0;0;0;9;0;0;2;5;2;1
12457.0;2022;31;MARTINIQUE;FEMININ;SCOLAIRE;BAC PROFESSIONNEL;BAC PRO PROD;BAC PRO 25219 MAINT.MATERIELS OPT.A AGRICOLES;1;1;1;0;0;0;0;1;0;0;0;0;1;0
12460.0;2022;31;MARTINIQUE;FEMININ;SCOLAIRE;BAC PROFESSIONNEL;BAC PRO PROD;BAC PRO 25408 REPARATION DES CARROSSERIES;1;1;1;0;0;0;0;1;0;0;0;1;0;0
12462.0;2022;31;MARTINIQUE;FEMININ;SCOLAIRE;BAC PROFESSIONNEL;BAC PRO PROD;BAC PRO 25510 METIERS ELECT. ENVIRON. CONNECTES;7;7;4;3;0;0;0;4;0;1;1;0;2;3
12464.0;2022;31;MARTINIQUE;FEMININ;SCOLAIRE;BAC PROFESSIONNEL;BAC PRO PROD;BAC PRO AG 21004 CGEA;7;7;7;0;0;0;0;7;0;0;1;4;2;0
12466.0;2022;31;MARTINIQUE;FEMININ;SCOLAIRE;BAC PROFESSIONNEL;BAC PRO PROD;BAC PRO AG 21405 AMENAGEMENTS PAYSAGERS;1;1;1;0;0;0;0;1;0;0;0;1;0;0
12478.0;2022;31;MARTINIQUE;FEMININ;SCOLAIRE;BAC PROFESSIONNEL;BAC PRO SERV;BAC PRO 33603 ESTHETIQUE COSMETIQUE PARFUMERIE;23;22;17;5;0;0;0;17;0;0;2;6;9;5
12482.0;2022;31;MARTINIQUE;FEMININ;SCOLAIRE;BAC TECHNOLOGIQUE;BAC ST2S;BAC ST2S SCIENCES & TECHNO. SANTE & SOCIAL;170;170;137;9;24;20;4;157;0;3;22;46;86;13
12487.0;2022;31;MARTINIQUE;FEMININ;SCOLAIRE;BAC TECHNOLOGIQUE;BAC STI2D;BAC STI2D ENERGIES  ET ENVIRONNEMENT;2;2;1;1;0;0;0;1;0;0;0;1;0;1
12490.0;2022;31;MARTINIQUE;FEMININ;SCOLAIRE;BAC TECHNOLOGIQUE;BAC STL;BAC STL BIOCHIM.-BIOLOGIE-BIOTECHNOL.;17;17;14;1;2;2;0;16;0;1;3;3;9;1
12497.0;2022;31;MARTINIQUE;MASCULIN;APPRENTISSAGE;BAC PROFESSIONNEL;BAC PRO PROD;BAC PRO 22703 TECHN.INSTALL.SYST.ENERG.CLIMATI;2;2;1;1;0;0;0;1;0;0;0;0;1;1
12504.0;2022;31;MARTINIQUE;MASCULIN;APPRENTISSAGE;BAC PROFESSIONNEL;BAC PRO PROD;BAC PRO 25214 MAINT.VEHIC.OPTA VOIT.PARTICUL.;21;16;11;3;2;2;0;13;0;0;1;4;8;3
12506.0;2022;31;MARTINIQUE;MASCULIN;APPRENTISSAGE;BAC PROFESSIONNEL;BAC PRO PROD;BAC PRO 25510 METIERS ELECT. ENVIRON. CONNECTES;14;12;11;0;1;1;0;12;0;0;0;7;5;0
12512.0;2022;31;MARTINIQUE;MASCULIN;FORMATION CONTINUE;BAC PROFESSIONNEL;BAC PRO PROD;BAC PRO 22105 BOULANGER-PÂTISSIER;1;1;1;0;0;0;0;1;0;0;0;1;0;0
12515.0;2022;31;MARTINIQUE;MASCULIN;INDIVIDUEL;BAC GENERAL;BAC GENERAL;BAC GENE 10019 BAC GENERAL;5;2;0;0;2;2;0;2;0;0;0;0;2;0
12521.0;2022;31;MARTINIQUE;MASCULIN;INDIVIDUEL;BAC PROFESSIONNEL;BAC PRO PROD;BAC PRO 25214 MAINT.VEHIC.OPTA VOIT.PARTICUL.;3;2;1;1;0;0;0;1;0;0;1;0;0;1
12523.0;2022;31;MARTINIQUE;MASCULIN;INDIVIDUEL;BAC PROFESSIONNEL;BAC PRO PROD;BAC PRO AG 21001 AGRO-EQUIPEMENT;1;1;1;0;0;0;0;1;0;0;0;0;1;0
12530.0;2022;31;MARTINIQUE;MASCULIN;SCOLAIRE;BAC PROFESSIONNEL;BAC PRO PROD;BAC PRO 22003 BIO-INDUSTRIES DE TRANSFORMATION;8;8;6;2;0;0;0;6;0;0;1;2;3;2
12537.0;2022;31;MARTINIQUE;MASCULIN;SCOLAIRE;BAC PROFESSIONNEL;BAC PRO PROD;BAC PRO 23005 TECHN. ETUDES BAT B ASSIST.ARCHI.;21;21;15;6;0;0;0;15;0;0;1;4;10;6
12540.0;2022;31;MARTINIQUE;MASCULIN;SCOLAIRE;BAC PROFESSIONNEL;BAC PRO PROD;BAC PRO 23203 TECHNICIEN BAT. : ORG.REAL.GROS O;5;5;5;0;0;0;0;5;0;0;1;2;2;0
12542.0;2022;31;MARTINIQUE;MASCULIN;SCOLAIRE;BAC PROFESSIONNEL;BAC PRO PROD;BAC PRO 23304 AMENAGEMENT FINITION BATIMENT;6;6;6;0;0;0;0;6;0;0;1;2;3;0
12543.0;2022;31;MARTINIQUE;MASCULIN;SCOLAIRE;BAC PROFESSIONNEL;BAC PRO PROD;BAC PRO 23404 TECHNICIEN CONSTRUCTEUR BOIS;9;8;5;2;1;1;0;6;0;0;1;1;4;2
12548.0;2022;31;MARTINIQUE;MASCULIN;SCOLAIRE;BAC PROFESSIONNEL;BAC PRO PROD;BAC PRO 25009 MAINTENANCE NAUTIQUE;25;25;15;6;4;2;2;17;0;0;1;4;12;8
12549.0;2022;31;MARTINIQUE;MASCULIN;SCOLAIRE;BAC PROFESSIONNEL;BAC PRO PROD;BAC PRO 25106 TECHNICIEN D'USINAGE;18;18;11;3;4;3;1;14;0;0;2;2;10;4
12554.0;2022;31;MARTINIQUE;MASCULIN;SCOLAIRE;BAC PROFESSIONNEL;BAC PRO PROD;BAC PRO 25408 REPARATION DES CARROSSERIES;20;20;15;3;2;1;1;16;0;0;1;9;6;4
12559.0;2022;31;MARTINIQUE;MASCULIN;SCOLAIRE;BAC PROFESSIONNEL;BAC PRO PROD;BAC PRO 25514 SYST.NUM.OPT.B AUD.RES.EQUIP.DOM.;23;23;21;1;1;1;0;22;0;0;2;9;11;1
12562.0;2022;31;MARTINIQUE;MASCULIN;SCOLAIRE;BAC PROFESSIONNEL;BAC PRO PROD;BAC PRO AG 21004 CGEA;12;12;12;0;0;0;0;12;0;0;2;2;8;0
12591.0;2022;31;MARTINIQUE;MASCULIN;SCOLAIRE;BAC TECHNOLOGIQUE;BAC STMG;BAC STMG MERCATIQUE (MARKETING);85;85;68;3;14;13;1;81;0;1;6;24;50;4
12593.0;2022;31;MARTINIQUE;MASCULIN;SCOLAIRE;BAC TECHNOLOGIQUE;BAC STMG;BAC STMG SYSTEMES D'INFORMATION DE GESTION;22;22;11;4;7;4;3;15;0;0;1;2;12;7
12600.0;2022;43;MAYOTTE;FEMININ;INDIVIDUEL;BAC PROFESSIONNEL;BAC PRO SERV;BAC PRO 30001 GESTION-ADMINISTRATION;6;5;1;4;0;0;0;1;0;0;0;0;1;4
12607.0;2022;43;MAYOTTE;FEMININ;INDIVIDUEL;BAC TECHNOLOGIQUE;BAC STMG;BAC STMG RESSOURCES HUMAINES ET COMMUNICATION;10;5;0;4;1;0;1;0;0;0;0;0;0;5
12612.0;2022;43;MAYOTTE;FEMININ;SCOLAIRE;BAC PROFESSIONNEL;BAC PRO PROD;BACPRO 23103 TECHNICIEN GEOMETRE-TOPOGRAPHE;2;2;1;1;0;0;0;1;0;0;0;0;1;1
12614.0;2022;43;MAYOTTE;FEMININ;SCOLAIRE;BAC PROFESSIONNEL;BAC PRO PROD;BAC PRO 25007 MAINTENANCE EQUIPEMENTS INDUST.;2;2;2;0;0;0;0;2;0;0;1;0;1;0
12615.0;2022;43;MAYOTTE;FEMININ;SCOLAIRE;BAC PROFESSIONNEL;BAC PRO PROD;BAC PRO 25214 MAINT.VEHIC.OPTA VOIT.PARTICUL.;1;1;0;1;0;0;0;0;0;0;0;0;0;1
12616.0;2022;43;MAYOTTE;FEMININ;SCOLAIRE;BAC PROFESSIONNEL;BAC PRO PROD;BAC PRO 25514 SYST.NUM.OPT.B AUD.RES.EQUIP.DOM.;2;2;2;0;0;0;0;2;0;0;0;1;1;0
12619.0;2022;43;MAYOTTE;FEMININ;SCOLAIRE;BAC PROFESSIONNEL;BAC PRO PROD;BAC PRO AG 21114 CONDUITE PRODUCTIONS HORTICOLES;2;2;2;0;0;0;0;2;0;0;0;2;0;0
12622.0;2022;43;MAYOTTE;FEMININ;SCOLAIRE;BAC PROFESSIONNEL;BAC PRO SERV;BAC PRO 31108 TRANSPORT;31;31;12;10;9;6;3;18;0;0;0;4;14;13
12623.0;2022;43;MAYOTTE;FEMININ;SCOLAIRE;BAC PROFESSIONNEL;BAC PRO SERV;BAC PRO 31212 METIERS DE L'ACCUEIL;77;77;55;7;15;10;5;65;0;0;6;20;39;12
12624.0;2022;43;MAYOTTE;FEMININ;SCOLAIRE;BAC PROFESSIONNEL;BAC PRO SERV;BAC PRO 31213 MET.COM.VEN.OP.A ANI.GES.ESP.COM.;97;97;41;35;21;17;4;58;0;0;4;8;46;39
12625.0;2022;43;MAYOTTE;FEMININ;SCOLAIRE;BAC PROFESSIONNEL;BAC PRO SERV;BAC PRO 31214 MET.COM.VEN.OP.B PR.CL.VA.OF.COM.;45;45;21;17;7;4;3;25;0;1;3;4;17;20
12632.0;2022;43;MAYOTTE;FEMININ;SCOLAIRE;BAC PROFESSIONNEL;BAC PRO SERV;BAC PRO AG 33002 SERV PERS TERRIT;23;22;21;1;0;0;0;21;0;0;0;5;16;1
12637.0;2022;43;MAYOTTE;FEMININ;SCOLAIRE;BAC TECHNOLOGIQUE;BAC STI2D;BAC STI2D ENERGIES  ET ENVIRONNEMENT;23;23;2;10;11;11;0;13;0;0;0;0;13;10
12639.0;2022;43;MAYOTTE;FEMININ;SCOLAIRE;BAC TECHNOLOGIQUE;BAC STI2D;BAC STI2D SYSTÈME D'INFORMATION  ET NUMERIQUE;25;25;3;9;13;13;0;16;0;0;0;0;16;9
12642.0;2022;43;MAYOTTE;FEMININ;SCOLAIRE;BAC TECHNOLOGIQUE;BAC STMG;BAC STMG MERCATIQUE (MARKETING);216;216;75;69;72;64;8;139;0;0;4;17;118;77
12645.0;2022;43;MAYOTTE;MASCULIN;APPRENTISSAGE;BAC PROFESSIONNEL;BAC PRO PROD;BAC PRO 25303 AERONAUTIQUE OPTION SYSTEMES;3;3;3;0;0;0;0;3;0;2;0;0;1;0
12646.0;2022;43;MAYOTTE;MASCULIN;APPRENTISSAGE;BAC PROFESSIONNEL;BAC PRO SERV;BAC PRO 31106 LOGISTIQUE;15;15;7;5;3;2;1;9;0;0;1;3;5;6
12648.0;2022;43;MAYOTTE;MASCULIN;INDIVIDUEL;BAC GENERAL;BAC GENERAL;BAC GENE 10019 BAC GENERAL;31;18;2;13;3;3;0;5;0;0;0;1;4;13
12654.0;2022;43;MAYOTTE;MASCULIN;INDIVIDUEL;BAC PROFESSIONNEL;BAC PRO PROD;BAC PRO 25510 METIERS ELECT. ENVIRON. CONNECTES;4;4;4;0;0;0;0;4;0;0;1;0;3;0
12658.0;2022;43;MAYOTTE;MASCULIN;INDIVIDUEL;BAC PROFESSIONNEL;BAC PRO SERV;BAC PRO 31106 LOGISTIQUE;1;1;0;0;1;0;1;0;0;0;0;0;0;1
12660.0;2022;43;MAYOTTE;MASCULIN;INDIVIDUEL;BAC TECHNOLOGIQUE;BAC ST2S;BAC ST2S SCIENCES & TECHNO. SANTE & SOCIAL;1;1;0;1;0;0;0;0;0;0;0;0;0;1
12661.0;2022;43;MAYOTTE;MASCULIN;INDIVIDUEL;BAC TECHNOLOGIQUE;BAC STMG;BAC STMG GESTION ET FINANCE;9;7;2;4;1;1;0;3;0;0;0;1;2;4
12664.0;2022;43;MAYOTTE;MASCULIN;SCOLAIRE;BAC GENERAL;BAC GENERAL;BAC GENE 10019 BAC GENERAL;757;757;422;129;206;136;70;558;1;20;53;141;343;199
12665.0;2022;43;MAYOTTE;MASCULIN;SCOLAIRE;BAC PROFESSIONNEL;BAC PRO PROD;BAC PRO 22003 BIO-INDUSTRIES DE TRANSFORMATION;3;3;1;2;0;0;0;1;0;0;0;0;1;2
12677.0;2022;43;MAYOTTE;MASCULIN;SCOLAIRE;BAC PROFESSIONNEL;BAC PRO PROD;BAC PRO 25009 MAINTENANCE NAUTIQUE;27;26;10;12;4;3;1;13;0;0;0;3;10;13
12683.0;2022;43;MAYOTTE;MASCULIN;SCOLAIRE;BAC PROFESSIONNEL;BAC PRO PROD;BAC PRO 25510 METIERS ELECT. ENVIRON. CONNECTES;102;102;87;11;4;4;0;91;0;3;16;33;39;11
12684.0;2022;43;MAYOTTE;MASCULIN;SCOLAIRE;BAC PROFESSIONNEL;BAC PRO PROD;BAC PRO 25513 SYST.NUM.OPT.A SURETE SECURITE;18;18;10;5;3;3;0;13;0;0;1;3;9;5
12691.0;2022;43;MAYOTTE;MASCULIN;SCOLAIRE;BAC PROFESSIONNEL;BAC PRO SERV;BAC PRO 31108 TRANSPORT;85;85;45;21;19;14;5;59;0;1;0;14;44;26
12696.0;2022;43;MAYOTTE;MASCULIN;SCOLAIRE;BAC PROFESSIONNEL;BAC PRO SERV;BAC PRO 33002 SERVICES DE PROXIMITE  VIE LOCAL;28;28;13;13;2;2;0;15;0;0;2;3;10;13
12706.0;2022;43;MAYOTTE;MASCULIN;SCOLAIRE;BAC TECHNOLOGIQUE;BAC STI2D;BAC STI2D ENERGIES  ET ENVIRONNEMENT;36;36;14;11;11;9;2;23;0;0;1;0;22;13
12709.0;2022;43;MAYOTTE;MASCULIN;SCOLAIRE;BAC TECHNOLOGIQUE;BAC STL;BAC STL SCIENCES PHYSIQUES CHIMIQUES  EN LABORAT.;28;28;12;5;11;8;3;20;1;0;2;1;16;8
12718.0;2022;11;MONTPELLIER;FEMININ;APPRENTISSAGE;BAC PROFESSIONNEL;BAC PRO PROD;BAC PRO 25106 TECHNICIEN D'USINAGE;1;1;1;0;0;0;0;1;0;0;1;0;0;0
12725.0;2022;11;MONTPELLIER;FEMININ;APPRENTISSAGE;BAC PROFESSIONNEL;BAC PRO PROD;BAC PRO AG 21113 CGEVV;1;1;1;0;0;0;0;1;0;0;0;0;1;0
12727.0;2022;11;MONTPELLIER;FEMININ;APPRENTISSAGE;BAC PROFESSIONNEL;BAC PRO PROD;BAC PRO AG 21203 TECHN CONSEIL DE VENTE ANIMAL;1;1;1;0;0;0;0;1;0;0;0;0;1;0
12728.0;2022;11;MONTPELLIER;FEMININ;APPRENTISSAGE;BAC PROFESSIONNEL;BAC PRO PROD;BAC PRO AG 21211 COND GEST ENTR HIPPIQUE;13;13;10;3;0;0;0;10;0;0;0;1;9;3
12729.0;2022;11;MONTPELLIER;FEMININ;APPRENTISSAGE;BAC PROFESSIONNEL;BAC PRO PROD;BAC PRO AG 21303 FORET;1;1;1;0;0;0;0;1;0;0;0;0;1;0
12733.0;2022;11;MONTPELLIER;FEMININ;APPRENTISSAGE;BAC PROFESSIONNEL;BAC PRO SERV;BAC PRO 31213 MET.COM.VEN.OP.A ANI.GES.ESP.COM.;38;38;29;7;2;1;1;30;0;2;5;14;9;8
12735.0;2022;11;MONTPELLIER;FEMININ;APPRENTISSAGE;BAC PROFESSIONNEL;BAC PRO SERV;BAC PRO 33004 ACC.SOINS-S.PERS. OPT.EN STRUCTUR;1;1;1;0;0;0;0;1;0;0;0;0;1;0
12736.0;2022;11;MONTPELLIER;FEMININ;APPRENTISSAGE;BAC PROFESSIONNEL;BAC PRO SERV;BAC PRO 33101 OPTIQUE LUNETTERIE;13;13;12;1;0;0;0;12;0;2;3;6;1;1
12739.0;2022;11;MONTPELLIER;FEMININ;APPRENTISSAGE;BAC PROFESSIONNEL;BAC PRO SERV;BAC PRO 33603 ESTHETIQUE COSMETIQUE PARFUMERIE;4;4;3;1;0;0;0;3;0;0;0;1;2;1
12743.0;2022;11;MONTPELLIER;FEMININ;ENSEIGNEMENT A DISTANCE;BAC PROFESSIONNEL;BAC PRO SERV;BAC PRO 33003 ACC.SOINS-S.PERS. OPT.A DOMICILE;1;0;0;0;0;0;0;0;0;0;0;0;0;0
12751.0;2022;11;MONTPELLIER;FEMININ;FORMATION CONTINUE;BAC PROFESSIONNEL;BAC PRO PROD;BAC PRO 25510 METIERS ELECT. ENVIRON. CONNECTES;1;1;1;0;0;0;0;1;0;1;0;0;0;0
12758.0;2022;11;MONTPELLIER;FEMININ;INDIVIDUEL;BAC PROFESSIONNEL;BAC PRO PROD;BAC PRO AG 21004 CGEA;3;3;3;0;0;0;0;3;0;0;0;0;3;0
12761.0;2022;11;MONTPELLIER;FEMININ;INDIVIDUEL;BAC PROFESSIONNEL;BAC PRO PROD;BAC PRO AG 21211 COND GEST ENTR HIPPIQUE;8;7;5;2;0;0;0;5;0;0;0;1;4;2
12762.0;2022;11;MONTPELLIER;FEMININ;INDIVIDUEL;BAC PROFESSIONNEL;BAC PRO SERV;BAC PRO 30001 GESTION-ADMINISTRATION;7;2;0;1;1;0;1;0;0;0;0;0;0;2
12768.0;2022;11;MONTPELLIER;FEMININ;INDIVIDUEL;BAC PROFESSIONNEL;BAC PRO SERV;BAC PRO 33004 ACC.SOINS-S.PERS. OPT.EN STRUCTUR;2;1;0;1;0;0;0;0;0;0;0;0;0;1
12771.0;2022;11;MONTPELLIER;FEMININ;INDIVIDUEL;BAC TECHNOLOGIQUE;BAC STD2A;BAC STD2A SCIENCES & TECHNO. DESIGN-ARTS APPLIQUES;1;1;1;0;0;0;0;1;0;0;0;1;0;0
12777.0;2022;11;MONTPELLIER;FEMININ;INDIVIDUEL;BAC TECHNOLOGIQUE;BAC STMG;BAC STMG RESSOURCES HUMAINES ET COMMUNICATION;7;6;0;3;3;1;2;1;0;0;0;0;1;5
12778.0;2022;11;MONTPELLIER;FEMININ;INDIVIDUEL;BAC TECHNOLOGIQUE;BAC STMG;BAC STMG SYSTEMES D'INFORMATION DE GESTION;1;0;0;0;0;0;0;0;0;0;0;0;0;0
12783.0;2022;11;MONTPELLIER;FEMININ;SCOLAIRE;BAC PROFESSIONNEL;BAC PRO PROD;BAC PRO 22106 CUISINE;55;55;51;1;3;1;2;52;0;3;14;23;12;3
12786.0;2022;11;MONTPELLIER;FEMININ;SCOLAIRE;BAC PROFESSIONNEL;BAC PRO PROD;BAC PRO 23003 ARTIS. & M.ART:MARCHANDISAGE VIS.;10;10;10;0;0;0;0;10;0;4;2;3;1;0
12787.0;2022;11;MONTPELLIER;FEMININ;SCOLAIRE;BAC PROFESSIONNEL;BAC PRO PROD;BAC PRO 23004 TECHN. ETUDES BAT.A ETUDES & ECO.;16;16;12;4;0;0;0;12;0;0;2;7;3;4
12790.0;2022;11;MONTPELLIER;FEMININ;SCOLAIRE;BAC PROFESSIONNEL;BAC PRO PROD;BAC PRO 23303 MENUISERIE ALUMINIUM-VERRE;1;1;0;1;0;0;0;0;0;0;0;0;0;1
12792.0;2022;11;MONTPELLIER;FEMININ;SCOLAIRE;BAC PROFESSIONNEL;BAC PRO PROD;BAC PRO 23404 TECHNICIEN CONSTRUCTEUR BOIS;2;2;0;2;0;0;0;0;0;0;0;0;0;2
12794.0;2022;11;MONTPELLIER;FEMININ;SCOLAIRE;BAC PROFESSIONNEL;BAC PRO PROD;BAC PRO 23408 Etude et réalisation d'agencement;7;7;5;2;0;0;0;5;0;0;0;2;3;2
12796.0;2022;11;MONTPELLIER;FEMININ;SCOLAIRE;BAC PROFESSIONNEL;BAC PRO PROD;BAC PRO 24203 METIERS DE LA MODE - VÊTEMENT;103;103;76;20;7;3;4;79;0;11;16;24;28;24
12799.0;2022;11;MONTPELLIER;FEMININ;SCOLAIRE;BAC PROFESSIONNEL;BAC PRO PROD;BAC PRO 25007 MAINTENANCE EQUIPEMENTS INDUST.;1;1;1;0;0;0;0;1;0;0;0;1;0;0
12802.0;2022;11;MONTPELLIER;FEMININ;SCOLAIRE;BAC PROFESSIONNEL;BAC PRO PROD;BAC PRO 25215 MAINT.VEHIC.OPTB VEHIC.TRANS.ROUT;2;2;1;1;0;0;0;1;0;0;0;1;0;1
12806.0;2022;11;MONTPELLIER;FEMININ;SCOLAIRE;BAC PROFESSIONNEL;BAC PRO PROD;BAC PRO 25408 REPARATION DES CARROSSERIES;1;1;1;0;0;0;0;1;0;0;0;1;0;0
12810.0;2022;11;MONTPELLIER;FEMININ;SCOLAIRE;BAC PROFESSIONNEL;BAC PRO PROD;BAC PRO 25515 SYST.NUM.OPT.C RES.INF.SYST.COMM.;5;5;4;1;0;0;0;4;0;0;1;2;1;1
12818.0;2022;11;MONTPELLIER;FEMININ;SCOLAIRE;BAC PROFESSIONNEL;BAC PRO PROD;BAC PRO AG 21405 AMENAGEMENTS PAYSAGERS;11;11;9;2;0;0;0;9;0;0;0;6;3;2
12825.0;2022;11;MONTPELLIER;FEMININ;SCOLAIRE;BAC PROFESSIONNEL;BAC PRO SERV;BAC PRO 31108 TRANSPORT;6;6;6;0;0;0;0;6;0;0;4;1;1;0
12831.0;2022;11;MONTPELLIER;FEMININ;SCOLAIRE;BAC PROFESSIONNEL;BAC PRO SERV;BAC PRO 32303 ART.& MET.ART:COM.VIS.VIS.PLURI-M;57;55;48;6;1;1;0;49;0;2;10;20;17;6
12832.0;2022;11;MONTPELLIER;FEMININ;SCOLAIRE;BAC PROFESSIONNEL;BAC PRO SERV;BAC PRO 32304 PHOTOGRAPHIE;8;8;8;0;0;0;0;8;0;1;1;5;1;0
12840.0;2022;11;MONTPELLIER;FEMININ;SCOLAIRE;BAC PROFESSIONNEL;BAC PRO SERV;BAC PRO 34304 HYGIENE PROPRETE STERILISATION;6;6;5;1;0;0;0;5;0;0;1;3;1;1
12849.0;2022;11;MONTPELLIER;FEMININ;SCOLAIRE;BAC TECHNOLOGIQUE;BAC STI2D;BAC STI2D ARCHITECTURE ET CONSTRUCTION;64;64;49;3;12;6;6;55;0;4;8;15;28;9
12852.0;2022;11;MONTPELLIER;FEMININ;SCOLAIRE;BAC TECHNOLOGIQUE;BAC STI2D;BAC STI2D SYSTÈME D'INFORMATION  ET NUMERIQUE;8;8;5;1;2;1;1;6;0;0;1;2;3;2
12853.0;2022;11;MONTPELLIER;FEMININ;SCOLAIRE;BAC TECHNOLOGIQUE;BAC STL;BAC STL BIOCHIM.-BIOLOGIE-BIOTECHNOL.;101;101;91;1;9;5;4;96;0;3;26;34;33;5
12855.0;2022;11;MONTPELLIER;FEMININ;SCOLAIRE;BAC TECHNOLOGIQUE;BAC STMG;BAC STMG GESTION ET FINANCE;286;286;244;10;32;20;12;264;0;10;63;96;95;22
12857.0;2022;11;MONTPELLIER;FEMININ;SCOLAIRE;BAC TECHNOLOGIQUE;BAC STMG;BAC STMG RESSOURCES HUMAINES ET COMMUNICATION;639;639;512;23;104;66;38;578;0;13;68;188;309;61
12863.0;2022;11;MONTPELLIER;MASCULIN;APPRENTISSAGE;BAC PROFESSIONNEL;BAC PRO PROD;BAC PRO 22703 TECHN.INSTALL.SYST.ENERG.CLIMATI;24;22;16;4;2;1;1;17;0;2;4;6;5;5
12864.0;2022;11;MONTPELLIER;MASCULIN;APPRENTISSAGE;BAC PROFESSIONNEL;BAC PRO PROD;BAC PRO 22704 TECHN. MAINT. SYST.ENERG.CLIMATI;1;1;1;0;0;0;0;1;0;0;0;1;0;0
12865.0;2022;11;MONTPELLIER;MASCULIN;APPRENTISSAGE;BAC PROFESSIONNEL;BAC PRO PROD;BAC PRO 23004 TECHN. ETUDES BAT.A ETUDES & ECO.;1;1;0;1;0;0;0;0;0;0;0;0;0;1
12867.0;2022;11;MONTPELLIER;MASCULIN;APPRENTISSAGE;BAC PROFESSIONNEL;BAC PRO PROD;BAC PRO 23102 TRAVAUX PUBLICS;25;25;23;2;0;0;0;23;0;2;10;5;6;2
12872.0;2022;11;MONTPELLIER;MASCULIN;APPRENTISSAGE;BAC PROFESSIONNEL;BAC PRO PROD;BAC PRO 25007 MAINTENANCE EQUIPEMENTS INDUST.;19;17;13;4;0;0;0;13;0;0;2;5;6;4
12882.0;2022;11;MONTPELLIER;MASCULIN;APPRENTISSAGE;BAC PROFESSIONNEL;BAC PRO PROD;BAC PRO 25408 REPARATION DES CARROSSERIES;41;40;30;10;0;0;0;30;0;0;5;11;14;10
12888.0;2022;11;MONTPELLIER;MASCULIN;APPRENTISSAGE;BAC PROFESSIONNEL;BAC PRO PROD;BAC PRO AG 21114 CONDUITE PRODUCTIONS HORTICOLES;1;1;1;0;0;0;0;1;0;0;0;0;1;0
12890.0;2022;11;MONTPELLIER;MASCULIN;APPRENTISSAGE;BAC PROFESSIONNEL;BAC PRO PROD;BAC PRO AG 21303 FORET;4;4;4;0;0;0;0;4;0;0;0;3;1;0
12895.0;2022;11;MONTPELLIER;MASCULIN;APPRENTISSAGE;BAC PROFESSIONNEL;BAC PRO SERV;BAC PRO 31213 MET.COM.VEN.OP.A ANI.GES.ESP.COM.;34;33;24;7;2;1;1;25;0;1;3;7;14;8
12902.0;2022;11;MONTPELLIER;MASCULIN;ENSEIGNEMENT A DISTANCE;BAC PROFESSIONNEL;BAC PRO SERV;BAC PRO 30001 GESTION-ADMINISTRATION;1;1;1;0;0;0;0;1;0;0;0;0;1;0
12903.0;2022;11;MONTPELLIER;MASCULIN;ENSEIGNEMENT A DISTANCE;BAC PROFESSIONNEL;BAC PRO SERV;BAC PRO 31213 MET.COM.VEN.OP.A ANI.GES.ESP.COM.;1;1;0;1;0;0;0;0;0;0;0;0;0;1
12908.0;2022;11;MONTPELLIER;MASCULIN;ENSEIGNEMENT A DISTANCE;BAC TECHNOLOGIQUE;BAC STMG;BAC STMG RESSOURCES HUMAINES ET COMMUNICATION;1;1;0;1;0;0;0;0;0;0;0;0;0;1
12910.0;2022;11;MONTPELLIER;MASCULIN;FORMATION CONTINUE;BAC PROFESSIONNEL;BAC PRO PROD;BAC PRO 22106 CUISINE;1;1;0;1;0;0;0;0;0;0;0;0;0;1
12913.0;2022;11;MONTPELLIER;MASCULIN;FORMATION CONTINUE;BAC PROFESSIONNEL;BAC PRO PROD;BAC PRO 25214 MAINT.VEHIC.OPTA VOIT.PARTICUL.;5;5;4;1;0;0;0;4;0;1;3;0;0;1
12914.0;2022;11;MONTPELLIER;MASCULIN;FORMATION CONTINUE;BAC PROFESSIONNEL;BAC PRO PROD;BAC PRO 25215 MAINT.VEHIC.OPTB VEHIC.TRANS.ROUT;1;1;1;0;0;0;0;1;0;1;0;0;0;0
12917.0;2022;11;MONTPELLIER;MASCULIN;FORMATION CONTINUE;BAC PROFESSIONNEL;BAC PRO PROD;BAC PRO AG 21405 AMENAGEMENTS PAYSAGERS;1;1;1;0;0;0;0;1;0;0;0;0;1;0
12919.0;2022;11;MONTPELLIER;MASCULIN;INDIVIDUEL;BAC GENERAL;BAC GENERAL;BAC GENE 10019 BAC GENERAL;152;118;85;21;12;7;5;92;1;6;18;29;38;26
12923.0;2022;11;MONTPELLIER;MASCULIN;INDIVIDUEL;BAC PROFESSIONNEL;BAC PRO PROD;BAC PRO 25007 MAINTENANCE EQUIPEMENTS INDUST.;1;1;0;1;0;0;0;0;0;0;0;0;0;1
12925.0;2022;11;MONTPELLIER;MASCULIN;INDIVIDUEL;BAC PROFESSIONNEL;BAC PRO PROD;BAC PRO 25214 MAINT.VEHIC.OPTA VOIT.PARTICUL.;5;4;2;2;0;0;0;2;0;0;2;0;0;2
12926.0;2022;11;MONTPELLIER;MASCULIN;INDIVIDUEL;BAC PROFESSIONNEL;BAC PRO PROD;BAC PRO 25510 METIERS ELECT. ENVIRON. CONNECTES;3;1;0;1;0;0;0;0;0;0;0;0;0;1
12935.0;2022;11;MONTPELLIER;MASCULIN;INDIVIDUEL;BAC PROFESSIONNEL;BAC PRO SERV;BAC PRO 33403 COMMERC. SERVICES EN RESTAURATION;1;0;0;0;0;0;0;0;0;0;0;0;0;0
12943.0;2022;11;MONTPELLIER;MASCULIN;INDIVIDUEL;BAC TECHNOLOGIQUE;BAC STMG;BAC STMG GESTION ET FINANCE;15;12;9;3;0;0;0;9;0;0;3;4;2;3
12944.0;2022;11;MONTPELLIER;MASCULIN;INDIVIDUEL;BAC TECHNOLOGIQUE;BAC STMG;BAC STMG MERCATIQUE (MARKETING);16;14;6;5;3;3;0;9;0;0;0;1;8;5
12953.0;2022;11;MONTPELLIER;MASCULIN;SCOLAIRE;BAC PROFESSIONNEL;BAC PRO PROD;BAC PRO 22106 CUISINE;143;142;122;15;5;5;0;127;0;5;31;47;44;15
12957.0;2022;11;MONTPELLIER;MASCULIN;SCOLAIRE;BAC PROFESSIONNEL;BAC PRO PROD;BAC PRO 22704 TECHN. MAINT. SYST.ENERG.CLIMATI;62;62;36;24;2;0;2;36;0;0;1;18;17;26
12961.0;2022;11;MONTPELLIER;MASCULIN;SCOLAIRE;BAC PROFESSIONNEL;BAC PRO PROD;BAC PRO 23102 TRAVAUX PUBLICS;38;38;33;4;1;1;0;34;0;0;9;16;9;4
12964.0;2022;11;MONTPELLIER;MASCULIN;SCOLAIRE;BAC PROFESSIONNEL;BAC PRO PROD;BAC PRO 23205 INTERV. SUR PATRIMOINE BATI OPT.A;6;6;5;0;1;1;0;6;0;0;1;2;3;0
12972.0;2022;11;MONTPELLIER;MASCULIN;SCOLAIRE;BAC PROFESSIONNEL;BAC PRO PROD;BAC PRO 24203 METIERS DE LA MODE - VÊTEMENT;13;13;11;1;1;1;0;12;0;1;1;5;5;1
12975.0;2022;11;MONTPELLIER;MASCULIN;SCOLAIRE;BAC PROFESSIONNEL;BAC PRO PROD;BAC PRO 25006 MICROTECHNIQUES;18;18;9;7;2;1;1;10;0;0;0;3;7;8
12981.0;2022;11;MONTPELLIER;MASCULIN;SCOLAIRE;BAC PROFESSIONNEL;BAC PRO PROD;BAC PRO 25216 MAINT.VEHIC.OPTC MOTOCYCLES;44;42;33;8;1;1;0;34;0;2;8;14;10;8
12982.0;2022;11;MONTPELLIER;MASCULIN;SCOLAIRE;BAC PROFESSIONNEL;BAC PRO PROD;BAC PRO 25219 MAINT.MATERIELS OPT.A AGRICOLES;20;20;18;2;0;0;0;18;0;1;9;4;4;2
12994.0;2022;11;MONTPELLIER;MASCULIN;SCOLAIRE;BAC PROFESSIONNEL;BAC PRO PROD;BAC PRO AG 21001 AGRO-EQUIPEMENT;29;28;27;1;0;0;0;27;0;0;4;9;14;1
12996.0;2022;11;MONTPELLIER;MASCULIN;SCOLAIRE;BAC PROFESSIONNEL;BAC PRO PROD;BAC PRO AG 21113 CGEVV;32;31;31;0;0;0;0;31;0;1;3;13;14;0
13000.0;2022;11;MONTPELLIER;MASCULIN;SCOLAIRE;BAC PROFESSIONNEL;BAC PRO PROD;BAC PRO AG 21210 COND GEST ENTR CANIN ET FELIN;13;13;13;0;0;0;0;13;0;0;2;4;7;0
13016.0;2022;11;MONTPELLIER;MASCULIN;SCOLAIRE;BAC PROFESSIONNEL;BAC PRO SERV;BAC PRO 32208 REAL.PR.IMPR.PLURI.OPTB.PR.IMPR.;9;9;9;0;0;0;0;9;0;3;2;3;1;0
13017.0;2022;11;MONTPELLIER;MASCULIN;SCOLAIRE;BAC PROFESSIONNEL;BAC PRO SERV;BAC PRO 32303 ART.& MET.ART:COM.VIS.VIS.PLURI-M;79;79;61;16;2;1;1;62;0;1;17;19;25;17
13020.0;2022;11;MONTPELLIER;MASCULIN;SCOLAIRE;BAC PROFESSIONNEL;BAC PRO SERV;BAC PRO 33003 ACC.SOINS-S.PERS. OPT.A DOMICILE;5;5;2;3;0;0;0;2;0;0;0;2;0;3
13023.0;2022;11;MONTPELLIER;MASCULIN;SCOLAIRE;BAC PROFESSIONNEL;BAC PRO SERV;BAC PRO 33102 PROTHESE DENTAIRE;13;13;7;6;0;0;0;7;0;0;2;0;5;6
13028.0;2022;11;MONTPELLIER;MASCULIN;SCOLAIRE;BAC TECHNOLOGIQUE;BAC S2TMD;BAC S2TMD MUSIQUE;2;2;2;0;0;0;0;2;0;0;1;0;1;0
13048.0;2022;12;NANCY-METZ;FEMININ;APPRENTISSAGE;BAC PROFESSIONNEL;BAC PRO PROD;BAC PRO 24203 METIERS DE LA MODE - VÊTEMENT;1;1;1;0;0;0;0;1;0;1;0;0;0;0
13051.0;2022;12;NANCY-METZ;FEMININ;APPRENTISSAGE;BAC PROFESSIONNEL;BAC PRO PROD;BAC PRO 25214 MAINT.VEHIC.OPTA VOIT.PARTICUL.;3;3;3;0;0;0;0;3;0;1;2;0;0;0
13052.0;2022;12;NANCY-METZ;FEMININ;APPRENTISSAGE;BAC PROFESSIONNEL;BAC PRO PROD;BAC PRO 25303 AERONAUTIQUE OPTION SYSTEMES;1;1;1;0;0;0;0;1;0;0;1;0;0;0
13057.0;2022;12;NANCY-METZ;FEMININ;APPRENTISSAGE;BAC PROFESSIONNEL;BAC PRO PROD;BAC PRO AG 21004 CGEA;12;12;7;5;0;0;0;7;0;0;0;1;6;5
13058.0;2022;12;NANCY-METZ;FEMININ;APPRENTISSAGE;BAC PROFESSIONNEL;BAC PRO PROD;BAC PRO AG 21114 CONDUITE PRODUCTIONS HORTICOLES;4;4;4;0;0;0;0;4;0;0;1;0;3;0
13075.0;2022;12;NANCY-METZ;FEMININ;ENSEIGNEMENT A DISTANCE;BAC GENERAL;BAC GENERAL;BAC GENE 10019 BAC GENERAL;42;42;36;3;3;3;0;39;1;1;4;16;17;3
13077.0;2022;12;NANCY-METZ;FEMININ;ENSEIGNEMENT A DISTANCE;BAC TECHNOLOGIQUE;BAC STMG;BAC STMG GESTION ET FINANCE;2;2;2;0;0;0;0;2;0;0;1;0;1;0
13080.0;2022;12;NANCY-METZ;FEMININ;FORMATION CONTINUE;BAC PROFESSIONNEL;BAC PRO PROD;BAC PRO 20102 PILOTE DE LIGNE DE PRODUCTION;1;1;1;0;0;0;0;1;0;0;0;1;0;0
13083.0;2022;12;NANCY-METZ;FEMININ;FORMATION CONTINUE;BAC PROFESSIONNEL;BAC PRO PROD;BAC PRO 25214 MAINT.VEHIC.OPTA VOIT.PARTICUL.;1;1;1;0;0;0;0;1;0;0;1;0;0;0
13089.0;2022;12;NANCY-METZ;FEMININ;FORMATION CONTINUE;BAC PROFESSIONNEL;BAC PRO SERV;BAC PRO 31214 MET.COM.VEN.OP.B PR.CL.VA.OF.COM.;12;11;9;1;1;0;1;9;0;1;2;6;0;2
13095.0;2022;12;NANCY-METZ;FEMININ;INDIVIDUEL;BAC PROFESSIONNEL;BAC PRO PROD;BAC PRO AG 21114 CONDUITE PRODUCTIONS HORTICOLES;2;2;2;0;0;0;0;2;0;0;0;0;2;0
13098.0;2022;12;NANCY-METZ;FEMININ;INDIVIDUEL;BAC PROFESSIONNEL;BAC PRO PROD;BAC PRO AG 21302 GEST MILIEUX NATURELS FAUNE;1;1;0;1;0;0;0;0;0;0;0;0;0;1
13101.0;2022;12;NANCY-METZ;FEMININ;INDIVIDUEL;BAC PROFESSIONNEL;BAC PRO SERV;BAC PRO 31212 METIERS DE L'ACCUEIL;1;1;0;1;0;0;0;0;0;0;0;0;0;1
13107.0;2022;12;NANCY-METZ;FEMININ;INDIVIDUEL;BAC PROFESSIONNEL;BAC PRO SERV;BAC PRO 33403 COMMERC. SERVICES EN RESTAURATION;2;1;0;1;0;0;0;0;0;0;0;0;0;1
13108.0;2022;12;NANCY-METZ;FEMININ;INDIVIDUEL;BAC PROFESSIONNEL;BAC PRO SERV;BAC PRO 33603 ESTHETIQUE COSMETIQUE PARFUMERIE;1;1;0;1;0;0;0;0;0;0;0;0;0;1
13115.0;2022;12;NANCY-METZ;FEMININ;INDIVIDUEL;BAC TECHNOLOGIQUE;BAC STMG;BAC STMG RESSOURCES HUMAINES ET COMMUNICATION;5;2;0;0;2;2;0;2;0;0;0;0;2;0
13121.0;2022;12;NANCY-METZ;FEMININ;SCOLAIRE;BAC PROFESSIONNEL;BAC PRO PROD;BAC PRO 22403 ARTS.& MET.ART:MET.ENSEIGN SIGNA;7;7;7;0;0;0;0;7;0;0;1;4;2;0
13125.0;2022;12;NANCY-METZ;FEMININ;SCOLAIRE;BAC PROFESSIONNEL;BAC PRO PROD;BAC PRO 23005 TECHN. ETUDES BAT B ASSIST.ARCHI.;12;12;11;1;0;0;0;11;0;2;2;3;4;1
13130.0;2022;12;NANCY-METZ;FEMININ;SCOLAIRE;BAC PROFESSIONNEL;BAC PRO PROD;BAC PRO 23407 TECHNIC.FAB.BOIS ET MATERX ASSOC;1;1;1;0;0;0;0;1;0;0;0;0;1;0
13140.0;2022;12;NANCY-METZ;FEMININ;SCOLAIRE;BAC PROFESSIONNEL;BAC PRO PROD;BAC PRO 25411 TECH.CHAUDRONNERIE INDUSTRIELLE;3;3;2;1;0;0;0;2;0;0;2;0;0;1
13144.0;2022;12;NANCY-METZ;FEMININ;SCOLAIRE;BAC PROFESSIONNEL;BAC PRO PROD;BAC PRO AG 21001 AGRO-EQUIPEMENT;4;4;4;0;0;0;0;4;0;0;0;2;2;0
13146.0;2022;12;NANCY-METZ;FEMININ;SCOLAIRE;BAC PROFESSIONNEL;BAC PRO PROD;BAC PRO AG 21114 CONDUITE PRODUCTIONS HORTICOLES;1;1;1;0;0;0;0;1;0;0;0;0;1;0
13153.0;2022;12;NANCY-METZ;FEMININ;SCOLAIRE;BAC PROFESSIONNEL;BAC PRO SERV;BAC PRO 31106 LOGISTIQUE;31;30;21;5;4;3;1;24;0;1;5;5;13;6
13155.0;2022;12;NANCY-METZ;FEMININ;SCOLAIRE;BAC PROFESSIONNEL;BAC PRO SERV;BAC PRO 31108 TRANSPORT;15;15;12;2;1;1;0;13;0;0;3;2;8;2
13157.0;2022;12;NANCY-METZ;FEMININ;SCOLAIRE;BAC PROFESSIONNEL;BAC PRO SERV;BAC PRO 31213 MET.COM.VEN.OP.A ANI.GES.ESP.COM.;398;398;369;15;14;8;6;377;0;33;96;162;86;21
13164.0;2022;12;NANCY-METZ;FEMININ;SCOLAIRE;BAC PROFESSIONNEL;BAC PRO SERV;BAC PRO 33003 ACC.SOINS-S.PERS. OPT.A DOMICILE;160;159;132;22;5;2;3;134;0;12;29;50;43;25
13169.0;2022;12;NANCY-METZ;FEMININ;SCOLAIRE;BAC PROFESSIONNEL;BAC PRO SERV;BAC PRO 33603 ESTHETIQUE COSMETIQUE PARFUMERIE;159;158;143;15;0;0;0;143;0;5;29;72;37;15
13177.0;2022;12;NANCY-METZ;FEMININ;SCOLAIRE;BAC TECHNOLOGIQUE;BAC STAV;BAC STAV AGRONOMIE ALIM ENV TERRITOI;55;55;55;0;0;0;0;55;0;2;6;20;27;0
13186.0;2022;12;NANCY-METZ;FEMININ;SCOLAIRE;BAC TECHNOLOGIQUE;BAC STMG;BAC STMG GESTION ET FINANCE;276;276;241;5;30;19;11;260;1;16;61;99;83;16
13187.0;2022;12;NANCY-METZ;FEMININ;SCOLAIRE;BAC TECHNOLOGIQUE;BAC STMG;BAC STMG MERCATIQUE (MARKETING);493;493;420;22;51;37;14;457;0;6;56;167;228;36
13197.0;2022;12;NANCY-METZ;MASCULIN;APPRENTISSAGE;BAC PROFESSIONNEL;BAC PRO PROD;BAC PRO 22705 TECHNICIEN GAZ;9;8;8;0;0;0;0;8;0;1;5;2;0;0
13214.0;2022;12;NANCY-METZ;MASCULIN;APPRENTISSAGE;BAC PROFESSIONNEL;BAC PRO PROD;BAC PRO 25221 MAINT.MATERIELS OPT.C ESP. VERTS;3;3;2;0;1;0;1;2;0;0;1;1;0;1
13215.0;2022;12;NANCY-METZ;MASCULIN;APPRENTISSAGE;BAC PROFESSIONNEL;BAC PRO PROD;BAC PRO 25302 AERONAUTIQUE OPTION AVIONIQUE;1;1;1;0;0;0;0;1;0;1;0;0;0;0
13218.0;2022;12;NANCY-METZ;MASCULIN;APPRENTISSAGE;BAC PROFESSIONNEL;BAC PRO PROD;BAC PRO 25408 REPARATION DES CARROSSERIES;20;20;15;5;0;0;0;15;0;4;3;5;3;5
13223.0;2022;12;NANCY-METZ;MASCULIN;APPRENTISSAGE;BAC PROFESSIONNEL;BAC PRO PROD;BAC PRO 25515 SYST.NUM.OPT.C RES.INF.SYST.COMM.;3;3;3;0;0;0;0;3;0;0;0;0;3;0
13225.0;2022;12;NANCY-METZ;MASCULIN;APPRENTISSAGE;BAC PROFESSIONNEL;BAC PRO PROD;BAC PRO AG 21004 CGEA;55;54;35;19;0;0;0;35;0;0;0;6;29;19
13226.0;2022;12;NANCY-METZ;MASCULIN;APPRENTISSAGE;BAC PROFESSIONNEL;BAC PRO PROD;BAC PRO AG 21114 CONDUITE PRODUCTIONS HORTICOLES;5;5;3;2;0;0;0;3;0;0;0;1;2;2
13234.0;2022;12;NANCY-METZ;MASCULIN;APPRENTISSAGE;BAC PROFESSIONNEL;BAC PRO SERV;BAC PRO 30001 GESTION-ADMINISTRATION;1;1;0;1;0;0;0;0;0;0;0;0;0;1
13242.0;2022;12;NANCY-METZ;MASCULIN;APPRENTISSAGE;BAC PROFESSIONNEL;BAC PRO SERV;BAC PRO 33403 COMMERC. SERVICES EN RESTAURATION;4;4;2;1;1;1;0;3;0;0;0;1;2;1
13246.0;2022;12;NANCY-METZ;MASCULIN;ENSEIGNEMENT A DISTANCE;BAC TECHNOLOGIQUE;BAC STMG;BAC STMG RESSOURCES HUMAINES ET COMMUNICATION;1;1;1;0;0;0;0;1;0;0;0;0;1;0
13249.0;2022;12;NANCY-METZ;MASCULIN;FORMATION CONTINUE;BAC PROFESSIONNEL;BAC PRO PROD;BAC PRO 22004 PROC. CHIMIE EAU PAPIERS-CARTONS;4;4;4;0;0;0;0;4;0;0;4;0;0;0
13260.0;2022;12;NANCY-METZ;MASCULIN;FORMATION CONTINUE;BAC PROFESSIONNEL;BAC PRO SERV;BAC PRO 30001 GESTION-ADMINISTRATION;7;7;6;0;1;1;0;7;0;1;3;0;3;0
13263.0;2022;12;NANCY-METZ;MASCULIN;FORMATION CONTINUE;BAC PROFESSIONNEL;BAC PRO SERV;BAC PRO 31213 MET.COM.VEN.OP.A ANI.GES.ESP.COM.;5;2;1;0;1;0;1;1;0;1;0;0;0;1
13277.0;2022;12;NANCY-METZ;MASCULIN;INDIVIDUEL;BAC PROFESSIONNEL;BAC PRO SERV;BAC PRO 30001 GESTION-ADMINISTRATION;4;1;0;1;0;0;0;0;0;0;0;0;0;1
13279.0;2022;12;NANCY-METZ;MASCULIN;INDIVIDUEL;BAC PROFESSIONNEL;BAC PRO SERV;BAC PRO 31213 MET.COM.VEN.OP.A ANI.GES.ESP.COM.;6;4;3;0;1;1;0;4;0;0;1;1;2;0
13281.0;2022;12;NANCY-METZ;MASCULIN;INDIVIDUEL;BAC PROFESSIONNEL;BAC PRO SERV;BAC PRO 34403 METIERS DE LA SECURITE;2;1;1;0;0;0;0;1;0;0;0;1;0;0
13282.0;2022;12;NANCY-METZ;MASCULIN;INDIVIDUEL;BAC TECHNOLOGIQUE;BAC S2TMD;BAC S2TMD MUSIQUE;1;1;0;1;0;0;0;0;0;0;0;0;0;1
13303.0;2022;12;NANCY-METZ;MASCULIN;SCOLAIRE;BAC PROFESSIONNEL;BAC PRO PROD;BAC PRO 23102 TRAVAUX PUBLICS;13;13;10;2;1;1;0;11;0;1;2;1;7;2
13307.0;2022;12;NANCY-METZ;MASCULIN;SCOLAIRE;BAC PROFESSIONNEL;BAC PRO PROD;BAC PRO 23304 AMENAGEMENT FINITION BATIMENT;32;32;18;7;7;4;3;22;0;0;2;7;13;10
13308.0;2022;12;NANCY-METZ;MASCULIN;SCOLAIRE;BAC PROFESSIONNEL;BAC PRO PROD;BAC PRO 23404 TECHNICIEN CONSTRUCTEUR BOIS;7;7;5;2;0;0;0;5;0;1;1;3;0;2
13311.0;2022;12;NANCY-METZ;MASCULIN;SCOLAIRE;BAC PROFESSIONNEL;BAC PRO PROD;BAC PRO 23407 TECHNIC.FAB.BOIS ET MATERX ASSOC;15;15;9;5;1;1;0;10;0;1;1;3;5;5
13320.0;2022;12;NANCY-METZ;MASCULIN;SCOLAIRE;BAC PROFESSIONNEL;BAC PRO PROD;BAC PRO 25219 MAINT.MATERIELS OPT.A AGRICOLES;5;5;5;0;0;0;0;5;0;0;1;1;3;0
13326.0;2022;12;NANCY-METZ;MASCULIN;SCOLAIRE;BAC PROFESSIONNEL;BAC PRO PROD;BAC PRO 25410 CONSTRUCTION DES CARROSSERIES;8;8;4;3;1;1;0;5;0;0;1;0;4;3
13330.0;2022;12;NANCY-METZ;MASCULIN;SCOLAIRE;BAC PROFESSIONNEL;BAC PRO PROD;BAC PRO 25513 SYST.NUM.OPT.A SURETE SECURITE;43;43;32;5;6;4;2;36;0;3;13;9;11;7
13331.0;2022;12;NANCY-METZ;MASCULIN;SCOLAIRE;BAC PROFESSIONNEL;BAC PRO PROD;BAC PRO 25514 SYST.NUM.OPT.B AUD.RES.EQUIP.DOM.;63;63;52;9;2;2;0;54;0;6;13;19;16;9
13337.0;2022;12;NANCY-METZ;MASCULIN;SCOLAIRE;BAC PROFESSIONNEL;BAC PRO PROD;BAC PRO AG 21211 COND GEST ENTR HIPPIQUE;3;3;2;1;0;0;0;2;0;0;0;0;2;1
13340.0;2022;12;NANCY-METZ;MASCULIN;SCOLAIRE;BAC PROFESSIONNEL;BAC PRO PROD;BAC PRO AG 21405 AMENAGEMENTS PAYSAGERS;26;26;23;3;0;0;0;23;0;0;4;15;4;3
13343.0;2022;12;NANCY-METZ;MASCULIN;SCOLAIRE;BAC PROFESSIONNEL;BAC PRO SERV;BAC PRO 31106 LOGISTIQUE;124;124;95;12;17;13;4;108;0;3;25;35;45;16
13347.0;2022;12;NANCY-METZ;MASCULIN;SCOLAIRE;BAC PROFESSIONNEL;BAC PRO SERV;BAC PRO 31213 MET.COM.VEN.OP.A ANI.GES.ESP.COM.;370;370;298;41;31;19;12;317;0;9;60;134;114;53
13351.0;2022;12;NANCY-METZ;MASCULIN;SCOLAIRE;BAC PROFESSIONNEL;BAC PRO SERV;BAC PRO 32303 ART.& MET.ART:COM.VIS.VIS.PLURI-M;13;13;12;1;0;0;0;12;0;0;1;8;3;1
13356.0;2022;12;NANCY-METZ;MASCULIN;SCOLAIRE;BAC PROFESSIONNEL;BAC PRO SERV;BAC PRO 33101 OPTIQUE LUNETTERIE;14;14;14;0;0;0;0;14;0;1;5;3;5;0
13365.0;2022;12;NANCY-METZ;MASCULIN;SCOLAIRE;BAC TECHNOLOGIQUE;BAC ST2S;BAC ST2S SCIENCES & TECHNO. SANTE & SOCIAL;132;132;97;7;28;19;9;116;0;1;4;33;78;16
13369.0;2022;12;NANCY-METZ;MASCULIN;SCOLAIRE;BAC TECHNOLOGIQUE;BAC STI2D;BAC STI2D ARCHITECTURE ET CONSTRUCTION;72;72;50;3;19;9;10;59;0;0;4;22;33;13
13374.0;2022;12;NANCY-METZ;MASCULIN;SCOLAIRE;BAC TECHNOLOGIQUE;BAC STL;BAC STL SCIENCES PHYSIQUES CHIMIQUES  EN LABORAT.;56;56;44;3;9;5;4;49;0;2;5;14;28;7
13380.0;2022;17;NANTES;FEMININ;APPRENTISSAGE;BAC PROFESSIONNEL;BAC PRO PROD;BAC PRO 22106 CUISINE;24;24;20;4;0;0;0;20;0;1;4;8;7;4
13392.0;2022;17;NANTES;FEMININ;APPRENTISSAGE;BAC PROFESSIONNEL;BAC PRO PROD;BAC PRO 25215 MAINT.VEHIC.OPTB VEHIC.TRANS.ROUT;2;2;2;0;0;0;0;2;0;0;2;0;0;0
13395.0;2022;17;NANTES;FEMININ;APPRENTISSAGE;BAC PROFESSIONNEL;BAC PRO PROD;BAC PRO 25304 AERONAUTIQUE OPTION STRUCTURE;4;4;4;0;0;0;0;4;0;2;1;0;1;0
13400.0;2022;17;NANTES;FEMININ;APPRENTISSAGE;BAC PROFESSIONNEL;BAC PRO PROD;BAC PRO AG 21001 AGRO-EQUIPEMENT;1;1;0;1;0;0;0;0;0;0;0;0;0;1
13404.0;2022;17;NANTES;FEMININ;APPRENTISSAGE;BAC PROFESSIONNEL;BAC PRO PROD;BAC PRO AG 21203 TECHN CONSEIL DE VENTE ANIMAL;2;2;0;2;0;0;0;0;0;0;0;0;0;2
13407.0;2022;17;NANTES;FEMININ;APPRENTISSAGE;BAC PROFESSIONNEL;BAC PRO PROD;BAC PRO AG 21302 GEST MILIEUX NATURELS FAUNE;1;1;1;0;0;0;0;1;0;0;0;0;1;0
13408.0;2022;17;NANTES;FEMININ;APPRENTISSAGE;BAC PROFESSIONNEL;BAC PRO PROD;BAC PRO AG 21405 AMENAGEMENTS PAYSAGERS;6;6;6;0;0;0;0;6;0;0;0;2;4;0
13417.0;2022;17;NANTES;FEMININ;APPRENTISSAGE;BAC PROFESSIONNEL;BAC PRO SERV;BAC PRO 32207 REAL.PR.IMPR.PLURI.OPTA.PR.GRAPH.;1;1;1;0;0;0;0;1;0;0;1;0;0;0
13421.0;2022;17;NANTES;FEMININ;APPRENTISSAGE;BAC PROFESSIONNEL;BAC PRO SERV;BAC PRO 33102 PROTHESE DENTAIRE;1;1;1;0;0;0;0;1;0;0;0;1;0;0
13423.0;2022;17;NANTES;FEMININ;APPRENTISSAGE;BAC PROFESSIONNEL;BAC PRO SERV;BAC PRO 33603 ESTHETIQUE COSMETIQUE PARFUMERIE;8;8;8;0;0;0;0;8;0;0;2;5;1;0
13424.0;2022;17;NANTES;FEMININ;APPRENTISSAGE;BAC PROFESSIONNEL;BAC PRO SERV;BAC PRO AG 33002 SERV PERS TERRIT;53;50;48;2;0;0;0;48;0;0;6;16;26;2
13427.0;2022;17;NANTES;FEMININ;ENSEIGNEMENT A DISTANCE;BAC PROFESSIONNEL;BAC PRO PROD;BAC PRO AG 21114 CONDUITE PRODUCTIONS HORTICOLES;15;14;14;0;0;0;0;14;0;0;0;1;13;0
13430.0;2022;17;NANTES;FEMININ;ENSEIGNEMENT A DISTANCE;BAC PROFESSIONNEL;BAC PRO SERV;BAC PRO 32304 PHOTOGRAPHIE;1;1;0;1;0;0;0;0;0;0;0;0;0;1
13454.0;2022;17;NANTES;FEMININ;INDIVIDUEL;BAC PROFESSIONNEL;BAC PRO SERV;BAC PRO 33004 ACC.SOINS-S.PERS. OPT.EN STRUCTUR;1;1;1;0;0;0;0;1;0;0;0;0;1;0
13459.0;2022;17;NANTES;FEMININ;INDIVIDUEL;BAC TECHNOLOGIQUE;BAC STMG;BAC STMG MERCATIQUE (MARKETING);20;16;4;7;5;5;0;9;0;0;0;1;8;7
13460.0;2022;17;NANTES;FEMININ;INDIVIDUEL;BAC TECHNOLOGIQUE;BAC STMG;BAC STMG RESSOURCES HUMAINES ET COMMUNICATION;11;9;3;0;6;3;3;6;0;0;0;0;6;3
13467.0;2022;17;NANTES;FEMININ;SCOLAIRE;BAC PROFESSIONNEL;BAC PRO PROD;BAC PRO 23003 ARTIS. & M.ART:MARCHANDISAGE VIS.;24;24;24;0;0;0;0;24;0;6;11;5;2;0
13469.0;2022;17;NANTES;FEMININ;SCOLAIRE;BAC PROFESSIONNEL;BAC PRO PROD;BAC PRO 23005 TECHN. ETUDES BAT B ASSIST.ARCHI.;32;32;29;2;1;0;1;29;0;0;8;15;6;3
13471.0;2022;17;NANTES;FEMININ;SCOLAIRE;BAC PROFESSIONNEL;BAC PRO PROD;BAC PRO 23304 AMENAGEMENT FINITION BATIMENT;18;18;15;3;0;0;0;15;0;1;4;5;5;3
13495.0;2022;17;NANTES;FEMININ;SCOLAIRE;BAC PROFESSIONNEL;BAC PRO PROD;BAC PRO AG 21203 TECHN CONSEIL DE VENTE ANIMAL;78;77;58;19;0;0;0;58;0;1;10;20;27;19
13499.0;2022;17;NANTES;FEMININ;SCOLAIRE;BAC PROFESSIONNEL;BAC PRO PROD;BAC PRO AG 21405 AMENAGEMENTS PAYSAGERS;14;14;13;1;0;0;0;13;0;1;2;3;7;1
13502.0;2022;17;NANTES;FEMININ;SCOLAIRE;BAC PROFESSIONNEL;BAC PRO PROD;BAC PRO AG 22106 TEC CONS VTE ALIMENTATION VINS SP;2;2;2;0;0;0;0;2;0;0;1;1;0;0
13517.0;2022;17;NANTES;FEMININ;SCOLAIRE;BAC PROFESSIONNEL;BAC PRO SERV;BAC PRO 33004 ACC.SOINS-S.PERS. OPT.EN STRUCTUR;740;740;688;37;15;12;3;700;0;41;197;305;157;40
13518.0;2022;17;NANTES;FEMININ;SCOLAIRE;BAC PROFESSIONNEL;BAC PRO SERV;BAC PRO 33101 OPTIQUE LUNETTERIE;19;19;19;0;0;0;0;19;0;2;4;10;3;0
13525.0;2022;17;NANTES;FEMININ;SCOLAIRE;BAC PROFESSIONNEL;BAC PRO SERV;BAC PRO 34403 METIERS DE LA SECURITE;47;47;47;0;0;0;0;47;0;5;22;17;3;0
13526.0;2022;17;NANTES;FEMININ;SCOLAIRE;BAC PROFESSIONNEL;BAC PRO SERV;BAC PRO AG 33002 SERV PERS TERRIT;877;861;805;56;0;0;0;805;0;9;117;303;376;56
13530.0;2022;17;NANTES;FEMININ;SCOLAIRE;BAC TECHNOLOGIQUE;BAC STAV;BAC STAV AGRONOMIE ALIM ENV TERRITOI;134;134;129;5;0;0;0;129;0;0;15;51;63;5
13532.0;2022;17;NANTES;FEMININ;SCOLAIRE;BAC TECHNOLOGIQUE;BAC STHR;BAC STHR SC.&TEC. HOTELLERIE-RESTAURATION;77;77;71;0;6;4;2;75;0;9;12;25;29;2
13537.0;2022;17;NANTES;FEMININ;SCOLAIRE;BAC TECHNOLOGIQUE;BAC STL;BAC STL BIOCHIM.-BIOLOGIE-BIOTECHNOL.;96;96;88;2;6;4;2;92;0;5;22;31;34;4
13539.0;2022;17;NANTES;FEMININ;SCOLAIRE;BAC TECHNOLOGIQUE;BAC STMG;BAC STMG GESTION ET FINANCE;344;344;300;8;36;24;12;324;0;10;47;125;142;20
13546.0;2022;17;NANTES;MASCULIN;APPRENTISSAGE;BAC PROFESSIONNEL;BAC PRO PROD;BAC PRO 22302 Traitement des matériaux;3;3;3;0;0;0;0;3;0;0;1;1;1;0
13548.0;2022;17;NANTES;MASCULIN;APPRENTISSAGE;BAC PROFESSIONNEL;BAC PRO PROD;BAC PRO 22703 TECHN.INSTALL.SYST.ENERG.CLIMATI;52;52;39;8;5;1;4;40;0;2;10;16;12;12
13550.0;2022;17;NANTES;MASCULIN;APPRENTISSAGE;BAC PROFESSIONNEL;BAC PRO PROD;BAC PRO 22705 TECHNICIEN GAZ;9;9;9;0;0;0;0;9;0;4;4;1;0;0
13551.0;2022;17;NANTES;MASCULIN;APPRENTISSAGE;BAC PROFESSIONNEL;BAC PRO PROD;BAC PRO 23004 TECHN. ETUDES BAT.A ETUDES & ECO.;2;2;2;0;0;0;0;2;0;0;0;1;1;0
13554.0;2022;17;NANTES;MASCULIN;APPRENTISSAGE;BAC PROFESSIONNEL;BAC PRO PROD;BAC PRO 23203 TECHNICIEN BAT. : ORG.REAL.GROS O;30;30;25;3;2;1;1;26;0;1;6;6;13;4
13559.0;2022;17;NANTES;MASCULIN;APPRENTISSAGE;BAC PROFESSIONNEL;BAC PRO PROD;BAC PRO 23405 TECHNICIEN MENUISIER AGENCEUR;31;31;27;2;2;1;1;28;0;0;9;12;7;3
13560.0;2022;17;NANTES;MASCULIN;APPRENTISSAGE;BAC PROFESSIONNEL;BAC PRO PROD;BAC PRO 23407 TECHNIC.FAB.BOIS ET MATERX ASSOC;2;2;1;1;0;0;0;1;0;0;1;0;0;1
13562.0;2022;17;NANTES;MASCULIN;APPRENTISSAGE;BAC PROFESSIONNEL;BAC PRO PROD;BAC PRO 25007 MAINTENANCE EQUIPEMENTS INDUST.;96;95;82;11;2;2;0;84;0;5;26;30;23;11
13577.0;2022;17;NANTES;MASCULIN;APPRENTISSAGE;BAC PROFESSIONNEL;BAC PRO PROD;BAC PRO 25411 TECH.CHAUDRONNERIE INDUSTRIELLE;111;111;94;13;4;2;2;96;0;9;17;36;34;15
13584.0;2022;17;NANTES;MASCULIN;APPRENTISSAGE;BAC PROFESSIONNEL;BAC PRO PROD;BAC PRO AG 21004 CGEA;97;94;83;11;0;0;0;83;0;0;10;21;52;11
13593.0;2022;17;NANTES;MASCULIN;APPRENTISSAGE;BAC PROFESSIONNEL;BAC PRO PROD;BAC PRO AG 21405 AMENAGEMENTS PAYSAGERS;152;150;134;16;0;0;0;134;0;1;15;41;77;16
13595.0;2022;17;NANTES;MASCULIN;APPRENTISSAGE;BAC PROFESSIONNEL;BAC PRO SERV;BAC PRO 30001 GESTION-ADMINISTRATION;2;2;2;0;0;0;0;2;0;1;0;1;0;0
13597.0;2022;17;NANTES;MASCULIN;APPRENTISSAGE;BAC PROFESSIONNEL;BAC PRO SERV;BAC PRO 31108 TRANSPORT;3;3;3;0;0;0;0;3;0;0;0;2;1;0
13602.0;2022;17;NANTES;MASCULIN;APPRENTISSAGE;BAC PROFESSIONNEL;BAC PRO SERV;BAC PRO 32206 FACONNAGE PRODTS IMPRIMES ROUTAGE;3;3;3;0;0;0;0;3;0;1;1;0;1;0
13607.0;2022;17;NANTES;MASCULIN;APPRENTISSAGE;BAC PROFESSIONNEL;BAC PRO SERV;BAC PRO AG 33002 SERV PERS TERRIT;11;11;11;0;0;0;0;11;0;0;0;2;9;0
13612.0;2022;17;NANTES;MASCULIN;ENSEIGNEMENT A DISTANCE;BAC PROFESSIONNEL;BAC PRO SERV;BAC PRO 31213 MET.COM.VEN.OP.A ANI.GES.ESP.COM.;2;1;1;0;0;0;0;1;0;0;1;0;0;0
13628.0;2022;17;NANTES;MASCULIN;FORMATION CONTINUE;BAC PROFESSIONNEL;BAC PRO PROD;BAC PRO 25515 SYST.NUM.OPT.C RES.INF.SYST.COMM.;7;7;5;2;0;0;0;5;0;2;3;0;0;2
13630.0;2022;17;NANTES;MASCULIN;FORMATION CONTINUE;BAC PROFESSIONNEL;BAC PRO SERV;BAC PRO 31106 LOGISTIQUE;12;10;9;1;0;0;0;9;0;2;1;3;3;1
13639.0;2022;17;NANTES;MASCULIN;INDIVIDUEL;BAC PROFESSIONNEL;BAC PRO PROD;BAC PRO 25007 MAINTENANCE EQUIPEMENTS INDUST.;3;2;1;1;0;0;0;1;0;0;0;0;1;1
13645.0;2022;17;NANTES;MASCULIN;INDIVIDUEL;BAC PROFESSIONNEL;BAC PRO PROD;BAC PRO 25513 SYST.NUM.OPT.A SURETE SECURITE;2;1;1;0;0;0;0;1;0;0;0;0;1;0
13653.0;2022;17;NANTES;MASCULIN;INDIVIDUEL;BAC PROFESSIONNEL;BAC PRO SERV;BAC PRO 30001 GESTION-ADMINISTRATION;2;1;0;1;0;0;0;0;0;0;0;0;0;1
13659.0;2022;17;NANTES;MASCULIN;INDIVIDUEL;BAC PROFESSIONNEL;BAC PRO SERV;BAC PRO AG 33002 SERV PERS TERRIT;2;1;1;0;0;0;0;1;0;0;0;0;1;0
13660.0;2022;17;NANTES;MASCULIN;INDIVIDUEL;BAC TECHNOLOGIQUE;BAC S2TMD;BAC S2TMD DANSE;1;1;0;1;0;0;0;0;0;0;0;0;0;1
13661.0;2022;17;NANTES;MASCULIN;INDIVIDUEL;BAC TECHNOLOGIQUE;BAC ST2S;BAC ST2S SCIENCES & TECHNO. SANTE & SOCIAL;3;3;0;3;0;0;0;0;0;0;0;0;0;3
13663.0;2022;17;NANTES;MASCULIN;INDIVIDUEL;BAC TECHNOLOGIQUE;BAC STD2A;BAC STD2A SCIENCES & TECHNO. DESIGN-ARTS APPLIQUES;1;1;0;1;0;0;0;0;0;0;0;0;0;1
13674.0;2022;17;NANTES;MASCULIN;SCOLAIRE;BAC PROFESSIONNEL;BAC PRO PROD;BACPRO 20002 ETUD.DEFINITION PRDTS INDUSTRIEL;29;29;26;3;0;0;0;26;0;2;6;10;8;3
13682.0;2022;17;NANTES;MASCULIN;SCOLAIRE;BAC PROFESSIONNEL;BAC PRO PROD;BAC PRO 22704 TECHN. MAINT. SYST.ENERG.CLIMATI;13;13;10;2;1;1;0;11;0;0;0;3;8;2
13694.0;2022;17;NANTES;MASCULIN;SCOLAIRE;BAC PROFESSIONNEL;BAC PRO PROD;BAC PRO 23407 TECHNIC.FAB.BOIS ET MATERX ASSOC;23;23;19;4;0;0;0;19;0;1;5;8;5;4
13697.0;2022;17;NANTES;MASCULIN;SCOLAIRE;BAC PROFESSIONNEL;BAC PRO PROD;BAC PRO 24203 METIERS DE LA MODE - VÊTEMENT;8;8;6;2;0;0;0;6;0;2;2;2;0;2
13701.0;2022;17;NANTES;MASCULIN;SCOLAIRE;BAC PROFESSIONNEL;BAC PRO PROD;BAC PRO 25009 MAINTENANCE NAUTIQUE;11;11;9;1;1;1;0;10;0;0;2;7;1;1
13703.0;2022;17;NANTES;MASCULIN;SCOLAIRE;BAC PROFESSIONNEL;BAC PRO PROD;BAC PRO 25107 TECHNICIEN OUTILLEUR;12;12;10;0;2;2;0;12;0;0;4;5;3;0
13710.0;2022;17;NANTES;MASCULIN;SCOLAIRE;BAC PROFESSIONNEL;BAC PRO PROD;BAC PRO 25406 OUVRAGES DU BATIMENT METALLERIE;39;39;31;5;3;3;0;34;0;2;4;13;15;5
13717.0;2022;17;NANTES;MASCULIN;SCOLAIRE;BAC PROFESSIONNEL;BAC PRO PROD;BAC PRO 25514 SYST.NUM.OPT.B AUD.RES.EQUIP.DOM.;91;91;72;13;6;4;2;76;0;6;17;33;20;15
13719.0;2022;17;NANTES;MASCULIN;SCOLAIRE;BAC PROFESSIONNEL;BAC PRO PROD;BAC PRO AG 21001 AGRO-EQUIPEMENT;89;89;77;12;0;0;0;77;0;0;10;21;46;12
13724.0;2022;17;NANTES;MASCULIN;SCOLAIRE;BAC PROFESSIONNEL;BAC PRO PROD;BAC PRO AG 21204 PROD-AQUACOLES;18;18;17;1;0;0;0;17;0;0;1;6;10;1
13731.0;2022;17;NANTES;MASCULIN;SCOLAIRE;BAC PROFESSIONNEL;BAC PRO PROD;BAC PRO AG 22105 LABORATOIRE CONTROLE QUALITE;15;15;14;1;0;0;0;14;0;0;1;6;7;1
13733.0;2022;17;NANTES;MASCULIN;SCOLAIRE;BAC PROFESSIONNEL;BAC PRO PROD;BAC PRO AG 22107 TEC CONS VTE ALIMENTATION P.ALIM;86;85;69;16;0;0;0;69;0;0;2;19;48;16
13737.0;2022;17;NANTES;MASCULIN;SCOLAIRE;BAC PROFESSIONNEL;BAC PRO SERV;BAC PRO 31108 TRANSPORT;40;40;28;11;1;1;0;29;0;2;5;10;12;11
13743.0;2022;17;NANTES;MASCULIN;SCOLAIRE;BAC PROFESSIONNEL;BAC PRO SERV;BAC PRO 32303 ART.& MET.ART:COM.VIS.VIS.PLURI-M;44;44;39;5;0;0;0;39;0;0;9;21;9;5
13760.0;2022;17;NANTES;MASCULIN;SCOLAIRE;BAC TECHNOLOGIQUE;BAC STD2A;BAC STD2A SCIENCES & TECHNO. DESIGN-ARTS APPLIQUES;43;43;40;0;3;2;1;42;0;2;8;22;10;1
13769.0;2022;17;NANTES;MASCULIN;SCOLAIRE;BAC TECHNOLOGIQUE;BAC STMG;BAC STMG MERCATIQUE (MARKETING);1128;1128;892;46;190;122;68;1014;0;5;55;330;624;114
13776.0;2022;23;NICE;FEMININ;APPRENTISSAGE;BAC PROFESSIONNEL;BAC PRO PROD;BAC PRO 23405 TECHNICIEN MENUISIER AGENCEUR;1;1;1;0;0;0;0;1;0;1;0;0;0;0
13777.0;2022;23;NICE;FEMININ;APPRENTISSAGE;BAC PROFESSIONNEL;BAC PRO PROD;BAC PRO 24002 METIERS PRESSING BLANCHISSERIE;1;1;1;0;0;0;0;1;0;0;0;1;0;0
13778.0;2022;23;NICE;FEMININ;APPRENTISSAGE;BAC PROFESSIONNEL;BAC PRO PROD;BAC PRO 25009 MAINTENANCE NAUTIQUE;1;1;0;1;0;0;0;0;0;0;0;0;0;1
13779.0;2022;23;NICE;FEMININ;APPRENTISSAGE;BAC PROFESSIONNEL;BAC PRO PROD;BAC PRO 25214 MAINT.VEHIC.OPTA VOIT.PARTICUL.;1;1;1;0;0;0;0;1;0;0;0;1;0;0
13782.0;2022;23;NICE;FEMININ;APPRENTISSAGE;BAC PROFESSIONNEL;BAC PRO PROD;BAC PRO 25514 SYST.NUM.OPT.B AUD.RES.EQUIP.DOM.;1;1;1;0;0;0;0;1;0;0;1;0;0;0
13791.0;2022;23;NICE;FEMININ;APPRENTISSAGE;BAC PROFESSIONNEL;BAC PRO SERV;BAC PRO 33102 PROTHESE DENTAIRE;1;1;1;0;0;0;0;1;0;0;0;0;1;0
13792.0;2022;23;NICE;FEMININ;APPRENTISSAGE;BAC PROFESSIONNEL;BAC PRO SERV;BAC PRO 33403 COMMERC. SERVICES EN RESTAURATION;4;4;4;0;0;0;0;4;0;0;0;3;1;0
13793.0;2022;23;NICE;FEMININ;ENSEIGNEMENT A DISTANCE;BAC GENERAL;BAC GENERAL;BAC GENE 10019 BAC GENERAL;70;70;45;15;10;2;8;47;0;5;11;12;19;23
13801.0;2022;23;NICE;FEMININ;ENSEIGNEMENT A DISTANCE;BAC TECHNOLOGIQUE;BAC STMG;BAC STMG MERCATIQUE (MARKETING);5;5;3;2;0;0;0;3;0;0;0;0;3;2
13802.0;2022;23;NICE;FEMININ;ENSEIGNEMENT A DISTANCE;BAC TECHNOLOGIQUE;BAC STMG;BAC STMG RESSOURCES HUMAINES ET COMMUNICATION;4;4;3;0;1;0;1;3;0;0;0;2;1;1
13814.0;2022;23;NICE;FEMININ;INDIVIDUEL;BAC PROFESSIONNEL;BAC PRO PROD;BAC PRO AG 21113 CGEVV;1;1;1;0;0;0;0;1;0;0;0;0;1;0
13815.0;2022;23;NICE;FEMININ;INDIVIDUEL;BAC PROFESSIONNEL;BAC PRO PROD;BAC PRO AG 21114 CONDUITE PRODUCTIONS HORTICOLES;10;5;4;1;0;0;0;4;0;0;0;0;4;1
13819.0;2022;23;NICE;FEMININ;INDIVIDUEL;BAC PROFESSIONNEL;BAC PRO SERV;BAC PRO 31214 MET.COM.VEN.OP.B PR.CL.VA.OF.COM.;4;1;0;1;0;0;0;0;0;0;0;0;0;1
13825.0;2022;23;NICE;FEMININ;INDIVIDUEL;BAC TECHNOLOGIQUE;BAC STMG;BAC STMG MERCATIQUE (MARKETING);6;6;1;3;2;1;1;2;0;0;0;0;2;4
13826.0;2022;23;NICE;FEMININ;INDIVIDUEL;BAC TECHNOLOGIQUE;BAC STMG;BAC STMG RESSOURCES HUMAINES ET COMMUNICATION;9;9;3;5;1;1;0;4;0;0;0;1;3;5
13832.0;2022;23;NICE;FEMININ;SCOLAIRE;BAC PROFESSIONNEL;BAC PRO PROD;BAC PRO 22403 ARTS.& MET.ART:MET.ENSEIGN SIGNA;6;6;6;0;0;0;0;6;0;1;3;2;0;0
13841.0;2022;23;NICE;FEMININ;SCOLAIRE;BAC PROFESSIONNEL;BAC PRO PROD;BAC PRO 24203 METIERS DE LA MODE - VÊTEMENT;66;66;57;7;2;1;1;58;0;8;19;17;14;8
13844.0;2022;23;NICE;FEMININ;SCOLAIRE;BAC PROFESSIONNEL;BAC PRO PROD;BAC PRO 25007 MAINTENANCE EQUIPEMENTS INDUST.;5;5;4;1;0;0;0;4;0;0;0;1;3;1
13847.0;2022;23;NICE;FEMININ;SCOLAIRE;BAC PROFESSIONNEL;BAC PRO PROD;BAC PRO 25216 MAINT.VEHIC.OPTC MOTOCYCLES;4;4;4;0;0;0;0;4;0;0;0;2;2;0
13849.0;2022;23;NICE;FEMININ;SCOLAIRE;BAC PROFESSIONNEL;BAC PRO PROD;BAC PRO 25408 REPARATION DES CARROSSERIES;1;1;1;0;0;0;0;1;0;0;0;0;1;0
13855.0;2022;23;NICE;FEMININ;SCOLAIRE;BAC PROFESSIONNEL;BAC PRO PROD;BAC PRO AG 21004 CGEA;20;19;16;3;0;0;0;16;0;0;3;3;10;3
13863.0;2022;23;NICE;FEMININ;SCOLAIRE;BAC PROFESSIONNEL;BAC PRO SERV;BAC PRO 31108 TRANSPORT;7;7;6;1;0;0;0;6;0;0;0;2;4;1
13868.0;2022;23;NICE;FEMININ;SCOLAIRE;BAC PROFESSIONNEL;BAC PRO SERV;BAC PRO 32303 ART.& MET.ART:COM.VIS.VIS.PLURI-M;7;7;7;0;0;0;0;7;0;5;1;1;0;0
13877.0;2022;23;NICE;FEMININ;SCOLAIRE;BAC PROFESSIONNEL;BAC PRO SERV;BAC PRO AG 33002 SERV PERS TERRIT;87;85;80;5;0;0;0;80;0;3;4;36;37;5
13881.0;2022;23;NICE;FEMININ;SCOLAIRE;BAC TECHNOLOGIQUE;BAC STAV;BAC STAV AGRONOMIE ALIM ENV TERRITOI;37;37;37;0;0;0;0;37;0;0;1;16;20;0
13884.0;2022;23;NICE;FEMININ;SCOLAIRE;BAC TECHNOLOGIQUE;BAC STI2D;BAC STI2D ARCHITECTURE ET CONSTRUCTION;21;21;19;0;2;2;0;21;0;0;3;10;8;0
13888.0;2022;23;NICE;FEMININ;SCOLAIRE;BAC TECHNOLOGIQUE;BAC STL;BAC STL BIOCHIM.-BIOLOGIE-BIOTECHNOL.;79;79;69;0;10;5;5;74;0;3;12;23;36;5
13896.0;2022;23;NICE;MASCULIN;APPRENTISSAGE;BAC PROFESSIONNEL;BAC PRO PROD;BAC PRO 22703 TECHN.INSTALL.SYST.ENERG.CLIMATI;3;3;3;0;0;0;0;3;0;0;0;0;3;0
13897.0;2022;23;NICE;MASCULIN;APPRENTISSAGE;BAC PROFESSIONNEL;BAC PRO PROD;BAC PRO 22704 TECHN. MAINT. SYST.ENERG.CLIMATI;6;6;3;3;0;0;0;3;0;0;1;1;1;3
13915.0;2022;23;NICE;MASCULIN;APPRENTISSAGE;BAC PROFESSIONNEL;BAC PRO PROD;BAC PRO 25514 SYST.NUM.OPT.B AUD.RES.EQUIP.DOM.;5;5;4;1;0;0;0;4;0;0;2;0;2;1
13930.0;2022;23;NICE;MASCULIN;ENSEIGNEMENT A DISTANCE;BAC PROFESSIONNEL;BAC PRO SERV;BAC PRO 31213 MET.COM.VEN.OP.A ANI.GES.ESP.COM.;4;1;1;0;0;0;0;1;0;0;0;1;0;0
13933.0;2022;23;NICE;MASCULIN;ENSEIGNEMENT A DISTANCE;BAC TECHNOLOGIQUE;BAC STMG;BAC STMG GESTION ET FINANCE;3;3;1;0;2;1;1;2;0;0;0;1;1;1
13941.0;2022;23;NICE;MASCULIN;FORMATION CONTINUE;BAC PROFESSIONNEL;BAC PRO SERV;BAC PRO 33101 OPTIQUE LUNETTERIE;3;3;3;0;0;0;0;3;0;0;1;2;0;0
13944.0;2022;23;NICE;MASCULIN;INDIVIDUEL;BAC PROFESSIONNEL;BAC PRO PROD;BACPRO 23103 TECHNICIEN GEOMETRE-TOPOGRAPHE;1;0;0;0;0;0;0;0;0;0;0;0;0;0
13946.0;2022;23;NICE;MASCULIN;INDIVIDUEL;BAC PROFESSIONNEL;BAC PRO PROD;BAC PRO 25214 MAINT.VEHIC.OPTA VOIT.PARTICUL.;1;0;0;0;0;0;0;0;0;0;0;0;0;0
13947.0;2022;23;NICE;MASCULIN;INDIVIDUEL;BAC PROFESSIONNEL;BAC PRO PROD;BAC PRO 25408 REPARATION DES CARROSSERIES;1;0;0;0;0;0;0;0;0;0;0;0;0;0
13960.0;2022;23;NICE;MASCULIN;INDIVIDUEL;BAC TECHNOLOGIQUE;BAC STHR;BAC STHR SC.&TEC. HOTELLERIE-RESTAURATION;1;1;0;0;1;1;0;1;0;0;0;0;1;0
13961.0;2022;23;NICE;MASCULIN;INDIVIDUEL;BAC TECHNOLOGIQUE;BAC STI2D;BAC STI2D ARCHITECTURE ET CONSTRUCTION;1;1;0;0;1;0;1;0;0;0;0;0;0;1
13967.0;2022;23;NICE;MASCULIN;INDIVIDUEL;BAC TECHNOLOGIQUE;BAC STMG;BAC STMG RESSOURCES HUMAINES ET COMMUNICATION;9;9;3;4;2;1;1;4;0;0;0;0;4;5
13968.0;2022;23;NICE;MASCULIN;SCOLAIRE;BAC GENERAL;BAC GENERAL;BAC GENE 10019 BAC GENERAL;5072;5072;4640;105;327;212;115;4852;114;593;1193;1531;1421;220
13973.0;2022;23;NICE;MASCULIN;SCOLAIRE;BAC PROFESSIONNEL;BAC PRO PROD;BAC PRO 22403 ARTS.& MET.ART:MET.ENSEIGN SIGNA;6;6;5;0;1;1;0;6;0;0;4;1;1;0
13977.0;2022;23;NICE;MASCULIN;SCOLAIRE;BAC PROFESSIONNEL;BAC PRO PROD;BAC PRO 23005 TECHN. ETUDES BAT B ASSIST.ARCHI.;27;27;18;8;1;1;0;19;0;0;4;4;11;8
13978.0;2022;23;NICE;MASCULIN;SCOLAIRE;BAC PROFESSIONNEL;BAC PRO PROD;BAC PRO 23102 TRAVAUX PUBLICS;19;19;12;5;2;2;0;14;0;2;2;7;3;5
13989.0;2022;23;NICE;MASCULIN;SCOLAIRE;BAC PROFESSIONNEL;BAC PRO PROD;BAC PRO 24302 METIERS DU CUIR : MAROQUINERIE;1;1;1;0;0;0;0;1;0;1;0;0;0;0
13991.0;2022;23;NICE;MASCULIN;SCOLAIRE;BAC PROFESSIONNEL;BAC PRO PROD;BAC PRO 25007 MAINTENANCE EQUIPEMENTS INDUST.;122;122;80;35;7;7;0;87;0;3;13;24;47;35
13998.0;2022;23;NICE;MASCULIN;SCOLAIRE;BAC PROFESSIONNEL;BAC PRO PROD;BAC PRO 25220 MAINT.MATERIELS OPT.B TP MANUT.;16;16;11;5;0;0;0;11;0;1;3;3;4;5
13999.0;2022;23;NICE;MASCULIN;SCOLAIRE;BAC PROFESSIONNEL;BAC PRO PROD;BAC PRO 25406 OUVRAGES DU BATIMENT METALLERIE;11;11;8;2;1;1;0;9;0;3;0;0;6;2
14006.0;2022;23;NICE;MASCULIN;SCOLAIRE;BAC PROFESSIONNEL;BAC PRO PROD;BAC PRO 25515 SYST.NUM.OPT.C RES.INF.SYST.COMM.;101;101;81;16;4;4;0;85;0;5;29;31;20;16
14007.0;2022;23;NICE;MASCULIN;SCOLAIRE;BAC PROFESSIONNEL;BAC PRO PROD;BAC PRO AG 21004 CGEA;9;8;8;0;0;0;0;8;0;1;1;3;3;0
14008.0;2022;23;NICE;MASCULIN;SCOLAIRE;BAC PROFESSIONNEL;BAC PRO PROD;BAC PRO AG 21113 CGEVV;19;18;12;6;0;0;0;12;0;0;2;3;7;6
14025.0;2022;23;NICE;MASCULIN;SCOLAIRE;BAC PROFESSIONNEL;BAC PRO SERV;BAC PRO 33004 ACC.SOINS-S.PERS. OPT.EN STRUCTUR;14;14;13;0;1;0;1;13;0;0;3;7;3;1
14028.0;2022;23;NICE;MASCULIN;SCOLAIRE;BAC PROFESSIONNEL;BAC PRO SERV;BAC PRO 33603 ESTHETIQUE COSMETIQUE PARFUMERIE;1;1;1;0;0;0;0;1;0;0;1;0;0;0
14031.0;2022;23;NICE;MASCULIN;SCOLAIRE;BAC PROFESSIONNEL;BAC PRO SERV;BAC PRO AG 33002 SERV PERS TERRIT;11;11;11;0;0;0;0;11;0;0;1;3;7;0
14040.0;2022;23;NICE;MASCULIN;SCOLAIRE;BAC TECHNOLOGIQUE;BAC STI2D;BAC STI2D SYSTÈME D'INFORMATION  ET NUMERIQUE;258;258;225;7;26;12;14;237;0;7;37;81;112;21
14044.0;2022;23;NICE;MASCULIN;SCOLAIRE;BAC TECHNOLOGIQUE;BAC STMG;BAC STMG MERCATIQUE (MARKETING);573;573;417;39;117;79;38;496;1;5;40;139;311;77
14046.0;2022;23;NICE;MASCULIN;SCOLAIRE;BAC TECHNOLOGIQUE;BAC STMG;BAC STMG SYSTEMES D'INFORMATION DE GESTION;16;16;12;0;4;3;1;15;0;0;1;8;6;1
14049.0;2022;70;NORMANDIE;FEMININ;APPRENTISSAGE;BAC PROFESSIONNEL;BAC PRO PROD;BAC PRO 22105 BOULANGER-PÂTISSIER;2;2;2;0;0;0;0;2;0;0;1;1;0;0
14063.0;2022;70;NORMANDIE;FEMININ;APPRENTISSAGE;BAC PROFESSIONNEL;BAC PRO PROD;BAC PRO AG 21203 TECHN CONSEIL DE VENTE ANIMAL;13;13;13;0;0;0;0;13;0;0;1;7;5;0
14074.0;2022;70;NORMANDIE;FEMININ;APPRENTISSAGE;BAC PROFESSIONNEL;BAC PRO SERV;BAC PRO 33403 COMMERC. SERVICES EN RESTAURATION;10;9;6;3;0;0;0;6;0;1;1;2;2;3
14082.0;2022;70;NORMANDIE;FEMININ;ENSEIGNEMENT A DISTANCE;BAC TECHNOLOGIQUE;BAC STMG;BAC STMG GESTION ET FINANCE;2;2;2;0;0;0;0;2;0;0;0;1;1;0
14094.0;2022;70;NORMANDIE;FEMININ;FORMATION CONTINUE;BAC PROFESSIONNEL;BAC PRO SERV;BAC PRO 30001 GESTION-ADMINISTRATION;53;53;51;1;1;1;0;52;0;12;24;12;4;1
14098.0;2022;70;NORMANDIE;FEMININ;FORMATION CONTINUE;BAC PROFESSIONNEL;BAC PRO SERV;BAC PRO 32304 PHOTOGRAPHIE;1;1;1;0;0;0;0;1;0;0;0;1;0;0
14103.0;2022;70;NORMANDIE;FEMININ;INDIVIDUEL;BAC PROFESSIONNEL;BAC PRO PROD;BAC PRO AG 21001 AGRO-EQUIPEMENT;1;1;0;1;0;0;0;0;0;0;0;0;0;1
14106.0;2022;70;NORMANDIE;FEMININ;INDIVIDUEL;BAC PROFESSIONNEL;BAC PRO PROD;BAC PRO AG 21211 COND GEST ENTR HIPPIQUE;5;4;4;0;0;0;0;4;0;0;0;0;4;0
14107.0;2022;70;NORMANDIE;FEMININ;INDIVIDUEL;BAC PROFESSIONNEL;BAC PRO SERV;BAC PRO 30001 GESTION-ADMINISTRATION;12;4;1;2;1;0;1;1;0;0;0;0;1;3
14110.0;2022;70;NORMANDIE;FEMININ;INDIVIDUEL;BAC PROFESSIONNEL;BAC PRO SERV;BAC PRO 31214 MET.COM.VEN.OP.B PR.CL.VA.OF.COM.;1;1;0;1;0;0;0;0;0;0;0;0;0;1
14115.0;2022;70;NORMANDIE;FEMININ;INDIVIDUEL;BAC TECHNOLOGIQUE;BAC STMG;BAC STMG GESTION ET FINANCE;6;5;3;1;1;0;1;3;0;0;0;3;0;2
14116.0;2022;70;NORMANDIE;FEMININ;INDIVIDUEL;BAC TECHNOLOGIQUE;BAC STMG;BAC STMG MERCATIQUE (MARKETING);8;4;0;3;1;1;0;1;0;0;0;0;1;3
14117.0;2022;70;NORMANDIE;FEMININ;INDIVIDUEL;BAC TECHNOLOGIQUE;BAC STMG;BAC STMG RESSOURCES HUMAINES ET COMMUNICATION;6;3;0;2;1;1;0;1;0;0;0;0;1;2
14129.0;2022;70;NORMANDIE;FEMININ;SCOLAIRE;BAC PROFESSIONNEL;BAC PRO PROD;BAC PRO 23005 TECHN. ETUDES BAT B ASSIST.ARCHI.;11;11;10;1;0;0;0;10;0;1;1;4;4;1
14140.0;2022;70;NORMANDIE;FEMININ;SCOLAIRE;BAC PROFESSIONNEL;BAC PRO PROD;BAC PRO 25007 MAINTENANCE EQUIPEMENTS INDUST.;9;9;7;2;0;0;0;7;0;0;2;4;1;2
14149.0;2022;70;NORMANDIE;FEMININ;SCOLAIRE;BAC PROFESSIONNEL;BAC PRO PROD;BAC PRO 25510 METIERS ELECT. ENVIRON. CONNECTES;10;10;8;2;0;0;0;8;0;0;3;2;3;2
14155.0;2022;70;NORMANDIE;FEMININ;SCOLAIRE;BAC PROFESSIONNEL;BAC PRO PROD;BAC PRO AG 21203 TECHN CONSEIL DE VENTE ANIMAL;10;10;10;0;0;0;0;10;0;0;1;4;5;0
14161.0;2022;70;NORMANDIE;FEMININ;SCOLAIRE;BAC PROFESSIONNEL;BAC PRO PROD;BAC PRO AG 21407 TEC CONS VTE UNIVERS JARDINERIE;12;11;10;1;0;0;0;10;0;0;1;2;7;1
14162.0;2022;70;NORMANDIE;FEMININ;SCOLAIRE;BAC PROFESSIONNEL;BAC PRO PROD;BAC PRO AG 22105 LABORATOIRE CONTROLE QUALITE;18;18;17;1;0;0;0;17;0;0;2;4;11;1
14164.0;2022;70;NORMANDIE;FEMININ;SCOLAIRE;BAC PROFESSIONNEL;BAC PRO SERV;BAC PRO 30001 GESTION-ADMINISTRATION;684;684;526;127;31;27;4;553;0;14;90;202;247;131
14168.0;2022;70;NORMANDIE;FEMININ;SCOLAIRE;BAC PROFESSIONNEL;BAC PRO SERV;BAC PRO 31212 METIERS DE L'ACCUEIL;211;211;179;25;7;5;2;184;0;9;51;62;62;27
14169.0;2022;70;NORMANDIE;FEMININ;SCOLAIRE;BAC PROFESSIONNEL;BAC PRO SERV;BAC PRO 31213 MET.COM.VEN.OP.A ANI.GES.ESP.COM.;524;523;451;55;17;12;5;463;0;18;98;165;182;60
14178.0;2022;70;NORMANDIE;FEMININ;SCOLAIRE;BAC PROFESSIONNEL;BAC PRO SERV;BAC PRO 33101 OPTIQUE LUNETTERIE;9;9;6;1;2;1;1;7;0;0;2;0;5;2
14181.0;2022;70;NORMANDIE;FEMININ;SCOLAIRE;BAC PROFESSIONNEL;BAC PRO SERV;BAC PRO 33602 PERRUQUIER POSTICHEUR;15;15;15;0;0;0;0;15;0;6;8;1;0;0
14183.0;2022;70;NORMANDIE;FEMININ;SCOLAIRE;BAC PROFESSIONNEL;BAC PRO SERV;BAC PRO 34304 HYGIENE PROPRETE STERILISATION;67;67;55;5;7;3;4;58;0;5;13;23;17;9
14189.0;2022;70;NORMANDIE;FEMININ;SCOLAIRE;BAC TECHNOLOGIQUE;BAC ST2S;BAC ST2S SCIENCES & TECHNO. SANTE & SOCIAL;836;836;719;20;97;67;30;786;1;20;104;275;386;50
14196.0;2022;70;NORMANDIE;FEMININ;SCOLAIRE;BAC TECHNOLOGIQUE;BAC STI2D;BAC STI2D SYSTÈME D'INFORMATION  ET NUMERIQUE;23;23;18;2;3;3;0;21;0;1;5;5;10;2
14205.0;2022;70;NORMANDIE;MASCULIN;APPRENTISSAGE;BAC PROFESSIONNEL;BAC PRO PROD;BAC PRO 22004 PROC. CHIMIE EAU PAPIERS-CARTONS;18;18;18;0;0;0;0;18;0;16;1;1;0;0
14206.0;2022;70;NORMANDIE;MASCULIN;APPRENTISSAGE;BAC PROFESSIONNEL;BAC PRO PROD;BAC PRO 22105 BOULANGER-PÂTISSIER;4;4;3;0;1;0;1;3;0;0;0;2;1;1
14209.0;2022;70;NORMANDIE;MASCULIN;APPRENTISSAGE;BAC PROFESSIONNEL;BAC PRO PROD;BAC PRO 22704 TECHN. MAINT. SYST.ENERG.CLIMATI;17;17;13;3;1;1;0;14;0;3;4;4;3;3
14219.0;2022;70;NORMANDIE;MASCULIN;APPRENTISSAGE;BAC PROFESSIONNEL;BAC PRO PROD;BAC PRO 25106 TECHNICIEN D'USINAGE;21;21;19;2;0;0;0;19;0;4;6;3;6;2
14234.0;2022;70;NORMANDIE;MASCULIN;APPRENTISSAGE;BAC PROFESSIONNEL;BAC PRO PROD;BAC PRO 25515 SYST.NUM.OPT.C RES.INF.SYST.COMM.;2;2;2;0;0;0;0;2;0;0;1;0;1;0
14237.0;2022;70;NORMANDIE;MASCULIN;APPRENTISSAGE;BAC PROFESSIONNEL;BAC PRO PROD;BAC PRO AG 21114 CONDUITE PRODUCTIONS HORTICOLES;6;6;6;0;0;0;0;6;0;0;1;4;1;0
14239.0;2022;70;NORMANDIE;MASCULIN;APPRENTISSAGE;BAC PROFESSIONNEL;BAC PRO PROD;BAC PRO AG 21204 PROD-AQUACOLES;3;3;3;0;0;0;0;3;0;0;0;1;2;0
14248.0;2022;70;NORMANDIE;MASCULIN;APPRENTISSAGE;BAC PROFESSIONNEL;BAC PRO SERV;BAC PRO 31214 MET.COM.VEN.OP.B PR.CL.VA.OF.COM.;7;5;5;0;0;0;0;5;0;0;0;2;3;0
14252.0;2022;70;NORMANDIE;MASCULIN;APPRENTISSAGE;BAC PROFESSIONNEL;BAC PRO SERV;BAC PRO 34305 TECHN.D'INTERV.SUR INSTALL. NUCL.;3;3;3;0;0;0;0;3;0;0;1;2;0;0
14255.0;2022;70;NORMANDIE;MASCULIN;ENSEIGNEMENT A DISTANCE;BAC PROFESSIONNEL;BAC PRO SERV;BAC PRO 30001 GESTION-ADMINISTRATION;2;1;0;1;0;0;0;0;0;0;0;0;0;1
14259.0;2022;70;NORMANDIE;MASCULIN;ENSEIGNEMENT A DISTANCE;BAC TECHNOLOGIQUE;BAC STMG;BAC STMG MERCATIQUE (MARKETING);3;3;2;1;0;0;0;2;0;0;0;1;1;1
14285.0;2022;70;NORMANDIE;MASCULIN;INDIVIDUEL;BAC PROFESSIONNEL;BAC PRO PROD;BAC PRO 22004 PROC. CHIMIE EAU PAPIERS-CARTONS;3;3;1;2;0;0;0;1;0;0;0;0;1;2
14289.0;2022;70;NORMANDIE;MASCULIN;INDIVIDUEL;BAC PROFESSIONNEL;BAC PRO PROD;BAC PRO 25007 MAINTENANCE EQUIPEMENTS INDUST.;3;2;0;2;0;0;0;0;0;0;0;0;0;2
14296.0;2022;70;NORMANDIE;MASCULIN;INDIVIDUEL;BAC PROFESSIONNEL;BAC PRO PROD;BAC PRO AG 21004 CGEA;10;9;5;4;0;0;0;5;0;1;0;0;4;4
14313.0;2022;70;NORMANDIE;MASCULIN;INDIVIDUEL;BAC TECHNOLOGIQUE;BAC STMG;BAC STMG GESTION ET FINANCE;6;1;0;1;0;0;0;0;0;0;0;0;0;1
14320.0;2022;70;NORMANDIE;MASCULIN;SCOLAIRE;BAC PROFESSIONNEL;BAC PRO PROD;BAC PRO 22004 PROC. CHIMIE EAU PAPIERS-CARTONS;53;53;42;10;1;1;0;43;0;2;8;20;13;10
14327.0;2022;70;NORMANDIE;MASCULIN;SCOLAIRE;BAC PROFESSIONNEL;BAC PRO PROD;BAC PRO 23003 ARTIS. & M.ART:MARCHANDISAGE VIS.;1;1;1;0;0;0;0;1;0;0;1;0;0;0
14328.0;2022;70;NORMANDIE;MASCULIN;SCOLAIRE;BAC PROFESSIONNEL;BAC PRO PROD;BAC PRO 23004 TECHN. ETUDES BAT.A ETUDES & ECO.;80;80;59;21;0;0;0;59;0;1;13;21;24;21
14329.0;2022;70;NORMANDIE;MASCULIN;SCOLAIRE;BAC PROFESSIONNEL;BAC PRO PROD;BAC PRO 23005 TECHN. ETUDES BAT B ASSIST.ARCHI.;20;20;13;4;3;2;1;15;0;2;1;3;9;5
14335.0;2022;70;NORMANDIE;MASCULIN;SCOLAIRE;BAC PROFESSIONNEL;BAC PRO PROD;BAC PRO 23304 AMENAGEMENT FINITION BATIMENT;19;18;10;6;2;1;1;11;0;1;1;4;5;7
14347.0;2022;70;NORMANDIE;MASCULIN;SCOLAIRE;BAC PROFESSIONNEL;BAC PRO PROD;BAC PRO 25106 TECHNICIEN D'USINAGE;138;138;93;41;4;4;0;97;0;5;14;29;49;41
14349.0;2022;70;NORMANDIE;MASCULIN;SCOLAIRE;BAC PROFESSIONNEL;BAC PRO PROD;BAC PRO 25214 MAINT.VEHIC.OPTA VOIT.PARTICUL.;182;182;135;46;1;1;0;136;0;9;35;54;38;46
14354.0;2022;70;NORMANDIE;MASCULIN;SCOLAIRE;BAC PROFESSIONNEL;BAC PRO PROD;BAC PRO 25221 MAINT.MATERIELS OPT.C ESP. VERTS;9;9;6;3;0;0;0;6;0;0;2;2;2;3
14359.0;2022;70;NORMANDIE;MASCULIN;SCOLAIRE;BAC PROFESSIONNEL;BAC PRO PROD;BAC PRO 25509 TECHNIC. FROID CONDITIONNEMT AIR;80;79;61;16;2;2;0;63;0;1;6;24;32;16
14363.0;2022;70;NORMANDIE;MASCULIN;SCOLAIRE;BAC PROFESSIONNEL;BAC PRO PROD;BAC PRO 25515 SYST.NUM.OPT.C RES.INF.SYST.COMM.;169;169;145;18;6;5;1;150;0;17;32;70;31;19
14366.0;2022;70;NORMANDIE;MASCULIN;SCOLAIRE;BAC PROFESSIONNEL;BAC PRO PROD;BAC PRO AG 21114 CONDUITE PRODUCTIONS HORTICOLES;22;22;20;2;0;0;0;20;0;0;3;8;9;2
14379.0;2022;70;NORMANDIE;MASCULIN;SCOLAIRE;BAC PROFESSIONNEL;BAC PRO SERV;BAC PRO 31107 CONDUCT. TRANSP.ROUT.MARCHANDISES;130;130;109;20;1;1;0;110;0;13;40;44;13;20
14380.0;2022;70;NORMANDIE;MASCULIN;SCOLAIRE;BAC PROFESSIONNEL;BAC PRO SERV;BAC PRO 31108 TRANSPORT;43;40;25;13;2;2;0;27;0;1;2;6;18;13
14394.0;2022;70;NORMANDIE;MASCULIN;SCOLAIRE;BAC PROFESSIONNEL;BAC PRO SERV;BAC PRO 34303 GEST. POLLUTIONS PROTEC. ENVIRON.;3;3;3;0;0;0;0;3;0;0;1;1;1;0
14411.0;2022;70;NORMANDIE;MASCULIN;SCOLAIRE;BAC TECHNOLOGIQUE;BAC STMG;BAC STMG GESTION ET FINANCE;434;434;329;31;74;56;18;385;0;8;48;105;224;49
14420.0;2022;18;ORLEANS-TOURS;FEMININ;APPRENTISSAGE;BAC PROFESSIONNEL;BAC PRO PROD;BAC PRO 25106 TECHNICIEN D'USINAGE;1;1;1;0;0;0;0;1;0;0;1;0;0;0
14421.0;2022;18;ORLEANS-TOURS;FEMININ;APPRENTISSAGE;BAC PROFESSIONNEL;BAC PRO PROD;BAC PRO 25108 TECHNICIEN MODELEUR;1;1;0;1;0;0;0;0;0;0;0;0;0;1
14425.0;2022;18;ORLEANS-TOURS;FEMININ;APPRENTISSAGE;BAC PROFESSIONNEL;BAC PRO PROD;BAC PRO 25411 TECH.CHAUDRONNERIE INDUSTRIELLE;2;2;2;0;0;0;0;2;0;1;0;1;0;0
14426.0;2022;18;ORLEANS-TOURS;FEMININ;APPRENTISSAGE;BAC PROFESSIONNEL;BAC PRO PROD;BAC PRO 25509 TECHNIC. FROID CONDITIONNEMT AIR;1;1;1;0;0;0;0;1;0;0;0;1;0;0
14431.0;2022;18;ORLEANS-TOURS;FEMININ;APPRENTISSAGE;BAC PROFESSIONNEL;BAC PRO PROD;BAC PRO AG 21303 FORET;1;1;1;0;0;0;0;1;0;0;0;0;1;0
14432.0;2022;18;ORLEANS-TOURS;FEMININ;APPRENTISSAGE;BAC PROFESSIONNEL;BAC PRO PROD;BAC PRO AG 21405 AMENAGEMENTS PAYSAGERS;4;4;4;0;0;0;0;4;0;1;1;2;0;0
14436.0;2022;18;ORLEANS-TOURS;FEMININ;APPRENTISSAGE;BAC PROFESSIONNEL;BAC PRO SERV;BAC PRO 31106 LOGISTIQUE;2;2;2;0;0;0;0;2;0;1;0;0;1;0
14439.0;2022;18;ORLEANS-TOURS;FEMININ;APPRENTISSAGE;BAC PROFESSIONNEL;BAC PRO SERV;BAC PRO 31214 MET.COM.VEN.OP.B PR.CL.VA.OF.COM.;4;3;1;1;1;1;0;2;0;0;0;0;2;1
14446.0;2022;18;ORLEANS-TOURS;FEMININ;ENSEIGNEMENT A DISTANCE;BAC GENERAL;BAC GENERAL;BAC GENE 10019 BAC GENERAL;57;55;37;6;12;8;4;45;0;2;11;12;20;10
14448.0;2022;18;ORLEANS-TOURS;FEMININ;ENSEIGNEMENT A DISTANCE;BAC TECHNOLOGIQUE;BAC STMG;BAC STMG GESTION ET FINANCE;1;1;0;0;1;0;1;0;0;0;0;0;0;1
14454.0;2022;18;ORLEANS-TOURS;FEMININ;FORMATION CONTINUE;BAC PROFESSIONNEL;BAC PRO PROD;BAC PRO 25007 MAINTENANCE EQUIPEMENTS INDUST.;1;1;1;0;0;0;0;1;0;0;0;1;0;0
14455.0;2022;18;ORLEANS-TOURS;FEMININ;FORMATION CONTINUE;BAC PROFESSIONNEL;BAC PRO PROD;BAC PRO 25302 AERONAUTIQUE OPTION AVIONIQUE;1;1;1;0;0;0;0;1;0;0;0;1;0;0
14460.0;2022;18;ORLEANS-TOURS;FEMININ;FORMATION CONTINUE;BAC PROFESSIONNEL;BAC PRO SERV;BAC PRO 31214 MET.COM.VEN.OP.B PR.CL.VA.OF.COM.;1;1;1;0;0;0;0;1;0;0;0;0;1;0
14463.0;2022;18;ORLEANS-TOURS;FEMININ;INDIVIDUEL;BAC PROFESSIONNEL;BAC PRO PROD;BAC PRO AG 21114 CONDUITE PRODUCTIONS HORTICOLES;8;7;7;0;0;0;0;7;0;0;0;0;7;0
14464.0;2022;18;ORLEANS-TOURS;FEMININ;INDIVIDUEL;BAC PROFESSIONNEL;BAC PRO PROD;BAC PRO AG 21211 COND GEST ENTR HIPPIQUE;8;8;6;2;0;0;0;6;0;0;0;1;5;2
14473.0;2022;18;ORLEANS-TOURS;FEMININ;INDIVIDUEL;BAC TECHNOLOGIQUE;BAC ST2S;BAC ST2S SCIENCES & TECHNO. SANTE & SOCIAL;14;6;1;2;3;2;1;3;0;0;0;0;3;3
14477.0;2022;18;ORLEANS-TOURS;FEMININ;INDIVIDUEL;BAC TECHNOLOGIQUE;BAC STI2D;BAC STI2D INNOVATION TECHNO.  ET ECO CONCEPTION;1;1;0;1;0;0;0;0;0;0;0;0;0;1
14487.0;2022;18;ORLEANS-TOURS;FEMININ;SCOLAIRE;BAC PROFESSIONNEL;BAC PRO PROD;BAC PRO 22105 BOULANGER-PÂTISSIER;18;18;18;0;0;0;0;18;0;4;4;6;4;0
14492.0;2022;18;ORLEANS-TOURS;FEMININ;SCOLAIRE;BAC PROFESSIONNEL;BAC PRO PROD;BAC PRO 22703 TECHN.INSTALL.SYST.ENERG.CLIMATI;1;1;1;0;0;0;0;1;0;0;0;0;1;0
14496.0;2022;18;ORLEANS-TOURS;FEMININ;SCOLAIRE;BAC PROFESSIONNEL;BAC PRO PROD;BAC PRO 23102 TRAVAUX PUBLICS;1;1;1;0;0;0;0;1;0;0;1;0;0;0
14497.0;2022;18;ORLEANS-TOURS;FEMININ;SCOLAIRE;BAC PROFESSIONNEL;BAC PRO PROD;BACPRO 23103 TECHNICIEN GEOMETRE-TOPOGRAPHE;2;2;1;1;0;0;0;1;0;0;0;1;0;1
14502.0;2022;18;ORLEANS-TOURS;FEMININ;SCOLAIRE;BAC PROFESSIONNEL;BAC PRO PROD;BAC PRO 24202 ARTIS.& MET.ART : TAPIS.D'AMEUBL;13;13;12;0;1;0;1;12;0;1;5;4;2;1
14503.0;2022;18;ORLEANS-TOURS;FEMININ;SCOLAIRE;BAC PROFESSIONNEL;BAC PRO PROD;BAC PRO 24203 METIERS DE LA MODE - VÊTEMENT;85;85;74;8;3;3;0;77;0;3;12;37;25;8
14513.0;2022;18;ORLEANS-TOURS;FEMININ;SCOLAIRE;BAC PROFESSIONNEL;BAC PRO PROD;BAC PRO 25411 TECH.CHAUDRONNERIE INDUSTRIELLE;4;4;3;1;0;0;0;3;0;0;0;2;1;1
14517.0;2022;18;ORLEANS-TOURS;FEMININ;SCOLAIRE;BAC PROFESSIONNEL;BAC PRO PROD;BAC PRO 25515 SYST.NUM.OPT.C RES.INF.SYST.COMM.;8;8;7;1;0;0;0;7;0;0;1;3;3;1
14519.0;2022;18;ORLEANS-TOURS;FEMININ;SCOLAIRE;BAC PROFESSIONNEL;BAC PRO PROD;BAC PRO AG 21113 CGEVV;2;2;2;0;0;0;0;2;0;0;0;0;2;0
14526.0;2022;18;ORLEANS-TOURS;FEMININ;SCOLAIRE;BAC PROFESSIONNEL;BAC PRO PROD;BAC PRO AG 21405 AMENAGEMENTS PAYSAGERS;8;8;6;2;0;0;0;6;0;0;0;3;3;2
14533.0;2022;18;ORLEANS-TOURS;FEMININ;SCOLAIRE;BAC PROFESSIONNEL;BAC PRO SERV;BAC PRO 31107 CONDUCT. TRANSP.ROUT.MARCHANDISES;10;10;8;2;0;0;0;8;0;0;4;4;0;2
14537.0;2022;18;ORLEANS-TOURS;FEMININ;SCOLAIRE;BAC PROFESSIONNEL;BAC PRO SERV;BAC PRO 31214 MET.COM.VEN.OP.B PR.CL.VA.OF.COM.;141;141;118;21;2;2;0;120;0;9;22;51;38;21
14544.0;2022;18;ORLEANS-TOURS;FEMININ;SCOLAIRE;BAC PROFESSIONNEL;BAC PRO SERV;BAC PRO 33004 ACC.SOINS-S.PERS. OPT.EN STRUCTUR;458;458;420;24;14;9;5;429;0;32;130;165;102;29
14548.0;2022;18;ORLEANS-TOURS;FEMININ;SCOLAIRE;BAC PROFESSIONNEL;BAC PRO SERV;BAC PRO 34304 HYGIENE PROPRETE STERILISATION;9;9;6;2;1;1;0;7;0;0;0;2;5;2
14550.0;2022;18;ORLEANS-TOURS;FEMININ;SCOLAIRE;BAC PROFESSIONNEL;BAC PRO SERV;BAC PRO AG 33002 SERV PERS TERRIT;259;254;231;23;0;0;0;231;0;2;27;72;130;23
14556.0;2022;18;ORLEANS-TOURS;FEMININ;SCOLAIRE;BAC TECHNOLOGIQUE;BAC STHR;BAC STHR SC.&TEC. HOTELLERIE-RESTAURATION;57;57;53;2;2;2;0;55;1;3;14;24;13;2
14558.0;2022;18;ORLEANS-TOURS;FEMININ;SCOLAIRE;BAC TECHNOLOGIQUE;BAC STI2D;BAC STI2D ENERGIES  ET ENVIRONNEMENT;10;10;9;0;1;1;0;10;0;0;0;4;6;0
14571.0;2022;18;ORLEANS-TOURS;MASCULIN;APPRENTISSAGE;BAC PROFESSIONNEL;BAC PRO PROD;BAC PRO 23102 TRAVAUX PUBLICS;23;22;20;1;1;1;0;21;0;0;4;7;10;1
14573.0;2022;18;ORLEANS-TOURS;MASCULIN;APPRENTISSAGE;BAC PROFESSIONNEL;BAC PRO PROD;BAC PRO 23205 INTERV. SUR PATRIMOINE BATI OPT.A;5;5;3;2;0;0;0;3;0;0;0;2;1;2
14581.0;2022;18;ORLEANS-TOURS;MASCULIN;APPRENTISSAGE;BAC PROFESSIONNEL;BAC PRO PROD;BAC PRO 25214 MAINT.VEHIC.OPTA VOIT.PARTICUL.;143;143;109;31;3;3;0;112;0;11;15;39;47;31
14582.0;2022;18;ORLEANS-TOURS;MASCULIN;APPRENTISSAGE;BAC PROFESSIONNEL;BAC PRO PROD;BAC PRO 25215 MAINT.VEHIC.OPTB VEHIC.TRANS.ROUT;13;13;10;1;2;2;0;12;0;0;0;2;10;1
14583.0;2022;18;ORLEANS-TOURS;MASCULIN;APPRENTISSAGE;BAC PROFESSIONNEL;BAC PRO PROD;BAC PRO 25219 MAINT.MATERIELS OPT.A AGRICOLES;56;56;49;3;4;2;2;51;0;3;11;23;14;5
14587.0;2022;18;ORLEANS-TOURS;MASCULIN;APPRENTISSAGE;BAC PROFESSIONNEL;BAC PRO PROD;BAC PRO 25408 REPARATION DES CARROSSERIES;24;24;20;3;1;1;0;21;0;0;3;8;10;3
14589.0;2022;18;ORLEANS-TOURS;MASCULIN;APPRENTISSAGE;BAC PROFESSIONNEL;BAC PRO PROD;BAC PRO 25411 TECH.CHAUDRONNERIE INDUSTRIELLE;21;21;21;0;0;0;0;21;0;1;3;10;7;0
14591.0;2022;18;ORLEANS-TOURS;MASCULIN;APPRENTISSAGE;BAC PROFESSIONNEL;BAC PRO PROD;BAC PRO 25510 METIERS ELECT. ENVIRON. CONNECTES;62;61;52;3;6;4;2;56;0;6;6;16;28;5
14595.0;2022;18;ORLEANS-TOURS;MASCULIN;APPRENTISSAGE;BAC PROFESSIONNEL;BAC PRO PROD;BAC PRO AG 21001 AGRO-EQUIPEMENT;11;10;9;1;0;0;0;9;0;0;0;0;9;1
14601.0;2022;18;ORLEANS-TOURS;MASCULIN;APPRENTISSAGE;BAC PROFESSIONNEL;BAC PRO PROD;BAC PRO AG 21303 FORET;12;12;8;4;0;0;0;8;0;0;0;4;4;4
14615.0;2022;18;ORLEANS-TOURS;MASCULIN;APPRENTISSAGE;BAC PROFESSIONNEL;BAC PRO SERV;BAC PRO AG 33002 SERV PERS TERRIT;2;1;1;0;0;0;0;1;0;0;1;0;0;0
14617.0;2022;18;ORLEANS-TOURS;MASCULIN;ENSEIGNEMENT A DISTANCE;BAC TECHNOLOGIQUE;BAC STMG;BAC STMG GESTION ET FINANCE;1;1;0;1;0;0;0;0;0;0;0;0;0;1
14619.0;2022;18;ORLEANS-TOURS;MASCULIN;ENSEIGNEMENT A DISTANCE;BAC TECHNOLOGIQUE;BAC STMG;BAC STMG SYSTEMES D'INFORMATION DE GESTION;1;1;1;0;0;0;0;1;0;0;0;1;0;0
14624.0;2022;18;ORLEANS-TOURS;MASCULIN;FORMATION CONTINUE;BAC PROFESSIONNEL;BAC PRO PROD;BAC PRO 25302 AERONAUTIQUE OPTION AVIONIQUE;10;10;10;0;0;0;0;10;0;1;3;5;1;0
14626.0;2022;18;ORLEANS-TOURS;MASCULIN;FORMATION CONTINUE;BAC PROFESSIONNEL;BAC PRO PROD;BAC PRO 25408 REPARATION DES CARROSSERIES;2;2;2;0;0;0;0;2;0;1;0;1;0;0
14629.0;2022;18;ORLEANS-TOURS;MASCULIN;FORMATION CONTINUE;BAC PROFESSIONNEL;BAC PRO PROD;BAC PRO 25510 METIERS ELECT. ENVIRON. CONNECTES;1;1;1;0;0;0;0;1;0;1;0;0;0;0
14630.0;2022;18;ORLEANS-TOURS;MASCULIN;FORMATION CONTINUE;BAC PROFESSIONNEL;BAC PRO PROD;BAC PRO AG 21405 AMENAGEMENTS PAYSAGERS;9;9;9;0;0;0;0;9;0;0;1;0;8;0
14636.0;2022;18;ORLEANS-TOURS;MASCULIN;INDIVIDUEL;BAC PROFESSIONNEL;BAC PRO PROD;BAC PRO 23408 Etude et réalisation d'agencement;1;1;0;1;0;0;0;0;0;0;0;0;0;1
14646.0;2022;18;ORLEANS-TOURS;MASCULIN;INDIVIDUEL;BAC PROFESSIONNEL;BAC PRO SERV;BAC PRO 31108 TRANSPORT;2;2;2;0;0;0;0;2;0;0;0;1;1;0
14648.0;2022;18;ORLEANS-TOURS;MASCULIN;INDIVIDUEL;BAC PROFESSIONNEL;BAC PRO SERV;BAC PRO 31213 MET.COM.VEN.OP.A ANI.GES.ESP.COM.;6;3;1;2;0;0;0;1;0;0;0;1;0;2
14657.0;2022;18;ORLEANS-TOURS;MASCULIN;INDIVIDUEL;BAC TECHNOLOGIQUE;BAC STMG;BAC STMG GESTION ET FINANCE;3;1;0;1;0;0;0;0;0;0;0;0;0;1
14666.0;2022;18;ORLEANS-TOURS;MASCULIN;SCOLAIRE;BAC PROFESSIONNEL;BAC PRO PROD;BAC PRO 22106 CUISINE;119;119;102;16;1;1;0;103;0;7;29;34;33;16
14668.0;2022;18;ORLEANS-TOURS;MASCULIN;SCOLAIRE;BAC PROFESSIONNEL;BAC PRO PROD;BAC PRO 22403 ARTS.& MET.ART:MET.ENSEIGN SIGNA;8;8;7;1;0;0;0;7;0;1;4;1;1;1
14670.0;2022;18;ORLEANS-TOURS;MASCULIN;SCOLAIRE;BAC PROFESSIONNEL;BAC PRO PROD;BAC PRO 22703 TECHN.INSTALL.SYST.ENERG.CLIMATI;23;23;15;7;1;1;0;16;0;0;3;5;8;7
14673.0;2022;18;ORLEANS-TOURS;MASCULIN;SCOLAIRE;BAC PROFESSIONNEL;BAC PRO PROD;BAC PRO 23004 TECHN. ETUDES BAT.A ETUDES & ECO.;35;35;24;10;1;1;0;25;0;0;3;12;10;10
14675.0;2022;18;ORLEANS-TOURS;MASCULIN;SCOLAIRE;BAC PROFESSIONNEL;BAC PRO PROD;BAC PRO 23102 TRAVAUX PUBLICS;8;8;6;2;0;0;0;6;0;0;0;2;4;2
14676.0;2022;18;ORLEANS-TOURS;MASCULIN;SCOLAIRE;BAC PROFESSIONNEL;BAC PRO PROD;BACPRO 23103 TECHNICIEN GEOMETRE-TOPOGRAPHE;19;19;14;5;0;0;0;14;0;1;3;2;8;5
14682.0;2022;18;ORLEANS-TOURS;MASCULIN;SCOLAIRE;BAC PROFESSIONNEL;BAC PRO PROD;BAC PRO 23404 TECHNICIEN CONSTRUCTEUR BOIS;5;5;3;2;0;0;0;3;0;0;0;1;2;2
14687.0;2022;18;ORLEANS-TOURS;MASCULIN;SCOLAIRE;BAC PROFESSIONNEL;BAC PRO PROD;BAC PRO 24302 METIERS DU CUIR : MAROQUINERIE;7;7;7;0;0;0;0;7;0;1;1;2;3;0
14690.0;2022;18;ORLEANS-TOURS;MASCULIN;SCOLAIRE;BAC PROFESSIONNEL;BAC PRO PROD;BAC PRO 25007 MAINTENANCE EQUIPEMENTS INDUST.;202;202;140;54;8;5;3;145;0;6;30;51;58;57
14694.0;2022;18;ORLEANS-TOURS;MASCULIN;SCOLAIRE;BAC PROFESSIONNEL;BAC PRO PROD;BAC PRO 25214 MAINT.VEHIC.OPTA VOIT.PARTICUL.;196;196;131;57;8;6;2;137;0;9;28;51;49;59
14700.0;2022;18;ORLEANS-TOURS;MASCULIN;SCOLAIRE;BAC PROFESSIONNEL;BAC PRO PROD;BAC PRO 25406 OUVRAGES DU BATIMENT METALLERIE;8;8;8;0;0;0;0;8;0;0;2;3;3;0
14704.0;2022;18;ORLEANS-TOURS;MASCULIN;SCOLAIRE;BAC PROFESSIONNEL;BAC PRO PROD;BAC PRO 25509 TECHNIC. FROID CONDITIONNEMT AIR;27;27;17;6;4;4;0;21;0;0;5;2;14;6
14708.0;2022;18;ORLEANS-TOURS;MASCULIN;SCOLAIRE;BAC PROFESSIONNEL;BAC PRO PROD;BAC PRO 25515 SYST.NUM.OPT.C RES.INF.SYST.COMM.;192;191;168;19;4;4;0;172;0;12;44;61;55;19
14713.0;2022;18;ORLEANS-TOURS;MASCULIN;SCOLAIRE;BAC PROFESSIONNEL;BAC PRO PROD;BAC PRO AG 21203 TECHN CONSEIL DE VENTE ANIMAL;23;23;22;1;0;0;0;22;0;0;3;3;16;1
14720.0;2022;18;ORLEANS-TOURS;MASCULIN;SCOLAIRE;BAC PROFESSIONNEL;BAC PRO PROD;BAC PRO AG 22105 LABORATOIRE CONTROLE QUALITE;7;7;5;2;0;0;0;5;0;0;1;1;3;2
14728.0;2022;18;ORLEANS-TOURS;MASCULIN;SCOLAIRE;BAC PROFESSIONNEL;BAC PRO SERV;BAC PRO 31213 MET.COM.VEN.OP.A ANI.GES.ESP.COM.;300;298;230;47;21;14;7;244;0;6;32;101;105;54
14739.0;2022;18;ORLEANS-TOURS;MASCULIN;SCOLAIRE;BAC PROFESSIONNEL;BAC PRO SERV;BAC PRO 34304 HYGIENE PROPRETE STERILISATION;4;4;2;2;0;0;0;2;0;0;0;1;1;2
14753.0;2022;18;ORLEANS-TOURS;MASCULIN;SCOLAIRE;BAC TECHNOLOGIQUE;BAC STL;BAC STL BIOCHIM.-BIOLOGIE-BIOTECHNOL.;83;83;73;0;10;6;4;79;0;6;17;16;40;4
14766.0;2022;01;PARIS;FEMININ;APPRENTISSAGE;BAC PROFESSIONNEL;BAC PRO SERV;BAC PRO 30001 GESTION-ADMINISTRATION;45;41;35;5;1;1;0;36;0;4;5;9;18;5
14776.0;2022;01;PARIS;FEMININ;APPRENTISSAGE;BAC PROFESSIONNEL;BAC PRO SERV;BAC PRO 33403 COMMERC. SERVICES EN RESTAURATION;26;26;22;2;2;2;0;24;0;0;8;6;10;2
14778.0;2022;01;PARIS;FEMININ;ENSEIGNEMENT A DISTANCE;BAC GENERAL;BAC GENERAL;BAC GENE 10019 BAC GENERAL;36;35;30;3;2;1;1;31;1;5;11;8;6;4
14779.0;2022;01;PARIS;FEMININ;ENSEIGNEMENT A DISTANCE;BAC PROFESSIONNEL;BAC PRO SERV;BAC PRO 30001 GESTION-ADMINISTRATION;3;3;1;2;0;0;0;1;0;0;0;0;1;2
14786.0;2022;01;PARIS;FEMININ;ENSEIGNEMENT A DISTANCE;BAC TECHNOLOGIQUE;BAC STMG;BAC STMG MERCATIQUE (MARKETING);2;2;2;0;0;0;0;2;0;0;0;1;1;0
14787.0;2022;01;PARIS;FEMININ;ENSEIGNEMENT A DISTANCE;BAC TECHNOLOGIQUE;BAC STMG;BAC STMG RESSOURCES HUMAINES ET COMMUNICATION;6;6;4;1;1;1;0;5;0;0;1;1;3;1
14798.0;2022;01;PARIS;FEMININ;INDIVIDUEL;BAC PROFESSIONNEL;BAC PRO PROD;BAC PRO AG 21004 CGEA;4;2;2;0;0;0;0;2;0;0;0;0;2;0
14800.0;2022;01;PARIS;FEMININ;INDIVIDUEL;BAC PROFESSIONNEL;BAC PRO PROD;BAC PRO AG 21211 COND GEST ENTR HIPPIQUE;1;1;1;0;0;0;0;1;0;0;0;0;1;0
14806.0;2022;01;PARIS;FEMININ;INDIVIDUEL;BAC PROFESSIONNEL;BAC PRO SERV;BAC PRO 32207 REAL.PR.IMPR.PLURI.OPTA.PR.GRAPH.;1;1;0;1;0;0;0;0;0;0;0;0;0;1
14807.0;2022;01;PARIS;FEMININ;INDIVIDUEL;BAC PROFESSIONNEL;BAC PRO SERV;BAC PRO 33002 SERVICES DE PROXIMITE  VIE LOCAL;1;1;1;0;0;0;0;1;0;1;0;0;0;0
14816.0;2022;01;PARIS;FEMININ;INDIVIDUEL;BAC TECHNOLOGIQUE;BAC STMG;BAC STMG MERCATIQUE (MARKETING);60;54;29;9;16;9;7;38;0;1;3;12;22;16
14831.0;2022;01;PARIS;FEMININ;SCOLAIRE;BAC PROFESSIONNEL;BAC PRO PROD;BAC PRO 23408 Etude et réalisation d'agencement;4;4;4;0;0;0;0;4;0;1;1;1;1;0
14837.0;2022;01;PARIS;FEMININ;SCOLAIRE;BAC PROFESSIONNEL;BAC PRO PROD;BAC PRO 25510 METIERS ELECT. ENVIRON. CONNECTES;1;1;1;0;0;0;0;1;0;0;0;1;0;0
14845.0;2022;01;PARIS;FEMININ;SCOLAIRE;BAC PROFESSIONNEL;BAC PRO SERV;BAC PRO 31212 METIERS DE L'ACCUEIL;180;180;145;22;13;7;6;152;0;8;33;66;45;28
14847.0;2022;01;PARIS;FEMININ;SCOLAIRE;BAC PROFESSIONNEL;BAC PRO SERV;BAC PRO 31214 MET.COM.VEN.OP.B PR.CL.VA.OF.COM.;42;42;34;5;3;3;0;37;0;3;11;8;15;5
14852.0;2022;01;PARIS;FEMININ;SCOLAIRE;BAC PROFESSIONNEL;BAC PRO SERV;BAC PRO 32304 PHOTOGRAPHIE;19;18;12;6;0;0;0;12;0;1;1;5;5;6
14856.0;2022;01;PARIS;FEMININ;SCOLAIRE;BAC PROFESSIONNEL;BAC PRO SERV;BAC PRO 33101 OPTIQUE LUNETTERIE;4;4;4;0;0;0;0;4;0;0;1;1;2;0
14858.0;2022;01;PARIS;FEMININ;SCOLAIRE;BAC PROFESSIONNEL;BAC PRO SERV;BAC PRO 33103 TECHNICIEN APPAREIL. ORTHOPEDIQUE;6;6;6;0;0;0;0;6;0;0;2;2;2;0
14860.0;2022;01;PARIS;FEMININ;SCOLAIRE;BAC PROFESSIONNEL;BAC PRO SERV;BAC PRO 33602 PERRUQUIER POSTICHEUR;9;9;9;0;0;0;0;9;0;2;2;3;2;0
14864.0;2022;01;PARIS;FEMININ;SCOLAIRE;BAC TECHNOLOGIQUE;BAC S2TMD;BAC S2TMD DANSE;13;13;13;0;0;0;0;13;0;1;5;5;2;0
14869.0;2022;01;PARIS;FEMININ;SCOLAIRE;BAC TECHNOLOGIQUE;BAC STI2D;BAC STI2D ARCHITECTURE ET CONSTRUCTION;15;15;14;0;1;1;0;15;0;0;2;8;5;0
14873.0;2022;01;PARIS;FEMININ;SCOLAIRE;BAC TECHNOLOGIQUE;BAC STL;BAC STL BIOCHIM.-BIOLOGIE-BIOTECHNOL.;57;57;50;2;5;2;3;52;0;1;9;18;24;5
14874.0;2022;01;PARIS;FEMININ;SCOLAIRE;BAC TECHNOLOGIQUE;BAC STL;BAC STL SCIENCES PHYSIQUES CHIMIQUES  EN LABORAT.;27;27;21;3;3;3;0;24;0;0;6;7;11;3
14875.0;2022;01;PARIS;FEMININ;SCOLAIRE;BAC TECHNOLOGIQUE;BAC STMG;BAC STMG GESTION ET FINANCE;174;174;160;6;8;6;2;166;0;10;52;64;40;8
14884.0;2022;01;PARIS;MASCULIN;APPRENTISSAGE;BAC PROFESSIONNEL;BAC PRO PROD;BAC PRO 23004 TECHN. ETUDES BAT.A ETUDES & ECO.;16;14;11;3;0;0;0;11;0;0;1;7;3;3
14889.0;2022;01;PARIS;MASCULIN;APPRENTISSAGE;BAC PROFESSIONNEL;BAC PRO PROD;BAC PRO 25509 TECHNIC. FROID CONDITIONNEMT AIR;21;20;18;1;1;0;1;18;0;4;1;8;5;2
14892.0;2022;01;PARIS;MASCULIN;APPRENTISSAGE;BAC PROFESSIONNEL;BAC PRO SERV;BAC PRO 31209 POISSONIER ECAILLER TRAITEUR;11;9;8;1;0;0;0;8;0;0;0;4;4;1
14896.0;2022;01;PARIS;MASCULIN;APPRENTISSAGE;BAC PROFESSIONNEL;BAC PRO SERV;BAC PRO 32207 REAL.PR.IMPR.PLURI.OPTA.PR.GRAPH.;16;16;15;0;1;1;0;16;0;0;6;6;4;0
14901.0;2022;01;PARIS;MASCULIN;ENSEIGNEMENT A DISTANCE;BAC GENERAL;BAC GENERAL;BAC GENE 10019 BAC GENERAL;24;23;15;6;2;2;0;17;0;3;2;5;7;6
14923.0;2022;01;PARIS;MASCULIN;INDIVIDUEL;BAC PROFESSIONNEL;BAC PRO PROD;BAC PRO 25303 AERONAUTIQUE OPTION SYSTEMES;1;0;0;0;0;0;0;0;0;0;0;0;0;0
14933.0;2022;01;PARIS;MASCULIN;INDIVIDUEL;BAC PROFESSIONNEL;BAC PRO SERV;BAC PRO 32303 ART.& MET.ART:COM.VIS.VIS.PLURI-M;1;1;0;1;0;0;0;0;0;0;0;0;0;1
14942.0;2022;01;PARIS;MASCULIN;INDIVIDUEL;BAC TECHNOLOGIQUE;BAC STMG;BAC STMG GESTION ET FINANCE;5;3;1;1;1;0;1;1;0;0;0;0;1;2
14950.0;2022;01;PARIS;MASCULIN;SCOLAIRE;BAC PROFESSIONNEL;BAC PRO PROD;BAC PRO 22004 PROC. CHIMIE EAU PAPIERS-CARTONS;7;7;5;1;1;1;0;6;0;0;1;3;2;1
14954.0;2022;01;PARIS;MASCULIN;SCOLAIRE;BAC PROFESSIONNEL;BAC PRO PROD;BAC PRO 22703 TECHN.INSTALL.SYST.ENERG.CLIMATI;11;10;7;3;0;0;0;7;0;0;2;2;3;3
14962.0;2022;01;PARIS;MASCULIN;SCOLAIRE;BAC PROFESSIONNEL;BAC PRO PROD;BAC PRO 23303 MENUISERIE ALUMINIUM-VERRE;8;8;6;2;0;0;0;6;0;0;1;2;3;2
14963.0;2022;01;PARIS;MASCULIN;SCOLAIRE;BAC PROFESSIONNEL;BAC PRO PROD;BAC PRO 23304 AMENAGEMENT FINITION BATIMENT;8;8;8;0;0;0;0;8;0;0;1;2;5;0
14964.0;2022;01;PARIS;MASCULIN;SCOLAIRE;BAC PROFESSIONNEL;BAC PRO PROD;BAC PRO 23405 TECHNICIEN MENUISIER AGENCEUR;30;30;28;1;1;0;1;28;0;3;7;10;8;2
14965.0;2022;01;PARIS;MASCULIN;SCOLAIRE;BAC PROFESSIONNEL;BAC PRO PROD;BAC PRO 23407 TECHNIC.FAB.BOIS ET MATERX ASSOC;10;10;9;1;0;0;0;9;0;1;1;6;1;1
14968.0;2022;01;PARIS;MASCULIN;SCOLAIRE;BAC PROFESSIONNEL;BAC PRO PROD;BAC PRO 24203 METIERS DE LA MODE - VÊTEMENT;16;15;14;1;0;0;0;14;0;3;3;5;3;1
14970.0;2022;01;PARIS;MASCULIN;SCOLAIRE;BAC PROFESSIONNEL;BAC PRO PROD;BAC PRO 24302 METIERS DU CUIR : MAROQUINERIE;5;5;5;0;0;0;0;5;0;0;1;3;1;0
14973.0;2022;01;PARIS;MASCULIN;SCOLAIRE;BAC PROFESSIONNEL;BAC PRO PROD;BAC PRO 25106 TECHNICIEN D'USINAGE;7;7;7;0;0;0;0;7;0;0;1;2;4;0
14976.0;2022;01;PARIS;MASCULIN;SCOLAIRE;BAC PROFESSIONNEL;BAC PRO PROD;BAC PRO 25216 MAINT.VEHIC.OPTC MOTOCYCLES;5;5;2;2;1;0;1;2;0;0;1;0;1;3
14982.0;2022;01;PARIS;MASCULIN;SCOLAIRE;BAC PROFESSIONNEL;BAC PRO PROD;BAC PRO 25514 SYST.NUM.OPT.B AUD.RES.EQUIP.DOM.;72;72;61;9;2;2;0;63;0;4;18;21;20;9
14983.0;2022;01;PARIS;MASCULIN;SCOLAIRE;BAC PROFESSIONNEL;BAC PRO PROD;BAC PRO 25515 SYST.NUM.OPT.C RES.INF.SYST.COMM.;174;173;152;18;3;3;0;155;0;8;36;68;43;18
14984.0;2022;01;PARIS;MASCULIN;SCOLAIRE;BAC PROFESSIONNEL;BAC PRO PROD;BAC PRO AG 21405 AMENAGEMENTS PAYSAGERS;25;25;22;3;0;0;0;22;0;3;4;6;9;3
14986.0;2022;01;PARIS;MASCULIN;SCOLAIRE;BAC PROFESSIONNEL;BAC PRO SERV;BAC PRO 30001 GESTION-ADMINISTRATION;281;280;180;92;8;7;1;187;0;6;30;69;82;93
14989.0;2022;01;PARIS;MASCULIN;SCOLAIRE;BAC PROFESSIONNEL;BAC PRO SERV;BAC PRO 31212 METIERS DE L'ACCUEIL;84;84;44;32;8;5;3;49;0;2;10;12;25;35
14991.0;2022;01;PARIS;MASCULIN;SCOLAIRE;BAC PROFESSIONNEL;BAC PRO SERV;BAC PRO 31214 MET.COM.VEN.OP.B PR.CL.VA.OF.COM.;98;97;74;15;8;7;1;81;0;2;8;35;36;16
14995.0;2022;01;PARIS;MASCULIN;SCOLAIRE;BAC PROFESSIONNEL;BAC PRO SERV;BAC PRO 32303 ART.& MET.ART:COM.VIS.VIS.PLURI-M;60;60;50;10;0;0;0;50;0;3;10;17;20;10
14997.0;2022;01;PARIS;MASCULIN;SCOLAIRE;BAC PROFESSIONNEL;BAC PRO SERV;BAC PRO 33002 SERVICES DE PROXIMITE  VIE LOCAL;23;22;18;2;2;0;2;18;0;0;4;2;12;4
14999.0;2022;01;PARIS;MASCULIN;SCOLAIRE;BAC PROFESSIONNEL;BAC PRO SERV;BAC PRO 33004 ACC.SOINS-S.PERS. OPT.EN STRUCTUR;11;11;10;1;0;0;0;10;0;0;2;6;2;1
15006.0;2022;01;PARIS;MASCULIN;SCOLAIRE;BAC PROFESSIONNEL;BAC PRO SERV;BAC PRO 34403 METIERS DE LA SECURITE;59;59;52;3;4;3;1;55;0;3;17;17;18;4
15009.0;2022;01;PARIS;MASCULIN;SCOLAIRE;BAC TECHNOLOGIQUE;BAC ST2S;BAC ST2S SCIENCES & TECHNO. SANTE & SOCIAL;42;42;30;5;7;3;4;33;1;2;4;9;17;9
15012.0;2022;01;PARIS;MASCULIN;SCOLAIRE;BAC TECHNOLOGIQUE;BAC STI2D;BAC STI2D ARCHITECTURE ET CONSTRUCTION;70;70;58;4;8;7;1;65;0;0;8;28;29;5
15021.0;2022;01;PARIS;MASCULIN;SCOLAIRE;BAC TECHNOLOGIQUE;BAC STMG;BAC STMG SYSTEMES D'INFORMATION DE GESTION;102;102;82;7;13;9;4;91;0;1;22;32;36;11
15023.0;2022;13;POITIERS;FEMININ;APPRENTISSAGE;BAC PROFESSIONNEL;BAC PRO PROD;BAC PRO 22106 CUISINE;11;11;8;2;1;0;1;8;0;1;2;2;3;3
15034.0;2022;13;POITIERS;FEMININ;APPRENTISSAGE;BAC PROFESSIONNEL;BAC PRO PROD;BAC PRO AG 21004 CGEA;4;4;4;0;0;0;0;4;0;0;0;0;4;0
15035.0;2022;13;POITIERS;FEMININ;APPRENTISSAGE;BAC PROFESSIONNEL;BAC PRO PROD;BAC PRO AG 21114 CONDUITE PRODUCTIONS HORTICOLES;2;2;2;0;0;0;0;2;0;0;0;1;1;0
15037.0;2022;13;POITIERS;FEMININ;APPRENTISSAGE;BAC PROFESSIONNEL;BAC PRO PROD;BAC PRO AG 21210 COND GEST ENTR CANIN ET FELIN;2;2;2;0;0;0;0;2;0;0;0;1;1;0
15042.0;2022;13;POITIERS;FEMININ;APPRENTISSAGE;BAC PROFESSIONNEL;BAC PRO SERV;BAC PRO 31214 MET.COM.VEN.OP.B PR.CL.VA.OF.COM.;3;2;2;0;0;0;0;2;0;0;0;1;1;0
15050.0;2022;13;POITIERS;FEMININ;ENSEIGNEMENT A DISTANCE;BAC GENERAL;BAC GENERAL;BAC GENE 10019 BAC GENERAL;33;32;18;7;7;5;2;23;0;4;2;4;13;9
15052.0;2022;13;POITIERS;FEMININ;ENSEIGNEMENT A DISTANCE;BAC PROFESSIONNEL;BAC PRO SERV;BAC PRO 31213 MET.COM.VEN.OP.A ANI.GES.ESP.COM.;2;2;1;1;0;0;0;1;0;0;1;0;0;1
15053.0;2022;13;POITIERS;FEMININ;ENSEIGNEMENT A DISTANCE;BAC PROFESSIONNEL;BAC PRO SERV;BAC PRO 31214 MET.COM.VEN.OP.B PR.CL.VA.OF.COM.;3;1;0;1;0;0;0;0;0;0;0;0;0;1
15066.0;2022;13;POITIERS;FEMININ;INDIVIDUEL;BAC PROFESSIONNEL;BAC PRO PROD;BAC PRO 22106 CUISINE;1;0;0;0;0;0;0;0;0;0;0;0;0;0
15067.0;2022;13;POITIERS;FEMININ;INDIVIDUEL;BAC PROFESSIONNEL;BAC PRO PROD;BAC PRO AG 21004 CGEA;4;3;3;0;0;0;0;3;0;0;1;0;2;0
15069.0;2022;13;POITIERS;FEMININ;INDIVIDUEL;BAC PROFESSIONNEL;BAC PRO PROD;BAC PRO AG 21114 CONDUITE PRODUCTIONS HORTICOLES;7;7;7;0;0;0;0;7;0;0;0;0;7;0
15077.0;2022;13;POITIERS;FEMININ;INDIVIDUEL;BAC PROFESSIONNEL;BAC PRO SERV;BAC PRO AG 33002 SERV PERS TERRIT;2;2;1;1;0;0;0;1;0;0;0;0;1;1
15080.0;2022;13;POITIERS;FEMININ;INDIVIDUEL;BAC TECHNOLOGIQUE;BAC STMG;BAC STMG MERCATIQUE (MARKETING);6;2;1;0;1;1;0;2;0;0;0;0;2;0
15086.0;2022;13;POITIERS;FEMININ;SCOLAIRE;BAC PROFESSIONNEL;BAC PRO PROD;BAC PRO 22003 BIO-INDUSTRIES DE TRANSFORMATION;6;6;4;2;0;0;0;4;0;0;1;1;2;2
15087.0;2022;13;POITIERS;FEMININ;SCOLAIRE;BAC PROFESSIONNEL;BAC PRO PROD;BAC PRO 22004 PROC. CHIMIE EAU PAPIERS-CARTONS;2;2;2;0;0;0;0;2;0;0;0;1;1;0
15088.0;2022;13;POITIERS;FEMININ;SCOLAIRE;BAC PROFESSIONNEL;BAC PRO PROD;BAC PRO 22105 BOULANGER-PÂTISSIER;19;19;18;1;0;0;0;18;0;2;7;7;2;1
15090.0;2022;13;POITIERS;FEMININ;SCOLAIRE;BAC PROFESSIONNEL;BAC PRO PROD;BAC PRO 22503 PLASTIQUES ET COMPOSITES;3;3;1;2;0;0;0;1;0;0;1;0;0;2
15099.0;2022;13;POITIERS;FEMININ;SCOLAIRE;BAC PROFESSIONNEL;BAC PRO PROD;BAC PRO 24302 METIERS DU CUIR : MAROQUINERIE;10;10;9;1;0;0;0;9;0;0;5;3;1;1
15102.0;2022;13;POITIERS;FEMININ;SCOLAIRE;BAC PROFESSIONNEL;BAC PRO PROD;BAC PRO 25009 MAINTENANCE NAUTIQUE;1;1;1;0;0;0;0;1;0;0;0;0;1;0
15104.0;2022;13;POITIERS;FEMININ;SCOLAIRE;BAC PROFESSIONNEL;BAC PRO PROD;BAC PRO 25214 MAINT.VEHIC.OPTA VOIT.PARTICUL.;3;3;2;1;0;0;0;2;0;0;0;2;0;1
15116.0;2022;13;POITIERS;FEMININ;SCOLAIRE;BAC PROFESSIONNEL;BAC PRO PROD;BAC PRO AG 21203 TECHN CONSEIL DE VENTE ANIMAL;27;26;25;1;0;0;0;25;0;1;2;9;13;1
15117.0;2022;13;POITIERS;FEMININ;SCOLAIRE;BAC PROFESSIONNEL;BAC PRO PROD;BAC PRO AG 21204 PROD-AQUACOLES;2;2;1;1;0;0;0;1;0;0;0;0;1;1
15124.0;2022;13;POITIERS;FEMININ;SCOLAIRE;BAC PROFESSIONNEL;BAC PRO PROD;BAC PRO AG 22105 LABORATOIRE CONTROLE QUALITE;18;18;17;1;0;0;0;17;0;0;2;5;10;1
15125.0;2022;13;POITIERS;FEMININ;SCOLAIRE;BAC PROFESSIONNEL;BAC PRO PROD;BAC PRO AG 22106 TEC CONS VTE ALIMENTATION VINS SP;7;7;5;2;0;0;0;5;0;0;0;1;4;2
15126.0;2022;13;POITIERS;FEMININ;SCOLAIRE;BAC PROFESSIONNEL;BAC PRO PROD;BAC PRO AG 22107 TEC CONS VTE ALIMENTATION P.ALIM;17;16;13;3;0;0;0;13;0;0;0;3;10;3
15135.0;2022;13;POITIERS;FEMININ;SCOLAIRE;BAC PROFESSIONNEL;BAC PRO SERV;BAC PRO 32208 REAL.PR.IMPR.PLURI.OPTB.PR.IMPR.;2;2;1;1;0;0;0;1;0;0;1;0;0;1
15140.0;2022;13;POITIERS;FEMININ;SCOLAIRE;BAC PROFESSIONNEL;BAC PRO SERV;BAC PRO 33101 OPTIQUE LUNETTERIE;10;10;6;4;0;0;0;6;0;0;1;1;4;4
15141.0;2022;13;POITIERS;FEMININ;SCOLAIRE;BAC PROFESSIONNEL;BAC PRO SERV;BAC PRO 33403 COMMERC. SERVICES EN RESTAURATION;37;37;31;5;1;1;0;32;0;2;7;9;14;5
15142.0;2022;13;POITIERS;FEMININ;SCOLAIRE;BAC PROFESSIONNEL;BAC PRO SERV;BAC PRO 33603 ESTHETIQUE COSMETIQUE PARFUMERIE;84;84;81;3;0;0;0;81;0;2;31;34;14;3
15152.0;2022;13;POITIERS;FEMININ;SCOLAIRE;BAC TECHNOLOGIQUE;BAC STI2D;BAC STI2D INNOVATION TECHNO.  ET ECO CONCEPTION;8;8;6;0;2;1;1;7;0;0;1;1;5;1
15157.0;2022;13;POITIERS;FEMININ;SCOLAIRE;BAC TECHNOLOGIQUE;BAC STMG;BAC STMG MERCATIQUE (MARKETING);473;473;373;25;75;56;19;429;0;2;51;147;229;44
15161.0;2022;13;POITIERS;MASCULIN;APPRENTISSAGE;BAC PROFESSIONNEL;BAC PRO PROD;BAC PRO 22004 PROC. CHIMIE EAU PAPIERS-CARTONS;3;3;3;0;0;0;0;3;0;1;1;1;0;0
15162.0;2022;13;POITIERS;MASCULIN;APPRENTISSAGE;BAC PROFESSIONNEL;BAC PRO PROD;BAC PRO 22106 CUISINE;23;21;19;2;0;0;0;19;0;0;8;3;8;2
15170.0;2022;13;POITIERS;MASCULIN;APPRENTISSAGE;BAC PROFESSIONNEL;BAC PRO PROD;BAC PRO 23407 TECHNIC.FAB.BOIS ET MATERX ASSOC;7;7;3;4;0;0;0;3;0;2;0;0;1;4
15174.0;2022;13;POITIERS;MASCULIN;APPRENTISSAGE;BAC PROFESSIONNEL;BAC PRO PROD;BAC PRO 25214 MAINT.VEHIC.OPTA VOIT.PARTICUL.;112;105;75;16;14;6;8;81;0;3;15;25;38;24
15182.0;2022;13;POITIERS;MASCULIN;APPRENTISSAGE;BAC PROFESSIONNEL;BAC PRO PROD;BAC PRO 25408 REPARATION DES CARROSSERIES;10;10;9;1;0;0;0;9;0;0;2;2;5;1
15186.0;2022;13;POITIERS;MASCULIN;APPRENTISSAGE;BAC PROFESSIONNEL;BAC PRO PROD;BAC PRO 25513 SYST.NUM.OPT.A SURETE SECURITE;2;2;2;0;0;0;0;2;0;0;2;0;0;0
15192.0;2022;13;POITIERS;MASCULIN;APPRENTISSAGE;BAC PROFESSIONNEL;BAC PRO PROD;BAC PRO AG 21303 FORET;3;3;3;0;0;0;0;3;0;0;0;1;2;0
15194.0;2022;13;POITIERS;MASCULIN;APPRENTISSAGE;BAC PROFESSIONNEL;BAC PRO PROD;BAC PRO AG 22107 TEC CONS VTE ALIMENTATION P.ALIM;7;7;6;1;0;0;0;6;0;0;0;3;3;1
15200.0;2022;13;POITIERS;MASCULIN;APPRENTISSAGE;BAC PROFESSIONNEL;BAC PRO SERV;BAC PRO 32207 REAL.PR.IMPR.PLURI.OPTA.PR.GRAPH.;2;2;1;1;0;0;0;1;0;0;0;0;1;1
15205.0;2022;13;POITIERS;MASCULIN;APPRENTISSAGE;BAC PROFESSIONNEL;BAC PRO SERV;BAC PRO AG 33002 SERV PERS TERRIT;4;4;4;0;0;0;0;4;0;0;0;1;3;0
15206.0;2022;13;POITIERS;MASCULIN;ENSEIGNEMENT A DISTANCE;BAC GENERAL;BAC GENERAL;BAC GENE 10019 BAC GENERAL;15;14;11;0;3;0;3;11;0;0;3;3;5;3
15207.0;2022;13;POITIERS;MASCULIN;ENSEIGNEMENT A DISTANCE;BAC PROFESSIONNEL;BAC PRO SERV;BAC PRO 30001 GESTION-ADMINISTRATION;1;1;1;0;0;0;0;1;0;0;0;0;1;0
15208.0;2022;13;POITIERS;MASCULIN;ENSEIGNEMENT A DISTANCE;BAC PROFESSIONNEL;BAC PRO SERV;BAC PRO 31213 MET.COM.VEN.OP.A ANI.GES.ESP.COM.;1;1;0;1;0;0;0;0;0;0;0;0;0;1
15211.0;2022;13;POITIERS;MASCULIN;FORMATION CONTINUE;BAC PROFESSIONNEL;BAC PRO PROD;BAC PRO 22004 PROC. CHIMIE EAU PAPIERS-CARTONS;3;3;3;0;0;0;0;3;0;2;0;1;0;0
15214.0;2022;13;POITIERS;MASCULIN;FORMATION CONTINUE;BAC PROFESSIONNEL;BAC PRO PROD;BAC PRO 25219 MAINT.MATERIELS OPT.A AGRICOLES;1;1;1;0;0;0;0;1;0;0;1;0;0;0
15229.0;2022;13;POITIERS;MASCULIN;INDIVIDUEL;BAC TECHNOLOGIQUE;BAC STMG;BAC STMG SYSTEMES D'INFORMATION DE GESTION;1;1;0;0;1;0;1;0;0;0;0;0;0;1
15230.0;2022;13;POITIERS;MASCULIN;SCOLAIRE;BAC GENERAL;BAC GENERAL;BAC GENE 10019 BAC GENERAL;3961;3961;3590;62;309;226;83;3816;47;406;842;1206;1315;145
15231.0;2022;13;POITIERS;MASCULIN;SCOLAIRE;BAC PROFESSIONNEL;BAC PRO PROD;BACPRO 20002 ETUD.DEFINITION PRDTS INDUSTRIEL;10;10;10;0;0;0;0;10;0;0;0;7;3;0
15232.0;2022;13;POITIERS;MASCULIN;SCOLAIRE;BAC PROFESSIONNEL;BAC PRO PROD;BAC PRO 20102 PILOTE DE LIGNE DE PRODUCTION;20;20;18;1;1;1;0;19;0;1;2;6;10;1
15237.0;2022;13;POITIERS;MASCULIN;SCOLAIRE;BAC PROFESSIONNEL;BAC PRO PROD;BAC PRO 22503 PLASTIQUES ET COMPOSITES;13;13;9;4;0;0;0;9;0;1;2;2;4;4
15239.0;2022;13;POITIERS;MASCULIN;SCOLAIRE;BAC PROFESSIONNEL;BAC PRO PROD;BAC PRO 22704 TECHN. MAINT. SYST.ENERG.CLIMATI;7;6;1;5;0;0;0;1;0;0;0;0;1;5
15259.0;2022;13;POITIERS;MASCULIN;SCOLAIRE;BAC PROFESSIONNEL;BAC PRO PROD;BAC PRO 25215 MAINT.VEHIC.OPTB VEHIC.TRANS.ROUT;17;17;15;1;1;1;0;16;0;0;4;6;6;1
15260.0;2022;13;POITIERS;MASCULIN;SCOLAIRE;BAC PROFESSIONNEL;BAC PRO PROD;BAC PRO 25216 MAINT.VEHIC.OPTC MOTOCYCLES;19;19;16;2;1;1;0;17;0;1;6;5;5;2
15261.0;2022;13;POITIERS;MASCULIN;SCOLAIRE;BAC PROFESSIONNEL;BAC PRO PROD;BAC PRO 25219 MAINT.MATERIELS OPT.A AGRICOLES;12;12;9;3;0;0;0;9;0;2;2;2;3;3
15269.0;2022;13;POITIERS;MASCULIN;SCOLAIRE;BAC PROFESSIONNEL;BAC PRO PROD;BAC PRO 25509 TECHNIC. FROID CONDITIONNEMT AIR;7;7;3;4;0;0;0;3;0;0;0;0;3;4
15270.0;2022;13;POITIERS;MASCULIN;SCOLAIRE;BAC PROFESSIONNEL;BAC PRO PROD;BAC PRO 25510 METIERS ELECT. ENVIRON. CONNECTES;179;179;141;32;6;5;1;146;0;5;20;63;58;33
15282.0;2022;13;POITIERS;MASCULIN;SCOLAIRE;BAC PROFESSIONNEL;BAC PRO PROD;BAC PRO AG 21302 GEST MILIEUX NATURELS FAUNE;80;75;70;5;0;0;0;70;0;1;9;30;30;5
15288.0;2022;13;POITIERS;MASCULIN;SCOLAIRE;BAC PROFESSIONNEL;BAC PRO PROD;BAC PRO AG 22107 TEC CONS VTE ALIMENTATION P.ALIM;14;14;9;5;0;0;0;9;0;0;0;1;8;5
15291.0;2022;13;POITIERS;MASCULIN;SCOLAIRE;BAC PROFESSIONNEL;BAC PRO SERV;BAC PRO 31107 CONDUCT. TRANSP.ROUT.MARCHANDISES;44;44;39;4;1;1;0;40;0;0;13;19;8;4
15296.0;2022;13;POITIERS;MASCULIN;SCOLAIRE;BAC PROFESSIONNEL;BAC PRO SERV;BAC PRO 32207 REAL.PR.IMPR.PLURI.OPTA.PR.GRAPH.;5;4;3;1;0;0;0;3;0;0;1;1;1;1
15297.0;2022;13;POITIERS;MASCULIN;SCOLAIRE;BAC PROFESSIONNEL;BAC PRO SERV;BAC PRO 32208 REAL.PR.IMPR.PLURI.OPTB.PR.IMPR.;6;6;3;3;0;0;0;3;0;1;0;1;1;3
15299.0;2022;13;POITIERS;MASCULIN;SCOLAIRE;BAC PROFESSIONNEL;BAC PRO SERV;BAC PRO 33002 SERVICES DE PROXIMITE  VIE LOCAL;33;33;23;2;8;5;3;28;0;0;4;12;12;5
15308.0;2022;13;POITIERS;MASCULIN;SCOLAIRE;BAC TECHNOLOGIQUE;BAC STAV;BAC STAV AGRONOMIE ALIM ENV TERRITOI;86;86;83;3;0;0;0;83;0;1;11;31;40;3
15314.0;2022;13;POITIERS;MASCULIN;SCOLAIRE;BAC TECHNOLOGIQUE;BAC STI2D;BAC STI2D SYSTÈME D'INFORMATION  ET NUMERIQUE;222;222;183;11;28;17;11;200;0;3;33;92;72;22
15317.0;2022;13;POITIERS;MASCULIN;SCOLAIRE;BAC TECHNOLOGIQUE;BAC STMG;BAC STMG GESTION ET FINANCE;175;175;144;9;22;15;7;159;0;5;20;47;87;16
15320.0;2022;13;POITIERS;MASCULIN;SCOLAIRE;BAC TECHNOLOGIQUE;BAC STMG;BAC STMG SYSTEMES D'INFORMATION DE GESTION;14;14;9;1;4;3;1;12;0;0;2;1;9;2
15325.0;2022;19;REIMS;FEMININ;APPRENTISSAGE;BAC PROFESSIONNEL;BAC PRO PROD;BAC PRO 25214 MAINT.VEHIC.OPTA VOIT.PARTICUL.;3;3;3;0;0;0;0;3;0;0;1;2;0;0
15326.0;2022;19;REIMS;FEMININ;APPRENTISSAGE;BAC PROFESSIONNEL;BAC PRO PROD;BAC PRO 25411 TECH.CHAUDRONNERIE INDUSTRIELLE;1;0;0;0;0;0;0;0;0;0;0;0;0;0
15328.0;2022;19;REIMS;FEMININ;APPRENTISSAGE;BAC PROFESSIONNEL;BAC PRO PROD;BAC PRO AG 21004 CGEA;3;3;1;2;0;0;0;1;0;0;0;0;1;2
15334.0;2022;19;REIMS;FEMININ;APPRENTISSAGE;BAC PROFESSIONNEL;BAC PRO SERV;BAC PRO 31212 METIERS DE L'ACCUEIL;2;2;2;0;0;0;0;2;0;0;0;1;1;0
15335.0;2022;19;REIMS;FEMININ;APPRENTISSAGE;BAC PROFESSIONNEL;BAC PRO SERV;BAC PRO 31213 MET.COM.VEN.OP.A ANI.GES.ESP.COM.;40;38;29;5;4;2;2;31;0;0;5;12;14;7
15337.0;2022;19;REIMS;FEMININ;APPRENTISSAGE;BAC PROFESSIONNEL;BAC PRO SERV;BAC PRO 33102 PROTHESE DENTAIRE;2;2;2;0;0;0;0;2;0;1;1;0;0;0
15340.0;2022;19;REIMS;FEMININ;APPRENTISSAGE;BAC PROFESSIONNEL;BAC PRO SERV;BAC PRO AG 33002 SERV PERS TERRIT;8;7;7;0;0;0;0;7;0;0;2;1;4;0
15341.0;2022;19;REIMS;FEMININ;ENSEIGNEMENT A DISTANCE;BAC GENERAL;BAC GENERAL;BAC GENE 10019 BAC GENERAL;20;20;13;2;5;3;2;16;1;0;2;4;9;4
15342.0;2022;19;REIMS;FEMININ;ENSEIGNEMENT A DISTANCE;BAC PROFESSIONNEL;BAC PRO SERV;BAC PRO 30001 GESTION-ADMINISTRATION;3;2;1;1;0;0;0;1;0;0;0;0;1;1
15345.0;2022;19;REIMS;FEMININ;ENSEIGNEMENT A DISTANCE;BAC PROFESSIONNEL;BAC PRO SERV;BAC PRO 33004 ACC.SOINS-S.PERS. OPT.EN STRUCTUR;3;3;0;3;0;0;0;0;0;0;0;0;0;3
15348.0;2022;19;REIMS;FEMININ;FORMATION CONTINUE;BAC PROFESSIONNEL;BAC PRO PROD;BAC PRO 22106 CUISINE;1;1;0;0;1;1;0;1;0;0;0;0;1;0
15358.0;2022;19;REIMS;FEMININ;INDIVIDUEL;BAC PROFESSIONNEL;BAC PRO PROD;BAC PRO AG 21113 CGEVV;1;1;1;0;0;0;0;1;0;0;0;0;1;0
15359.0;2022;19;REIMS;FEMININ;INDIVIDUEL;BAC PROFESSIONNEL;BAC PRO PROD;BAC PRO AG 21114 CONDUITE PRODUCTIONS HORTICOLES;1;0;0;0;0;0;0;0;0;0;0;0;0;0
15360.0;2022;19;REIMS;FEMININ;INDIVIDUEL;BAC PROFESSIONNEL;BAC PRO PROD;BAC PRO AG 21211 COND GEST ENTR HIPPIQUE;1;1;1;0;0;0;0;1;0;0;0;0;1;0
15367.0;2022;19;REIMS;FEMININ;INDIVIDUEL;BAC TECHNOLOGIQUE;BAC STMG;BAC STMG MERCATIQUE (MARKETING);4;2;2;0;0;0;0;2;0;0;0;0;2;0
15368.0;2022;19;REIMS;FEMININ;INDIVIDUEL;BAC TECHNOLOGIQUE;BAC STMG;BAC STMG RESSOURCES HUMAINES ET COMMUNICATION;8;5;0;4;1;1;0;1;0;0;0;0;1;4
15370.0;2022;19;REIMS;FEMININ;SCOLAIRE;BAC PROFESSIONNEL;BAC PRO PROD;BACPRO 20002 ETUD.DEFINITION PRDTS INDUSTRIEL;1;1;1;0;0;0;0;1;0;0;0;1;0;0
15373.0;2022;19;REIMS;FEMININ;SCOLAIRE;BAC PROFESSIONNEL;BAC PRO PROD;BAC PRO 22105 BOULANGER-PÂTISSIER;12;12;11;0;1;0;1;11;0;1;4;4;2;1
15377.0;2022;19;REIMS;FEMININ;SCOLAIRE;BAC PROFESSIONNEL;BAC PRO PROD;BAC PRO 23005 TECHN. ETUDES BAT B ASSIST.ARCHI.;12;12;9;2;1;1;0;10;0;0;0;5;5;2
15382.0;2022;19;REIMS;FEMININ;SCOLAIRE;BAC PROFESSIONNEL;BAC PRO PROD;BAC PRO 24203 METIERS DE LA MODE - VÊTEMENT;52;52;44;3;5;3;2;47;0;10;7;16;14;5
15383.0;2022;19;REIMS;FEMININ;SCOLAIRE;BAC PROFESSIONNEL;BAC PRO PROD;BAC PRO 25007 MAINTENANCE EQUIPEMENTS INDUST.;4;4;2;2;0;0;0;2;0;0;1;0;1;2
15389.0;2022;19;REIMS;FEMININ;SCOLAIRE;BAC PROFESSIONNEL;BAC PRO PROD;BAC PRO 25513 SYST.NUM.OPT.A SURETE SECURITE;2;2;1;0;1;0;1;1;0;0;0;0;1;1
15390.0;2022;19;REIMS;FEMININ;SCOLAIRE;BAC PROFESSIONNEL;BAC PRO PROD;BAC PRO 25514 SYST.NUM.OPT.B AUD.RES.EQUIP.DOM.;2;2;2;0;0;0;0;2;0;0;1;1;0;0
15391.0;2022;19;REIMS;FEMININ;SCOLAIRE;BAC PROFESSIONNEL;BAC PRO PROD;BAC PRO 25515 SYST.NUM.OPT.C RES.INF.SYST.COMM.;2;2;2;0;0;0;0;2;0;0;0;1;1;0
15399.0;2022;19;REIMS;FEMININ;SCOLAIRE;BAC PROFESSIONNEL;BAC PRO PROD;BAC PRO AG 21303 FORET;1;1;1;0;0;0;0;1;0;0;0;0;1;0
15408.0;2022;19;REIMS;FEMININ;SCOLAIRE;BAC PROFESSIONNEL;BAC PRO SERV;BAC PRO 31212 METIERS DE L'ACCUEIL;69;69;50;16;3;2;1;52;0;0;13;20;19;17
15428.0;2022;19;REIMS;FEMININ;SCOLAIRE;BAC TECHNOLOGIQUE;BAC STAV;BAC STAV AGRONOMIE ALIM ENV TERRITOI;60;60;58;2;0;0;0;58;0;0;10;27;21;2
15431.0;2022;19;REIMS;FEMININ;SCOLAIRE;BAC TECHNOLOGIQUE;BAC STI2D;BAC STI2D ARCHITECTURE ET CONSTRUCTION;20;20;18;0;2;1;1;19;1;1;2;10;5;1
15437.0;2022;19;REIMS;FEMININ;SCOLAIRE;BAC TECHNOLOGIQUE;BAC STMG;BAC STMG GESTION ET FINANCE;127;127;101;6;20;6;14;107;0;3;13;38;53;20
15438.0;2022;19;REIMS;FEMININ;SCOLAIRE;BAC TECHNOLOGIQUE;BAC STMG;BAC STMG MERCATIQUE (MARKETING);329;329;256;23;50;28;22;284;0;6;39;91;148;45
15439.0;2022;19;REIMS;FEMININ;SCOLAIRE;BAC TECHNOLOGIQUE;BAC STMG;BAC STMG RESSOURCES HUMAINES ET COMMUNICATION;309;309;219;21;69;45;24;264;0;3;22;83;156;45
15440.0;2022;19;REIMS;FEMININ;SCOLAIRE;BAC TECHNOLOGIQUE;BAC STMG;BAC STMG SYSTEMES D'INFORMATION DE GESTION;2;2;2;0;0;0;0;2;0;0;0;0;2;0
15444.0;2022;19;REIMS;MASCULIN;APPRENTISSAGE;BAC PROFESSIONNEL;BAC PRO PROD;BAC PRO 22303 FONDERIE;1;1;1;0;0;0;0;1;0;1;0;0;0;0
15453.0;2022;19;REIMS;MASCULIN;APPRENTISSAGE;BAC PROFESSIONNEL;BAC PRO PROD;BAC PRO 25007 MAINTENANCE EQUIPEMENTS INDUST.;30;30;28;2;0;0;0;28;0;2;5;8;13;2
15456.0;2022;19;REIMS;MASCULIN;APPRENTISSAGE;BAC PROFESSIONNEL;BAC PRO PROD;BAC PRO 25214 MAINT.VEHIC.OPTA VOIT.PARTICUL.;48;48;30;13;5;2;3;32;0;2;4;11;15;16
15462.0;2022;19;REIMS;MASCULIN;APPRENTISSAGE;BAC PROFESSIONNEL;BAC PRO PROD;BAC PRO 25408 REPARATION DES CARROSSERIES;6;6;4;2;0;0;0;4;0;0;0;1;3;2
15469.0;2022;19;REIMS;MASCULIN;APPRENTISSAGE;BAC PROFESSIONNEL;BAC PRO PROD;BAC PRO AG 21004 CGEA;22;20;10;10;0;0;0;10;0;0;0;3;7;10
15473.0;2022;19;REIMS;MASCULIN;APPRENTISSAGE;BAC PROFESSIONNEL;BAC PRO SERV;BAC PRO 30001 GESTION-ADMINISTRATION;2;2;1;1;0;0;0;1;0;0;1;0;0;1
15485.0;2022;19;REIMS;MASCULIN;FORMATION CONTINUE;BAC PROFESSIONNEL;BAC PRO PROD;BAC PRO 22106 CUISINE;2;2;2;0;0;0;0;2;0;1;1;0;0;0
15487.0;2022;19;REIMS;MASCULIN;FORMATION CONTINUE;BAC PROFESSIONNEL;BAC PRO PROD;BAC PRO 23304 AMENAGEMENT FINITION BATIMENT;1;1;1;0;0;0;0;1;0;1;0;0;0;0
15492.0;2022;19;REIMS;MASCULIN;INDIVIDUEL;BAC GENERAL;BAC GENERAL;BAC GENE 10019 BAC GENERAL;28;24;12;7;5;3;2;15;0;0;2;2;11;9
15506.0;2022;19;REIMS;MASCULIN;SCOLAIRE;BAC GENERAL;BAC GENERAL;BAC GENE 10019 BAC GENERAL;2741;2741;2422;58;261;175;86;2597;29;278;528;846;916;144
15509.0;2022;19;REIMS;MASCULIN;SCOLAIRE;BAC PROFESSIONNEL;BAC PRO PROD;BAC PRO 22003 BIO-INDUSTRIES DE TRANSFORMATION;5;5;5;0;0;0;0;5;0;0;0;3;2;0
15511.0;2022;19;REIMS;MASCULIN;SCOLAIRE;BAC PROFESSIONNEL;BAC PRO PROD;BAC PRO 22106 CUISINE;69;69;57;11;1;1;0;58;0;9;7;29;13;11
15517.0;2022;19;REIMS;MASCULIN;SCOLAIRE;BAC PROFESSIONNEL;BAC PRO PROD;BAC PRO 23004 TECHN. ETUDES BAT.A ETUDES & ECO.;18;18;12;6;0;0;0;12;0;1;3;4;4;6
15519.0;2022;19;REIMS;MASCULIN;SCOLAIRE;BAC PROFESSIONNEL;BAC PRO PROD;BAC PRO 23102 TRAVAUX PUBLICS;22;22;19;3;0;0;0;19;0;1;4;6;8;3
15522.0;2022;19;REIMS;MASCULIN;SCOLAIRE;BAC PROFESSIONNEL;BAC PRO PROD;BAC PRO 23303 MENUISERIE ALUMINIUM-VERRE;4;4;1;1;2;1;1;2;0;0;0;0;2;2
15528.0;2022;19;REIMS;MASCULIN;SCOLAIRE;BAC PROFESSIONNEL;BAC PRO PROD;BAC PRO 24203 METIERS DE LA MODE - VÊTEMENT;7;7;5;2;0;0;0;5;0;0;1;3;1;2
15529.0;2022;19;REIMS;MASCULIN;SCOLAIRE;BAC PROFESSIONNEL;BAC PRO PROD;BAC PRO 25007 MAINTENANCE EQUIPEMENTS INDUST.;136;136;92;36;8;7;1;99;0;1;20;38;40;37
15530.0;2022;19;REIMS;MASCULIN;SCOLAIRE;BAC PROFESSIONNEL;BAC PRO PROD;BAC PRO 25106 TECHNICIEN D'USINAGE;17;16;11;5;0;0;0;11;0;0;6;2;3;5
15534.0;2022;19;REIMS;MASCULIN;SCOLAIRE;BAC PROFESSIONNEL;BAC PRO PROD;BAC PRO 25219 MAINT.MATERIELS OPT.A AGRICOLES;20;20;14;6;0;0;0;14;0;1;4;5;4;6
15535.0;2022;19;REIMS;MASCULIN;SCOLAIRE;BAC PROFESSIONNEL;BAC PRO PROD;BAC PRO 25220 MAINT.MATERIELS OPT.B TP MANUT.;5;5;3;2;0;0;0;3;0;0;0;2;1;2
15538.0;2022;19;REIMS;MASCULIN;SCOLAIRE;BAC PROFESSIONNEL;BAC PRO PROD;BAC PRO 25411 TECH.CHAUDRONNERIE INDUSTRIELLE;30;30;27;2;1;1;0;28;0;2;2;12;12;2
15539.0;2022;19;REIMS;MASCULIN;SCOLAIRE;BAC PROFESSIONNEL;BAC PRO PROD;BAC PRO 25509 TECHNIC. FROID CONDITIONNEMT AIR;17;17;8;9;0;0;0;8;0;1;2;1;4;9
15541.0;2022;19;REIMS;MASCULIN;SCOLAIRE;BAC PROFESSIONNEL;BAC PRO PROD;BAC PRO 25513 SYST.NUM.OPT.A SURETE SECURITE;26;26;20;5;1;1;0;21;0;0;3;11;7;5
15550.0;2022;19;REIMS;MASCULIN;SCOLAIRE;BAC PROFESSIONNEL;BAC PRO PROD;BAC PRO AG 21211 COND GEST ENTR HIPPIQUE;1;1;1;0;0;0;0;1;0;0;0;0;1;0
15563.0;2022;19;REIMS;MASCULIN;SCOLAIRE;BAC PROFESSIONNEL;BAC PRO SERV;BAC PRO 31214 MET.COM.VEN.OP.B PR.CL.VA.OF.COM.;159;158;101;46;11;9;2;110;0;5;8;44;53;48
15566.0;2022;19;REIMS;MASCULIN;SCOLAIRE;BAC PROFESSIONNEL;BAC PRO SERV;BAC PRO 32303 ART.& MET.ART:COM.VIS.VIS.PLURI-M;25;25;21;3;1;1;0;22;0;1;5;10;6;3
15569.0;2022;19;REIMS;MASCULIN;SCOLAIRE;BAC PROFESSIONNEL;BAC PRO SERV;BAC PRO 33004 ACC.SOINS-S.PERS. OPT.EN STRUCTUR;15;15;13;2;0;0;0;13;0;0;5;7;1;2
15578.0;2022;19;REIMS;MASCULIN;SCOLAIRE;BAC TECHNOLOGIQUE;BAC STAV;BAC STAV AGRONOMIE ALIM ENV TERRITOI;88;87;86;1;0;0;0;86;0;1;9;40;36;1
15579.0;2022;19;REIMS;MASCULIN;SCOLAIRE;BAC TECHNOLOGIQUE;BAC STD2A;BAC STD2A SCIENCES & TECHNO. DESIGN-ARTS APPLIQUES;23;23;23;0;0;0;0;23;0;1;4;5;13;0
15584.0;2022;19;REIMS;MASCULIN;SCOLAIRE;BAC TECHNOLOGIQUE;BAC STI2D;BAC STI2D SYSTÈME D'INFORMATION  ET NUMERIQUE;131;131;103;13;15;9;6;112;0;3;21;34;54;19
15588.0;2022;19;REIMS;MASCULIN;SCOLAIRE;BAC TECHNOLOGIQUE;BAC STMG;BAC STMG MERCATIQUE (MARKETING);296;296;209;19;68;45;23;254;0;0;7;71;176;42
15592.0;2022;14;RENNES;FEMININ;APPRENTISSAGE;BAC PROFESSIONNEL;BAC PRO PROD;BAC PRO 22106 CUISINE;9;9;8;1;0;0;0;8;0;1;3;3;1;1
15596.0;2022;14;RENNES;FEMININ;APPRENTISSAGE;BAC PROFESSIONNEL;BAC PRO PROD;BAC PRO 25408 REPARATION DES CARROSSERIES;2;2;2;0;0;0;0;2;0;0;1;0;1;0
15603.0;2022;14;RENNES;FEMININ;APPRENTISSAGE;BAC PROFESSIONNEL;BAC PRO PROD;BAC PRO AG 21210 COND GEST ENTR CANIN ET FELIN;9;9;8;1;0;0;0;8;0;0;1;2;5;1
15604.0;2022;14;RENNES;FEMININ;APPRENTISSAGE;BAC PROFESSIONNEL;BAC PRO PROD;BAC PRO AG 21211 COND GEST ENTR HIPPIQUE;17;17;15;2;0;0;0;15;0;0;3;3;9;2
15610.0;2022;14;RENNES;FEMININ;APPRENTISSAGE;BAC PROFESSIONNEL;BAC PRO SERV;BAC PRO 31213 MET.COM.VEN.OP.A ANI.GES.ESP.COM.;128;123;88;21;14;6;8;94;0;3;15;35;41;29
15614.0;2022;14;RENNES;FEMININ;APPRENTISSAGE;BAC PROFESSIONNEL;BAC PRO SERV;BAC PRO AG 33002 SERV PERS TERRIT;17;17;16;1;0;0;0;16;0;0;3;5;8;1
15616.0;2022;14;RENNES;FEMININ;ENSEIGNEMENT A DISTANCE;BAC PROFESSIONNEL;BAC PRO SERV;BAC PRO 30001 GESTION-ADMINISTRATION;4;2;2;0;0;0;0;2;0;0;0;0;2;0
15619.0;2022;14;RENNES;FEMININ;ENSEIGNEMENT A DISTANCE;BAC PROFESSIONNEL;BAC PRO SERV;BAC PRO 33004 ACC.SOINS-S.PERS. OPT.EN STRUCTUR;1;1;0;1;0;0;0;0;0;0;0;0;0;1
15627.0;2022;14;RENNES;FEMININ;FORMATION CONTINUE;BAC PROFESSIONNEL;BAC PRO SERV;BAC PRO 31213 MET.COM.VEN.OP.A ANI.GES.ESP.COM.;4;4;3;0;1;1;0;4;0;0;2;0;2;0
15629.0;2022;14;RENNES;FEMININ;INDIVIDUEL;BAC PROFESSIONNEL;BAC PRO PROD;BAC PRO 23405 TECHNICIEN MENUISIER AGENCEUR;1;1;1;0;0;0;0;1;0;1;0;0;0;0
15637.0;2022;14;RENNES;FEMININ;INDIVIDUEL;BAC PROFESSIONNEL;BAC PRO SERV;BAC PRO 31213 MET.COM.VEN.OP.A ANI.GES.ESP.COM.;1;1;0;1;0;0;0;0;0;0;0;0;0;1
15642.0;2022;14;RENNES;FEMININ;INDIVIDUEL;BAC PROFESSIONNEL;BAC PRO SERV;BAC PRO 33603 ESTHETIQUE COSMETIQUE PARFUMERIE;1;1;0;1;0;0;0;0;0;0;0;0;0;1
15643.0;2022;14;RENNES;FEMININ;INDIVIDUEL;BAC TECHNOLOGIQUE;BAC ST2S;BAC ST2S SCIENCES & TECHNO. SANTE & SOCIAL;6;4;0;3;1;1;0;1;0;0;0;0;1;3
15645.0;2022;14;RENNES;FEMININ;INDIVIDUEL;BAC TECHNOLOGIQUE;BAC STMG;BAC STMG GESTION ET FINANCE;3;3;1;2;0;0;0;1;0;0;0;0;1;2
15651.0;2022;14;RENNES;FEMININ;SCOLAIRE;BAC PROFESSIONNEL;BAC PRO PROD;BAC PRO 22106 CUISINE;86;86;83;2;1;1;0;84;0;12;20;32;20;2
15656.0;2022;14;RENNES;FEMININ;SCOLAIRE;BAC PROFESSIONNEL;BAC PRO PROD;BAC PRO 23005 TECHN. ETUDES BAT B ASSIST.ARCHI.;29;29;28;1;0;0;0;28;0;3;6;11;8;1
15657.0;2022;14;RENNES;FEMININ;SCOLAIRE;BAC PROFESSIONNEL;BAC PRO PROD;BACPRO 23103 TECHNICIEN GEOMETRE-TOPOGRAPHE;2;2;2;0;0;0;0;2;0;0;0;0;2;0
15658.0;2022;14;RENNES;FEMININ;SCOLAIRE;BAC PROFESSIONNEL;BAC PRO PROD;BAC PRO 23203 TECHNICIEN BAT. : ORG.REAL.GROS O;1;1;1;0;0;0;0;1;0;1;0;0;0;0
15659.0;2022;14;RENNES;FEMININ;SCOLAIRE;BAC PROFESSIONNEL;BAC PRO PROD;BAC PRO 23304 AMENAGEMENT FINITION BATIMENT;14;14;12;0;2;1;1;13;0;0;3;3;7;1
15660.0;2022;14;RENNES;FEMININ;SCOLAIRE;BAC PROFESSIONNEL;BAC PRO PROD;BAC PRO 23404 TECHNICIEN CONSTRUCTEUR BOIS;1;1;1;0;0;0;0;1;0;0;0;1;0;0
15663.0;2022;14;RENNES;FEMININ;SCOLAIRE;BAC PROFESSIONNEL;BAC PRO PROD;BAC PRO 24202 ARTIS.& MET.ART : TAPIS.D'AMEUBL;20;19;18;1;0;0;0;18;0;1;6;7;4;1
15669.0;2022;14;RENNES;FEMININ;SCOLAIRE;BAC PROFESSIONNEL;BAC PRO PROD;BAC PRO 25106 TECHNICIEN D'USINAGE;3;3;3;0;0;0;0;3;0;0;0;2;1;0
15675.0;2022;14;RENNES;FEMININ;SCOLAIRE;BAC PROFESSIONNEL;BAC PRO PROD;BAC PRO 25303 AERONAUTIQUE OPTION SYSTEMES;2;2;2;0;0;0;0;2;0;1;1;0;0;0
15682.0;2022;14;RENNES;FEMININ;SCOLAIRE;BAC PROFESSIONNEL;BAC PRO PROD;BAC PRO 25514 SYST.NUM.OPT.B AUD.RES.EQUIP.DOM.;4;4;3;1;0;0;0;3;0;0;2;0;1;1
15687.0;2022;14;RENNES;FEMININ;SCOLAIRE;BAC PROFESSIONNEL;BAC PRO PROD;BAC PRO AG 21203 TECHN CONSEIL DE VENTE ANIMAL;46;45;37;8;0;0;0;37;0;0;4;8;25;8
15689.0;2022;14;RENNES;FEMININ;SCOLAIRE;BAC PROFESSIONNEL;BAC PRO PROD;BAC PRO AG 21210 COND GEST ENTR CANIN ET FELIN;37;37;35;2;0;0;0;35;0;0;1;14;20;2
15703.0;2022;14;RENNES;FEMININ;SCOLAIRE;BAC PROFESSIONNEL;BAC PRO SERV;BAC PRO 32207 REAL.PR.IMPR.PLURI.OPTA.PR.GRAPH.;13;13;11;2;0;0;0;11;0;1;2;5;3;2
15706.0;2022;14;RENNES;FEMININ;SCOLAIRE;BAC PROFESSIONNEL;BAC PRO SERV;BAC PRO 33002 SERVICES DE PROXIMITE  VIE LOCAL;69;69;64;2;3;3;0;67;0;4;19;28;16;2
15711.0;2022;14;RENNES;FEMININ;SCOLAIRE;BAC PROFESSIONNEL;BAC PRO SERV;BAC PRO 33603 ESTHETIQUE COSMETIQUE PARFUMERIE;126;123;115;7;1;1;0;116;0;3;30;52;31;7
15712.0;2022;14;RENNES;FEMININ;SCOLAIRE;BAC PROFESSIONNEL;BAC PRO SERV;BAC PRO 34303 GEST. POLLUTIONS PROTEC. ENVIRON.;1;1;1;0;0;0;0;1;0;0;0;1;0;0
15714.0;2022;14;RENNES;FEMININ;SCOLAIRE;BAC PROFESSIONNEL;BAC PRO SERV;BAC PRO 34403 METIERS DE LA SECURITE;13;13;13;0;0;0;0;13;0;2;3;7;1;0
15725.0;2022;14;RENNES;FEMININ;SCOLAIRE;BAC TECHNOLOGIQUE;BAC STI2D;BAC STI2D SYSTÈME D'INFORMATION  ET NUMERIQUE;25;25;20;2;3;1;2;21;0;0;6;7;8;4
15726.0;2022;14;RENNES;FEMININ;SCOLAIRE;BAC TECHNOLOGIQUE;BAC STL;BAC STL BIOCHIM.-BIOLOGIE-BIOTECHNOL.;75;75;71;0;4;2;2;73;1;3;19;26;24;2
15729.0;2022;14;RENNES;FEMININ;SCOLAIRE;BAC TECHNOLOGIQUE;BAC STMG;BAC STMG MERCATIQUE (MARKETING);1166;1166;1020;26;120;88;32;1108;0;12;139;421;536;58
15730.0;2022;14;RENNES;FEMININ;SCOLAIRE;BAC TECHNOLOGIQUE;BAC STMG;BAC STMG RESSOURCES HUMAINES ET COMMUNICATION;640;640;524;20;96;69;27;593;0;3;42;217;331;47
15731.0;2022;14;RENNES;FEMININ;SCOLAIRE;BAC TECHNOLOGIQUE;BAC STMG;BAC STMG SYSTEMES D'INFORMATION DE GESTION;11;11;7;1;3;2;1;9;0;0;0;4;5;2
15736.0;2022;14;RENNES;MASCULIN;APPRENTISSAGE;BAC PROFESSIONNEL;BAC PRO PROD;BAC PRO 22704 TECHN. MAINT. SYST.ENERG.CLIMATI;11;11;11;0;0;0;0;11;0;7;1;2;1;0
15742.0;2022;14;RENNES;MASCULIN;APPRENTISSAGE;BAC PROFESSIONNEL;BAC PRO PROD;BAC PRO 23405 TECHNICIEN MENUISIER AGENCEUR;17;17;14;2;1;1;0;15;0;1;2;3;9;2
15745.0;2022;14;RENNES;MASCULIN;APPRENTISSAGE;BAC PROFESSIONNEL;BAC PRO PROD;BAC PRO 25106 TECHNICIEN D'USINAGE;6;6;5;1;0;0;0;5;0;0;0;3;2;1
15746.0;2022;14;RENNES;MASCULIN;APPRENTISSAGE;BAC PROFESSIONNEL;BAC PRO PROD;BAC PRO 25107 TECHNICIEN OUTILLEUR;2;2;2;0;0;0;0;2;0;0;0;2;0;0
15747.0;2022;14;RENNES;MASCULIN;APPRENTISSAGE;BAC PROFESSIONNEL;BAC PRO PROD;BAC PRO 25214 MAINT.VEHIC.OPTA VOIT.PARTICUL.;195;191;137;44;10;2;8;139;0;14;21;43;61;52
15748.0;2022;14;RENNES;MASCULIN;APPRENTISSAGE;BAC PROFESSIONNEL;BAC PRO PROD;BAC PRO 25215 MAINT.VEHIC.OPTB VEHIC.TRANS.ROUT;31;31;27;4;0;0;0;27;0;0;4;13;10;4
15749.0;2022;14;RENNES;MASCULIN;APPRENTISSAGE;BAC PROFESSIONNEL;BAC PRO PROD;BAC PRO 25216 MAINT.VEHIC.OPTC MOTOCYCLES;15;15;14;1;0;0;0;14;0;3;3;6;2;1
15754.0;2022;14;RENNES;MASCULIN;APPRENTISSAGE;BAC PROFESSIONNEL;BAC PRO PROD;BAC PRO 25408 REPARATION DES CARROSSERIES;23;23;19;4;0;0;0;19;0;2;0;5;12;4
15755.0;2022;14;RENNES;MASCULIN;APPRENTISSAGE;BAC PROFESSIONNEL;BAC PRO PROD;BAC PRO 25411 TECH.CHAUDRONNERIE INDUSTRIELLE;85;85;72;6;7;4;3;76;0;17;10;31;18;9
15756.0;2022;14;RENNES;MASCULIN;APPRENTISSAGE;BAC PROFESSIONNEL;BAC PRO PROD;BAC PRO 25509 TECHNIC. FROID CONDITIONNEMT AIR;3;3;3;0;0;0;0;3;0;0;1;1;1;0
15758.0;2022;14;RENNES;MASCULIN;APPRENTISSAGE;BAC PROFESSIONNEL;BAC PRO PROD;BAC PRO 25515 SYST.NUM.OPT.C RES.INF.SYST.COMM.;7;7;7;0;0;0;0;7;0;0;2;2;3;0
15760.0;2022;14;RENNES;MASCULIN;APPRENTISSAGE;BAC PROFESSIONNEL;BAC PRO PROD;BAC PRO AG 21004 CGEA;66;66;38;28;0;0;0;38;0;0;1;12;25;28
15761.0;2022;14;RENNES;MASCULIN;APPRENTISSAGE;BAC PROFESSIONNEL;BAC PRO PROD;BAC PRO AG 21113 CGEVV;1;1;1;0;0;0;0;1;0;0;0;0;1;0
15777.0;2022;14;RENNES;MASCULIN;ENSEIGNEMENT A DISTANCE;BAC PROFESSIONNEL;BAC PRO SERV;BAC PRO 30001 GESTION-ADMINISTRATION;2;1;0;1;0;0;0;0;0;0;0;0;0;1
15788.0;2022;14;RENNES;MASCULIN;FORMATION CONTINUE;BAC PROFESSIONNEL;BAC PRO PROD;BAC PRO 25510 METIERS ELECT. ENVIRON. CONNECTES;3;3;2;0;1;0;1;2;0;0;1;1;0;1
15791.0;2022;14;RENNES;MASCULIN;INDIVIDUEL;BAC PROFESSIONNEL;BAC PRO PROD;BAC PRO 22104 BOUCHER CHARCUTIER TRAITEUR;1;0;0;0;0;0;0;0;0;0;0;0;0;0
15792.0;2022;14;RENNES;MASCULIN;INDIVIDUEL;BAC PROFESSIONNEL;BAC PRO PROD;BAC PRO 22106 CUISINE;2;1;1;0;0;0;0;1;0;0;0;0;1;0
15796.0;2022;14;RENNES;MASCULIN;INDIVIDUEL;BAC PROFESSIONNEL;BAC PRO PROD;BAC PRO 25214 MAINT.VEHIC.OPTA VOIT.PARTICUL.;2;2;2;0;0;0;0;2;0;0;1;0;1;0
15807.0;2022;14;RENNES;MASCULIN;INDIVIDUEL;BAC PROFESSIONNEL;BAC PRO PROD;BAC PRO AG 21405 AMENAGEMENTS PAYSAGERS;3;3;3;0;0;0;0;3;0;0;0;0;3;0
15810.0;2022;14;RENNES;MASCULIN;INDIVIDUEL;BAC PROFESSIONNEL;BAC PRO SERV;BAC PRO 30001 GESTION-ADMINISTRATION;2;1;0;1;0;0;0;0;0;0;0;0;0;1
15812.0;2022;14;RENNES;MASCULIN;INDIVIDUEL;BAC PROFESSIONNEL;BAC PRO SERV;BAC PRO 31213 MET.COM.VEN.OP.A ANI.GES.ESP.COM.;1;0;0;0;0;0;0;0;0;0;0;0;0;0
15818.0;2022;14;RENNES;MASCULIN;INDIVIDUEL;BAC TECHNOLOGIQUE;BAC STMG;BAC STMG GESTION ET FINANCE;4;4;1;3;0;0;0;1;0;0;0;0;1;3
15828.0;2022;14;RENNES;MASCULIN;SCOLAIRE;BAC PROFESSIONNEL;BAC PRO PROD;BAC PRO 22703 TECHN.INSTALL.SYST.ENERG.CLIMATI;70;70;41;22;7;6;1;47;0;0;5;17;25;23
15830.0;2022;14;RENNES;MASCULIN;SCOLAIRE;BAC PROFESSIONNEL;BAC PRO PROD;BAC PRO 23003 ARTIS. & M.ART:MARCHANDISAGE VIS.;4;4;4;0;0;0;0;4;0;1;3;0;0;0
15834.0;2022;14;RENNES;MASCULIN;SCOLAIRE;BAC PROFESSIONNEL;BAC PRO PROD;BACPRO 23103 TECHNICIEN GEOMETRE-TOPOGRAPHE;24;24;20;4;0;0;0;20;0;0;4;13;3;4
15852.0;2022;14;RENNES;MASCULIN;SCOLAIRE;BAC PROFESSIONNEL;BAC PRO PROD;BAC PRO 25219 MAINT.MATERIELS OPT.A AGRICOLES;44;44;40;2;2;1;1;41;0;1;13;14;13;3
15854.0;2022;14;RENNES;MASCULIN;SCOLAIRE;BAC PROFESSIONNEL;BAC PRO PROD;BAC PRO 25221 MAINT.MATERIELS OPT.C ESP. VERTS;14;14;10;2;2;1;1;11;0;1;1;3;6;3
15866.0;2022;14;RENNES;MASCULIN;SCOLAIRE;BAC PROFESSIONNEL;BAC PRO PROD;BAC PRO AG 21001 AGRO-EQUIPEMENT;112;112;97;15;0;0;0;97;0;0;12;33;52;15
15867.0;2022;14;RENNES;MASCULIN;SCOLAIRE;BAC PROFESSIONNEL;BAC PRO PROD;BAC PRO AG 21004 CGEA;296;292;262;30;0;0;0;262;0;3;29;88;142;30
15876.0;2022;14;RENNES;MASCULIN;SCOLAIRE;BAC PROFESSIONNEL;BAC PRO PROD;BAC PRO AG 21407 TEC CONS VTE UNIVERS JARDINERIE;11;10;6;4;0;0;0;6;0;0;2;0;4;4
15881.0;2022;14;RENNES;MASCULIN;SCOLAIRE;BAC PROFESSIONNEL;BAC PRO SERV;BAC PRO 31107 CONDUCT. TRANSP.ROUT.MARCHANDISES;95;95;88;2;5;5;0;93;0;5;30;43;15;2
15884.0;2022;14;RENNES;MASCULIN;SCOLAIRE;BAC PROFESSIONNEL;BAC PRO SERV;BAC PRO 31213 MET.COM.VEN.OP.A ANI.GES.ESP.COM.;489;489;410;63;16;13;3;423;0;9;75;163;176;66
15895.0;2022;14;RENNES;MASCULIN;SCOLAIRE;BAC PROFESSIONNEL;BAC PRO SERV;BAC PRO 34303 GEST. POLLUTIONS PROTEC. ENVIRON.;3;3;3;0;0;0;0;3;0;1;1;1;0;0
15907.0;2022;14;RENNES;MASCULIN;SCOLAIRE;BAC TECHNOLOGIQUE;BAC STI2D;BAC STI2D INNOVATION TECHNO.  ET ECO CONCEPTION;445;444;414;4;26;17;9;431;0;11;61;196;163;13
15917.0;2022;15;STRASBOURG;FEMININ;APPRENTISSAGE;BAC PROFESSIONNEL;BAC PRO PROD;BAC PRO 22403 ARTS.& MET.ART:MET.ENSEIGN SIGNA;1;1;1;0;0;0;0;1;0;0;1;0;0;0
15925.0;2022;15;STRASBOURG;FEMININ;APPRENTISSAGE;BAC PROFESSIONNEL;BAC PRO PROD;BAC PRO 25215 MAINT.VEHIC.OPTB VEHIC.TRANS.ROUT;1;1;1;0;0;0;0;1;0;1;0;0;0;0
15926.0;2022;15;STRASBOURG;FEMININ;APPRENTISSAGE;BAC PROFESSIONNEL;BAC PRO PROD;BAC PRO 25411 TECH.CHAUDRONNERIE INDUSTRIELLE;2;2;2;0;0;0;0;2;0;1;1;0;0;0
15933.0;2022;15;STRASBOURG;FEMININ;APPRENTISSAGE;BAC PROFESSIONNEL;BAC PRO PROD;BAC PRO AG 21405 AMENAGEMENTS PAYSAGERS;1;1;1;0;0;0;0;1;0;0;0;1;0;0
15949.0;2022;15;STRASBOURG;FEMININ;ENSEIGNEMENT A DISTANCE;BAC TECHNOLOGIQUE;BAC STMG;BAC STMG MERCATIQUE (MARKETING);1;1;1;0;0;0;0;1;0;0;0;0;1;0
15952.0;2022;15;STRASBOURG;FEMININ;FORMATION CONTINUE;BAC PROFESSIONNEL;BAC PRO PROD;BAC PRO 25106 TECHNICIEN D'USINAGE;1;1;1;0;0;0;0;1;0;0;1;0;0;0
15953.0;2022;15;STRASBOURG;FEMININ;FORMATION CONTINUE;BAC PROFESSIONNEL;BAC PRO PROD;BAC PRO 25411 TECH.CHAUDRONNERIE INDUSTRIELLE;1;1;1;0;0;0;0;1;0;1;0;0;0;0
15955.0;2022;15;STRASBOURG;FEMININ;FORMATION CONTINUE;BAC PROFESSIONNEL;BAC PRO SERV;BAC PRO 30001 GESTION-ADMINISTRATION;2;2;2;0;0;0;0;2;0;1;1;0;0;0
15957.0;2022;15;STRASBOURG;FEMININ;INDIVIDUEL;BAC GENERAL;BAC GENERAL;BAC GENE 10019 BAC GENERAL;88;70;45;19;6;2;4;47;1;15;6;9;16;23
15960.0;2022;15;STRASBOURG;FEMININ;INDIVIDUEL;BAC PROFESSIONNEL;BAC PRO PROD;BAC PRO AG 21004 CGEA;1;1;0;1;0;0;0;0;0;0;0;0;0;1
15964.0;2022;15;STRASBOURG;FEMININ;INDIVIDUEL;BAC PROFESSIONNEL;BAC PRO SERV;BAC PRO 30001 GESTION-ADMINISTRATION;8;3;1;2;0;0;0;1;0;0;0;0;1;2
15965.0;2022;15;STRASBOURG;FEMININ;INDIVIDUEL;BAC PROFESSIONNEL;BAC PRO SERV;BAC PRO 31212 METIERS DE L'ACCUEIL;3;3;1;2;0;0;0;1;0;0;1;0;0;2
15976.0;2022;15;STRASBOURG;FEMININ;INDIVIDUEL;BAC TECHNOLOGIQUE;BAC STMG;BAC STMG RESSOURCES HUMAINES ET COMMUNICATION;6;3;0;2;1;1;0;1;0;0;0;0;1;2
15987.0;2022;15;STRASBOURG;FEMININ;SCOLAIRE;BAC PROFESSIONNEL;BAC PRO PROD;BAC PRO 23405 TECHNICIEN MENUISIER AGENCEUR;2;2;1;1;0;0;0;1;0;0;1;0;0;1
15993.0;2022;15;STRASBOURG;FEMININ;SCOLAIRE;BAC PROFESSIONNEL;BAC PRO PROD;BAC PRO 25214 MAINT.VEHIC.OPTA VOIT.PARTICUL.;2;2;2;0;0;0;0;2;0;0;2;0;0;0
15997.0;2022;15;STRASBOURG;FEMININ;SCOLAIRE;BAC PROFESSIONNEL;BAC PRO PROD;BAC PRO 25406 OUVRAGES DU BATIMENT METALLERIE;2;2;2;0;0;0;0;2;0;0;0;0;2;0
15998.0;2022;15;STRASBOURG;FEMININ;SCOLAIRE;BAC PROFESSIONNEL;BAC PRO PROD;BAC PRO 25408 REPARATION DES CARROSSERIES;1;1;1;0;0;0;0;1;0;0;0;1;0;0
16002.0;2022;15;STRASBOURG;FEMININ;SCOLAIRE;BAC PROFESSIONNEL;BAC PRO PROD;BAC PRO AG 21113 CGEVV;8;8;8;0;0;0;0;8;0;0;4;0;4;0
16006.0;2022;15;STRASBOURG;FEMININ;SCOLAIRE;BAC PROFESSIONNEL;BAC PRO PROD;BAC PRO AG 21405 AMENAGEMENTS PAYSAGERS;4;4;3;1;0;0;0;3;0;0;0;0;3;1
16017.0;2022;15;STRASBOURG;FEMININ;SCOLAIRE;BAC PROFESSIONNEL;BAC PRO SERV;BAC PRO 32207 REAL.PR.IMPR.PLURI.OPTA.PR.GRAPH.;11;11;10;1;0;0;0;10;0;0;2;5;3;1
16027.0;2022;15;STRASBOURG;FEMININ;SCOLAIRE;BAC PROFESSIONNEL;BAC PRO SERV;BAC PRO 34403 METIERS DE LA SECURITE;8;8;7;1;0;0;0;7;0;1;2;1;3;1
16043.0;2022;15;STRASBOURG;MASCULIN;APPRENTISSAGE;BAC PROFESSIONNEL;BAC PRO PROD;BAC PRO 22106 CUISINE;20;20;18;1;1;0;1;18;0;0;4;7;7;2
16052.0;2022;15;STRASBOURG;MASCULIN;APPRENTISSAGE;BAC PROFESSIONNEL;BAC PRO PROD;BAC PRO 23405 TECHNICIEN MENUISIER AGENCEUR;13;13;11;1;1;0;1;11;0;1;1;5;4;2
16054.0;2022;15;STRASBOURG;MASCULIN;APPRENTISSAGE;BAC PROFESSIONNEL;BAC PRO PROD;BAC PRO 25006 MICROTECHNIQUES;2;2;2;0;0;0;0;2;0;0;0;0;2;0
16057.0;2022;15;STRASBOURG;MASCULIN;APPRENTISSAGE;BAC PROFESSIONNEL;BAC PRO PROD;BAC PRO 25107 TECHNICIEN OUTILLEUR;4;4;4;0;0;0;0;4;0;0;1;3;0;0
16062.0;2022;15;STRASBOURG;MASCULIN;APPRENTISSAGE;BAC PROFESSIONNEL;BAC PRO PROD;BAC PRO 25220 MAINT.MATERIELS OPT.B TP MANUT.;14;14;13;0;1;0;1;13;0;2;4;3;4;1
16066.0;2022;15;STRASBOURG;MASCULIN;APPRENTISSAGE;BAC PROFESSIONNEL;BAC PRO PROD;BAC PRO 25410 CONSTRUCTION DES CARROSSERIES;1;1;0;1;0;0;0;0;0;0;0;0;0;1
16069.0;2022;15;STRASBOURG;MASCULIN;APPRENTISSAGE;BAC PROFESSIONNEL;BAC PRO PROD;BAC PRO 25510 METIERS ELECT. ENVIRON. CONNECTES;103;103;82;14;7;1;6;83;0;10;18;31;24;20
16088.0;2022;15;STRASBOURG;MASCULIN;ENSEIGNEMENT A DISTANCE;BAC TECHNOLOGIQUE;BAC STMG;BAC STMG GESTION ET FINANCE;1;1;1;0;0;0;0;1;0;0;0;1;0;0
16090.0;2022;15;STRASBOURG;MASCULIN;FORMATION CONTINUE;BAC PROFESSIONNEL;BAC PRO PROD;BAC PRO 20102 PILOTE DE LIGNE DE PRODUCTION;2;2;2;0;0;0;0;2;0;0;1;1;0;0
16094.0;2022;15;STRASBOURG;MASCULIN;FORMATION CONTINUE;BAC PROFESSIONNEL;BAC PRO PROD;BAC PRO 23405 TECHNICIEN MENUISIER AGENCEUR;2;2;2;0;0;0;0;2;0;2;0;0;0;0
16107.0;2022;15;STRASBOURG;MASCULIN;INDIVIDUEL;BAC PROFESSIONNEL;BAC PRO PROD;BAC PRO 23405 TECHNICIEN MENUISIER AGENCEUR;1;0;0;0;0;0;0;0;0;0;0;0;0;0
16109.0;2022;15;STRASBOURG;MASCULIN;INDIVIDUEL;BAC PROFESSIONNEL;BAC PRO PROD;BAC PRO 25106 TECHNICIEN D'USINAGE;1;1;0;1;0;0;0;0;0;0;0;0;0;1
16110.0;2022;15;STRASBOURG;MASCULIN;INDIVIDUEL;BAC PROFESSIONNEL;BAC PRO PROD;BAC PRO 25214 MAINT.VEHIC.OPTA VOIT.PARTICUL.;1;1;0;1;0;0;0;0;0;0;0;0;0;1
16117.0;2022;15;STRASBOURG;MASCULIN;INDIVIDUEL;BAC PROFESSIONNEL;BAC PRO PROD;BAC PRO AG 21114 CONDUITE PRODUCTIONS HORTICOLES;2;2;1;1;0;0;0;1;0;0;0;0;1;1
16119.0;2022;15;STRASBOURG;MASCULIN;INDIVIDUEL;BAC PROFESSIONNEL;BAC PRO SERV;BAC PRO 30001 GESTION-ADMINISTRATION;2;2;0;2;0;0;0;0;0;0;0;0;0;2
16128.0;2022;15;STRASBOURG;MASCULIN;INDIVIDUEL;BAC TECHNOLOGIQUE;BAC STI2D;BAC STI2D SYSTÈME D'INFORMATION  ET NUMERIQUE;1;0;0;0;0;0;0;0;0;0;0;0;0;0
16129.0;2022;15;STRASBOURG;MASCULIN;INDIVIDUEL;BAC TECHNOLOGIQUE;BAC STMG;BAC STMG GESTION ET FINANCE;5;4;1;2;1;1;0;2;0;0;0;0;2;2
16136.0;2022;15;STRASBOURG;MASCULIN;SCOLAIRE;BAC PROFESSIONNEL;BAC PRO PROD;BAC PRO 22105 BOULANGER-PÂTISSIER;9;9;7;0;2;2;0;9;0;1;2;2;4;0
16138.0;2022;15;STRASBOURG;MASCULIN;SCOLAIRE;BAC PROFESSIONNEL;BAC PRO PROD;BAC PRO 22503 PLASTIQUES ET COMPOSITES;11;11;10;0;1;0;1;10;0;0;0;8;2;1
16144.0;2022;15;STRASBOURG;MASCULIN;SCOLAIRE;BAC PROFESSIONNEL;BAC PRO PROD;BAC PRO 23203 TECHNICIEN BAT. : ORG.REAL.GROS O;5;5;5;0;0;0;0;5;0;0;1;0;4;0
16153.0;2022;15;STRASBOURG;MASCULIN;SCOLAIRE;BAC PROFESSIONNEL;BAC PRO PROD;BAC PRO 25106 TECHNICIEN D'USINAGE;74;74;60;10;4;2;2;62;0;1;14;26;21;12
16159.0;2022;15;STRASBOURG;MASCULIN;SCOLAIRE;BAC PROFESSIONNEL;BAC PRO PROD;BAC PRO 25220 MAINT.MATERIELS OPT.B TP MANUT.;5;5;2;2;1;1;0;3;0;0;0;2;1;2
16161.0;2022;15;STRASBOURG;MASCULIN;SCOLAIRE;BAC PROFESSIONNEL;BAC PRO PROD;BAC PRO 25408 REPARATION DES CARROSSERIES;21;20;10;9;1;0;1;10;0;0;2;2;6;10
16166.0;2022;15;STRASBOURG;MASCULIN;SCOLAIRE;BAC PROFESSIONNEL;BAC PRO PROD;BAC PRO 25514 SYST.NUM.OPT.B AUD.RES.EQUIP.DOM.;45;45;33;11;1;1;0;34;0;4;10;9;11;11
16170.0;2022;15;STRASBOURG;MASCULIN;SCOLAIRE;BAC PROFESSIONNEL;BAC PRO PROD;BAC PRO AG 21114 CONDUITE PRODUCTIONS HORTICOLES;8;8;7;1;0;0;0;7;0;1;1;0;5;1
16188.0;2022;15;STRASBOURG;MASCULIN;SCOLAIRE;BAC PROFESSIONNEL;BAC PRO SERV;BAC PRO 33004 ACC.SOINS-S.PERS. OPT.EN STRUCTUR;29;29;26;2;1;0;1;26;0;1;3;8;14;3
16189.0;2022;15;STRASBOURG;MASCULIN;SCOLAIRE;BAC PROFESSIONNEL;BAC PRO SERV;BAC PRO 33101 OPTIQUE LUNETTERIE;5;5;3;2;0;0;0;3;0;0;0;2;1;2
16201.0;2022;15;STRASBOURG;MASCULIN;SCOLAIRE;BAC TECHNOLOGIQUE;BAC STI2D;BAC STI2D ENERGIES  ET ENVIRONNEMENT;138;138;106;10;22;11;11;117;0;3;13;39;62;21
16203.0;2022;15;STRASBOURG;MASCULIN;SCOLAIRE;BAC TECHNOLOGIQUE;BAC STI2D;BAC STI2D SYSTÈME D'INFORMATION  ET NUMERIQUE;246;246;206;15;25;13;12;219;0;9;34;79;97;27
16213.0;2022;16;TOULOUSE;FEMININ;APPRENTISSAGE;BAC PROFESSIONNEL;BAC PRO PROD;BAC PRO 22106 CUISINE;5;5;5;0;0;0;0;5;0;1;2;1;1;0
16230.0;2022;16;TOULOUSE;FEMININ;APPRENTISSAGE;BAC PROFESSIONNEL;BAC PRO PROD;BAC PRO 25515 SYST.NUM.OPT.C RES.INF.SYST.COMM.;1;1;1;0;0;0;0;1;0;0;0;0;1;0
16232.0;2022;16;TOULOUSE;FEMININ;APPRENTISSAGE;BAC PROFESSIONNEL;BAC PRO PROD;BAC PRO AG 21211 COND GEST ENTR HIPPIQUE;2;2;2;0;0;0;0;2;0;0;0;2;0;0
16237.0;2022;16;TOULOUSE;FEMININ;APPRENTISSAGE;BAC PROFESSIONNEL;BAC PRO SERV;BAC PRO 31212 METIERS DE L'ACCUEIL;8;7;7;0;0;0;0;7;0;3;1;3;0;0
16238.0;2022;16;TOULOUSE;FEMININ;APPRENTISSAGE;BAC PROFESSIONNEL;BAC PRO SERV;BAC PRO 31213 MET.COM.VEN.OP.A ANI.GES.ESP.COM.;79;79;58;17;4;2;2;60;0;6;14;20;20;19
16244.0;2022;16;TOULOUSE;FEMININ;APPRENTISSAGE;BAC PROFESSIONNEL;BAC PRO SERV;BAC PRO 33004 ACC.SOINS-S.PERS. OPT.EN STRUCTUR;13;13;12;1;0;0;0;12;0;0;2;5;5;1
16258.0;2022;16;TOULOUSE;FEMININ;ENSEIGNEMENT A DISTANCE;BAC TECHNOLOGIQUE;BAC STMG;BAC STMG RESSOURCES HUMAINES ET COMMUNICATION;1;1;1;0;0;0;0;1;0;0;0;1;0;0
16260.0;2022;16;TOULOUSE;FEMININ;FORMATION CONTINUE;BAC PROFESSIONNEL;BAC PRO PROD;BAC PRO AG 21004 CGEA;2;2;2;0;0;0;0;2;0;0;1;1;0;0
16272.0;2022;16;TOULOUSE;FEMININ;INDIVIDUEL;BAC PROFESSIONNEL;BAC PRO SERV;BAC PRO 30001 GESTION-ADMINISTRATION;13;8;4;2;2;1;1;5;0;0;0;2;3;3
16273.0;2022;16;TOULOUSE;FEMININ;INDIVIDUEL;BAC PROFESSIONNEL;BAC PRO SERV;BAC PRO 31212 METIERS DE L'ACCUEIL;3;2;1;1;0;0;0;1;0;0;0;1;0;1
16292.0;2022;16;TOULOUSE;FEMININ;SCOLAIRE;BAC PROFESSIONNEL;BAC PRO PROD;BAC PRO 22403 ARTS.& MET.ART:MET.ENSEIGN SIGNA;4;4;3;1;0;0;0;3;0;0;2;1;0;1
16294.0;2022;16;TOULOUSE;FEMININ;SCOLAIRE;BAC PROFESSIONNEL;BAC PRO PROD;BAC PRO 22704 TECHN. MAINT. SYST.ENERG.CLIMATI;1;1;0;0;1;1;0;1;0;0;0;0;1;0
16297.0;2022;16;TOULOUSE;FEMININ;SCOLAIRE;BAC PROFESSIONNEL;BAC PRO PROD;BAC PRO 23005 TECHN. ETUDES BAT B ASSIST.ARCHI.;20;20;18;2;0;0;0;18;0;0;3;10;5;2
16303.0;2022;16;TOULOUSE;FEMININ;SCOLAIRE;BAC PROFESSIONNEL;BAC PRO PROD;BAC PRO 24203 METIERS DE LA MODE - VÊTEMENT;91;91;77;12;2;1;1;78;0;9;14;33;22;13
16307.0;2022;16;TOULOUSE;FEMININ;SCOLAIRE;BAC PROFESSIONNEL;BAC PRO PROD;BAC PRO 25108 TECHNICIEN MODELEUR;4;4;4;0;0;0;0;4;0;0;1;3;0;0
16308.0;2022;16;TOULOUSE;FEMININ;SCOLAIRE;BAC PROFESSIONNEL;BAC PRO PROD;BAC PRO 25214 MAINT.VEHIC.OPTA VOIT.PARTICUL.;9;9;9;0;0;0;0;9;0;0;0;3;6;0
16309.0;2022;16;TOULOUSE;FEMININ;SCOLAIRE;BAC PROFESSIONNEL;BAC PRO PROD;BAC PRO 25216 MAINT.VEHIC.OPTC MOTOCYCLES;3;3;2;1;0;0;0;2;0;0;0;1;1;1
16315.0;2022;16;TOULOUSE;FEMININ;SCOLAIRE;BAC PROFESSIONNEL;BAC PRO PROD;BAC PRO 25514 SYST.NUM.OPT.B AUD.RES.EQUIP.DOM.;3;3;3;0;0;0;0;3;0;0;1;1;1;0
16326.0;2022;16;TOULOUSE;FEMININ;SCOLAIRE;BAC PROFESSIONNEL;BAC PRO PROD;BAC PRO AG 21407 TEC CONS VTE UNIVERS JARDINERIE;6;6;6;0;0;0;0;6;0;0;0;1;5;0
16337.0;2022;16;TOULOUSE;FEMININ;SCOLAIRE;BAC PROFESSIONNEL;BAC PRO SERV;BAC PRO 32208 REAL.PR.IMPR.PLURI.OPTB.PR.IMPR.;3;3;2;1;0;0;0;2;0;1;0;1;0;1
16339.0;2022;16;TOULOUSE;FEMININ;SCOLAIRE;BAC PROFESSIONNEL;BAC PRO SERV;BAC PRO 32304 PHOTOGRAPHIE;8;8;8;0;0;0;0;8;0;0;3;2;3;0
16348.0;2022;16;TOULOUSE;FEMININ;SCOLAIRE;BAC PROFESSIONNEL;BAC PRO SERV;BAC PRO 33603 ESTHETIQUE COSMETIQUE PARFUMERIE;154;153;128;20;5;5;0;133;0;4;20;54;55;20
16350.0;2022;16;TOULOUSE;FEMININ;SCOLAIRE;BAC PROFESSIONNEL;BAC PRO SERV;BAC PRO 34403 METIERS DE LA SECURITE;32;32;31;1;0;0;0;31;0;4;10;9;8;1
16358.0;2022;16;TOULOUSE;FEMININ;SCOLAIRE;BAC TECHNOLOGIQUE;BAC STHR;BAC STHR SC.&TEC. HOTELLERIE-RESTAURATION;64;64;60;1;3;0;3;60;1;3;17;25;14;4
16359.0;2022;16;TOULOUSE;FEMININ;SCOLAIRE;BAC TECHNOLOGIQUE;BAC STI2D;BAC STI2D ARCHITECTURE ET CONSTRUCTION;56;56;50;2;4;3;1;53;0;3;8;17;25;3
16366.0;2022;16;TOULOUSE;FEMININ;SCOLAIRE;BAC TECHNOLOGIQUE;BAC STMG;BAC STMG MERCATIQUE (MARKETING);699;699;592;19;88;62;26;654;0;16;96;230;312;45
16367.0;2022;16;TOULOUSE;FEMININ;SCOLAIRE;BAC TECHNOLOGIQUE;BAC STMG;BAC STMG RESSOURCES HUMAINES ET COMMUNICATION;433;433;349;19;65;51;14;400;0;4;41;133;222;33
16368.0;2022;16;TOULOUSE;FEMININ;SCOLAIRE;BAC TECHNOLOGIQUE;BAC STMG;BAC STMG SYSTEMES D'INFORMATION DE GESTION;5;5;4;1;0;0;0;4;0;0;1;2;1;1
16369.0;2022;16;TOULOUSE;MASCULIN;APPRENTISSAGE;BAC PROFESSIONNEL;BAC PRO PROD;BAC PRO 22003 BIO-INDUSTRIES DE TRANSFORMATION;1;1;0;0;1;0;1;0;0;0;0;0;0;1
16378.0;2022;16;TOULOUSE;MASCULIN;APPRENTISSAGE;BAC PROFESSIONNEL;BAC PRO PROD;BAC PRO 23005 TECHN. ETUDES BAT B ASSIST.ARCHI.;5;5;5;0;0;0;0;5;0;0;2;2;1;0
16384.0;2022;16;TOULOUSE;MASCULIN;APPRENTISSAGE;BAC PROFESSIONNEL;BAC PRO PROD;BAC PRO 23303 MENUISERIE ALUMINIUM-VERRE;10;10;6;2;2;2;0;8;0;0;1;3;4;2
16385.0;2022;16;TOULOUSE;MASCULIN;APPRENTISSAGE;BAC PROFESSIONNEL;BAC PRO PROD;BAC PRO 23304 AMENAGEMENT FINITION BATIMENT;10;10;7;1;2;1;1;8;0;0;0;5;3;2
16389.0;2022;16;TOULOUSE;MASCULIN;APPRENTISSAGE;BAC PROFESSIONNEL;BAC PRO PROD;BAC PRO 23407 TECHNIC.FAB.BOIS ET MATERX ASSOC;3;3;2;1;0;0;0;2;0;0;2;0;0;1
16397.0;2022;16;TOULOUSE;MASCULIN;APPRENTISSAGE;BAC PROFESSIONNEL;BAC PRO PROD;BAC PRO 25221 MAINT.MATERIELS OPT.C ESP. VERTS;9;9;6;1;2;2;0;8;0;0;0;2;6;1
16399.0;2022;16;TOULOUSE;MASCULIN;APPRENTISSAGE;BAC PROFESSIONNEL;BAC PRO PROD;BAC PRO 25303 AERONAUTIQUE OPTION SYSTEMES;11;11;9;2;0;0;0;9;0;2;4;2;1;2
16403.0;2022;16;TOULOUSE;MASCULIN;APPRENTISSAGE;BAC PROFESSIONNEL;BAC PRO PROD;BAC PRO 25411 TECH.CHAUDRONNERIE INDUSTRIELLE;53;53;53;0;0;0;0;53;0;5;14;21;13;0
16415.0;2022;16;TOULOUSE;MASCULIN;APPRENTISSAGE;BAC PROFESSIONNEL;BAC PRO SERV;BAC PRO 32208 REAL.PR.IMPR.PLURI.OPTB.PR.IMPR.;7;7;6;1;0;0;0;6;0;0;2;2;2;1
16422.0;2022;16;TOULOUSE;MASCULIN;ENSEIGNEMENT A DISTANCE;BAC PROFESSIONNEL;BAC PRO PROD;BAC PRO 25007 MAINTENANCE EQUIPEMENTS INDUST.;1;0;0;0;0;0;0;0;0;0;0;0;0;0
16423.0;2022;16;TOULOUSE;MASCULIN;ENSEIGNEMENT A DISTANCE;BAC PROFESSIONNEL;BAC PRO SERV;BAC PRO 30001 GESTION-ADMINISTRATION;4;3;0;3;0;0;0;0;0;0;0;0;0;3
16425.0;2022;16;TOULOUSE;MASCULIN;ENSEIGNEMENT A DISTANCE;BAC PROFESSIONNEL;BAC PRO SERV;BAC PRO 31214 MET.COM.VEN.OP.B PR.CL.VA.OF.COM.;4;2;2;0;0;0;0;2;0;0;0;0;2;0
16426.0;2022;16;TOULOUSE;MASCULIN;ENSEIGNEMENT A DISTANCE;BAC TECHNOLOGIQUE;BAC ST2S;BAC ST2S SCIENCES & TECHNO. SANTE & SOCIAL;1;1;1;0;0;0;0;1;0;0;0;0;1;0
16427.0;2022;16;TOULOUSE;MASCULIN;ENSEIGNEMENT A DISTANCE;BAC TECHNOLOGIQUE;BAC STMG;BAC STMG GESTION ET FINANCE;2;2;1;1;0;0;0;1;0;0;1;0;0;1
16428.0;2022;16;TOULOUSE;MASCULIN;ENSEIGNEMENT A DISTANCE;BAC TECHNOLOGIQUE;BAC STMG;BAC STMG MERCATIQUE (MARKETING);6;5;4;0;1;1;0;5;0;0;0;1;4;0
16429.0;2022;16;TOULOUSE;MASCULIN;ENSEIGNEMENT A DISTANCE;BAC TECHNOLOGIQUE;BAC STMG;BAC STMG RESSOURCES HUMAINES ET COMMUNICATION;1;1;1;0;0;0;0;1;0;0;0;1;0;0
16433.0;2022;16;TOULOUSE;MASCULIN;FORMATION CONTINUE;BAC PROFESSIONNEL;BAC PRO PROD;BAC PRO 25106 TECHNICIEN D'USINAGE;1;1;1;0;0;0;0;1;0;0;0;1;0;0
16436.0;2022;16;TOULOUSE;MASCULIN;FORMATION CONTINUE;BAC PROFESSIONNEL;BAC PRO PROD;BAC PRO 25509 TECHNIC. FROID CONDITIONNEMT AIR;1;1;1;0;0;0;0;1;0;0;1;0;0;0
16446.0;2022;16;TOULOUSE;MASCULIN;INDIVIDUEL;BAC PROFESSIONNEL;BAC PRO PROD;BAC PRO 23407 TECHNIC.FAB.BOIS ET MATERX ASSOC;1;0;0;0;0;0;0;0;0;0;0;0;0;0
16447.0;2022;16;TOULOUSE;MASCULIN;INDIVIDUEL;BAC PROFESSIONNEL;BAC PRO PROD;BAC PRO 25007 MAINTENANCE EQUIPEMENTS INDUST.;3;2;0;2;0;0;0;0;0;0;0;0;0;2
16449.0;2022;16;TOULOUSE;MASCULIN;INDIVIDUEL;BAC PROFESSIONNEL;BAC PRO PROD;BAC PRO 25215 MAINT.VEHIC.OPTB VEHIC.TRANS.ROUT;1;1;0;1;0;0;0;0;0;0;0;0;0;1
16453.0;2022;16;TOULOUSE;MASCULIN;INDIVIDUEL;BAC PROFESSIONNEL;BAC PRO PROD;BAC PRO 25515 SYST.NUM.OPT.C RES.INF.SYST.COMM.;2;2;2;0;0;0;0;2;0;0;0;1;1;0
16456.0;2022;16;TOULOUSE;MASCULIN;INDIVIDUEL;BAC PROFESSIONNEL;BAC PRO PROD;BAC PRO AG 21114 CONDUITE PRODUCTIONS HORTICOLES;3;2;2;0;0;0;0;2;0;0;0;0;2;0
16467.0;2022;16;TOULOUSE;MASCULIN;INDIVIDUEL;BAC TECHNOLOGIQUE;BAC STD2A;BAC STD2A SCIENCES & TECHNO. DESIGN-ARTS APPLIQUES;1;0;0;0;0;0;0;0;0;0;0;0;0;0
16469.0;2022;16;TOULOUSE;MASCULIN;INDIVIDUEL;BAC TECHNOLOGIQUE;BAC STI2D;BAC STI2D SYSTÈME D'INFORMATION  ET NUMERIQUE;3;1;0;1;0;0;0;0;0;0;0;0;0;1
16480.0;2022;16;TOULOUSE;MASCULIN;SCOLAIRE;BAC PROFESSIONNEL;BAC PRO PROD;BAC PRO 22403 ARTS.& MET.ART:MET.ENSEIGN SIGNA;10;10;10;0;0;0;0;10;0;2;3;3;2;0
16488.0;2022;16;TOULOUSE;MASCULIN;SCOLAIRE;BAC PROFESSIONNEL;BAC PRO PROD;BAC PRO 23102 TRAVAUX PUBLICS;38;38;25;8;5;5;0;30;0;1;1;10;18;8
16491.0;2022;16;TOULOUSE;MASCULIN;SCOLAIRE;BAC PROFESSIONNEL;BAC PRO PROD;BAC PRO 23205 INTERV. SUR PATRIMOINE BATI OPT.A;3;3;1;2;0;0;0;1;0;0;0;0;1;2
16505.0;2022;16;TOULOUSE;MASCULIN;SCOLAIRE;BAC PROFESSIONNEL;BAC PRO PROD;BAC PRO 25107 TECHNICIEN OUTILLEUR;12;12;6;4;2;1;1;7;0;0;4;1;2;5
16511.0;2022;16;TOULOUSE;MASCULIN;SCOLAIRE;BAC PROFESSIONNEL;BAC PRO PROD;BAC PRO 25220 MAINT.MATERIELS OPT.B TP MANUT.;27;27;19;6;2;1;1;20;0;0;7;7;6;7
16512.0;2022;16;TOULOUSE;MASCULIN;SCOLAIRE;BAC PROFESSIONNEL;BAC PRO PROD;BAC PRO 25221 MAINT.MATERIELS OPT.C ESP. VERTS;13;13;7;4;2;2;0;9;0;0;2;2;5;4
16514.0;2022;16;TOULOUSE;MASCULIN;SCOLAIRE;BAC PROFESSIONNEL;BAC PRO PROD;BAC PRO 25303 AERONAUTIQUE OPTION SYSTEMES;21;21;14;7;0;0;0;14;0;2;3;4;5;7
16521.0;2022;16;TOULOUSE;MASCULIN;SCOLAIRE;BAC PROFESSIONNEL;BAC PRO PROD;BAC PRO 25513 SYST.NUM.OPT.A SURETE SECURITE;29;29;23;5;1;1;0;24;0;0;2;10;12;5
16522.0;2022;16;TOULOUSE;MASCULIN;SCOLAIRE;BAC PROFESSIONNEL;BAC PRO PROD;BAC PRO 25514 SYST.NUM.OPT.B AUD.RES.EQUIP.DOM.;70;70;67;3;0;0;0;67;0;8;14;29;16;3
16526.0;2022;16;TOULOUSE;MASCULIN;SCOLAIRE;BAC PROFESSIONNEL;BAC PRO PROD;BAC PRO AG 21113 CGEVV;4;4;4;0;0;0;0;4;0;0;3;0;1;0
16527.0;2022;16;TOULOUSE;MASCULIN;SCOLAIRE;BAC PROFESSIONNEL;BAC PRO PROD;BAC PRO AG 21114 CONDUITE PRODUCTIONS HORTICOLES;14;14;12;2;0;0;0;12;0;0;1;4;7;2
16533.0;2022;16;TOULOUSE;MASCULIN;SCOLAIRE;BAC PROFESSIONNEL;BAC PRO PROD;BAC PRO AG 21405 AMENAGEMENTS PAYSAGERS;80;78;72;6;0;0;0;72;0;1;13;26;32;6
16536.0;2022;16;TOULOUSE;MASCULIN;SCOLAIRE;BAC PROFESSIONNEL;BAC PRO PROD;BAC PRO AG 22107 TEC CONS VTE ALIMENTATION P.ALIM;17;17;15;2;0;0;0;15;0;0;1;2;12;2
16537.0;2022;16;TOULOUSE;MASCULIN;SCOLAIRE;BAC PROFESSIONNEL;BAC PRO SERV;BAC PRO 30001 GESTION-ADMINISTRATION;224;224;153;58;13;13;0;166;0;2;19;71;74;58
16542.0;2022;16;TOULOUSE;MASCULIN;SCOLAIRE;BAC PROFESSIONNEL;BAC PRO SERV;BAC PRO 31213 MET.COM.VEN.OP.A ANI.GES.ESP.COM.;415;412;332;63;17;10;7;342;0;5;42;127;168;70
16543.0;2022;16;TOULOUSE;MASCULIN;SCOLAIRE;BAC PROFESSIONNEL;BAC PRO SERV;BAC PRO 31214 MET.COM.VEN.OP.B PR.CL.VA.OF.COM.;186;185;149;26;10;7;3;156;0;6;21;58;71;29
16544.0;2022;16;TOULOUSE;MASCULIN;SCOLAIRE;BAC PROFESSIONNEL;BAC PRO SERV;BAC PRO 32207 REAL.PR.IMPR.PLURI.OPTA.PR.GRAPH.;10;10;10;0;0;0;0;10;0;0;6;2;2;0
16554.0;2022;16;TOULOUSE;MASCULIN;SCOLAIRE;BAC PROFESSIONNEL;BAC PRO SERV;BAC PRO 33403 COMMERC. SERVICES EN RESTAURATION;80;80;59;16;5;4;1;63;0;1;10;24;28;17
16555.0;2022;16;TOULOUSE;MASCULIN;SCOLAIRE;BAC PROFESSIONNEL;BAC PRO SERV;BAC PRO 33603 ESTHETIQUE COSMETIQUE PARFUMERIE;2;2;1;1;0;0;0;1;0;0;0;1;0;1
16556.0;2022;16;TOULOUSE;MASCULIN;SCOLAIRE;BAC PROFESSIONNEL;BAC PRO SERV;BAC PRO 34304 HYGIENE PROPRETE STERILISATION;2;2;2;0;0;0;0;2;0;0;1;1;0;0
16558.0;2022;16;TOULOUSE;MASCULIN;SCOLAIRE;BAC PROFESSIONNEL;BAC PRO SERV;BAC PRO AG 33002 SERV PERS TERRIT;42;42;39;3;0;0;0;39;0;0;6;14;19;3
16567.0;2022;16;TOULOUSE;MASCULIN;SCOLAIRE;BAC TECHNOLOGIQUE;BAC STI2D;BAC STI2D ENERGIES  ET ENVIRONNEMENT;153;153;136;5;12;8;4;144;0;1;27;53;63;9
16570.0;2022;16;TOULOUSE;MASCULIN;SCOLAIRE;BAC TECHNOLOGIQUE;BAC STL;BAC STL BIOCHIM.-BIOLOGIE-BIOTECHNOL.;82;82;66;3;13;9;4;75;0;0;9;25;41;7
16572.0;2022;16;TOULOUSE;MASCULIN;SCOLAIRE;BAC TECHNOLOGIQUE;BAC STMG;BAC STMG GESTION ET FINANCE;367;367;321;10;36;26;10;347;0;6;38;138;165;20
16580.0;2022;25;VERSAILLES;FEMININ;APPRENTISSAGE;BAC PROFESSIONNEL;BAC PRO PROD;BAC PRO 25007 MAINTENANCE EQUIPEMENTS INDUST.;1;1;1;0;0;0;0;1;0;1;0;0;0;0
16583.0;2022;25;VERSAILLES;FEMININ;APPRENTISSAGE;BAC PROFESSIONNEL;BAC PRO PROD;BAC PRO 25215 MAINT.VEHIC.OPTB VEHIC.TRANS.ROUT;2;2;2;0;0;0;0;2;0;0;0;1;1;0
16585.0;2022;25;VERSAILLES;FEMININ;APPRENTISSAGE;BAC PROFESSIONNEL;BAC PRO PROD;BAC PRO 25221 MAINT.MATERIELS OPT.C ESP. VERTS;1;1;1;0;0;0;0;1;0;0;0;0;1;0
16588.0;2022;25;VERSAILLES;FEMININ;APPRENTISSAGE;BAC PROFESSIONNEL;BAC PRO PROD;BAC PRO 25510 METIERS ELECT. ENVIRON. CONNECTES;1;1;1;0;0;0;0;1;0;1;0;0;0;0
16591.0;2022;25;VERSAILLES;FEMININ;APPRENTISSAGE;BAC PROFESSIONNEL;BAC PRO PROD;BAC PRO AG 21405 AMENAGEMENTS PAYSAGERS;3;3;2;1;0;0;0;2;0;0;1;0;1;1
16597.0;2022;25;VERSAILLES;FEMININ;APPRENTISSAGE;BAC PROFESSIONNEL;BAC PRO SERV;BAC PRO 33004 ACC.SOINS-S.PERS. OPT.EN STRUCTUR;24;24;23;0;1;0;1;23;0;3;12;4;4;1
16600.0;2022;25;VERSAILLES;FEMININ;APPRENTISSAGE;BAC PROFESSIONNEL;BAC PRO SERV;BAC PRO 33603 ESTHETIQUE COSMETIQUE PARFUMERIE;8;8;7;1;0;0;0;7;0;0;1;4;2;1
16606.0;2022;25;VERSAILLES;FEMININ;ENSEIGNEMENT A DISTANCE;BAC PROFESSIONNEL;BAC PRO SERV;BAC PRO 31213 MET.COM.VEN.OP.A ANI.GES.ESP.COM.;6;5;3;2;0;0;0;3;0;0;2;0;1;2
16612.0;2022;25;VERSAILLES;FEMININ;ENSEIGNEMENT A DISTANCE;BAC TECHNOLOGIQUE;BAC STMG;BAC STMG GESTION ET FINANCE;5;5;2;3;0;0;0;2;0;0;0;1;1;3
16613.0;2022;25;VERSAILLES;FEMININ;ENSEIGNEMENT A DISTANCE;BAC TECHNOLOGIQUE;BAC STMG;BAC STMG MERCATIQUE (MARKETING);11;10;10;0;0;0;0;10;0;1;1;5;3;0
16617.0;2022;25;VERSAILLES;FEMININ;FORMATION CONTINUE;BAC PROFESSIONNEL;BAC PRO PROD;BAC PRO 22106 CUISINE;1;1;1;0;0;0;0;1;0;0;0;0;1;0
16621.0;2022;25;VERSAILLES;FEMININ;FORMATION CONTINUE;BAC PROFESSIONNEL;BAC PRO SERV;BAC PRO 30001 GESTION-ADMINISTRATION;17;16;15;1;0;0;0;15;0;2;6;4;3;1
16624.0;2022;25;VERSAILLES;FEMININ;FORMATION CONTINUE;BAC PROFESSIONNEL;BAC PRO SERV;BAC PRO 33403 COMMERC. SERVICES EN RESTAURATION;1;0;0;0;0;0;0;0;0;0;0;0;0;0
16628.0;2022;25;VERSAILLES;FEMININ;INDIVIDUEL;BAC PROFESSIONNEL;BAC PRO PROD;BAC PRO 23408 Etude et réalisation d'agencement;1;0;0;0;0;0;0;0;0;0;0;0;0;0
16630.0;2022;25;VERSAILLES;FEMININ;INDIVIDUEL;BAC PROFESSIONNEL;BAC PRO PROD;BAC PRO AG 21004 CGEA;8;6;6;0;0;0;0;6;0;0;0;0;6;0
16633.0;2022;25;VERSAILLES;FEMININ;INDIVIDUEL;BAC PROFESSIONNEL;BAC PRO PROD;BAC PRO AG 21211 COND GEST ENTR HIPPIQUE;6;4;4;0;0;0;0;4;0;0;0;0;4;0
16639.0;2022;25;VERSAILLES;FEMININ;INDIVIDUEL;BAC PROFESSIONNEL;BAC PRO SERV;BAC PRO 33002 SERVICES DE PROXIMITE  VIE LOCAL;5;1;1;0;0;0;0;1;0;0;0;0;1;0
16652.0;2022;25;VERSAILLES;FEMININ;SCOLAIRE;BAC GENERAL;BAC GENERAL;BAC GENE 10019 BAC GENERAL;21569;21569;20091;344;1134;758;376;20849;404;3215;5976;6351;4903;720
16655.0;2022;25;VERSAILLES;FEMININ;SCOLAIRE;BAC PROFESSIONNEL;BAC PRO PROD;BAC PRO 22105 BOULANGER-PÂTISSIER;47;47;44;3;0;0;0;44;0;3;18;14;9;3
16658.0;2022;25;VERSAILLES;FEMININ;SCOLAIRE;BAC PROFESSIONNEL;BAC PRO PROD;BAC PRO 23004 TECHN. ETUDES BAT.A ETUDES & ECO.;7;7;6;1;0;0;0;6;0;0;2;1;3;1
16659.0;2022;25;VERSAILLES;FEMININ;SCOLAIRE;BAC PROFESSIONNEL;BAC PRO PROD;BAC PRO 23005 TECHN. ETUDES BAT B ASSIST.ARCHI.;28;28;21;7;0;0;0;21;0;0;3;10;8;7
16660.0;2022;25;VERSAILLES;FEMININ;SCOLAIRE;BAC PROFESSIONNEL;BAC PRO PROD;BACPRO 23103 TECHNICIEN GEOMETRE-TOPOGRAPHE;3;3;3;0;0;0;0;3;0;0;0;1;2;0
16668.0;2022;25;VERSAILLES;FEMININ;SCOLAIRE;BAC PROFESSIONNEL;BAC PRO PROD;BAC PRO 25007 MAINTENANCE EQUIPEMENTS INDUST.;1;1;1;0;0;0;0;1;0;0;0;0;1;0
16671.0;2022;25;VERSAILLES;FEMININ;SCOLAIRE;BAC PROFESSIONNEL;BAC PRO PROD;BAC PRO 25214 MAINT.VEHIC.OPTA VOIT.PARTICUL.;2;2;1;1;0;0;0;1;0;0;0;1;0;1
16672.0;2022;25;VERSAILLES;FEMININ;SCOLAIRE;BAC PROFESSIONNEL;BAC PRO PROD;BAC PRO 25220 MAINT.MATERIELS OPT.B TP MANUT.;1;1;1;0;0;0;0;1;0;0;1;0;0;0
16685.0;2022;25;VERSAILLES;FEMININ;SCOLAIRE;BAC PROFESSIONNEL;BAC PRO PROD;BAC PRO AG 21203 TECHN CONSEIL DE VENTE ANIMAL;24;24;16;8;0;0;0;16;0;0;2;6;8;8
16690.0;2022;25;VERSAILLES;FEMININ;SCOLAIRE;BAC PROFESSIONNEL;BAC PRO SERV;BAC PRO 31107 CONDUCT. TRANSP.ROUT.MARCHANDISES;2;2;1;1;0;0;0;1;0;0;0;1;0;1
16698.0;2022;25;VERSAILLES;FEMININ;SCOLAIRE;BAC PROFESSIONNEL;BAC PRO SERV;BAC PRO 32303 ART.& MET.ART:COM.VIS.VIS.PLURI-M;68;67;60;7;0;0;0;60;0;3;15;24;18;7
16699.0;2022;25;VERSAILLES;FEMININ;SCOLAIRE;BAC PROFESSIONNEL;BAC PRO SERV;BAC PRO 32304 PHOTOGRAPHIE;12;12;11;1;0;0;0;11;0;0;0;5;6;1
16704.0;2022;25;VERSAILLES;FEMININ;SCOLAIRE;BAC PROFESSIONNEL;BAC PRO SERV;BAC PRO 33403 COMMERC. SERVICES EN RESTAURATION;64;64;48;12;4;3;1;51;0;4;10;16;21;13
16707.0;2022;25;VERSAILLES;FEMININ;SCOLAIRE;BAC PROFESSIONNEL;BAC PRO SERV;BAC PRO 34403 METIERS DE LA SECURITE;60;60;51;3;6;6;0;57;0;7;19;13;18;3
16712.0;2022;25;VERSAILLES;FEMININ;SCOLAIRE;BAC TECHNOLOGIQUE;BAC STAV;BAC STAV AGRONOMIE ALIM ENV TERRITOI;42;42;41;1;0;0;0;41;0;0;4;15;22;1
16715.0;2022;25;VERSAILLES;FEMININ;SCOLAIRE;BAC TECHNOLOGIQUE;BAC STI2D;BAC STI2D ARCHITECTURE ET CONSTRUCTION;60;60;55;2;3;2;1;57;0;1;3;24;29;3
16718.0;2022;25;VERSAILLES;FEMININ;SCOLAIRE;BAC TECHNOLOGIQUE;BAC STI2D;BAC STI2D SYSTÈME D'INFORMATION  ET NUMERIQUE;64;64;56;1;7;5;2;61;0;1;8;25;27;3
16728.0;2022;25;VERSAILLES;MASCULIN;APPRENTISSAGE;BAC PROFESSIONNEL;BAC PRO PROD;BAC PRO 22704 TECHN. MAINT. SYST.ENERG.CLIMATI;55;52;32;18;2;2;0;34;0;4;6;6;18;18
16731.0;2022;25;VERSAILLES;MASCULIN;APPRENTISSAGE;BAC PROFESSIONNEL;BAC PRO PROD;BAC PRO 23203 TECHNICIEN BAT. : ORG.REAL.GROS O;21;21;18;2;1;1;0;19;0;1;3;8;7;2
16733.0;2022;25;VERSAILLES;MASCULIN;APPRENTISSAGE;BAC PROFESSIONNEL;BAC PRO PROD;BAC PRO 23405 TECHNICIEN MENUISIER AGENCEUR;4;4;2;2;0;0;0;2;0;0;0;0;2;2
16735.0;2022;25;VERSAILLES;MASCULIN;APPRENTISSAGE;BAC PROFESSIONNEL;BAC PRO PROD;BAC PRO 25007 MAINTENANCE EQUIPEMENTS INDUST.;20;20;13;7;0;0;0;13;0;1;3;3;6;7
16761.0;2022;25;VERSAILLES;MASCULIN;APPRENTISSAGE;BAC PROFESSIONNEL;BAC PRO SERV;BAC PRO 31213 MET.COM.VEN.OP.A ANI.GES.ESP.COM.;151;146;112;25;9;5;4;117;0;3;25;41;48;29
16762.0;2022;25;VERSAILLES;MASCULIN;APPRENTISSAGE;BAC PROFESSIONNEL;BAC PRO SERV;BAC PRO 31214 MET.COM.VEN.OP.B PR.CL.VA.OF.COM.;25;23;17;4;2;2;0;19;0;0;6;5;8;4
16764.0;2022;25;VERSAILLES;MASCULIN;APPRENTISSAGE;BAC PROFESSIONNEL;BAC PRO SERV;BAC PRO 33403 COMMERC. SERVICES EN RESTAURATION;44;44;34;8;2;2;0;36;0;1;8;11;16;8
16768.0;2022;25;VERSAILLES;MASCULIN;ENSEIGNEMENT A DISTANCE;BAC GENERAL;BAC GENERAL;BAC GENE 10019 BAC GENERAL;48;45;32;8;5;4;1;36;0;1;6;7;22;9
16773.0;2022;25;VERSAILLES;MASCULIN;ENSEIGNEMENT A DISTANCE;BAC TECHNOLOGIQUE;BAC ST2S;BAC ST2S SCIENCES & TECHNO. SANTE & SOCIAL;2;2;1;0;1;1;0;2;0;0;0;1;1;0
16777.0;2022;25;VERSAILLES;MASCULIN;ENSEIGNEMENT A DISTANCE;BAC TECHNOLOGIQUE;BAC STMG;BAC STMG SYSTEMES D'INFORMATION DE GESTION;1;1;1;0;0;0;0;1;0;0;1;0;0;0
16780.0;2022;25;VERSAILLES;MASCULIN;FORMATION CONTINUE;BAC PROFESSIONNEL;BAC PRO PROD;BAC PRO 22703 TECHN.INSTALL.SYST.ENERG.CLIMATI;10;7;6;1;0;0;0;6;0;0;1;1;4;1
16781.0;2022;25;VERSAILLES;MASCULIN;FORMATION CONTINUE;BAC PROFESSIONNEL;BAC PRO PROD;BAC PRO 23004 TECHN. ETUDES BAT.A ETUDES & ECO.;3;3;2;1;0;0;0;2;0;0;0;1;1;1
16782.0;2022;25;VERSAILLES;MASCULIN;FORMATION CONTINUE;BAC PROFESSIONNEL;BAC PRO PROD;BAC PRO 23005 TECHN. ETUDES BAT B ASSIST.ARCHI.;3;3;2;1;0;0;0;2;0;0;0;1;1;1
16792.0;2022;25;VERSAILLES;MASCULIN;INDIVIDUEL;BAC GENERAL;BAC GENERAL;BAC GENE 10019 BAC GENERAL;337;224;135;56;33;24;9;159;1;23;33;38;64;65
16801.0;2022;25;VERSAILLES;MASCULIN;INDIVIDUEL;BAC PROFESSIONNEL;BAC PRO PROD;BAC PRO 25007 MAINTENANCE EQUIPEMENTS INDUST.;1;1;0;1;0;0;0;0;0;0;0;0;0;1
16803.0;2022;25;VERSAILLES;MASCULIN;INDIVIDUEL;BAC PROFESSIONNEL;BAC PRO PROD;BAC PRO 25221 MAINT.MATERIELS OPT.C ESP. VERTS;1;0;0;0;0;0;0;0;0;0;0;0;0;0
16815.0;2022;25;VERSAILLES;MASCULIN;INDIVIDUEL;BAC PROFESSIONNEL;BAC PRO PROD;BAC PRO AG 21405 AMENAGEMENTS PAYSAGERS;2;1;1;0;0;0;0;1;0;0;0;1;0;0
16816.0;2022;25;VERSAILLES;MASCULIN;INDIVIDUEL;BAC PROFESSIONNEL;BAC PRO SERV;BAC PRO 30001 GESTION-ADMINISTRATION;33;20;3;15;2;1;1;4;0;0;0;1;3;16
16819.0;2022;25;VERSAILLES;MASCULIN;INDIVIDUEL;BAC PROFESSIONNEL;BAC PRO SERV;BAC PRO 31213 MET.COM.VEN.OP.A ANI.GES.ESP.COM.;16;10;3;6;1;1;0;4;0;0;1;0;3;6
16822.0;2022;25;VERSAILLES;MASCULIN;INDIVIDUEL;BAC PROFESSIONNEL;BAC PRO SERV;BAC PRO 32208 REAL.PR.IMPR.PLURI.OPTB.PR.IMPR.;1;1;0;1;0;0;0;0;0;0;0;0;0;1
16830.0;2022;25;VERSAILLES;MASCULIN;INDIVIDUEL;BAC TECHNOLOGIQUE;BAC STD2A;BAC STD2A SCIENCES & TECHNO. DESIGN-ARTS APPLIQUES;5;4;2;0;2;1;1;3;0;0;0;0;3;1
16846.0;2022;25;VERSAILLES;MASCULIN;SCOLAIRE;BAC PROFESSIONNEL;BAC PRO PROD;BAC PRO 22105 BOULANGER-PÂTISSIER;56;56;50;5;1;1;0;51;0;1;11;20;19;5
16847.0;2022;25;VERSAILLES;MASCULIN;SCOLAIRE;BAC PROFESSIONNEL;BAC PRO PROD;BAC PRO 22106 CUISINE;169;169;137;23;9;6;3;143;0;9;41;43;50;26
16857.0;2022;25;VERSAILLES;MASCULIN;SCOLAIRE;BAC PROFESSIONNEL;BAC PRO PROD;BAC PRO 23303 MENUISERIE ALUMINIUM-VERRE;11;11;5;5;1;1;0;6;0;0;2;1;3;5
16861.0;2022;25;VERSAILLES;MASCULIN;SCOLAIRE;BAC PROFESSIONNEL;BAC PRO PROD;BAC PRO 23408 Etude et réalisation d'agencement;21;21;12;8;1;1;0;13;0;1;2;2;8;8
16863.0;2022;25;VERSAILLES;MASCULIN;SCOLAIRE;BAC PROFESSIONNEL;BAC PRO PROD;BAC PRO 24203 METIERS DE LA MODE - VÊTEMENT;12;12;9;3;0;0;0;9;0;1;3;3;2;3
16865.0;2022;25;VERSAILLES;MASCULIN;SCOLAIRE;BAC PROFESSIONNEL;BAC PRO PROD;BAC PRO 25006 MICROTECHNIQUES;142;142;109;27;6;6;0;115;0;3;21;51;40;27
16866.0;2022;25;VERSAILLES;MASCULIN;SCOLAIRE;BAC PROFESSIONNEL;BAC PRO PROD;BAC PRO 25007 MAINTENANCE EQUIPEMENTS INDUST.;263;261;169;71;21;18;3;187;0;1;29;68;89;74
16868.0;2022;25;VERSAILLES;MASCULIN;SCOLAIRE;BAC PROFESSIONNEL;BAC PRO PROD;BAC PRO 25106 TECHNICIEN D'USINAGE;120;120;72;41;7;3;4;75;0;5;15;25;30;45
16878.0;2022;25;VERSAILLES;MASCULIN;SCOLAIRE;BAC PROFESSIONNEL;BAC PRO PROD;BAC PRO 25305 AVIATION GENERALE;10;10;6;4;0;0;0;6;0;0;3;0;3;4
16884.0;2022;25;VERSAILLES;MASCULIN;SCOLAIRE;BAC PROFESSIONNEL;BAC PRO PROD;BAC PRO 25510 METIERS ELECT. ENVIRON. CONNECTES;1202;1194;823;301;70;44;26;867;0;31;131;306;399;327
16885.0;2022;25;VERSAILLES;MASCULIN;SCOLAIRE;BAC PROFESSIONNEL;BAC PRO PROD;BAC PRO 25513 SYST.NUM.OPT.A SURETE SECURITE;113;113;95;15;3;2;1;97;0;5;20;38;34;16
16893.0;2022;25;VERSAILLES;MASCULIN;SCOLAIRE;BAC PROFESSIONNEL;BAC PRO PROD;BAC PRO AG 21405 AMENAGEMENTS PAYSAGERS;40;38;36;2;0;0;0;36;0;0;5;17;14;2
16894.0;2022;25;VERSAILLES;MASCULIN;SCOLAIRE;BAC PROFESSIONNEL;BAC PRO SERV;BAC PRO 30001 GESTION-ADMINISTRATION;903;903;601;236;66;44;22;645;0;8;83;187;367;258
16896.0;2022;25;VERSAILLES;MASCULIN;SCOLAIRE;BAC PROFESSIONNEL;BAC PRO SERV;BAC PRO 31107 CONDUCT. TRANSP.ROUT.MARCHANDISES;38;38;25;12;1;0;1;25;0;2;7;8;8;13
16897.0;2022;25;VERSAILLES;MASCULIN;SCOLAIRE;BAC PROFESSIONNEL;BAC PRO SERV;BAC PRO 31108 TRANSPORT;39;39;26;13;0;0;0;26;0;1;1;13;11;13
16899.0;2022;25;VERSAILLES;MASCULIN;SCOLAIRE;BAC PROFESSIONNEL;BAC PRO SERV;BAC PRO 31213 MET.COM.VEN.OP.A ANI.GES.ESP.COM.;1036;1034;687;274;73;47;26;734;0;22;95;276;341;300
16928.0;2022;25;VERSAILLES;MASCULIN;SCOLAIRE;BAC TECHNOLOGIQUE;BAC STMG;BAC STMG RESSOURCES HUMAINES ET COMMUNICATION;861;861;596;94;171;108;63;704;0;5;43;210;446;157
16939.0;2023;02;AIX-MARSEILLE;FEMININ;APPRENTISSAGE;BAC PROFESSIONNEL;BAC PRO PROD;BAC PRO 25510 METIERS ELECT. ENVIRON. CONNECTES;2;2;2;0;0;0;0;2;0;2;0;0;0;0
16941.0;2023;02;AIX-MARSEILLE;FEMININ;APPRENTISSAGE;BAC PROFESSIONNEL;BAC PRO PROD;BAC PRO AG 21113 CGEVV;2;2;2;0;0;0;0;2;0;0;0;0;2;0
16944.0;2023;02;AIX-MARSEILLE;FEMININ;APPRENTISSAGE;BAC PROFESSIONNEL;BAC PRO PROD;BAC PRO AG 21210 COND GEST ENTR CANIN ET FELIN;2;2;2;0;0;0;0;2;0;0;0;0;2;0
16949.0;2023;02;AIX-MARSEILLE;FEMININ;APPRENTISSAGE;BAC PROFESSIONNEL;BAC PRO SERV;BAC PRO 31106 LOGISTIQUE;6;6;6;0;0;0;0;6;0;1;2;2;1;0
16950.0;2023;02;AIX-MARSEILLE;FEMININ;APPRENTISSAGE;BAC PROFESSIONNEL;BAC PRO SERV;BAC PRO 31212 METIERS DE L'ACCUEIL;6;6;5;1;0;0;0;5;0;2;1;2;0;1
16955.0;2023;02;AIX-MARSEILLE;FEMININ;APPRENTISSAGE;BAC PROFESSIONNEL;BAC PRO SERV;BAC PRO 33101 OPTIQUE LUNETTERIE;3;3;3;0;0;0;0;3;0;0;1;1;1;0
16957.0;2023;02;AIX-MARSEILLE;FEMININ;APPRENTISSAGE;BAC PROFESSIONNEL;BAC PRO SERV;BAC PRO 33403 COMMERC. SERVICES EN RESTAURATION;12;11;9;1;1;1;0;10;0;1;2;5;2;1
16963.0;2023;02;AIX-MARSEILLE;FEMININ;ENSEIGNEMENT A DISTANCE;BAC PROFESSIONNEL;BAC PRO SERV;BAC PRO 31213 MET.COM.VEN.OP.A ANI.GES.ESP.COM.;3;2;1;1;0;0;0;1;0;0;1;0;0;1
16968.0;2023;02;AIX-MARSEILLE;FEMININ;ENSEIGNEMENT A DISTANCE;BAC TECHNOLOGIQUE;BAC ST2S;BAC ST2S SCIENCES & TECHNO. SANTE & SOCIAL;12;12;9;2;1;0;1;9;0;0;0;2;7;3
16973.0;2023;02;AIX-MARSEILLE;FEMININ;FORMATION CONTINUE;BAC PROFESSIONNEL;BAC PRO PROD;BAC PRO 24203 METIERS DE LA MODE - VÊTEMENT;1;1;1;0;0;0;0;1;0;1;0;0;0;0
16979.0;2023;02;AIX-MARSEILLE;FEMININ;FORMATION CONTINUE;BAC PROFESSIONNEL;BAC PRO SERV;BAC PRO 32304 PHOTOGRAPHIE;4;4;4;0;0;0;0;4;0;0;0;2;2;0
16980.0;2023;02;AIX-MARSEILLE;FEMININ;FORMATION CONTINUE;BAC PROFESSIONNEL;BAC PRO SERV;BAC PRO 33101 OPTIQUE LUNETTERIE;1;1;1;0;0;0;0;1;0;0;1;0;0;0
16981.0;2023;02;AIX-MARSEILLE;FEMININ;FORMATION CONTINUE;BAC PROFESSIONNEL;BAC PRO SERV;BAC PRO 33403 COMMERC. SERVICES EN RESTAURATION;1;1;0;1;0;0;0;0;0;0;0;0;0;1
16985.0;2023;02;AIX-MARSEILLE;FEMININ;INDIVIDUEL;BAC PROFESSIONNEL;BAC PRO PROD;BAC PRO 22106 CUISINE;2;1;0;1;0;0;0;0;0;0;0;0;0;1
17002.0;2023;02;AIX-MARSEILLE;FEMININ;INDIVIDUEL;BAC TECHNOLOGIQUE;BAC STAV;BAC STAV AGRONOMIE ALIM ENV TERRITOI;1;0;0;0;0;0;0;0;0;0;0;0;0;0
17004.0;2023;02;AIX-MARSEILLE;FEMININ;INDIVIDUEL;BAC TECHNOLOGIQUE;BAC STHR;BAC STHR SC.&TEC. HOTELLERIE-RESTAURATION;6;6;6;0;0;0;0;6;0;1;2;2;1;0
17007.0;2023;02;AIX-MARSEILLE;FEMININ;INDIVIDUEL;BAC TECHNOLOGIQUE;BAC STMG;BAC STMG GESTION ET FINANCE;7;7;0;6;1;0;1;0;0;0;0;0;0;7
17022.0;2023;02;AIX-MARSEILLE;FEMININ;SCOLAIRE;BAC PROFESSIONNEL;BAC PRO PROD;BAC PRO 23304 AMENAGEMENT FINITION BATIMENT;6;6;4;1;1;1;0;5;0;0;1;0;4;1
17031.0;2023;02;AIX-MARSEILLE;FEMININ;SCOLAIRE;BAC PROFESSIONNEL;BAC PRO PROD;BAC PRO 25216 MAINT.VEHIC.OPTC MOTOCYCLES;2;2;1;1;0;0;0;1;0;0;0;1;0;1
17043.0;2023;02;AIX-MARSEILLE;FEMININ;SCOLAIRE;BAC PROFESSIONNEL;BAC PRO PROD;BAC PRO AG 21210 COND GEST ENTR CANIN ET FELIN;16;16;14;2;0;0;0;14;0;0;0;5;9;2
17044.0;2023;02;AIX-MARSEILLE;FEMININ;SCOLAIRE;BAC PROFESSIONNEL;BAC PRO PROD;BAC PRO AG 21211 COND GEST ENTR HIPPIQUE;6;6;6;0;0;0;0;6;0;0;0;1;5;0
17049.0;2023;02;AIX-MARSEILLE;FEMININ;SCOLAIRE;BAC PROFESSIONNEL;BAC PRO PROD;BAC PRO AG 22108 TEC CONS VTE ALIMENTATION (PAB);20;20;16;4;0;0;0;16;0;0;1;5;10;4
17053.0;2023;02;AIX-MARSEILLE;FEMININ;SCOLAIRE;BAC PROFESSIONNEL;BAC PRO SERV;BAC PRO 31114 ORGANIS. TRANSPORT MARCHANDISES;4;4;1;3;0;0;0;1;0;0;1;0;0;3
17054.0;2023;02;AIX-MARSEILLE;FEMININ;SCOLAIRE;BAC PROFESSIONNEL;BAC PRO SERV;BAC PRO 31212 METIERS DE L'ACCUEIL;337;337;271;42;24;14;10;285;0;14;50;94;127;52
17055.0;2023;02;AIX-MARSEILLE;FEMININ;SCOLAIRE;BAC PROFESSIONNEL;BAC PRO SERV;BAC PRO 31213 MET.COM.VEN.OP.A ANI.GES.ESP.COM.;363;361;309;33;19;11;8;320;0;11;73;113;123;41
17064.0;2023;02;AIX-MARSEILLE;FEMININ;SCOLAIRE;BAC PROFESSIONNEL;BAC PRO SERV;BAC PRO 33101 OPTIQUE LUNETTERIE;11;11;11;0;0;0;0;11;0;0;5;4;2;0
17066.0;2023;02;AIX-MARSEILLE;FEMININ;SCOLAIRE;BAC PROFESSIONNEL;BAC PRO SERV;BAC PRO 33104 TECHNICIEN EN PROTHESE DENTAIRE;6;5;5;0;0;0;0;5;0;1;0;3;1;0
17071.0;2023;02;AIX-MARSEILLE;FEMININ;SCOLAIRE;BAC PROFESSIONNEL;BAC PRO SERV;BAC PRO 34403 METIERS DE LA SECURITE;18;18;18;0;0;0;0;18;0;1;7;5;5;0
17072.0;2023;02;AIX-MARSEILLE;FEMININ;SCOLAIRE;BAC PROFESSIONNEL;BAC PRO SERV;BAC PRO AG 33002 SERV PERS TERRIT;181;179;160;19;0;0;0;160;0;1;15;45;99;19
17074.0;2023;02;AIX-MARSEILLE;FEMININ;SCOLAIRE;BAC TECHNOLOGIQUE;BAC STAV;BAC STAV AGRONOMIE ALIM ENV TERRITOI;102;102;95;7;0;0;0;95;0;1;7;27;60;7
17089.0;2023;02;AIX-MARSEILLE;MASCULIN;APPRENTISSAGE;BAC PROFESSIONNEL;BAC PRO PROD;BAC PRO 22104 BOUCHER CHARCUTIER TRAITEUR;9;6;4;2;0;0;0;4;0;0;1;2;1;2
17093.0;2023;02;AIX-MARSEILLE;MASCULIN;APPRENTISSAGE;BAC PROFESSIONNEL;BAC PRO PROD;BAC PRO 22704 TECHN. MAINT. SYST.ENERG.CLIMATI;10;10;8;2;0;0;0;8;0;0;2;2;4;2
17094.0;2023;02;AIX-MARSEILLE;MASCULIN;APPRENTISSAGE;BAC PROFESSIONNEL;BAC PRO PROD;BAC PRO 22705 TECHNICIEN GAZ;6;6;6;0;0;0;0;6;0;1;2;3;0;0
17097.0;2023;02;AIX-MARSEILLE;MASCULIN;APPRENTISSAGE;BAC PROFESSIONNEL;BAC PRO PROD;BAC PRO 23205 INTERV. SUR PATRIMOINE BATI OPT.A;1;1;1;0;0;0;0;1;0;0;0;0;1;0
17101.0;2023;02;AIX-MARSEILLE;MASCULIN;APPRENTISSAGE;BAC PROFESSIONNEL;BAC PRO PROD;BAC PRO 25007 MAINTENANCE EQUIPEMENTS INDUST.;17;17;15;2;0;0;0;15;0;2;1;6;6;2
17106.0;2023;02;AIX-MARSEILLE;MASCULIN;APPRENTISSAGE;BAC PROFESSIONNEL;BAC PRO PROD;BAC PRO 25216 MAINT.VEHIC.OPTC MOTOCYCLES;21;21;15;5;1;1;0;16;0;3;2;5;6;5
17120.0;2023;02;AIX-MARSEILLE;MASCULIN;APPRENTISSAGE;BAC PROFESSIONNEL;BAC PRO PROD;BAC PRO AG 21211 COND GEST ENTR HIPPIQUE;6;6;6;0;0;0;0;6;0;0;0;4;2;0
17130.0;2023;02;AIX-MARSEILLE;MASCULIN;APPRENTISSAGE;BAC PROFESSIONNEL;BAC PRO SERV;BAC PRO 32208 REAL.PR.IMPR.PLURI.OPTB.PR.IMPR.;4;4;2;1;1;0;1;2;0;1;1;0;0;2
17141.0;2023;02;AIX-MARSEILLE;MASCULIN;ENSEIGNEMENT A DISTANCE;BAC PROFESSIONNEL;BAC PRO SERV;BAC PRO 33003 ACC.SOINS-S.PERS. OPT.A DOMICILE;1;1;0;1;0;0;0;0;0;0;0;0;0;1
17144.0;2023;02;AIX-MARSEILLE;MASCULIN;ENSEIGNEMENT A DISTANCE;BAC TECHNOLOGIQUE;BAC ST2S;BAC ST2S SCIENCES & TECHNO. SANTE & SOCIAL;2;2;0;1;1;1;0;1;0;0;0;0;1;1
17148.0;2023;02;AIX-MARSEILLE;MASCULIN;ENSEIGNEMENT A DISTANCE;BAC TECHNOLOGIQUE;BAC STMG;BAC STMG SYSTEMES D'INFORMATION DE GESTION;2;2;1;1;0;0;0;1;0;1;0;0;0;1
17150.0;2023;02;AIX-MARSEILLE;MASCULIN;FORMATION CONTINUE;BAC PROFESSIONNEL;BAC PRO PROD;BAC PRO 22703 TECHN.INSTALL.SYST.ENERG.CLIMATI;4;3;2;1;0;0;0;2;0;0;2;0;0;1
17153.0;2023;02;AIX-MARSEILLE;MASCULIN;FORMATION CONTINUE;BAC PROFESSIONNEL;BAC PRO PROD;BAC PRO 23405 TECHNICIEN MENUISIER AGENCEUR;2;2;2;0;0;0;0;2;0;2;0;0;0;0
17179.0;2023;02;AIX-MARSEILLE;MASCULIN;INDIVIDUEL;BAC PROFESSIONNEL;BAC PRO PROD;BAC PRO AG 21004 CGEA;1;1;1;0;0;0;0;1;0;0;0;0;1;0
17181.0;2023;02;AIX-MARSEILLE;MASCULIN;INDIVIDUEL;BAC PROFESSIONNEL;BAC PRO PROD;BAC PRO AG 21114 CONDUITE PRODUCTIONS HORTICOLES;4;4;4;0;0;0;0;4;0;0;0;0;4;0
17186.0;2023;02;AIX-MARSEILLE;MASCULIN;INDIVIDUEL;BAC PROFESSIONNEL;BAC PRO SERV;BAC PRO 31213 MET.COM.VEN.OP.A ANI.GES.ESP.COM.;5;3;2;1;0;0;0;2;0;0;1;1;0;1
17190.0;2023;02;AIX-MARSEILLE;MASCULIN;INDIVIDUEL;BAC TECHNOLOGIQUE;BAC STHR;BAC STHR SC.&TEC. HOTELLERIE-RESTAURATION;8;8;8;0;0;0;0;8;0;1;2;2;3;0
17194.0;2023;02;AIX-MARSEILLE;MASCULIN;INDIVIDUEL;BAC TECHNOLOGIQUE;BAC STI2D;BAC STI2D SYSTÈME D'INFORMATION  ET NUMERIQUE;3;3;0;2;1;0;1;0;0;0;0;0;0;3
17196.0;2023;02;AIX-MARSEILLE;MASCULIN;INDIVIDUEL;BAC TECHNOLOGIQUE;BAC STMG;BAC STMG GESTION ET FINANCE;5;5;3;1;1;1;0;4;0;0;0;0;4;1
17211.0;2023;02;AIX-MARSEILLE;MASCULIN;SCOLAIRE;BAC PROFESSIONNEL;BAC PRO PROD;BAC PRO 23004 TECHN. ETUDES BAT.A ETUDES & ECO.;38;38;34;2;2;2;0;36;0;1;3;12;20;2
17225.0;2023;02;AIX-MARSEILLE;MASCULIN;SCOLAIRE;BAC PROFESSIONNEL;BAC PRO PROD;BAC PRO 25009 MAINTENANCE NAUTIQUE;41;41;29;11;1;1;0;30;0;1;3;9;17;11
17232.0;2023;02;AIX-MARSEILLE;MASCULIN;SCOLAIRE;BAC PROFESSIONNEL;BAC PRO PROD;BAC PRO 25220 MAINT.MATERIELS OPT.B TP MANUT.;16;16;13;2;1;1;0;14;0;0;2;3;9;2
17247.0;2023;02;AIX-MARSEILLE;MASCULIN;SCOLAIRE;BAC PROFESSIONNEL;BAC PRO PROD;BAC PRO AG 21113 CGEVV;29;29;26;3;0;0;0;26;0;0;2;12;12;3
17249.0;2023;02;AIX-MARSEILLE;MASCULIN;SCOLAIRE;BAC PROFESSIONNEL;BAC PRO PROD;BAC PRO AG 21203 TECHN CONSEIL DE VENTE ANIMAL;11;11;10;1;0;0;0;10;0;0;1;4;5;1
17251.0;2023;02;AIX-MARSEILLE;MASCULIN;SCOLAIRE;BAC PROFESSIONNEL;BAC PRO PROD;BAC PRO AG 21211 COND GEST ENTR HIPPIQUE;1;1;1;0;0;0;0;1;0;0;0;1;0;0
17260.0;2023;02;AIX-MARSEILLE;MASCULIN;SCOLAIRE;BAC PROFESSIONNEL;BAC PRO SERV;BAC PRO 31114 ORGANIS. TRANSPORT MARCHANDISES;36;36;30;6;0;0;0;30;0;2;4;18;6;6
17261.0;2023;02;AIX-MARSEILLE;MASCULIN;SCOLAIRE;BAC PROFESSIONNEL;BAC PRO SERV;BAC PRO 31212 METIERS DE L'ACCUEIL;103;103;69;24;10;5;5;74;0;1;5;25;43;29
17267.0;2023;02;AIX-MARSEILLE;MASCULIN;SCOLAIRE;BAC PROFESSIONNEL;BAC PRO SERV;BAC PRO 32304 PHOTOGRAPHIE;5;5;4;1;0;0;0;4;0;0;2;1;1;1
17269.0;2023;02;AIX-MARSEILLE;MASCULIN;SCOLAIRE;BAC PROFESSIONNEL;BAC PRO SERV;BAC PRO 33004 ACC.SOINS-S.PERS. OPT.EN STRUCTUR;45;44;33;8;3;3;0;36;0;2;1;13;20;8
17281.0;2023;02;AIX-MARSEILLE;MASCULIN;SCOLAIRE;BAC TECHNOLOGIQUE;BAC STAV;BAC STAV AGRONOMIE ALIM ENV TERRITOI;94;94;90;4;0;0;0;90;0;1;8;21;60;4
17290.0;2023;02;AIX-MARSEILLE;MASCULIN;SCOLAIRE;BAC TECHNOLOGIQUE;BAC STMG;BAC STMG GESTION ET FINANCE;434;434;339;21;74;59;15;398;0;0;39;101;258;36
17291.0;2023;02;AIX-MARSEILLE;MASCULIN;SCOLAIRE;BAC TECHNOLOGIQUE;BAC STMG;BAC STMG MERCATIQUE (MARKETING);798;798;589;42;167;116;51;705;0;4;48;181;472;93
17294.0;2023;20;AMIENS;FEMININ;APPRENTISSAGE;BAC PROFESSIONNEL;BAC PRO PROD;BAC PRO 20102 PILOTE DE LIGNE DE PRODUCTION;1;1;1;0;0;0;0;1;0;1;0;0;0;0
17296.0;2023;20;AMIENS;FEMININ;APPRENTISSAGE;BAC PROFESSIONNEL;BAC PRO PROD;BAC PRO 22704 TECHN. MAINT. SYST.ENERG.CLIMATI;1;1;1;0;0;0;0;1;0;0;0;0;1;0
17297.0;2023;20;AMIENS;FEMININ;APPRENTISSAGE;BAC PROFESSIONNEL;BAC PRO PROD;BAC PRO 23102 TRAVAUX PUBLICS;1;1;1;0;0;0;0;1;0;1;0;0;0;0
17319.0;2023;20;AMIENS;FEMININ;FORMATION CONTINUE;BAC PROFESSIONNEL;BAC PRO PROD;BAC PRO 20102 PILOTE DE LIGNE DE PRODUCTION;5;5;5;0;0;0;0;5;0;2;2;1;0;0
17322.0;2023;20;AMIENS;FEMININ;FORMATION CONTINUE;BAC PROFESSIONNEL;BAC PRO PROD;BAC PRO AG 21114 CONDUITE PRODUCTIONS HORTICOLES;1;1;1;0;0;0;0;1;0;0;0;0;1;0
17325.0;2023;20;AMIENS;FEMININ;INDIVIDUEL;BAC PROFESSIONNEL;BAC PRO PROD;BAC PRO 22003 BIO-INDUSTRIES DE TRANSFORMATION;1;0;0;0;0;0;0;0;0;0;0;0;0;0
17326.0;2023;20;AMIENS;FEMININ;INDIVIDUEL;BAC PROFESSIONNEL;BAC PRO PROD;BAC PRO 25513 SYST.NUM.OPT.A SURETE SECURITE;1;1;0;1;0;0;0;0;0;0;0;0;0;1
17338.0;2023;20;AMIENS;FEMININ;INDIVIDUEL;BAC PROFESSIONNEL;BAC PRO SERV;BAC PRO 33603 ESTHETIQUE COSMETIQUE PARFUMERIE;1;0;0;0;0;0;0;0;0;0;0;0;0;0
17345.0;2023;20;AMIENS;FEMININ;INDIVIDUEL;BAC TECHNOLOGIQUE;BAC STMG;BAC STMG RESSOURCES HUMAINES ET COMMUNICATION;4;4;0;3;1;1;0;1;0;0;0;0;1;3
17351.0;2023;20;AMIENS;FEMININ;SCOLAIRE;BAC PROFESSIONNEL;BAC PRO PROD;BAC PRO 22104 BOUCHER CHARCUTIER TRAITEUR;2;2;1;1;0;0;0;1;0;0;1;0;0;1
17355.0;2023;20;AMIENS;FEMININ;SCOLAIRE;BAC PROFESSIONNEL;BAC PRO PROD;BAC PRO 22703 TECHN.INSTALL.SYST.ENERG.CLIMATI;1;1;0;1;0;0;0;0;0;0;0;0;0;1
17356.0;2023;20;AMIENS;FEMININ;SCOLAIRE;BAC PROFESSIONNEL;BAC PRO PROD;BAC PRO 23004 TECHN. ETUDES BAT.A ETUDES & ECO.;1;1;0;1;0;0;0;0;0;0;0;0;0;1
17358.0;2023;20;AMIENS;FEMININ;SCOLAIRE;BAC PROFESSIONNEL;BAC PRO PROD;BAC PRO 23208 METIERS ET ARTS DE LA PIERRE;2;2;2;0;0;0;0;2;0;0;0;0;2;0
17364.0;2023;20;AMIENS;FEMININ;SCOLAIRE;BAC PROFESSIONNEL;BAC PRO PROD;BAC PRO 25007 MAINTENANCE EQUIPEMENTS INDUST.;2;2;2;0;0;0;0;2;0;1;0;1;0;0
17367.0;2023;20;AMIENS;FEMININ;SCOLAIRE;BAC PROFESSIONNEL;BAC PRO PROD;BAC PRO 25214 MAINT.VEHIC.OPTA VOIT.PARTICUL.;6;6;5;1;0;0;0;5;0;2;1;0;2;1
17373.0;2023;20;AMIENS;FEMININ;SCOLAIRE;BAC PROFESSIONNEL;BAC PRO PROD;BAC PRO 25510 METIERS ELECT. ENVIRON. CONNECTES;2;2;2;0;0;0;0;2;0;0;1;1;0;0
17379.0;2023;20;AMIENS;FEMININ;SCOLAIRE;BAC PROFESSIONNEL;BAC PRO PROD;BAC PRO AG 21114 CONDUITE PRODUCTIONS HORTICOLES;8;8;6;2;0;0;0;6;0;0;1;2;3;2
17388.0;2023;20;AMIENS;FEMININ;SCOLAIRE;BAC PROFESSIONNEL;BAC PRO SERV;BAC PRO 31107 CONDUCT. TRANSP.ROUT.MARCHANDISES;1;1;0;1;0;0;0;0;0;0;0;0;0;1
17390.0;2023;20;AMIENS;FEMININ;SCOLAIRE;BAC PROFESSIONNEL;BAC PRO SERV;BAC PRO 31212 METIERS DE L'ACCUEIL;154;153;104;29;20;8;12;112;0;5;21;37;49;41
17392.0;2023;20;AMIENS;FEMININ;SCOLAIRE;BAC PROFESSIONNEL;BAC PRO SERV;BAC PRO 31214 MET.COM.VEN.OP.B PR.CL.VA.OF.COM.;123;123;100;18;5;3;2;103;0;7;23;41;32;20
17395.0;2023;20;AMIENS;FEMININ;SCOLAIRE;BAC PROFESSIONNEL;BAC PRO SERV;BAC PRO 33003 ACC.SOINS-S.PERS. OPT.A DOMICILE;160;160;127;22;11;4;7;131;0;3;29;48;51;29
17406.0;2023;20;AMIENS;FEMININ;SCOLAIRE;BAC TECHNOLOGIQUE;BAC STAV;BAC STAV AGRONOMIE ALIM ENV TERRITOI;71;70;67;3;0;0;0;67;0;1;3;23;40;3
17407.0;2023;20;AMIENS;FEMININ;SCOLAIRE;BAC TECHNOLOGIQUE;BAC STD2A;BAC STD2A SCIENCES & TECHNO. DESIGN-ARTS APPLIQUES;78;78;71;1;6;4;2;75;0;7;20;28;20;3
17412.0;2023;20;AMIENS;FEMININ;SCOLAIRE;BAC TECHNOLOGIQUE;BAC STI2D;BAC STI2D SYSTÈME D'INFORMATION  ET NUMERIQUE;12;12;10;0;2;2;0;12;0;0;2;5;5;0
17414.0;2023;20;AMIENS;FEMININ;SCOLAIRE;BAC TECHNOLOGIQUE;BAC STL;BAC STL SCIENCES PHYSIQUES CHIMIQUES  EN LABORAT.;58;58;48;4;6;4;2;52;1;4;7;18;22;6
17430.0;2023;20;AMIENS;MASCULIN;APPRENTISSAGE;BAC PROFESSIONNEL;BAC PRO PROD;BAC PRO 23407 TECHNIC.FAB.BOIS ET MATERX ASSOC;1;1;1;0;0;0;0;1;0;0;1;0;0;0
17434.0;2023;20;AMIENS;MASCULIN;APPRENTISSAGE;BAC PROFESSIONNEL;BAC PRO PROD;BAC PRO 25214 MAINT.VEHIC.OPTA VOIT.PARTICUL.;105;103;81;13;9;5;4;86;0;9;14;29;34;17
17435.0;2023;20;AMIENS;MASCULIN;APPRENTISSAGE;BAC PROFESSIONNEL;BAC PRO PROD;BAC PRO 25215 MAINT.VEHIC.OPTB VEHIC.TRANS.ROUT;20;20;12;6;2;1;1;13;0;1;6;3;3;7
17437.0;2023;20;AMIENS;MASCULIN;APPRENTISSAGE;BAC PROFESSIONNEL;BAC PRO PROD;BAC PRO 25219 MAINT.MATERIELS OPT.A AGRICOLES;2;2;2;0;0;0;0;2;0;1;1;0;0;0
17440.0;2023;20;AMIENS;MASCULIN;APPRENTISSAGE;BAC PROFESSIONNEL;BAC PRO PROD;BAC PRO 25304 AERONAUTIQUE OPTION STRUCTURE;12;12;12;0;0;0;0;12;0;3;6;3;0;0
17443.0;2023;20;AMIENS;MASCULIN;APPRENTISSAGE;BAC PROFESSIONNEL;BAC PRO PROD;BAC PRO 25509 TECHNIC. FROID CONDITIONNEMT AIR;16;16;10;6;0;0;0;10;0;0;6;2;2;6
17447.0;2023;20;AMIENS;MASCULIN;APPRENTISSAGE;BAC PROFESSIONNEL;BAC PRO PROD;BAC PRO AG 21004 CGEA;17;16;13;3;0;0;0;13;0;0;0;1;12;3
17449.0;2023;20;AMIENS;MASCULIN;APPRENTISSAGE;BAC PROFESSIONNEL;BAC PRO PROD;BAC PRO AG 21203 TECHN CONSEIL DE VENTE ANIMAL;1;1;1;0;0;0;0;1;0;0;0;1;0;0
17461.0;2023;20;AMIENS;MASCULIN;FORMATION CONTINUE;BAC PROFESSIONNEL;BAC PRO PROD;BAC PRO 20102 PILOTE DE LIGNE DE PRODUCTION;3;3;3;0;0;0;0;3;0;1;0;2;0;0
17464.0;2023;20;AMIENS;MASCULIN;FORMATION CONTINUE;BAC PROFESSIONNEL;BAC PRO PROD;BAC PRO 23102 TRAVAUX PUBLICS;2;2;2;0;0;0;0;2;0;0;0;0;2;0
17466.0;2023;20;AMIENS;MASCULIN;FORMATION CONTINUE;BAC PROFESSIONNEL;BAC PRO PROD;BAC PRO 25007 MAINTENANCE EQUIPEMENTS INDUST.;1;1;1;0;0;0;0;1;0;0;1;0;0;0
17470.0;2023;20;AMIENS;MASCULIN;INDIVIDUEL;BAC PROFESSIONNEL;BAC PRO PROD;BAC PRO 25214 MAINT.VEHIC.OPTA VOIT.PARTICUL.;2;2;2;0;0;0;0;2;0;1;1;0;0;0
17475.0;2023;20;AMIENS;MASCULIN;INDIVIDUEL;BAC PROFESSIONNEL;BAC PRO SERV;BAC PRO 30004 ASSISTANC.GEST.ORGANIS.ACTIVITES;2;0;0;0;0;0;0;0;0;0;0;0;0;0
17486.0;2023;20;AMIENS;MASCULIN;INDIVIDUEL;BAC TECHNOLOGIQUE;BAC STMG;BAC STMG GESTION ET FINANCE;5;5;1;4;0;0;0;1;0;0;0;0;1;4
17491.0;2023;20;AMIENS;MASCULIN;SCOLAIRE;BAC PROFESSIONNEL;BAC PRO PROD;BACPRO 20002 ETUD.DEFINITION PRDTS INDUSTRIEL;18;18;12;5;1;1;0;13;0;0;3;3;7;5
17494.0;2023;20;AMIENS;MASCULIN;SCOLAIRE;BAC PROFESSIONNEL;BAC PRO PROD;BAC PRO 22104 BOUCHER CHARCUTIER TRAITEUR;10;10;9;1;0;0;0;9;0;1;0;3;5;1
17500.0;2023;20;AMIENS;MASCULIN;SCOLAIRE;BAC PROFESSIONNEL;BAC PRO PROD;BAC PRO 22704 TECHN. MAINT. SYST.ENERG.CLIMATI;22;22;18;4;0;0;0;18;0;1;2;7;8;4
17504.0;2023;20;AMIENS;MASCULIN;SCOLAIRE;BAC PROFESSIONNEL;BAC PRO PROD;BACPRO 23103 TECHNICIEN GEOMETRE-TOPOGRAPHE;3;3;3;0;0;0;0;3;0;0;2;1;0;0
17505.0;2023;20;AMIENS;MASCULIN;SCOLAIRE;BAC PROFESSIONNEL;BAC PRO PROD;BAC PRO 23203 TECHNICIEN BAT. : ORG.REAL.GROS O;11;11;7;3;1;1;0;8;0;0;0;1;7;3
17510.0;2023;20;AMIENS;MASCULIN;SCOLAIRE;BAC PROFESSIONNEL;BAC PRO PROD;BAC PRO 23405 TECHNICIEN MENUISIER AGENCEUR;42;42;32;7;3;2;1;34;0;4;6;11;13;8
17511.0;2023;20;AMIENS;MASCULIN;SCOLAIRE;BAC PROFESSIONNEL;BAC PRO PROD;BAC PRO 23407 TECHNIC.FAB.BOIS ET MATERX ASSOC;4;4;2;2;0;0;0;2;0;1;0;0;1;2
17513.0;2023;20;AMIENS;MASCULIN;SCOLAIRE;BAC PROFESSIONNEL;BAC PRO PROD;BAC PRO 25005 PRODUCTIQ.MECA. OPT.DECOLLETAGE;2;2;1;1;0;0;0;1;0;1;0;0;0;1
17514.0;2023;20;AMIENS;MASCULIN;SCOLAIRE;BAC PROFESSIONNEL;BAC PRO PROD;BAC PRO 25006 MICROTECHNIQUES;11;11;5;5;1;1;0;6;0;0;2;1;3;5
17532.0;2023;20;AMIENS;MASCULIN;SCOLAIRE;BAC PROFESSIONNEL;BAC PRO PROD;BAC PRO 25514 SYST.NUM.OPT.B AUD.RES.EQUIP.DOM.;85;85;70;13;2;2;0;72;0;2;17;28;25;13
17534.0;2023;20;AMIENS;MASCULIN;SCOLAIRE;BAC PROFESSIONNEL;BAC PRO PROD;BAC PRO AG 21001 AGRO-EQUIPEMENT;24;21;16;5;0;0;0;16;0;0;2;5;9;5
17545.0;2023;20;AMIENS;MASCULIN;SCOLAIRE;BAC PROFESSIONNEL;BAC PRO SERV;BAC PRO 31106 LOGISTIQUE;80;80;51;26;3;3;0;54;0;1;4;13;36;26
17560.0;2023;20;AMIENS;MASCULIN;SCOLAIRE;BAC PROFESSIONNEL;BAC PRO SERV;BAC PRO 34403 METIERS DE LA SECURITE;74;74;60;11;3;2;1;62;0;2;12;24;24;12
17562.0;2023;20;AMIENS;MASCULIN;SCOLAIRE;BAC TECHNOLOGIQUE;BAC ST2S;BAC ST2S SCIENCES & TECHNO. SANTE & SOCIAL;125;125;89;8;28;16;12;105;0;2;14;25;64;20
17577.0;2023;03;BESANCON;FEMININ;APPRENTISSAGE;BAC PROFESSIONNEL;BAC PRO PROD;BAC PRO 22004 PROC. CHIMIE EAU PAPIERS-CARTONS;1;1;1;0;0;0;0;1;0;1;0;0;0;0
17588.0;2023;03;BESANCON;FEMININ;APPRENTISSAGE;BAC PROFESSIONNEL;BAC PRO PROD;BAC PRO AG 21302 GEST MILIEUX NATURELS FAUNE;1;1;1;0;0;0;0;1;0;1;0;0;0;0
17599.0;2023;03;BESANCON;FEMININ;APPRENTISSAGE;BAC PROFESSIONNEL;BAC PRO SERV;BAC PRO 33006 ANIMAT. ENFANCE& PERSONNES AGEES;3;3;3;0;0;0;0;3;0;0;0;2;1;0
17602.0;2023;03;BESANCON;FEMININ;APPRENTISSAGE;BAC PROFESSIONNEL;BAC PRO SERV;BAC PRO 33403 COMMERC. SERVICES EN RESTAURATION;3;3;3;0;0;0;0;3;0;0;0;2;1;0
17603.0;2023;03;BESANCON;FEMININ;APPRENTISSAGE;BAC PROFESSIONNEL;BAC PRO SERV;BAC PRO 33603 ESTHETIQUE COSMETIQUE PARFUMERIE;1;1;1;0;0;0;0;1;0;0;1;0;0;0
17604.0;2023;03;BESANCON;FEMININ;APPRENTISSAGE;BAC PROFESSIONNEL;BAC PRO SERV;BAC PRO AG 33002 SERV PERS TERRIT;10;10;9;1;0;0;0;9;0;0;1;2;6;1
17615.0;2023;03;BESANCON;FEMININ;INDIVIDUEL;BAC GENERAL;BAC GENERAL;BAC GENE 10019 BAC GENERAL;31;31;25;4;2;2;0;27;0;5;5;9;8;4
17618.0;2023;03;BESANCON;FEMININ;INDIVIDUEL;BAC TECHNOLOGIQUE;BAC ST2S;BAC ST2S SCIENCES & TECHNO. SANTE & SOCIAL;4;4;2;0;2;2;0;4;0;0;0;1;3;0
17626.0;2023;03;BESANCON;FEMININ;SCOLAIRE;BAC PROFESSIONNEL;BAC PRO PROD;BAC PRO 23102 TRAVAUX PUBLICS;1;1;1;0;0;0;0;1;0;0;0;1;0;0
17627.0;2023;03;BESANCON;FEMININ;SCOLAIRE;BAC PROFESSIONNEL;BAC PRO PROD;BACPRO 23103 TECHNICIEN GEOMETRE-TOPOGRAPHE;3;3;2;1;0;0;0;2;0;0;0;0;2;1
17631.0;2023;03;BESANCON;FEMININ;SCOLAIRE;BAC PROFESSIONNEL;BAC PRO PROD;BAC PRO 24002 METIERS PRESSING BLANCHISSERIE;5;5;4;1;0;0;0;4;0;0;0;0;4;1
17635.0;2023;03;BESANCON;FEMININ;SCOLAIRE;BAC PROFESSIONNEL;BAC PRO PROD;BAC PRO 25007 MAINTENANCE EQUIPEMENTS INDUST.;4;4;3;1;0;0;0;3;0;0;1;0;2;1
17644.0;2023;03;BESANCON;FEMININ;SCOLAIRE;BAC PROFESSIONNEL;BAC PRO PROD;BAC PRO AG 21004 CGEA;20;20;17;3;0;0;0;17;0;1;3;4;9;3
17646.0;2023;03;BESANCON;FEMININ;SCOLAIRE;BAC PROFESSIONNEL;BAC PRO PROD;BAC PRO AG 21203 TECHN CONSEIL DE VENTE ANIMAL;18;18;16;2;0;0;0;16;0;0;3;8;5;2
17647.0;2023;03;BESANCON;FEMININ;SCOLAIRE;BAC PROFESSIONNEL;BAC PRO PROD;BAC PRO AG 21211 COND GEST ENTR HIPPIQUE;33;33;30;3;0;0;0;30;0;0;7;9;14;3
17649.0;2023;03;BESANCON;FEMININ;SCOLAIRE;BAC PROFESSIONNEL;BAC PRO PROD;BAC PRO AG 21303 FORET;1;1;1;0;0;0;0;1;0;0;0;1;0;0
17652.0;2023;03;BESANCON;FEMININ;SCOLAIRE;BAC PROFESSIONNEL;BAC PRO SERV;BAC PRO 30004 ASSISTANC.GEST.ORGANIS.ACTIVITES;174;172;127;29;16;16;0;143;0;3;27;46;67;29
17653.0;2023;03;BESANCON;FEMININ;SCOLAIRE;BAC PROFESSIONNEL;BAC PRO SERV;BAC PRO 31106 LOGISTIQUE;2;2;1;0;1;1;0;2;0;0;0;0;2;0
17660.0;2023;03;BESANCON;FEMININ;SCOLAIRE;BAC PROFESSIONNEL;BAC PRO SERV;BAC PRO 33004 ACC.SOINS-S.PERS. OPT.EN STRUCTUR;233;233;197;24;12;10;2;207;0;7;44;73;83;26
17667.0;2023;03;BESANCON;FEMININ;SCOLAIRE;BAC PROFESSIONNEL;BAC PRO SERV;BAC PRO 34403 METIERS DE LA SECURITE;27;27;21;5;1;1;0;22;0;3;4;9;6;5
17677.0;2023;03;BESANCON;FEMININ;SCOLAIRE;BAC TECHNOLOGIQUE;BAC STI2D;BAC STI2D INNOVATION TECHNO.  ET ECO CONCEPTION;11;11;11;0;0;0;0;11;0;0;2;4;5;0
17690.0;2023;03;BESANCON;MASCULIN;APPRENTISSAGE;BAC PROFESSIONNEL;BAC PRO PROD;BAC PRO 23004 TECHN. ETUDES BAT.A ETUDES & ECO.;1;1;0;0;1;1;0;1;0;0;0;0;1;0
17694.0;2023;03;BESANCON;MASCULIN;APPRENTISSAGE;BAC PROFESSIONNEL;BAC PRO PROD;BAC PRO 23203 TECHNICIEN BAT. : ORG.REAL.GROS O;3;3;3;0;0;0;0;3;0;0;0;1;2;0
17696.0;2023;03;BESANCON;MASCULIN;APPRENTISSAGE;BAC PROFESSIONNEL;BAC PRO PROD;BAC PRO 23304 AMENAGEMENT FINITION BATIMENT;2;2;2;0;0;0;0;2;0;0;1;1;0;0
17699.0;2023;03;BESANCON;MASCULIN;APPRENTISSAGE;BAC PROFESSIONNEL;BAC PRO PROD;BAC PRO 23407 TECHNIC.FAB.BOIS ET MATERX ASSOC;2;2;2;0;0;0;0;2;0;0;1;1;0;0
17709.0;2023;03;BESANCON;MASCULIN;APPRENTISSAGE;BAC PROFESSIONNEL;BAC PRO PROD;BAC PRO 25220 MAINT.MATERIELS OPT.B TP MANUT.;2;2;2;0;0;0;0;2;0;1;0;0;1;0
17725.0;2023;03;BESANCON;MASCULIN;APPRENTISSAGE;BAC PROFESSIONNEL;BAC PRO PROD;BAC PRO AG 21405 AMENAGEMENTS PAYSAGERS;52;50;48;2;0;0;0;48;0;0;2;18;28;2
17739.0;2023;03;BESANCON;MASCULIN;ENSEIGNEMENT A DISTANCE;BAC PROFESSIONNEL;BAC PRO PROD;BAC PRO 25510 METIERS ELECT. ENVIRON. CONNECTES;1;0;0;0;0;0;0;0;0;0;0;0;0;0
17745.0;2023;03;BESANCON;MASCULIN;INDIVIDUEL;BAC PROFESSIONNEL;BAC PRO PROD;BAC PRO 22703 TECHN.INSTALL.SYST.ENERG.CLIMATI;1;0;0;0;0;0;0;0;0;0;0;0;0;0
17749.0;2023;03;BESANCON;MASCULIN;INDIVIDUEL;BAC PROFESSIONNEL;BAC PRO PROD;BAC PRO 25214 MAINT.VEHIC.OPTA VOIT.PARTICUL.;1;1;0;1;0;0;0;0;0;0;0;0;0;1
17752.0;2023;03;BESANCON;MASCULIN;INDIVIDUEL;BAC PROFESSIONNEL;BAC PRO PROD;BAC PRO AG 21004 CGEA;1;1;1;0;0;0;0;1;0;0;0;0;1;0
17754.0;2023;03;BESANCON;MASCULIN;INDIVIDUEL;BAC PROFESSIONNEL;BAC PRO SERV;BAC PRO 31213 MET.COM.VEN.OP.A ANI.GES.ESP.COM.;1;0;0;0;0;0;0;0;0;0;0;0;0;0
17757.0;2023;03;BESANCON;MASCULIN;INDIVIDUEL;BAC TECHNOLOGIQUE;BAC ST2S;BAC ST2S SCIENCES & TECHNO. SANTE & SOCIAL;2;2;1;1;0;0;0;1;0;0;0;1;0;1
17760.0;2023;03;BESANCON;MASCULIN;INDIVIDUEL;BAC TECHNOLOGIQUE;BAC STI2D;BAC STI2D SYSTÈME D'INFORMATION  ET NUMERIQUE;1;1;0;1;0;0;0;0;0;0;0;0;0;1
17771.0;2023;03;BESANCON;MASCULIN;SCOLAIRE;BAC PROFESSIONNEL;BAC PRO PROD;BAC PRO 23005 TECHN. ETUDES BAT B ASSIST.ARCHI.;21;21;21;0;0;0;0;21;0;0;1;11;9;0
17772.0;2023;03;BESANCON;MASCULIN;SCOLAIRE;BAC PROFESSIONNEL;BAC PRO PROD;BAC PRO 23102 TRAVAUX PUBLICS;11;11;10;1;0;0;0;10;0;1;2;4;3;1
17781.0;2023;03;BESANCON;MASCULIN;SCOLAIRE;BAC PROFESSIONNEL;BAC PRO PROD;BAC PRO 24203 METIERS DE LA MODE - VÊTEMENT;4;4;4;0;0;0;0;4;0;2;2;0;0;0
17788.0;2023;03;BESANCON;MASCULIN;SCOLAIRE;BAC PROFESSIONNEL;BAC PRO PROD;BAC PRO 25214 MAINT.VEHIC.OPTA VOIT.PARTICUL.;69;69;46;15;8;5;3;51;0;1;11;14;25;18
17789.0;2023;03;BESANCON;MASCULIN;SCOLAIRE;BAC PROFESSIONNEL;BAC PRO PROD;BAC PRO 25215 MAINT.VEHIC.OPTB VEHIC.TRANS.ROUT;4;4;3;1;0;0;0;3;0;0;0;0;3;1
17792.0;2023;03;BESANCON;MASCULIN;SCOLAIRE;BAC PROFESSIONNEL;BAC PRO PROD;BAC PRO 25410 CONSTRUCTION DES CARROSSERIES;6;6;4;2;0;0;0;4;0;0;0;2;2;2
17793.0;2023;03;BESANCON;MASCULIN;SCOLAIRE;BAC PROFESSIONNEL;BAC PRO PROD;BAC PRO 25411 TECH.CHAUDRONNERIE INDUSTRIELLE;36;36;28;7;1;0;1;28;0;3;12;9;4;8
17804.0;2023;03;BESANCON;MASCULIN;SCOLAIRE;BAC PROFESSIONNEL;BAC PRO PROD;BAC PRO AG 21303 FORET;5;5;5;0;0;0;0;5;0;0;0;3;2;0
17807.0;2023;03;BESANCON;MASCULIN;SCOLAIRE;BAC PROFESSIONNEL;BAC PRO SERV;BAC PRO 30004 ASSISTANC.GEST.ORGANIS.ACTIVITES;62;62;41;19;2;2;0;43;0;0;3;15;25;19
17812.0;2023;03;BESANCON;MASCULIN;SCOLAIRE;BAC PROFESSIONNEL;BAC PRO SERV;BAC PRO 31213 MET.COM.VEN.OP.A ANI.GES.ESP.COM.;133;133;107;16;10;8;2;115;0;5;18;47;45;18
17814.0;2023;03;BESANCON;MASCULIN;SCOLAIRE;BAC PROFESSIONNEL;BAC PRO SERV;BAC PRO 33003 ACC.SOINS-S.PERS. OPT.A DOMICILE;2;2;1;1;0;0;0;1;0;0;0;1;0;1
17823.0;2023;03;BESANCON;MASCULIN;SCOLAIRE;BAC TECHNOLOGIQUE;BAC S2TMD;BAC S2TMD MUSIQUE;4;4;4;0;0;0;0;4;0;1;1;1;1;0
17826.0;2023;03;BESANCON;MASCULIN;SCOLAIRE;BAC TECHNOLOGIQUE;BAC STD2A;BAC STD2A SCIENCES & TECHNO. DESIGN-ARTS APPLIQUES;9;9;9;0;0;0;0;9;0;0;5;3;1;0
17830.0;2023;03;BESANCON;MASCULIN;SCOLAIRE;BAC TECHNOLOGIQUE;BAC STI2D;BAC STI2D INNOVATION TECHNO.  ET ECO CONCEPTION;167;167;143;6;18;12;6;155;0;5;26;55;69;12
17831.0;2023;03;BESANCON;MASCULIN;SCOLAIRE;BAC TECHNOLOGIQUE;BAC STI2D;BAC STI2D SYSTÈME D'INFORMATION  ET NUMERIQUE;129;129;101;11;17;7;10;108;0;3;15;39;51;21
17839.0;2023;04;BORDEAUX;FEMININ;APPRENTISSAGE;BAC PROFESSIONNEL;BAC PRO PROD;BAC PRO 22105 BOULANGER-PÂTISSIER;1;1;1;0;0;0;0;1;0;0;0;0;1;0
17843.0;2023;04;BORDEAUX;FEMININ;APPRENTISSAGE;BAC PROFESSIONNEL;BAC PRO PROD;BAC PRO 24302 METIERS DU CUIR : MAROQUINERIE;2;2;2;0;0;0;0;2;0;0;1;1;0;0
17849.0;2023;04;BORDEAUX;FEMININ;APPRENTISSAGE;BAC PROFESSIONNEL;BAC PRO PROD;BAC PRO 25221 MAINT.MATERIELS OPT.C ESP. VERTS;1;1;1;0;0;0;0;1;0;0;0;0;1;0
17858.0;2023;04;BORDEAUX;FEMININ;APPRENTISSAGE;BAC PROFESSIONNEL;BAC PRO PROD;BAC PRO AG 21407 TEC CONS VTE UNIVERS JARDINERIE;2;2;2;0;0;0;0;2;0;0;0;0;2;0
17868.0;2023;04;BORDEAUX;FEMININ;APPRENTISSAGE;BAC PROFESSIONNEL;BAC PRO SERV;BAC PRO 33101 OPTIQUE LUNETTERIE;6;6;6;0;0;0;0;6;0;0;4;2;0;0
17876.0;2023;04;BORDEAUX;FEMININ;ENSEIGNEMENT A DISTANCE;BAC GENERAL;BAC GENERAL;BAC GENE 10019 BAC GENERAL;131;126;78;25;23;14;9;92;0;2;12;29;49;34
17882.0;2023;04;BORDEAUX;FEMININ;ENSEIGNEMENT A DISTANCE;BAC PROFESSIONNEL;BAC PRO SERV;BAC PRO 33004 ACC.SOINS-S.PERS. OPT.EN STRUCTUR;3;2;1;1;0;0;0;1;0;0;0;0;1;1
17883.0;2023;04;BORDEAUX;FEMININ;ENSEIGNEMENT A DISTANCE;BAC PROFESSIONNEL;BAC PRO SERV;BAC PRO 33603 ESTHETIQUE COSMETIQUE PARFUMERIE;1;1;0;1;0;0;0;0;0;0;0;0;0;1
17885.0;2023;04;BORDEAUX;FEMININ;ENSEIGNEMENT A DISTANCE;BAC TECHNOLOGIQUE;BAC STMG;BAC STMG GESTION ET FINANCE;2;2;2;0;0;0;0;2;0;0;0;2;0;0
17890.0;2023;04;BORDEAUX;FEMININ;FORMATION CONTINUE;BAC PROFESSIONNEL;BAC PRO PROD;BAC PRO 24203 METIERS DE LA MODE - VÊTEMENT;1;1;1;0;0;0;0;1;0;0;1;0;0;0
17892.0;2023;04;BORDEAUX;FEMININ;FORMATION CONTINUE;BAC PROFESSIONNEL;BAC PRO PROD;BAC PRO AG 21114 CONDUITE PRODUCTIONS HORTICOLES;7;6;6;0;0;0;0;6;0;0;0;0;6;0
17894.0;2023;04;BORDEAUX;FEMININ;FORMATION CONTINUE;BAC PROFESSIONNEL;BAC PRO SERV;BAC PRO 31213 MET.COM.VEN.OP.A ANI.GES.ESP.COM.;5;5;3;2;0;0;0;3;0;0;0;2;1;2
17898.0;2023;04;BORDEAUX;FEMININ;INDIVIDUEL;BAC PROFESSIONNEL;BAC PRO PROD;BAC PRO 25106 TECHNICIEN D'USINAGE;1;1;0;1;0;0;0;0;0;0;0;0;0;1
17917.0;2023;04;BORDEAUX;FEMININ;INDIVIDUEL;BAC TECHNOLOGIQUE;BAC STMG;BAC STMG RESSOURCES HUMAINES ET COMMUNICATION;7;6;1;4;1;0;1;1;0;0;0;0;1;5
17924.0;2023;04;BORDEAUX;FEMININ;SCOLAIRE;BAC PROFESSIONNEL;BAC PRO PROD;BAC PRO 22105 BOULANGER-PÂTISSIER;33;33;30;3;0;0;0;30;0;7;9;10;4;3
17928.0;2023;04;BORDEAUX;FEMININ;SCOLAIRE;BAC PROFESSIONNEL;BAC PRO PROD;BAC PRO 23003 ARTIS. & M.ART:MARCHANDISAGE VIS.;11;11;9;2;0;0;0;9;0;0;1;5;3;2
17932.0;2023;04;BORDEAUX;FEMININ;SCOLAIRE;BAC PROFESSIONNEL;BAC PRO PROD;BACPRO 23103 TECHNICIEN GEOMETRE-TOPOGRAPHE;3;3;3;0;0;0;0;3;0;0;0;0;3;0
17933.0;2023;04;BORDEAUX;FEMININ;SCOLAIRE;BAC PROFESSIONNEL;BAC PRO PROD;BAC PRO 23304 AMENAGEMENT FINITION BATIMENT;12;12;12;0;0;0;0;12;0;0;3;4;5;0
17951.0;2023;04;BORDEAUX;FEMININ;SCOLAIRE;BAC PROFESSIONNEL;BAC PRO PROD;BAC PRO 25510 METIERS ELECT. ENVIRON. CONNECTES;2;2;2;0;0;0;0;2;0;0;0;0;2;0
17955.0;2023;04;BORDEAUX;FEMININ;SCOLAIRE;BAC PROFESSIONNEL;BAC PRO PROD;BAC PRO AG 21004 CGEA;67;66;56;10;0;0;0;56;0;2;8;17;29;10
17958.0;2023;04;BORDEAUX;FEMININ;SCOLAIRE;BAC PROFESSIONNEL;BAC PRO PROD;BAC PRO AG 21203 TECHN CONSEIL DE VENTE ANIMAL;32;32;28;4;0;0;0;28;0;2;6;11;9;4
17966.0;2023;04;BORDEAUX;FEMININ;SCOLAIRE;BAC PROFESSIONNEL;BAC PRO PROD;BAC PRO AG 22108 TEC CONS VTE ALIMENTATION (PAB);14;12;11;1;0;0;0;11;0;0;2;5;4;1
17973.0;2023;04;BORDEAUX;FEMININ;SCOLAIRE;BAC PROFESSIONNEL;BAC PRO SERV;BAC PRO 31214 MET.COM.VEN.OP.B PR.CL.VA.OF.COM.;155;155;133;20;2;1;1;134;0;4;36;53;41;21
17976.0;2023;04;BORDEAUX;FEMININ;SCOLAIRE;BAC PROFESSIONNEL;BAC PRO SERV;BAC PRO 32303 ART.& MET.ART:COM.VIS.VIS.PLURI-M;59;59;56;2;1;1;0;57;0;3;17;23;14;2
17979.0;2023;04;BORDEAUX;FEMININ;SCOLAIRE;BAC PROFESSIONNEL;BAC PRO SERV;BAC PRO 33004 ACC.SOINS-S.PERS. OPT.EN STRUCTUR;444;444;415;21;8;4;4;419;0;25;133;165;96;25
17990.0;2023;04;BORDEAUX;FEMININ;SCOLAIRE;BAC TECHNOLOGIQUE;BAC S2TMD;BAC S2TMD MUSIQUE;4;4;4;0;0;0;0;4;0;0;3;1;0;0
17991.0;2023;04;BORDEAUX;FEMININ;SCOLAIRE;BAC TECHNOLOGIQUE;BAC ST2S;BAC ST2S SCIENCES & TECHNO. SANTE & SOCIAL;516;516;462;8;46;36;10;498;1;12;76;186;223;18
17995.0;2023;04;BORDEAUX;FEMININ;SCOLAIRE;BAC TECHNOLOGIQUE;BAC STI2D;BAC STI2D ARCHITECTURE ET CONSTRUCTION;50;50;46;1;3;2;1;48;0;4;9;19;16;2
17996.0;2023;04;BORDEAUX;FEMININ;SCOLAIRE;BAC TECHNOLOGIQUE;BAC STI2D;BAC STI2D ENERGIES  ET ENVIRONNEMENT;15;15;14;0;1;1;0;15;0;1;2;8;4;0
17999.0;2023;04;BORDEAUX;FEMININ;SCOLAIRE;BAC TECHNOLOGIQUE;BAC STL;BAC STL BIOCHIM.-BIOLOGIE-BIOTECHNOL.;127;127;112;1;14;12;2;124;2;6;22;47;47;3
18006.0;2023;04;BORDEAUX;MASCULIN;APPRENTISSAGE;BAC PROFESSIONNEL;BAC PRO PROD;BAC PRO 22003 BIO-INDUSTRIES DE TRANSFORMATION;1;1;1;0;0;0;0;1;0;0;0;1;0;0
18021.0;2023;04;BORDEAUX;MASCULIN;APPRENTISSAGE;BAC PROFESSIONNEL;BAC PRO PROD;BAC PRO 25007 MAINTENANCE EQUIPEMENTS INDUST.;61;61;55;4;2;0;2;55;0;5;16;20;14;6
18023.0;2023;04;BORDEAUX;MASCULIN;APPRENTISSAGE;BAC PROFESSIONNEL;BAC PRO PROD;BAC PRO 25106 TECHNICIEN D'USINAGE;26;26;24;2;0;0;0;24;0;3;5;10;6;2
18031.0;2023;04;BORDEAUX;MASCULIN;APPRENTISSAGE;BAC PROFESSIONNEL;BAC PRO PROD;BAC PRO 25304 AERONAUTIQUE OPTION STRUCTURE;7;7;5;2;0;0;0;5;0;2;1;1;1;2
18033.0;2023;04;BORDEAUX;MASCULIN;APPRENTISSAGE;BAC PROFESSIONNEL;BAC PRO PROD;BAC PRO 25411 TECH.CHAUDRONNERIE INDUSTRIELLE;73;70;64;3;3;2;1;66;0;6;17;20;23;4
18039.0;2023;04;BORDEAUX;MASCULIN;APPRENTISSAGE;BAC PROFESSIONNEL;BAC PRO PROD;BAC PRO AG 21001 AGRO-EQUIPEMENT;38;37;28;9;0;0;0;28;0;1;2;9;16;9
18043.0;2023;04;BORDEAUX;MASCULIN;APPRENTISSAGE;BAC PROFESSIONNEL;BAC PRO PROD;BAC PRO AG 21211 COND GEST ENTR HIPPIQUE;2;2;2;0;0;0;0;2;0;0;0;1;1;0
18045.0;2023;04;BORDEAUX;MASCULIN;APPRENTISSAGE;BAC PROFESSIONNEL;BAC PRO PROD;BAC PRO AG 21405 AMENAGEMENTS PAYSAGERS;79;77;63;14;0;0;0;63;0;1;6;21;35;14
18046.0;2023;04;BORDEAUX;MASCULIN;APPRENTISSAGE;BAC PROFESSIONNEL;BAC PRO PROD;BAC PRO AG 21407 TEC CONS VTE UNIVERS JARDINERIE;2;2;2;0;0;0;0;2;0;0;0;1;1;0
18047.0;2023;04;BORDEAUX;MASCULIN;APPRENTISSAGE;BAC PROFESSIONNEL;BAC PRO PROD;BAC PRO AG 22108 TEC CONS VTE ALIMENTATION (PAB);4;4;3;1;0;0;0;3;0;0;0;2;1;1
18055.0;2023;04;BORDEAUX;MASCULIN;APPRENTISSAGE;BAC PROFESSIONNEL;BAC PRO SERV;BAC PRO 32208 REAL.PR.IMPR.PLURI.OPTB.PR.IMPR.;5;5;4;1;0;0;0;4;0;1;1;2;0;1
18063.0;2023;04;BORDEAUX;MASCULIN;APPRENTISSAGE;BAC PROFESSIONNEL;BAC PRO SERV;BAC PRO AG 33002 SERV PERS TERRIT;3;3;2;1;0;0;0;2;0;0;0;1;1;1
18064.0;2023;04;BORDEAUX;MASCULIN;ENSEIGNEMENT A DISTANCE;BAC GENERAL;BAC GENERAL;BAC GENE 10019 BAC GENERAL;39;39;20;7;12;7;5;27;1;3;4;4;15;12
18069.0;2023;04;BORDEAUX;MASCULIN;ENSEIGNEMENT A DISTANCE;BAC TECHNOLOGIQUE;BAC STMG;BAC STMG MERCATIQUE (MARKETING);8;8;6;2;0;0;0;6;0;0;0;1;5;2
18075.0;2023;04;BORDEAUX;MASCULIN;FORMATION CONTINUE;BAC PROFESSIONNEL;BAC PRO PROD;BAC PRO 25411 TECH.CHAUDRONNERIE INDUSTRIELLE;1;1;1;0;0;0;0;1;0;0;1;0;0;0
18079.0;2023;04;BORDEAUX;MASCULIN;FORMATION CONTINUE;BAC PROFESSIONNEL;BAC PRO SERV;BAC PRO 33104 TECHNICIEN EN PROTHESE DENTAIRE;2;2;1;0;1;1;0;2;0;1;0;0;1;0
18099.0;2023;04;BORDEAUX;MASCULIN;INDIVIDUEL;BAC TECHNOLOGIQUE;BAC STI2D;BAC STI2D ARCHITECTURE ET CONSTRUCTION;1;1;0;1;0;0;0;0;0;0;0;0;0;1
18103.0;2023;04;BORDEAUX;MASCULIN;INDIVIDUEL;BAC TECHNOLOGIQUE;BAC STMG;BAC STMG GESTION ET FINANCE;6;6;1;3;2;2;0;3;0;0;0;1;2;3
18113.0;2023;04;BORDEAUX;MASCULIN;SCOLAIRE;BAC PROFESSIONNEL;BAC PRO PROD;BAC PRO 22105 BOULANGER-PÂTISSIER;31;31;28;2;1;1;0;29;0;3;7;11;8;2
18119.0;2023;04;BORDEAUX;MASCULIN;SCOLAIRE;BAC PROFESSIONNEL;BAC PRO PROD;BAC PRO 23003 ARTIS. & M.ART:MARCHANDISAGE VIS.;2;2;1;0;1;1;0;2;0;0;0;0;2;0
18127.0;2023;04;BORDEAUX;MASCULIN;SCOLAIRE;BAC PROFESSIONNEL;BAC PRO PROD;BAC PRO 23304 AMENAGEMENT FINITION BATIMENT;33;33;24;7;2;2;0;26;0;0;6;13;7;7
18129.0;2023;04;BORDEAUX;MASCULIN;SCOLAIRE;BAC PROFESSIONNEL;BAC PRO PROD;BAC PRO 23405 TECHNICIEN MENUISIER AGENCEUR;106;106;82;21;3;2;1;84;0;6;10;37;31;22
18130.0;2023;04;BORDEAUX;MASCULIN;SCOLAIRE;BAC PROFESSIONNEL;BAC PRO PROD;BAC PRO 23407 TECHNIC.FAB.BOIS ET MATERX ASSOC;12;12;11;1;0;0;0;11;0;2;1;4;4;1
18150.0;2023;04;BORDEAUX;MASCULIN;SCOLAIRE;BAC PROFESSIONNEL;BAC PRO PROD;BAC PRO 25509 TECHNIC. FROID CONDITIONNEMT AIR;40;40;31;6;3;2;1;33;0;2;6;10;15;7
18152.0;2023;04;BORDEAUX;MASCULIN;SCOLAIRE;BAC PROFESSIONNEL;BAC PRO PROD;BAC PRO 25513 SYST.NUM.OPT.A SURETE SECURITE;37;37;31;5;1;0;1;31;0;0;6;15;10;6
18154.0;2023;04;BORDEAUX;MASCULIN;SCOLAIRE;BAC PROFESSIONNEL;BAC PRO PROD;BAC PRO 25515 SYST.NUM.OPT.C RES.INF.SYST.COMM.;240;240;199;35;6;5;1;204;0;17;47;87;53;36
18155.0;2023;04;BORDEAUX;MASCULIN;SCOLAIRE;BAC PROFESSIONNEL;BAC PRO PROD;BAC PRO AG 21001 AGRO-EQUIPEMENT;43;42;39;3;0;0;0;39;0;2;3;14;20;3
18156.0;2023;04;BORDEAUX;MASCULIN;SCOLAIRE;BAC PROFESSIONNEL;BAC PRO PROD;BAC PRO AG 21004 CGEA;100;98;89;9;0;0;0;89;0;6;13;33;37;9
18158.0;2023;04;BORDEAUX;MASCULIN;SCOLAIRE;BAC PROFESSIONNEL;BAC PRO PROD;BAC PRO AG 21114 CONDUITE PRODUCTIONS HORTICOLES;15;15;8;7;0;0;0;8;0;0;1;0;7;7
18169.0;2023;04;BORDEAUX;MASCULIN;SCOLAIRE;BAC PROFESSIONNEL;BAC PRO SERV;BAC PRO 30004 ASSISTANC.GEST.ORGANIS.ACTIVITES;195;195;133;62;0;0;0;133;0;5;25;43;60;62
18174.0;2023;04;BORDEAUX;MASCULIN;SCOLAIRE;BAC PROFESSIONNEL;BAC PRO SERV;BAC PRO 31213 MET.COM.VEN.OP.A ANI.GES.ESP.COM.;418;416;311;84;21;16;5;327;0;10;63;112;142;89
18178.0;2023;04;BORDEAUX;MASCULIN;SCOLAIRE;BAC PROFESSIONNEL;BAC PRO SERV;BAC PRO 32303 ART.& MET.ART:COM.VIS.VIS.PLURI-M;41;41;39;2;0;0;0;39;0;1;6;16;16;2
18189.0;2023;04;BORDEAUX;MASCULIN;SCOLAIRE;BAC PROFESSIONNEL;BAC PRO SERV;BAC PRO 34305 TECHN.D'INTERV.SUR INSTALL. NUCL.;11;11;8;3;0;0;0;8;0;0;0;1;7;3
18192.0;2023;04;BORDEAUX;MASCULIN;SCOLAIRE;BAC TECHNOLOGIQUE;BAC S2TMD;BAC S2TMD DANSE;2;2;2;0;0;0;0;2;0;0;1;1;0;0
18196.0;2023;04;BORDEAUX;MASCULIN;SCOLAIRE;BAC TECHNOLOGIQUE;BAC STD2A;BAC STD2A SCIENCES & TECHNO. DESIGN-ARTS APPLIQUES;47;47;47;0;0;0;0;47;0;2;16;14;15;0
18197.0;2023;04;BORDEAUX;MASCULIN;SCOLAIRE;BAC TECHNOLOGIQUE;BAC STHR;BAC STHR SC.&TEC. HOTELLERIE-RESTAURATION;40;40;34;1;5;2;3;36;1;1;6;15;13;4
18201.0;2023;04;BORDEAUX;MASCULIN;SCOLAIRE;BAC TECHNOLOGIQUE;BAC STI2D;BAC STI2D SYSTÈME D'INFORMATION  ET NUMERIQUE;365;365;317;14;34;24;10;341;1;15;68;115;142;24
18204.0;2023;04;BORDEAUX;MASCULIN;SCOLAIRE;BAC TECHNOLOGIQUE;BAC STMG;BAC STMG GESTION ET FINANCE;421;421;325;26;70;52;18;377;0;2;35;115;225;44
18210.0;2023;06;CLERMONT-FERRAND;FEMININ;APPRENTISSAGE;BAC PROFESSIONNEL;BAC PRO PROD;BAC PRO 23405 TECHNICIEN MENUISIER AGENCEUR;1;1;1;0;0;0;0;1;0;1;0;0;0;0
18218.0;2023;06;CLERMONT-FERRAND;FEMININ;APPRENTISSAGE;BAC PROFESSIONNEL;BAC PRO PROD;BAC PRO AG 21210 COND GEST ENTR CANIN ET FELIN;18;18;15;3;0;0;0;15;0;0;1;1;13;3
18219.0;2023;06;CLERMONT-FERRAND;FEMININ;APPRENTISSAGE;BAC PROFESSIONNEL;BAC PRO PROD;BAC PRO AG 21211 COND GEST ENTR HIPPIQUE;3;3;3;0;0;0;0;3;0;0;0;1;2;0
18220.0;2023;06;CLERMONT-FERRAND;FEMININ;APPRENTISSAGE;BAC PROFESSIONNEL;BAC PRO PROD;BAC PRO AG 21405 AMENAGEMENTS PAYSAGERS;1;1;1;0;0;0;0;1;0;0;0;0;1;0
18221.0;2023;06;CLERMONT-FERRAND;FEMININ;APPRENTISSAGE;BAC PROFESSIONNEL;BAC PRO PROD;BAC PRO AG 22108 TEC CONS VTE ALIMENTATION (PAB);4;4;4;0;0;0;0;4;0;0;0;2;2;0
18228.0;2023;06;CLERMONT-FERRAND;FEMININ;APPRENTISSAGE;BAC PROFESSIONNEL;BAC PRO SERV;BAC PRO 33403 COMMERC. SERVICES EN RESTAURATION;1;1;1;0;0;0;0;1;0;0;0;1;0;0
18230.0;2023;06;CLERMONT-FERRAND;FEMININ;ENSEIGNEMENT A DISTANCE;BAC GENERAL;BAC GENERAL;BAC GENE 10019 BAC GENERAL;24;24;17;2;5;4;1;21;1;0;2;7;11;3
18233.0;2023;06;CLERMONT-FERRAND;FEMININ;ENSEIGNEMENT A DISTANCE;BAC PROFESSIONNEL;BAC PRO SERV;BAC PRO 31213 MET.COM.VEN.OP.A ANI.GES.ESP.COM.;2;2;1;1;0;0;0;1;0;0;0;1;0;1
18234.0;2023;06;CLERMONT-FERRAND;FEMININ;ENSEIGNEMENT A DISTANCE;BAC PROFESSIONNEL;BAC PRO SERV;BAC PRO 33004 ACC.SOINS-S.PERS. OPT.EN STRUCTUR;4;3;0;3;0;0;0;0;0;0;0;0;0;3
18239.0;2023;06;CLERMONT-FERRAND;FEMININ;FORMATION CONTINUE;BAC PROFESSIONNEL;BAC PRO PROD;BAC PRO AG 21004 CGEA;10;9;9;0;0;0;0;9;0;0;0;0;9;0
18244.0;2023;06;CLERMONT-FERRAND;FEMININ;FORMATION CONTINUE;BAC PROFESSIONNEL;BAC PRO SERV;BAC PRO 33101 OPTIQUE LUNETTERIE;1;1;1;0;0;0;0;1;0;0;0;1;0;0
18245.0;2023;06;CLERMONT-FERRAND;FEMININ;FORMATION CONTINUE;BAC PROFESSIONNEL;BAC PRO SERV;BAC PRO 33604 METIERS DE LA COIFFURE;1;0;0;0;0;0;0;0;0;0;0;0;0;0
18248.0;2023;06;CLERMONT-FERRAND;FEMININ;INDIVIDUEL;BAC PROFESSIONNEL;BAC PRO PROD;BAC PRO AG 21004 CGEA;3;3;2;1;0;0;0;2;0;0;0;0;2;1
18260.0;2023;06;CLERMONT-FERRAND;FEMININ;SCOLAIRE;BAC GENERAL;BAC GENERAL;BAC GENE 10019 BAC GENERAL;3778;3778;3553;39;186;131;55;3684;79;460;912;1188;1045;94
18266.0;2023;06;CLERMONT-FERRAND;FEMININ;SCOLAIRE;BAC PROFESSIONNEL;BAC PRO PROD;BAC PRO 23004 TECHN. ETUDES BAT.A ETUDES & ECO.;7;7;5;2;0;0;0;5;0;0;1;1;3;2
18268.0;2023;06;CLERMONT-FERRAND;FEMININ;SCOLAIRE;BAC PROFESSIONNEL;BAC PRO PROD;BACPRO 23103 TECHNICIEN GEOMETRE-TOPOGRAPHE;1;1;1;0;0;0;0;1;0;0;0;1;0;0
18270.0;2023;06;CLERMONT-FERRAND;FEMININ;SCOLAIRE;BAC PROFESSIONNEL;BAC PRO PROD;BAC PRO 23304 AMENAGEMENT FINITION BATIMENT;4;4;4;0;0;0;0;4;0;1;0;0;3;0
18281.0;2023;06;CLERMONT-FERRAND;FEMININ;SCOLAIRE;BAC PROFESSIONNEL;BAC PRO PROD;BAC PRO 25510 METIERS ELECT. ENVIRON. CONNECTES;3;3;2;1;0;0;0;2;0;0;0;1;1;1
18284.0;2023;06;CLERMONT-FERRAND;FEMININ;SCOLAIRE;BAC PROFESSIONNEL;BAC PRO PROD;BAC PRO AG 21004 CGEA;72;71;57;14;0;0;0;57;0;1;4;18;34;14
18294.0;2023;06;CLERMONT-FERRAND;FEMININ;SCOLAIRE;BAC PROFESSIONNEL;BAC PRO PROD;BAC PRO AG 22105 LABORATOIRE CONTROLE QUALITE;2;2;2;0;0;0;0;2;0;0;2;0;0;0
18295.0;2023;06;CLERMONT-FERRAND;FEMININ;SCOLAIRE;BAC PROFESSIONNEL;BAC PRO PROD;BAC PRO AG 22108 TEC CONS VTE ALIMENTATION (PAB);3;3;3;0;0;0;0;3;0;0;1;1;1;0
18296.0;2023;06;CLERMONT-FERRAND;FEMININ;SCOLAIRE;BAC PROFESSIONNEL;BAC PRO SERV;BAC PRO 30004 ASSISTANC.GEST.ORGANIS.ACTIVITES;160;160;133;20;7;4;3;137;0;6;33;46;52;23
18298.0;2023;06;CLERMONT-FERRAND;FEMININ;SCOLAIRE;BAC PROFESSIONNEL;BAC PRO SERV;BAC PRO 31107 CONDUCT. TRANSP.ROUT.MARCHANDISES;2;2;2;0;0;0;0;2;0;0;1;0;1;0
18301.0;2023;06;CLERMONT-FERRAND;FEMININ;SCOLAIRE;BAC PROFESSIONNEL;BAC PRO SERV;BAC PRO 31213 MET.COM.VEN.OP.A ANI.GES.ESP.COM.;179;177;152;22;3;2;1;154;0;7;31;61;55;23
18305.0;2023;06;CLERMONT-FERRAND;FEMININ;SCOLAIRE;BAC PROFESSIONNEL;BAC PRO SERV;BAC PRO 32303 ART.& MET.ART:COM.VIS.VIS.PLURI-M;39;39;34;5;0;0;0;34;0;3;8;13;10;5
18319.0;2023;06;CLERMONT-FERRAND;FEMININ;SCOLAIRE;BAC TECHNOLOGIQUE;BAC STAV;BAC STAV AGRONOMIE ALIM ENV TERRITOI;76;74;74;0;0;0;0;74;0;2;12;22;38;0
18321.0;2023;06;CLERMONT-FERRAND;FEMININ;SCOLAIRE;BAC TECHNOLOGIQUE;BAC STHR;BAC STHR SC.&TEC. HOTELLERIE-RESTAURATION;36;36;33;0;3;2;1;35;0;5;9;14;7;1
18356.0;2023;06;CLERMONT-FERRAND;MASCULIN;APPRENTISSAGE;BAC PROFESSIONNEL;BAC PRO PROD;BAC PRO 25509 TECHNIC. FROID CONDITIONNEMT AIR;15;15;14;0;1;1;0;15;0;2;4;5;4;0
18360.0;2023;06;CLERMONT-FERRAND;MASCULIN;APPRENTISSAGE;BAC PROFESSIONNEL;BAC PRO PROD;BAC PRO 25515 SYST.NUM.OPT.C RES.INF.SYST.COMM.;1;1;1;0;0;0;0;1;0;0;1;0;0;0
18363.0;2023;06;CLERMONT-FERRAND;MASCULIN;APPRENTISSAGE;BAC PROFESSIONNEL;BAC PRO PROD;BAC PRO AG 21203 TECHN CONSEIL DE VENTE ANIMAL;1;1;1;0;0;0;0;1;0;0;0;0;1;0
18364.0;2023;06;CLERMONT-FERRAND;MASCULIN;APPRENTISSAGE;BAC PROFESSIONNEL;BAC PRO PROD;BAC PRO AG 21210 COND GEST ENTR CANIN ET FELIN;7;7;6;1;0;0;0;6;0;0;0;0;6;1
18366.0;2023;06;CLERMONT-FERRAND;MASCULIN;APPRENTISSAGE;BAC PROFESSIONNEL;BAC PRO PROD;BAC PRO AG 21405 AMENAGEMENTS PAYSAGERS;22;20;18;2;0;0;0;18;0;0;2;6;10;2
18369.0;2023;06;CLERMONT-FERRAND;MASCULIN;APPRENTISSAGE;BAC PROFESSIONNEL;BAC PRO SERV;BAC PRO 31106 LOGISTIQUE;24;24;21;2;1;1;0;22;0;1;3;12;6;2
18374.0;2023;06;CLERMONT-FERRAND;MASCULIN;ENSEIGNEMENT A DISTANCE;BAC GENERAL;BAC GENERAL;BAC GENE 10019 BAC GENERAL;10;10;3;4;3;3;0;6;0;0;0;1;5;4
18379.0;2023;06;CLERMONT-FERRAND;MASCULIN;FORMATION CONTINUE;BAC PROFESSIONNEL;BAC PRO PROD;BAC PRO 25509 TECHNIC. FROID CONDITIONNEMT AIR;1;1;1;0;0;0;0;1;0;1;0;0;0;0
18381.0;2023;06;CLERMONT-FERRAND;MASCULIN;FORMATION CONTINUE;BAC PROFESSIONNEL;BAC PRO PROD;BAC PRO AG 21004 CGEA;16;14;14;0;0;0;0;14;0;1;1;1;11;0
18383.0;2023;06;CLERMONT-FERRAND;MASCULIN;FORMATION CONTINUE;BAC PROFESSIONNEL;BAC PRO SERV;BAC PRO 32208 REAL.PR.IMPR.PLURI.OPTB.PR.IMPR.;1;1;1;0;0;0;0;1;0;1;0;0;0;0
18393.0;2023;06;CLERMONT-FERRAND;MASCULIN;INDIVIDUEL;BAC PROFESSIONNEL;BAC PRO PROD;BAC PRO AG 21114 CONDUITE PRODUCTIONS HORTICOLES;1;1;1;0;0;0;0;1;0;0;0;0;1;0
18396.0;2023;06;CLERMONT-FERRAND;MASCULIN;INDIVIDUEL;BAC PROFESSIONNEL;BAC PRO SERV;BAC PRO 31212 METIERS DE L'ACCUEIL;1;1;1;0;0;0;0;1;0;0;0;1;0;0
18404.0;2023;06;CLERMONT-FERRAND;MASCULIN;INDIVIDUEL;BAC TECHNOLOGIQUE;BAC STMG;BAC STMG GESTION ET FINANCE;2;2;2;0;0;0;0;2;0;1;1;0;0;0
18408.0;2023;06;CLERMONT-FERRAND;MASCULIN;SCOLAIRE;BAC GENERAL;BAC GENERAL;BAC GENE 10019 BAC GENERAL;2741;2741;2486;38;217;161;56;2647;42;242;559;874;930;94
18421.0;2023;06;CLERMONT-FERRAND;MASCULIN;SCOLAIRE;BAC PROFESSIONNEL;BAC PRO PROD;BACPRO 23103 TECHNICIEN GEOMETRE-TOPOGRAPHE;11;11;9;2;0;0;0;9;0;0;2;4;3;2
18423.0;2023;06;CLERMONT-FERRAND;MASCULIN;SCOLAIRE;BAC PROFESSIONNEL;BAC PRO PROD;BAC PRO 23304 AMENAGEMENT FINITION BATIMENT;8;8;4;3;1;0;1;4;0;0;1;0;3;4
18430.0;2023;06;CLERMONT-FERRAND;MASCULIN;SCOLAIRE;BAC PROFESSIONNEL;BAC PRO PROD;BAC PRO 25214 MAINT.VEHIC.OPTA VOIT.PARTICUL.;66;66;49;11;6;4;2;53;0;2;10;17;24;13
18453.0;2023;06;CLERMONT-FERRAND;MASCULIN;SCOLAIRE;BAC PROFESSIONNEL;BAC PRO PROD;BAC PRO AG 21303 FORET;18;18;17;1;0;0;0;17;0;0;2;8;7;1
18454.0;2023;06;CLERMONT-FERRAND;MASCULIN;SCOLAIRE;BAC PROFESSIONNEL;BAC PRO PROD;BAC PRO AG 21405 AMENAGEMENTS PAYSAGERS;52;51;46;5;0;0;0;46;0;0;5;21;20;5
18461.0;2023;06;CLERMONT-FERRAND;MASCULIN;SCOLAIRE;BAC PROFESSIONNEL;BAC PRO SERV;BAC PRO 31212 METIERS DE L'ACCUEIL;33;33;27;4;2;2;0;29;0;0;3;14;12;4
18462.0;2023;06;CLERMONT-FERRAND;MASCULIN;SCOLAIRE;BAC PROFESSIONNEL;BAC PRO SERV;BAC PRO 31213 MET.COM.VEN.OP.A ANI.GES.ESP.COM.;135;135;96;28;11;9;2;105;0;4;19;31;51;30
18473.0;2023;06;CLERMONT-FERRAND;MASCULIN;SCOLAIRE;BAC PROFESSIONNEL;BAC PRO SERV;BAC PRO 33403 COMMERC. SERVICES EN RESTAURATION;39;39;30;9;0;0;0;30;0;1;3;12;14;9
18474.0;2023;06;CLERMONT-FERRAND;MASCULIN;SCOLAIRE;BAC PROFESSIONNEL;BAC PRO SERV;BAC PRO 33604 METIERS DE LA COIFFURE;1;1;0;1;0;0;0;0;0;0;0;0;0;1
18480.0;2023;06;CLERMONT-FERRAND;MASCULIN;SCOLAIRE;BAC TECHNOLOGIQUE;BAC STD2A;BAC STD2A SCIENCES & TECHNO. DESIGN-ARTS APPLIQUES;22;22;22;0;0;0;0;22;0;0;6;11;5;0
18483.0;2023;06;CLERMONT-FERRAND;MASCULIN;SCOLAIRE;BAC TECHNOLOGIQUE;BAC STI2D;BAC STI2D ENERGIES  ET ENVIRONNEMENT;50;50;44;3;3;2;1;46;0;1;10;13;22;4
18494.0;2023;27;CORSE;FEMININ;APPRENTISSAGE;BAC PROFESSIONNEL;BAC PRO SERV;BAC PRO 31106 LOGISTIQUE;2;2;2;0;0;0;0;2;0;0;0;2;0;0
18495.0;2023;27;CORSE;FEMININ;APPRENTISSAGE;BAC PROFESSIONNEL;BAC PRO SERV;BAC PRO 31213 MET.COM.VEN.OP.A ANI.GES.ESP.COM.;8;8;5;2;1;1;0;6;0;0;0;2;4;2
18499.0;2023;27;CORSE;FEMININ;ENSEIGNEMENT A DISTANCE;BAC PROFESSIONNEL;BAC PRO SERV;BAC PRO 33004 ACC.SOINS-S.PERS. OPT.EN STRUCTUR;1;1;1;0;0;0;0;1;0;0;0;0;1;0
18500.0;2023;27;CORSE;FEMININ;ENSEIGNEMENT A DISTANCE;BAC TECHNOLOGIQUE;BAC ST2S;BAC ST2S SCIENCES & TECHNO. SANTE & SOCIAL;1;1;1;0;0;0;0;1;0;0;0;1;0;0
18505.0;2023;27;CORSE;FEMININ;INDIVIDUEL;BAC PROFESSIONNEL;BAC PRO PROD;BAC PRO AG 21114 CONDUITE PRODUCTIONS HORTICOLES;7;6;5;1;0;0;0;5;0;0;0;0;5;1
18514.0;2023;27;CORSE;FEMININ;SCOLAIRE;BAC PROFESSIONNEL;BAC PRO PROD;BAC PRO 25515 SYST.NUM.OPT.C RES.INF.SYST.COMM.;2;2;2;0;0;0;0;2;0;1;1;0;0;0
18517.0;2023;27;CORSE;FEMININ;SCOLAIRE;BAC PROFESSIONNEL;BAC PRO PROD;BAC PRO AG 21302 GEST MILIEUX NATURELS FAUNE;1;1;1;0;0;0;0;1;0;0;0;1;0;0
18522.0;2023;27;CORSE;FEMININ;SCOLAIRE;BAC PROFESSIONNEL;BAC PRO SERV;BAC PRO 31107 CONDUCT. TRANSP.ROUT.MARCHANDISES;2;2;2;0;0;0;0;2;0;0;0;2;0;0
18529.0;2023;27;CORSE;FEMININ;SCOLAIRE;BAC PROFESSIONNEL;BAC PRO SERV;BAC PRO 33403 COMMERC. SERVICES EN RESTAURATION;12;12;12;0;0;0;0;12;0;0;4;2;6;0
18534.0;2023;27;CORSE;FEMININ;SCOLAIRE;BAC TECHNOLOGIQUE;BAC STHR;BAC STHR SC.&TEC. HOTELLERIE-RESTAURATION;4;4;3;0;1;1;0;4;0;0;0;1;3;0
18535.0;2023;27;CORSE;FEMININ;SCOLAIRE;BAC TECHNOLOGIQUE;BAC STI2D;BAC STI2D ARCHITECTURE ET CONSTRUCTION;5;5;5;0;0;0;0;5;0;0;1;2;2;0
18536.0;2023;27;CORSE;FEMININ;SCOLAIRE;BAC TECHNOLOGIQUE;BAC STI2D;BAC STI2D SYSTÈME D'INFORMATION  ET NUMERIQUE;1;1;1;0;0;0;0;1;0;0;1;0;0;0
18537.0;2023;27;CORSE;FEMININ;SCOLAIRE;BAC TECHNOLOGIQUE;BAC STL;BAC STL BIOCHIM.-BIOLOGIE-BIOTECHNOL.;7;7;5;0;2;0;2;5;0;1;0;2;2;2
18540.0;2023;27;CORSE;FEMININ;SCOLAIRE;BAC TECHNOLOGIQUE;BAC STMG;BAC STMG RESSOURCES HUMAINES ET COMMUNICATION;57;57;42;6;9;9;0;51;0;2;3;15;31;6
18553.0;2023;27;CORSE;MASCULIN;APPRENTISSAGE;BAC PROFESSIONNEL;BAC PRO SERV;BAC PRO 31214 MET.COM.VEN.OP.B PR.CL.VA.OF.COM.;2;2;1;1;0;0;0;1;0;0;0;0;1;1
18560.0;2023;27;CORSE;MASCULIN;INDIVIDUEL;BAC PROFESSIONNEL;BAC PRO PROD;BAC PRO 25406 OUVRAGES DU BATIMENT METALLERIE;2;2;0;0;2;1;1;1;0;0;0;0;1;1
18567.0;2023;27;CORSE;MASCULIN;SCOLAIRE;BAC PROFESSIONNEL;BAC PRO PROD;BAC PRO 22703 TECHN.INSTALL.SYST.ENERG.CLIMATI;6;6;4;1;1;1;0;5;0;0;0;1;4;1
18569.0;2023;27;CORSE;MASCULIN;SCOLAIRE;BAC PROFESSIONNEL;BAC PRO PROD;BAC PRO 23005 TECHN. ETUDES BAT B ASSIST.ARCHI.;6;6;5;1;0;0;0;5;0;1;2;0;2;1
18571.0;2023;27;CORSE;MASCULIN;SCOLAIRE;BAC PROFESSIONNEL;BAC PRO PROD;BAC PRO 25009 MAINTENANCE NAUTIQUE;10;10;8;2;0;0;0;8;0;0;1;4;3;2
18572.0;2023;27;CORSE;MASCULIN;SCOLAIRE;BAC PROFESSIONNEL;BAC PRO PROD;BAC PRO 25214 MAINT.VEHIC.OPTA VOIT.PARTICUL.;18;18;15;1;2;2;0;17;0;1;3;7;6;1
18574.0;2023;27;CORSE;MASCULIN;SCOLAIRE;BAC PROFESSIONNEL;BAC PRO PROD;BAC PRO 25509 TECHNIC. FROID CONDITIONNEMT AIR;8;8;4;4;0;0;0;4;0;0;0;1;3;4
18575.0;2023;27;CORSE;MASCULIN;SCOLAIRE;BAC PROFESSIONNEL;BAC PRO PROD;BAC PRO 25510 METIERS ELECT. ENVIRON. CONNECTES;28;28;23;2;3;3;0;26;0;0;9;8;9;2
18576.0;2023;27;CORSE;MASCULIN;SCOLAIRE;BAC PROFESSIONNEL;BAC PRO PROD;BAC PRO 25513 SYST.NUM.OPT.A SURETE SECURITE;9;9;7;0;2;2;0;9;0;0;3;3;3;0
18581.0;2023;27;CORSE;MASCULIN;SCOLAIRE;BAC PROFESSIONNEL;BAC PRO PROD;BAC PRO AG 21302 GEST MILIEUX NATURELS FAUNE;5;5;5;0;0;0;0;5;0;0;1;2;2;0
18584.0;2023;27;CORSE;MASCULIN;SCOLAIRE;BAC PROFESSIONNEL;BAC PRO SERV;BAC PRO 30004 ASSISTANC.GEST.ORGANIS.ACTIVITES;20;20;11;9;0;0;0;11;0;0;4;0;7;9
18586.0;2023;27;CORSE;MASCULIN;SCOLAIRE;BAC PROFESSIONNEL;BAC PRO SERV;BAC PRO 31107 CONDUCT. TRANSP.ROUT.MARCHANDISES;8;8;8;0;0;0;0;8;0;1;2;4;1;0
18587.0;2023;27;CORSE;MASCULIN;SCOLAIRE;BAC PROFESSIONNEL;BAC PRO SERV;BAC PRO 31212 METIERS DE L'ACCUEIL;1;1;1;0;0;0;0;1;0;0;1;0;0;0
18591.0;2023;27;CORSE;MASCULIN;SCOLAIRE;BAC PROFESSIONNEL;BAC PRO SERV;BAC PRO 33006 ANIMAT. ENFANCE& PERSONNES AGEES;1;1;1;0;0;0;0;1;0;0;0;1;0;0
18592.0;2023;27;CORSE;MASCULIN;SCOLAIRE;BAC PROFESSIONNEL;BAC PRO SERV;BAC PRO 33403 COMMERC. SERVICES EN RESTAURATION;17;17;17;0;0;0;0;17;0;1;3;6;7;0
18597.0;2023;27;CORSE;MASCULIN;SCOLAIRE;BAC TECHNOLOGIQUE;BAC STHR;BAC STHR SC.&TEC. HOTELLERIE-RESTAURATION;4;4;2;0;2;1;1;3;0;0;0;1;2;1
18598.0;2023;27;CORSE;MASCULIN;SCOLAIRE;BAC TECHNOLOGIQUE;BAC STI2D;BAC STI2D ARCHITECTURE ET CONSTRUCTION;6;6;6;0;0;0;0;6;0;0;0;2;4;0
18600.0;2023;27;CORSE;MASCULIN;SCOLAIRE;BAC TECHNOLOGIQUE;BAC STI2D;BAC STI2D INNOVATION TECHNO.  ET ECO CONCEPTION;6;6;6;0;0;0;0;6;0;0;2;1;3;0
18603.0;2023;27;CORSE;MASCULIN;SCOLAIRE;BAC TECHNOLOGIQUE;BAC STMG;BAC STMG GESTION ET FINANCE;36;36;30;0;6;4;2;34;0;0;2;12;20;2
18606.0;2023;24;CRETEIL;FEMININ;APPRENTISSAGE;BAC PROFESSIONNEL;BAC PRO PROD;BAC PRO 22106 CUISINE;27;27;21;5;1;0;1;21;0;3;2;10;6;6
18615.0;2023;24;CRETEIL;FEMININ;APPRENTISSAGE;BAC PROFESSIONNEL;BAC PRO PROD;BAC PRO 25216 MAINT.VEHIC.OPTC MOTOCYCLES;2;2;2;0;0;0;0;2;0;0;0;2;0;0
18617.0;2023;24;CRETEIL;FEMININ;APPRENTISSAGE;BAC PROFESSIONNEL;BAC PRO PROD;BAC PRO 25510 METIERS ELECT. ENVIRON. CONNECTES;2;2;2;0;0;0;0;2;0;1;0;0;1;0
18622.0;2023;24;CRETEIL;FEMININ;APPRENTISSAGE;BAC PROFESSIONNEL;BAC PRO SERV;BAC PRO 31212 METIERS DE L'ACCUEIL;11;11;11;0;0;0;0;11;0;4;4;3;0;0
18633.0;2023;24;CRETEIL;FEMININ;ENSEIGNEMENT A DISTANCE;BAC PROFESSIONNEL;BAC PRO SERV;BAC PRO 30004 ASSISTANC.GEST.ORGANIS.ACTIVITES;9;5;2;3;0;0;0;2;0;0;0;0;2;3
18652.0;2023;24;CRETEIL;FEMININ;FORMATION CONTINUE;BAC PROFESSIONNEL;BAC PRO SERV;BAC PRO 33603 ESTHETIQUE COSMETIQUE PARFUMERIE;15;11;7;4;0;0;0;7;0;0;1;0;6;4
18661.0;2023;24;CRETEIL;FEMININ;INDIVIDUEL;BAC PROFESSIONNEL;BAC PRO SERV;BAC PRO 30004 ASSISTANC.GEST.ORGANIS.ACTIVITES;31;18;7;11;0;0;0;7;0;0;0;0;7;11
18664.0;2023;24;CRETEIL;FEMININ;INDIVIDUEL;BAC PROFESSIONNEL;BAC PRO SERV;BAC PRO 31214 MET.COM.VEN.OP.B PR.CL.VA.OF.COM.;1;1;0;1;0;0;0;0;0;0;0;0;0;1
18666.0;2023;24;CRETEIL;FEMININ;INDIVIDUEL;BAC PROFESSIONNEL;BAC PRO SERV;BAC PRO 33003 ACC.SOINS-S.PERS. OPT.A DOMICILE;2;1;0;1;0;0;0;0;0;0;0;0;0;1
18670.0;2023;24;CRETEIL;FEMININ;INDIVIDUEL;BAC PROFESSIONNEL;BAC PRO SERV;BAC PRO 34403 METIERS DE LA SECURITE;1;0;0;0;0;0;0;0;0;0;0;0;0;0
18674.0;2023;24;CRETEIL;FEMININ;INDIVIDUEL;BAC TECHNOLOGIQUE;BAC STI2D;BAC STI2D INNOVATION TECHNO.  ET ECO CONCEPTION;1;1;0;1;0;0;0;0;0;0;0;0;0;1
18678.0;2023;24;CRETEIL;FEMININ;INDIVIDUEL;BAC TECHNOLOGIQUE;BAC STMG;BAC STMG MERCATIQUE (MARKETING);29;28;3;20;5;4;1;7;0;0;0;1;6;21
18679.0;2023;24;CRETEIL;FEMININ;INDIVIDUEL;BAC TECHNOLOGIQUE;BAC STMG;BAC STMG RESSOURCES HUMAINES ET COMMUNICATION;32;32;5;21;6;3;3;8;0;0;0;2;6;24
18686.0;2023;24;CRETEIL;FEMININ;SCOLAIRE;BAC PROFESSIONNEL;BAC PRO PROD;BAC PRO 23003 ARTIS. & M.ART:MARCHANDISAGE VIS.;16;16;14;2;0;0;0;14;0;1;5;5;3;2
18687.0;2023;24;CRETEIL;FEMININ;SCOLAIRE;BAC PROFESSIONNEL;BAC PRO PROD;BAC PRO 23004 TECHN. ETUDES BAT.A ETUDES & ECO.;8;8;7;1;0;0;0;7;0;2;1;1;3;1
18689.0;2023;24;CRETEIL;FEMININ;SCOLAIRE;BAC PROFESSIONNEL;BAC PRO PROD;BAC PRO 23102 TRAVAUX PUBLICS;1;1;1;0;0;0;0;1;0;0;0;1;0;0
18692.0;2023;24;CRETEIL;FEMININ;SCOLAIRE;BAC PROFESSIONNEL;BAC PRO PROD;BAC PRO 23304 AMENAGEMENT FINITION BATIMENT;4;4;2;1;1;0;1;2;0;0;1;1;0;2
18693.0;2023;24;CRETEIL;FEMININ;SCOLAIRE;BAC PROFESSIONNEL;BAC PRO PROD;BAC PRO 23404 TECHNICIEN CONSTRUCTEUR BOIS;1;1;0;1;0;0;0;0;0;0;0;0;0;1
18696.0;2023;24;CRETEIL;FEMININ;SCOLAIRE;BAC PROFESSIONNEL;BAC PRO PROD;BAC PRO 24202 ARTIS.& MET.ART : TAPIS.D'AMEUBL;6;6;5;1;0;0;0;5;0;0;2;1;2;1
18698.0;2023;24;CRETEIL;FEMININ;SCOLAIRE;BAC PROFESSIONNEL;BAC PRO PROD;BAC PRO 24302 METIERS DU CUIR : MAROQUINERIE;18;18;15;2;1;1;0;16;0;2;2;7;5;2
18703.0;2023;24;CRETEIL;FEMININ;SCOLAIRE;BAC PROFESSIONNEL;BAC PRO PROD;BAC PRO 25216 MAINT.VEHIC.OPTC MOTOCYCLES;2;2;2;0;0;0;0;2;0;1;1;0;0;0
18706.0;2023;24;CRETEIL;FEMININ;SCOLAIRE;BAC PROFESSIONNEL;BAC PRO PROD;BAC PRO 25411 TECH.CHAUDRONNERIE INDUSTRIELLE;3;3;2;1;0;0;0;2;0;0;1;1;0;1
18708.0;2023;24;CRETEIL;FEMININ;SCOLAIRE;BAC PROFESSIONNEL;BAC PRO PROD;BAC PRO 25514 SYST.NUM.OPT.B AUD.RES.EQUIP.DOM.;2;2;2;0;0;0;0;2;0;0;0;2;0;0
18715.0;2023;24;CRETEIL;FEMININ;SCOLAIRE;BAC PROFESSIONNEL;BAC PRO PROD;BAC PRO AG 22108 TEC CONS VTE ALIMENTATION (PAB);4;4;1;3;0;0;0;1;0;0;0;0;1;3
18719.0;2023;24;CRETEIL;FEMININ;SCOLAIRE;BAC PROFESSIONNEL;BAC PRO SERV;BAC PRO 31114 ORGANIS. TRANSPORT MARCHANDISES;12;12;7;5;0;0;0;7;0;0;2;2;3;5
18734.0;2023;24;CRETEIL;FEMININ;SCOLAIRE;BAC PROFESSIONNEL;BAC PRO SERV;BAC PRO 33604 METIERS DE LA COIFFURE;39;39;24;13;2;2;0;26;0;1;4;11;10;13
18756.0;2023;24;CRETEIL;MASCULIN;APPRENTISSAGE;BAC PROFESSIONNEL;BAC PRO PROD;BAC PRO 22704 TECHN. MAINT. SYST.ENERG.CLIMATI;34;34;19;14;1;1;0;20;0;1;4;6;9;14
18763.0;2023;24;CRETEIL;MASCULIN;APPRENTISSAGE;BAC PROFESSIONNEL;BAC PRO PROD;BAC PRO 25214 MAINT.VEHIC.OPTA VOIT.PARTICUL.;177;177;136;30;11;5;6;141;0;10;41;46;44;36
18764.0;2023;24;CRETEIL;MASCULIN;APPRENTISSAGE;BAC PROFESSIONNEL;BAC PRO PROD;BAC PRO 25215 MAINT.VEHIC.OPTB VEHIC.TRANS.ROUT;30;30;20;7;3;3;0;23;0;2;3;7;11;7
18766.0;2023;24;CRETEIL;MASCULIN;APPRENTISSAGE;BAC PROFESSIONNEL;BAC PRO PROD;BAC PRO 25219 MAINT.MATERIELS OPT.A AGRICOLES;7;7;6;0;1;0;1;6;0;2;2;2;0;1
18781.0;2023;24;CRETEIL;MASCULIN;APPRENTISSAGE;BAC PROFESSIONNEL;BAC PRO SERV;BAC PRO 31212 METIERS DE L'ACCUEIL;7;7;6;0;1;1;0;7;0;3;2;0;2;0
18802.0;2023;24;CRETEIL;MASCULIN;FORMATION CONTINUE;BAC PROFESSIONNEL;BAC PRO PROD;BAC PRO 24303 MET. DU CUIR: SELLERIE GARNISSAGE;2;2;2;0;0;0;0;2;0;0;0;2;0;0
18810.0;2023;24;CRETEIL;MASCULIN;FORMATION CONTINUE;BAC PROFESSIONNEL;BAC PRO SERV;BAC PRO 32304 PHOTOGRAPHIE;2;2;1;1;0;0;0;1;0;0;0;0;1;1
18816.0;2023;24;CRETEIL;MASCULIN;INDIVIDUEL;BAC PROFESSIONNEL;BAC PRO PROD;BAC PRO 23004 TECHN. ETUDES BAT.A ETUDES & ECO.;3;3;0;3;0;0;0;0;0;0;0;0;0;3
18818.0;2023;24;CRETEIL;MASCULIN;INDIVIDUEL;BAC PROFESSIONNEL;BAC PRO PROD;BAC PRO 23405 TECHNICIEN MENUISIER AGENCEUR;1;1;1;0;0;0;0;1;0;0;1;0;0;0
18821.0;2023;24;CRETEIL;MASCULIN;INDIVIDUEL;BAC PROFESSIONNEL;BAC PRO PROD;BAC PRO 25214 MAINT.VEHIC.OPTA VOIT.PARTICUL.;2;2;2;0;0;0;0;2;0;0;1;1;0;0
18822.0;2023;24;CRETEIL;MASCULIN;INDIVIDUEL;BAC PROFESSIONNEL;BAC PRO PROD;BAC PRO 25215 MAINT.VEHIC.OPTB VEHIC.TRANS.ROUT;1;0;0;0;0;0;0;0;0;0;0;0;0;0
18823.0;2023;24;CRETEIL;MASCULIN;INDIVIDUEL;BAC PROFESSIONNEL;BAC PRO PROD;BAC PRO 25216 MAINT.VEHIC.OPTC MOTOCYCLES;1;1;0;1;0;0;0;0;0;0;0;0;0;1
18836.0;2023;24;CRETEIL;MASCULIN;INDIVIDUEL;BAC PROFESSIONNEL;BAC PRO SERV;BAC PRO 31213 MET.COM.VEN.OP.A ANI.GES.ESP.COM.;14;9;5;4;0;0;0;5;0;0;0;0;5;4
18842.0;2023;24;CRETEIL;MASCULIN;INDIVIDUEL;BAC TECHNOLOGIQUE;BAC ST2S;BAC ST2S SCIENCES & TECHNO. SANTE & SOCIAL;4;4;0;4;0;0;0;0;0;0;0;0;0;4
18845.0;2023;24;CRETEIL;MASCULIN;INDIVIDUEL;BAC TECHNOLOGIQUE;BAC STHR;BAC STHR SC.&TEC. HOTELLERIE-RESTAURATION;1;1;0;1;0;0;0;0;0;0;0;0;0;1
18847.0;2023;24;CRETEIL;MASCULIN;INDIVIDUEL;BAC TECHNOLOGIQUE;BAC STI2D;BAC STI2D ENERGIES  ET ENVIRONNEMENT;1;1;0;1;0;0;0;0;0;0;0;0;0;1
18849.0;2023;24;CRETEIL;MASCULIN;INDIVIDUEL;BAC TECHNOLOGIQUE;BAC STI2D;BAC STI2D SYSTÈME D'INFORMATION  ET NUMERIQUE;4;4;1;3;0;0;0;1;0;0;0;0;1;3
18854.0;2023;24;CRETEIL;MASCULIN;INDIVIDUEL;BAC TECHNOLOGIQUE;BAC STMG;BAC STMG RESSOURCES HUMAINES ET COMMUNICATION;20;20;1;15;4;2;2;3;0;0;0;0;3;17
18865.0;2023;24;CRETEIL;MASCULIN;SCOLAIRE;BAC PROFESSIONNEL;BAC PRO PROD;BAC PRO 23005 TECHN. ETUDES BAT B ASSIST.ARCHI.;38;38;37;1;0;0;0;37;0;6;10;11;10;1
18876.0;2023;24;CRETEIL;MASCULIN;SCOLAIRE;BAC PROFESSIONNEL;BAC PRO PROD;BAC PRO 24203 METIERS DE LA MODE - VÊTEMENT;14;14;8;6;0;0;0;8;0;2;2;1;3;6
18882.0;2023;24;CRETEIL;MASCULIN;SCOLAIRE;BAC PROFESSIONNEL;BAC PRO PROD;BAC PRO 25214 MAINT.VEHIC.OPTA VOIT.PARTICUL.;165;165;114;36;15;11;4;125;0;9;22;42;52;40
18887.0;2023;24;CRETEIL;MASCULIN;SCOLAIRE;BAC PROFESSIONNEL;BAC PRO PROD;BAC PRO 25221 MAINT.MATERIELS OPT.C ESP. VERTS;13;13;9;4;0;0;0;9;0;0;3;2;4;4
18896.0;2023;24;CRETEIL;MASCULIN;SCOLAIRE;BAC PROFESSIONNEL;BAC PRO PROD;BAC PRO 25510 METIERS ELECT. ENVIRON. CONNECTES;1211;1211;885;222;104;65;39;950;0;51;182;314;403;261
18897.0;2023;24;CRETEIL;MASCULIN;SCOLAIRE;BAC PROFESSIONNEL;BAC PRO PROD;BAC PRO 25513 SYST.NUM.OPT.A SURETE SECURITE;100;100;69;23;8;6;2;75;0;2;10;25;38;25
18899.0;2023;24;CRETEIL;MASCULIN;SCOLAIRE;BAC PROFESSIONNEL;BAC PRO PROD;BAC PRO 25515 SYST.NUM.OPT.C RES.INF.SYST.COMM.;527;527;429;93;5;4;1;433;0;24;103;168;138;94
18901.0;2023;24;CRETEIL;MASCULIN;SCOLAIRE;BAC PROFESSIONNEL;BAC PRO PROD;BAC PRO AG 21114 CONDUITE PRODUCTIONS HORTICOLES;13;13;9;4;0;0;0;9;0;1;0;1;7;4
18902.0;2023;24;CRETEIL;MASCULIN;SCOLAIRE;BAC PROFESSIONNEL;BAC PRO PROD;BAC PRO AG 21405 AMENAGEMENTS PAYSAGERS;32;31;27;4;0;0;0;27;0;0;5;8;14;4
18931.0;2023;24;CRETEIL;MASCULIN;SCOLAIRE;BAC TECHNOLOGIQUE;BAC STD2A;BAC STD2A SCIENCES & TECHNO. DESIGN-ARTS APPLIQUES;67;67;56;3;8;6;2;62;0;0;7;20;35;5
18935.0;2023;24;CRETEIL;MASCULIN;SCOLAIRE;BAC TECHNOLOGIQUE;BAC STI2D;BAC STI2D INNOVATION TECHNO.  ET ECO CONCEPTION;503;503;354;48;101;66;35;420;0;4;38;111;267;83
18936.0;2023;24;CRETEIL;MASCULIN;SCOLAIRE;BAC TECHNOLOGIQUE;BAC STI2D;BAC STI2D SYSTÈME D'INFORMATION  ET NUMERIQUE;804;804;634;58;112;68;44;702;1;20;95;230;356;102
18942.0;2023;24;CRETEIL;MASCULIN;SCOLAIRE;BAC TECHNOLOGIQUE;BAC STMG;BAC STMG SYSTEMES D'INFORMATION DE GESTION;233;233;140;28;65;60;5;200;0;0;9;22;169;33
18962.0;2023;07;DIJON;FEMININ;APPRENTISSAGE;BAC PROFESSIONNEL;BAC PRO SERV;BAC PRO 31212 METIERS DE L'ACCUEIL;2;2;2;0;0;0;0;2;0;0;1;0;1;0
18963.0;2023;07;DIJON;FEMININ;APPRENTISSAGE;BAC PROFESSIONNEL;BAC PRO SERV;BAC PRO 31213 MET.COM.VEN.OP.A ANI.GES.ESP.COM.;52;52;41;8;3;0;3;41;0;3;7;14;17;11
18966.0;2023;07;DIJON;FEMININ;APPRENTISSAGE;BAC PROFESSIONNEL;BAC PRO SERV;BAC PRO 34304 HYGIENE PROPRETE STERILISATION;1;1;1;0;0;0;0;1;0;0;0;0;1;0
18968.0;2023;07;DIJON;FEMININ;ENSEIGNEMENT A DISTANCE;BAC GENERAL;BAC GENERAL;BAC GENE 10019 BAC GENERAL;37;37;26;10;1;0;1;26;0;3;4;9;10;11
18971.0;2023;07;DIJON;FEMININ;ENSEIGNEMENT A DISTANCE;BAC PROFESSIONNEL;BAC PRO SERV;BAC PRO 31214 MET.COM.VEN.OP.B PR.CL.VA.OF.COM.;1;1;0;1;0;0;0;0;0;0;0;0;0;1
18975.0;2023;07;DIJON;FEMININ;ENSEIGNEMENT A DISTANCE;BAC TECHNOLOGIQUE;BAC STMG;BAC STMG MERCATIQUE (MARKETING);4;4;3;0;1;0;1;3;0;0;0;2;1;1
18977.0;2023;07;DIJON;FEMININ;FORMATION CONTINUE;BAC PROFESSIONNEL;BAC PRO PROD;BAC PRO 22106 CUISINE;1;1;1;0;0;0;0;1;0;0;0;1;0;0
18986.0;2023;07;DIJON;FEMININ;INDIVIDUEL;BAC PROFESSIONNEL;BAC PRO SERV;BAC PRO 30004 ASSISTANC.GEST.ORGANIS.ACTIVITES;9;8;3;4;1;1;0;4;0;0;0;0;4;4
18988.0;2023;07;DIJON;FEMININ;INDIVIDUEL;BAC PROFESSIONNEL;BAC PRO SERV;BAC PRO 33003 ACC.SOINS-S.PERS. OPT.A DOMICILE;1;1;0;1;0;0;0;0;0;0;0;0;0;1
18989.0;2023;07;DIJON;FEMININ;INDIVIDUEL;BAC PROFESSIONNEL;BAC PRO SERV;BAC PRO 33603 ESTHETIQUE COSMETIQUE PARFUMERIE;1;1;0;1;0;0;0;0;0;0;0;0;0;1
18993.0;2023;07;DIJON;FEMININ;INDIVIDUEL;BAC TECHNOLOGIQUE;BAC STMG;BAC STMG MERCATIQUE (MARKETING);10;10;2;5;3;1;2;3;0;0;0;1;2;7
18997.0;2023;07;DIJON;FEMININ;SCOLAIRE;BAC PROFESSIONNEL;BAC PRO PROD;BAC PRO 22003 BIO-INDUSTRIES DE TRANSFORMATION;8;8;6;1;1;1;0;7;0;0;1;4;2;1
19000.0;2023;07;DIJON;FEMININ;SCOLAIRE;BAC PROFESSIONNEL;BAC PRO PROD;BAC PRO 22106 CUISINE;42;42;37;0;5;4;1;41;0;1;10;16;14;1
19003.0;2023;07;DIJON;FEMININ;SCOLAIRE;BAC PROFESSIONNEL;BAC PRO PROD;BACPRO 23103 TECHNICIEN GEOMETRE-TOPOGRAPHE;2;2;2;0;0;0;0;2;0;1;0;1;0;0
19006.0;2023;07;DIJON;FEMININ;SCOLAIRE;BAC PROFESSIONNEL;BAC PRO PROD;BAC PRO 23405 TECHNICIEN MENUISIER AGENCEUR;8;8;8;0;0;0;0;8;0;0;1;4;3;0
19008.0;2023;07;DIJON;FEMININ;SCOLAIRE;BAC PROFESSIONNEL;BAC PRO PROD;BAC PRO 24202 ARTIS.& MET.ART : TAPIS.D'AMEUBL;2;2;2;0;0;0;0;2;0;0;0;1;1;0
19009.0;2023;07;DIJON;FEMININ;SCOLAIRE;BAC PROFESSIONNEL;BAC PRO PROD;BAC PRO 24203 METIERS DE LA MODE - VÊTEMENT;68;68;60;6;2;0;2;60;0;7;21;13;19;8
19010.0;2023;07;DIJON;FEMININ;SCOLAIRE;BAC PROFESSIONNEL;BAC PRO PROD;BAC PRO 24302 METIERS DU CUIR : MAROQUINERIE;12;12;10;2;0;0;0;10;0;1;3;0;6;2
19011.0;2023;07;DIJON;FEMININ;SCOLAIRE;BAC PROFESSIONNEL;BAC PRO PROD;BAC PRO 25007 MAINTENANCE EQUIPEMENTS INDUST.;5;5;4;1;0;0;0;4;0;1;1;1;1;1
19013.0;2023;07;DIJON;FEMININ;SCOLAIRE;BAC PROFESSIONNEL;BAC PRO PROD;BAC PRO 25214 MAINT.VEHIC.OPTA VOIT.PARTICUL.;4;4;3;1;0;0;0;3;0;0;1;1;1;1
19014.0;2023;07;DIJON;FEMININ;SCOLAIRE;BAC PROFESSIONNEL;BAC PRO PROD;BAC PRO 25215 MAINT.VEHIC.OPTB VEHIC.TRANS.ROUT;1;1;1;0;0;0;0;1;0;0;1;0;0;0
19017.0;2023;07;DIJON;FEMININ;SCOLAIRE;BAC PROFESSIONNEL;BAC PRO PROD;BAC PRO 25411 TECH.CHAUDRONNERIE INDUSTRIELLE;2;2;2;0;0;0;0;2;0;1;0;0;1;0
19018.0;2023;07;DIJON;FEMININ;SCOLAIRE;BAC PROFESSIONNEL;BAC PRO PROD;BAC PRO 25510 METIERS ELECT. ENVIRON. CONNECTES;3;3;3;0;0;0;0;3;0;0;1;1;1;0
19020.0;2023;07;DIJON;FEMININ;SCOLAIRE;BAC PROFESSIONNEL;BAC PRO PROD;BAC PRO 25514 SYST.NUM.OPT.B AUD.RES.EQUIP.DOM.;1;1;1;0;0;0;0;1;0;0;1;0;0;0
19024.0;2023;07;DIJON;FEMININ;SCOLAIRE;BAC PROFESSIONNEL;BAC PRO PROD;BAC PRO AG 21114 CONDUITE PRODUCTIONS HORTICOLES;7;7;7;0;0;0;0;7;0;0;1;2;4;0
19033.0;2023;07;DIJON;FEMININ;SCOLAIRE;BAC PROFESSIONNEL;BAC PRO SERV;BAC PRO 31212 METIERS DE L'ACCUEIL;113;113;91;7;15;9;6;100;0;4;23;42;31;13
19035.0;2023;07;DIJON;FEMININ;SCOLAIRE;BAC PROFESSIONNEL;BAC PRO SERV;BAC PRO 31214 MET.COM.VEN.OP.B PR.CL.VA.OF.COM.;56;56;48;6;2;2;0;50;0;4;15;18;13;6
19037.0;2023;07;DIJON;FEMININ;SCOLAIRE;BAC PROFESSIONNEL;BAC PRO SERV;BAC PRO 33003 ACC.SOINS-S.PERS. OPT.A DOMICILE;103;103;87;15;1;0;1;87;0;7;14;35;31;16
19041.0;2023;07;DIJON;FEMININ;SCOLAIRE;BAC PROFESSIONNEL;BAC PRO SERV;BAC PRO 33103 TECHNICIEN APPAREIL. ORTHOPEDIQUE;8;8;6;2;0;0;0;6;0;0;0;4;2;2
19044.0;2023;07;DIJON;FEMININ;SCOLAIRE;BAC PROFESSIONNEL;BAC PRO SERV;BAC PRO 33603 ESTHETIQUE COSMETIQUE PARFUMERIE;61;60;53;7;0;0;0;53;0;1;12;18;22;7
19050.0;2023;07;DIJON;FEMININ;SCOLAIRE;BAC TECHNOLOGIQUE;BAC S2TMD;BAC S2TMD DANSE;10;10;10;0;0;0;0;10;0;3;6;1;0;0
19058.0;2023;07;DIJON;FEMININ;SCOLAIRE;BAC TECHNOLOGIQUE;BAC STI2D;BAC STI2D INNOVATION TECHNO.  ET ECO CONCEPTION;15;15;15;0;0;0;0;15;0;2;6;4;3;0
19070.0;2023;07;DIJON;MASCULIN;APPRENTISSAGE;BAC PROFESSIONNEL;BAC PRO PROD;BAC PRO 23004 TECHN. ETUDES BAT.A ETUDES & ECO.;3;3;3;0;0;0;0;3;0;0;0;2;1;0
19074.0;2023;07;DIJON;MASCULIN;APPRENTISSAGE;BAC PROFESSIONNEL;BAC PRO PROD;BAC PRO 23304 AMENAGEMENT FINITION BATIMENT;7;7;5;1;1;0;1;5;0;0;0;5;0;2
19083.0;2023;07;DIJON;MASCULIN;APPRENTISSAGE;BAC PROFESSIONNEL;BAC PRO PROD;BAC PRO 25216 MAINT.VEHIC.OPTC MOTOCYCLES;14;14;13;0;1;1;0;14;0;3;3;5;3;0
19085.0;2023;07;DIJON;MASCULIN;APPRENTISSAGE;BAC PROFESSIONNEL;BAC PRO PROD;BAC PRO 25408 REPARATION DES CARROSSERIES;11;11;9;2;0;0;0;9;0;3;1;3;2;2
19087.0;2023;07;DIJON;MASCULIN;APPRENTISSAGE;BAC PROFESSIONNEL;BAC PRO PROD;BAC PRO 25509 TECHNIC. FROID CONDITIONNEMT AIR;1;1;0;1;0;0;0;0;0;0;0;0;0;1
19088.0;2023;07;DIJON;MASCULIN;APPRENTISSAGE;BAC PROFESSIONNEL;BAC PRO PROD;BAC PRO 25510 METIERS ELECT. ENVIRON. CONNECTES;41;41;37;2;2;1;1;38;0;0;14;14;10;3
19091.0;2023;07;DIJON;MASCULIN;APPRENTISSAGE;BAC PROFESSIONNEL;BAC PRO PROD;BAC PRO AG 21001 AGRO-EQUIPEMENT;7;7;5;2;0;0;0;5;0;0;0;1;4;2
19093.0;2023;07;DIJON;MASCULIN;APPRENTISSAGE;BAC PROFESSIONNEL;BAC PRO PROD;BAC PRO AG 21113 CGEVV;26;26;23;3;0;0;0;23;0;0;2;9;12;3
19098.0;2023;07;DIJON;MASCULIN;APPRENTISSAGE;BAC PROFESSIONNEL;BAC PRO SERV;BAC PRO 31106 LOGISTIQUE;20;19;13;2;4;3;1;16;0;0;4;3;9;3
19107.0;2023;07;DIJON;MASCULIN;ENSEIGNEMENT A DISTANCE;BAC TECHNOLOGIQUE;BAC STMG;BAC STMG MERCATIQUE (MARKETING);3;3;3;0;0;0;0;3;0;0;0;1;2;0
19114.0;2023;07;DIJON;MASCULIN;INDIVIDUEL;BAC GENERAL;BAC GENERAL;BAC GENE 10019 BAC GENERAL;44;44;10;25;9;8;1;18;0;0;0;2;16;26
19117.0;2023;07;DIJON;MASCULIN;INDIVIDUEL;BAC PROFESSIONNEL;BAC PRO PROD;BAC PRO 25106 TECHNICIEN D'USINAGE;1;1;0;1;0;0;0;0;0;0;0;0;0;1
19118.0;2023;07;DIJON;MASCULIN;INDIVIDUEL;BAC PROFESSIONNEL;BAC PRO PROD;BAC PRO 25510 METIERS ELECT. ENVIRON. CONNECTES;2;1;0;1;0;0;0;0;0;0;0;0;0;1
19120.0;2023;07;DIJON;MASCULIN;INDIVIDUEL;BAC PROFESSIONNEL;BAC PRO PROD;BAC PRO 25514 SYST.NUM.OPT.B AUD.RES.EQUIP.DOM.;1;1;1;0;0;0;0;1;0;0;0;1;0;0
19121.0;2023;07;DIJON;MASCULIN;INDIVIDUEL;BAC PROFESSIONNEL;BAC PRO PROD;BAC PRO AG 21004 CGEA;3;3;3;0;0;0;0;3;0;0;0;0;3;0
19134.0;2023;07;DIJON;MASCULIN;SCOLAIRE;BAC PROFESSIONNEL;BAC PRO PROD;BACPRO 20002 ETUD.DEFINITION PRDTS INDUSTRIEL;15;15;13;2;0;0;0;13;0;1;1;5;6;2
19137.0;2023;07;DIJON;MASCULIN;SCOLAIRE;BAC PROFESSIONNEL;BAC PRO PROD;BAC PRO 22004 PROC. CHIMIE EAU PAPIERS-CARTONS;8;8;7;1;0;0;0;7;0;0;2;4;1;1
19139.0;2023;07;DIJON;MASCULIN;SCOLAIRE;BAC PROFESSIONNEL;BAC PRO PROD;BAC PRO 22106 CUISINE;68;68;56;8;4;2;2;58;0;1;12;22;23;10
19144.0;2023;07;DIJON;MASCULIN;SCOLAIRE;BAC PROFESSIONNEL;BAC PRO PROD;BAC PRO 23005 TECHN. ETUDES BAT B ASSIST.ARCHI.;6;6;4;2;0;0;0;4;0;0;1;1;2;2
19146.0;2023;07;DIJON;MASCULIN;SCOLAIRE;BAC PROFESSIONNEL;BAC PRO PROD;BACPRO 23103 TECHNICIEN GEOMETRE-TOPOGRAPHE;6;6;5;1;0;0;0;5;0;0;1;3;1;1
19148.0;2023;07;DIJON;MASCULIN;SCOLAIRE;BAC PROFESSIONNEL;BAC PRO PROD;BAC PRO 23208 METIERS ET ARTS DE LA PIERRE;1;1;0;1;0;0;0;0;0;0;0;0;0;1
19149.0;2023;07;DIJON;MASCULIN;SCOLAIRE;BAC PROFESSIONNEL;BAC PRO PROD;BAC PRO 23304 AMENAGEMENT FINITION BATIMENT;12;12;10;1;1;0;1;10;0;1;2;4;3;2
19152.0;2023;07;DIJON;MASCULIN;SCOLAIRE;BAC PROFESSIONNEL;BAC PRO PROD;BAC PRO 23408 Etude et réalisation d'agencement;3;3;3;0;0;0;0;3;0;0;0;2;1;0
19155.0;2023;07;DIJON;MASCULIN;SCOLAIRE;BAC PROFESSIONNEL;BAC PRO PROD;BAC PRO 24302 METIERS DU CUIR : MAROQUINERIE;1;1;1;0;0;0;0;1;0;0;1;0;0;0
19157.0;2023;07;DIJON;MASCULIN;SCOLAIRE;BAC PROFESSIONNEL;BAC PRO PROD;BAC PRO 25106 TECHNICIEN D'USINAGE;37;37;28;7;2;0;2;28;0;0;4;8;16;9
19159.0;2023;07;DIJON;MASCULIN;SCOLAIRE;BAC PROFESSIONNEL;BAC PRO PROD;BAC PRO 25108 TECHNICIEN MODELEUR;5;5;3;1;1;1;0;4;0;0;1;0;3;1
19160.0;2023;07;DIJON;MASCULIN;SCOLAIRE;BAC PROFESSIONNEL;BAC PRO PROD;BAC PRO 25214 MAINT.VEHIC.OPTA VOIT.PARTICUL.;118;116;95;16;5;3;2;98;0;10;26;31;31;18
19161.0;2023;07;DIJON;MASCULIN;SCOLAIRE;BAC PROFESSIONNEL;BAC PRO PROD;BAC PRO 25215 MAINT.VEHIC.OPTB VEHIC.TRANS.ROUT;8;8;8;0;0;0;0;8;0;1;1;4;2;0
19163.0;2023;07;DIJON;MASCULIN;SCOLAIRE;BAC PROFESSIONNEL;BAC PRO PROD;BAC PRO 25220 MAINT.MATERIELS OPT.B TP MANUT.;5;5;5;0;0;0;0;5;0;1;2;1;1;0
19168.0;2023;07;DIJON;MASCULIN;SCOLAIRE;BAC PROFESSIONNEL;BAC PRO PROD;BAC PRO 25408 REPARATION DES CARROSSERIES;12;12;11;1;0;0;0;11;0;1;2;5;3;1
19176.0;2023;07;DIJON;MASCULIN;SCOLAIRE;BAC PROFESSIONNEL;BAC PRO PROD;BAC PRO AG 21004 CGEA;53;53;46;7;0;0;0;46;0;1;6;21;18;7
19179.0;2023;07;DIJON;MASCULIN;SCOLAIRE;BAC PROFESSIONNEL;BAC PRO PROD;BAC PRO AG 21203 TECHN CONSEIL DE VENTE ANIMAL;12;11;6;5;0;0;0;6;0;0;0;3;3;5
19189.0;2023;07;DIJON;MASCULIN;SCOLAIRE;BAC PROFESSIONNEL;BAC PRO SERV;BAC PRO 31107 CONDUCT. TRANSP.ROUT.MARCHANDISES;31;31;30;0;1;1;0;31;0;2;10;11;8;0
19194.0;2023;07;DIJON;MASCULIN;SCOLAIRE;BAC PROFESSIONNEL;BAC PRO SERV;BAC PRO 32207 REAL.PR.IMPR.PLURI.OPTA.PR.GRAPH.;2;2;2;0;0;0;0;2;0;0;2;0;0;0
19198.0;2023;07;DIJON;MASCULIN;SCOLAIRE;BAC PROFESSIONNEL;BAC PRO SERV;BAC PRO 33004 ACC.SOINS-S.PERS. OPT.EN STRUCTUR;22;22;18;3;1;0;1;18;0;1;4;8;5;4
19200.0;2023;07;DIJON;MASCULIN;SCOLAIRE;BAC PROFESSIONNEL;BAC PRO SERV;BAC PRO 33101 OPTIQUE LUNETTERIE;5;5;5;0;0;0;0;5;0;0;1;1;3;0
19201.0;2023;07;DIJON;MASCULIN;SCOLAIRE;BAC PROFESSIONNEL;BAC PRO SERV;BAC PRO 33103 TECHNICIEN APPAREIL. ORTHOPEDIQUE;7;7;4;3;0;0;0;4;0;0;0;1;3;3
19215.0;2023;07;DIJON;MASCULIN;SCOLAIRE;BAC TECHNOLOGIQUE;BAC STHR;BAC STHR SC.&TEC. HOTELLERIE-RESTAURATION;20;20;19;1;0;0;0;19;0;2;5;9;3;1
19223.0;2023;07;DIJON;MASCULIN;SCOLAIRE;BAC TECHNOLOGIQUE;BAC STMG;BAC STMG MERCATIQUE (MARKETING);363;363;255;19;89;60;29;315;0;0;15;82;218;48
19231.0;2023;08;GRENOBLE;FEMININ;APPRENTISSAGE;BAC PROFESSIONNEL;BAC PRO PROD;BAC PRO 22704 TECHN. MAINT. SYST.ENERG.CLIMATI;1;1;1;0;0;0;0;1;0;0;1;0;0;0
19234.0;2023;08;GRENOBLE;FEMININ;APPRENTISSAGE;BAC PROFESSIONNEL;BAC PRO PROD;BAC PRO 23304 AMENAGEMENT FINITION BATIMENT;3;3;1;2;0;0;0;1;0;0;1;0;0;2
19239.0;2023;08;GRENOBLE;FEMININ;APPRENTISSAGE;BAC PROFESSIONNEL;BAC PRO PROD;BAC PRO 25106 TECHNICIEN D'USINAGE;4;4;4;0;0;0;0;4;0;1;1;1;1;0
19249.0;2023;08;GRENOBLE;FEMININ;APPRENTISSAGE;BAC PROFESSIONNEL;BAC PRO PROD;BAC PRO AG 21303 FORET;2;2;2;0;0;0;0;2;0;1;1;0;0;0
19250.0;2023;08;GRENOBLE;FEMININ;APPRENTISSAGE;BAC PROFESSIONNEL;BAC PRO PROD;BAC PRO AG 21405 AMENAGEMENTS PAYSAGERS;5;5;5;0;0;0;0;5;0;0;2;2;1;0
19258.0;2023;08;GRENOBLE;FEMININ;APPRENTISSAGE;BAC PROFESSIONNEL;BAC PRO SERV;BAC PRO 33003 ACC.SOINS-S.PERS. OPT.A DOMICILE;2;2;2;0;0;0;0;2;0;0;0;1;1;0
19259.0;2023;08;GRENOBLE;FEMININ;APPRENTISSAGE;BAC PROFESSIONNEL;BAC PRO SERV;BAC PRO 33004 ACC.SOINS-S.PERS. OPT.EN STRUCTUR;3;3;2;1;0;0;0;2;0;0;1;0;1;1
19262.0;2023;08;GRENOBLE;FEMININ;APPRENTISSAGE;BAC PROFESSIONNEL;BAC PRO SERV;BAC PRO AG 33002 SERV PERS TERRIT;32;30;29;1;0;0;0;29;0;0;3;7;19;1
19278.0;2023;08;GRENOBLE;FEMININ;INDIVIDUEL;BAC PROFESSIONNEL;BAC PRO SERV;BAC PRO 31106 LOGISTIQUE;1;0;0;0;0;0;0;0;0;0;0;0;0;0
19290.0;2023;08;GRENOBLE;FEMININ;INDIVIDUEL;BAC TECHNOLOGIQUE;BAC STHR;BAC STHR SC.&TEC. HOTELLERIE-RESTAURATION;1;1;1;0;0;0;0;1;0;0;0;0;1;0
19293.0;2023;08;GRENOBLE;FEMININ;INDIVIDUEL;BAC TECHNOLOGIQUE;BAC STL;BAC STL BIOCHIM.-BIOLOGIE-BIOTECHNOL.;1;1;0;1;0;0;0;0;0;0;0;0;0;1
19298.0;2023;08;GRENOBLE;FEMININ;SCOLAIRE;BAC PROFESSIONNEL;BAC PRO PROD;BAC PRO 20102 PILOTE DE LIGNE DE PRODUCTION;4;4;4;0;0;0;0;4;0;0;3;1;0;0
19302.0;2023;08;GRENOBLE;FEMININ;SCOLAIRE;BAC PROFESSIONNEL;BAC PRO PROD;BAC PRO 22106 CUISINE;60;60;57;0;3;2;1;59;0;7;20;20;12;1
19317.0;2023;08;GRENOBLE;FEMININ;SCOLAIRE;BAC PROFESSIONNEL;BAC PRO PROD;BAC PRO 25005 PRODUCTIQ.MECA. OPT.DECOLLETAGE;1;1;1;0;0;0;0;1;0;0;0;1;0;0
19321.0;2023;08;GRENOBLE;FEMININ;SCOLAIRE;BAC PROFESSIONNEL;BAC PRO PROD;BAC PRO 25214 MAINT.VEHIC.OPTA VOIT.PARTICUL.;5;5;5;0;0;0;0;5;0;0;2;1;2;0
19323.0;2023;08;GRENOBLE;FEMININ;SCOLAIRE;BAC PROFESSIONNEL;BAC PRO PROD;BAC PRO 25510 METIERS ELECT. ENVIRON. CONNECTES;6;6;5;1;0;0;0;5;0;0;2;2;1;1
19327.0;2023;08;GRENOBLE;FEMININ;SCOLAIRE;BAC PROFESSIONNEL;BAC PRO PROD;BAC PRO AG 21114 CONDUITE PRODUCTIONS HORTICOLES;23;22;16;6;0;0;0;16;0;0;0;10;6;6
19336.0;2023;08;GRENOBLE;FEMININ;SCOLAIRE;BAC PROFESSIONNEL;BAC PRO PROD;BAC PRO AG 22108 TEC CONS VTE ALIMENTATION (PAB);43;43;40;3;0;0;0;40;0;0;2;12;26;3
19338.0;2023;08;GRENOBLE;FEMININ;SCOLAIRE;BAC PROFESSIONNEL;BAC PRO SERV;BAC PRO 31106 LOGISTIQUE;15;15;10;4;1;1;0;11;0;2;0;4;5;4
19339.0;2023;08;GRENOBLE;FEMININ;SCOLAIRE;BAC PROFESSIONNEL;BAC PRO SERV;BAC PRO 31107 CONDUCT. TRANSP.ROUT.MARCHANDISES;3;3;3;0;0;0;0;3;0;1;0;2;0;0
19349.0;2023;08;GRENOBLE;FEMININ;SCOLAIRE;BAC PROFESSIONNEL;BAC PRO SERV;BAC PRO 33004 ACC.SOINS-S.PERS. OPT.EN STRUCTUR;506;506;449;47;10;9;1;458;0;18;108;198;134;48
19358.0;2023;08;GRENOBLE;FEMININ;SCOLAIRE;BAC TECHNOLOGIQUE;BAC S2TMD;BAC S2TMD DANSE;4;4;4;0;0;0;0;4;0;1;1;2;0;0
19363.0;2023;08;GRENOBLE;FEMININ;SCOLAIRE;BAC TECHNOLOGIQUE;BAC STHR;BAC STHR SC.&TEC. HOTELLERIE-RESTAURATION;65;65;65;0;0;0;0;65;1;9;18;20;17;0
19369.0;2023;08;GRENOBLE;FEMININ;SCOLAIRE;BAC TECHNOLOGIQUE;BAC STL;BAC STL SCIENCES PHYSIQUES CHIMIQUES  EN LABORAT.;52;52;50;0;2;0;2;50;0;8;5;24;13;2
19371.0;2023;08;GRENOBLE;FEMININ;SCOLAIRE;BAC TECHNOLOGIQUE;BAC STMG;BAC STMG MERCATIQUE (MARKETING);1248;1248;957;54;237;179;58;1136;0;10;114;340;672;112
19378.0;2023;08;GRENOBLE;MASCULIN;APPRENTISSAGE;BAC PROFESSIONNEL;BAC PRO PROD;BAC PRO 22106 CUISINE;14;14;11;2;1;1;0;12;0;1;0;6;5;2
19380.0;2023;08;GRENOBLE;MASCULIN;APPRENTISSAGE;BAC PROFESSIONNEL;BAC PRO PROD;BAC PRO 22704 TECHN. MAINT. SYST.ENERG.CLIMATI;19;19;17;2;0;0;0;17;0;1;4;7;5;2
19384.0;2023;08;GRENOBLE;MASCULIN;APPRENTISSAGE;BAC PROFESSIONNEL;BAC PRO PROD;BAC PRO 23205 INTERV. SUR PATRIMOINE BATI OPT.A;1;1;1;0;0;0;0;1;0;0;0;1;0;0
19387.0;2023;08;GRENOBLE;MASCULIN;APPRENTISSAGE;BAC PROFESSIONNEL;BAC PRO PROD;BAC PRO 23404 TECHNICIEN CONSTRUCTEUR BOIS;34;34;32;2;0;0;0;32;0;2;7;13;10;2
19388.0;2023;08;GRENOBLE;MASCULIN;APPRENTISSAGE;BAC PROFESSIONNEL;BAC PRO PROD;BAC PRO 23405 TECHNICIEN MENUISIER AGENCEUR;38;38;37;0;1;1;0;38;0;3;5;15;15;0
19397.0;2023;08;GRENOBLE;MASCULIN;APPRENTISSAGE;BAC PROFESSIONNEL;BAC PRO PROD;BAC PRO 25216 MAINT.VEHIC.OPTC MOTOCYCLES;22;22;22;0;0;0;0;22;0;4;5;10;3;0
19399.0;2023;08;GRENOBLE;MASCULIN;APPRENTISSAGE;BAC PROFESSIONNEL;BAC PRO PROD;BAC PRO 25220 MAINT.MATERIELS OPT.B TP MANUT.;37;37;33;3;1;1;0;34;0;2;12;8;12;3
19402.0;2023;08;GRENOBLE;MASCULIN;APPRENTISSAGE;BAC PROFESSIONNEL;BAC PRO PROD;BAC PRO 25303 AERONAUTIQUE OPTION SYSTEMES;25;25;20;2;3;0;3;20;0;3;7;6;4;5
19405.0;2023;08;GRENOBLE;MASCULIN;APPRENTISSAGE;BAC PROFESSIONNEL;BAC PRO PROD;BAC PRO 25411 TECH.CHAUDRONNERIE INDUSTRIELLE;70;70;68;0;2;1;1;69;0;5;15;30;19;1
19414.0;2023;08;GRENOBLE;MASCULIN;APPRENTISSAGE;BAC PROFESSIONNEL;BAC PRO PROD;BAC PRO AG 21303 FORET;10;10;10;0;0;0;0;10;0;0;0;2;8;0
19416.0;2023;08;GRENOBLE;MASCULIN;APPRENTISSAGE;BAC PROFESSIONNEL;BAC PRO PROD;BAC PRO AG 22108 TEC CONS VTE ALIMENTATION (PAB);18;18;18;0;0;0;0;18;0;0;1;9;8;0
19423.0;2023;08;GRENOBLE;MASCULIN;APPRENTISSAGE;BAC PROFESSIONNEL;BAC PRO SERV;BAC PRO 33403 COMMERC. SERVICES EN RESTAURATION;12;12;9;3;0;0;0;9;0;0;2;4;3;3
19429.0;2023;08;GRENOBLE;MASCULIN;ENSEIGNEMENT A DISTANCE;BAC PROFESSIONNEL;BAC PRO SERV;BAC PRO 31213 MET.COM.VEN.OP.A ANI.GES.ESP.COM.;3;3;2;1;0;0;0;2;0;0;0;2;0;1
19430.0;2023;08;GRENOBLE;MASCULIN;ENSEIGNEMENT A DISTANCE;BAC PROFESSIONNEL;BAC PRO SERV;BAC PRO 31214 MET.COM.VEN.OP.B PR.CL.VA.OF.COM.;6;4;3;0;1;1;0;4;0;0;0;2;2;0
19441.0;2023;08;GRENOBLE;MASCULIN;INDIVIDUEL;BAC GENERAL;BAC GENERAL;BAC GENE 10019 BAC GENERAL;89;89;32;45;12;9;3;41;0;0;6;8;27;48
19445.0;2023;08;GRENOBLE;MASCULIN;INDIVIDUEL;BAC PROFESSIONNEL;BAC PRO PROD;BAC PRO 23004 TECHN. ETUDES BAT.A ETUDES & ECO.;1;1;0;1;0;0;0;0;0;0;0;0;0;1
19447.0;2023;08;GRENOBLE;MASCULIN;INDIVIDUEL;BAC PROFESSIONNEL;BAC PRO PROD;BAC PRO 23203 TECHNICIEN BAT. : ORG.REAL.GROS O;1;1;0;1;0;0;0;0;0;0;0;0;0;1
19461.0;2023;08;GRENOBLE;MASCULIN;INDIVIDUEL;BAC PROFESSIONNEL;BAC PRO SERV;BAC PRO 30004 ASSISTANC.GEST.ORGANIS.ACTIVITES;2;1;0;1;0;0;0;0;0;0;0;0;0;1
19465.0;2023;08;GRENOBLE;MASCULIN;INDIVIDUEL;BAC PROFESSIONNEL;BAC PRO SERV;BAC PRO 31214 MET.COM.VEN.OP.B PR.CL.VA.OF.COM.;2;2;2;0;0;0;0;2;0;0;0;1;1;0
19469.0;2023;08;GRENOBLE;MASCULIN;INDIVIDUEL;BAC TECHNOLOGIQUE;BAC ST2S;BAC ST2S SCIENCES & TECHNO. SANTE & SOCIAL;2;2;0;1;1;1;0;1;0;0;0;0;1;1
19470.0;2023;08;GRENOBLE;MASCULIN;INDIVIDUEL;BAC TECHNOLOGIQUE;BAC STI2D;BAC STI2D ARCHITECTURE ET CONSTRUCTION;1;1;0;1;0;0;0;0;0;0;0;0;0;1
19473.0;2023;08;GRENOBLE;MASCULIN;INDIVIDUEL;BAC TECHNOLOGIQUE;BAC STL;BAC STL BIOCHIM.-BIOLOGIE-BIOTECHNOL.;1;1;0;1;0;0;0;0;0;0;0;0;0;1
19475.0;2023;08;GRENOBLE;MASCULIN;INDIVIDUEL;BAC TECHNOLOGIQUE;BAC STMG;BAC STMG MERCATIQUE (MARKETING);19;19;1;16;2;1;1;2;0;0;0;0;2;17
19476.0;2023;08;GRENOBLE;MASCULIN;INDIVIDUEL;BAC TECHNOLOGIQUE;BAC STMG;BAC STMG RESSOURCES HUMAINES ET COMMUNICATION;4;4;1;3;0;0;0;1;0;0;0;0;1;3
19480.0;2023;08;GRENOBLE;MASCULIN;SCOLAIRE;BAC PROFESSIONNEL;BAC PRO PROD;BAC PRO 22003 BIO-INDUSTRIES DE TRANSFORMATION;6;6;6;0;0;0;0;6;0;0;4;2;0;0
19481.0;2023;08;GRENOBLE;MASCULIN;SCOLAIRE;BAC PROFESSIONNEL;BAC PRO PROD;BAC PRO 22004 PROC. CHIMIE EAU PAPIERS-CARTONS;37;37;27;7;3;3;0;30;0;4;3;13;10;7
19491.0;2023;08;GRENOBLE;MASCULIN;SCOLAIRE;BAC PROFESSIONNEL;BAC PRO PROD;BAC PRO 23203 TECHNICIEN BAT. : ORG.REAL.GROS O;37;37;27;2;8;2;6;29;0;1;7;12;9;8
19500.0;2023;08;GRENOBLE;MASCULIN;SCOLAIRE;BAC PROFESSIONNEL;BAC PRO PROD;BAC PRO 24302 METIERS DU CUIR : MAROQUINERIE;2;2;1;1;0;0;0;1;0;0;0;0;1;1
19502.0;2023;08;GRENOBLE;MASCULIN;SCOLAIRE;BAC PROFESSIONNEL;BAC PRO PROD;BAC PRO 25006 MICROTECHNIQUES;55;55;49;6;0;0;0;49;0;5;9;17;18;6
19513.0;2023;08;GRENOBLE;MASCULIN;SCOLAIRE;BAC PROFESSIONNEL;BAC PRO PROD;BAC PRO 25509 TECHNIC. FROID CONDITIONNEMT AIR;23;23;22;1;0;0;0;22;0;0;4;9;9;1
19516.0;2023;08;GRENOBLE;MASCULIN;SCOLAIRE;BAC PROFESSIONNEL;BAC PRO PROD;BAC PRO 25514 SYST.NUM.OPT.B AUD.RES.EQUIP.DOM.;112;112;100;8;4;3;1;103;0;6;26;38;33;9
19533.0;2023;08;GRENOBLE;MASCULIN;SCOLAIRE;BAC PROFESSIONNEL;BAC PRO SERV;BAC PRO 31107 CONDUCT. TRANSP.ROUT.MARCHANDISES;40;40;35;3;2;2;0;37;0;2;11;18;6;3
19538.0;2023;08;GRENOBLE;MASCULIN;SCOLAIRE;BAC PROFESSIONNEL;BAC PRO SERV;BAC PRO 31214 MET.COM.VEN.OP.B PR.CL.VA.OF.COM.;297;297;257;21;19;15;4;272;0;5;53;104;110;25
19549.0;2023;08;GRENOBLE;MASCULIN;SCOLAIRE;BAC PROFESSIONNEL;BAC PRO SERV;BAC PRO 34403 METIERS DE LA SECURITE;62;62;60;1;1;0;1;60;0;2;19;28;11;2
19560.0;2023;08;GRENOBLE;MASCULIN;SCOLAIRE;BAC TECHNOLOGIQUE;BAC STI2D;BAC STI2D SYSTÈME D'INFORMATION  ET NUMERIQUE;569;569;510;21;38;24;14;534;3;28;130;197;176;35
19566.0;2023;08;GRENOBLE;MASCULIN;SCOLAIRE;BAC TECHNOLOGIQUE;BAC STMG;BAC STMG SYSTEMES D'INFORMATION DE GESTION;112;112;65;9;38;29;9;94;0;0;5;19;70;18
19569.0;2023;32;GUADELOUPE;FEMININ;APPRENTISSAGE;BAC PROFESSIONNEL;BAC PRO SERV;BAC PRO 31214 MET.COM.VEN.OP.B PR.CL.VA.OF.COM.;5;4;3;0;1;1;0;4;0;0;2;0;2;0
19573.0;2023;32;GUADELOUPE;FEMININ;APPRENTISSAGE;BAC PROFESSIONNEL;BAC PRO SERV;BAC PRO AG 33002 SERV PERS TERRIT;6;6;6;0;0;0;0;6;0;0;1;2;3;0
19578.0;2023;32;GUADELOUPE;FEMININ;ENSEIGNEMENT A DISTANCE;BAC TECHNOLOGIQUE;BAC ST2S;BAC ST2S SCIENCES & TECHNO. SANTE & SOCIAL;1;1;0;0;1;1;0;1;0;0;0;0;1;0
19580.0;2023;32;GUADELOUPE;FEMININ;ENSEIGNEMENT A DISTANCE;BAC TECHNOLOGIQUE;BAC STMG;BAC STMG RESSOURCES HUMAINES ET COMMUNICATION;3;3;2;0;1;1;0;3;0;0;1;0;2;0
19584.0;2023;32;GUADELOUPE;FEMININ;FORMATION CONTINUE;BAC PROFESSIONNEL;BAC PRO SERV;BAC PRO 33603 ESTHETIQUE COSMETIQUE PARFUMERIE;1;1;0;1;0;0;0;0;0;0;0;0;0;1
19591.0;2023;32;GUADELOUPE;FEMININ;INDIVIDUEL;BAC PROFESSIONNEL;BAC PRO SERV;BAC PRO 33002 SERVICES DE PROXIMITE  VIE LOCAL;1;1;1;0;0;0;0;1;0;0;0;0;1;0
19602.0;2023;32;GUADELOUPE;FEMININ;SCOLAIRE;BAC GENERAL;BAC GENERAL;BAC GENE 10019 BAC GENERAL;1700;1700;1435;58;207;160;47;1595;16;166;354;455;604;105
19604.0;2023;32;GUADELOUPE;FEMININ;SCOLAIRE;BAC PROFESSIONNEL;BAC PRO PROD;BAC PRO 22105 BOULANGER-PÂTISSIER;6;6;5;1;0;0;0;5;0;1;1;3;0;1
19611.0;2023;32;GUADELOUPE;FEMININ;SCOLAIRE;BAC PROFESSIONNEL;BAC PRO PROD;BAC PRO 23404 TECHNICIEN CONSTRUCTEUR BOIS;1;1;1;0;0;0;0;1;0;0;0;0;1;0
19614.0;2023;32;GUADELOUPE;FEMININ;SCOLAIRE;BAC PROFESSIONNEL;BAC PRO PROD;BAC PRO 25007 MAINTENANCE EQUIPEMENTS INDUST.;4;4;3;1;0;0;0;3;0;0;0;1;2;1
19618.0;2023;32;GUADELOUPE;FEMININ;SCOLAIRE;BAC PROFESSIONNEL;BAC PRO PROD;BAC PRO 25216 MAINT.VEHIC.OPTC MOTOCYCLES;1;1;0;1;0;0;0;0;0;0;0;0;0;1
19619.0;2023;32;GUADELOUPE;FEMININ;SCOLAIRE;BAC PROFESSIONNEL;BAC PRO PROD;BAC PRO 25406 OUVRAGES DU BATIMENT METALLERIE;4;4;4;0;0;0;0;4;0;0;0;1;3;0
19622.0;2023;32;GUADELOUPE;FEMININ;SCOLAIRE;BAC PROFESSIONNEL;BAC PRO PROD;BAC PRO 25514 SYST.NUM.OPT.B AUD.RES.EQUIP.DOM.;1;1;1;0;0;0;0;1;0;0;0;1;0;0
19625.0;2023;32;GUADELOUPE;FEMININ;SCOLAIRE;BAC PROFESSIONNEL;BAC PRO PROD;BAC PRO AG 21114 CONDUITE PRODUCTIONS HORTICOLES;6;6;3;3;0;0;0;3;0;0;0;1;2;3
19626.0;2023;32;GUADELOUPE;FEMININ;SCOLAIRE;BAC PROFESSIONNEL;BAC PRO PROD;BAC PRO AG 21405 AMENAGEMENTS PAYSAGERS;2;2;2;0;0;0;0;2;0;0;0;1;1;0
19627.0;2023;32;GUADELOUPE;FEMININ;SCOLAIRE;BAC PROFESSIONNEL;BAC PRO PROD;BAC PRO AG 22108 TEC CONS VTE ALIMENTATION (PAB);6;6;6;0;0;0;0;6;0;0;1;0;5;0
19630.0;2023;32;GUADELOUPE;FEMININ;SCOLAIRE;BAC PROFESSIONNEL;BAC PRO SERV;BAC PRO 31114 ORGANIS. TRANSPORT MARCHANDISES;10;10;10;0;0;0;0;10;0;1;0;3;6;0
19631.0;2023;32;GUADELOUPE;FEMININ;SCOLAIRE;BAC PROFESSIONNEL;BAC PRO SERV;BAC PRO 31212 METIERS DE L'ACCUEIL;74;74;59;8;7;6;1;65;0;1;12;26;26;9
19647.0;2023;32;GUADELOUPE;FEMININ;SCOLAIRE;BAC TECHNOLOGIQUE;BAC ST2S;BAC ST2S SCIENCES & TECHNO. SANTE & SOCIAL;239;239;203;2;34;31;3;234;0;5;41;64;124;5
19662.0;2023;32;GUADELOUPE;MASCULIN;APPRENTISSAGE;BAC PROFESSIONNEL;BAC PRO PROD;BAC PRO 25009 MAINTENANCE NAUTIQUE;1;1;1;0;0;0;0;1;0;1;0;0;0;0
19668.0;2023;32;GUADELOUPE;MASCULIN;APPRENTISSAGE;BAC PROFESSIONNEL;BAC PRO SERV;BAC PRO 33603 ESTHETIQUE COSMETIQUE PARFUMERIE;2;1;0;1;0;0;0;0;0;0;0;0;0;1
19675.0;2023;32;GUADELOUPE;MASCULIN;INDIVIDUEL;BAC GENERAL;BAC GENERAL;BAC GENE 10019 BAC GENERAL;17;17;12;4;1;1;0;13;0;6;1;2;4;4
19676.0;2023;32;GUADELOUPE;MASCULIN;INDIVIDUEL;BAC PROFESSIONNEL;BAC PRO PROD;BAC PRO 25215 MAINT.VEHIC.OPTB VEHIC.TRANS.ROUT;1;1;0;1;0;0;0;0;0;0;0;0;0;1
19681.0;2023;32;GUADELOUPE;MASCULIN;INDIVIDUEL;BAC PROFESSIONNEL;BAC PRO SERV;BAC PRO 30004 ASSISTANC.GEST.ORGANIS.ACTIVITES;1;1;1;0;0;0;0;1;0;0;0;0;1;0
19682.0;2023;32;GUADELOUPE;MASCULIN;INDIVIDUEL;BAC PROFESSIONNEL;BAC PRO SERV;BAC PRO 31114 ORGANIS. TRANSPORT MARCHANDISES;1;1;1;0;0;0;0;1;0;0;0;1;0;0
19686.0;2023;32;GUADELOUPE;MASCULIN;INDIVIDUEL;BAC TECHNOLOGIQUE;BAC STMG;BAC STMG MERCATIQUE (MARKETING);3;3;1;2;0;0;0;1;0;0;1;0;0;2
19696.0;2023;32;GUADELOUPE;MASCULIN;SCOLAIRE;BAC PROFESSIONNEL;BAC PRO PROD;BAC PRO 23203 TECHNICIEN BAT. : ORG.REAL.GROS O;32;32;27;3;2;2;0;29;0;0;3;9;17;3
19699.0;2023;32;GUADELOUPE;MASCULIN;SCOLAIRE;BAC PROFESSIONNEL;BAC PRO PROD;BAC PRO 23404 TECHNICIEN CONSTRUCTEUR BOIS;13;13;9;2;2;2;0;11;0;0;2;1;8;2
19705.0;2023;32;GUADELOUPE;MASCULIN;SCOLAIRE;BAC PROFESSIONNEL;BAC PRO PROD;BAC PRO 25214 MAINT.VEHIC.OPTA VOIT.PARTICUL.;76;76;60;6;10;9;1;69;0;5;13;22;29;7
19707.0;2023;32;GUADELOUPE;MASCULIN;SCOLAIRE;BAC PROFESSIONNEL;BAC PRO PROD;BAC PRO 25216 MAINT.VEHIC.OPTC MOTOCYCLES;5;5;4;0;1;0;1;4;0;0;1;3;0;1
19708.0;2023;32;GUADELOUPE;MASCULIN;SCOLAIRE;BAC PROFESSIONNEL;BAC PRO PROD;BAC PRO 25219 MAINT.MATERIELS OPT.A AGRICOLES;8;8;4;4;0;0;0;4;0;0;1;1;2;4
19712.0;2023;32;GUADELOUPE;MASCULIN;SCOLAIRE;BAC PROFESSIONNEL;BAC PRO PROD;BAC PRO 25408 REPARATION DES CARROSSERIES;9;9;6;2;1;1;0;7;0;0;2;1;4;2
19713.0;2023;32;GUADELOUPE;MASCULIN;SCOLAIRE;BAC PROFESSIONNEL;BAC PRO PROD;BAC PRO 25411 TECH.CHAUDRONNERIE INDUSTRIELLE;29;29;15;12;2;0;2;15;0;1;1;6;7;14
19715.0;2023;32;GUADELOUPE;MASCULIN;SCOLAIRE;BAC PROFESSIONNEL;BAC PRO PROD;BAC PRO 25510 METIERS ELECT. ENVIRON. CONNECTES;170;168;125;22;21;17;4;142;0;6;22;38;76;26
19728.0;2023;32;GUADELOUPE;MASCULIN;SCOLAIRE;BAC PROFESSIONNEL;BAC PRO SERV;BAC PRO 31214 MET.COM.VEN.OP.B PR.CL.VA.OF.COM.;51;50;36;3;11;8;3;44;0;2;6;10;26;6
19731.0;2023;32;GUADELOUPE;MASCULIN;SCOLAIRE;BAC PROFESSIONNEL;BAC PRO SERV;BAC PRO 33004 ACC.SOINS-S.PERS. OPT.EN STRUCTUR;9;9;4;5;0;0;0;4;0;0;0;1;3;5
19738.0;2023;32;GUADELOUPE;MASCULIN;SCOLAIRE;BAC TECHNOLOGIQUE;BAC S2TMD;BAC S2TMD DANSE;3;3;3;0;0;0;0;3;0;0;3;0;0;0
19740.0;2023;32;GUADELOUPE;MASCULIN;SCOLAIRE;BAC TECHNOLOGIQUE;BAC S2TMD;BAC S2TMD THEATRE;6;6;5;0;1;0;1;5;0;0;2;2;1;1
19745.0;2023;32;GUADELOUPE;MASCULIN;SCOLAIRE;BAC TECHNOLOGIQUE;BAC STI2D;BAC STI2D ARCHITECTURE ET CONSTRUCTION;37;37;28;0;9;7;2;35;0;0;4;9;22;2
19749.0;2023;32;GUADELOUPE;MASCULIN;SCOLAIRE;BAC TECHNOLOGIQUE;BAC STL;BAC STL BIOCHIM.-BIOLOGIE-BIOTECHNOL.;6;6;4;0;2;0;2;4;0;0;0;0;4;2
19753.0;2023;32;GUADELOUPE;MASCULIN;SCOLAIRE;BAC TECHNOLOGIQUE;BAC STMG;BAC STMG RESSOURCES HUMAINES ET COMMUNICATION;56;56;44;3;9;8;1;52;0;0;1;18;33;4
19761.0;2023;33;GUYANE;FEMININ;FORMATION CONTINUE;BAC PROFESSIONNEL;BAC PRO SERV;BAC PRO 33004 ACC.SOINS-S.PERS. OPT.EN STRUCTUR;1;1;0;1;0;0;0;0;0;0;0;0;0;1
19765.0;2023;33;GUYANE;FEMININ;INDIVIDUEL;BAC PROFESSIONNEL;BAC PRO PROD;BAC PRO 23303 MENUISERIE ALUMINIUM-VERRE;1;1;0;1;0;0;0;0;0;0;0;0;0;1
19766.0;2023;33;GUYANE;FEMININ;INDIVIDUEL;BAC PROFESSIONNEL;BAC PRO PROD;BAC PRO AG 21004 CGEA;3;3;2;1;0;0;0;2;0;0;0;0;2;1
19772.0;2023;33;GUYANE;FEMININ;INDIVIDUEL;BAC PROFESSIONNEL;BAC PRO SERV;BAC PRO 31214 MET.COM.VEN.OP.B PR.CL.VA.OF.COM.;2;2;1;1;0;0;0;1;0;0;0;0;1;1
19776.0;2023;33;GUYANE;FEMININ;INDIVIDUEL;BAC TECHNOLOGIQUE;BAC STMG;BAC STMG GESTION ET FINANCE;2;2;0;0;2;1;1;1;0;0;0;0;1;1
19781.0;2023;33;GUYANE;FEMININ;SCOLAIRE;BAC PROFESSIONNEL;BAC PRO PROD;BAC PRO 22106 CUISINE;15;14;6;2;6;5;1;11;0;0;0;1;10;3
19784.0;2023;33;GUYANE;FEMININ;SCOLAIRE;BAC PROFESSIONNEL;BAC PRO PROD;BAC PRO 23005 TECHN. ETUDES BAT B ASSIST.ARCHI.;3;3;1;2;0;0;0;1;0;0;0;0;1;2
19786.0;2023;33;GUYANE;FEMININ;SCOLAIRE;BAC PROFESSIONNEL;BAC PRO PROD;BAC PRO 23203 TECHNICIEN BAT. : ORG.REAL.GROS O;5;5;2;2;1;1;0;3;0;0;1;0;2;2
19791.0;2023;33;GUYANE;FEMININ;SCOLAIRE;BAC PROFESSIONNEL;BAC PRO PROD;BAC PRO 24203 METIERS DE LA MODE - VÊTEMENT;35;35;22;11;2;1;1;23;0;0;3;9;11;12
19795.0;2023;33;GUYANE;FEMININ;SCOLAIRE;BAC PROFESSIONNEL;BAC PRO PROD;BAC PRO 25411 TECH.CHAUDRONNERIE INDUSTRIELLE;1;1;0;1;0;0;0;0;0;0;0;0;0;1
19798.0;2023;33;GUYANE;FEMININ;SCOLAIRE;BAC PROFESSIONNEL;BAC PRO PROD;BAC PRO AG 21004 CGEA;28;28;23;5;0;0;0;23;0;0;2;7;14;5
19806.0;2023;33;GUYANE;FEMININ;SCOLAIRE;BAC PROFESSIONNEL;BAC PRO SERV;BAC PRO 31213 MET.COM.VEN.OP.A ANI.GES.ESP.COM.;103;103;50;35;18;18;0;68;0;1;2;18;47;35
19807.0;2023;33;GUYANE;FEMININ;SCOLAIRE;BAC PROFESSIONNEL;BAC PRO SERV;BAC PRO 31214 MET.COM.VEN.OP.B PR.CL.VA.OF.COM.;36;36;20;11;5;3;2;23;0;0;1;4;18;13
19815.0;2023;33;GUYANE;FEMININ;SCOLAIRE;BAC PROFESSIONNEL;BAC PRO SERV;BAC PRO 34304 HYGIENE PROPRETE STERILISATION;20;20;14;4;2;0;2;14;0;0;2;4;8;6
19817.0;2023;33;GUYANE;FEMININ;SCOLAIRE;BAC PROFESSIONNEL;BAC PRO SERV;BAC PRO AG 33002 SERV PERS TERRIT;24;24;22;2;0;0;0;22;0;0;2;4;16;2
19818.0;2023;33;GUYANE;FEMININ;SCOLAIRE;BAC TECHNOLOGIQUE;BAC ST2S;BAC ST2S SCIENCES & TECHNO. SANTE & SOCIAL;213;213;142;11;60;41;19;183;0;1;14;46;122;30
19821.0;2023;33;GUYANE;FEMININ;SCOLAIRE;BAC TECHNOLOGIQUE;BAC STI2D;BAC STI2D ARCHITECTURE ET CONSTRUCTION;7;7;3;1;3;1;2;4;0;0;1;1;2;3
19845.0;2023;33;GUYANE;MASCULIN;INDIVIDUEL;BAC PROFESSIONNEL;BAC PRO PROD;BAC PRO AG 21004 CGEA;1;1;1;0;0;0;0;1;0;0;0;0;1;0
19852.0;2023;33;GUYANE;MASCULIN;INDIVIDUEL;BAC TECHNOLOGIQUE;BAC STMG;BAC STMG GESTION ET FINANCE;1;1;0;1;0;0;0;0;0;0;0;0;0;1
19853.0;2023;33;GUYANE;MASCULIN;INDIVIDUEL;BAC TECHNOLOGIQUE;BAC STMG;BAC STMG MERCATIQUE (MARKETING);1;1;0;1;0;0;0;0;0;0;0;0;0;1
19855.0;2023;33;GUYANE;MASCULIN;SCOLAIRE;BAC PROFESSIONNEL;BAC PRO PROD;BAC PRO 22004 PROC. CHIMIE EAU PAPIERS-CARTONS;9;9;5;3;1;1;0;6;0;0;0;3;3;3
19861.0;2023;33;GUYANE;MASCULIN;SCOLAIRE;BAC PROFESSIONNEL;BAC PRO PROD;BAC PRO 23005 TECHN. ETUDES BAT B ASSIST.ARCHI.;10;10;6;4;0;0;0;6;0;1;0;0;5;4
19862.0;2023;33;GUYANE;MASCULIN;SCOLAIRE;BAC PROFESSIONNEL;BAC PRO PROD;BACPRO 23103 TECHNICIEN GEOMETRE-TOPOGRAPHE;6;6;5;1;0;0;0;5;0;0;0;4;1;1
19864.0;2023;33;GUYANE;MASCULIN;SCOLAIRE;BAC PROFESSIONNEL;BAC PRO PROD;BAC PRO 23205 INTERV. SUR PATRIMOINE BATI OPT.A;13;13;6;4;3;3;0;9;0;0;0;0;9;4
19867.0;2023;33;GUYANE;MASCULIN;SCOLAIRE;BAC PROFESSIONNEL;BAC PRO PROD;BAC PRO 23404 TECHNICIEN CONSTRUCTEUR BOIS;19;19;5;10;4;3;1;8;0;0;0;1;7;11
19868.0;2023;33;GUYANE;MASCULIN;SCOLAIRE;BAC PROFESSIONNEL;BAC PRO PROD;BAC PRO 23405 TECHNICIEN MENUISIER AGENCEUR;33;33;22;5;6;5;1;27;0;0;1;7;19;6
19869.0;2023;33;GUYANE;MASCULIN;SCOLAIRE;BAC PROFESSIONNEL;BAC PRO PROD;BAC PRO 24203 METIERS DE LA MODE - VÊTEMENT;3;3;2;0;1;0;1;2;0;0;1;0;1;1
19870.0;2023;33;GUYANE;MASCULIN;SCOLAIRE;BAC PROFESSIONNEL;BAC PRO PROD;BAC PRO 25007 MAINTENANCE EQUIPEMENTS INDUST.;20;20;8;9;3;3;0;11;0;0;0;2;9;9
19873.0;2023;33;GUYANE;MASCULIN;SCOLAIRE;BAC PROFESSIONNEL;BAC PRO PROD;BAC PRO 25411 TECH.CHAUDRONNERIE INDUSTRIELLE;16;16;6;10;0;0;0;6;0;0;0;2;4;10
19875.0;2023;33;GUYANE;MASCULIN;SCOLAIRE;BAC PROFESSIONNEL;BAC PRO PROD;BAC PRO 25510 METIERS ELECT. ENVIRON. CONNECTES;76;76;38;30;8;7;1;45;0;0;4;16;25;31
19876.0;2023;33;GUYANE;MASCULIN;SCOLAIRE;BAC PROFESSIONNEL;BAC PRO PROD;BAC PRO 25513 SYST.NUM.OPT.A SURETE SECURITE;10;10;5;4;1;1;0;6;0;0;2;1;3;4
19885.0;2023;33;GUYANE;MASCULIN;SCOLAIRE;BAC PROFESSIONNEL;BAC PRO SERV;BAC PRO 31212 METIERS DE L'ACCUEIL;20;20;9;9;2;0;2;9;0;0;1;2;6;11
19887.0;2023;33;GUYANE;MASCULIN;SCOLAIRE;BAC PROFESSIONNEL;BAC PRO SERV;BAC PRO 31214 MET.COM.VEN.OP.B PR.CL.VA.OF.COM.;29;29;16;9;4;4;0;20;0;0;1;3;16;9
19888.0;2023;33;GUYANE;MASCULIN;SCOLAIRE;BAC PROFESSIONNEL;BAC PRO SERV;BAC PRO 32303 ART.& MET.ART:COM.VIS.VIS.PLURI-M;12;12;10;2;0;0;0;10;0;1;0;4;5;2
19897.0;2023;33;GUYANE;MASCULIN;SCOLAIRE;BAC PROFESSIONNEL;BAC PRO SERV;BAC PRO AG 33002 SERV PERS TERRIT;10;10;10;0;0;0;0;10;0;0;1;2;7;0
19900.0;2023;33;GUYANE;MASCULIN;SCOLAIRE;BAC TECHNOLOGIQUE;BAC STHR;BAC STHR SC.&TEC. HOTELLERIE-RESTAURATION;9;9;6;2;1;1;0;7;0;0;2;2;3;2
19914.0;2023;28;LA REUNION;FEMININ;APPRENTISSAGE;BAC PROFESSIONNEL;BAC PRO PROD;BAC PRO AG 22108 TEC CONS VTE ALIMENTATION (PAB);4;4;3;1;0;0;0;3;0;0;0;0;3;1
19921.0;2023;28;LA REUNION;FEMININ;INDIVIDUEL;BAC GENERAL;BAC GENERAL;BAC GENE 10019 BAC GENERAL;22;22;10;10;2;2;0;12;0;1;1;3;7;10
19944.0;2023;28;LA REUNION;FEMININ;SCOLAIRE;BAC PROFESSIONNEL;BAC PRO PROD;BAC PRO 23004 TECHN. ETUDES BAT.A ETUDES & ECO.;5;5;4;1;0;0;0;4;0;0;0;1;3;1
19952.0;2023;28;LA REUNION;FEMININ;SCOLAIRE;BAC PROFESSIONNEL;BAC PRO PROD;BAC PRO 23405 TECHNICIEN MENUISIER AGENCEUR;6;6;5;1;0;0;0;5;0;0;1;2;2;1
19958.0;2023;28;LA REUNION;FEMININ;SCOLAIRE;BAC PROFESSIONNEL;BAC PRO PROD;BAC PRO 25216 MAINT.VEHIC.OPTC MOTOCYCLES;1;1;1;0;0;0;0;1;0;0;0;1;0;0
19960.0;2023;28;LA REUNION;FEMININ;SCOLAIRE;BAC PROFESSIONNEL;BAC PRO PROD;BAC PRO 25408 REPARATION DES CARROSSERIES;3;3;3;0;0;0;0;3;0;0;1;0;2;0
19963.0;2023;28;LA REUNION;FEMININ;SCOLAIRE;BAC PROFESSIONNEL;BAC PRO PROD;BAC PRO 25515 SYST.NUM.OPT.C RES.INF.SYST.COMM.;8;8;8;0;0;0;0;8;0;1;2;2;3;0
19964.0;2023;28;LA REUNION;FEMININ;SCOLAIRE;BAC PROFESSIONNEL;BAC PRO PROD;BAC PRO AG 21004 CGEA;10;9;6;3;0;0;0;6;0;0;1;4;1;3
19966.0;2023;28;LA REUNION;FEMININ;SCOLAIRE;BAC PROFESSIONNEL;BAC PRO PROD;BAC PRO AG 21302 GEST MILIEUX NATURELS FAUNE;3;3;3;0;0;0;0;3;0;0;0;2;1;0
19967.0;2023;28;LA REUNION;FEMININ;SCOLAIRE;BAC PROFESSIONNEL;BAC PRO PROD;BAC PRO AG 21405 AMENAGEMENTS PAYSAGERS;1;0;0;0;0;0;0;0;0;0;0;0;0;0
19971.0;2023;28;LA REUNION;FEMININ;SCOLAIRE;BAC PROFESSIONNEL;BAC PRO SERV;BAC PRO 31106 LOGISTIQUE;36;36;24;7;5;5;0;29;0;3;6;6;14;7
19973.0;2023;28;LA REUNION;FEMININ;SCOLAIRE;BAC PROFESSIONNEL;BAC PRO SERV;BAC PRO 31212 METIERS DE L'ACCUEIL;149;149;123;15;11;8;3;131;0;5;26;36;64;18
19975.0;2023;28;LA REUNION;FEMININ;SCOLAIRE;BAC PROFESSIONNEL;BAC PRO SERV;BAC PRO 31214 MET.COM.VEN.OP.B PR.CL.VA.OF.COM.;43;43;33;5;5;5;0;38;0;3;10;10;15;5
19982.0;2023;28;LA REUNION;FEMININ;SCOLAIRE;BAC PROFESSIONNEL;BAC PRO SERV;BAC PRO 33101 OPTIQUE LUNETTERIE;6;6;4;2;0;0;0;4;0;0;1;3;0;2
19987.0;2023;28;LA REUNION;FEMININ;SCOLAIRE;BAC PROFESSIONNEL;BAC PRO SERV;BAC PRO 34403 METIERS DE LA SECURITE;33;33;30;3;0;0;0;30;0;2;1;18;9;3
19992.0;2023;28;LA REUNION;FEMININ;SCOLAIRE;BAC TECHNOLOGIQUE;BAC STHR;BAC STHR SC.&TEC. HOTELLERIE-RESTAURATION;13;13;11;0;2;1;1;12;0;2;3;4;3;1
19994.0;2023;28;LA REUNION;FEMININ;SCOLAIRE;BAC TECHNOLOGIQUE;BAC STI2D;BAC STI2D ENERGIES  ET ENVIRONNEMENT;21;21;18;0;3;3;0;21;0;2;0;5;14;0
19995.0;2023;28;LA REUNION;FEMININ;SCOLAIRE;BAC TECHNOLOGIQUE;BAC STI2D;BAC STI2D INNOVATION TECHNO.  ET ECO CONCEPTION;14;14;11;0;3;3;0;14;0;0;0;7;7;0
1.0;2021;02;AIX-MARSEILLE;FEMININ;APPRENTISSAGE;BAC PROFESSIONNEL;BAC PRO PROD;BAC PRO 22106 CUISINE;13;12;8;3;1;0;1;8;0;0;2;3;3;4
2.0;2021;02;AIX-MARSEILLE;FEMININ;APPRENTISSAGE;BAC PROFESSIONNEL;BAC PRO PROD;BAC PRO 23102 TRAVAUX PUBLICS;1;1;1;0;0;0;0;1;0;0;0;1;0;0
5.0;2021;02;AIX-MARSEILLE;FEMININ;APPRENTISSAGE;BAC PROFESSIONNEL;BAC PRO PROD;BAC PRO 25303 AERONAUTIQUE OPTION SYSTEMES;3;3;3;0;0;0;0;3;0;0;0;3;0;0
6.0;2021;02;AIX-MARSEILLE;FEMININ;APPRENTISSAGE;BAC PROFESSIONNEL;BAC PRO PROD;BAC PRO 25510 METIERS ELECT. ENVIRON. CONNECTES;2;2;2;0;0;0;0;2;0;0;1;1;0;0
8.0;2021;02;AIX-MARSEILLE;FEMININ;APPRENTISSAGE;BAC PROFESSIONNEL;BAC PRO PROD;BAC PRO AG 21114 CONDUITE PRODUCTIONS HORTICOLES;1;1;1;0;0;0;0;1;0;0;0;0;1;0
15.0;2021;02;AIX-MARSEILLE;FEMININ;APPRENTISSAGE;BAC PROFESSIONNEL;BAC PRO SERV;BAC PRO 31106 LOGISTIQUE;1;1;1;0;0;0;0;1;0;0;0;0;1;0
17.0;2021;02;AIX-MARSEILLE;FEMININ;APPRENTISSAGE;BAC PROFESSIONNEL;BAC PRO SERV;BAC PRO 31210 ACCUEIL -RELATION CLIENTS USAGERS;14;13;6;6;1;1;0;7;0;1;0;2;4;6
23.0;2021;02;AIX-MARSEILLE;FEMININ;APPRENTISSAGE;BAC PROFESSIONNEL;BAC PRO SERV;BAC PRO 33603 ESTHETIQUE COSMETIQUE PARFUMERIE;1;1;1;0;0;0;0;1;0;0;0;1;0;0
27.0;2021;02;AIX-MARSEILLE;FEMININ;ENSEIGNEMENT A DISTANCE;BAC PROFESSIONNEL;BAC PRO SERV;BAC PRO 30001 GESTION-ADMINISTRATION;4;1;0;1;0;0;0;0;0;0;0;0;0;1
29.0;2021;02;AIX-MARSEILLE;FEMININ;ENSEIGNEMENT A DISTANCE;BAC PROFESSIONNEL;BAC PRO SERV;BAC PRO 31206 VENTE (PROSPECT.NEGO.SUIV.CLIENT;1;1;1;0;0;0;0;1;0;0;1;0;0;0
33.0;2021;02;AIX-MARSEILLE;FEMININ;ENSEIGNEMENT A DISTANCE;BAC TECHNOLOGIQUE;BAC ST2S;BAC ST2S SCIENCES & TECHNO. SANTE & SOCIAL;7;7;7;0;0;0;0;7;0;3;1;1;2;0
42.0;2021;02;AIX-MARSEILLE;FEMININ;FORMATION CONTINUE;BAC PROFESSIONNEL;BAC PRO SERV;BAC PRO 31210 ACCUEIL -RELATION CLIENTS USAGERS;19;19;15;4;0;0;0;15;0;1;3;6;5;4
47.0;2021;02;AIX-MARSEILLE;FEMININ;INDIVIDUEL;BAC PROFESSIONNEL;BAC PRO PROD;BAC PRO 22105 BOULANGER-PÂTISSIER;1;0;0;0;0;0;0;0;0;0;0;0;0;0
51.0;2021;02;AIX-MARSEILLE;FEMININ;INDIVIDUEL;BAC PROFESSIONNEL;BAC PRO PROD;BAC PRO AG 21004 CGEA;4;3;2;1;0;0;0;2;0;0;0;1;1;1
55.0;2021;02;AIX-MARSEILLE;FEMININ;INDIVIDUEL;BAC PROFESSIONNEL;BAC PRO SERV;BAC PRO 30001 GESTION-ADMINISTRATION;12;4;2;2;0;0;0;2;0;0;0;0;2;2
56.0;2021;02;AIX-MARSEILLE;FEMININ;INDIVIDUEL;BAC PROFESSIONNEL;BAC PRO SERV;BAC PRO 31202 COMMERCE;5;3;1;2;0;0;0;1;0;0;0;0;1;2
67.0;2021;02;AIX-MARSEILLE;FEMININ;INDIVIDUEL;BAC TECHNOLOGIQUE;BAC STAV;BAC STAV AGRONOMIE ALIM ENV TERRITOI;1;1;1;0;0;0;0;1;0;0;0;0;1;0
73.0;2021;02;AIX-MARSEILLE;FEMININ;INDIVIDUEL;BAC TECHNOLOGIQUE;BAC STMG;BAC STMG RESSOURCES HUMAINES ET COMMUNICATION;19;13;8;2;3;1;2;9;0;0;0;1;8;4
75.0;2021;02;AIX-MARSEILLE;FEMININ;SCOLAIRE;BAC GENERAL;BAC GENERAL;BAC GENE 10019 BAC GENERAL;9102;9100;8874;42;184;128;56;9002;219;1290;2700;3087;1706;98
78.0;2021;02;AIX-MARSEILLE;FEMININ;SCOLAIRE;BAC PROFESSIONNEL;BAC PRO PROD;BAC PRO 22004 PROC. CHIMIE EAU PAPIERS-CARTONS;6;6;3;0;3;3;0;6;0;1;0;2;3;0
81.0;2021;02;AIX-MARSEILLE;FEMININ;SCOLAIRE;BAC PROFESSIONNEL;BAC PRO PROD;BAC PRO 22403 ARTS.& MET.ART:MET.ENSEIGN SIGNA;2;2;2;0;0;0;0;2;0;0;1;1;0;0
84.0;2021;02;AIX-MARSEILLE;FEMININ;SCOLAIRE;BAC PROFESSIONNEL;BAC PRO PROD;BAC PRO 23304 AMENAGEMENT FINITION BATIMENT;7;7;4;3;0;0;0;4;0;0;0;3;1;3
85.0;2021;02;AIX-MARSEILLE;FEMININ;SCOLAIRE;BAC PROFESSIONNEL;BAC PRO PROD;BAC PRO 23405 TECHNICIEN MENUISIER AGENCEUR;3;3;3;0;0;0;0;3;0;0;1;1;1;0
95.0;2021;02;AIX-MARSEILLE;FEMININ;SCOLAIRE;BAC PROFESSIONNEL;BAC PRO PROD;BAC PRO 25303 AERONAUTIQUE OPTION SYSTEMES;2;2;2;0;0;0;0;2;0;0;0;1;1;0
99.0;2021;02;AIX-MARSEILLE;FEMININ;SCOLAIRE;BAC PROFESSIONNEL;BAC PRO PROD;BAC PRO 25510 METIERS ELECT. ENVIRON. CONNECTES;5;5;5;0;0;0;0;5;0;0;1;4;0;0
114.0;2021;02;AIX-MARSEILLE;FEMININ;SCOLAIRE;BAC PROFESSIONNEL;BAC PRO SERV;BAC PRO 31107 CONDUCT. TRANSP.ROUT.MARCHANDISES;6;6;6;0;0;0;0;6;0;0;2;3;1;0
118.0;2021;02;AIX-MARSEILLE;FEMININ;SCOLAIRE;BAC PROFESSIONNEL;BAC PRO SERV;BAC PRO 31210 ACCUEIL -RELATION CLIENTS USAGERS;293;291;241;28;22;14;8;255;0;8;33;107;107;36
119.0;2021;02;AIX-MARSEILLE;FEMININ;SCOLAIRE;BAC PROFESSIONNEL;BAC PRO SERV;BAC PRO 32207 REAL.PR.IMPR.PLURI.OPTA.PR.GRAPH.;10;9;8;1;0;0;0;8;0;0;2;3;3;1
121.0;2021;02;AIX-MARSEILLE;FEMININ;SCOLAIRE;BAC PROFESSIONNEL;BAC PRO SERV;BAC PRO 32303 ART.& MET.ART:COM.VIS.VIS.PLURI-M;22;22;13;7;2;2;0;15;0;1;4;4;6;7
122.0;2021;02;AIX-MARSEILLE;FEMININ;SCOLAIRE;BAC PROFESSIONNEL;BAC PRO SERV;BAC PRO 32304 PHOTOGRAPHIE;17;17;12;5;0;0;0;12;0;1;4;4;3;5
135.0;2021;02;AIX-MARSEILLE;FEMININ;SCOLAIRE;BAC TECHNOLOGIQUE;BAC STAV;BAC STAV AGRONOMIE ALIM ENV TERRITOI;126;124;123;1;0;0;0;123;0;5;17;57;44;1
140.0;2021;02;AIX-MARSEILLE;FEMININ;SCOLAIRE;BAC TECHNOLOGIQUE;BAC STI2D;BAC STI2D INNOVATION TECHNO.  ET ECO CONCEPTION;23;23;20;0;3;3;0;23;0;0;6;8;9;0
144.0;2021;02;AIX-MARSEILLE;FEMININ;SCOLAIRE;BAC TECHNOLOGIQUE;BAC STMG;BAC STMG GESTION ET FINANCE;234;234;226;5;3;1;2;227;0;13;61;91;62;7
154.0;2021;02;AIX-MARSEILLE;MASCULIN;APPRENTISSAGE;BAC PROFESSIONNEL;BAC PRO PROD;BAC PRO 23203 TECHNICIEN BAT. : ORG.REAL.GROS O;7;7;6;0;1;0;1;6;0;0;0;3;3;1
157.0;2021;02;AIX-MARSEILLE;MASCULIN;APPRENTISSAGE;BAC PROFESSIONNEL;BAC PRO PROD;BAC PRO 25009 MAINTENANCE NAUTIQUE;1;1;1;0;0;0;0;1;0;0;0;0;1;0
160.0;2021;02;AIX-MARSEILLE;MASCULIN;APPRENTISSAGE;BAC PROFESSIONNEL;BAC PRO PROD;BAC PRO 25215 MAINT.VEHIC.OPTB VEHIC.TRANS.ROUT;16;16;9;5;2;2;0;11;0;0;0;3;8;5
169.0;2021;02;AIX-MARSEILLE;MASCULIN;APPRENTISSAGE;BAC PROFESSIONNEL;BAC PRO PROD;BAC PRO 25514 SYST.NUM.OPT.B AUD.RES.EQUIP.DOM.;11;7;5;2;0;0;0;5;0;1;0;3;1;2
171.0;2021;02;AIX-MARSEILLE;MASCULIN;APPRENTISSAGE;BAC PROFESSIONNEL;BAC PRO PROD;BAC PRO AG 21113 CGEVV;10;9;8;1;0;0;0;8;0;0;0;5;3;1
176.0;2021;02;AIX-MARSEILLE;MASCULIN;APPRENTISSAGE;BAC PROFESSIONNEL;BAC PRO PROD;BAC PRO AG 21405 AMENAGEMENTS PAYSAGERS;44;40;34;6;0;0;0;34;0;0;1;16;17;6
182.0;2021;02;AIX-MARSEILLE;MASCULIN;APPRENTISSAGE;BAC PROFESSIONNEL;BAC PRO SERV;BAC PRO 31210 ACCUEIL -RELATION CLIENTS USAGERS;11;9;4;4;1;0;1;4;0;0;1;1;2;5
184.0;2021;02;AIX-MARSEILLE;MASCULIN;APPRENTISSAGE;BAC PROFESSIONNEL;BAC PRO SERV;BAC PRO 32208 REAL.PR.IMPR.PLURI.OPTB.PR.IMPR.;1;1;1;0;0;0;0;1;0;0;0;0;1;0
186.0;2021;02;AIX-MARSEILLE;MASCULIN;APPRENTISSAGE;BAC PROFESSIONNEL;BAC PRO SERV;BAC PRO 32304 PHOTOGRAPHIE;3;3;3;0;0;0;0;3;0;0;0;3;0;0
190.0;2021;02;AIX-MARSEILLE;MASCULIN;APPRENTISSAGE;BAC PROFESSIONNEL;BAC PRO SERV;BAC PRO 34304 HYGIENE PROPRETE STERILISATION;5;4;4;0;0;0;0;4;0;0;1;3;0;0
192.0;2021;02;AIX-MARSEILLE;MASCULIN;ENSEIGNEMENT A DISTANCE;BAC PROFESSIONNEL;BAC PRO SERV;BAC PRO 30001 GESTION-ADMINISTRATION;3;1;0;1;0;0;0;0;0;0;0;0;0;1
200.0;2021;02;AIX-MARSEILLE;MASCULIN;FORMATION CONTINUE;BAC PROFESSIONNEL;BAC PRO PROD;BAC PRO 22004 PROC. CHIMIE EAU PAPIERS-CARTONS;1;1;1;0;0;0;0;1;0;0;1;0;0;0
210.0;2021;02;AIX-MARSEILLE;MASCULIN;FORMATION CONTINUE;BAC PROFESSIONNEL;BAC PRO SERV;BAC PRO 31206 VENTE (PROSPECT.NEGO.SUIV.CLIENT;2;2;1;1;0;0;0;1;0;0;0;0;1;1
217.0;2021;02;AIX-MARSEILLE;MASCULIN;INDIVIDUEL;BAC PROFESSIONNEL;BAC PRO PROD;BAC PRO 22106 CUISINE;3;1;0;1;0;0;0;0;0;0;0;0;0;1
222.0;2021;02;AIX-MARSEILLE;MASCULIN;INDIVIDUEL;BAC PROFESSIONNEL;BAC PRO PROD;BAC PRO 25411 TECH.CHAUDRONNERIE INDUSTRIELLE;1;0;0;0;0;0;0;0;0;0;0;0;0;0
223.0;2021;02;AIX-MARSEILLE;MASCULIN;INDIVIDUEL;BAC PROFESSIONNEL;BAC PRO PROD;BAC PRO 25510 METIERS ELECT. ENVIRON. CONNECTES;5;5;4;1;0;0;0;4;0;1;0;2;1;1
227.0;2021;02;AIX-MARSEILLE;MASCULIN;INDIVIDUEL;BAC PROFESSIONNEL;BAC PRO PROD;BAC PRO AG 21113 CGEVV;3;3;3;0;0;0;0;3;0;0;0;0;3;0
231.0;2021;02;AIX-MARSEILLE;MASCULIN;INDIVIDUEL;BAC PROFESSIONNEL;BAC PRO PROD;BAC PRO AG 21405 AMENAGEMENTS PAYSAGERS;2;2;2;0;0;0;0;2;0;0;0;0;2;0
252.0;2021;02;AIX-MARSEILLE;MASCULIN;INDIVIDUEL;BAC TECHNOLOGIQUE;BAC STMG;BAC STMG SYSTEMES D'INFORMATION DE GESTION;1;0;0;0;0;0;0;0;0;0;0;0;0;0
253.0;2021;02;AIX-MARSEILLE;MASCULIN;SCOLAIRE;BAC GENERAL;BAC GENERAL;BAC GENE 10019 BAC GENERAL;7393;7393;7017;56;320;188;132;7205;120;720;1731;2607;2027;188
256.0;2021;02;AIX-MARSEILLE;MASCULIN;SCOLAIRE;BAC PROFESSIONNEL;BAC PRO PROD;BAC PRO 22003 BIO-INDUSTRIES DE TRANSFORMATION;8;8;6;2;0;0;0;6;0;2;2;1;1;2
267.0;2021;02;AIX-MARSEILLE;MASCULIN;SCOLAIRE;BAC PROFESSIONNEL;BAC PRO PROD;BACPRO 23103 TECHNICIEN GEOMETRE-TOPOGRAPHE;17;17;14;3;0;0;0;14;0;0;1;8;5;3
281.0;2021;02;AIX-MARSEILLE;MASCULIN;SCOLAIRE;BAC PROFESSIONNEL;BAC PRO PROD;BAC PRO 25214 MAINT.VEHIC.OPTA VOIT.PARTICUL.;144;143;103;33;7;4;3;107;0;4;18;43;42;36
287.0;2021;02;AIX-MARSEILLE;MASCULIN;SCOLAIRE;BAC PROFESSIONNEL;BAC PRO PROD;BAC PRO 25302 AERONAUTIQUE OPTION AVIONIQUE;11;11;10;0;1;0;1;10;0;0;7;3;0;1
288.0;2021;02;AIX-MARSEILLE;MASCULIN;SCOLAIRE;BAC PROFESSIONNEL;BAC PRO PROD;BAC PRO 25303 AERONAUTIQUE OPTION SYSTEMES;25;25;25;0;0;0;0;25;0;1;7;14;3;0
295.0;2021;02;AIX-MARSEILLE;MASCULIN;SCOLAIRE;BAC PROFESSIONNEL;BAC PRO PROD;BAC PRO 25513 SYST.NUM.OPT.A SURETE SECURITE;63;62;51;8;3;0;3;51;0;1;10;22;18;11
298.0;2021;02;AIX-MARSEILLE;MASCULIN;SCOLAIRE;BAC PROFESSIONNEL;BAC PRO PROD;BAC PRO AG 21001 AGRO-EQUIPEMENT;5;5;3;2;0;0;0;3;0;0;0;2;1;2
299.0;2021;02;AIX-MARSEILLE;MASCULIN;SCOLAIRE;BAC PROFESSIONNEL;BAC PRO PROD;BAC PRO AG 21004 CGEA;41;40;36;4;0;0;0;36;0;1;7;13;15;4
304.0;2021;02;AIX-MARSEILLE;MASCULIN;SCOLAIRE;BAC PROFESSIONNEL;BAC PRO PROD;BAC PRO AG 21302 GEST MILIEUX NATURELS FAUNE;62;61;60;1;0;0;0;60;0;1;10;21;28;1
305.0;2021;02;AIX-MARSEILLE;MASCULIN;SCOLAIRE;BAC PROFESSIONNEL;BAC PRO PROD;BAC PRO AG 21303 FORET;10;10;10;0;0;0;0;10;0;0;0;6;4;0
308.0;2021;02;AIX-MARSEILLE;MASCULIN;SCOLAIRE;BAC PROFESSIONNEL;BAC PRO PROD;BAC PRO AG 22106 TEC CONS VTE ALIMENTATION VINS SP;14;13;13;0;0;0;0;13;0;0;1;5;7;0
316.0;2021;02;AIX-MARSEILLE;MASCULIN;SCOLAIRE;BAC PROFESSIONNEL;BAC PRO SERV;BAC PRO 31210 ACCUEIL -RELATION CLIENTS USAGERS;62;62;48;10;4;1;3;49;0;2;8;18;21;13
320.0;2021;02;AIX-MARSEILLE;MASCULIN;SCOLAIRE;BAC PROFESSIONNEL;BAC PRO SERV;BAC PRO 32304 PHOTOGRAPHIE;5;5;5;0;0;0;0;5;0;1;1;1;2;0
326.0;2021;02;AIX-MARSEILLE;MASCULIN;SCOLAIRE;BAC PROFESSIONNEL;BAC PRO SERV;BAC PRO 33103 TECHNICIEN APPAREIL. ORTHOPEDIQUE;4;4;2;1;1;0;1;2;0;0;0;1;1;2
332.0;2021;02;AIX-MARSEILLE;MASCULIN;SCOLAIRE;BAC TECHNOLOGIQUE;BAC STAV;BAC STAV AGRONOMIE ALIM ENV TERRITOI;77;77;75;2;0;0;0;75;0;2;7;30;36;2
334.0;2021;02;AIX-MARSEILLE;MASCULIN;SCOLAIRE;BAC TECHNOLOGIQUE;BAC STHR;BAC STHR SC.&TEC. HOTELLERIE-RESTAURATION;26;26;23;0;3;3;0;26;0;0;5;8;13;0
351.0;2021;20;AMIENS;FEMININ;APPRENTISSAGE;BAC PROFESSIONNEL;BAC PRO PROD;BAC PRO AG 21004 CGEA;4;3;3;0;0;0;0;3;0;0;0;2;1;0
352.0;2021;20;AMIENS;FEMININ;APPRENTISSAGE;BAC PROFESSIONNEL;BAC PRO PROD;BAC PRO AG 21114 CONDUITE PRODUCTIONS HORTICOLES;3;3;3;0;0;0;0;3;0;0;0;1;2;0
356.0;2021;20;AMIENS;FEMININ;APPRENTISSAGE;BAC PROFESSIONNEL;BAC PRO SERV;BAC PRO 30001 GESTION-ADMINISTRATION;22;22;21;1;0;0;0;21;0;3;8;8;2;1
363.0;2021;20;AMIENS;FEMININ;ENSEIGNEMENT A DISTANCE;BAC TECHNOLOGIQUE;BAC ST2S;BAC ST2S SCIENCES & TECHNO. SANTE & SOCIAL;5;5;4;0;1;0;1;4;0;0;1;1;2;1
368.0;2021;20;AMIENS;FEMININ;FORMATION CONTINUE;BAC PROFESSIONNEL;BAC PRO PROD;BAC PRO 25214 MAINT.VEHIC.OPTA VOIT.PARTICUL.;1;0;0;0;0;0;0;0;0;0;0;0;0;0
370.0;2021;20;AMIENS;FEMININ;FORMATION CONTINUE;BAC PROFESSIONNEL;BAC PRO SERV;BAC PRO 31106 LOGISTIQUE;1;1;1;0;0;0;0;1;0;0;1;0;0;0
375.0;2021;20;AMIENS;FEMININ;INDIVIDUEL;BAC PROFESSIONNEL;BAC PRO PROD;BAC PRO AG 21114 CONDUITE PRODUCTIONS HORTICOLES;2;1;1;0;0;0;0;1;0;0;0;0;1;0
380.0;2021;20;AMIENS;FEMININ;INDIVIDUEL;BAC PROFESSIONNEL;BAC PRO SERV;BAC PRO 31106 LOGISTIQUE;1;0;0;0;0;0;0;0;0;0;0;0;0;0
387.0;2021;20;AMIENS;FEMININ;INDIVIDUEL;BAC PROFESSIONNEL;BAC PRO SERV;BAC PRO AG 33002 SERV PERS TERRIT;1;1;1;0;0;0;0;1;0;0;0;0;1;0
389.0;2021;20;AMIENS;FEMININ;INDIVIDUEL;BAC TECHNOLOGIQUE;BAC STHR;BAC STHR SC.&TEC. HOTELLERIE-RESTAURATION;2;2;0;1;1;0;1;0;0;0;0;0;0;2
391.0;2021;20;AMIENS;FEMININ;INDIVIDUEL;BAC TECHNOLOGIQUE;BAC STL;BAC STL BIOCHIM.-BIOLOGIE-BIOTECHNOL.;2;1;0;1;0;0;0;0;0;0;0;0;0;1
392.0;2021;20;AMIENS;FEMININ;INDIVIDUEL;BAC TECHNOLOGIQUE;BAC STMG;BAC STMG GESTION ET FINANCE;2;2;0;1;1;1;0;1;0;0;0;0;1;1
396.0;2021;20;AMIENS;FEMININ;SCOLAIRE;BAC PROFESSIONNEL;BAC PRO PROD;BACPRO 20002 ETUD.DEFINITION PRDTS INDUSTRIEL;1;1;1;0;0;0;0;1;0;0;0;0;1;0
402.0;2021;20;AMIENS;FEMININ;SCOLAIRE;BAC PROFESSIONNEL;BAC PRO PROD;BAC PRO 22703 TECHN.INSTALL.SYST.ENERG.CLIMATI;1;1;0;1;0;0;0;0;0;0;0;0;0;1
403.0;2021;20;AMIENS;FEMININ;SCOLAIRE;BAC PROFESSIONNEL;BAC PRO PROD;BAC PRO 23004 TECHN. ETUDES BAT.A ETUDES & ECO.;4;3;3;0;0;0;0;3;0;0;1;1;1;0
410.0;2021;20;AMIENS;FEMININ;SCOLAIRE;BAC PROFESSIONNEL;BAC PRO PROD;BAC PRO 25007 MAINTENANCE EQUIPEMENTS INDUST.;4;4;3;1;0;0;0;3;0;0;1;1;1;1
411.0;2021;20;AMIENS;FEMININ;SCOLAIRE;BAC PROFESSIONNEL;BAC PRO PROD;BAC PRO 25009 MAINTENANCE NAUTIQUE;1;1;1;0;0;0;0;1;0;0;1;0;0;0
415.0;2021;20;AMIENS;FEMININ;SCOLAIRE;BAC PROFESSIONNEL;BAC PRO PROD;BAC PRO 25219 MAINT.MATERIELS OPT.A AGRICOLES;2;2;2;0;0;0;0;2;0;1;0;1;0;0
431.0;2021;20;AMIENS;FEMININ;SCOLAIRE;BAC PROFESSIONNEL;BAC PRO SERV;BAC PRO 31107 CONDUCT. TRANSP.ROUT.MARCHANDISES;1;1;1;0;0;0;0;1;0;0;1;0;0;0
435.0;2021;20;AMIENS;FEMININ;SCOLAIRE;BAC PROFESSIONNEL;BAC PRO SERV;BAC PRO 32207 REAL.PR.IMPR.PLURI.OPTA.PR.GRAPH.;3;3;2;1;0;0;0;2;0;0;0;1;1;1
444.0;2021;20;AMIENS;FEMININ;SCOLAIRE;BAC PROFESSIONNEL;BAC PRO SERV;BAC PRO 34403 METIERS DE LA SECURITE;46;46;43;2;1;1;0;44;0;4;8;18;14;2
449.0;2021;20;AMIENS;FEMININ;SCOLAIRE;BAC TECHNOLOGIQUE;BAC STHR;BAC STHR SC.&TEC. HOTELLERIE-RESTAURATION;11;11;9;0;2;1;1;10;1;0;4;2;3;1
452.0;2021;20;AMIENS;FEMININ;SCOLAIRE;BAC TECHNOLOGIQUE;BAC STI2D;BAC STI2D INNOVATION TECHNO.  ET ECO CONCEPTION;23;23;18;2;3;3;0;21;0;1;4;10;6;2
455.0;2021;20;AMIENS;FEMININ;SCOLAIRE;BAC TECHNOLOGIQUE;BAC STL;BAC STL SCIENCES PHYSIQUES CHIMIQUES  EN LABORAT.;69;69;61;2;6;2;4;63;0;6;13;18;26;6
456.0;2021;20;AMIENS;FEMININ;SCOLAIRE;BAC TECHNOLOGIQUE;BAC STMG;BAC STMG GESTION ET FINANCE;181;181;162;5;14;8;6;170;1;8;28;60;73;11
457.0;2021;20;AMIENS;FEMININ;SCOLAIRE;BAC TECHNOLOGIQUE;BAC STMG;BAC STMG MERCATIQUE (MARKETING);477;477;434;11;32;18;14;452;0;15;67;180;190;25
461.0;2021;20;AMIENS;MASCULIN;APPRENTISSAGE;BAC PROFESSIONNEL;BAC PRO PROD;BAC PRO 22106 CUISINE;15;13;9;3;1;0;1;9;0;1;1;4;3;4
467.0;2021;20;AMIENS;MASCULIN;APPRENTISSAGE;BAC PROFESSIONNEL;BAC PRO PROD;BAC PRO 25214 MAINT.VEHIC.OPTA VOIT.PARTICUL.;74;71;61;4;6;5;1;66;0;1;12;26;27;5
471.0;2021;20;AMIENS;MASCULIN;APPRENTISSAGE;BAC PROFESSIONNEL;BAC PRO PROD;BAC PRO 25220 MAINT.MATERIELS OPT.B TP MANUT.;3;3;3;0;0;0;0;3;0;0;0;2;1;0
473.0;2021;20;AMIENS;MASCULIN;APPRENTISSAGE;BAC PROFESSIONNEL;BAC PRO PROD;BAC PRO 25304 AERONAUTIQUE OPTION STRUCTURE;14;14;14;0;0;0;0;14;0;3;9;2;0;0
478.0;2021;20;AMIENS;MASCULIN;APPRENTISSAGE;BAC PROFESSIONNEL;BAC PRO PROD;BAC PRO 25515 SYST.NUM.OPT.C RES.INF.SYST.COMM.;1;1;0;1;0;0;0;0;0;0;0;0;0;1
484.0;2021;20;AMIENS;MASCULIN;APPRENTISSAGE;BAC PROFESSIONNEL;BAC PRO SERV;BAC PRO 30001 GESTION-ADMINISTRATION;3;3;3;0;0;0;0;3;0;1;1;1;0;0
487.0;2021;20;AMIENS;MASCULIN;APPRENTISSAGE;BAC PROFESSIONNEL;BAC PRO SERV;BAC PRO 31210 ACCUEIL -RELATION CLIENTS USAGERS;1;1;1;0;0;0;0;1;0;1;0;0;0;0
488.0;2021;20;AMIENS;MASCULIN;APPRENTISSAGE;BAC PROFESSIONNEL;BAC PRO SERV;BAC PRO 33403 COMMERC. SERVICES EN RESTAURATION;3;3;3;0;0;0;0;3;0;1;0;2;0;0
491.0;2021;20;AMIENS;MASCULIN;ENSEIGNEMENT A DISTANCE;BAC TECHNOLOGIQUE;BAC STMG;BAC STMG MERCATIQUE (MARKETING);1;1;1;0;0;0;0;1;0;0;0;0;1;0
494.0;2021;20;AMIENS;MASCULIN;FORMATION CONTINUE;BAC PROFESSIONNEL;BAC PRO PROD;BAC PRO 25007 MAINTENANCE EQUIPEMENTS INDUST.;1;1;1;0;0;0;0;1;0;0;0;1;0;0
495.0;2021;20;AMIENS;MASCULIN;FORMATION CONTINUE;BAC PROFESSIONNEL;BAC PRO PROD;BAC PRO 25214 MAINT.VEHIC.OPTA VOIT.PARTICUL.;6;6;4;2;0;0;0;4;0;0;1;2;1;2
512.0;2021;20;AMIENS;MASCULIN;INDIVIDUEL;BAC PROFESSIONNEL;BAC PRO PROD;BAC PRO 25513 SYST.NUM.OPT.A SURETE SECURITE;1;0;0;0;0;0;0;0;0;0;0;0;0;0
513.0;2021;20;AMIENS;MASCULIN;INDIVIDUEL;BAC PROFESSIONNEL;BAC PRO PROD;BAC PRO 25515 SYST.NUM.OPT.C RES.INF.SYST.COMM.;2;0;0;0;0;0;0;0;0;0;0;0;0;0
515.0;2021;20;AMIENS;MASCULIN;INDIVIDUEL;BAC PROFESSIONNEL;BAC PRO PROD;BAC PRO AG 21203 TECHN CONSEIL DE VENTE ANIMAL;1;1;1;0;0;0;0;1;0;0;0;0;1;0
519.0;2021;20;AMIENS;MASCULIN;INDIVIDUEL;BAC PROFESSIONNEL;BAC PRO SERV;BAC PRO 31206 VENTE (PROSPECT.NEGO.SUIV.CLIENT;2;1;0;1;0;0;0;0;0;0;0;0;0;1
523.0;2021;20;AMIENS;MASCULIN;INDIVIDUEL;BAC TECHNOLOGIQUE;BAC ST2S;BAC ST2S SCIENCES & TECHNO. SANTE & SOCIAL;3;3;2;1;0;0;0;2;0;0;0;0;2;1
527.0;2021;20;AMIENS;MASCULIN;INDIVIDUEL;BAC TECHNOLOGIQUE;BAC STI2D;BAC STI2D INNOVATION TECHNO.  ET ECO CONCEPTION;3;3;1;2;0;0;0;1;0;0;0;0;1;2
528.0;2021;20;AMIENS;MASCULIN;INDIVIDUEL;BAC TECHNOLOGIQUE;BAC STI2D;BAC STI2D SYSTÈME D'INFORMATION  ET NUMERIQUE;2;2;0;2;0;0;0;0;0;0;0;0;0;2
529.0;2021;20;AMIENS;MASCULIN;INDIVIDUEL;BAC TECHNOLOGIQUE;BAC STMG;BAC STMG GESTION ET FINANCE;3;3;2;1;0;0;0;2;0;0;0;0;2;1
530.0;2021;20;AMIENS;MASCULIN;INDIVIDUEL;BAC TECHNOLOGIQUE;BAC STMG;BAC STMG MERCATIQUE (MARKETING);8;8;1;5;2;2;0;3;0;0;0;1;2;5
539.0;2021;20;AMIENS;MASCULIN;SCOLAIRE;BAC PROFESSIONNEL;BAC PRO PROD;BAC PRO 22106 CUISINE;88;87;76;8;3;2;1;78;0;9;16;30;23;9
545.0;2021;20;AMIENS;MASCULIN;SCOLAIRE;BAC PROFESSIONNEL;BAC PRO PROD;BAC PRO 23005 TECHN. ETUDES BAT B ASSIST.ARCHI.;17;17;15;2;0;0;0;15;0;1;4;6;4;2
558.0;2021;20;AMIENS;MASCULIN;SCOLAIRE;BAC PROFESSIONNEL;BAC PRO PROD;BAC PRO 25006 MICROTECHNIQUES;11;11;10;1;0;0;0;10;0;1;2;3;4;1
567.0;2021;20;AMIENS;MASCULIN;SCOLAIRE;BAC PROFESSIONNEL;BAC PRO PROD;BAC PRO 25220 MAINT.MATERIELS OPT.B TP MANUT.;15;15;11;4;0;0;0;11;0;2;2;4;3;4
573.0;2021;20;AMIENS;MASCULIN;SCOLAIRE;BAC PROFESSIONNEL;BAC PRO PROD;BAC PRO 25509 TECHNIC. FROID CONDITIONNEMT AIR;29;29;17;10;2;1;1;18;0;0;3;3;12;11
575.0;2021;20;AMIENS;MASCULIN;SCOLAIRE;BAC PROFESSIONNEL;BAC PRO PROD;BAC PRO 25513 SYST.NUM.OPT.A SURETE SECURITE;62;62;51;10;1;1;0;52;0;2;7;27;16;10
587.0;2021;20;AMIENS;MASCULIN;SCOLAIRE;BAC PROFESSIONNEL;BAC PRO PROD;BAC PRO AG 22105 LABORATOIRE CONTROLE QUALITE;6;6;6;0;0;0;0;6;0;1;0;3;2;0
590.0;2021;20;AMIENS;MASCULIN;SCOLAIRE;BAC PROFESSIONNEL;BAC PRO SERV;BAC PRO 31106 LOGISTIQUE;70;70;46;13;11;8;3;54;0;0;6;13;35;16
606.0;2021;20;AMIENS;MASCULIN;SCOLAIRE;BAC TECHNOLOGIQUE;BAC ST2S;BAC ST2S SCIENCES & TECHNO. SANTE & SOCIAL;122;122;100;5;17;10;7;110;0;2;9;39;60;12
608.0;2021;20;AMIENS;MASCULIN;SCOLAIRE;BAC TECHNOLOGIQUE;BAC STD2A;BAC STD2A SCIENCES & TECHNO. DESIGN-ARTS APPLIQUES;19;19;19;0;0;0;0;19;0;1;9;7;2;0
618.0;2021;20;AMIENS;MASCULIN;SCOLAIRE;BAC TECHNOLOGIQUE;BAC STMG;BAC STMG RESSOURCES HUMAINES ET COMMUNICATION;262;262;214;14;34;23;11;237;0;0;15;74;148;25
628.0;2021;03;BESANCON;FEMININ;APPRENTISSAGE;BAC PROFESSIONNEL;BAC PRO PROD;BAC PRO AG 21114 CONDUITE PRODUCTIONS HORTICOLES;2;2;2;0;0;0;0;2;0;0;0;2;0;0
631.0;2021;03;BESANCON;FEMININ;APPRENTISSAGE;BAC PROFESSIONNEL;BAC PRO PROD;BAC PRO AG 21302 GEST MILIEUX NATURELS FAUNE;2;2;2;0;0;0;0;2;0;0;0;2;0;0
634.0;2021;03;BESANCON;FEMININ;APPRENTISSAGE;BAC PROFESSIONNEL;BAC PRO SERV;BAC PRO 30001 GESTION-ADMINISTRATION;5;5;5;0;0;0;0;5;0;1;1;2;1;0
637.0;2021;03;BESANCON;FEMININ;APPRENTISSAGE;BAC PROFESSIONNEL;BAC PRO SERV;BAC PRO 33003 ACC.SOINS-S.PERS. OPT.A DOMICILE;1;1;1;0;0;0;0;1;0;0;1;0;0;0
638.0;2021;03;BESANCON;FEMININ;APPRENTISSAGE;BAC PROFESSIONNEL;BAC PRO SERV;BAC PRO 33101 OPTIQUE LUNETTERIE;1;1;1;0;0;0;0;1;0;0;1;0;0;0
644.0;2021;03;BESANCON;FEMININ;ENSEIGNEMENT A DISTANCE;BAC TECHNOLOGIQUE;BAC ST2S;BAC ST2S SCIENCES & TECHNO. SANTE & SOCIAL;1;1;1;0;0;0;0;1;0;0;0;0;1;0
649.0;2021;03;BESANCON;FEMININ;INDIVIDUEL;BAC PROFESSIONNEL;BAC PRO PROD;BAC PRO AG 21004 CGEA;1;1;0;1;0;0;0;0;0;0;0;0;0;1
653.0;2021;03;BESANCON;FEMININ;INDIVIDUEL;BAC PROFESSIONNEL;BAC PRO SERV;BAC PRO 33002 SERVICES DE PROXIMITE  VIE LOCAL;1;0;0;0;0;0;0;0;0;0;0;0;0;0
655.0;2021;03;BESANCON;FEMININ;INDIVIDUEL;BAC PROFESSIONNEL;BAC PRO SERV;BAC PRO 33101 OPTIQUE LUNETTERIE;1;0;0;0;0;0;0;0;0;0;0;0;0;0
659.0;2021;03;BESANCON;FEMININ;INDIVIDUEL;BAC TECHNOLOGIQUE;BAC STMG;BAC STMG MERCATIQUE (MARKETING);2;2;0;2;0;0;0;0;0;0;0;0;0;2
660.0;2021;03;BESANCON;FEMININ;INDIVIDUEL;BAC TECHNOLOGIQUE;BAC STMG;BAC STMG RESSOURCES HUMAINES ET COMMUNICATION;4;1;0;0;1;0;1;0;0;0;0;0;0;1
662.0;2021;03;BESANCON;FEMININ;SCOLAIRE;BAC PROFESSIONNEL;BAC PRO PROD;BAC PRO 22004 PROC. CHIMIE EAU PAPIERS-CARTONS;2;2;1;0;1;1;0;2;0;0;0;1;1;0
666.0;2021;03;BESANCON;FEMININ;SCOLAIRE;BAC PROFESSIONNEL;BAC PRO PROD;BAC PRO 23102 TRAVAUX PUBLICS;1;1;1;0;0;0;0;1;0;0;0;1;0;0
677.0;2021;03;BESANCON;FEMININ;SCOLAIRE;BAC PROFESSIONNEL;BAC PRO PROD;BAC PRO 25106 TECHNICIEN D'USINAGE;5;5;3;2;0;0;0;3;0;0;1;1;1;2
681.0;2021;03;BESANCON;FEMININ;SCOLAIRE;BAC PROFESSIONNEL;BAC PRO PROD;BAC PRO 25510 METIERS ELECT. ENVIRON. CONNECTES;2;2;2;0;0;0;0;2;0;0;1;0;1;0
684.0;2021;03;BESANCON;FEMININ;SCOLAIRE;BAC PROFESSIONNEL;BAC PRO PROD;BAC PRO AG 21004 CGEA;31;30;30;0;0;0;0;30;0;0;5;14;11;0
697.0;2021;03;BESANCON;FEMININ;SCOLAIRE;BAC PROFESSIONNEL;BAC PRO SERV;BAC PRO 31210 ACCUEIL -RELATION CLIENTS USAGERS;41;41;35;4;2;2;0;37;0;2;8;11;16;4
701.0;2021;03;BESANCON;FEMININ;SCOLAIRE;BAC PROFESSIONNEL;BAC PRO SERV;BAC PRO 33101 OPTIQUE LUNETTERIE;15;15;15;0;0;0;0;15;0;0;6;6;3;0
710.0;2021;03;BESANCON;FEMININ;SCOLAIRE;BAC TECHNOLOGIQUE;BAC STAV;BAC STAV AGRONOMIE ALIM ENV TERRITOI;71;71;71;0;0;0;0;71;0;2;19;33;17;0
716.0;2021;03;BESANCON;FEMININ;SCOLAIRE;BAC TECHNOLOGIQUE;BAC STI2D;BAC STI2D SYSTÈME D'INFORMATION  ET NUMERIQUE;6;6;6;0;0;0;0;6;0;1;1;3;1;0
717.0;2021;03;BESANCON;FEMININ;SCOLAIRE;BAC TECHNOLOGIQUE;BAC STL;BAC STL BIOCHIM.-BIOLOGIE-BIOTECHNOL.;62;62;58;0;4;2;2;60;1;2;10;24;23;2
719.0;2021;03;BESANCON;FEMININ;SCOLAIRE;BAC TECHNOLOGIQUE;BAC STMG;BAC STMG GESTION ET FINANCE;91;91;85;4;2;2;0;87;0;3;22;29;33;4
725.0;2021;03;BESANCON;MASCULIN;APPRENTISSAGE;BAC PROFESSIONNEL;BAC PRO PROD;BAC PRO 22704 TECHN. MAINT. SYST.ENERG.CLIMATI;4;4;3;1;0;0;0;3;0;0;0;2;1;1
731.0;2021;03;BESANCON;MASCULIN;APPRENTISSAGE;BAC PROFESSIONNEL;BAC PRO PROD;BAC PRO 23405 TECHNICIEN MENUISIER AGENCEUR;12;12;10;1;1;1;0;11;0;1;3;6;1;1
732.0;2021;03;BESANCON;MASCULIN;APPRENTISSAGE;BAC PROFESSIONNEL;BAC PRO PROD;BAC PRO 23407 TECHNIC.FAB.BOIS ET MATERX ASSOC;1;1;1;0;0;0;0;1;0;0;1;0;0;0
736.0;2021;03;BESANCON;MASCULIN;APPRENTISSAGE;BAC PROFESSIONNEL;BAC PRO PROD;BAC PRO 25106 TECHNICIEN D'USINAGE;23;23;19;2;2;0;2;19;0;2;4;7;6;4
737.0;2021;03;BESANCON;MASCULIN;APPRENTISSAGE;BAC PROFESSIONNEL;BAC PRO PROD;BAC PRO 25107 TECHNICIEN OUTILLEUR;9;9;7;1;1;0;1;7;0;0;2;4;1;2
738.0;2021;03;BESANCON;MASCULIN;APPRENTISSAGE;BAC PROFESSIONNEL;BAC PRO PROD;BAC PRO 25214 MAINT.VEHIC.OPTA VOIT.PARTICUL.;63;62;54;8;0;0;0;54;0;2;14;21;17;8
748.0;2021;03;BESANCON;MASCULIN;APPRENTISSAGE;BAC PROFESSIONNEL;BAC PRO PROD;BAC PRO 25510 METIERS ELECT. ENVIRON. CONNECTES;30;30;28;2;0;0;0;28;0;5;6;7;10;2
749.0;2021;03;BESANCON;MASCULIN;APPRENTISSAGE;BAC PROFESSIONNEL;BAC PRO PROD;BAC PRO 25515 SYST.NUM.OPT.C RES.INF.SYST.COMM.;6;5;5;0;0;0;0;5;0;0;1;3;1;0
751.0;2021;03;BESANCON;MASCULIN;APPRENTISSAGE;BAC PROFESSIONNEL;BAC PRO PROD;BAC PRO AG 21004 CGEA;54;50;46;4;0;0;0;46;0;1;7;15;23;4
758.0;2021;03;BESANCON;MASCULIN;APPRENTISSAGE;BAC PROFESSIONNEL;BAC PRO SERV;BAC PRO 30001 GESTION-ADMINISTRATION;1;1;1;0;0;0;0;1;0;0;0;1;0;0
759.0;2021;03;BESANCON;MASCULIN;APPRENTISSAGE;BAC PROFESSIONNEL;BAC PRO SERV;BAC PRO 31106 LOGISTIQUE;6;6;3;3;0;0;0;3;0;0;0;2;1;3
763.0;2021;03;BESANCON;MASCULIN;APPRENTISSAGE;BAC PROFESSIONNEL;BAC PRO SERV;BAC PRO 33102 PROTHESE DENTAIRE;2;2;1;1;0;0;0;1;0;0;1;0;0;1
770.0;2021;03;BESANCON;MASCULIN;ENSEIGNEMENT A DISTANCE;BAC TECHNOLOGIQUE;BAC ST2S;BAC ST2S SCIENCES & TECHNO. SANTE & SOCIAL;1;1;1;0;0;0;0;1;0;0;0;1;0;0
775.0;2021;03;BESANCON;MASCULIN;FORMATION CONTINUE;BAC PROFESSIONNEL;BAC PRO SERV;BAC PRO 33101 OPTIQUE LUNETTERIE;3;3;2;1;0;0;0;2;0;1;1;0;0;1
780.0;2021;03;BESANCON;MASCULIN;INDIVIDUEL;BAC PROFESSIONNEL;BAC PRO PROD;BAC PRO 25515 SYST.NUM.OPT.C RES.INF.SYST.COMM.;1;0;0;0;0;0;0;0;0;0;0;0;0;0
781.0;2021;03;BESANCON;MASCULIN;INDIVIDUEL;BAC PROFESSIONNEL;BAC PRO PROD;BAC PRO AG 21004 CGEA;1;1;1;0;0;0;0;1;0;0;0;0;1;0
793.0;2021;03;BESANCON;MASCULIN;SCOLAIRE;BAC PROFESSIONNEL;BAC PRO PROD;BAC PRO 22004 PROC. CHIMIE EAU PAPIERS-CARTONS;6;6;6;0;0;0;0;6;0;0;3;2;1;0
797.0;2021;03;BESANCON;MASCULIN;SCOLAIRE;BAC PROFESSIONNEL;BAC PRO PROD;BAC PRO 22704 TECHN. MAINT. SYST.ENERG.CLIMATI;24;24;19;5;0;0;0;19;0;1;4;8;6;5
803.0;2021;03;BESANCON;MASCULIN;SCOLAIRE;BAC PROFESSIONNEL;BAC PRO PROD;BAC PRO 23207 INTERV. SUR PATRIMOINE BATI OPT.C;2;2;2;0;0;0;0;2;0;0;0;2;0;0
805.0;2021;03;BESANCON;MASCULIN;SCOLAIRE;BAC PROFESSIONNEL;BAC PRO PROD;BAC PRO 23404 TECHNICIEN CONSTRUCTEUR BOIS;25;25;23;1;1;1;0;24;0;0;5;12;7;1
809.0;2021;03;BESANCON;MASCULIN;SCOLAIRE;BAC PROFESSIONNEL;BAC PRO PROD;BAC PRO 24302 METIERS DU CUIR : MAROQUINERIE;2;2;1;1;0;0;0;1;0;0;0;1;0;1
816.0;2021;03;BESANCON;MASCULIN;SCOLAIRE;BAC PROFESSIONNEL;BAC PRO PROD;BAC PRO 25215 MAINT.VEHIC.OPTB VEHIC.TRANS.ROUT;9;9;8;0;1;1;0;9;0;0;2;3;4;0
828.0;2021;03;BESANCON;MASCULIN;SCOLAIRE;BAC PROFESSIONNEL;BAC PRO PROD;BAC PRO AG 21114 CONDUITE PRODUCTIONS HORTICOLES;3;3;3;0;0;0;0;3;0;0;0;0;3;0
834.0;2021;03;BESANCON;MASCULIN;SCOLAIRE;BAC PROFESSIONNEL;BAC PRO PROD;BAC PRO AG 21406 TEC CONS VTE PROD DES JARDINS;2;2;2;0;0;0;0;2;0;0;1;1;0;0
838.0;2021;03;BESANCON;MASCULIN;SCOLAIRE;BAC PROFESSIONNEL;BAC PRO SERV;BAC PRO 31107 CONDUCT. TRANSP.ROUT.MARCHANDISES;49;49;37;11;1;0;1;37;0;2;13;12;10;12
841.0;2021;03;BESANCON;MASCULIN;SCOLAIRE;BAC PROFESSIONNEL;BAC PRO SERV;BAC PRO 31210 ACCUEIL -RELATION CLIENTS USAGERS;20;20;15;3;2;2;0;17;0;1;3;6;7;3
857.0;2021;03;BESANCON;MASCULIN;SCOLAIRE;BAC TECHNOLOGIQUE;BAC STI2D;BAC STI2D SYSTÈME D'INFORMATION  ET NUMERIQUE;114;114;106;2;6;3;3;109;0;3;9;48;49;5
859.0;2021;03;BESANCON;MASCULIN;SCOLAIRE;BAC TECHNOLOGIQUE;BAC STL;BAC STL SCIENCES PHYSIQUES CHIMIQUES  EN LABORAT.;38;38;37;0;1;1;0;38;0;0;4;18;16;0
865.0;2021;04;BORDEAUX;FEMININ;APPRENTISSAGE;BAC PROFESSIONNEL;BAC PRO PROD;BAC PRO 22106 CUISINE;14;13;11;1;1;1;0;12;0;0;3;1;8;1
867.0;2021;04;BORDEAUX;FEMININ;APPRENTISSAGE;BAC PROFESSIONNEL;BAC PRO PROD;BAC PRO 25007 MAINTENANCE EQUIPEMENTS INDUST.;2;2;2;0;0;0;0;2;0;0;1;1;0;0
870.0;2021;04;BORDEAUX;FEMININ;APPRENTISSAGE;BAC PROFESSIONNEL;BAC PRO PROD;BAC PRO 25215 MAINT.VEHIC.OPTB VEHIC.TRANS.ROUT;1;1;1;0;0;0;0;1;0;0;0;1;0;0
874.0;2021;04;BORDEAUX;FEMININ;APPRENTISSAGE;BAC PROFESSIONNEL;BAC PRO PROD;BAC PRO 25411 TECH.CHAUDRONNERIE INDUSTRIELLE;3;3;3;0;0;0;0;3;0;0;1;1;1;0
893.0;2021;04;BORDEAUX;FEMININ;APPRENTISSAGE;BAC PROFESSIONNEL;BAC PRO SERV;BAC PRO 33403 COMMERC. SERVICES EN RESTAURATION;14;14;12;2;0;0;0;12;0;0;3;5;4;2
900.0;2021;04;BORDEAUX;FEMININ;ENSEIGNEMENT A DISTANCE;BAC PROFESSIONNEL;BAC PRO SERV;BAC PRO 32207 REAL.PR.IMPR.PLURI.OPTA.PR.GRAPH.;1;1;1;0;0;0;0;1;0;0;0;0;1;0
904.0;2021;04;BORDEAUX;FEMININ;ENSEIGNEMENT A DISTANCE;BAC TECHNOLOGIQUE;BAC ST2S;BAC ST2S SCIENCES & TECHNO. SANTE & SOCIAL;11;11;10;0;1;0;1;10;0;0;4;3;3;1
917.0;2021;04;BORDEAUX;FEMININ;INDIVIDUEL;BAC PROFESSIONNEL;BAC PRO PROD;BAC PRO 23004 TECHN. ETUDES BAT.A ETUDES & ECO.;1;1;0;1;0;0;0;0;0;0;0;0;0;1
921.0;2021;04;BORDEAUX;FEMININ;INDIVIDUEL;BAC PROFESSIONNEL;BAC PRO PROD;BAC PRO AG 21302 GEST MILIEUX NATURELS FAUNE;1;0;0;0;0;0;0;0;0;0;0;0;0;0
929.0;2021;04;BORDEAUX;FEMININ;INDIVIDUEL;BAC PROFESSIONNEL;BAC PRO SERV;BAC PRO 33004 ACC.SOINS-S.PERS. OPT.EN STRUCTUR;3;3;2;1;0;0;0;2;0;0;0;2;0;1
931.0;2021;04;BORDEAUX;FEMININ;INDIVIDUEL;BAC PROFESSIONNEL;BAC PRO SERV;BAC PRO 33603 ESTHETIQUE COSMETIQUE PARFUMERIE;4;1;1;0;0;0;0;1;0;0;0;0;1;0
936.0;2021;04;BORDEAUX;FEMININ;INDIVIDUEL;BAC TECHNOLOGIQUE;BAC STL;BAC STL SCIENCES PHYSIQUES CHIMIQUES  EN LABORAT.;1;0;0;0;0;0;0;0;0;0;0;0;0;0
938.0;2021;04;BORDEAUX;FEMININ;INDIVIDUEL;BAC TECHNOLOGIQUE;BAC STMG;BAC STMG MERCATIQUE (MARKETING);9;6;4;1;1;1;0;5;0;0;1;2;2;1
941.0;2021;04;BORDEAUX;FEMININ;SCOLAIRE;BAC GENERAL;BAC GENERAL;BAC GENE 10019 BAC GENERAL;10399;10398;10118;49;231;126;105;10244;164;1249;3041;3756;2034;154
961.0;2021;04;BORDEAUX;FEMININ;SCOLAIRE;BAC PROFESSIONNEL;BAC PRO PROD;BAC PRO 24203 METIERS DE LA MODE - VÊTEMENT;107;107;93;12;2;2;0;95;0;10;28;34;23;12
963.0;2021;04;BORDEAUX;FEMININ;SCOLAIRE;BAC PROFESSIONNEL;BAC PRO PROD;BAC PRO 25009 MAINTENANCE NAUTIQUE;2;2;2;0;0;0;0;2;0;0;0;1;1;0
964.0;2021;04;BORDEAUX;FEMININ;SCOLAIRE;BAC PROFESSIONNEL;BAC PRO PROD;BAC PRO 25106 TECHNICIEN D'USINAGE;3;3;3;0;0;0;0;3;0;0;1;1;1;0
969.0;2021;04;BORDEAUX;FEMININ;SCOLAIRE;BAC PROFESSIONNEL;BAC PRO PROD;BAC PRO 25304 AERONAUTIQUE OPTION STRUCTURE;2;2;2;0;0;0;0;2;0;0;1;0;1;0
977.0;2021;04;BORDEAUX;FEMININ;SCOLAIRE;BAC PROFESSIONNEL;BAC PRO PROD;BAC PRO AG 21004 CGEA;65;62;53;9;0;0;0;53;0;1;13;14;25;9
979.0;2021;04;BORDEAUX;FEMININ;SCOLAIRE;BAC PROFESSIONNEL;BAC PRO PROD;BAC PRO AG 21114 CONDUITE PRODUCTIONS HORTICOLES;15;14;14;0;0;0;0;14;0;0;0;6;8;0
984.0;2021;04;BORDEAUX;FEMININ;SCOLAIRE;BAC PROFESSIONNEL;BAC PRO PROD;BAC PRO AG 21302 GEST MILIEUX NATURELS FAUNE;21;21;18;3;0;0;0;18;0;3;6;7;2;3
985.0;2021;04;BORDEAUX;FEMININ;SCOLAIRE;BAC PROFESSIONNEL;BAC PRO PROD;BAC PRO AG 21405 AMENAGEMENTS PAYSAGERS;10;9;9;0;0;0;0;9;0;0;2;4;3;0
992.0;2021;04;BORDEAUX;FEMININ;SCOLAIRE;BAC PROFESSIONNEL;BAC PRO SERV;BAC PRO 31107 CONDUCT. TRANSP.ROUT.MARCHANDISES;1;0;0;0;0;0;0;0;0;0;0;0;0;0
996.0;2021;04;BORDEAUX;FEMININ;SCOLAIRE;BAC PROFESSIONNEL;BAC PRO SERV;BAC PRO 31210 ACCUEIL -RELATION CLIENTS USAGERS;219;219;186;20;13;10;3;196;0;17;37;73;69;23
998.0;2021;04;BORDEAUX;FEMININ;SCOLAIRE;BAC PROFESSIONNEL;BAC PRO SERV;BAC PRO 32208 REAL.PR.IMPR.PLURI.OPTB.PR.IMPR.;2;2;2;0;0;0;0;2;0;1;1;0;0;0
999.0;2021;04;BORDEAUX;FEMININ;SCOLAIRE;BAC PROFESSIONNEL;BAC PRO SERV;BAC PRO 32303 ART.& MET.ART:COM.VIS.VIS.PLURI-M;49;49;45;4;0;0;0;45;0;2;19;18;6;4
1000.0;2021;04;BORDEAUX;FEMININ;SCOLAIRE;BAC PROFESSIONNEL;BAC PRO SERV;BAC PRO 32304 PHOTOGRAPHIE;30;30;29;0;1;1;0;30;0;1;9;11;9;0
1004.0;2021;04;BORDEAUX;FEMININ;SCOLAIRE;BAC PROFESSIONNEL;BAC PRO SERV;BAC PRO 33101 OPTIQUE LUNETTERIE;8;8;8;0;0;0;0;8;0;0;1;3;4;0
1011.0;2021;04;BORDEAUX;FEMININ;SCOLAIRE;BAC PROFESSIONNEL;BAC PRO SERV;BAC PRO AG 33002 SERV PERS TERRIT;419;409;394;15;0;0;0;394;0;22;76;142;154;15
1015.0;2021;04;BORDEAUX;FEMININ;SCOLAIRE;BAC TECHNOLOGIQUE;BAC STD2A;BAC STD2A SCIENCES & TECHNO. DESIGN-ARTS APPLIQUES;178;178;174;0;4;2;2;176;2;10;70;69;25;2
1017.0;2021;04;BORDEAUX;FEMININ;SCOLAIRE;BAC TECHNOLOGIQUE;BAC STI2D;BAC STI2D ARCHITECTURE ET CONSTRUCTION;64;64;60;0;4;3;1;63;0;4;17;30;12;1
1021.0;2021;04;BORDEAUX;FEMININ;SCOLAIRE;BAC TECHNOLOGIQUE;BAC STL;BAC STL BIOCHIM.-BIOLOGIE-BIOTECHNOL.;143;143;138;0;5;4;1;142;0;9;27;49;57;1
1022.0;2021;04;BORDEAUX;FEMININ;SCOLAIRE;BAC TECHNOLOGIQUE;BAC STL;BAC STL SCIENCES PHYSIQUES CHIMIQUES  EN LABORAT.;91;91;82;1;8;6;2;88;0;5;14;33;36;3
1026.0;2021;04;BORDEAUX;FEMININ;SCOLAIRE;BAC TECHNOLOGIQUE;BAC STMG;BAC STMG SYSTEMES D'INFORMATION DE GESTION;12;12;12;0;0;0;0;12;0;2;0;5;5;0
1028.0;2021;04;BORDEAUX;MASCULIN;APPRENTISSAGE;BAC PROFESSIONNEL;BAC PRO PROD;BAC PRO 20102 PILOTE DE LIGNE DE PRODUCTION;23;22;18;3;1;1;0;19;0;4;5;4;6;3
1029.0;2021;04;BORDEAUX;MASCULIN;APPRENTISSAGE;BAC PROFESSIONNEL;BAC PRO PROD;BAC PRO 22106 CUISINE;19;18;16;1;1;1;0;17;0;1;5;5;6;1
1032.0;2021;04;BORDEAUX;MASCULIN;APPRENTISSAGE;BAC PROFESSIONNEL;BAC PRO PROD;BAC PRO 23004 TECHN. ETUDES BAT.A ETUDES & ECO.;1;1;0;1;0;0;0;0;0;0;0;0;0;1
1039.0;2021;04;BORDEAUX;MASCULIN;APPRENTISSAGE;BAC PROFESSIONNEL;BAC PRO PROD;BAC PRO 23406 TECHNICIEN DE SCIERIE;1;1;1;0;0;0;0;1;0;1;0;0;0;0
1048.0;2021;04;BORDEAUX;MASCULIN;APPRENTISSAGE;BAC PROFESSIONNEL;BAC PRO PROD;BAC PRO 25219 MAINT.MATERIELS OPT.A AGRICOLES;2;2;2;0;0;0;0;2;0;0;0;1;1;0
1064.0;2021;04;BORDEAUX;MASCULIN;APPRENTISSAGE;BAC PROFESSIONNEL;BAC PRO PROD;BAC PRO AG 21303 FORET;10;10;10;0;0;0;0;10;0;0;2;1;7;0
1066.0;2021;04;BORDEAUX;MASCULIN;APPRENTISSAGE;BAC PROFESSIONNEL;BAC PRO PROD;BAC PRO AG 22106 TEC CONS VTE ALIMENTATION VINS SP;2;2;2;0;0;0;0;2;0;1;0;1;0;0
1073.0;2021;04;BORDEAUX;MASCULIN;APPRENTISSAGE;BAC PROFESSIONNEL;BAC PRO SERV;BAC PRO 32207 REAL.PR.IMPR.PLURI.OPTA.PR.GRAPH.;1;1;1;0;0;0;0;1;0;0;0;1;0;0
1090.0;2021;04;BORDEAUX;MASCULIN;ENSEIGNEMENT A DISTANCE;BAC TECHNOLOGIQUE;BAC STMG;BAC STMG RESSOURCES HUMAINES ET COMMUNICATION;10;9;8;0;1;0;1;8;0;3;1;1;3;1
1095.0;2021;04;BORDEAUX;MASCULIN;FORMATION CONTINUE;BAC PROFESSIONNEL;BAC PRO PROD;BAC PRO 25510 METIERS ELECT. ENVIRON. CONNECTES;1;1;1;0;0;0;0;1;0;1;0;0;0;0
1096.0;2021;04;BORDEAUX;MASCULIN;FORMATION CONTINUE;BAC PROFESSIONNEL;BAC PRO PROD;BAC PRO AG 21113 CGEVV;1;1;1;0;0;0;0;1;0;0;0;0;1;0
1100.0;2021;04;BORDEAUX;MASCULIN;FORMATION CONTINUE;BAC PROFESSIONNEL;BAC PRO SERV;BAC PRO 31106 LOGISTIQUE;1;1;1;0;0;0;0;1;0;0;0;0;1;0
1110.0;2021;04;BORDEAUX;MASCULIN;INDIVIDUEL;BAC PROFESSIONNEL;BAC PRO PROD;BAC PRO 25214 MAINT.VEHIC.OPTA VOIT.PARTICUL.;1;1;0;1;0;0;0;0;0;0;0;0;0;1
1111.0;2021;04;BORDEAUX;MASCULIN;INDIVIDUEL;BAC PROFESSIONNEL;BAC PRO PROD;BAC PRO 25220 MAINT.MATERIELS OPT.B TP MANUT.;1;1;1;0;0;0;0;1;0;0;0;0;1;0
1125.0;2021;04;BORDEAUX;MASCULIN;INDIVIDUEL;BAC PROFESSIONNEL;BAC PRO SERV;BAC PRO 34304 HYGIENE PROPRETE STERILISATION;1;0;0;0;0;0;0;0;0;0;0;0;0;0
1127.0;2021;04;BORDEAUX;MASCULIN;INDIVIDUEL;BAC TECHNOLOGIQUE;BAC S2TMD;BAC S2TMD MUSIQUE;1;1;1;0;0;0;0;1;0;0;0;1;0;0
1143.0;2021;04;BORDEAUX;MASCULIN;SCOLAIRE;BAC PROFESSIONNEL;BAC PRO PROD;BAC PRO 22503 PLASTIQUES ET COMPOSITES;41;41;33;6;2;2;0;35;0;1;9;13;12;6
1147.0;2021;04;BORDEAUX;MASCULIN;SCOLAIRE;BAC PROFESSIONNEL;BAC PRO PROD;BAC PRO 23005 TECHN. ETUDES BAT B ASSIST.ARCHI.;9;8;8;0;0;0;0;8;0;1;2;3;2;0
1170.0;2021;04;BORDEAUX;MASCULIN;SCOLAIRE;BAC PROFESSIONNEL;BAC PRO PROD;BAC PRO 25302 AERONAUTIQUE OPTION AVIONIQUE;11;11;11;0;0;0;0;11;0;0;7;2;2;0
1171.0;2021;04;BORDEAUX;MASCULIN;SCOLAIRE;BAC PROFESSIONNEL;BAC PRO PROD;BAC PRO 25303 AERONAUTIQUE OPTION SYSTEMES;46;46;45;1;0;0;0;45;0;7;20;13;5;1
1174.0;2021;04;BORDEAUX;MASCULIN;SCOLAIRE;BAC PROFESSIONNEL;BAC PRO PROD;BAC PRO 25408 REPARATION DES CARROSSERIES;31;31;23;7;1;0;1;23;0;0;3;12;8;8
1175.0;2021;04;BORDEAUX;MASCULIN;SCOLAIRE;BAC PROFESSIONNEL;BAC PRO PROD;BAC PRO 25411 TECH.CHAUDRONNERIE INDUSTRIELLE;136;135;108;25;2;2;0;110;0;4;29;40;37;25
1176.0;2021;04;BORDEAUX;MASCULIN;SCOLAIRE;BAC PROFESSIONNEL;BAC PRO PROD;BAC PRO 25509 TECHNIC. FROID CONDITIONNEMT AIR;52;52;39;10;3;2;1;41;0;3;4;17;17;11
1178.0;2021;04;BORDEAUX;MASCULIN;SCOLAIRE;BAC PROFESSIONNEL;BAC PRO PROD;BAC PRO 25513 SYST.NUM.OPT.A SURETE SECURITE;43;43;33;9;1;1;0;34;0;0;7;16;11;9
1179.0;2021;04;BORDEAUX;MASCULIN;SCOLAIRE;BAC PROFESSIONNEL;BAC PRO PROD;BAC PRO 25514 SYST.NUM.OPT.B AUD.RES.EQUIP.DOM.;121;120;101;16;3;3;0;104;0;3;25;46;30;16
1183.0;2021;04;BORDEAUX;MASCULIN;SCOLAIRE;BAC PROFESSIONNEL;BAC PRO PROD;BAC PRO AG 21113 CGEVV;24;23;16;7;0;0;0;16;0;0;2;7;7;7
1184.0;2021;04;BORDEAUX;MASCULIN;SCOLAIRE;BAC PROFESSIONNEL;BAC PRO PROD;BAC PRO AG 21114 CONDUITE PRODUCTIONS HORTICOLES;13;13;11;2;0;0;0;11;0;0;4;2;5;2
1204.0;2021;04;BORDEAUX;MASCULIN;SCOLAIRE;BAC PROFESSIONNEL;BAC PRO SERV;BAC PRO 32208 REAL.PR.IMPR.PLURI.OPTB.PR.IMPR.;15;15;9;6;0;0;0;9;0;0;2;3;4;6
1212.0;2021;04;BORDEAUX;MASCULIN;SCOLAIRE;BAC PROFESSIONNEL;BAC PRO SERV;BAC PRO 33403 COMMERC. SERVICES EN RESTAURATION;100;100;91;6;3;2;1;93;0;5;14;35;39;7
1233.0;2021;06;CLERMONT-FERRAND;FEMININ;APPRENTISSAGE;BAC PROFESSIONNEL;BAC PRO PROD;BAC PRO 22106 CUISINE;3;2;2;0;0;0;0;2;0;0;0;1;1;0
1237.0;2021;06;CLERMONT-FERRAND;FEMININ;APPRENTISSAGE;BAC PROFESSIONNEL;BAC PRO PROD;BAC PRO 23304 AMENAGEMENT FINITION BATIMENT;1;1;1;0;0;0;0;1;0;0;0;1;0;0
1243.0;2021;06;CLERMONT-FERRAND;FEMININ;APPRENTISSAGE;BAC PROFESSIONNEL;BAC PRO PROD;BAC PRO 25303 AERONAUTIQUE OPTION SYSTEMES;1;1;0;0;1;1;0;1;0;0;0;0;1;0
1247.0;2021;06;CLERMONT-FERRAND;FEMININ;APPRENTISSAGE;BAC PROFESSIONNEL;BAC PRO PROD;BAC PRO AG 21210 COND GEST ENTR CANIN ET FELIN;8;7;7;0;0;0;0;7;0;0;0;1;6;0
1253.0;2021;06;CLERMONT-FERRAND;FEMININ;ENSEIGNEMENT A DISTANCE;BAC GENERAL;BAC GENERAL;BAC GENE 10019 BAC GENERAL;31;31;26;5;0;0;0;26;0;3;13;9;1;5
1254.0;2021;06;CLERMONT-FERRAND;FEMININ;ENSEIGNEMENT A DISTANCE;BAC PROFESSIONNEL;BAC PRO PROD;BAC PRO AG 21004 CGEA;57;56;47;9;0;0;0;47;0;0;1;0;46;9
1260.0;2021;06;CLERMONT-FERRAND;FEMININ;ENSEIGNEMENT A DISTANCE;BAC TECHNOLOGIQUE;BAC STAV;BAC STAV AGRONOMIE ALIM ENV TERRITOI;9;8;8;0;0;0;0;8;0;0;0;2;6;0
1272.0;2021;06;CLERMONT-FERRAND;FEMININ;INDIVIDUEL;BAC PROFESSIONNEL;BAC PRO PROD;BAC PRO AG 21114 CONDUITE PRODUCTIONS HORTICOLES;5;4;4;0;0;0;0;4;0;0;0;0;4;0
1278.0;2021;06;CLERMONT-FERRAND;FEMININ;INDIVIDUEL;BAC PROFESSIONNEL;BAC PRO SERV;BAC PRO 33004 ACC.SOINS-S.PERS. OPT.EN STRUCTUR;1;1;1;0;0;0;0;1;0;0;0;0;1;0
1281.0;2021;06;CLERMONT-FERRAND;FEMININ;INDIVIDUEL;BAC TECHNOLOGIQUE;BAC ST2S;BAC ST2S SCIENCES & TECHNO. SANTE & SOCIAL;2;2;0;1;1;1;0;1;0;0;0;0;1;1
1285.0;2021;06;CLERMONT-FERRAND;FEMININ;SCOLAIRE;BAC GENERAL;BAC GENERAL;BAC GENE 10019 BAC GENERAL;3838;3838;3725;15;98;61;37;3786;57;456;993;1345;935;52
1290.0;2021;06;CLERMONT-FERRAND;FEMININ;SCOLAIRE;BAC PROFESSIONNEL;BAC PRO PROD;BAC PRO 22703 TECHN.INSTALL.SYST.ENERG.CLIMATI;1;1;1;0;0;0;0;1;0;1;0;0;0;0
1293.0;2021;06;CLERMONT-FERRAND;FEMININ;SCOLAIRE;BAC PROFESSIONNEL;BAC PRO PROD;BAC PRO 23005 TECHN. ETUDES BAT B ASSIST.ARCHI.;2;2;2;0;0;0;0;2;0;1;0;1;0;0
1300.0;2021;06;CLERMONT-FERRAND;FEMININ;SCOLAIRE;BAC PROFESSIONNEL;BAC PRO PROD;BAC PRO 25214 MAINT.VEHIC.OPTA VOIT.PARTICUL.;1;1;1;0;0;0;0;1;0;0;0;1;0;0
1301.0;2021;06;CLERMONT-FERRAND;FEMININ;SCOLAIRE;BAC PROFESSIONNEL;BAC PRO PROD;BAC PRO 25215 MAINT.VEHIC.OPTB VEHIC.TRANS.ROUT;2;2;1;1;0;0;0;1;0;0;0;1;0;1
1306.0;2021;06;CLERMONT-FERRAND;FEMININ;SCOLAIRE;BAC PROFESSIONNEL;BAC PRO PROD;BAC PRO 25515 SYST.NUM.OPT.C RES.INF.SYST.COMM.;2;2;2;0;0;0;0;2;0;0;0;2;0;0
1315.0;2021;06;CLERMONT-FERRAND;FEMININ;SCOLAIRE;BAC PROFESSIONNEL;BAC PRO PROD;BAC PRO AG 21303 FORET;2;2;2;0;0;0;0;2;0;0;1;0;1;0
1318.0;2021;06;CLERMONT-FERRAND;FEMININ;SCOLAIRE;BAC PROFESSIONNEL;BAC PRO PROD;BAC PRO AG 22105 LABORATOIRE CONTROLE QUALITE;3;3;3;0;0;0;0;3;0;0;2;1;0;0
1325.0;2021;06;CLERMONT-FERRAND;FEMININ;SCOLAIRE;BAC PROFESSIONNEL;BAC PRO SERV;BAC PRO 31210 ACCUEIL -RELATION CLIENTS USAGERS;84;84;65;14;5;3;2;68;0;2;13;23;30;16
1327.0;2021;06;CLERMONT-FERRAND;FEMININ;SCOLAIRE;BAC PROFESSIONNEL;BAC PRO SERV;BAC PRO 32208 REAL.PR.IMPR.PLURI.OPTB.PR.IMPR.;3;3;3;0;0;0;0;3;0;0;1;0;2;0
1331.0;2021;06;CLERMONT-FERRAND;FEMININ;SCOLAIRE;BAC PROFESSIONNEL;BAC PRO SERV;BAC PRO 33003 ACC.SOINS-S.PERS. OPT.A DOMICILE;38;38;21;14;3;1;2;22;0;0;2;11;9;16
1333.0;2021;06;CLERMONT-FERRAND;FEMININ;SCOLAIRE;BAC PROFESSIONNEL;BAC PRO SERV;BAC PRO 33101 OPTIQUE LUNETTERIE;16;16;16;0;0;0;0;16;0;1;4;5;6;0
1339.0;2021;06;CLERMONT-FERRAND;FEMININ;SCOLAIRE;BAC PROFESSIONNEL;BAC PRO SERV;BAC PRO AG 33002 SERV PERS TERRIT;171;171;162;9;0;0;0;162;0;2;22;71;67;9
1347.0;2021;06;CLERMONT-FERRAND;FEMININ;SCOLAIRE;BAC TECHNOLOGIQUE;BAC STI2D;BAC STI2D SYSTÈME D'INFORMATION  ET NUMERIQUE;8;8;8;0;0;0;0;8;0;0;0;3;5;0
1356.0;2021;06;CLERMONT-FERRAND;MASCULIN;APPRENTISSAGE;BAC PROFESSIONNEL;BAC PRO PROD;BAC PRO 22106 CUISINE;6;5;4;1;0;0;0;4;0;0;0;1;3;1
1363.0;2021;06;CLERMONT-FERRAND;MASCULIN;APPRENTISSAGE;BAC PROFESSIONNEL;BAC PRO PROD;BAC PRO 23404 TECHNICIEN CONSTRUCTEUR BOIS;4;3;3;0;0;0;0;3;0;1;0;2;0;0
1366.0;2021;06;CLERMONT-FERRAND;MASCULIN;APPRENTISSAGE;BAC PROFESSIONNEL;BAC PRO PROD;BAC PRO 25007 MAINTENANCE EQUIPEMENTS INDUST.;40;40;34;3;3;2;1;36;0;2;10;13;11;4
1371.0;2021;06;CLERMONT-FERRAND;MASCULIN;APPRENTISSAGE;BAC PROFESSIONNEL;BAC PRO PROD;BAC PRO 25216 MAINT.VEHIC.OPTC MOTOCYCLES;6;6;6;0;0;0;0;6;0;0;3;2;1;0
1373.0;2021;06;CLERMONT-FERRAND;MASCULIN;APPRENTISSAGE;BAC PROFESSIONNEL;BAC PRO PROD;BAC PRO 25220 MAINT.MATERIELS OPT.B TP MANUT.;2;2;2;0;0;0;0;2;0;0;1;0;1;0
1375.0;2021;06;CLERMONT-FERRAND;MASCULIN;APPRENTISSAGE;BAC PROFESSIONNEL;BAC PRO PROD;BAC PRO 25302 AERONAUTIQUE OPTION AVIONIQUE;1;1;1;0;0;0;0;1;0;0;0;1;0;0
1380.0;2021;06;CLERMONT-FERRAND;MASCULIN;APPRENTISSAGE;BAC PROFESSIONNEL;BAC PRO PROD;BAC PRO 25509 TECHNIC. FROID CONDITIONNEMT AIR;12;12;8;3;1;1;0;9;0;0;0;4;5;3
1383.0;2021;06;CLERMONT-FERRAND;MASCULIN;APPRENTISSAGE;BAC PROFESSIONNEL;BAC PRO PROD;BAC PRO AG 21210 COND GEST ENTR CANIN ET FELIN;6;6;6;0;0;0;0;6;0;0;0;3;3;0
1385.0;2021;06;CLERMONT-FERRAND;MASCULIN;APPRENTISSAGE;BAC PROFESSIONNEL;BAC PRO PROD;BAC PRO AG 21405 AMENAGEMENTS PAYSAGERS;7;7;7;0;0;0;0;7;0;0;1;1;5;0
1386.0;2021;06;CLERMONT-FERRAND;MASCULIN;APPRENTISSAGE;BAC PROFESSIONNEL;BAC PRO PROD;BAC PRO AG 22107 TEC CONS VTE ALIMENTATION P.ALIM;1;1;1;0;0;0;0;1;0;0;0;0;1;0
1395.0;2021;06;CLERMONT-FERRAND;MASCULIN;ENSEIGNEMENT A DISTANCE;BAC GENERAL;BAC GENERAL;BAC GENE 10019 BAC GENERAL;5;5;5;0;0;0;0;5;0;1;2;1;1;0
1401.0;2021;06;CLERMONT-FERRAND;MASCULIN;FORMATION CONTINUE;BAC PROFESSIONNEL;BAC PRO PROD;BAC PRO 22703 TECHN.INSTALL.SYST.ENERG.CLIMATI;1;1;1;0;0;0;0;1;0;0;0;0;1;0
1403.0;2021;06;CLERMONT-FERRAND;MASCULIN;FORMATION CONTINUE;BAC PROFESSIONNEL;BAC PRO PROD;BAC PRO 22705 TECHNICIEN GAZ;1;1;1;0;0;0;0;1;0;0;0;1;0;0
1407.0;2021;06;CLERMONT-FERRAND;MASCULIN;FORMATION CONTINUE;BAC PROFESSIONNEL;BAC PRO SERV;BAC PRO 30001 GESTION-ADMINISTRATION;1;1;1;0;0;0;0;1;0;0;1;0;0;0
1410.0;2021;06;CLERMONT-FERRAND;MASCULIN;INDIVIDUEL;BAC PROFESSIONNEL;BAC PRO PROD;BAC PRO 25304 AERONAUTIQUE OPTION STRUCTURE;1;1;1;0;0;0;0;1;0;0;0;0;1;0
1416.0;2021;06;CLERMONT-FERRAND;MASCULIN;INDIVIDUEL;BAC TECHNOLOGIQUE;BAC ST2S;BAC ST2S SCIENCES & TECHNO. SANTE & SOCIAL;2;2;0;1;1;0;1;0;0;0;0;0;0;2
1431.0;2021;06;CLERMONT-FERRAND;MASCULIN;SCOLAIRE;BAC PROFESSIONNEL;BAC PRO PROD;BAC PRO 23003 ARTIS. & M.ART:MARCHANDISAGE VIS.;3;3;2;1;0;0;0;2;0;0;1;1;0;1
1442.0;2021;06;CLERMONT-FERRAND;MASCULIN;SCOLAIRE;BAC PROFESSIONNEL;BAC PRO PROD;BAC PRO 24302 METIERS DU CUIR : MAROQUINERIE;3;3;1;2;0;0;0;1;0;0;0;0;1;2
1446.0;2021;06;CLERMONT-FERRAND;MASCULIN;SCOLAIRE;BAC PROFESSIONNEL;BAC PRO PROD;BAC PRO 25215 MAINT.VEHIC.OPTB VEHIC.TRANS.ROUT;15;15;12;2;1;1;0;13;0;0;5;3;5;2
1460.0;2021;06;CLERMONT-FERRAND;MASCULIN;SCOLAIRE;BAC PROFESSIONNEL;BAC PRO PROD;BAC PRO 25515 SYST.NUM.OPT.C RES.INF.SYST.COMM.;59;59;53;1;5;3;2;56;0;3;10;26;17;3
1469.0;2021;06;CLERMONT-FERRAND;MASCULIN;SCOLAIRE;BAC PROFESSIONNEL;BAC PRO PROD;BAC PRO AG 21303 FORET;25;25;24;1;0;0;0;24;0;0;3;9;12;1
1472.0;2021;06;CLERMONT-FERRAND;MASCULIN;SCOLAIRE;BAC PROFESSIONNEL;BAC PRO PROD;BAC PRO AG 22105 LABORATOIRE CONTROLE QUALITE;8;8;8;0;0;0;0;8;0;0;3;3;2;0
1482.0;2021;06;CLERMONT-FERRAND;MASCULIN;SCOLAIRE;BAC PROFESSIONNEL;BAC PRO SERV;BAC PRO 32208 REAL.PR.IMPR.PLURI.OPTB.PR.IMPR.;8;8;8;0;0;0;0;8;0;0;2;4;2;0
1489.0;2021;06;CLERMONT-FERRAND;MASCULIN;SCOLAIRE;BAC PROFESSIONNEL;BAC PRO SERV;BAC PRO 33102 PROTHESE DENTAIRE;7;7;6;1;0;0;0;6;0;0;0;2;4;1
1491.0;2021;06;CLERMONT-FERRAND;MASCULIN;SCOLAIRE;BAC PROFESSIONNEL;BAC PRO SERV;BAC PRO 34304 HYGIENE PROPRETE STERILISATION;5;5;5;0;0;0;0;5;0;0;0;5;0;0
1499.0;2021;06;CLERMONT-FERRAND;MASCULIN;SCOLAIRE;BAC TECHNOLOGIQUE;BAC STI2D;BAC STI2D ENERGIES  ET ENVIRONNEMENT;90;90;82;4;4;2;2;84;0;1;12;19;52;6
1503.0;2021;06;CLERMONT-FERRAND;MASCULIN;SCOLAIRE;BAC TECHNOLOGIQUE;BAC STL;BAC STL SCIENCES PHYSIQUES CHIMIQUES  EN LABORAT.;27;27;24;0;3;2;1;26;0;0;4;10;12;1
1505.0;2021;06;CLERMONT-FERRAND;MASCULIN;SCOLAIRE;BAC TECHNOLOGIQUE;BAC STMG;BAC STMG MERCATIQUE (MARKETING);212;212;173;7;32;19;13;192;0;0;6;62;124;20
1517.0;2021;27;CORSE;FEMININ;ENSEIGNEMENT A DISTANCE;BAC TECHNOLOGIQUE;BAC STMG;BAC STMG GESTION ET FINANCE;1;1;1;0;0;0;0;1;0;0;0;1;0;0
1532.0;2021;27;CORSE;FEMININ;SCOLAIRE;BAC PROFESSIONNEL;BAC PRO PROD;BAC PRO 24203 METIERS DE LA MODE - VÊTEMENT;12;12;11;1;0;0;0;11;0;3;5;1;2;1
1535.0;2021;27;CORSE;FEMININ;SCOLAIRE;BAC PROFESSIONNEL;BAC PRO PROD;BAC PRO 25515 SYST.NUM.OPT.C RES.INF.SYST.COMM.;3;3;3;0;0;0;0;3;0;0;1;1;1;0
1543.0;2021;27;CORSE;FEMININ;SCOLAIRE;BAC PROFESSIONNEL;BAC PRO SERV;BAC PRO 31210 ACCUEIL -RELATION CLIENTS USAGERS;14;14;13;1;0;0;0;13;0;1;3;2;7;1
1545.0;2021;27;CORSE;FEMININ;SCOLAIRE;BAC PROFESSIONNEL;BAC PRO SERV;BAC PRO 33004 ACC.SOINS-S.PERS. OPT.EN STRUCTUR;70;70;67;1;2;2;0;69;0;6;17;27;19;1
1548.0;2021;27;CORSE;FEMININ;SCOLAIRE;BAC PROFESSIONNEL;BAC PRO SERV;BAC PRO AG 33002 SERV PERS TERRIT;11;11;11;0;0;0;0;11;0;1;1;3;6;0
1560.0;2021;27;CORSE;MASCULIN;APPRENTISSAGE;BAC PROFESSIONNEL;BAC PRO PROD;BAC PRO 25214 MAINT.VEHIC.OPTA VOIT.PARTICUL.;11;9;9;0;0;0;0;9;0;0;1;6;2;0
1571.0;2021;27;CORSE;MASCULIN;INDIVIDUEL;BAC PROFESSIONNEL;BAC PRO PROD;BAC PRO 25510 METIERS ELECT. ENVIRON. CONNECTES;1;1;1;0;0;0;0;1;0;0;0;1;0;0
1574.0;2021;27;CORSE;MASCULIN;INDIVIDUEL;BAC PROFESSIONNEL;BAC PRO PROD;BAC PRO AG 21114 CONDUITE PRODUCTIONS HORTICOLES;23;11;8;3;0;0;0;8;0;0;0;0;8;3
1578.0;2021;27;CORSE;MASCULIN;INDIVIDUEL;BAC PROFESSIONNEL;BAC PRO SERV;BAC PRO 31202 COMMERCE;1;0;0;0;0;0;0;0;0;0;0;0;0;0
1579.0;2021;27;CORSE;MASCULIN;INDIVIDUEL;BAC TECHNOLOGIQUE;BAC ST2S;BAC ST2S SCIENCES & TECHNO. SANTE & SOCIAL;1;0;0;0;0;0;0;0;0;0;0;0;0;0
1582.0;2021;27;CORSE;MASCULIN;INDIVIDUEL;BAC TECHNOLOGIQUE;BAC STMG;BAC STMG MERCATIQUE (MARKETING);3;1;1;0;0;0;0;1;0;0;0;0;1;0
1584.0;2021;27;CORSE;MASCULIN;SCOLAIRE;BAC GENERAL;BAC GENERAL;BAC GENE 10019 BAC GENERAL;653;653;621;11;21;17;4;638;9;50;146;234;199;15
1588.0;2021;27;CORSE;MASCULIN;SCOLAIRE;BAC PROFESSIONNEL;BAC PRO PROD;BAC PRO 23005 TECHN. ETUDES BAT B ASSIST.ARCHI.;8;8;7;1;0;0;0;7;0;2;1;1;3;1
1605.0;2021;27;CORSE;MASCULIN;SCOLAIRE;BAC PROFESSIONNEL;BAC PRO SERV;BAC PRO 31107 CONDUCT. TRANSP.ROUT.MARCHANDISES;10;10;7;3;0;0;0;7;0;1;1;4;1;3
1615.0;2021;27;CORSE;MASCULIN;SCOLAIRE;BAC TECHNOLOGIQUE;BAC STHR;BAC STHR SC.&TEC. HOTELLERIE-RESTAURATION;7;7;7;0;0;0;0;7;0;0;1;3;3;0
1621.0;2021;27;CORSE;MASCULIN;SCOLAIRE;BAC TECHNOLOGIQUE;BAC STMG;BAC STMG GESTION ET FINANCE;47;47;41;0;6;6;0;47;0;1;7;22;17;0
1629.0;2021;24;CRETEIL;FEMININ;APPRENTISSAGE;BAC PROFESSIONNEL;BAC PRO PROD;BAC PRO 25216 MAINT.VEHIC.OPTC MOTOCYCLES;5;5;5;0;0;0;0;5;0;0;2;1;2;0
1637.0;2021;24;CRETEIL;FEMININ;APPRENTISSAGE;BAC PROFESSIONNEL;BAC PRO SERV;BAC PRO 31202 COMMERCE;36;35;27;8;0;0;0;27;0;3;7;7;10;8
1641.0;2021;24;CRETEIL;FEMININ;APPRENTISSAGE;BAC PROFESSIONNEL;BAC PRO SERV;BAC PRO 33102 PROTHESE DENTAIRE;6;6;4;1;1;0;1;4;0;0;0;1;3;2
1644.0;2021;24;CRETEIL;FEMININ;APPRENTISSAGE;BAC PROFESSIONNEL;BAC PRO SERV;BAC PRO 34304 HYGIENE PROPRETE STERILISATION;8;8;7;0;1;1;0;8;0;0;2;3;3;0
1645.0;2021;24;CRETEIL;FEMININ;ENSEIGNEMENT A DISTANCE;BAC GENERAL;BAC GENERAL;BAC GENE 10019 BAC GENERAL;72;71;65;4;2;1;1;66;2;12;27;19;6;5
1655.0;2021;24;CRETEIL;FEMININ;FORMATION CONTINUE;BAC PROFESSIONNEL;BAC PRO PROD;BAC PRO 25006 MICROTECHNIQUES;1;1;0;0;1;0;1;0;0;0;0;0;0;1
1659.0;2021;24;CRETEIL;FEMININ;FORMATION CONTINUE;BAC PROFESSIONNEL;BAC PRO PROD;BAC PRO AG 21405 AMENAGEMENTS PAYSAGERS;6;6;6;0;0;0;0;6;0;0;0;0;6;0
1660.0;2021;24;CRETEIL;FEMININ;FORMATION CONTINUE;BAC PROFESSIONNEL;BAC PRO SERV;BAC PRO 30001 GESTION-ADMINISTRATION;3;3;3;0;0;0;0;3;0;2;0;1;0;0
1665.0;2021;24;CRETEIL;FEMININ;INDIVIDUEL;BAC PROFESSIONNEL;BAC PRO PROD;BAC PRO 24203 METIERS DE LA MODE - VÊTEMENT;3;3;1;1;1;1;0;2;0;0;0;0;2;1
1670.0;2021;24;CRETEIL;FEMININ;INDIVIDUEL;BAC PROFESSIONNEL;BAC PRO PROD;BAC PRO AG 21211 COND GEST ENTR HIPPIQUE;4;1;0;1;0;0;0;0;0;0;0;0;0;1
1671.0;2021;24;CRETEIL;FEMININ;INDIVIDUEL;BAC PROFESSIONNEL;BAC PRO PROD;BAC PRO AG 21405 AMENAGEMENTS PAYSAGERS;2;2;1;1;0;0;0;1;0;0;0;0;1;1
1680.0;2021;24;CRETEIL;FEMININ;INDIVIDUEL;BAC PROFESSIONNEL;BAC PRO SERV;BAC PRO 33004 ACC.SOINS-S.PERS. OPT.EN STRUCTUR;10;4;2;2;0;0;0;2;0;0;0;0;2;2
1681.0;2021;24;CRETEIL;FEMININ;INDIVIDUEL;BAC PROFESSIONNEL;BAC PRO SERV;BAC PRO 33102 PROTHESE DENTAIRE;1;1;0;0;1;0;1;0;0;0;0;0;0;1
1689.0;2021;24;CRETEIL;FEMININ;INDIVIDUEL;BAC TECHNOLOGIQUE;BAC STMG;BAC STMG GESTION ET FINANCE;24;11;5;5;1;0;1;5;0;0;0;2;3;6
1691.0;2021;24;CRETEIL;FEMININ;INDIVIDUEL;BAC TECHNOLOGIQUE;BAC STMG;BAC STMG RESSOURCES HUMAINES ET COMMUNICATION;24;11;1;6;4;3;1;4;0;0;0;0;4;7
1694.0;2021;24;CRETEIL;FEMININ;SCOLAIRE;BAC PROFESSIONNEL;BAC PRO PROD;BACPRO 20002 ETUD.DEFINITION PRDTS INDUSTRIEL;1;1;1;0;0;0;0;1;0;1;0;0;0;0
1698.0;2021;24;CRETEIL;FEMININ;SCOLAIRE;BAC PROFESSIONNEL;BAC PRO PROD;BAC PRO 23004 TECHN. ETUDES BAT.A ETUDES & ECO.;9;9;9;0;0;0;0;9;0;0;2;1;6;0
1702.0;2021;24;CRETEIL;FEMININ;SCOLAIRE;BAC PROFESSIONNEL;BAC PRO PROD;BAC PRO 23405 TECHNICIEN MENUISIER AGENCEUR;5;5;3;2;0;0;0;3;0;0;2;0;1;2
1709.0;2021;24;CRETEIL;FEMININ;SCOLAIRE;BAC PROFESSIONNEL;BAC PRO PROD;BAC PRO 25106 TECHNICIEN D'USINAGE;1;1;1;0;0;0;0;1;0;0;1;0;0;0
1712.0;2021;24;CRETEIL;FEMININ;SCOLAIRE;BAC PROFESSIONNEL;BAC PRO PROD;BAC PRO 25216 MAINT.VEHIC.OPTC MOTOCYCLES;2;2;1;1;0;0;0;1;0;0;0;1;0;1
1713.0;2021;24;CRETEIL;FEMININ;SCOLAIRE;BAC PROFESSIONNEL;BAC PRO PROD;BAC PRO 25408 REPARATION DES CARROSSERIES;1;1;1;0;0;0;0;1;0;0;0;1;0;0
1720.0;2021;24;CRETEIL;FEMININ;SCOLAIRE;BAC PROFESSIONNEL;BAC PRO PROD;BAC PRO AG 21114 CONDUITE PRODUCTIONS HORTICOLES;11;11;11;0;0;0;0;11;0;0;0;7;4;0
1725.0;2021;24;CRETEIL;FEMININ;SCOLAIRE;BAC PROFESSIONNEL;BAC PRO SERV;BAC PRO 30001 GESTION-ADMINISTRATION;1326;1326;995;239;92;65;27;1060;0;30;162;373;495;266
1734.0;2021;24;CRETEIL;FEMININ;SCOLAIRE;BAC PROFESSIONNEL;BAC PRO SERV;BAC PRO 32208 REAL.PR.IMPR.PLURI.OPTB.PR.IMPR.;1;1;1;0;0;0;0;1;0;0;0;0;1;0
1738.0;2021;24;CRETEIL;FEMININ;SCOLAIRE;BAC PROFESSIONNEL;BAC PRO SERV;BAC PRO 33004 ACC.SOINS-S.PERS. OPT.EN STRUCTUR;1470;1468;1310;90;68;45;23;1355;0;53;310;563;429;113
1739.0;2021;24;CRETEIL;FEMININ;SCOLAIRE;BAC PROFESSIONNEL;BAC PRO SERV;BAC PRO 33101 OPTIQUE LUNETTERIE;26;26;21;5;0;0;0;21;0;3;5;8;5;5
1751.0;2021;24;CRETEIL;FEMININ;SCOLAIRE;BAC TECHNOLOGIQUE;BAC STI2D;BAC STI2D ARCHITECTURE ET CONSTRUCTION;58;58;55;0;3;1;2;56;0;1;11;21;23;2
1757.0;2021;24;CRETEIL;FEMININ;SCOLAIRE;BAC TECHNOLOGIQUE;BAC STMG;BAC STMG GESTION ET FINANCE;685;685;635;12;38;28;10;663;0;19;152;261;231;22
1767.0;2021;24;CRETEIL;MASCULIN;APPRENTISSAGE;BAC PROFESSIONNEL;BAC PRO PROD;BAC PRO 23304 AMENAGEMENT FINITION BATIMENT;6;6;6;0;0;0;0;6;0;0;2;1;3;0
1768.0;2021;24;CRETEIL;MASCULIN;APPRENTISSAGE;BAC PROFESSIONNEL;BAC PRO PROD;BAC PRO 23405 TECHNICIEN MENUISIER AGENCEUR;1;1;1;0;0;0;0;1;0;0;0;0;1;0
1776.0;2021;24;CRETEIL;MASCULIN;APPRENTISSAGE;BAC PROFESSIONNEL;BAC PRO PROD;BAC PRO 25408 REPARATION DES CARROSSERIES;36;36;27;4;5;3;2;30;0;1;5;12;12;6
1781.0;2021;24;CRETEIL;MASCULIN;APPRENTISSAGE;BAC PROFESSIONNEL;BAC PRO PROD;BAC PRO AG 21001 AGRO-EQUIPEMENT;2;2;1;1;0;0;0;1;0;0;0;0;1;1
1784.0;2021;24;CRETEIL;MASCULIN;APPRENTISSAGE;BAC PROFESSIONNEL;BAC PRO PROD;BAC PRO AG 21405 AMENAGEMENTS PAYSAGERS;36;33;27;6;0;0;0;27;0;0;2;6;19;6
1786.0;2021;24;CRETEIL;MASCULIN;APPRENTISSAGE;BAC PROFESSIONNEL;BAC PRO SERV;BAC PRO 31202 COMMERCE;38;33;23;7;3;2;1;25;0;3;5;9;8;8
1794.0;2021;24;CRETEIL;MASCULIN;ENSEIGNEMENT A DISTANCE;BAC PROFESSIONNEL;BAC PRO PROD;BAC PRO 25515 SYST.NUM.OPT.C RES.INF.SYST.COMM.;1;0;0;0;0;0;0;0;0;0;0;0;0;0
1798.0;2021;24;CRETEIL;MASCULIN;ENSEIGNEMENT A DISTANCE;BAC PROFESSIONNEL;BAC PRO SERV;BAC PRO 31210 ACCUEIL -RELATION CLIENTS USAGERS;1;1;0;1;0;0;0;0;0;0;0;0;0;1
1802.0;2021;24;CRETEIL;MASCULIN;ENSEIGNEMENT A DISTANCE;BAC TECHNOLOGIQUE;BAC STMG;BAC STMG RESSOURCES HUMAINES ET COMMUNICATION;4;2;2;0;0;0;0;2;0;1;1;0;0;0
1813.0;2021;24;CRETEIL;MASCULIN;FORMATION CONTINUE;BAC PROFESSIONNEL;BAC PRO SERV;BAC PRO 30001 GESTION-ADMINISTRATION;2;0;0;0;0;0;0;0;0;0;0;0;0;0
1822.0;2021;24;CRETEIL;MASCULIN;INDIVIDUEL;BAC PROFESSIONNEL;BAC PRO PROD;BAC PRO 25214 MAINT.VEHIC.OPTA VOIT.PARTICUL.;1;0;0;0;0;0;0;0;0;0;0;0;0;0
1830.0;2021;24;CRETEIL;MASCULIN;INDIVIDUEL;BAC PROFESSIONNEL;BAC PRO PROD;BAC PRO 25515 SYST.NUM.OPT.C RES.INF.SYST.COMM.;2;1;1;0;0;0;0;1;0;0;1;0;0;0
1834.0;2021;24;CRETEIL;MASCULIN;INDIVIDUEL;BAC PROFESSIONNEL;BAC PRO PROD;BAC PRO AG 21302 GEST MILIEUX NATURELS FAUNE;1;1;1;0;0;0;0;1;0;0;0;0;1;0
1835.0;2021;24;CRETEIL;MASCULIN;INDIVIDUEL;BAC PROFESSIONNEL;BAC PRO SERV;BAC PRO 30001 GESTION-ADMINISTRATION;13;9;4;4;1;1;0;5;0;0;0;0;5;4
1837.0;2021;24;CRETEIL;MASCULIN;INDIVIDUEL;BAC PROFESSIONNEL;BAC PRO SERV;BAC PRO 31108 TRANSPORT;1;1;1;0;0;0;0;1;0;0;0;0;1;0
1840.0;2021;24;CRETEIL;MASCULIN;INDIVIDUEL;BAC PROFESSIONNEL;BAC PRO SERV;BAC PRO 31210 ACCUEIL -RELATION CLIENTS USAGERS;3;3;2;1;0;0;0;2;0;0;0;2;0;1
1856.0;2021;24;CRETEIL;MASCULIN;INDIVIDUEL;BAC TECHNOLOGIQUE;BAC STMG;BAC STMG RESSOURCES HUMAINES ET COMMUNICATION;21;15;10;4;1;1;0;11;0;0;0;3;8;4
1858.0;2021;24;CRETEIL;MASCULIN;SCOLAIRE;BAC GENERAL;BAC GENERAL;BAC GENE 10019 BAC GENERAL;11176;11170;10146;226;798;533;265;10679;111;863;2153;3735;3817;491
1860.0;2021;24;CRETEIL;MASCULIN;SCOLAIRE;BAC PROFESSIONNEL;BAC PRO PROD;BAC PRO 22004 PROC. CHIMIE EAU PAPIERS-CARTONS;3;3;3;0;0;0;0;3;0;0;1;1;1;0
1863.0;2021;24;CRETEIL;MASCULIN;SCOLAIRE;BAC PROFESSIONNEL;BAC PRO PROD;BAC PRO 22703 TECHN.INSTALL.SYST.ENERG.CLIMATI;129;129;93;25;11;5;6;98;0;1;9;34;54;31
1866.0;2021;24;CRETEIL;MASCULIN;SCOLAIRE;BAC PROFESSIONNEL;BAC PRO PROD;BAC PRO 23004 TECHN. ETUDES BAT.A ETUDES & ECO.;55;55;40;6;9;7;2;47;0;0;3;14;30;8
1881.0;2021;24;CRETEIL;MASCULIN;SCOLAIRE;BAC PROFESSIONNEL;BAC PRO PROD;BAC PRO 25106 TECHNICIEN D'USINAGE;120;119;96;19;4;3;1;99;0;4;13;40;42;20
1886.0;2021;24;CRETEIL;MASCULIN;SCOLAIRE;BAC PROFESSIONNEL;BAC PRO PROD;BAC PRO 25219 MAINT.MATERIELS OPT.A AGRICOLES;5;5;3;2;0;0;0;3;0;0;1;2;0;2
1887.0;2021;24;CRETEIL;MASCULIN;SCOLAIRE;BAC PROFESSIONNEL;BAC PRO PROD;BAC PRO 25220 MAINT.MATERIELS OPT.B TP MANUT.;20;20;17;2;1;1;0;18;0;2;1;8;7;2
1888.0;2021;24;CRETEIL;MASCULIN;SCOLAIRE;BAC PROFESSIONNEL;BAC PRO PROD;BAC PRO 25221 MAINT.MATERIELS OPT.C ESP. VERTS;12;12;9;2;1;1;0;10;0;0;0;5;5;2
1889.0;2021;24;CRETEIL;MASCULIN;SCOLAIRE;BAC PROFESSIONNEL;BAC PRO PROD;BAC PRO 25303 AERONAUTIQUE OPTION SYSTEMES;20;20;17;3;0;0;0;17;0;2;1;12;2;3
1904.0;2021;24;CRETEIL;MASCULIN;SCOLAIRE;BAC PROFESSIONNEL;BAC PRO PROD;BAC PRO AG 22105 LABORATOIRE CONTROLE QUALITE;8;6;6;0;0;0;0;6;0;0;1;1;4;0
1911.0;2021;24;CRETEIL;MASCULIN;SCOLAIRE;BAC PROFESSIONNEL;BAC PRO SERV;BAC PRO 31206 VENTE (PROSPECT.NEGO.SUIV.CLIENT;595;594;466;117;11;4;7;470;0;10;75;174;211;124
1915.0;2021;24;CRETEIL;MASCULIN;SCOLAIRE;BAC PROFESSIONNEL;BAC PRO SERV;BAC PRO 32208 REAL.PR.IMPR.PLURI.OPTB.PR.IMPR.;13;13;10;3;0;0;0;10;0;0;3;3;4;3
1917.0;2021;24;CRETEIL;MASCULIN;SCOLAIRE;BAC PROFESSIONNEL;BAC PRO SERV;BAC PRO 32304 PHOTOGRAPHIE;21;21;18;3;0;0;0;18;0;1;3;7;7;3
1919.0;2021;24;CRETEIL;MASCULIN;SCOLAIRE;BAC PROFESSIONNEL;BAC PRO SERV;BAC PRO 33004 ACC.SOINS-S.PERS. OPT.EN STRUCTUR;97;96;82;11;3;1;2;83;0;3;20;34;26;13
1921.0;2021;24;CRETEIL;MASCULIN;SCOLAIRE;BAC PROFESSIONNEL;BAC PRO SERV;BAC PRO 33102 PROTHESE DENTAIRE;1;1;1;0;0;0;0;1;0;0;0;0;1;0
1924.0;2021;24;CRETEIL;MASCULIN;SCOLAIRE;BAC PROFESSIONNEL;BAC PRO SERV;BAC PRO 34304 HYGIENE PROPRETE STERILISATION;6;6;5;1;0;0;0;5;0;0;0;2;3;1
1927.0;2021;24;CRETEIL;MASCULIN;SCOLAIRE;BAC TECHNOLOGIQUE;BAC ST2S;BAC ST2S SCIENCES & TECHNO. SANTE & SOCIAL;228;228;189;14;25;18;7;207;1;4;22;69;111;21
1929.0;2021;24;CRETEIL;MASCULIN;SCOLAIRE;BAC TECHNOLOGIQUE;BAC STD2A;BAC STD2A SCIENCES & TECHNO. DESIGN-ARTS APPLIQUES;63;63;55;3;5;2;3;57;0;3;3;24;27;6
1930.0;2021;24;CRETEIL;MASCULIN;SCOLAIRE;BAC TECHNOLOGIQUE;BAC STHR;BAC STHR SC.&TEC. HOTELLERIE-RESTAURATION;47;47;41;0;6;6;0;47;0;0;11;12;24;0
1939.0;2021;24;CRETEIL;MASCULIN;SCOLAIRE;BAC TECHNOLOGIQUE;BAC STMG;BAC STMG RESSOURCES HUMAINES ET COMMUNICATION;507;506;401;36;69;46;23;447;0;1;30;131;285;59
1944.0;2021;07;DIJON;FEMININ;APPRENTISSAGE;BAC PROFESSIONNEL;BAC PRO PROD;BAC PRO 23304 AMENAGEMENT FINITION BATIMENT;1;1;1;0;0;0;0;1;0;1;0;0;0;0
1948.0;2021;07;DIJON;FEMININ;APPRENTISSAGE;BAC PROFESSIONNEL;BAC PRO PROD;BAC PRO 25214 MAINT.VEHIC.OPTA VOIT.PARTICUL.;4;4;4;0;0;0;0;4;0;0;2;1;1;0
1952.0;2021;07;DIJON;FEMININ;APPRENTISSAGE;BAC PROFESSIONNEL;BAC PRO PROD;BAC PRO AG 21004 CGEA;7;7;6;1;0;0;0;6;0;0;2;1;3;1
1955.0;2021;07;DIJON;FEMININ;APPRENTISSAGE;BAC PROFESSIONNEL;BAC PRO PROD;BAC PRO AG 21210 COND GEST ENTR CANIN ET FELIN;8;8;8;0;0;0;0;8;0;0;1;5;2;0
1958.0;2021;07;DIJON;FEMININ;APPRENTISSAGE;BAC PROFESSIONNEL;BAC PRO PROD;BAC PRO AG 22106 TEC CONS VTE ALIMENTATION VINS SP;1;1;1;0;0;0;0;1;0;0;0;1;0;0
1968.0;2021;07;DIJON;FEMININ;ENSEIGNEMENT A DISTANCE;BAC PROFESSIONNEL;BAC PRO SERV;BAC PRO 30001 GESTION-ADMINISTRATION;1;1;0;0;1;0;1;0;0;0;0;0;0;1
1971.0;2021;07;DIJON;FEMININ;ENSEIGNEMENT A DISTANCE;BAC TECHNOLOGIQUE;BAC ST2S;BAC ST2S SCIENCES & TECHNO. SANTE & SOCIAL;3;3;3;0;0;0;0;3;0;0;2;0;1;0
1973.0;2021;07;DIJON;FEMININ;ENSEIGNEMENT A DISTANCE;BAC TECHNOLOGIQUE;BAC STMG;BAC STMG RESSOURCES HUMAINES ET COMMUNICATION;2;2;1;1;0;0;0;1;0;0;0;1;0;1
1982.0;2021;07;DIJON;FEMININ;INDIVIDUEL;BAC PROFESSIONNEL;BAC PRO PROD;BAC PRO AG 21113 CGEVV;2;1;1;0;0;0;0;1;0;0;0;0;1;0
1984.0;2021;07;DIJON;FEMININ;INDIVIDUEL;BAC PROFESSIONNEL;BAC PRO PROD;BAC PRO AG 21302 GEST MILIEUX NATURELS FAUNE;1;0;0;0;0;0;0;0;0;0;0;0;0;0
1986.0;2021;07;DIJON;FEMININ;INDIVIDUEL;BAC PROFESSIONNEL;BAC PRO SERV;BAC PRO 31202 COMMERCE;3;2;1;1;0;0;0;1;0;0;0;0;1;1
1990.0;2021;07;DIJON;FEMININ;INDIVIDUEL;BAC PROFESSIONNEL;BAC PRO SERV;BAC PRO 33004 ACC.SOINS-S.PERS. OPT.EN STRUCTUR;4;3;1;2;0;0;0;1;0;0;1;0;0;2
1996.0;2021;07;DIJON;FEMININ;INDIVIDUEL;BAC TECHNOLOGIQUE;BAC STMG;BAC STMG SYSTEMES D'INFORMATION DE GESTION;1;0;0;0;0;0;0;0;0;0;0;0;0;0
2000.0;2021;07;DIJON;FEMININ;SCOLAIRE;BAC PROFESSIONNEL;BAC PRO PROD;BAC PRO 22004 PROC. CHIMIE EAU PAPIERS-CARTONS;1;1;1;0;0;0;0;1;0;0;1;0;0;0
2002.0;2021;07;DIJON;FEMININ;SCOLAIRE;BAC PROFESSIONNEL;BAC PRO PROD;BAC PRO 22106 CUISINE;30;30;26;2;2;1;1;27;0;2;4;9;12;3
2006.0;2021;07;DIJON;FEMININ;SCOLAIRE;BAC PROFESSIONNEL;BAC PRO PROD;BAC PRO 23005 TECHN. ETUDES BAT B ASSIST.ARCHI.;4;4;4;0;0;0;0;4;0;0;0;2;2;0
2009.0;2021;07;DIJON;FEMININ;SCOLAIRE;BAC PROFESSIONNEL;BAC PRO PROD;BAC PRO 23405 TECHNICIEN MENUISIER AGENCEUR;2;2;1;1;0;0;0;1;0;0;1;0;0;1
2017.0;2021;07;DIJON;FEMININ;SCOLAIRE;BAC PROFESSIONNEL;BAC PRO PROD;BAC PRO 25214 MAINT.VEHIC.OPTA VOIT.PARTICUL.;4;4;4;0;0;0;0;4;0;0;2;2;0;0
2035.0;2021;07;DIJON;FEMININ;SCOLAIRE;BAC PROFESSIONNEL;BAC PRO PROD;BAC PRO AG 21302 GEST MILIEUX NATURELS FAUNE;2;2;2;0;0;0;0;2;0;0;0;2;0;0
2036.0;2021;07;DIJON;FEMININ;SCOLAIRE;BAC PROFESSIONNEL;BAC PRO PROD;BAC PRO AG 21405 AMENAGEMENTS PAYSAGERS;7;7;7;0;0;0;0;7;0;0;0;2;5;0
2045.0;2021;07;DIJON;FEMININ;SCOLAIRE;BAC PROFESSIONNEL;BAC PRO SERV;BAC PRO 31210 ACCUEIL -RELATION CLIENTS USAGERS;98;98;80;7;11;4;7;84;0;5;23;30;26;14
2047.0;2021;07;DIJON;FEMININ;SCOLAIRE;BAC PROFESSIONNEL;BAC PRO SERV;BAC PRO 32208 REAL.PR.IMPR.PLURI.OPTB.PR.IMPR.;1;1;1;0;0;0;0;1;0;0;1;0;0;0
2050.0;2021;07;DIJON;FEMININ;SCOLAIRE;BAC PROFESSIONNEL;BAC PRO SERV;BAC PRO 33004 ACC.SOINS-S.PERS. OPT.EN STRUCTUR;236;235;213;9;13;10;3;223;0;6;47;110;60;12
2053.0;2021;07;DIJON;FEMININ;SCOLAIRE;BAC PROFESSIONNEL;BAC PRO SERV;BAC PRO 33103 TECHNICIEN APPAREIL. ORTHOPEDIQUE;8;8;8;0;0;0;0;8;0;0;4;3;1;0
2054.0;2021;07;DIJON;FEMININ;SCOLAIRE;BAC PROFESSIONNEL;BAC PRO SERV;BAC PRO 33403 COMMERC. SERVICES EN RESTAURATION;36;36;33;1;2;2;0;35;0;0;8;15;12;1
2058.0;2021;07;DIJON;FEMININ;SCOLAIRE;BAC PROFESSIONNEL;BAC PRO SERV;BAC PRO AG 33002 SERV PERS TERRIT;198;195;192;3;0;0;0;192;0;4;29;81;78;3
2063.0;2021;07;DIJON;FEMININ;SCOLAIRE;BAC TECHNOLOGIQUE;BAC STD2A;BAC STD2A SCIENCES & TECHNO. DESIGN-ARTS APPLIQUES;47;47;47;0;0;0;0;47;0;8;18;20;1;0
2068.0;2021;07;DIJON;FEMININ;SCOLAIRE;BAC TECHNOLOGIQUE;BAC STI2D;BAC STI2D SYSTÈME D'INFORMATION  ET NUMERIQUE;5;5;5;0;0;0;0;5;0;0;2;2;1;0
2073.0;2021;07;DIJON;FEMININ;SCOLAIRE;BAC TECHNOLOGIQUE;BAC STMG;BAC STMG RESSOURCES HUMAINES ET COMMUNICATION;292;292;262;5;25;12;13;274;0;3;32;102;137;18
2075.0;2021;07;DIJON;MASCULIN;APPRENTISSAGE;BAC PROFESSIONNEL;BAC PRO PROD;BAC PRO 22106 CUISINE;20;20;13;3;4;2;2;15;0;1;2;5;7;5
2078.0;2021;07;DIJON;MASCULIN;APPRENTISSAGE;BAC PROFESSIONNEL;BAC PRO PROD;BAC PRO 23004 TECHN. ETUDES BAT.A ETUDES & ECO.;4;4;3;1;0;0;0;3;0;0;2;1;0;1
2086.0;2021;07;DIJON;MASCULIN;APPRENTISSAGE;BAC PROFESSIONNEL;BAC PRO PROD;BAC PRO 25106 TECHNICIEN D'USINAGE;23;23;21;2;0;0;0;21;0;3;4;6;8;2
2092.0;2021;07;DIJON;MASCULIN;APPRENTISSAGE;BAC PROFESSIONNEL;BAC PRO PROD;BAC PRO 25219 MAINT.MATERIELS OPT.A AGRICOLES;19;19;18;1;0;0;0;18;0;1;4;8;5;1
2093.0;2021;07;DIJON;MASCULIN;APPRENTISSAGE;BAC PROFESSIONNEL;BAC PRO PROD;BAC PRO 25408 REPARATION DES CARROSSERIES;10;10;6;1;3;3;0;9;0;0;1;3;5;1
2103.0;2021;07;DIJON;MASCULIN;APPRENTISSAGE;BAC PROFESSIONNEL;BAC PRO PROD;BAC PRO AG 21211 COND GEST ENTR HIPPIQUE;1;1;1;0;0;0;0;1;0;0;0;1;0;0
2107.0;2021;07;DIJON;MASCULIN;APPRENTISSAGE;BAC PROFESSIONNEL;BAC PRO SERV;BAC PRO 31106 LOGISTIQUE;15;15;11;1;3;1;2;12;0;0;2;4;6;3
2110.0;2021;07;DIJON;MASCULIN;APPRENTISSAGE;BAC PROFESSIONNEL;BAC PRO SERV;BAC PRO 32207 REAL.PR.IMPR.PLURI.OPTA.PR.GRAPH.;2;2;1;1;0;0;0;1;0;0;0;0;1;1
2118.0;2021;07;DIJON;MASCULIN;FORMATION CONTINUE;BAC PROFESSIONNEL;BAC PRO PROD;BAC PRO 24301 METIERS DU CUIR : CHAUSSURES;1;1;1;0;0;0;0;1;0;0;0;1;0;0
2123.0;2021;07;DIJON;MASCULIN;FORMATION CONTINUE;BAC PROFESSIONNEL;BAC PRO SERV;BAC PRO 33102 PROTHESE DENTAIRE;1;0;0;0;0;0;0;0;0;0;0;0;0;0
2127.0;2021;07;DIJON;MASCULIN;INDIVIDUEL;BAC PROFESSIONNEL;BAC PRO PROD;BAC PRO 25007 MAINTENANCE EQUIPEMENTS INDUST.;1;0;0;0;0;0;0;0;0;0;0;0;0;0
2129.0;2021;07;DIJON;MASCULIN;INDIVIDUEL;BAC PROFESSIONNEL;BAC PRO PROD;BAC PRO 25305 AVIATION GENERALE;1;1;1;0;0;0;0;1;0;0;0;1;0;0
2132.0;2021;07;DIJON;MASCULIN;INDIVIDUEL;BAC PROFESSIONNEL;BAC PRO PROD;BAC PRO AG 21405 AMENAGEMENTS PAYSAGERS;1;0;0;0;0;0;0;0;0;0;0;0;0;0
2137.0;2021;07;DIJON;MASCULIN;INDIVIDUEL;BAC PROFESSIONNEL;BAC PRO SERV;BAC PRO 33004 ACC.SOINS-S.PERS. OPT.EN STRUCTUR;1;0;0;0;0;0;0;0;0;0;0;0;0;0
2138.0;2021;07;DIJON;MASCULIN;INDIVIDUEL;BAC PROFESSIONNEL;BAC PRO SERV;BAC PRO 33403 COMMERC. SERVICES EN RESTAURATION;1;1;0;1;0;0;0;0;0;0;0;0;0;1
2145.0;2021;07;DIJON;MASCULIN;SCOLAIRE;BAC GENERAL;BAC GENERAL;BAC GENE 10019 BAC GENERAL;3654;3652;3462;28;162;106;56;3568;56;312;807;1295;1098;84
2146.0;2021;07;DIJON;MASCULIN;SCOLAIRE;BAC PROFESSIONNEL;BAC PRO PROD;BACPRO 20002 ETUD.DEFINITION PRDTS INDUSTRIEL;14;14;12;1;1;1;0;13;0;1;0;9;3;1
2148.0;2021;07;DIJON;MASCULIN;SCOLAIRE;BAC PROFESSIONNEL;BAC PRO PROD;BAC PRO 22003 BIO-INDUSTRIES DE TRANSFORMATION;8;8;7;1;0;0;0;7;0;0;3;1;3;1
2156.0;2021;07;DIJON;MASCULIN;SCOLAIRE;BAC PROFESSIONNEL;BAC PRO PROD;BAC PRO 23005 TECHN. ETUDES BAT B ASSIST.ARCHI.;5;5;3;0;2;2;0;5;0;0;0;0;5;0
2157.0;2021;07;DIJON;MASCULIN;SCOLAIRE;BAC PROFESSIONNEL;BAC PRO PROD;BAC PRO 23102 TRAVAUX PUBLICS;11;11;9;2;0;0;0;9;0;0;2;1;6;2
2158.0;2021;07;DIJON;MASCULIN;SCOLAIRE;BAC PROFESSIONNEL;BAC PRO PROD;BACPRO 23103 TECHNICIEN GEOMETRE-TOPOGRAPHE;5;5;3;1;1;1;0;4;0;1;1;1;1;1
2163.0;2021;07;DIJON;MASCULIN;SCOLAIRE;BAC PROFESSIONNEL;BAC PRO PROD;BAC PRO 23304 AMENAGEMENT FINITION BATIMENT;21;21;12;5;4;2;2;14;0;2;0;3;9;7
2164.0;2021;07;DIJON;MASCULIN;SCOLAIRE;BAC PROFESSIONNEL;BAC PRO PROD;BAC PRO 23404 TECHNICIEN CONSTRUCTEUR BOIS;17;17;13;4;0;0;0;13;0;1;4;5;3;4
2165.0;2021;07;DIJON;MASCULIN;SCOLAIRE;BAC PROFESSIONNEL;BAC PRO PROD;BAC PRO 23405 TECHNICIEN MENUISIER AGENCEUR;52;52;45;4;3;1;2;46;0;3;4;23;16;6
2181.0;2021;07;DIJON;MASCULIN;SCOLAIRE;BAC PROFESSIONNEL;BAC PRO PROD;BAC PRO 25406 OUVRAGES DU BATIMENT METALLERIE;22;22;18;2;2;1;1;19;0;0;5;12;2;3
2188.0;2021;07;DIJON;MASCULIN;SCOLAIRE;BAC PROFESSIONNEL;BAC PRO PROD;BAC PRO 25515 SYST.NUM.OPT.C RES.INF.SYST.COMM.;66;66;61;3;2;1;1;62;0;6;19;20;17;4
2190.0;2021;07;DIJON;MASCULIN;SCOLAIRE;BAC PROFESSIONNEL;BAC PRO PROD;BAC PRO AG 21113 CGEVV;40;40;33;7;0;0;0;33;0;1;4;15;13;7
2194.0;2021;07;DIJON;MASCULIN;SCOLAIRE;BAC PROFESSIONNEL;BAC PRO PROD;BAC PRO AG 21210 COND GEST ENTR CANIN ET FELIN;8;8;7;1;0;0;0;7;0;0;0;5;2;1
2195.0;2021;07;DIJON;MASCULIN;SCOLAIRE;BAC PROFESSIONNEL;BAC PRO PROD;BAC PRO AG 21211 COND GEST ENTR HIPPIQUE;5;5;4;1;0;0;0;4;0;0;2;1;1;1
2201.0;2021;07;DIJON;MASCULIN;SCOLAIRE;BAC PROFESSIONNEL;BAC PRO SERV;BAC PRO 30001 GESTION-ADMINISTRATION;136;135;98;28;9;5;4;103;0;5;11;37;50;32
2207.0;2021;07;DIJON;MASCULIN;SCOLAIRE;BAC PROFESSIONNEL;BAC PRO SERV;BAC PRO 31210 ACCUEIL -RELATION CLIENTS USAGERS;45;44;33;7;4;2;2;35;0;3;4;12;16;9
2211.0;2021;07;DIJON;MASCULIN;SCOLAIRE;BAC PROFESSIONNEL;BAC PRO SERV;BAC PRO 33003 ACC.SOINS-S.PERS. OPT.A DOMICILE;7;7;4;1;2;2;0;6;0;0;2;1;3;1
2229.0;2021;07;DIJON;MASCULIN;SCOLAIRE;BAC TECHNOLOGIQUE;BAC STI2D;BAC STI2D SYSTÈME D'INFORMATION  ET NUMERIQUE;176;176;164;1;11;6;5;170;1;3;35;67;64;6
2232.0;2021;07;DIJON;MASCULIN;SCOLAIRE;BAC TECHNOLOGIQUE;BAC STMG;BAC STMG GESTION ET FINANCE;167;166;147;5;14;9;5;156;0;5;14;64;73;10
2237.0;2021;08;GRENOBLE;FEMININ;APPRENTISSAGE;BAC PROFESSIONNEL;BAC PRO PROD;BAC PRO 20102 PILOTE DE LIGNE DE PRODUCTION;1;1;1;0;0;0;0;1;0;0;1;0;0;0
2239.0;2021;08;GRENOBLE;FEMININ;APPRENTISSAGE;BAC PROFESSIONNEL;BAC PRO PROD;BAC PRO 22004 PROC. CHIMIE EAU PAPIERS-CARTONS;3;3;3;0;0;0;0;3;0;3;0;0;0;0
2243.0;2021;08;GRENOBLE;FEMININ;APPRENTISSAGE;BAC PROFESSIONNEL;BAC PRO PROD;BAC PRO 23304 AMENAGEMENT FINITION BATIMENT;3;3;3;0;0;0;0;3;0;0;1;0;2;0
2244.0;2021;08;GRENOBLE;FEMININ;APPRENTISSAGE;BAC PROFESSIONNEL;BAC PRO PROD;BAC PRO 23404 TECHNICIEN CONSTRUCTEUR BOIS;1;1;1;0;0;0;0;1;0;0;0;1;0;0
2245.0;2021;08;GRENOBLE;FEMININ;APPRENTISSAGE;BAC PROFESSIONNEL;BAC PRO PROD;BAC PRO 25007 MAINTENANCE EQUIPEMENTS INDUST.;3;3;3;0;0;0;0;3;0;0;1;2;0;0
2260.0;2021;08;GRENOBLE;FEMININ;APPRENTISSAGE;BAC PROFESSIONNEL;BAC PRO SERV;BAC PRO 31202 COMMERCE;92;88;78;4;6;3;3;81;0;5;15;32;29;7
2264.0;2021;08;GRENOBLE;FEMININ;ENSEIGNEMENT A DISTANCE;BAC GENERAL;BAC GENERAL;BAC GENE 10019 BAC GENERAL;79;76;75;0;1;0;1;75;2;16;29;19;9;1
2273.0;2021;08;GRENOBLE;FEMININ;FORMATION CONTINUE;BAC PROFESSIONNEL;BAC PRO PROD;BAC PRO 25510 METIERS ELECT. ENVIRON. CONNECTES;1;1;1;0;0;0;0;1;0;0;0;1;0;0
2275.0;2021;08;GRENOBLE;FEMININ;FORMATION CONTINUE;BAC PROFESSIONNEL;BAC PRO SERV;BAC PRO 30001 GESTION-ADMINISTRATION;1;1;1;0;0;0;0;1;0;0;0;1;0;0
2284.0;2021;08;GRENOBLE;FEMININ;INDIVIDUEL;BAC PROFESSIONNEL;BAC PRO PROD;BAC PRO AG 21210 COND GEST ENTR CANIN ET FELIN;1;1;0;1;0;0;0;0;0;0;0;0;0;1
2292.0;2021;08;GRENOBLE;FEMININ;INDIVIDUEL;BAC PROFESSIONNEL;BAC PRO SERV;BAC PRO 33403 COMMERC. SERVICES EN RESTAURATION;1;0;0;0;0;0;0;0;0;0;0;0;0;0
2300.0;2021;08;GRENOBLE;FEMININ;INDIVIDUEL;BAC TECHNOLOGIQUE;BAC STMG;BAC STMG RESSOURCES HUMAINES ET COMMUNICATION;12;5;2;2;1;0;1;2;0;0;0;1;1;3
2301.0;2021;08;GRENOBLE;FEMININ;SCOLAIRE;BAC GENERAL;BAC GENERAL;BAC GENE 10019 BAC GENERAL;11008;11008;10737;37;234;145;89;10882;198;1619;3255;3843;1967;126
2302.0;2021;08;GRENOBLE;FEMININ;SCOLAIRE;BAC PROFESSIONNEL;BAC PRO PROD;BACPRO 20002 ETUD.DEFINITION PRDTS INDUSTRIEL;4;4;3;1;0;0;0;3;0;0;2;0;1;1
2304.0;2021;08;GRENOBLE;FEMININ;SCOLAIRE;BAC PROFESSIONNEL;BAC PRO PROD;BAC PRO 22003 BIO-INDUSTRIES DE TRANSFORMATION;6;6;6;0;0;0;0;6;0;1;3;1;1;0
2306.0;2021;08;GRENOBLE;FEMININ;SCOLAIRE;BAC PROFESSIONNEL;BAC PRO PROD;BAC PRO 22105 BOULANGER-PÂTISSIER;23;23;22;0;1;1;0;23;0;3;11;8;1;0
2308.0;2021;08;GRENOBLE;FEMININ;SCOLAIRE;BAC PROFESSIONNEL;BAC PRO PROD;BAC PRO 23003 ARTIS. & M.ART:MARCHANDISAGE VIS.;11;11;10;1;0;0;0;10;0;1;1;6;2;1
2309.0;2021;08;GRENOBLE;FEMININ;SCOLAIRE;BAC PROFESSIONNEL;BAC PRO PROD;BAC PRO 23004 TECHN. ETUDES BAT.A ETUDES & ECO.;4;4;4;0;0;0;0;4;0;0;1;3;0;0
2323.0;2021;08;GRENOBLE;FEMININ;SCOLAIRE;BAC PROFESSIONNEL;BAC PRO PROD;BAC PRO 25106 TECHNICIEN D'USINAGE;1;1;1;0;0;0;0;1;0;0;0;0;1;0
2324.0;2021;08;GRENOBLE;FEMININ;SCOLAIRE;BAC PROFESSIONNEL;BAC PRO PROD;BAC PRO 25107 TECHNICIEN OUTILLEUR;2;2;2;0;0;0;0;2;0;0;0;0;2;0
2326.0;2021;08;GRENOBLE;FEMININ;SCOLAIRE;BAC PROFESSIONNEL;BAC PRO PROD;BAC PRO 25215 MAINT.VEHIC.OPTB VEHIC.TRANS.ROUT;1;1;1;0;0;0;0;1;0;0;0;1;0;0
2334.0;2021;08;GRENOBLE;FEMININ;SCOLAIRE;BAC PROFESSIONNEL;BAC PRO PROD;BAC PRO AG 21004 CGEA;52;52;48;4;0;0;0;48;0;2;3;19;24;4
2338.0;2021;08;GRENOBLE;FEMININ;SCOLAIRE;BAC PROFESSIONNEL;BAC PRO PROD;BAC PRO AG 21211 COND GEST ENTR HIPPIQUE;98;96;91;5;0;0;0;91;0;6;11;38;36;5
2339.0;2021;08;GRENOBLE;FEMININ;SCOLAIRE;BAC PROFESSIONNEL;BAC PRO PROD;BAC PRO AG 21302 GEST MILIEUX NATURELS FAUNE;18;18;17;1;0;0;0;17;0;0;7;9;1;1
2341.0;2021;08;GRENOBLE;FEMININ;SCOLAIRE;BAC PROFESSIONNEL;BAC PRO PROD;BAC PRO AG 21405 AMENAGEMENTS PAYSAGERS;15;15;14;1;0;0;0;14;0;1;3;5;5;1
2342.0;2021;08;GRENOBLE;FEMININ;SCOLAIRE;BAC PROFESSIONNEL;BAC PRO PROD;BAC PRO AG 21406 TEC CONS VTE PROD DES JARDINS;26;26;25;1;0;0;0;25;0;1;3;12;9;1
2346.0;2021;08;GRENOBLE;FEMININ;SCOLAIRE;BAC PROFESSIONNEL;BAC PRO SERV;BAC PRO 31106 LOGISTIQUE;16;15;8;6;1;1;0;9;0;0;2;1;6;6
2347.0;2021;08;GRENOBLE;FEMININ;SCOLAIRE;BAC PROFESSIONNEL;BAC PRO SERV;BAC PRO 31107 CONDUCT. TRANSP.ROUT.MARCHANDISES;4;4;4;0;0;0;0;4;0;0;0;3;1;0
2348.0;2021;08;GRENOBLE;FEMININ;SCOLAIRE;BAC PROFESSIONNEL;BAC PRO SERV;BAC PRO 31108 TRANSPORT;8;8;5;3;0;0;0;5;0;1;1;0;3;3
2353.0;2021;08;GRENOBLE;FEMININ;SCOLAIRE;BAC PROFESSIONNEL;BAC PRO SERV;BAC PRO 32303 ART.& MET.ART:COM.VIS.VIS.PLURI-M;42;42;42;0;0;0;0;42;0;10;12;14;6;0
2355.0;2021;08;GRENOBLE;FEMININ;SCOLAIRE;BAC PROFESSIONNEL;BAC PRO SERV;BAC PRO 33003 ACC.SOINS-S.PERS. OPT.A DOMICILE;121;121;104;16;1;0;1;104;0;7;16;44;37;17
2358.0;2021;08;GRENOBLE;FEMININ;SCOLAIRE;BAC PROFESSIONNEL;BAC PRO SERV;BAC PRO 33403 COMMERC. SERVICES EN RESTAURATION;103;103;89;10;4;4;0;93;0;8;22;32;31;10
2359.0;2021;08;GRENOBLE;FEMININ;SCOLAIRE;BAC PROFESSIONNEL;BAC PRO SERV;BAC PRO 33603 ESTHETIQUE COSMETIQUE PARFUMERIE;122;122;114;7;1;1;0;115;0;7;32;53;23;7
2361.0;2021;08;GRENOBLE;FEMININ;SCOLAIRE;BAC PROFESSIONNEL;BAC PRO SERV;BAC PRO 34403 METIERS DE LA SECURITE;22;22;22;0;0;0;0;22;0;1;9;9;3;0
2364.0;2021;08;GRENOBLE;FEMININ;SCOLAIRE;BAC TECHNOLOGIQUE;BAC S2TMD;BAC S2TMD MUSIQUE;1;1;1;0;0;0;0;1;0;0;1;0;0;0
2376.0;2021;08;GRENOBLE;FEMININ;SCOLAIRE;BAC TECHNOLOGIQUE;BAC STMG;BAC STMG MERCATIQUE (MARKETING);1092;1092;1009;16;67;35;32;1044;1;21;154;446;422;48
2387.0;2021;08;GRENOBLE;MASCULIN;APPRENTISSAGE;BAC PROFESSIONNEL;BAC PRO PROD;BAC PRO 23004 TECHN. ETUDES BAT.A ETUDES & ECO.;1;1;1;0;0;0;0;1;0;1;0;0;0;0
2388.0;2021;08;GRENOBLE;MASCULIN;APPRENTISSAGE;BAC PROFESSIONNEL;BAC PRO PROD;BAC PRO 23005 TECHN. ETUDES BAT B ASSIST.ARCHI.;1;1;0;1;0;0;0;0;0;0;0;0;0;1
2389.0;2021;08;GRENOBLE;MASCULIN;APPRENTISSAGE;BAC PROFESSIONNEL;BAC PRO PROD;BAC PRO 23102 TRAVAUX PUBLICS;48;48;43;3;2;0;2;43;0;0;9;17;17;5
2398.0;2021;08;GRENOBLE;MASCULIN;APPRENTISSAGE;BAC PROFESSIONNEL;BAC PRO PROD;BAC PRO 25007 MAINTENANCE EQUIPEMENTS INDUST.;86;86;68;12;6;5;1;73;0;9;21;18;25;13
2406.0;2021;08;GRENOBLE;MASCULIN;APPRENTISSAGE;BAC PROFESSIONNEL;BAC PRO PROD;BAC PRO 25221 MAINT.MATERIELS OPT.C ESP. VERTS;8;8;6;2;0;0;0;6;0;0;1;2;3;2
2408.0;2021;08;GRENOBLE;MASCULIN;APPRENTISSAGE;BAC PROFESSIONNEL;BAC PRO PROD;BAC PRO 25303 AERONAUTIQUE OPTION SYSTEMES;26;26;22;3;1;1;0;23;0;2;6;8;7;3
2409.0;2021;08;GRENOBLE;MASCULIN;APPRENTISSAGE;BAC PROFESSIONNEL;BAC PRO PROD;BAC PRO 25406 OUVRAGES DU BATIMENT METALLERIE;5;4;4;0;0;0;0;4;0;0;1;3;0;0
2418.0;2021;08;GRENOBLE;MASCULIN;APPRENTISSAGE;BAC PROFESSIONNEL;BAC PRO PROD;BAC PRO AG 22107 TEC CONS VTE ALIMENTATION P.ALIM;8;8;8;0;0;0;0;8;0;2;3;0;3;0
2422.0;2021;08;GRENOBLE;MASCULIN;APPRENTISSAGE;BAC PROFESSIONNEL;BAC PRO SERV;BAC PRO 31108 TRANSPORT;6;6;6;0;0;0;0;6;0;1;1;3;1;0
2427.0;2021;08;GRENOBLE;MASCULIN;APPRENTISSAGE;BAC PROFESSIONNEL;BAC PRO SERV;BAC PRO AG 33002 SERV PERS TERRIT;1;1;1;0;0;0;0;1;0;0;0;1;0;0
2442.0;2021;08;GRENOBLE;MASCULIN;INDIVIDUEL;BAC GENERAL;BAC GENERAL;BAC GENE 10019 BAC GENERAL;75;44;17;13;14;11;3;28;0;1;0;6;21;16
2443.0;2021;08;GRENOBLE;MASCULIN;INDIVIDUEL;BAC PROFESSIONNEL;BAC PRO PROD;BACPRO 20002 ETUD.DEFINITION PRDTS INDUSTRIEL;2;2;0;2;0;0;0;0;0;0;0;0;0;2
2444.0;2021;08;GRENOBLE;MASCULIN;INDIVIDUEL;BAC PROFESSIONNEL;BAC PRO PROD;BAC PRO 22004 PROC. CHIMIE EAU PAPIERS-CARTONS;2;1;1;0;0;0;0;1;0;0;0;0;1;0
2448.0;2021;08;GRENOBLE;MASCULIN;INDIVIDUEL;BAC PROFESSIONNEL;BAC PRO PROD;BAC PRO 25007 MAINTENANCE EQUIPEMENTS INDUST.;2;1;0;1;0;0;0;0;0;0;0;0;0;1
2453.0;2021;08;GRENOBLE;MASCULIN;INDIVIDUEL;BAC PROFESSIONNEL;BAC PRO PROD;BAC PRO 25411 TECH.CHAUDRONNERIE INDUSTRIELLE;1;1;1;0;0;0;0;1;0;0;0;0;1;0
2466.0;2021;08;GRENOBLE;MASCULIN;INDIVIDUEL;BAC PROFESSIONNEL;BAC PRO SERV;BAC PRO 31206 VENTE (PROSPECT.NEGO.SUIV.CLIENT;4;4;3;0;1;1;0;4;0;0;0;0;4;0
2473.0;2021;08;GRENOBLE;MASCULIN;INDIVIDUEL;BAC TECHNOLOGIQUE;BAC STI2D;BAC STI2D ARCHITECTURE ET CONSTRUCTION;1;0;0;0;0;0;0;0;0;0;0;0;0;0
2480.0;2021;08;GRENOBLE;MASCULIN;INDIVIDUEL;BAC TECHNOLOGIQUE;BAC STMG;BAC STMG RESSOURCES HUMAINES ET COMMUNICATION;6;1;0;1;0;0;0;0;0;0;0;0;0;1
2482.0;2021;08;GRENOBLE;MASCULIN;SCOLAIRE;BAC GENERAL;BAC GENERAL;BAC GENE 10019 BAC GENERAL;8478;8478;8036;45;397;256;141;8292;101;756;1917;3047;2471;186
2490.0;2021;08;GRENOBLE;MASCULIN;SCOLAIRE;BAC PROFESSIONNEL;BAC PRO PROD;BAC PRO 22703 TECHN.INSTALL.SYST.ENERG.CLIMATI;105;105;67;24;14;5;9;72;0;0;13;20;39;33
2493.0;2021;08;GRENOBLE;MASCULIN;SCOLAIRE;BAC PROFESSIONNEL;BAC PRO PROD;BAC PRO 23004 TECHN. ETUDES BAT.A ETUDES & ECO.;33;33;22;5;6;4;2;26;0;1;3;5;17;7
2496.0;2021;08;GRENOBLE;MASCULIN;SCOLAIRE;BAC PROFESSIONNEL;BAC PRO PROD;BACPRO 23103 TECHNICIEN GEOMETRE-TOPOGRAPHE;19;19;15;3;1;1;0;16;0;0;3;9;4;3
2502.0;2021;08;GRENOBLE;MASCULIN;SCOLAIRE;BAC PROFESSIONNEL;BAC PRO PROD;BAC PRO 23405 TECHNICIEN MENUISIER AGENCEUR;130;130;113;7;10;4;6;117;0;5;24;52;36;13
2503.0;2021;08;GRENOBLE;MASCULIN;SCOLAIRE;BAC PROFESSIONNEL;BAC PRO PROD;BAC PRO 23407 TECHNIC.FAB.BOIS ET MATERX ASSOC;33;33;32;1;0;0;0;32;0;1;4;8;19;1
2505.0;2021;08;GRENOBLE;MASCULIN;SCOLAIRE;BAC PROFESSIONNEL;BAC PRO PROD;BAC PRO 24203 METIERS DE LA MODE - VÊTEMENT;10;10;9;0;1;1;0;10;0;0;3;3;4;0
2509.0;2021;08;GRENOBLE;MASCULIN;SCOLAIRE;BAC PROFESSIONNEL;BAC PRO PROD;BAC PRO 25006 MICROTECHNIQUES;49;49;41;5;3;2;1;43;0;5;7;19;12;6
2510.0;2021;08;GRENOBLE;MASCULIN;SCOLAIRE;BAC PROFESSIONNEL;BAC PRO PROD;BAC PRO 25007 MAINTENANCE EQUIPEMENTS INDUST.;391;389;292;60;37;26;11;318;0;17;56;105;140;71
2511.0;2021;08;GRENOBLE;MASCULIN;SCOLAIRE;BAC PROFESSIONNEL;BAC PRO PROD;BAC PRO 25106 TECHNICIEN D'USINAGE;161;160;101;45;14;13;1;114;0;4;12;36;62;46
2514.0;2021;08;GRENOBLE;MASCULIN;SCOLAIRE;BAC PROFESSIONNEL;BAC PRO PROD;BAC PRO 25215 MAINT.VEHIC.OPTB VEHIC.TRANS.ROUT;23;23;21;2;0;0;0;21;0;2;5;6;8;2
2527.0;2021;08;GRENOBLE;MASCULIN;SCOLAIRE;BAC PROFESSIONNEL;BAC PRO PROD;BAC PRO AG 21004 CGEA;104;102;94;8;0;0;0;94;0;5;15;34;40;8
2530.0;2021;08;GRENOBLE;MASCULIN;SCOLAIRE;BAC PROFESSIONNEL;BAC PRO PROD;BAC PRO AG 21204 PROD-AQUACOLES;16;16;16;0;0;0;0;16;0;0;4;7;5;0
2532.0;2021;08;GRENOBLE;MASCULIN;SCOLAIRE;BAC PROFESSIONNEL;BAC PRO PROD;BAC PRO AG 21211 COND GEST ENTR HIPPIQUE;6;6;4;2;0;0;0;4;0;0;0;1;3;2
2537.0;2021;08;GRENOBLE;MASCULIN;SCOLAIRE;BAC PROFESSIONNEL;BAC PRO PROD;BAC PRO AG 22105 LABORATOIRE CONTROLE QUALITE;20;19;19;0;0;0;0;19;0;1;1;8;9;0
2544.0;2021;08;GRENOBLE;MASCULIN;SCOLAIRE;BAC PROFESSIONNEL;BAC PRO SERV;BAC PRO 31202 COMMERCE;483;483;421;23;39;24;15;445;0;20;105;184;136;38
2548.0;2021;08;GRENOBLE;MASCULIN;SCOLAIRE;BAC PROFESSIONNEL;BAC PRO SERV;BAC PRO 32208 REAL.PR.IMPR.PLURI.OPTB.PR.IMPR.;6;6;5;1;0;0;0;5;0;1;3;1;0;1
2558.0;2021;08;GRENOBLE;MASCULIN;SCOLAIRE;BAC PROFESSIONNEL;BAC PRO SERV;BAC PRO AG 33002 SERV PERS TERRIT;64;63;59;4;0;0;0;59;0;2;5;24;28;4
2560.0;2021;08;GRENOBLE;MASCULIN;SCOLAIRE;BAC TECHNOLOGIQUE;BAC ST2S;BAC ST2S SCIENCES & TECHNO. SANTE & SOCIAL;98;98;89;3;6;4;2;93;0;0;11;49;33;5
2578.0;2021;32;GUADELOUPE;FEMININ;ENSEIGNEMENT A DISTANCE;BAC GENERAL;BAC GENERAL;BAC GENE 10019 BAC GENERAL;7;7;6;0;1;1;0;7;0;1;3;1;2;0
2581.0;2021;32;GUADELOUPE;FEMININ;ENSEIGNEMENT A DISTANCE;BAC TECHNOLOGIQUE;BAC ST2S;BAC ST2S SCIENCES & TECHNO. SANTE & SOCIAL;2;2;2;0;0;0;0;2;0;1;0;1;0;0
2583.0;2021;32;GUADELOUPE;FEMININ;FORMATION CONTINUE;BAC PROFESSIONNEL;BAC PRO SERV;BAC PRO 31202 COMMERCE;4;4;2;1;1;1;0;3;0;0;0;1;2;1
2585.0;2021;32;GUADELOUPE;FEMININ;FORMATION CONTINUE;BAC PROFESSIONNEL;BAC PRO SERV;BAC PRO 33004 ACC.SOINS-S.PERS. OPT.EN STRUCTUR;8;6;4;1;1;1;0;5;0;0;0;1;4;1
2592.0;2021;32;GUADELOUPE;FEMININ;INDIVIDUEL;BAC PROFESSIONNEL;BAC PRO SERV;BAC PRO 33004 ACC.SOINS-S.PERS. OPT.EN STRUCTUR;3;3;1;2;0;0;0;1;0;0;0;1;0;2
2605.0;2021;32;GUADELOUPE;FEMININ;SCOLAIRE;BAC PROFESSIONNEL;BAC PRO PROD;BAC PRO 23005 TECHN. ETUDES BAT B ASSIST.ARCHI.;4;4;4;0;0;0;0;4;0;0;0;1;3;0
2621.0;2021;32;GUADELOUPE;FEMININ;SCOLAIRE;BAC PROFESSIONNEL;BAC PRO PROD;BAC PRO AG 21405 AMENAGEMENTS PAYSAGERS;2;1;1;0;0;0;0;1;0;0;0;1;0;0
2622.0;2021;32;GUADELOUPE;FEMININ;SCOLAIRE;BAC PROFESSIONNEL;BAC PRO PROD;BAC PRO AG 22107 TEC CONS VTE ALIMENTATION P.ALIM;3;3;3;0;0;0;0;3;0;0;0;1;2;0
2625.0;2021;32;GUADELOUPE;FEMININ;SCOLAIRE;BAC PROFESSIONNEL;BAC PRO SERV;BAC PRO 31202 COMMERCE;64;64;52;2;10;9;1;61;0;0;9;25;27;3
2628.0;2021;32;GUADELOUPE;FEMININ;SCOLAIRE;BAC PROFESSIONNEL;BAC PRO SERV;BAC PRO 32303 ART.& MET.ART:COM.VIS.VIS.PLURI-M;3;3;3;0;0;0;0;3;0;0;0;0;3;0
2634.0;2021;32;GUADELOUPE;FEMININ;SCOLAIRE;BAC PROFESSIONNEL;BAC PRO SERV;BAC PRO 33603 ESTHETIQUE COSMETIQUE PARFUMERIE;33;33;32;0;1;1;0;33;0;3;2;13;15;0
2638.0;2021;32;GUADELOUPE;FEMININ;SCOLAIRE;BAC TECHNOLOGIQUE;BAC S2TMD;BAC S2TMD MUSIQUE;3;3;3;0;0;0;0;3;0;3;0;0;0;0
2639.0;2021;32;GUADELOUPE;FEMININ;SCOLAIRE;BAC TECHNOLOGIQUE;BAC S2TMD;BAC S2TMD THEATRE;4;4;4;0;0;0;0;4;0;0;1;1;2;0
2642.0;2021;32;GUADELOUPE;FEMININ;SCOLAIRE;BAC TECHNOLOGIQUE;BAC STD2A;BAC STD2A SCIENCES & TECHNO. DESIGN-ARTS APPLIQUES;27;27;27;0;0;0;0;27;0;0;10;15;2;0
2645.0;2021;32;GUADELOUPE;FEMININ;SCOLAIRE;BAC TECHNOLOGIQUE;BAC STI2D;BAC STI2D ENERGIES  ET ENVIRONNEMENT;4;4;4;0;0;0;0;4;0;0;1;1;2;0
2647.0;2021;32;GUADELOUPE;FEMININ;SCOLAIRE;BAC TECHNOLOGIQUE;BAC STI2D;BAC STI2D SYSTÈME D'INFORMATION  ET NUMERIQUE;4;4;3;0;1;1;0;4;0;0;1;1;2;0
2650.0;2021;32;GUADELOUPE;FEMININ;SCOLAIRE;BAC TECHNOLOGIQUE;BAC STMG;BAC STMG GESTION ET FINANCE;67;67;63;1;3;3;0;66;0;1;9;25;31;1
2651.0;2021;32;GUADELOUPE;FEMININ;SCOLAIRE;BAC TECHNOLOGIQUE;BAC STMG;BAC STMG MERCATIQUE (MARKETING);98;98;89;0;9;8;1;97;0;3;14;36;44;1
2654.0;2021;32;GUADELOUPE;MASCULIN;APPRENTISSAGE;BAC PROFESSIONNEL;BAC PRO PROD;BAC PRO 25509 TECHNIC. FROID CONDITIONNEMT AIR;1;1;0;1;0;0;0;0;0;0;0;0;0;1
2656.0;2021;32;GUADELOUPE;MASCULIN;APPRENTISSAGE;BAC PROFESSIONNEL;BAC PRO PROD;BAC PRO AG 21004 CGEA;5;5;5;0;0;0;0;5;0;0;0;2;3;0
2667.0;2021;32;GUADELOUPE;MASCULIN;INDIVIDUEL;BAC PROFESSIONNEL;BAC PRO PROD;BAC PRO 22106 CUISINE;1;1;1;0;0;0;0;1;0;0;0;0;1;0
2676.0;2021;32;GUADELOUPE;MASCULIN;INDIVIDUEL;BAC TECHNOLOGIQUE;BAC ST2S;BAC ST2S SCIENCES & TECHNO. SANTE & SOCIAL;3;2;1;0;1;1;0;2;0;0;0;0;2;0
2677.0;2021;32;GUADELOUPE;MASCULIN;INDIVIDUEL;BAC TECHNOLOGIQUE;BAC STI2D;BAC STI2D INNOVATION TECHNO.  ET ECO CONCEPTION;1;0;0;0;0;0;0;0;0;0;0;0;0;0
2687.0;2021;32;GUADELOUPE;MASCULIN;SCOLAIRE;BAC PROFESSIONNEL;BAC PRO PROD;BAC PRO 23003 ARTIS. & M.ART:MARCHANDISAGE VIS.;9;9;6;3;0;0;0;6;0;0;1;3;2;3
2689.0;2021;32;GUADELOUPE;MASCULIN;SCOLAIRE;BAC PROFESSIONNEL;BAC PRO PROD;BAC PRO 23005 TECHN. ETUDES BAT B ASSIST.ARCHI.;7;7;4;0;3;3;0;7;0;0;0;2;5;0
2699.0;2021;32;GUADELOUPE;MASCULIN;SCOLAIRE;BAC PROFESSIONNEL;BAC PRO PROD;BAC PRO 25214 MAINT.VEHIC.OPTA VOIT.PARTICUL.;71;71;55;10;6;2;4;57;0;1;13;17;26;14
2707.0;2021;32;GUADELOUPE;MASCULIN;SCOLAIRE;BAC PROFESSIONNEL;BAC PRO PROD;BAC PRO 25411 TECH.CHAUDRONNERIE INDUSTRIELLE;23;23;14;9;0;0;0;14;0;0;0;4;10;9
2708.0;2021;32;GUADELOUPE;MASCULIN;SCOLAIRE;BAC PROFESSIONNEL;BAC PRO PROD;BAC PRO 25509 TECHNIC. FROID CONDITIONNEMT AIR;44;44;29;10;5;3;2;32;0;0;0;10;22;12
2710.0;2021;32;GUADELOUPE;MASCULIN;SCOLAIRE;BAC PROFESSIONNEL;BAC PRO PROD;BAC PRO 25513 SYST.NUM.OPT.A SURETE SECURITE;27;27;26;0;1;0;1;26;0;1;4;10;11;1
2717.0;2021;32;GUADELOUPE;MASCULIN;SCOLAIRE;BAC PROFESSIONNEL;BAC PRO SERV;BAC PRO 31106 LOGISTIQUE;16;16;15;0;1;1;0;16;0;1;1;5;9;0
2719.0;2021;32;GUADELOUPE;MASCULIN;SCOLAIRE;BAC PROFESSIONNEL;BAC PRO SERV;BAC PRO 31202 COMMERCE;69;69;41;10;18;12;6;53;0;0;4;20;29;16
2726.0;2021;32;GUADELOUPE;MASCULIN;SCOLAIRE;BAC PROFESSIONNEL;BAC PRO SERV;BAC PRO 33403 COMMERC. SERVICES EN RESTAURATION;16;16;14;1;1;1;0;15;0;1;5;5;4;1
2728.0;2021;32;GUADELOUPE;MASCULIN;SCOLAIRE;BAC PROFESSIONNEL;BAC PRO SERV;BAC PRO 34304 HYGIENE PROPRETE STERILISATION;2;2;0;0;2;0;2;0;0;0;0;0;0;2
2731.0;2021;32;GUADELOUPE;MASCULIN;SCOLAIRE;BAC TECHNOLOGIQUE;BAC S2TMD;BAC S2TMD MUSIQUE;3;3;3;0;0;0;0;3;0;0;2;1;0;0
2734.0;2021;32;GUADELOUPE;MASCULIN;SCOLAIRE;BAC TECHNOLOGIQUE;BAC STAV;BAC STAV AGRONOMIE ALIM ENV TERRITOI;13;13;13;0;0;0;0;13;0;0;1;7;5;0
2736.0;2021;32;GUADELOUPE;MASCULIN;SCOLAIRE;BAC TECHNOLOGIQUE;BAC STHR;BAC STHR SC.&TEC. HOTELLERIE-RESTAURATION;10;10;10;0;0;0;0;10;0;0;3;4;3;0
2739.0;2021;32;GUADELOUPE;MASCULIN;SCOLAIRE;BAC TECHNOLOGIQUE;BAC STI2D;BAC STI2D INNOVATION TECHNO.  ET ECO CONCEPTION;51;51;43;1;7;5;2;48;0;0;2;17;29;3
2741.0;2021;32;GUADELOUPE;MASCULIN;SCOLAIRE;BAC TECHNOLOGIQUE;BAC STL;BAC STL BIOCHIM.-BIOLOGIE-BIOTECHNOL.;10;10;9;1;0;0;0;9;0;0;1;3;5;1
2745.0;2021;32;GUADELOUPE;MASCULIN;SCOLAIRE;BAC TECHNOLOGIQUE;BAC STMG;BAC STMG SYSTEMES D'INFORMATION DE GESTION;10;10;7;2;1;1;0;8;0;0;0;3;5;2
2754.0;2021;33;GUYANE;FEMININ;INDIVIDUEL;BAC PROFESSIONNEL;BAC PRO PROD;BAC PRO AG 21114 CONDUITE PRODUCTIONS HORTICOLES;2;2;2;0;0;0;0;2;0;0;0;0;2;0
2755.0;2021;33;GUYANE;FEMININ;INDIVIDUEL;BAC PROFESSIONNEL;BAC PRO SERV;BAC PRO 30001 GESTION-ADMINISTRATION;5;5;3;1;1;0;1;3;0;0;0;1;2;2
2757.0;2021;33;GUYANE;FEMININ;INDIVIDUEL;BAC PROFESSIONNEL;BAC PRO SERV;BAC PRO 31210 ACCUEIL -RELATION CLIENTS USAGERS;6;5;4;1;0;0;0;4;0;0;0;0;4;1
2768.0;2021;33;GUYANE;FEMININ;SCOLAIRE;BAC PROFESSIONNEL;BAC PRO PROD;BAC PRO 23004 TECHN. ETUDES BAT.A ETUDES & ECO.;6;6;0;5;1;1;0;1;0;0;0;0;1;5
2771.0;2021;33;GUYANE;FEMININ;SCOLAIRE;BAC PROFESSIONNEL;BAC PRO PROD;BAC PRO 23203 TECHNICIEN BAT. : ORG.REAL.GROS O;1;1;1;0;0;0;0;1;0;0;1;0;0;0
2772.0;2021;33;GUYANE;FEMININ;SCOLAIRE;BAC PROFESSIONNEL;BAC PRO PROD;BAC PRO 23205 INTERV. SUR PATRIMOINE BATI OPT.A;2;2;1;1;0;0;0;1;0;0;0;0;1;1
2782.0;2021;33;GUYANE;FEMININ;SCOLAIRE;BAC PROFESSIONNEL;BAC PRO PROD;BAC PRO AG 21004 CGEA;11;10;9;1;0;0;0;9;0;1;2;1;5;1
2786.0;2021;33;GUYANE;FEMININ;SCOLAIRE;BAC PROFESSIONNEL;BAC PRO SERV;BAC PRO 31106 LOGISTIQUE;2;2;0;2;0;0;0;0;0;0;0;0;0;2
2789.0;2021;33;GUYANE;FEMININ;SCOLAIRE;BAC PROFESSIONNEL;BAC PRO SERV;BAC PRO 31209 POISSONIER ECAILLER TRAITEUR;4;4;1;2;1;1;0;2;0;0;0;0;2;2
2793.0;2021;33;GUYANE;FEMININ;SCOLAIRE;BAC PROFESSIONNEL;BAC PRO SERV;BAC PRO 33003 ACC.SOINS-S.PERS. OPT.A DOMICILE;40;40;26;3;11;7;4;33;0;0;5;9;19;7
2794.0;2021;33;GUYANE;FEMININ;SCOLAIRE;BAC PROFESSIONNEL;BAC PRO SERV;BAC PRO 33004 ACC.SOINS-S.PERS. OPT.EN STRUCTUR;84;84;68;7;9;9;0;77;0;1;15;26;35;7
2795.0;2021;33;GUYANE;FEMININ;SCOLAIRE;BAC PROFESSIONNEL;BAC PRO SERV;BAC PRO 33403 COMMERC. SERVICES EN RESTAURATION;16;16;12;2;2;1;1;13;0;0;2;4;7;3
2796.0;2021;33;GUYANE;FEMININ;SCOLAIRE;BAC PROFESSIONNEL;BAC PRO SERV;BAC PRO 34303 GEST. POLLUTIONS PROTEC. ENVIRON.;2;2;1;0;1;1;0;2;0;0;0;0;2;0
2799.0;2021;33;GUYANE;FEMININ;SCOLAIRE;BAC TECHNOLOGIQUE;BAC ST2S;BAC ST2S SCIENCES & TECHNO. SANTE & SOCIAL;169;169;134;6;29;10;19;144;0;4;20;29;91;25
2800.0;2021;33;GUYANE;FEMININ;SCOLAIRE;BAC TECHNOLOGIQUE;BAC STAV;BAC STAV AGRONOMIE ALIM ENV TERRITOI;4;4;4;0;0;0;0;4;0;0;1;3;0;0
2801.0;2021;33;GUYANE;FEMININ;SCOLAIRE;BAC TECHNOLOGIQUE;BAC STHR;BAC STHR SC.&TEC. HOTELLERIE-RESTAURATION;10;10;7;2;1;0;1;7;0;1;1;2;3;3
2803.0;2021;33;GUYANE;FEMININ;SCOLAIRE;BAC TECHNOLOGIQUE;BAC STI2D;BAC STI2D ENERGIES  ET ENVIRONNEMENT;6;6;6;0;0;0;0;6;0;0;1;4;1;0
2806.0;2021;33;GUYANE;FEMININ;SCOLAIRE;BAC TECHNOLOGIQUE;BAC STL;BAC STL BIOCHIM.-BIOLOGIE-BIOTECHNOL.;17;17;9;2;6;0;6;9;0;0;0;2;7;8
2810.0;2021;33;GUYANE;FEMININ;SCOLAIRE;BAC TECHNOLOGIQUE;BAC STMG;BAC STMG RESSOURCES HUMAINES ET COMMUNICATION;59;59;49;3;7;3;4;52;0;0;4;16;32;7
2813.0;2021;33;GUYANE;MASCULIN;APPRENTISSAGE;BAC PROFESSIONNEL;BAC PRO PROD;BAC PRO AG 22107 TEC CONS VTE ALIMENTATION P.ALIM;1;1;1;0;0;0;0;1;0;0;0;1;0;0
2816.0;2021;33;GUYANE;MASCULIN;FORMATION CONTINUE;BAC PROFESSIONNEL;BAC PRO PROD;BAC PRO AG 21004 CGEA;1;0;0;0;0;0;0;0;0;0;0;0;0;0
2818.0;2021;33;GUYANE;MASCULIN;FORMATION CONTINUE;BAC PROFESSIONNEL;BAC PRO SERV;BAC PRO 31202 COMMERCE;19;18;7;10;1;1;0;8;0;0;2;0;6;10
2821.0;2021;33;GUYANE;MASCULIN;INDIVIDUEL;BAC PROFESSIONNEL;BAC PRO PROD;BAC PRO 25007 MAINTENANCE EQUIPEMENTS INDUST.;1;1;0;1;0;0;0;0;0;0;0;0;0;1
2824.0;2021;33;GUYANE;MASCULIN;INDIVIDUEL;BAC PROFESSIONNEL;BAC PRO PROD;BAC PRO AG 21114 CONDUITE PRODUCTIONS HORTICOLES;2;2;1;1;0;0;0;1;0;0;0;0;1;1
2827.0;2021;33;GUYANE;MASCULIN;INDIVIDUEL;BAC TECHNOLOGIQUE;BAC ST2S;BAC ST2S SCIENCES & TECHNO. SANTE & SOCIAL;1;1;0;0;1;1;0;1;0;0;0;0;1;0
2833.0;2021;33;GUYANE;MASCULIN;SCOLAIRE;BAC PROFESSIONNEL;BAC PRO PROD;BAC PRO 22106 CUISINE;14;14;7;6;1;1;0;8;0;0;2;1;5;6
2858.0;2021;33;GUYANE;MASCULIN;SCOLAIRE;BAC PROFESSIONNEL;BAC PRO SERV;BAC PRO 31202 COMMERCE;57;57;48;3;6;5;1;53;0;2;4;20;27;4
2861.0;2021;33;GUYANE;MASCULIN;SCOLAIRE;BAC PROFESSIONNEL;BAC PRO SERV;BAC PRO 31210 ACCUEIL -RELATION CLIENTS USAGERS;17;17;14;3;0;0;0;14;0;0;0;8;6;3
2867.0;2021;33;GUYANE;MASCULIN;SCOLAIRE;BAC PROFESSIONNEL;BAC PRO SERV;BAC PRO 34303 GEST. POLLUTIONS PROTEC. ENVIRON.;10;10;6;3;1;1;0;7;0;0;0;3;4;3
2872.0;2021;33;GUYANE;MASCULIN;SCOLAIRE;BAC TECHNOLOGIQUE;BAC STHR;BAC STHR SC.&TEC. HOTELLERIE-RESTAURATION;9;9;4;3;2;1;1;5;0;0;0;1;4;4
2878.0;2021;33;GUYANE;MASCULIN;SCOLAIRE;BAC TECHNOLOGIQUE;BAC STL;BAC STL SCIENCES PHYSIQUES CHIMIQUES  EN LABORAT.;9;9;5;2;2;1;1;6;0;0;1;2;3;3
2883.0;2021;28;LA REUNION;FEMININ;APPRENTISSAGE;BAC PROFESSIONNEL;BAC PRO PROD;BAC PRO 25408 REPARATION DES CARROSSERIES;1;1;0;1;0;0;0;0;0;0;0;0;0;1
2893.0;2021;28;LA REUNION;FEMININ;INDIVIDUEL;BAC PROFESSIONNEL;BAC PRO PROD;BAC PRO AG 21114 CONDUITE PRODUCTIONS HORTICOLES;21;14;14;0;0;0;0;14;0;0;0;0;14;0
2894.0;2021;28;LA REUNION;FEMININ;INDIVIDUEL;BAC PROFESSIONNEL;BAC PRO SERV;BAC PRO 30001 GESTION-ADMINISTRATION;3;1;1;0;0;0;0;1;0;0;0;1;0;0
2909.0;2021;28;LA REUNION;FEMININ;SCOLAIRE;BAC PROFESSIONNEL;BAC PRO PROD;BAC PRO 23102 TRAVAUX PUBLICS;1;1;0;0;1;0;1;0;0;0;0;0;0;1
2921.0;2021;28;LA REUNION;FEMININ;SCOLAIRE;BAC PROFESSIONNEL;BAC PRO PROD;BAC PRO 25514 SYST.NUM.OPT.B AUD.RES.EQUIP.DOM.;3;3;3;0;0;0;0;3;0;0;0;1;2;0
2922.0;2021;28;LA REUNION;FEMININ;SCOLAIRE;BAC PROFESSIONNEL;BAC PRO PROD;BAC PRO 25515 SYST.NUM.OPT.C RES.INF.SYST.COMM.;2;2;2;0;0;0;0;2;0;0;0;1;1;0
2924.0;2021;28;LA REUNION;FEMININ;SCOLAIRE;BAC PROFESSIONNEL;BAC PRO PROD;BAC PRO AG 21004 CGEA;4;3;2;1;0;0;0;2;0;0;0;2;0;1
2925.0;2021;28;LA REUNION;FEMININ;SCOLAIRE;BAC PROFESSIONNEL;BAC PRO PROD;BAC PRO AG 21114 CONDUITE PRODUCTIONS HORTICOLES;2;2;2;0;0;0;0;2;0;0;1;0;1;0
2929.0;2021;28;LA REUNION;FEMININ;SCOLAIRE;BAC PROFESSIONNEL;BAC PRO PROD;BAC PRO AG 22107 TEC CONS VTE ALIMENTATION P.ALIM;4;4;3;1;0;0;0;3;0;0;0;0;3;1
2934.0;2021;28;LA REUNION;FEMININ;SCOLAIRE;BAC PROFESSIONNEL;BAC PRO SERV;BAC PRO 31206 VENTE (PROSPECT.NEGO.SUIV.CLIENT;33;32;23;2;7;1;6;24;0;3;4;6;11;8
2939.0;2021;28;LA REUNION;FEMININ;SCOLAIRE;BAC PROFESSIONNEL;BAC PRO SERV;BAC PRO 33002 SERVICES DE PROXIMITE  VIE LOCAL;35;35;25;6;4;3;1;28;0;0;6;12;10;7
2941.0;2021;28;LA REUNION;FEMININ;SCOLAIRE;BAC PROFESSIONNEL;BAC PRO SERV;BAC PRO 33004 ACC.SOINS-S.PERS. OPT.EN STRUCTUR;153;153;137;7;9;7;2;144;0;5;34;52;53;9
2951.0;2021;28;LA REUNION;FEMININ;SCOLAIRE;BAC TECHNOLOGIQUE;BAC STD2A;BAC STD2A SCIENCES & TECHNO. DESIGN-ARTS APPLIQUES;23;23;23;0;0;0;0;23;0;2;9;6;6;0
2953.0;2021;28;LA REUNION;FEMININ;SCOLAIRE;BAC TECHNOLOGIQUE;BAC STI2D;BAC STI2D ARCHITECTURE ET CONSTRUCTION;43;43;42;0;1;1;0;43;0;1;10;16;16;0
2955.0;2021;28;LA REUNION;FEMININ;SCOLAIRE;BAC TECHNOLOGIQUE;BAC STI2D;BAC STI2D INNOVATION TECHNO.  ET ECO CONCEPTION;15;15;11;0;4;3;1;14;0;0;2;5;7;1
2976.0;2021;28;LA REUNION;MASCULIN;ENSEIGNEMENT A DISTANCE;BAC TECHNOLOGIQUE;BAC STMG;BAC STMG GESTION ET FINANCE;2;2;2;0;0;0;0;2;0;0;1;1;0;0
2986.0;2021;28;LA REUNION;MASCULIN;INDIVIDUEL;BAC PROFESSIONNEL;BAC PRO SERV;BAC PRO 33004 ACC.SOINS-S.PERS. OPT.EN STRUCTUR;1;1;0;1;0;0;0;0;0;0;0;0;0;1
2987.0;2021;28;LA REUNION;MASCULIN;INDIVIDUEL;BAC TECHNOLOGIQUE;BAC ST2S;BAC ST2S SCIENCES & TECHNO. SANTE & SOCIAL;2;0;0;0;0;0;0;0;0;0;0;0;0;0
2990.0;2021;28;LA REUNION;MASCULIN;INDIVIDUEL;BAC TECHNOLOGIQUE;BAC STI2D;BAC STI2D SYSTÈME D'INFORMATION  ET NUMERIQUE;1;0;0;0;0;0;0;0;0;0;0;0;0;0
2994.0;2021;28;LA REUNION;MASCULIN;SCOLAIRE;BAC PROFESSIONNEL;BAC PRO PROD;BACPRO 20002 ETUD.DEFINITION PRDTS INDUSTRIEL;8;8;7;0;1;1;0;8;0;0;0;3;5;0
2995.0;2021;28;LA REUNION;MASCULIN;SCOLAIRE;BAC PROFESSIONNEL;BAC PRO PROD;BAC PRO 20102 PILOTE DE LIGNE DE PRODUCTION;4;4;3;0;1;0;1;3;0;0;0;2;1;1
2996.0;2021;28;LA REUNION;MASCULIN;SCOLAIRE;BAC PROFESSIONNEL;BAC PRO PROD;BAC PRO 22003 BIO-INDUSTRIES DE TRANSFORMATION;13;13;11;1;1;0;1;11;0;0;0;3;8;2
3003.0;2021;28;LA REUNION;MASCULIN;SCOLAIRE;BAC PROFESSIONNEL;BAC PRO PROD;BAC PRO 23003 ARTIS. & M.ART:MARCHANDISAGE VIS.;2;2;2;0;0;0;0;2;0;0;0;1;1;0
3006.0;2021;28;LA REUNION;MASCULIN;SCOLAIRE;BAC PROFESSIONNEL;BAC PRO PROD;BAC PRO 23102 TRAVAUX PUBLICS;26;26;16;3;7;5;2;21;0;0;4;6;11;5
3007.0;2021;28;LA REUNION;MASCULIN;SCOLAIRE;BAC PROFESSIONNEL;BAC PRO PROD;BACPRO 23103 TECHNICIEN GEOMETRE-TOPOGRAPHE;32;32;23;6;3;2;1;25;0;0;2;7;16;7
3018.0;2021;28;LA REUNION;MASCULIN;SCOLAIRE;BAC PROFESSIONNEL;BAC PRO PROD;BAC PRO 24203 METIERS DE LA MODE - VÊTEMENT;2;2;1;1;0;0;0;1;0;1;0;0;0;1
3019.0;2021;28;LA REUNION;MASCULIN;SCOLAIRE;BAC PROFESSIONNEL;BAC PRO PROD;BAC PRO 25007 MAINTENANCE EQUIPEMENTS INDUST.;88;88;52;18;18;11;7;63;0;0;5;26;32;25
3025.0;2021;28;LA REUNION;MASCULIN;SCOLAIRE;BAC PROFESSIONNEL;BAC PRO PROD;BAC PRO 25221 MAINT.MATERIELS OPT.C ESP. VERTS;3;3;0;1;2;2;0;2;0;0;0;0;2;1
3032.0;2021;28;LA REUNION;MASCULIN;SCOLAIRE;BAC PROFESSIONNEL;BAC PRO PROD;BAC PRO 25513 SYST.NUM.OPT.A SURETE SECURITE;20;20;12;4;4;4;0;16;0;0;2;5;9;4
3034.0;2021;28;LA REUNION;MASCULIN;SCOLAIRE;BAC PROFESSIONNEL;BAC PRO PROD;BAC PRO 25515 SYST.NUM.OPT.C RES.INF.SYST.COMM.;91;91;77;9;5;2;3;79;0;3;23;37;16;12
3042.0;2021;28;LA REUNION;MASCULIN;SCOLAIRE;BAC PROFESSIONNEL;BAC PRO SERV;BAC PRO 30001 GESTION-ADMINISTRATION;177;177;135;22;20;12;8;147;0;3;23;49;72;30
3049.0;2021;28;LA REUNION;MASCULIN;SCOLAIRE;BAC PROFESSIONNEL;BAC PRO SERV;BAC PRO 32208 REAL.PR.IMPR.PLURI.OPTB.PR.IMPR.;13;13;9;3;1;1;0;10;0;0;4;1;5;3
3067.0;2021;28;LA REUNION;MASCULIN;SCOLAIRE;BAC TECHNOLOGIQUE;BAC STI2D;BAC STI2D SYSTÈME D'INFORMATION  ET NUMERIQUE;177;177;156;2;19;10;9;166;0;7;32;62;65;11
3072.0;2021;28;LA REUNION;MASCULIN;SCOLAIRE;BAC TECHNOLOGIQUE;BAC STMG;BAC STMG RESSOURCES HUMAINES ET COMMUNICATION;138;138;100;9;29;22;7;122;0;0;11;27;84;16
3075.0;2021;09;LILLE;FEMININ;APPRENTISSAGE;BAC PROFESSIONNEL;BAC PRO PROD;BAC PRO 22004 PROC. CHIMIE EAU PAPIERS-CARTONS;3;3;3;0;0;0;0;3;0;3;0;0;0;0
3080.0;2021;09;LILLE;FEMININ;APPRENTISSAGE;BAC PROFESSIONNEL;BAC PRO PROD;BAC PRO 23304 AMENAGEMENT FINITION BATIMENT;2;2;2;0;0;0;0;2;0;0;1;1;0;0
3102.0;2021;09;LILLE;FEMININ;APPRENTISSAGE;BAC PROFESSIONNEL;BAC PRO SERV;BAC PRO 33603 ESTHETIQUE COSMETIQUE PARFUMERIE;5;5;4;1;0;0;0;4;0;0;1;2;1;1
3106.0;2021;09;LILLE;FEMININ;ENSEIGNEMENT A DISTANCE;BAC PROFESSIONNEL;BAC PRO SERV;BAC PRO 31202 COMMERCE;2;1;1;0;0;0;0;1;0;0;0;0;1;0
3124.0;2021;09;LILLE;FEMININ;FORMATION CONTINUE;BAC PROFESSIONNEL;BAC PRO SERV;BAC PRO 32304 PHOTOGRAPHIE;1;1;1;0;0;0;0;1;0;1;0;0;0;0
3127.0;2021;09;LILLE;FEMININ;INDIVIDUEL;BAC PROFESSIONNEL;BAC PRO PROD;BAC PRO 22106 CUISINE;1;0;0;0;0;0;0;0;0;0;0;0;0;0
3129.0;2021;09;LILLE;FEMININ;INDIVIDUEL;BAC PROFESSIONNEL;BAC PRO PROD;BAC PRO AG 21004 CGEA;3;3;3;0;0;0;0;3;0;0;0;0;3;0
3136.0;2021;09;LILLE;FEMININ;INDIVIDUEL;BAC PROFESSIONNEL;BAC PRO SERV;BAC PRO 31210 ACCUEIL -RELATION CLIENTS USAGERS;2;2;0;2;0;0;0;0;0;0;0;0;0;2
3143.0;2021;09;LILLE;FEMININ;INDIVIDUEL;BAC TECHNOLOGIQUE;BAC STMG;BAC STMG MERCATIQUE (MARKETING);6;4;2;1;1;0;1;2;0;0;1;1;0;2
3152.0;2021;09;LILLE;FEMININ;SCOLAIRE;BAC PROFESSIONNEL;BAC PRO PROD;BAC PRO 23003 ARTIS. & M.ART:MARCHANDISAGE VIS.;11;11;6;3;2;1;1;7;0;0;3;2;2;4
3154.0;2021;09;LILLE;FEMININ;SCOLAIRE;BAC PROFESSIONNEL;BAC PRO PROD;BAC PRO 23005 TECHN. ETUDES BAT B ASSIST.ARCHI.;4;4;4;0;0;0;0;4;0;1;2;1;0;0
3156.0;2021;09;LILLE;FEMININ;SCOLAIRE;BAC PROFESSIONNEL;BAC PRO PROD;BAC PRO 23203 TECHNICIEN BAT. : ORG.REAL.GROS O;1;1;0;1;0;0;0;0;0;0;0;0;0;1
3158.0;2021;09;LILLE;FEMININ;SCOLAIRE;BAC PROFESSIONNEL;BAC PRO PROD;BAC PRO 23404 TECHNICIEN CONSTRUCTEUR BOIS;1;1;1;0;0;0;0;1;0;0;0;0;1;0
3159.0;2021;09;LILLE;FEMININ;SCOLAIRE;BAC PROFESSIONNEL;BAC PRO PROD;BAC PRO 23405 TECHNICIEN MENUISIER AGENCEUR;8;8;7;0;1;1;0;8;0;0;2;3;3;0
3161.0;2021;09;LILLE;FEMININ;SCOLAIRE;BAC PROFESSIONNEL;BAC PRO PROD;BAC PRO 23408 Etude et réalisation d'agencement;13;13;13;0;0;0;0;13;0;2;6;3;2;0
3162.0;2021;09;LILLE;FEMININ;SCOLAIRE;BAC PROFESSIONNEL;BAC PRO PROD;BAC PRO 24203 METIERS DE LA MODE - VÊTEMENT;102;101;85;16;0;0;0;85;0;9;19;36;21;16
3168.0;2021;09;LILLE;FEMININ;SCOLAIRE;BAC PROFESSIONNEL;BAC PRO PROD;BAC PRO 25303 AERONAUTIQUE OPTION SYSTEMES;2;2;2;0;0;0;0;2;0;0;0;0;2;0
3175.0;2021;09;LILLE;FEMININ;SCOLAIRE;BAC PROFESSIONNEL;BAC PRO PROD;BAC PRO 25514 SYST.NUM.OPT.B AUD.RES.EQUIP.DOM.;2;2;2;0;0;0;0;2;0;0;0;0;2;0
3177.0;2021;09;LILLE;FEMININ;SCOLAIRE;BAC PROFESSIONNEL;BAC PRO PROD;BAC PRO AG 21001 AGRO-EQUIPEMENT;2;2;2;0;0;0;0;2;0;0;0;0;2;0
3178.0;2021;09;LILLE;FEMININ;SCOLAIRE;BAC PROFESSIONNEL;BAC PRO PROD;BAC PRO AG 21004 CGEA;75;74;65;9;0;0;0;65;0;2;6;17;40;9
3185.0;2021;09;LILLE;FEMININ;SCOLAIRE;BAC PROFESSIONNEL;BAC PRO PROD;BAC PRO AG 21405 AMENAGEMENTS PAYSAGERS;12;12;11;1;0;0;0;11;0;1;2;5;3;1
3186.0;2021;09;LILLE;FEMININ;SCOLAIRE;BAC PROFESSIONNEL;BAC PRO PROD;BAC PRO AG 21406 TEC CONS VTE PROD DES JARDINS;24;24;23;1;0;0;0;23;0;0;4;8;11;1
3195.0;2021;09;LILLE;FEMININ;SCOLAIRE;BAC PROFESSIONNEL;BAC PRO SERV;BAC PRO 31210 ACCUEIL -RELATION CLIENTS USAGERS;271;270;217;31;22;15;7;232;0;8;47;89;88;38
3218.0;2021;09;LILLE;FEMININ;SCOLAIRE;BAC TECHNOLOGIQUE;BAC STI2D;BAC STI2D ARCHITECTURE ET CONSTRUCTION;39;39;36;1;2;1;1;37;0;1;12;12;12;2
3221.0;2021;09;LILLE;FEMININ;SCOLAIRE;BAC TECHNOLOGIQUE;BAC STI2D;BAC STI2D SYSTÈME D'INFORMATION  ET NUMERIQUE;16;16;16;0;0;0;0;16;0;0;5;5;6;0
3223.0;2021;09;LILLE;FEMININ;SCOLAIRE;BAC TECHNOLOGIQUE;BAC STL;BAC STL SCIENCES PHYSIQUES CHIMIQUES  EN LABORAT.;89;89;85;0;4;2;2;87;2;7;13;34;31;2
3228.0;2021;09;LILLE;MASCULIN;APPRENTISSAGE;BAC PROFESSIONNEL;BAC PRO PROD;BAC PRO 20102 PILOTE DE LIGNE DE PRODUCTION;11;11;11;0;0;0;0;11;0;3;3;5;0;0
3237.0;2021;09;LILLE;MASCULIN;APPRENTISSAGE;BAC PROFESSIONNEL;BAC PRO PROD;BAC PRO 23203 TECHNICIEN BAT. : ORG.REAL.GROS O;5;5;4;1;0;0;0;4;0;0;1;2;1;1
3238.0;2021;09;LILLE;MASCULIN;APPRENTISSAGE;BAC PROFESSIONNEL;BAC PRO PROD;BAC PRO 23303 MENUISERIE ALUMINIUM-VERRE;13;13;13;0;0;0;0;13;0;1;4;7;1;0
3241.0;2021;09;LILLE;MASCULIN;APPRENTISSAGE;BAC PROFESSIONNEL;BAC PRO PROD;BAC PRO 25007 MAINTENANCE EQUIPEMENTS INDUST.;72;69;59;8;2;1;1;60;0;12;16;13;19;9
3253.0;2021;09;LILLE;MASCULIN;APPRENTISSAGE;BAC PROFESSIONNEL;BAC PRO PROD;BAC PRO 25509 TECHNIC. FROID CONDITIONNEMT AIR;1;1;1;0;0;0;0;1;0;0;0;0;1;0
3255.0;2021;09;LILLE;MASCULIN;APPRENTISSAGE;BAC PROFESSIONNEL;BAC PRO PROD;BAC PRO AG 21001 AGRO-EQUIPEMENT;27;27;26;1;0;0;0;26;0;0;1;8;17;1
3259.0;2021;09;LILLE;MASCULIN;APPRENTISSAGE;BAC PROFESSIONNEL;BAC PRO PROD;BAC PRO AG 21211 COND GEST ENTR HIPPIQUE;2;2;1;1;0;0;0;1;0;0;0;1;0;1
3261.0;2021;09;LILLE;MASCULIN;APPRENTISSAGE;BAC PROFESSIONNEL;BAC PRO PROD;BAC PRO AG 22107 TEC CONS VTE ALIMENTATION P.ALIM;13;13;13;0;0;0;0;13;0;0;1;5;7;0
3262.0;2021;09;LILLE;MASCULIN;APPRENTISSAGE;BAC PROFESSIONNEL;BAC PRO SERV;BAC PRO 30001 GESTION-ADMINISTRATION;2;2;2;0;0;0;0;2;0;0;1;0;1;0
3263.0;2021;09;LILLE;MASCULIN;APPRENTISSAGE;BAC PROFESSIONNEL;BAC PRO SERV;BAC PRO 31106 LOGISTIQUE;22;21;14;4;3;2;1;16;0;1;4;4;7;5
3265.0;2021;09;LILLE;MASCULIN;APPRENTISSAGE;BAC PROFESSIONNEL;BAC PRO SERV;BAC PRO 31206 VENTE (PROSPECT.NEGO.SUIV.CLIENT;3;3;3;0;0;0;0;3;0;1;1;1;0;0
3269.0;2021;09;LILLE;MASCULIN;APPRENTISSAGE;BAC PROFESSIONNEL;BAC PRO SERV;BAC PRO AG 33002 SERV PERS TERRIT;3;3;3;0;0;0;0;3;0;0;1;1;1;0
3272.0;2021;09;LILLE;MASCULIN;ENSEIGNEMENT A DISTANCE;BAC PROFESSIONNEL;BAC PRO SERV;BAC PRO 31206 VENTE (PROSPECT.NEGO.SUIV.CLIENT;1;1;1;0;0;0;0;1;0;0;0;0;1;0
3297.0;2021;09;LILLE;MASCULIN;FORMATION CONTINUE;BAC PROFESSIONNEL;BAC PRO SERV;BAC PRO 31202 COMMERCE;17;14;13;1;0;0;0;13;0;1;5;4;3;1
3299.0;2021;09;LILLE;MASCULIN;INDIVIDUEL;BAC PROFESSIONNEL;BAC PRO PROD;BACPRO 20002 ETUD.DEFINITION PRDTS INDUSTRIEL;1;0;0;0;0;0;0;0;0;0;0;0;0;0
3302.0;2021;09;LILLE;MASCULIN;INDIVIDUEL;BAC PROFESSIONNEL;BAC PRO PROD;BAC PRO 25007 MAINTENANCE EQUIPEMENTS INDUST.;1;1;1;0;0;0;0;1;0;0;1;0;0;0
3308.0;2021;09;LILLE;MASCULIN;INDIVIDUEL;BAC PROFESSIONNEL;BAC PRO SERV;BAC PRO 30001 GESTION-ADMINISTRATION;3;1;1;0;0;0;0;1;0;0;0;0;1;0
3309.0;2021;09;LILLE;MASCULIN;INDIVIDUEL;BAC PROFESSIONNEL;BAC PRO SERV;BAC PRO 31202 COMMERCE;4;1;1;0;0;0;0;1;0;0;0;1;0;0
3312.0;2021;09;LILLE;MASCULIN;INDIVIDUEL;BAC PROFESSIONNEL;BAC PRO SERV;BAC PRO 33004 ACC.SOINS-S.PERS. OPT.EN STRUCTUR;2;0;0;0;0;0;0;0;0;0;0;0;0;0
3313.0;2021;09;LILLE;MASCULIN;INDIVIDUEL;BAC PROFESSIONNEL;BAC PRO SERV;BAC PRO 33403 COMMERC. SERVICES EN RESTAURATION;1;0;0;0;0;0;0;0;0;0;0;0;0;0
3319.0;2021;09;LILLE;MASCULIN;INDIVIDUEL;BAC TECHNOLOGIQUE;BAC STL;BAC STL BIOCHIM.-BIOLOGIE-BIOTECHNOL.;2;1;1;0;0;0;0;1;0;0;0;1;0;0
3322.0;2021;09;LILLE;MASCULIN;INDIVIDUEL;BAC TECHNOLOGIQUE;BAC STMG;BAC STMG RESSOURCES HUMAINES ET COMMUNICATION;12;7;3;2;2;0;2;3;0;0;0;2;1;4
3323.0;2021;09;LILLE;MASCULIN;INDIVIDUEL;BAC TECHNOLOGIQUE;BAC STMG;BAC STMG SYSTEMES D'INFORMATION DE GESTION;2;0;0;0;0;0;0;0;0;0;0;0;0;0
3328.0;2021;09;LILLE;MASCULIN;SCOLAIRE;BAC PROFESSIONNEL;BAC PRO PROD;BAC PRO 22105 BOULANGER-PÂTISSIER;89;88;79;4;5;4;1;83;0;8;15;35;25;5
3335.0;2021;09;LILLE;MASCULIN;SCOLAIRE;BAC PROFESSIONNEL;BAC PRO PROD;BAC PRO 23004 TECHN. ETUDES BAT.A ETUDES & ECO.;68;68;40;19;9;6;3;46;0;0;7;18;21;22
3336.0;2021;09;LILLE;MASCULIN;SCOLAIRE;BAC PROFESSIONNEL;BAC PRO PROD;BAC PRO 23005 TECHN. ETUDES BAT B ASSIST.ARCHI.;15;15;13;1;1;1;0;14;0;0;2;5;7;1
3339.0;2021;09;LILLE;MASCULIN;SCOLAIRE;BAC PROFESSIONNEL;BAC PRO PROD;BAC PRO 23203 TECHNICIEN BAT. : ORG.REAL.GROS O;98;98;63;27;8;3;5;66;0;0;13;26;27;32
3351.0;2021;09;LILLE;MASCULIN;SCOLAIRE;BAC PROFESSIONNEL;BAC PRO PROD;BAC PRO 25215 MAINT.VEHIC.OPTB VEHIC.TRANS.ROUT;43;43;38;4;1;1;0;39;0;3;10;16;10;4
3355.0;2021;09;LILLE;MASCULIN;SCOLAIRE;BAC PROFESSIONNEL;BAC PRO PROD;BAC PRO 25221 MAINT.MATERIELS OPT.C ESP. VERTS;3;3;3;0;0;0;0;3;0;0;0;3;0;0
3362.0;2021;09;LILLE;MASCULIN;SCOLAIRE;BAC PROFESSIONNEL;BAC PRO PROD;BAC PRO 25510 METIERS ELECT. ENVIRON. CONNECTES;919;918;740;153;25;17;8;757;0;60;173;301;223;161
3370.0;2021;09;LILLE;MASCULIN;SCOLAIRE;BAC PROFESSIONNEL;BAC PRO PROD;BAC PRO AG 21204 PROD-AQUACOLES;10;9;9;0;0;0;0;9;0;0;2;2;5;0
3371.0;2021;09;LILLE;MASCULIN;SCOLAIRE;BAC PROFESSIONNEL;BAC PRO PROD;BAC PRO AG 21210 COND GEST ENTR CANIN ET FELIN;6;6;6;0;0;0;0;6;0;0;1;3;2;0
3372.0;2021;09;LILLE;MASCULIN;SCOLAIRE;BAC PROFESSIONNEL;BAC PRO PROD;BAC PRO AG 21211 COND GEST ENTR HIPPIQUE;3;3;3;0;0;0;0;3;0;0;1;1;1;0
3375.0;2021;09;LILLE;MASCULIN;SCOLAIRE;BAC PROFESSIONNEL;BAC PRO PROD;BAC PRO AG 21405 AMENAGEMENTS PAYSAGERS;94;91;88;3;0;0;0;88;0;2;14;38;34;3
3383.0;2021;09;LILLE;MASCULIN;SCOLAIRE;BAC PROFESSIONNEL;BAC PRO SERV;BAC PRO 31202 COMMERCE;1046;1035;786;159;90;58;32;844;0;27;181;288;348;191
3384.0;2021;09;LILLE;MASCULIN;SCOLAIRE;BAC PROFESSIONNEL;BAC PRO SERV;BAC PRO 31206 VENTE (PROSPECT.NEGO.SUIV.CLIENT;224;223;173;37;13;8;5;181;0;3;34;76;68;42
3386.0;2021;09;LILLE;MASCULIN;SCOLAIRE;BAC PROFESSIONNEL;BAC PRO SERV;BAC PRO 32207 REAL.PR.IMPR.PLURI.OPTA.PR.GRAPH.;23;23;17;6;0;0;0;17;0;2;1;8;6;6
3389.0;2021;09;LILLE;MASCULIN;SCOLAIRE;BAC PROFESSIONNEL;BAC PRO SERV;BAC PRO 32304 PHOTOGRAPHIE;5;5;4;1;0;0;0;4;0;0;1;0;3;1
3393.0;2021;09;LILLE;MASCULIN;SCOLAIRE;BAC PROFESSIONNEL;BAC PRO SERV;BAC PRO 33101 OPTIQUE LUNETTERIE;19;19;17;0;2;1;1;18;0;1;4;8;5;1
3401.0;2021;09;LILLE;MASCULIN;SCOLAIRE;BAC TECHNOLOGIQUE;BAC S2TMD;BAC S2TMD MUSIQUE;8;8;8;0;0;0;0;8;0;1;3;4;0;0
3412.0;2021;09;LILLE;MASCULIN;SCOLAIRE;BAC TECHNOLOGIQUE;BAC STMG;BAC STMG GESTION ET FINANCE;565;564;475;27;62;42;20;517;0;9;75;192;241;47
3416.0;2021;22;LIMOGES;FEMININ;APPRENTISSAGE;BAC PROFESSIONNEL;BAC PRO PROD;BAC PRO 23207 INTERV. SUR PATRIMOINE BATI OPT.C;2;2;2;0;0;0;0;2;0;1;1;0;0;0
3428.0;2021;22;LIMOGES;FEMININ;ENSEIGNEMENT A DISTANCE;BAC PROFESSIONNEL;BAC PRO SERV;BAC PRO 30001 GESTION-ADMINISTRATION;1;0;0;0;0;0;0;0;0;0;0;0;0;0
3431.0;2021;22;LIMOGES;FEMININ;ENSEIGNEMENT A DISTANCE;BAC TECHNOLOGIQUE;BAC STMG;BAC STMG MERCATIQUE (MARKETING);2;2;2;0;0;0;0;2;0;0;1;1;0;0
3434.0;2021;22;LIMOGES;FEMININ;INDIVIDUEL;BAC GENERAL;BAC GENERAL;BAC GENE 10019 BAC GENERAL;9;5;4;0;1;1;0;5;0;0;0;0;5;0
3440.0;2021;22;LIMOGES;FEMININ;INDIVIDUEL;BAC PROFESSIONNEL;BAC PRO SERV;BAC PRO 31202 COMMERCE;1;1;0;1;0;0;0;0;0;0;0;0;0;1
3447.0;2021;22;LIMOGES;FEMININ;INDIVIDUEL;BAC TECHNOLOGIQUE;BAC STMG;BAC STMG MERCATIQUE (MARKETING);2;2;0;1;1;0;1;0;0;0;0;0;0;2
3450.0;2021;22;LIMOGES;FEMININ;SCOLAIRE;BAC PROFESSIONNEL;BAC PRO PROD;BAC PRO 22004 PROC. CHIMIE EAU PAPIERS-CARTONS;4;4;3;1;0;0;0;3;0;0;0;1;2;1
3453.0;2021;22;LIMOGES;FEMININ;SCOLAIRE;BAC PROFESSIONNEL;BAC PRO PROD;BAC PRO 23004 TECHN. ETUDES BAT.A ETUDES & ECO.;3;3;2;1;0;0;0;2;0;0;0;1;1;1
3454.0;2021;22;LIMOGES;FEMININ;SCOLAIRE;BAC PROFESSIONNEL;BAC PRO PROD;BAC PRO 23005 TECHN. ETUDES BAT B ASSIST.ARCHI.;2;2;2;0;0;0;0;2;0;0;0;1;1;0
3455.0;2021;22;LIMOGES;FEMININ;SCOLAIRE;BAC PROFESSIONNEL;BAC PRO PROD;BAC PRO 23102 TRAVAUX PUBLICS;3;3;3;0;0;0;0;3;0;0;2;1;0;0
3460.0;2021;22;LIMOGES;FEMININ;SCOLAIRE;BAC PROFESSIONNEL;BAC PRO PROD;BAC PRO 24203 METIERS DE LA MODE - VÊTEMENT;27;27;22;3;2;2;0;24;0;4;7;9;4;3
3471.0;2021;22;LIMOGES;FEMININ;SCOLAIRE;BAC PROFESSIONNEL;BAC PRO PROD;BAC PRO AG 21114 CONDUITE PRODUCTIONS HORTICOLES;3;3;2;1;0;0;0;2;0;0;0;2;0;1
3476.0;2021;22;LIMOGES;FEMININ;SCOLAIRE;BAC PROFESSIONNEL;BAC PRO PROD;BAC PRO AG 21406 TEC CONS VTE PROD DES JARDINS;2;2;2;0;0;0;0;2;0;0;1;1;0;0
3477.0;2021;22;LIMOGES;FEMININ;SCOLAIRE;BAC PROFESSIONNEL;BAC PRO PROD;BAC PRO AG 22105 LABORATOIRE CONTROLE QUALITE;9;8;7;1;0;0;0;7;0;0;1;3;3;1
3481.0;2021;22;LIMOGES;FEMININ;SCOLAIRE;BAC PROFESSIONNEL;BAC PRO SERV;BAC PRO 31206 VENTE (PROSPECT.NEGO.SUIV.CLIENT;10;10;9;0;1;1;0;10;0;2;1;4;3;0
3484.0;2021;22;LIMOGES;FEMININ;SCOLAIRE;BAC PROFESSIONNEL;BAC PRO SERV;BAC PRO 32208 REAL.PR.IMPR.PLURI.OPTB.PR.IMPR.;2;2;2;0;0;0;0;2;0;0;1;1;0;0
3488.0;2021;22;LIMOGES;FEMININ;SCOLAIRE;BAC PROFESSIONNEL;BAC PRO SERV;BAC PRO 33004 ACC.SOINS-S.PERS. OPT.EN STRUCTUR;138;137;124;7;6;3;3;127;0;7;27;54;39;10
3491.0;2021;22;LIMOGES;FEMININ;SCOLAIRE;BAC PROFESSIONNEL;BAC PRO SERV;BAC PRO 33603 ESTHETIQUE COSMETIQUE PARFUMERIE;45;45;45;0;0;0;0;45;0;1;8;24;12;0
3492.0;2021;22;LIMOGES;FEMININ;SCOLAIRE;BAC PROFESSIONNEL;BAC PRO SERV;BAC PRO 34304 HYGIENE PROPRETE STERILISATION;4;3;3;0;0;0;0;3;0;0;0;2;1;0
3520.0;2021;22;LIMOGES;MASCULIN;APPRENTISSAGE;BAC PROFESSIONNEL;BAC PRO PROD;BAC PRO 25106 TECHNICIEN D'USINAGE;12;12;10;1;1;1;0;11;0;0;2;2;7;1
3522.0;2021;22;LIMOGES;MASCULIN;APPRENTISSAGE;BAC PROFESSIONNEL;BAC PRO PROD;BAC PRO 25215 MAINT.VEHIC.OPTB VEHIC.TRANS.ROUT;8;8;7;1;0;0;0;7;0;0;1;6;0;1
3523.0;2021;22;LIMOGES;MASCULIN;APPRENTISSAGE;BAC PROFESSIONNEL;BAC PRO PROD;BAC PRO 25216 MAINT.VEHIC.OPTC MOTOCYCLES;4;4;3;0;1;1;0;4;0;1;1;1;1;0
3525.0;2021;22;LIMOGES;MASCULIN;APPRENTISSAGE;BAC PROFESSIONNEL;BAC PRO PROD;BAC PRO 25221 MAINT.MATERIELS OPT.C ESP. VERTS;2;2;2;0;0;0;0;2;0;0;1;0;1;0
3526.0;2021;22;LIMOGES;MASCULIN;APPRENTISSAGE;BAC PROFESSIONNEL;BAC PRO PROD;BAC PRO 25408 REPARATION DES CARROSSERIES;5;5;4;0;1;1;0;5;0;0;0;3;2;0
3546.0;2021;22;LIMOGES;MASCULIN;INDIVIDUEL;BAC PROFESSIONNEL;BAC PRO PROD;BAC PRO AG 21004 CGEA;3;2;2;0;0;0;0;2;0;0;0;0;2;0
3548.0;2021;22;LIMOGES;MASCULIN;INDIVIDUEL;BAC PROFESSIONNEL;BAC PRO PROD;BAC PRO AG 21114 CONDUITE PRODUCTIONS HORTICOLES;2;1;1;0;0;0;0;1;0;0;0;0;1;0
3550.0;2021;22;LIMOGES;MASCULIN;INDIVIDUEL;BAC PROFESSIONNEL;BAC PRO SERV;BAC PRO 31202 COMMERCE;2;2;0;1;1;1;0;1;0;0;0;0;1;1
3551.0;2021;22;LIMOGES;MASCULIN;INDIVIDUEL;BAC PROFESSIONNEL;BAC PRO SERV;BAC PRO 31206 VENTE (PROSPECT.NEGO.SUIV.CLIENT;3;1;1;0;0;0;0;1;0;0;0;0;1;0
3557.0;2021;22;LIMOGES;MASCULIN;SCOLAIRE;BAC PROFESSIONNEL;BAC PRO PROD;BAC PRO 20102 PILOTE DE LIGNE DE PRODUCTION;9;9;7;0;2;1;1;8;0;0;1;2;5;1
3571.0;2021;22;LIMOGES;MASCULIN;SCOLAIRE;BAC PROFESSIONNEL;BAC PRO PROD;BAC PRO 24202 ARTIS.& MET.ART : TAPIS.D'AMEUBL;2;2;2;0;0;0;0;2;0;0;0;0;2;0
3572.0;2021;22;LIMOGES;MASCULIN;SCOLAIRE;BAC PROFESSIONNEL;BAC PRO PROD;BAC PRO 24203 METIERS DE LA MODE - VÊTEMENT;3;3;3;0;0;0;0;3;0;0;1;2;0;0
3574.0;2021;22;LIMOGES;MASCULIN;SCOLAIRE;BAC PROFESSIONNEL;BAC PRO PROD;BAC PRO 25106 TECHNICIEN D'USINAGE;46;46;26;20;0;0;0;26;0;0;5;9;12;20
3584.0;2021;22;LIMOGES;MASCULIN;SCOLAIRE;BAC PROFESSIONNEL;BAC PRO PROD;BAC PRO 25410 CONSTRUCTION DES CARROSSERIES;4;4;1;1;2;1;1;2;0;0;0;0;2;2
3587.0;2021;22;LIMOGES;MASCULIN;SCOLAIRE;BAC PROFESSIONNEL;BAC PRO PROD;BAC PRO 25510 METIERS ELECT. ENVIRON. CONNECTES;102;102;80;21;1;1;0;81;0;3;13;27;38;21
3588.0;2021;22;LIMOGES;MASCULIN;SCOLAIRE;BAC PROFESSIONNEL;BAC PRO PROD;BAC PRO 25514 SYST.NUM.OPT.B AUD.RES.EQUIP.DOM.;27;27;25;2;0;0;0;25;0;0;7;7;11;2
3598.0;2021;22;LIMOGES;MASCULIN;SCOLAIRE;BAC PROFESSIONNEL;BAC PRO PROD;BAC PRO AG 21405 AMENAGEMENTS PAYSAGERS;19;19;17;2;0;0;0;17;0;0;3;8;6;2
3603.0;2021;22;LIMOGES;MASCULIN;SCOLAIRE;BAC PROFESSIONNEL;BAC PRO SERV;BAC PRO 31107 CONDUCT. TRANSP.ROUT.MARCHANDISES;17;17;16;1;0;0;0;16;0;0;5;5;6;1
3608.0;2021;22;LIMOGES;MASCULIN;SCOLAIRE;BAC PROFESSIONNEL;BAC PRO SERV;BAC PRO 32207 REAL.PR.IMPR.PLURI.OPTA.PR.GRAPH.;10;10;9;1;0;0;0;9;0;1;2;6;0;1
3611.0;2021;22;LIMOGES;MASCULIN;SCOLAIRE;BAC PROFESSIONNEL;BAC PRO SERV;BAC PRO 33002 SERVICES DE PROXIMITE  VIE LOCAL;14;14;14;0;0;0;0;14;0;0;1;8;5;0
3612.0;2021;22;LIMOGES;MASCULIN;SCOLAIRE;BAC PROFESSIONNEL;BAC PRO SERV;BAC PRO 33003 ACC.SOINS-S.PERS. OPT.A DOMICILE;5;5;5;0;0;0;0;5;0;0;0;3;2;0
3621.0;2021;22;LIMOGES;MASCULIN;SCOLAIRE;BAC TECHNOLOGIQUE;BAC STD2A;BAC STD2A SCIENCES & TECHNO. DESIGN-ARTS APPLIQUES;4;4;3;0;1;1;0;4;0;0;0;3;1;0
3623.0;2021;22;LIMOGES;MASCULIN;SCOLAIRE;BAC TECHNOLOGIQUE;BAC STI2D;BAC STI2D ARCHITECTURE ET CONSTRUCTION;34;34;26;0;8;4;4;30;0;1;2;12;15;4
3627.0;2021;22;LIMOGES;MASCULIN;SCOLAIRE;BAC TECHNOLOGIQUE;BAC STL;BAC STL BIOCHIM.-BIOLOGIE-BIOTECHNOL.;13;13;13;0;0;0;0;13;0;0;2;4;7;0
3634.0;2021;10;LYON;FEMININ;APPRENTISSAGE;BAC PROFESSIONNEL;BAC PRO PROD;BAC PRO 22003 BIO-INDUSTRIES DE TRANSFORMATION;5;5;4;1;0;0;0;4;0;1;3;0;0;1
3635.0;2021;10;LYON;FEMININ;APPRENTISSAGE;BAC PROFESSIONNEL;BAC PRO PROD;BAC PRO 22004 PROC. CHIMIE EAU PAPIERS-CARTONS;1;1;1;0;0;0;0;1;0;0;1;0;0;0
3640.0;2021;10;LYON;FEMININ;APPRENTISSAGE;BAC PROFESSIONNEL;BAC PRO PROD;BAC PRO 23203 TECHNICIEN BAT. : ORG.REAL.GROS O;1;1;1;0;0;0;0;1;0;0;0;1;0;0
3646.0;2021;10;LYON;FEMININ;APPRENTISSAGE;BAC PROFESSIONNEL;BAC PRO PROD;BAC PRO 25214 MAINT.VEHIC.OPTA VOIT.PARTICUL.;5;5;3;1;1;1;0;4;0;1;1;1;1;1
3649.0;2021;10;LYON;FEMININ;APPRENTISSAGE;BAC PROFESSIONNEL;BAC PRO PROD;BAC PRO 25408 REPARATION DES CARROSSERIES;3;3;1;2;0;0;0;1;0;0;0;0;1;2
3670.0;2021;10;LYON;FEMININ;APPRENTISSAGE;BAC PROFESSIONNEL;BAC PRO SERV;BAC PRO AG 33002 SERV PERS TERRIT;8;8;8;0;0;0;0;8;0;1;2;3;2;0
3671.0;2021;10;LYON;FEMININ;ENSEIGNEMENT A DISTANCE;BAC GENERAL;BAC GENERAL;BAC GENE 10019 BAC GENERAL;75;73;68;3;2;1;1;69;3;12;25;14;15;4
3676.0;2021;10;LYON;FEMININ;FORMATION CONTINUE;BAC PROFESSIONNEL;BAC PRO PROD;BAC PRO 24302 METIERS DU CUIR : MAROQUINERIE;7;7;5;2;0;0;0;5;0;0;1;2;2;2
3679.0;2021;10;LYON;FEMININ;FORMATION CONTINUE;BAC PROFESSIONNEL;BAC PRO SERV;BAC PRO 30001 GESTION-ADMINISTRATION;16;16;15;0;1;1;0;16;0;3;2;9;2;0
3681.0;2021;10;LYON;FEMININ;FORMATION CONTINUE;BAC PROFESSIONNEL;BAC PRO SERV;BAC PRO 31210 ACCUEIL -RELATION CLIENTS USAGERS;2;2;2;0;0;0;0;2;0;2;0;0;0;0
3687.0;2021;10;LYON;FEMININ;INDIVIDUEL;BAC PROFESSIONNEL;BAC PRO PROD;BAC PRO AG 21211 COND GEST ENTR HIPPIQUE;4;3;3;0;0;0;0;3;0;0;0;0;3;0
3691.0;2021;10;LYON;FEMININ;INDIVIDUEL;BAC PROFESSIONNEL;BAC PRO SERV;BAC PRO 31210 ACCUEIL -RELATION CLIENTS USAGERS;8;7;3;3;1;1;0;4;0;0;1;0;3;3
3692.0;2021;10;LYON;FEMININ;INDIVIDUEL;BAC PROFESSIONNEL;BAC PRO SERV;BAC PRO 32304 PHOTOGRAPHIE;1;0;0;0;0;0;0;0;0;0;0;0;0;0
3697.0;2021;10;LYON;FEMININ;INDIVIDUEL;BAC PROFESSIONNEL;BAC PRO SERV;BAC PRO AG 33002 SERV PERS TERRIT;3;3;2;1;0;0;0;2;0;0;0;0;2;1
3699.0;2021;10;LYON;FEMININ;INDIVIDUEL;BAC TECHNOLOGIQUE;BAC ST2S;BAC ST2S SCIENCES & TECHNO. SANTE & SOCIAL;29;25;17;6;2;2;0;19;0;0;0;6;13;6
3703.0;2021;10;LYON;FEMININ;INDIVIDUEL;BAC TECHNOLOGIQUE;BAC STL;BAC STL SCIENCES PHYSIQUES CHIMIQUES  EN LABORAT.;2;1;0;0;1;0;1;0;0;0;0;0;0;1
3720.0;2021;10;LYON;FEMININ;SCOLAIRE;BAC PROFESSIONNEL;BAC PRO PROD;BAC PRO 24002 METIERS PRESSING BLANCHISSERIE;4;4;0;4;0;0;0;0;0;0;0;0;0;4
3727.0;2021;10;LYON;FEMININ;SCOLAIRE;BAC PROFESSIONNEL;BAC PRO PROD;BAC PRO 25106 TECHNICIEN D'USINAGE;2;2;2;0;0;0;0;2;0;0;1;0;1;0
3728.0;2021;10;LYON;FEMININ;SCOLAIRE;BAC PROFESSIONNEL;BAC PRO PROD;BAC PRO 25214 MAINT.VEHIC.OPTA VOIT.PARTICUL.;7;7;5;2;0;0;0;5;0;0;2;2;1;2
3737.0;2021;10;LYON;FEMININ;SCOLAIRE;BAC PROFESSIONNEL;BAC PRO PROD;BAC PRO AG 21004 CGEA;14;14;13;1;0;0;0;13;0;0;0;3;10;1
3738.0;2021;10;LYON;FEMININ;SCOLAIRE;BAC PROFESSIONNEL;BAC PRO PROD;BAC PRO AG 21113 CGEVV;2;2;2;0;0;0;0;2;0;0;0;0;2;0
3739.0;2021;10;LYON;FEMININ;SCOLAIRE;BAC PROFESSIONNEL;BAC PRO PROD;BAC PRO AG 21114 CONDUITE PRODUCTIONS HORTICOLES;17;17;14;3;0;0;0;14;0;0;3;8;3;3
3742.0;2021;10;LYON;FEMININ;SCOLAIRE;BAC PROFESSIONNEL;BAC PRO PROD;BAC PRO AG 21211 COND GEST ENTR HIPPIQUE;73;73;65;8;0;0;0;65;0;2;9;22;32;8
3756.0;2021;10;LYON;FEMININ;SCOLAIRE;BAC PROFESSIONNEL;BAC PRO SERV;BAC PRO 31210 ACCUEIL -RELATION CLIENTS USAGERS;251;251;220;16;15;8;7;228;0;6;41;84;97;23
3764.0;2021;10;LYON;FEMININ;SCOLAIRE;BAC PROFESSIONNEL;BAC PRO SERV;BAC PRO 33101 OPTIQUE LUNETTERIE;13;13;10;2;1;1;0;11;0;1;4;1;5;2
3767.0;2021;10;LYON;FEMININ;SCOLAIRE;BAC PROFESSIONNEL;BAC PRO SERV;BAC PRO 33602 PERRUQUIER POSTICHEUR;10;10;10;0;0;0;0;10;0;5;2;2;1;0
3769.0;2021;10;LYON;FEMININ;SCOLAIRE;BAC PROFESSIONNEL;BAC PRO SERV;BAC PRO 34304 HYGIENE PROPRETE STERILISATION;31;31;22;2;7;4;3;26;0;0;6;5;15;5
3775.0;2021;10;LYON;FEMININ;SCOLAIRE;BAC TECHNOLOGIQUE;BAC STAV;BAC STAV AGRONOMIE ALIM ENV TERRITOI;113;113;113;0;0;0;0;113;0;1;10;55;47;0
3779.0;2021;10;LYON;FEMININ;SCOLAIRE;BAC TECHNOLOGIQUE;BAC STI2D;BAC STI2D ENERGIES  ET ENVIRONNEMENT;13;13;12;0;1;1;0;13;0;1;1;5;6;0
3785.0;2021;10;LYON;FEMININ;SCOLAIRE;BAC TECHNOLOGIQUE;BAC STMG;BAC STMG MERCATIQUE (MARKETING);1020;1020;922;19;79;34;45;956;2;14;123;403;414;64
3787.0;2021;10;LYON;FEMININ;SCOLAIRE;BAC TECHNOLOGIQUE;BAC STMG;BAC STMG SYSTEMES D'INFORMATION DE GESTION;15;15;14;0;1;1;0;15;0;0;1;5;9;0
3809.0;2021;10;LYON;MASCULIN;APPRENTISSAGE;BAC PROFESSIONNEL;BAC PRO PROD;BAC PRO 25107 TECHNICIEN OUTILLEUR;12;12;8;2;2;2;0;10;0;0;2;4;4;2
3812.0;2021;10;LYON;MASCULIN;APPRENTISSAGE;BAC PROFESSIONNEL;BAC PRO PROD;BAC PRO 25216 MAINT.VEHIC.OPTC MOTOCYCLES;9;9;9;0;0;0;0;9;0;2;1;4;2;0
3822.0;2021;10;LYON;MASCULIN;APPRENTISSAGE;BAC PROFESSIONNEL;BAC PRO PROD;BAC PRO 25514 SYST.NUM.OPT.B AUD.RES.EQUIP.DOM.;1;1;1;0;0;0;0;1;0;0;0;0;1;0
3825.0;2021;10;LYON;MASCULIN;APPRENTISSAGE;BAC PROFESSIONNEL;BAC PRO PROD;BAC PRO AG 21113 CGEVV;3;3;3;0;0;0;0;3;0;0;0;1;2;0
3847.0;2021;10;LYON;MASCULIN;ENSEIGNEMENT A DISTANCE;BAC TECHNOLOGIQUE;BAC STMG;BAC STMG RESSOURCES HUMAINES ET COMMUNICATION;3;3;2;1;0;0;0;2;0;0;1;0;1;1
3852.0;2021;10;LYON;MASCULIN;FORMATION CONTINUE;BAC PROFESSIONNEL;BAC PRO PROD;BAC PRO 23205 INTERV. SUR PATRIMOINE BATI OPT.A;5;5;4;1;0;0;0;4;0;0;0;2;2;1
3859.0;2021;10;LYON;MASCULIN;FORMATION CONTINUE;BAC PROFESSIONNEL;BAC PRO SERV;BAC PRO 33102 PROTHESE DENTAIRE;5;5;2;2;1;1;0;3;0;0;1;0;2;2
3864.0;2021;10;LYON;MASCULIN;INDIVIDUEL;BAC PROFESSIONNEL;BAC PRO PROD;BAC PRO 23003 ARTIS. & M.ART:MARCHANDISAGE VIS.;1;0;0;0;0;0;0;0;0;0;0;0;0;0
3866.0;2021;10;LYON;MASCULIN;INDIVIDUEL;BAC PROFESSIONNEL;BAC PRO PROD;BAC PRO 23405 TECHNICIEN MENUISIER AGENCEUR;1;0;0;0;0;0;0;0;0;0;0;0;0;0
3867.0;2021;10;LYON;MASCULIN;INDIVIDUEL;BAC PROFESSIONNEL;BAC PRO PROD;BAC PRO 25007 MAINTENANCE EQUIPEMENTS INDUST.;2;0;0;0;0;0;0;0;0;0;0;0;0;0
3874.0;2021;10;LYON;MASCULIN;INDIVIDUEL;BAC PROFESSIONNEL;BAC PRO PROD;BAC PRO AG 21004 CGEA;5;4;4;0;0;0;0;4;0;0;0;0;4;0
3880.0;2021;10;LYON;MASCULIN;INDIVIDUEL;BAC PROFESSIONNEL;BAC PRO SERV;BAC PRO 30001 GESTION-ADMINISTRATION;16;4;3;1;0;0;0;3;0;0;0;1;2;1
3884.0;2021;10;LYON;MASCULIN;INDIVIDUEL;BAC PROFESSIONNEL;BAC PRO SERV;BAC PRO 31206 VENTE (PROSPECT.NEGO.SUIV.CLIENT;3;1;1;0;0;0;0;1;0;0;1;0;0;0
3887.0;2021;10;LYON;MASCULIN;INDIVIDUEL;BAC PROFESSIONNEL;BAC PRO SERV;BAC PRO 32303 ART.& MET.ART:COM.VIS.VIS.PLURI-M;1;0;0;0;0;0;0;0;0;0;0;0;0;0
3889.0;2021;10;LYON;MASCULIN;INDIVIDUEL;BAC PROFESSIONNEL;BAC PRO SERV;BAC PRO 33004 ACC.SOINS-S.PERS. OPT.EN STRUCTUR;1;1;0;1;0;0;0;0;0;0;0;0;0;1
3897.0;2021;10;LYON;MASCULIN;INDIVIDUEL;BAC TECHNOLOGIQUE;BAC STI2D;BAC STI2D INNOVATION TECHNO.  ET ECO CONCEPTION;3;1;0;0;1;0;1;0;0;0;0;0;0;1
3906.0;2021;10;LYON;MASCULIN;SCOLAIRE;BAC PROFESSIONNEL;BAC PRO PROD;BACPRO 20002 ETUD.DEFINITION PRDTS INDUSTRIEL;31;31;20;10;1;1;0;21;0;0;3;8;10;10
3912.0;2021;10;LYON;MASCULIN;SCOLAIRE;BAC PROFESSIONNEL;BAC PRO PROD;BAC PRO 22106 CUISINE;97;97;88;6;3;0;3;88;0;5;17;41;25;9
3913.0;2021;10;LYON;MASCULIN;SCOLAIRE;BAC PROFESSIONNEL;BAC PRO PROD;BAC PRO 22303 FONDERIE;8;8;7;0;1;0;1;7;0;0;2;2;3;1
3915.0;2021;10;LYON;MASCULIN;SCOLAIRE;BAC PROFESSIONNEL;BAC PRO PROD;BAC PRO 22703 TECHN.INSTALL.SYST.ENERG.CLIMATI;77;77;57;9;11;6;5;63;0;0;3;25;35;14
3923.0;2021;10;LYON;MASCULIN;SCOLAIRE;BAC PROFESSIONNEL;BAC PRO PROD;BAC PRO 23303 MENUISERIE ALUMINIUM-VERRE;16;16;15;1;0;0;0;15;0;0;2;6;7;1
3926.0;2021;10;LYON;MASCULIN;SCOLAIRE;BAC PROFESSIONNEL;BAC PRO PROD;BAC PRO 23405 TECHNICIEN MENUISIER AGENCEUR;102;102;84;9;9;6;3;90;0;4;10;40;36;12
3929.0;2021;10;LYON;MASCULIN;SCOLAIRE;BAC PROFESSIONNEL;BAC PRO PROD;BAC PRO 23408 Etude et réalisation d'agencement;17;17;15;2;0;0;0;15;0;0;3;7;5;2
3932.0;2021;10;LYON;MASCULIN;SCOLAIRE;BAC PROFESSIONNEL;BAC PRO PROD;BAC PRO 24303 MET. DU CUIR: SELLERIE GARNISSAGE;2;1;0;1;0;0;0;0;0;0;0;0;0;1
3934.0;2021;10;LYON;MASCULIN;SCOLAIRE;BAC PROFESSIONNEL;BAC PRO PROD;BAC PRO 25006 MICROTECHNIQUES;25;25;22;3;0;0;0;22;0;0;5;10;7;3
3935.0;2021;10;LYON;MASCULIN;SCOLAIRE;BAC PROFESSIONNEL;BAC PRO PROD;BAC PRO 25007 MAINTENANCE EQUIPEMENTS INDUST.;233;230;168;37;25;10;15;178;0;8;34;56;80;52
3941.0;2021;10;LYON;MASCULIN;SCOLAIRE;BAC PROFESSIONNEL;BAC PRO PROD;BAC PRO 25216 MAINT.VEHIC.OPTC MOTOCYCLES;34;34;32;1;1;1;0;33;0;3;9;8;13;1
3947.0;2021;10;LYON;MASCULIN;SCOLAIRE;BAC PROFESSIONNEL;BAC PRO PROD;BAC PRO 25411 TECH.CHAUDRONNERIE INDUSTRIELLE;80;80;69;7;4;4;0;73;0;4;21;21;27;7
3949.0;2021;10;LYON;MASCULIN;SCOLAIRE;BAC PROFESSIONNEL;BAC PRO PROD;BAC PRO 25510 METIERS ELECT. ENVIRON. CONNECTES;531;531;447;74;10;3;7;450;0;37;95;172;146;81
3950.0;2021;10;LYON;MASCULIN;SCOLAIRE;BAC PROFESSIONNEL;BAC PRO PROD;BAC PRO 25513 SYST.NUM.OPT.A SURETE SECURITE;24;24;20;3;1;1;0;21;0;1;3;8;9;3
3951.0;2021;10;LYON;MASCULIN;SCOLAIRE;BAC PROFESSIONNEL;BAC PRO PROD;BAC PRO 25514 SYST.NUM.OPT.B AUD.RES.EQUIP.DOM.;87;87;80;7;0;0;0;80;0;4;18;37;21;7
3956.0;2021;10;LYON;MASCULIN;SCOLAIRE;BAC PROFESSIONNEL;BAC PRO PROD;BAC PRO AG 21114 CONDUITE PRODUCTIONS HORTICOLES;24;24;19;5;0;0;0;19;0;1;2;4;12;5
3967.0;2021;10;LYON;MASCULIN;SCOLAIRE;BAC PROFESSIONNEL;BAC PRO PROD;BAC PRO AG 22107 TEC CONS VTE ALIMENTATION P.ALIM;34;32;29;3;0;0;0;29;0;0;5;10;14;3
3970.0;2021;10;LYON;MASCULIN;SCOLAIRE;BAC PROFESSIONNEL;BAC PRO SERV;BAC PRO 31107 CONDUCT. TRANSP.ROUT.MARCHANDISES;68;67;55;12;0;0;0;55;0;4;14;23;14;12
3989.0;2021;10;LYON;MASCULIN;SCOLAIRE;BAC PROFESSIONNEL;BAC PRO SERV;BAC PRO AG 33002 SERV PERS TERRIT;32;30;28;2;0;0;0;28;0;0;1;10;17;2
3990.0;2021;10;LYON;MASCULIN;SCOLAIRE;BAC TECHNOLOGIQUE;BAC S2TMD;BAC S2TMD DANSE;2;2;2;0;0;0;0;2;0;0;2;0;0;0
3991.0;2021;10;LYON;MASCULIN;SCOLAIRE;BAC TECHNOLOGIQUE;BAC S2TMD;BAC S2TMD MUSIQUE;4;4;4;0;0;0;0;4;0;1;2;1;0;0
3994.0;2021;10;LYON;MASCULIN;SCOLAIRE;BAC TECHNOLOGIQUE;BAC STD2A;BAC STD2A SCIENCES & TECHNO. DESIGN-ARTS APPLIQUES;38;38;38;0;0;0;0;38;0;5;10;13;10;0
4004.0;2021;10;LYON;MASCULIN;SCOLAIRE;BAC TECHNOLOGIQUE;BAC STMG;BAC STMG RESSOURCES HUMAINES ET COMMUNICATION;267;267;196;24;47;28;19;224;0;0;11;63;150;43
4011.0;2021;31;MARTINIQUE;FEMININ;APPRENTISSAGE;BAC PROFESSIONNEL;BAC PRO SERV;BAC PRO 31210 ACCUEIL -RELATION CLIENTS USAGERS;9;9;9;0;0;0;0;9;0;0;4;3;2;0
4024.0;2021;31;MARTINIQUE;FEMININ;SCOLAIRE;BAC GENERAL;BAC GENERAL;BAC GENE 10019 BAC GENERAL;1149;1149;1088;9;52;42;10;1130;16;145;295;398;276;19
4028.0;2021;31;MARTINIQUE;FEMININ;SCOLAIRE;BAC PROFESSIONNEL;BAC PRO PROD;BAC PRO 23003 ARTIS. & M.ART:MARCHANDISAGE VIS.;8;8;8;0;0;0;0;8;0;1;2;3;2;0
4041.0;2021;31;MARTINIQUE;FEMININ;SCOLAIRE;BAC PROFESSIONNEL;BAC PRO PROD;BAC PRO 25510 METIERS ELECT. ENVIRON. CONNECTES;3;3;2;1;0;0;0;2;0;0;0;1;1;1
4046.0;2021;31;MARTINIQUE;FEMININ;SCOLAIRE;BAC PROFESSIONNEL;BAC PRO PROD;BAC PRO AG 21405 AMENAGEMENTS PAYSAGERS;1;1;1;0;0;0;0;1;0;0;0;1;0;0
4048.0;2021;31;MARTINIQUE;FEMININ;SCOLAIRE;BAC PROFESSIONNEL;BAC PRO SERV;BAC PRO 30001 GESTION-ADMINISTRATION;134;133;89;31;13;9;4;98;0;1;5;27;65;35
4049.0;2021;31;MARTINIQUE;FEMININ;SCOLAIRE;BAC PROFESSIONNEL;BAC PRO SERV;BAC PRO 31106 LOGISTIQUE;3;3;3;0;0;0;0;3;0;0;0;0;3;0
4053.0;2021;31;MARTINIQUE;FEMININ;SCOLAIRE;BAC PROFESSIONNEL;BAC PRO SERV;BAC PRO 31210 ACCUEIL -RELATION CLIENTS USAGERS;34;34;33;0;1;0;1;33;0;1;5;16;11;1
4061.0;2021;31;MARTINIQUE;FEMININ;SCOLAIRE;BAC PROFESSIONNEL;BAC PRO SERV;BAC PRO 34304 HYGIENE PROPRETE STERILISATION;6;6;3;2;1;1;0;4;0;0;0;1;3;2
4067.0;2021;31;MARTINIQUE;FEMININ;SCOLAIRE;BAC TECHNOLOGIQUE;BAC STI2D;BAC STI2D ARCHITECTURE ET CONSTRUCTION;14;14;14;0;0;0;0;14;0;0;1;8;5;0
4068.0;2021;31;MARTINIQUE;FEMININ;SCOLAIRE;BAC TECHNOLOGIQUE;BAC STI2D;BAC STI2D ENERGIES  ET ENVIRONNEMENT;2;2;1;1;0;0;0;1;0;0;0;0;1;1
4075.0;2021;31;MARTINIQUE;FEMININ;SCOLAIRE;BAC TECHNOLOGIQUE;BAC STMG;BAC STMG SYSTEMES D'INFORMATION DE GESTION;10;10;7;2;1;1;0;8;0;0;0;4;4;2
4079.0;2021;31;MARTINIQUE;MASCULIN;APPRENTISSAGE;BAC PROFESSIONNEL;BAC PRO PROD;BAC PRO 22704 TECHN. MAINT. SYST.ENERG.CLIMATI;6;6;4;1;1;1;0;5;0;0;1;1;3;1
4080.0;2021;31;MARTINIQUE;MASCULIN;APPRENTISSAGE;BAC PROFESSIONNEL;BAC PRO PROD;BAC PRO 23203 TECHNICIEN BAT. : ORG.REAL.GROS O;1;1;0;1;0;0;0;0;0;0;0;0;0;1
4081.0;2021;31;MARTINIQUE;MASCULIN;APPRENTISSAGE;BAC PROFESSIONNEL;BAC PRO PROD;BAC PRO 23304 AMENAGEMENT FINITION BATIMENT;4;3;2;1;0;0;0;2;0;0;0;1;1;1
4094.0;2021;31;MARTINIQUE;MASCULIN;ENSEIGNEMENT A DISTANCE;BAC TECHNOLOGIQUE;BAC STMG;BAC STMG MERCATIQUE (MARKETING);1;1;1;0;0;0;0;1;0;0;0;1;0;0
4096.0;2021;31;MARTINIQUE;MASCULIN;INDIVIDUEL;BAC PROFESSIONNEL;BAC PRO PROD;BAC PRO 22004 PROC. CHIMIE EAU PAPIERS-CARTONS;1;1;0;0;1;1;0;1;0;0;0;0;1;0
4098.0;2021;31;MARTINIQUE;MASCULIN;INDIVIDUEL;BAC PROFESSIONNEL;BAC PRO PROD;BAC PRO 25214 MAINT.VEHIC.OPTA VOIT.PARTICUL.;1;1;0;1;0;0;0;0;0;0;0;0;0;1
4100.0;2021;31;MARTINIQUE;MASCULIN;INDIVIDUEL;BAC PROFESSIONNEL;BAC PRO SERV;BAC PRO 30001 GESTION-ADMINISTRATION;2;1;0;1;0;0;0;0;0;0;0;0;0;1
4101.0;2021;31;MARTINIQUE;MASCULIN;INDIVIDUEL;BAC PROFESSIONNEL;BAC PRO SERV;BAC PRO 31106 LOGISTIQUE;1;1;0;1;0;0;0;0;0;0;0;0;0;1
4104.0;2021;31;MARTINIQUE;MASCULIN;INDIVIDUEL;BAC TECHNOLOGIQUE;BAC STI2D;BAC STI2D ARCHITECTURE ET CONSTRUCTION;1;0;0;0;0;0;0;0;0;0;0;0;0;0
4106.0;2021;31;MARTINIQUE;MASCULIN;INDIVIDUEL;BAC TECHNOLOGIQUE;BAC STI2D;BAC STI2D SYSTÈME D'INFORMATION  ET NUMERIQUE;1;0;0;0;0;0;0;0;0;0;0;0;0;0
4110.0;2021;31;MARTINIQUE;MASCULIN;SCOLAIRE;BAC PROFESSIONNEL;BAC PRO PROD;BAC PRO 22004 PROC. CHIMIE EAU PAPIERS-CARTONS;9;9;7;0;2;2;0;9;0;0;2;1;6;0
4120.0;2021;31;MARTINIQUE;MASCULIN;SCOLAIRE;BAC PROFESSIONNEL;BAC PRO PROD;BAC PRO 23203 TECHNICIEN BAT. : ORG.REAL.GROS O;4;4;3;0;1;1;0;4;0;0;0;2;2;0
4123.0;2021;31;MARTINIQUE;MASCULIN;SCOLAIRE;BAC PROFESSIONNEL;BAC PRO PROD;BAC PRO 23404 TECHNICIEN CONSTRUCTEUR BOIS;11;11;8;0;3;2;1;10;0;0;0;3;7;1
4137.0;2021;31;MARTINIQUE;MASCULIN;SCOLAIRE;BAC PROFESSIONNEL;BAC PRO PROD;BAC PRO 25510 METIERS ELECT. ENVIRON. CONNECTES;134;134;105;23;6;6;0;111;0;3;6;51;51;23
4138.0;2021;31;MARTINIQUE;MASCULIN;SCOLAIRE;BAC PROFESSIONNEL;BAC PRO PROD;BAC PRO 25513 SYST.NUM.OPT.A SURETE SECURITE;7;7;7;0;0;0;0;7;0;0;1;4;2;0
4141.0;2021;31;MARTINIQUE;MASCULIN;SCOLAIRE;BAC PROFESSIONNEL;BAC PRO PROD;BAC PRO AG 21001 AGRO-EQUIPEMENT;7;6;6;0;0;0;0;6;0;0;0;1;5;0
4147.0;2021;31;MARTINIQUE;MASCULIN;SCOLAIRE;BAC PROFESSIONNEL;BAC PRO SERV;BAC PRO 31106 LOGISTIQUE;20;20;16;1;3;2;1;18;0;0;1;6;11;2
4148.0;2021;31;MARTINIQUE;MASCULIN;SCOLAIRE;BAC PROFESSIONNEL;BAC PRO SERV;BAC PRO 31108 TRANSPORT;19;19;16;0;3;2;1;18;0;0;2;3;13;1
4153.0;2021;31;MARTINIQUE;MASCULIN;SCOLAIRE;BAC PROFESSIONNEL;BAC PRO SERV;BAC PRO 33002 SERVICES DE PROXIMITE  VIE LOCAL;3;3;2;0;1;1;0;3;0;0;0;1;2;0
4172.0;2021;31;MARTINIQUE;MASCULIN;SCOLAIRE;BAC TECHNOLOGIQUE;BAC STMG;BAC STMG SYSTEMES D'INFORMATION DE GESTION;27;27;17;1;9;9;0;26;0;0;0;3;23;1
4175.0;2021;43;MAYOTTE;FEMININ;ENSEIGNEMENT A DISTANCE;BAC PROFESSIONNEL;BAC PRO SERV;BAC PRO 30001 GESTION-ADMINISTRATION;1;1;1;0;0;0;0;1;0;0;1;0;0;0
4176.0;2021;43;MAYOTTE;FEMININ;INDIVIDUEL;BAC GENERAL;BAC GENERAL;BAC GENE 10019 BAC GENERAL;31;19;0;14;5;1;4;1;0;0;0;0;1;18
4200.0;2021;43;MAYOTTE;FEMININ;SCOLAIRE;BAC PROFESSIONNEL;BAC PRO SERV;BAC PRO 31108 TRANSPORT;6;6;1;2;3;0;3;1;0;0;0;0;1;5
4201.0;2021;43;MAYOTTE;FEMININ;SCOLAIRE;BAC PROFESSIONNEL;BAC PRO SERV;BAC PRO 31202 COMMERCE;84;84;46;10;28;14;14;60;0;1;1;7;51;24
4214.0;2021;43;MAYOTTE;FEMININ;SCOLAIRE;BAC TECHNOLOGIQUE;BAC STI2D;BAC STI2D ARCHITECTURE ET CONSTRUCTION;10;10;8;0;2;0;2;8;0;0;0;3;5;2
4216.0;2021;43;MAYOTTE;FEMININ;SCOLAIRE;BAC TECHNOLOGIQUE;BAC STI2D;BAC STI2D INNOVATION TECHNO.  ET ECO CONCEPTION;8;8;4;0;4;1;3;5;0;0;0;1;4;3
4224.0;2021;43;MAYOTTE;MASCULIN;APPRENTISSAGE;BAC PROFESSIONNEL;BAC PRO SERV;BAC PRO 31106 LOGISTIQUE;12;12;4;7;1;1;0;5;0;0;1;3;1;7
4225.0;2021;43;MAYOTTE;MASCULIN;INDIVIDUEL;BAC GENERAL;BAC GENERAL;BAC GENE 10019 BAC GENERAL;38;21;0;16;5;4;1;4;0;0;0;0;4;17
4228.0;2021;43;MAYOTTE;MASCULIN;INDIVIDUEL;BAC PROFESSIONNEL;BAC PRO PROD;BAC PRO 25510 METIERS ELECT. ENVIRON. CONNECTES;2;2;0;2;0;0;0;0;0;0;0;0;0;2
4232.0;2021;43;MAYOTTE;MASCULIN;INDIVIDUEL;BAC TECHNOLOGIQUE;BAC STD2A;BAC STD2A SCIENCES & TECHNO. DESIGN-ARTS APPLIQUES;1;1;0;1;0;0;0;0;0;0;0;0;0;1
4233.0;2021;43;MAYOTTE;MASCULIN;INDIVIDUEL;BAC TECHNOLOGIQUE;BAC STI2D;BAC STI2D ARCHITECTURE ET CONSTRUCTION;1;1;0;1;0;0;0;0;0;0;0;0;0;1
4236.0;2021;43;MAYOTTE;MASCULIN;INDIVIDUEL;BAC TECHNOLOGIQUE;BAC STMG;BAC STMG GESTION ET FINANCE;7;7;1;4;2;0;2;1;0;0;0;0;1;6
4237.0;2021;43;MAYOTTE;MASCULIN;INDIVIDUEL;BAC TECHNOLOGIQUE;BAC STMG;BAC STMG MERCATIQUE (MARKETING);6;6;0;6;0;0;0;0;0;0;0;0;0;6
4247.0;2021;43;MAYOTTE;MASCULIN;SCOLAIRE;BAC PROFESSIONNEL;BAC PRO PROD;BAC PRO 23304 AMENAGEMENT FINITION BATIMENT;14;14;5;0;9;8;1;13;0;0;0;1;12;1
4267.0;2021;43;MAYOTTE;MASCULIN;SCOLAIRE;BAC PROFESSIONNEL;BAC PRO SERV;BAC PRO 31206 VENTE (PROSPECT.NEGO.SUIV.CLIENT;14;14;9;4;1;1;0;10;0;0;1;5;4;4
4268.0;2021;43;MAYOTTE;MASCULIN;SCOLAIRE;BAC PROFESSIONNEL;BAC PRO SERV;BAC PRO 31210 ACCUEIL -RELATION CLIENTS USAGERS;21;21;14;4;3;1;2;15;0;0;1;4;10;6
4276.0;2021;43;MAYOTTE;MASCULIN;SCOLAIRE;BAC TECHNOLOGIQUE;BAC ST2S;BAC ST2S SCIENCES & TECHNO. SANTE & SOCIAL;6;6;4;0;2;1;1;5;0;0;0;0;5;1
4277.0;2021;43;MAYOTTE;MASCULIN;SCOLAIRE;BAC TECHNOLOGIQUE;BAC STD2A;BAC STD2A SCIENCES & TECHNO. DESIGN-ARTS APPLIQUES;18;18;16;0;2;0;2;16;0;0;1;5;10;2
4283.0;2021;43;MAYOTTE;MASCULIN;SCOLAIRE;BAC TECHNOLOGIQUE;BAC STL;BAC STL SCIENCES PHYSIQUES CHIMIQUES  EN LABORAT.;25;25;14;2;9;7;2;21;0;0;1;3;17;4
4293.0;2021;11;MONTPELLIER;FEMININ;APPRENTISSAGE;BAC PROFESSIONNEL;BAC PRO PROD;BAC PRO 25302 AERONAUTIQUE OPTION AVIONIQUE;1;1;1;0;0;0;0;1;0;0;1;0;0;0
4295.0;2021;11;MONTPELLIER;FEMININ;APPRENTISSAGE;BAC PROFESSIONNEL;BAC PRO PROD;BAC PRO 25510 METIERS ELECT. ENVIRON. CONNECTES;2;2;2;0;0;0;0;2;0;1;1;0;0;0
4297.0;2021;11;MONTPELLIER;FEMININ;APPRENTISSAGE;BAC PROFESSIONNEL;BAC PRO PROD;BAC PRO AG 21203 TECHN CONSEIL DE VENTE ANIMAL;1;1;1;0;0;0;0;1;0;0;1;0;0;0
4298.0;2021;11;MONTPELLIER;FEMININ;APPRENTISSAGE;BAC PROFESSIONNEL;BAC PRO PROD;BAC PRO AG 21211 COND GEST ENTR HIPPIQUE;12;12;12;0;0;0;0;12;0;0;1;4;7;0
4303.0;2021;11;MONTPELLIER;FEMININ;APPRENTISSAGE;BAC PROFESSIONNEL;BAC PRO SERV;BAC PRO 33101 OPTIQUE LUNETTERIE;15;15;14;1;0;0;0;14;0;1;4;4;5;1
4306.0;2021;11;MONTPELLIER;FEMININ;APPRENTISSAGE;BAC PROFESSIONNEL;BAC PRO SERV;BAC PRO AG 33002 SERV PERS TERRIT;7;7;6;1;0;0;0;6;0;2;2;1;1;1
4316.0;2021;11;MONTPELLIER;FEMININ;ENSEIGNEMENT A DISTANCE;BAC TECHNOLOGIQUE;BAC STMG;BAC STMG RESSOURCES HUMAINES ET COMMUNICATION;9;9;9;0;0;0;0;9;0;0;2;5;2;0
4318.0;2021;11;MONTPELLIER;FEMININ;FORMATION CONTINUE;BAC PROFESSIONNEL;BAC PRO PROD;BAC PRO 25510 METIERS ELECT. ENVIRON. CONNECTES;1;1;0;1;0;0;0;0;0;0;0;0;0;1
4321.0;2021;11;MONTPELLIER;FEMININ;FORMATION CONTINUE;BAC PROFESSIONNEL;BAC PRO SERV;BAC PRO 31206 VENTE (PROSPECT.NEGO.SUIV.CLIENT;2;2;1;1;0;0;0;1;0;0;0;1;0;1
4322.0;2021;11;MONTPELLIER;FEMININ;FORMATION CONTINUE;BAC PROFESSIONNEL;BAC PRO SERV;BAC PRO 31210 ACCUEIL -RELATION CLIENTS USAGERS;4;4;4;0;0;0;0;4;0;0;1;2;1;0
4325.0;2021;11;MONTPELLIER;FEMININ;INDIVIDUEL;BAC GENERAL;BAC GENERAL;BAC GENE 10019 BAC GENERAL;106;70;49;14;7;4;3;53;3;7;9;15;19;17
4326.0;2021;11;MONTPELLIER;FEMININ;INDIVIDUEL;BAC PROFESSIONNEL;BAC PRO PROD;BAC PRO 25216 MAINT.VEHIC.OPTC MOTOCYCLES;1;1;1;0;0;0;0;1;0;0;0;1;0;0
4329.0;2021;11;MONTPELLIER;FEMININ;INDIVIDUEL;BAC PROFESSIONNEL;BAC PRO PROD;BAC PRO AG 21114 CONDUITE PRODUCTIONS HORTICOLES;8;7;5;2;0;0;0;5;0;0;0;0;5;2
4332.0;2021;11;MONTPELLIER;FEMININ;INDIVIDUEL;BAC PROFESSIONNEL;BAC PRO SERV;BAC PRO 30001 GESTION-ADMINISTRATION;11;4;3;1;0;0;0;3;0;0;0;2;1;1
4336.0;2021;11;MONTPELLIER;FEMININ;INDIVIDUEL;BAC PROFESSIONNEL;BAC PRO SERV;BAC PRO 33004 ACC.SOINS-S.PERS. OPT.EN STRUCTUR;7;4;4;0;0;0;0;4;0;0;1;0;3;0
4341.0;2021;11;MONTPELLIER;FEMININ;INDIVIDUEL;BAC TECHNOLOGIQUE;BAC ST2S;BAC ST2S SCIENCES & TECHNO. SANTE & SOCIAL;16;12;3;3;6;3;3;6;0;0;1;0;5;6
4347.0;2021;11;MONTPELLIER;FEMININ;SCOLAIRE;BAC PROFESSIONNEL;BAC PRO PROD;BAC PRO 22003 BIO-INDUSTRIES DE TRANSFORMATION;9;9;6;3;0;0;0;6;0;0;0;1;5;3
4356.0;2021;11;MONTPELLIER;FEMININ;SCOLAIRE;BAC PROFESSIONNEL;BAC PRO PROD;BACPRO 23103 TECHNICIEN GEOMETRE-TOPOGRAPHE;2;2;1;1;0;0;0;1;0;0;0;0;1;1
4366.0;2021;11;MONTPELLIER;FEMININ;SCOLAIRE;BAC PROFESSIONNEL;BAC PRO PROD;BAC PRO 25006 MICROTECHNIQUES;3;3;3;0;0;0;0;3;0;0;0;2;1;0
4376.0;2021;11;MONTPELLIER;FEMININ;SCOLAIRE;BAC PROFESSIONNEL;BAC PRO PROD;BAC PRO 25509 TECHNIC. FROID CONDITIONNEMT AIR;1;1;1;0;0;0;0;1;0;0;0;1;0;0
4382.0;2021;11;MONTPELLIER;FEMININ;SCOLAIRE;BAC PROFESSIONNEL;BAC PRO PROD;BAC PRO AG 21114 CONDUITE PRODUCTIONS HORTICOLES;17;17;16;1;0;0;0;16;0;1;2;5;8;1
4387.0;2021;11;MONTPELLIER;FEMININ;SCOLAIRE;BAC PROFESSIONNEL;BAC PRO PROD;BAC PRO AG 21405 AMENAGEMENTS PAYSAGERS;10;10;10;0;0;0;0;10;0;0;0;7;3;0
4391.0;2021;11;MONTPELLIER;FEMININ;SCOLAIRE;BAC PROFESSIONNEL;BAC PRO SERV;BAC PRO 30001 GESTION-ADMINISTRATION;605;605;510;66;29;21;8;531;0;25;103;184;219;74
4396.0;2021;11;MONTPELLIER;FEMININ;SCOLAIRE;BAC PROFESSIONNEL;BAC PRO SERV;BAC PRO 31206 VENTE (PROSPECT.NEGO.SUIV.CLIENT;99;98;87;7;4;3;1;90;0;5;23;38;24;8
4399.0;2021;11;MONTPELLIER;FEMININ;SCOLAIRE;BAC PROFESSIONNEL;BAC PRO SERV;BAC PRO 32208 REAL.PR.IMPR.PLURI.OPTB.PR.IMPR.;1;1;1;0;0;0;0;1;0;0;0;1;0;0
4404.0;2021;11;MONTPELLIER;FEMININ;SCOLAIRE;BAC PROFESSIONNEL;BAC PRO SERV;BAC PRO 33004 ACC.SOINS-S.PERS. OPT.EN STRUCTUR;629;626;566;31;29;19;10;585;0;35;170;231;149;41
4406.0;2021;11;MONTPELLIER;FEMININ;SCOLAIRE;BAC PROFESSIONNEL;BAC PRO SERV;BAC PRO 33102 PROTHESE DENTAIRE;14;14;9;5;0;0;0;9;0;0;0;4;5;5
4411.0;2021;11;MONTPELLIER;FEMININ;SCOLAIRE;BAC PROFESSIONNEL;BAC PRO SERV;BAC PRO AG 33002 SERV PERS TERRIT;359;350;326;24;0;0;0;326;0;5;51;117;153;24
4419.0;2021;11;MONTPELLIER;FEMININ;SCOLAIRE;BAC TECHNOLOGIQUE;BAC STI2D;BAC STI2D ENERGIES  ET ENVIRONNEMENT;12;12;9;1;2;2;0;11;0;0;5;2;4;1
4424.0;2021;11;MONTPELLIER;FEMININ;SCOLAIRE;BAC TECHNOLOGIQUE;BAC STMG;BAC STMG GESTION ET FINANCE;239;239;225;4;10;3;7;228;0;9;56;87;76;11
4426.0;2021;11;MONTPELLIER;FEMININ;SCOLAIRE;BAC TECHNOLOGIQUE;BAC STMG;BAC STMG RESSOURCES HUMAINES ET COMMUNICATION;639;639;580;17;42;21;21;601;0;7;107;251;236;38
4428.0;2021;11;MONTPELLIER;MASCULIN;APPRENTISSAGE;BAC PROFESSIONNEL;BAC PRO PROD;BAC PRO 20102 PILOTE DE LIGNE DE PRODUCTION;3;3;3;0;0;0;0;3;0;2;1;0;0;0
4433.0;2021;11;MONTPELLIER;MASCULIN;APPRENTISSAGE;BAC PROFESSIONNEL;BAC PRO PROD;BAC PRO 23102 TRAVAUX PUBLICS;22;22;22;0;0;0;0;22;0;3;7;9;3;0
4439.0;2021;11;MONTPELLIER;MASCULIN;APPRENTISSAGE;BAC PROFESSIONNEL;BAC PRO PROD;BAC PRO 25214 MAINT.VEHIC.OPTA VOIT.PARTICUL.;103;97;73;15;9;5;4;78;0;3;15;30;30;19
4441.0;2021;11;MONTPELLIER;MASCULIN;APPRENTISSAGE;BAC PROFESSIONNEL;BAC PRO PROD;BAC PRO 25216 MAINT.VEHIC.OPTC MOTOCYCLES;7;7;5;1;1;1;0;6;0;0;1;3;2;1
4448.0;2021;11;MONTPELLIER;MASCULIN;APPRENTISSAGE;BAC PROFESSIONNEL;BAC PRO PROD;BAC PRO 25510 METIERS ELECT. ENVIRON. CONNECTES;43;43;40;3;0;0;0;40;0;3;11;13;13;3
4451.0;2021;11;MONTPELLIER;MASCULIN;APPRENTISSAGE;BAC PROFESSIONNEL;BAC PRO PROD;BAC PRO AG 21113 CGEVV;3;3;3;0;0;0;0;3;0;0;0;1;2;0
4452.0;2021;11;MONTPELLIER;MASCULIN;APPRENTISSAGE;BAC PROFESSIONNEL;BAC PRO PROD;BAC PRO AG 21114 CONDUITE PRODUCTIONS HORTICOLES;2;2;2;0;0;0;0;2;0;0;1;1;0;0
4458.0;2021;11;MONTPELLIER;MASCULIN;APPRENTISSAGE;BAC PROFESSIONNEL;BAC PRO SERV;BAC PRO 31107 CONDUCT. TRANSP.ROUT.MARCHANDISES;1;1;1;0;0;0;0;1;0;0;0;0;1;0
4469.0;2021;11;MONTPELLIER;MASCULIN;ENSEIGNEMENT A DISTANCE;BAC PROFESSIONNEL;BAC PRO SERV;BAC PRO 31210 ACCUEIL -RELATION CLIENTS USAGERS;1;1;0;1;0;0;0;0;0;0;0;0;0;1
4480.0;2021;11;MONTPELLIER;MASCULIN;FORMATION CONTINUE;BAC PROFESSIONNEL;BAC PRO PROD;BAC PRO 25215 MAINT.VEHIC.OPTB VEHIC.TRANS.ROUT;2;1;1;0;0;0;0;1;0;0;0;0;1;0
4485.0;2021;11;MONTPELLIER;MASCULIN;FORMATION CONTINUE;BAC PROFESSIONNEL;BAC PRO SERV;BAC PRO 31202 COMMERCE;10;10;7;1;2;1;1;8;0;0;4;2;2;2
4488.0;2021;11;MONTPELLIER;MASCULIN;INDIVIDUEL;BAC GENERAL;BAC GENERAL;BAC GENE 10019 BAC GENERAL;116;79;60;12;7;3;4;63;2;7;16;11;27;16
4491.0;2021;11;MONTPELLIER;MASCULIN;INDIVIDUEL;BAC PROFESSIONNEL;BAC PRO PROD;BAC PRO 24303 MET. DU CUIR: SELLERIE GARNISSAGE;1;1;0;1;0;0;0;0;0;0;0;0;0;1
4493.0;2021;11;MONTPELLIER;MASCULIN;INDIVIDUEL;BAC PROFESSIONNEL;BAC PRO PROD;BAC PRO 25214 MAINT.VEHIC.OPTA VOIT.PARTICUL.;1;1;1;0;0;0;0;1;0;0;0;0;1;0
4495.0;2021;11;MONTPELLIER;MASCULIN;INDIVIDUEL;BAC PROFESSIONNEL;BAC PRO PROD;BAC PRO 25408 REPARATION DES CARROSSERIES;2;2;1;0;1;0;1;1;0;0;1;0;0;1
4499.0;2021;11;MONTPELLIER;MASCULIN;INDIVIDUEL;BAC PROFESSIONNEL;BAC PRO PROD;BAC PRO AG 21004 CGEA;2;1;1;0;0;0;0;1;0;0;0;0;1;0
4507.0;2021;11;MONTPELLIER;MASCULIN;INDIVIDUEL;BAC PROFESSIONNEL;BAC PRO SERV;BAC PRO 33403 COMMERC. SERVICES EN RESTAURATION;1;0;0;0;0;0;0;0;0;0;0;0;0;0
4516.0;2021;11;MONTPELLIER;MASCULIN;INDIVIDUEL;BAC TECHNOLOGIQUE;BAC STMG;BAC STMG GESTION ET FINANCE;21;16;16;0;0;0;0;16;1;1;4;5;5;0
4517.0;2021;11;MONTPELLIER;MASCULIN;INDIVIDUEL;BAC TECHNOLOGIQUE;BAC STMG;BAC STMG MERCATIQUE (MARKETING);34;21;13;3;5;4;1;17;0;0;0;5;12;4
4529.0;2021;11;MONTPELLIER;MASCULIN;SCOLAIRE;BAC PROFESSIONNEL;BAC PRO PROD;BAC PRO 22703 TECHN.INSTALL.SYST.ENERG.CLIMATI;87;87;59;21;7;1;6;60;0;0;1;18;41;27
4539.0;2021;11;MONTPELLIER;MASCULIN;SCOLAIRE;BAC PROFESSIONNEL;BAC PRO PROD;BAC PRO 23303 MENUISERIE ALUMINIUM-VERRE;14;14;9;1;4;3;1;12;0;0;0;4;8;2
4540.0;2021;11;MONTPELLIER;MASCULIN;SCOLAIRE;BAC PROFESSIONNEL;BAC PRO PROD;BAC PRO 23304 AMENAGEMENT FINITION BATIMENT;14;13;7;5;1;0;1;7;0;1;2;2;2;6
4542.0;2021;11;MONTPELLIER;MASCULIN;SCOLAIRE;BAC PROFESSIONNEL;BAC PRO PROD;BAC PRO 23405 TECHNICIEN MENUISIER AGENCEUR;41;40;29;6;5;3;2;32;0;0;3;10;19;8
4549.0;2021;11;MONTPELLIER;MASCULIN;SCOLAIRE;BAC PROFESSIONNEL;BAC PRO PROD;BAC PRO 25007 MAINTENANCE EQUIPEMENTS INDUST.;196;195;150;36;9;6;3;156;0;8;28;47;73;39
4552.0;2021;11;MONTPELLIER;MASCULIN;SCOLAIRE;BAC PROFESSIONNEL;BAC PRO PROD;BAC PRO 25214 MAINT.VEHIC.OPTA VOIT.PARTICUL.;201;201;157;39;5;3;2;160;0;5;28;67;60;41
4553.0;2021;11;MONTPELLIER;MASCULIN;SCOLAIRE;BAC PROFESSIONNEL;BAC PRO PROD;BAC PRO 25215 MAINT.VEHIC.OPTB VEHIC.TRANS.ROUT;26;26;18;5;3;2;1;20;0;2;5;5;8;6
4558.0;2021;11;MONTPELLIER;MASCULIN;SCOLAIRE;BAC PROFESSIONNEL;BAC PRO PROD;BAC PRO 25303 AERONAUTIQUE OPTION SYSTEMES;17;17;17;0;0;0;0;17;0;1;5;5;6;0
4562.0;2021;11;MONTPELLIER;MASCULIN;SCOLAIRE;BAC PROFESSIONNEL;BAC PRO PROD;BAC PRO 25509 TECHNIC. FROID CONDITIONNEMT AIR;70;70;51;17;2;1;1;52;0;1;10;14;27;18
4565.0;2021;11;MONTPELLIER;MASCULIN;SCOLAIRE;BAC PROFESSIONNEL;BAC PRO PROD;BAC PRO 25514 SYST.NUM.OPT.B AUD.RES.EQUIP.DOM.;107;107;89;11;7;5;2;94;0;3;17;46;28;13
4591.0;2021;11;MONTPELLIER;MASCULIN;SCOLAIRE;BAC PROFESSIONNEL;BAC PRO SERV;BAC PRO 32304 PHOTOGRAPHIE;6;6;5;1;0;0;0;5;0;3;1;0;1;1
4595.0;2021;11;MONTPELLIER;MASCULIN;SCOLAIRE;BAC PROFESSIONNEL;BAC PRO SERV;BAC PRO 33101 OPTIQUE LUNETTERIE;3;3;3;0;0;0;0;3;0;1;2;0;0;0
4600.0;2021;11;MONTPELLIER;MASCULIN;SCOLAIRE;BAC PROFESSIONNEL;BAC PRO SERV;BAC PRO AG 33002 SERV PERS TERRIT;64;62;57;5;0;0;0;57;0;3;6;14;34;5
4606.0;2021;11;MONTPELLIER;MASCULIN;SCOLAIRE;BAC TECHNOLOGIQUE;BAC STI2D;BAC STI2D ARCHITECTURE ET CONSTRUCTION;248;248;220;5;23;12;11;232;0;6;43;88;95;16
4607.0;2021;11;MONTPELLIER;MASCULIN;SCOLAIRE;BAC TECHNOLOGIQUE;BAC STI2D;BAC STI2D ENERGIES  ET ENVIRONNEMENT;204;204;184;4;16;9;7;193;0;6;24;84;79;11
4627.0;2021;12;NANCY-METZ;FEMININ;APPRENTISSAGE;BAC PROFESSIONNEL;BAC PRO PROD;BAC PRO AG 21004 CGEA;8;8;7;1;0;0;0;7;0;0;3;1;3;1
4628.0;2021;12;NANCY-METZ;FEMININ;APPRENTISSAGE;BAC PROFESSIONNEL;BAC PRO PROD;BAC PRO AG 21203 TECHN CONSEIL DE VENTE ANIMAL;3;3;3;0;0;0;0;3;0;0;2;1;0;0
4637.0;2021;12;NANCY-METZ;FEMININ;APPRENTISSAGE;BAC PROFESSIONNEL;BAC PRO SERV;BAC PRO 32303 ART.& MET.ART:COM.VIS.VIS.PLURI-M;2;2;2;0;0;0;0;2;0;0;1;1;0;0
4640.0;2021;12;NANCY-METZ;FEMININ;ENSEIGNEMENT A DISTANCE;BAC TECHNOLOGIQUE;BAC STMG;BAC STMG RESSOURCES HUMAINES ET COMMUNICATION;4;4;4;0;0;0;0;4;0;0;1;1;2;0
4641.0;2021;12;NANCY-METZ;FEMININ;ENSEIGNEMENT A DISTANCE;BAC TECHNOLOGIQUE;BAC STMG;BAC STMG SYSTEMES D'INFORMATION DE GESTION;1;1;1;0;0;0;0;1;0;0;0;0;1;0
4642.0;2021;12;NANCY-METZ;FEMININ;FORMATION CONTINUE;BAC PROFESSIONNEL;BAC PRO PROD;BAC PRO 22704 TECHN. MAINT. SYST.ENERG.CLIMATI;1;1;1;0;0;0;0;1;0;1;0;0;0;0
4643.0;2021;12;NANCY-METZ;FEMININ;FORMATION CONTINUE;BAC PROFESSIONNEL;BAC PRO PROD;BAC PRO 23004 TECHN. ETUDES BAT.A ETUDES & ECO.;1;1;1;0;0;0;0;1;0;0;1;0;0;0
4649.0;2021;12;NANCY-METZ;FEMININ;FORMATION CONTINUE;BAC PROFESSIONNEL;BAC PRO PROD;BAC PRO 25510 METIERS ELECT. ENVIRON. CONNECTES;1;1;1;0;0;0;0;1;0;1;0;0;0;0
4651.0;2021;12;NANCY-METZ;FEMININ;FORMATION CONTINUE;BAC PROFESSIONNEL;BAC PRO SERV;BAC PRO 30001 GESTION-ADMINISTRATION;50;50;47;3;0;0;0;47;0;12;20;11;4;3
4655.0;2021;12;NANCY-METZ;FEMININ;FORMATION CONTINUE;BAC PROFESSIONNEL;BAC PRO SERV;BAC PRO 31210 ACCUEIL -RELATION CLIENTS USAGERS;3;3;2;0;1;1;0;3;0;0;2;0;1;0
4667.0;2021;12;NANCY-METZ;FEMININ;INDIVIDUEL;BAC PROFESSIONNEL;BAC PRO SERV;BAC PRO 31206 VENTE (PROSPECT.NEGO.SUIV.CLIENT;1;1;1;0;0;0;0;1;0;0;0;0;1;0
4674.0;2021;12;NANCY-METZ;FEMININ;INDIVIDUEL;BAC TECHNOLOGIQUE;BAC STHR;BAC STHR SC.&TEC. HOTELLERIE-RESTAURATION;1;0;0;0;0;0;0;0;0;0;0;0;0;0
4681.0;2021;12;NANCY-METZ;FEMININ;SCOLAIRE;BAC PROFESSIONNEL;BAC PRO PROD;BAC PRO 22003 BIO-INDUSTRIES DE TRANSFORMATION;5;5;5;0;0;0;0;5;0;0;2;1;2;0
4682.0;2021;12;NANCY-METZ;FEMININ;SCOLAIRE;BAC PROFESSIONNEL;BAC PRO PROD;BAC PRO 22004 PROC. CHIMIE EAU PAPIERS-CARTONS;10;10;8;1;1;1;0;9;0;0;0;6;3;1
4684.0;2021;12;NANCY-METZ;FEMININ;SCOLAIRE;BAC PROFESSIONNEL;BAC PRO PROD;BAC PRO 22106 CUISINE;69;69;64;4;1;0;1;64;0;11;17;22;14;5
4686.0;2021;12;NANCY-METZ;FEMININ;SCOLAIRE;BAC PROFESSIONNEL;BAC PRO PROD;BAC PRO 22503 PLASTIQUES ET COMPOSITES;3;3;3;0;0;0;0;3;0;0;0;2;1;0
4687.0;2021;12;NANCY-METZ;FEMININ;SCOLAIRE;BAC PROFESSIONNEL;BAC PRO PROD;BAC PRO 23004 TECHN. ETUDES BAT.A ETUDES & ECO.;14;14;10;3;1;0;1;10;0;1;0;4;5;4
4689.0;2021;12;NANCY-METZ;FEMININ;SCOLAIRE;BAC PROFESSIONNEL;BAC PRO PROD;BAC PRO 23102 TRAVAUX PUBLICS;1;1;0;1;0;0;0;0;0;0;0;0;0;1
4691.0;2021;12;NANCY-METZ;FEMININ;SCOLAIRE;BAC PROFESSIONNEL;BAC PRO PROD;BAC PRO 23304 AMENAGEMENT FINITION BATIMENT;1;1;1;0;0;0;0;1;0;0;1;0;0;0
4696.0;2021;12;NANCY-METZ;FEMININ;SCOLAIRE;BAC PROFESSIONNEL;BAC PRO PROD;BAC PRO 25007 MAINTENANCE EQUIPEMENTS INDUST.;7;7;4;2;1;0;1;4;0;0;0;1;3;3
4702.0;2021;12;NANCY-METZ;FEMININ;SCOLAIRE;BAC PROFESSIONNEL;BAC PRO PROD;BAC PRO 25406 OUVRAGES DU BATIMENT METALLERIE;1;1;1;0;0;0;0;1;0;0;0;1;0;0
4706.0;2021;12;NANCY-METZ;FEMININ;SCOLAIRE;BAC PROFESSIONNEL;BAC PRO PROD;BAC PRO 25514 SYST.NUM.OPT.B AUD.RES.EQUIP.DOM.;4;3;3;0;0;0;0;3;0;0;0;2;1;0
4710.0;2021;12;NANCY-METZ;FEMININ;SCOLAIRE;BAC PROFESSIONNEL;BAC PRO PROD;BAC PRO AG 21114 CONDUITE PRODUCTIONS HORTICOLES;3;3;3;0;0;0;0;3;0;0;1;1;1;0
4718.0;2021;12;NANCY-METZ;FEMININ;SCOLAIRE;BAC PROFESSIONNEL;BAC PRO SERV;BAC PRO 31106 LOGISTIQUE;20;20;17;1;2;1;1;18;0;0;3;8;7;2
4722.0;2021;12;NANCY-METZ;FEMININ;SCOLAIRE;BAC PROFESSIONNEL;BAC PRO SERV;BAC PRO 31206 VENTE (PROSPECT.NEGO.SUIV.CLIENT;111;111;96;9;6;1;5;97;0;8;13;42;34;14
4723.0;2021;12;NANCY-METZ;FEMININ;SCOLAIRE;BAC PROFESSIONNEL;BAC PRO SERV;BAC PRO 31210 ACCUEIL -RELATION CLIENTS USAGERS;111;111;95;7;9;8;1;103;0;2;27;35;39;8
4725.0;2021;12;NANCY-METZ;FEMININ;SCOLAIRE;BAC PROFESSIONNEL;BAC PRO SERV;BAC PRO 32208 REAL.PR.IMPR.PLURI.OPTB.PR.IMPR.;4;4;4;0;0;0;0;4;0;0;0;2;2;0
4730.0;2021;12;NANCY-METZ;FEMININ;SCOLAIRE;BAC PROFESSIONNEL;BAC PRO SERV;BAC PRO 33004 ACC.SOINS-S.PERS. OPT.EN STRUCTUR;599;598;544;36;18;12;6;556;0;56;164;198;138;42
4735.0;2021;12;NANCY-METZ;FEMININ;SCOLAIRE;BAC PROFESSIONNEL;BAC PRO SERV;BAC PRO 34304 HYGIENE PROPRETE STERILISATION;10;10;9;1;0;0;0;9;0;0;0;4;5;1
4743.0;2021;12;NANCY-METZ;FEMININ;SCOLAIRE;BAC TECHNOLOGIQUE;BAC STHR;BAC STHR SC.&TEC. HOTELLERIE-RESTAURATION;63;63;57;0;6;3;3;60;0;3;8;28;21;3
4745.0;2021;12;NANCY-METZ;FEMININ;SCOLAIRE;BAC TECHNOLOGIQUE;BAC STI2D;BAC STI2D ENERGIES  ET ENVIRONNEMENT;19;19;19;0;0;0;0;19;0;0;4;11;4;0
4758.0;2021;12;NANCY-METZ;MASCULIN;APPRENTISSAGE;BAC PROFESSIONNEL;BAC PRO PROD;BAC PRO 22703 TECHN.INSTALL.SYST.ENERG.CLIMATI;15;15;14;1;0;0;0;14;0;1;5;2;6;1
4763.0;2021;12;NANCY-METZ;MASCULIN;APPRENTISSAGE;BAC PROFESSIONNEL;BAC PRO PROD;BAC PRO 23404 TECHNICIEN CONSTRUCTEUR BOIS;4;4;4;0;0;0;0;4;0;0;0;1;3;0
4765.0;2021;12;NANCY-METZ;MASCULIN;APPRENTISSAGE;BAC PROFESSIONNEL;BAC PRO PROD;BAC PRO 23406 TECHNICIEN DE SCIERIE;2;2;1;0;1;0;1;1;0;0;1;0;0;1
4766.0;2021;12;NANCY-METZ;MASCULIN;APPRENTISSAGE;BAC PROFESSIONNEL;BAC PRO PROD;BAC PRO 23407 TECHNIC.FAB.BOIS ET MATERX ASSOC;3;3;3;0;0;0;0;3;0;1;0;0;2;0
4772.0;2021;12;NANCY-METZ;MASCULIN;APPRENTISSAGE;BAC PROFESSIONNEL;BAC PRO PROD;BAC PRO 25216 MAINT.VEHIC.OPTC MOTOCYCLES;1;1;1;0;0;0;0;1;0;1;0;0;0;0
4773.0;2021;12;NANCY-METZ;MASCULIN;APPRENTISSAGE;BAC PROFESSIONNEL;BAC PRO PROD;BAC PRO 25219 MAINT.MATERIELS OPT.A AGRICOLES;10;10;10;0;0;0;0;10;0;0;4;1;5;0
4774.0;2021;12;NANCY-METZ;MASCULIN;APPRENTISSAGE;BAC PROFESSIONNEL;BAC PRO PROD;BAC PRO 25220 MAINT.MATERIELS OPT.B TP MANUT.;8;8;6;2;0;0;0;6;0;1;0;5;0;2
4776.0;2021;12;NANCY-METZ;MASCULIN;APPRENTISSAGE;BAC PROFESSIONNEL;BAC PRO PROD;BAC PRO 25302 AERONAUTIQUE OPTION AVIONIQUE;1;1;1;0;0;0;0;1;0;0;0;1;0;0
4781.0;2021;12;NANCY-METZ;MASCULIN;APPRENTISSAGE;BAC PROFESSIONNEL;BAC PRO PROD;BAC PRO 25509 TECHNIC. FROID CONDITIONNEMT AIR;7;7;5;2;0;0;0;5;0;0;1;3;1;2
4786.0;2021;12;NANCY-METZ;MASCULIN;APPRENTISSAGE;BAC PROFESSIONNEL;BAC PRO PROD;BAC PRO AG 21211 COND GEST ENTR HIPPIQUE;1;1;1;0;0;0;0;1;0;0;0;1;0;0
4791.0;2021;12;NANCY-METZ;MASCULIN;APPRENTISSAGE;BAC PROFESSIONNEL;BAC PRO SERV;BAC PRO 31106 LOGISTIQUE;22;21;14;4;3;2;1;16;0;0;7;3;6;5
4798.0;2021;12;NANCY-METZ;MASCULIN;ENSEIGNEMENT A DISTANCE;BAC GENERAL;BAC GENERAL;BAC GENE 10019 BAC GENERAL;12;11;11;0;0;0;0;11;0;1;5;1;4;0
4811.0;2021;12;NANCY-METZ;MASCULIN;FORMATION CONTINUE;BAC PROFESSIONNEL;BAC PRO PROD;BAC PRO 25509 TECHNIC. FROID CONDITIONNEMT AIR;1;1;1;0;0;0;0;1;0;1;0;0;0;0
4814.0;2021;12;NANCY-METZ;MASCULIN;FORMATION CONTINUE;BAC PROFESSIONNEL;BAC PRO PROD;BAC PRO AG 22107 TEC CONS VTE ALIMENTATION P.ALIM;3;2;2;0;0;0;0;2;0;0;0;1;1;0
4831.0;2021;12;NANCY-METZ;MASCULIN;INDIVIDUEL;BAC PROFESSIONNEL;BAC PRO PROD;BAC PRO AG 21004 CGEA;1;1;1;0;0;0;0;1;0;0;0;0;1;0
4834.0;2021;12;NANCY-METZ;MASCULIN;INDIVIDUEL;BAC PROFESSIONNEL;BAC PRO SERV;BAC PRO 31107 CONDUCT. TRANSP.ROUT.MARCHANDISES;1;0;0;0;0;0;0;0;0;0;0;0;0;0
4844.0;2021;12;NANCY-METZ;MASCULIN;INDIVIDUEL;BAC TECHNOLOGIQUE;BAC STMG;BAC STMG GESTION ET FINANCE;8;3;3;0;0;0;0;3;0;0;0;0;3;0
4845.0;2021;12;NANCY-METZ;MASCULIN;INDIVIDUEL;BAC TECHNOLOGIQUE;BAC STMG;BAC STMG MERCATIQUE (MARKETING);18;10;5;3;2;2;0;7;0;0;0;4;3;3
4854.0;2021;12;NANCY-METZ;MASCULIN;SCOLAIRE;BAC PROFESSIONNEL;BAC PRO PROD;BAC PRO 22303 FONDERIE;3;3;2;0;1;0;1;2;0;0;1;0;1;1
4860.0;2021;12;NANCY-METZ;MASCULIN;SCOLAIRE;BAC PROFESSIONNEL;BAC PRO PROD;BAC PRO 23004 TECHN. ETUDES BAT.A ETUDES & ECO.;34;34;28;5;1;1;0;29;0;1;4;11;13;5
4864.0;2021;12;NANCY-METZ;MASCULIN;SCOLAIRE;BAC PROFESSIONNEL;BAC PRO PROD;BAC PRO 23208 METIERS ET ARTS DE LA PIERRE;9;9;7;0;2;2;0;9;0;0;2;2;5;0
4871.0;2021;12;NANCY-METZ;MASCULIN;SCOLAIRE;BAC PROFESSIONNEL;BAC PRO PROD;BAC PRO 24203 METIERS DE LA MODE - VÊTEMENT;6;6;6;0;0;0;0;6;0;1;2;1;2;0
4872.0;2021;12;NANCY-METZ;MASCULIN;SCOLAIRE;BAC PROFESSIONNEL;BAC PRO PROD;BAC PRO 25006 MICROTECHNIQUES;22;22;22;0;0;0;0;22;0;2;5;7;8;0
4892.0;2021;12;NANCY-METZ;MASCULIN;SCOLAIRE;BAC PROFESSIONNEL;BAC PRO PROD;BAC PRO 25515 SYST.NUM.OPT.C RES.INF.SYST.COMM.;115;115;98;10;7;3;4;101;0;4;25;46;26;14
4896.0;2021;12;NANCY-METZ;MASCULIN;SCOLAIRE;BAC PROFESSIONNEL;BAC PRO PROD;BAC PRO AG 21203 TECHN CONSEIL DE VENTE ANIMAL;5;5;4;1;0;0;0;4;0;0;0;2;2;1
4897.0;2021;12;NANCY-METZ;MASCULIN;SCOLAIRE;BAC PROFESSIONNEL;BAC PRO PROD;BAC PRO AG 21211 COND GEST ENTR HIPPIQUE;5;5;4;1;0;0;0;4;0;0;0;3;1;1
4899.0;2021;12;NANCY-METZ;MASCULIN;SCOLAIRE;BAC PROFESSIONNEL;BAC PRO PROD;BAC PRO AG 21303 FORET;17;17;17;0;0;0;0;17;0;0;1;9;7;0
4900.0;2021;12;NANCY-METZ;MASCULIN;SCOLAIRE;BAC PROFESSIONNEL;BAC PRO PROD;BAC PRO AG 21405 AMENAGEMENTS PAYSAGERS;41;41;39;2;0;0;0;39;0;5;11;15;8;2
4902.0;2021;12;NANCY-METZ;MASCULIN;SCOLAIRE;BAC PROFESSIONNEL;BAC PRO SERV;BAC PRO 30001 GESTION-ADMINISTRATION;253;252;194;34;24;18;6;212;0;3;30;84;95;40
4903.0;2021;12;NANCY-METZ;MASCULIN;SCOLAIRE;BAC PROFESSIONNEL;BAC PRO SERV;BAC PRO 31106 LOGISTIQUE;123;123;93;15;15;13;2;106;0;5;20;26;55;17
4921.0;2021;12;NANCY-METZ;MASCULIN;SCOLAIRE;BAC PROFESSIONNEL;BAC PRO SERV;BAC PRO 34403 METIERS DE LA SECURITE;52;52;46;4;2;2;0;48;0;3;15;22;8;4
4922.0;2021;12;NANCY-METZ;MASCULIN;SCOLAIRE;BAC PROFESSIONNEL;BAC PRO SERV;BAC PRO AG 33002 SERV PERS TERRIT;10;10;10;0;0;0;0;10;0;0;0;3;7;0
4933.0;2021;12;NANCY-METZ;MASCULIN;SCOLAIRE;BAC TECHNOLOGIQUE;BAC STL;BAC STL SCIENCES PHYSIQUES CHIMIQUES  EN LABORAT.;72;72;63;4;5;2;3;65;0;0;13;29;23;7
4937.0;2021;12;NANCY-METZ;MASCULIN;SCOLAIRE;BAC TECHNOLOGIQUE;BAC STMG;BAC STMG SYSTEMES D'INFORMATION DE GESTION;37;37;30;1;6;3;3;33;0;3;1;8;21;4
4941.0;2021;17;NANTES;FEMININ;APPRENTISSAGE;BAC PROFESSIONNEL;BAC PRO PROD;BAC PRO 22705 TECHNICIEN GAZ;1;1;1;0;0;0;0;1;0;1;0;0;0;0
4942.0;2021;17;NANTES;FEMININ;APPRENTISSAGE;BAC PROFESSIONNEL;BAC PRO PROD;BAC PRO 23004 TECHN. ETUDES BAT.A ETUDES & ECO.;3;3;3;0;0;0;0;3;0;0;0;2;1;0
4944.0;2021;17;NANTES;FEMININ;APPRENTISSAGE;BAC PROFESSIONNEL;BAC PRO PROD;BAC PRO 24203 METIERS DE LA MODE - VÊTEMENT;1;1;0;0;1;1;0;1;0;0;0;0;1;0
4953.0;2021;17;NANTES;FEMININ;APPRENTISSAGE;BAC PROFESSIONNEL;BAC PRO PROD;BAC PRO 25304 AERONAUTIQUE OPTION STRUCTURE;2;2;2;0;0;0;0;2;0;0;1;1;0;0
4956.0;2021;17;NANTES;FEMININ;APPRENTISSAGE;BAC PROFESSIONNEL;BAC PRO PROD;BAC PRO 25510 METIERS ELECT. ENVIRON. CONNECTES;2;2;2;0;0;0;0;2;0;1;0;0;1;0
4963.0;2021;17;NANTES;FEMININ;APPRENTISSAGE;BAC PROFESSIONNEL;BAC PRO PROD;BAC PRO AG 21211 COND GEST ENTR HIPPIQUE;28;27;25;2;0;0;0;25;0;0;3;9;13;2
4972.0;2021;17;NANTES;FEMININ;APPRENTISSAGE;BAC PROFESSIONNEL;BAC PRO SERV;BAC PRO 32208 REAL.PR.IMPR.PLURI.OPTB.PR.IMPR.;2;2;2;0;0;0;0;2;0;1;0;0;1;0
4974.0;2021;17;NANTES;FEMININ;APPRENTISSAGE;BAC PROFESSIONNEL;BAC PRO SERV;BAC PRO 33004 ACC.SOINS-S.PERS. OPT.EN STRUCTUR;7;7;7;0;0;0;0;7;0;0;1;4;2;0
4986.0;2021;17;NANTES;FEMININ;FORMATION CONTINUE;BAC PROFESSIONNEL;BAC PRO PROD;BAC PRO 24203 METIERS DE LA MODE - VÊTEMENT;5;5;5;0;0;0;0;5;0;0;2;0;3;0
4989.0;2021;17;NANTES;FEMININ;FORMATION CONTINUE;BAC PROFESSIONNEL;BAC PRO PROD;BAC PRO 25510 METIERS ELECT. ENVIRON. CONNECTES;4;4;4;0;0;0;0;4;0;4;0;0;0;0
4993.0;2021;17;NANTES;FEMININ;FORMATION CONTINUE;BAC PROFESSIONNEL;BAC PRO SERV;BAC PRO 31202 COMMERCE;6;6;3;1;2;1;1;4;0;0;1;2;1;2
4998.0;2021;17;NANTES;FEMININ;INDIVIDUEL;BAC PROFESSIONNEL;BAC PRO PROD;BAC PRO AG 21004 CGEA;8;5;1;4;0;0;0;1;0;0;0;0;1;4
5002.0;2021;17;NANTES;FEMININ;INDIVIDUEL;BAC PROFESSIONNEL;BAC PRO PROD;BAC PRO AG 21211 COND GEST ENTR HIPPIQUE;10;10;6;4;0;0;0;6;0;0;0;1;5;4
5005.0;2021;17;NANTES;FEMININ;INDIVIDUEL;BAC PROFESSIONNEL;BAC PRO SERV;BAC PRO 31202 COMMERCE;7;5;1;3;1;0;1;1;0;1;0;0;0;4
5009.0;2021;17;NANTES;FEMININ;INDIVIDUEL;BAC PROFESSIONNEL;BAC PRO SERV;BAC PRO 33004 ACC.SOINS-S.PERS. OPT.EN STRUCTUR;11;7;5;0;2;1;1;6;0;0;0;1;5;1
5014.0;2021;17;NANTES;FEMININ;INDIVIDUEL;BAC TECHNOLOGIQUE;BAC STMG;BAC STMG MERCATIQUE (MARKETING);6;4;1;0;3;1;2;2;0;0;0;0;2;2
5019.0;2021;17;NANTES;FEMININ;SCOLAIRE;BAC PROFESSIONNEL;BAC PRO PROD;BAC PRO 22105 BOULANGER-PÂTISSIER;29;29;28;1;0;0;0;28;0;1;8;9;10;1
5024.0;2021;17;NANTES;FEMININ;SCOLAIRE;BAC PROFESSIONNEL;BAC PRO PROD;BAC PRO 23003 ARTIS. & M.ART:MARCHANDISAGE VIS.;25;25;23;2;0;0;0;23;0;1;10;11;1;2
5032.0;2021;17;NANTES;FEMININ;SCOLAIRE;BAC PROFESSIONNEL;BAC PRO PROD;BAC PRO 23408 Etude et réalisation d'agencement;7;7;7;0;0;0;0;7;0;0;2;2;3;0
5035.0;2021;17;NANTES;FEMININ;SCOLAIRE;BAC PROFESSIONNEL;BAC PRO PROD;BAC PRO 24302 METIERS DU CUIR : MAROQUINERIE;10;10;10;0;0;0;0;10;0;1;2;5;2;0
5056.0;2021;17;NANTES;FEMININ;SCOLAIRE;BAC PROFESSIONNEL;BAC PRO PROD;BAC PRO AG 21405 AMENAGEMENTS PAYSAGERS;11;11;10;1;0;0;0;10;0;0;3;5;2;1
5073.0;2021;17;NANTES;FEMININ;SCOLAIRE;BAC PROFESSIONNEL;BAC PRO SERV;BAC PRO 33004 ACC.SOINS-S.PERS. OPT.EN STRUCTUR;785;785;751;14;20;9;11;760;0;38;209;333;180;25
5074.0;2021;17;NANTES;FEMININ;SCOLAIRE;BAC PROFESSIONNEL;BAC PRO SERV;BAC PRO 33101 OPTIQUE LUNETTERIE;21;21;21;0;0;0;0;21;0;0;10;9;2;0
5075.0;2021;17;NANTES;FEMININ;SCOLAIRE;BAC PROFESSIONNEL;BAC PRO SERV;BAC PRO 33102 PROTHESE DENTAIRE;24;24;23;0;1;1;0;24;0;0;6;9;9;0
5077.0;2021;17;NANTES;FEMININ;SCOLAIRE;BAC PROFESSIONNEL;BAC PRO SERV;BAC PRO 33403 COMMERC. SERVICES EN RESTAURATION;86;85;76;5;4;3;1;79;0;7;15;26;31;6
5080.0;2021;17;NANTES;FEMININ;SCOLAIRE;BAC PROFESSIONNEL;BAC PRO SERV;BAC PRO 34403 METIERS DE LA SECURITE;49;49;49;0;0;0;0;49;0;4;16;24;5;0
5083.0;2021;17;NANTES;FEMININ;SCOLAIRE;BAC TECHNOLOGIQUE;BAC S2TMD;BAC S2TMD MUSIQUE;7;7;7;0;0;0;0;7;0;2;0;3;2;0
5084.0;2021;17;NANTES;FEMININ;SCOLAIRE;BAC TECHNOLOGIQUE;BAC ST2S;BAC ST2S SCIENCES & TECHNO. SANTE & SOCIAL;1132;1132;1077;9;46;22;24;1099;0;44;219;463;373;33
5087.0;2021;17;NANTES;FEMININ;SCOLAIRE;BAC TECHNOLOGIQUE;BAC STHR;BAC STHR SC.&TEC. HOTELLERIE-RESTAURATION;94;94;92;0;2;1;1;93;0;6;23;36;28;1
5090.0;2021;17;NANTES;FEMININ;SCOLAIRE;BAC TECHNOLOGIQUE;BAC STI2D;BAC STI2D INNOVATION TECHNO.  ET ECO CONCEPTION;31;31;28;0;3;1;2;29;0;0;8;6;15;2
5096.0;2021;17;NANTES;FEMININ;SCOLAIRE;BAC TECHNOLOGIQUE;BAC STMG;BAC STMG RESSOURCES HUMAINES ET COMMUNICATION;711;711;659;11;41;24;17;683;0;8;87;278;310;28
5097.0;2021;17;NANTES;FEMININ;SCOLAIRE;BAC TECHNOLOGIQUE;BAC STMG;BAC STMG SYSTEMES D'INFORMATION DE GESTION;4;4;4;0;0;0;0;4;0;0;1;1;2;0
5105.0;2021;17;NANTES;MASCULIN;APPRENTISSAGE;BAC PROFESSIONNEL;BAC PRO PROD;BAC PRO 22705 TECHNICIEN GAZ;8;8;8;0;0;0;0;8;0;3;3;2;0;0
5116.0;2021;17;NANTES;MASCULIN;APPRENTISSAGE;BAC PROFESSIONNEL;BAC PRO PROD;BAC PRO 25106 TECHNICIEN D'USINAGE;75;75;59;13;3;3;0;62;0;1;19;24;18;13
5118.0;2021;17;NANTES;MASCULIN;APPRENTISSAGE;BAC PROFESSIONNEL;BAC PRO PROD;BAC PRO 25214 MAINT.VEHIC.OPTA VOIT.PARTICUL.;233;233;201;27;5;2;3;203;0;7;48;82;66;30
5120.0;2021;17;NANTES;MASCULIN;APPRENTISSAGE;BAC PROFESSIONNEL;BAC PRO PROD;BAC PRO 25216 MAINT.VEHIC.OPTC MOTOCYCLES;17;17;15;2;0;0;0;15;0;1;5;4;5;2
5121.0;2021;17;NANTES;MASCULIN;APPRENTISSAGE;BAC PROFESSIONNEL;BAC PRO PROD;BAC PRO 25219 MAINT.MATERIELS OPT.A AGRICOLES;59;59;51;5;3;0;3;51;0;3;15;19;14;8
5126.0;2021;17;NANTES;MASCULIN;APPRENTISSAGE;BAC PROFESSIONNEL;BAC PRO PROD;BAC PRO 25304 AERONAUTIQUE OPTION STRUCTURE;23;23;23;0;0;0;0;23;0;1;2;15;5;0
5127.0;2021;17;NANTES;MASCULIN;APPRENTISSAGE;BAC PROFESSIONNEL;BAC PRO PROD;BAC PRO 25406 OUVRAGES DU BATIMENT METALLERIE;6;6;6;0;0;0;0;6;0;0;1;4;1;0
5133.0;2021;17;NANTES;MASCULIN;APPRENTISSAGE;BAC PROFESSIONNEL;BAC PRO PROD;BAC PRO 25514 SYST.NUM.OPT.B AUD.RES.EQUIP.DOM.;1;1;1;0;0;0;0;1;0;0;1;0;0;0
5134.0;2021;17;NANTES;MASCULIN;APPRENTISSAGE;BAC PROFESSIONNEL;BAC PRO PROD;BAC PRO 25515 SYST.NUM.OPT.C RES.INF.SYST.COMM.;31;31;26;5;0;0;0;26;0;4;14;4;4;5
5141.0;2021;17;NANTES;MASCULIN;APPRENTISSAGE;BAC PROFESSIONNEL;BAC PRO PROD;BAC PRO AG 21211 COND GEST ENTR HIPPIQUE;11;10;9;1;0;0;0;9;0;0;0;3;6;1
5146.0;2021;17;NANTES;MASCULIN;APPRENTISSAGE;BAC PROFESSIONNEL;BAC PRO SERV;BAC PRO 31106 LOGISTIQUE;54;54;35;15;4;2;2;37;0;2;4;13;18;17
5149.0;2021;17;NANTES;MASCULIN;APPRENTISSAGE;BAC PROFESSIONNEL;BAC PRO SERV;BAC PRO 31209 POISSONIER ECAILLER TRAITEUR;2;2;2;0;0;0;0;2;0;0;1;1;0;0
5151.0;2021;17;NANTES;MASCULIN;APPRENTISSAGE;BAC PROFESSIONNEL;BAC PRO SERV;BAC PRO 32207 REAL.PR.IMPR.PLURI.OPTA.PR.GRAPH.;7;5;3;2;0;0;0;3;0;0;1;2;0;2
5152.0;2021;17;NANTES;MASCULIN;APPRENTISSAGE;BAC PROFESSIONNEL;BAC PRO SERV;BAC PRO 32208 REAL.PR.IMPR.PLURI.OPTB.PR.IMPR.;6;6;5;1;0;0;0;5;0;0;3;1;1;1
5155.0;2021;17;NANTES;MASCULIN;APPRENTISSAGE;BAC PROFESSIONNEL;BAC PRO SERV;BAC PRO AG 33002 SERV PERS TERRIT;1;1;1;0;0;0;0;1;0;0;0;0;1;0
5160.0;2021;17;NANTES;MASCULIN;ENSEIGNEMENT A DISTANCE;BAC TECHNOLOGIQUE;BAC STMG;BAC STMG GESTION ET FINANCE;1;1;1;0;0;0;0;1;0;0;0;0;1;0
5161.0;2021;17;NANTES;MASCULIN;ENSEIGNEMENT A DISTANCE;BAC TECHNOLOGIQUE;BAC STMG;BAC STMG MERCATIQUE (MARKETING);5;5;4;1;0;0;0;4;0;0;1;3;0;1
5179.0;2021;17;NANTES;MASCULIN;FORMATION CONTINUE;BAC PROFESSIONNEL;BAC PRO PROD;BAC PRO AG 21114 CONDUITE PRODUCTIONS HORTICOLES;1;0;0;0;0;0;0;0;0;0;0;0;0;0
5183.0;2021;17;NANTES;MASCULIN;INDIVIDUEL;BAC GENERAL;BAC GENERAL;BAC GENE 10019 BAC GENERAL;89;68;42;18;8;5;3;47;0;4;5;11;27;21
5184.0;2021;17;NANTES;MASCULIN;INDIVIDUEL;BAC PROFESSIONNEL;BAC PRO PROD;BAC PRO 22703 TECHN.INSTALL.SYST.ENERG.CLIMATI;1;1;1;0;0;0;0;1;0;0;0;0;1;0
5185.0;2021;17;NANTES;MASCULIN;INDIVIDUEL;BAC PROFESSIONNEL;BAC PRO PROD;BAC PRO 22704 TECHN. MAINT. SYST.ENERG.CLIMATI;2;0;0;0;0;0;0;0;0;0;0;0;0;0
5190.0;2021;17;NANTES;MASCULIN;INDIVIDUEL;BAC PROFESSIONNEL;BAC PRO PROD;BAC PRO 25510 METIERS ELECT. ENVIRON. CONNECTES;4;2;1;0;1;1;0;2;0;0;0;0;2;0
5200.0;2021;17;NANTES;MASCULIN;INDIVIDUEL;BAC PROFESSIONNEL;BAC PRO SERV;BAC PRO 31206 VENTE (PROSPECT.NEGO.SUIV.CLIENT;3;3;1;1;1;1;0;2;0;0;0;0;2;1
5202.0;2021;17;NANTES;MASCULIN;INDIVIDUEL;BAC PROFESSIONNEL;BAC PRO SERV;BAC PRO 32303 ART.& MET.ART:COM.VIS.VIS.PLURI-M;1;0;0;0;0;0;0;0;0;0;0;0;0;0
5215.0;2021;17;NANTES;MASCULIN;SCOLAIRE;BAC GENERAL;BAC GENERAL;BAC GENE 10019 BAC GENERAL;9163;9160;8780;61;319;194;125;8974;91;778;2048;3454;2603;186
5226.0;2021;17;NANTES;MASCULIN;SCOLAIRE;BAC PROFESSIONNEL;BAC PRO PROD;BAC PRO 23004 TECHN. ETUDES BAT.A ETUDES & ECO.;79;79;55;15;9;8;1;63;0;2;9;16;36;16
5234.0;2021;17;NANTES;MASCULIN;SCOLAIRE;BAC PROFESSIONNEL;BAC PRO PROD;BAC PRO 23404 TECHNICIEN CONSTRUCTEUR BOIS;25;25;17;6;2;1;1;18;0;1;3;7;7;7
5241.0;2021;17;NANTES;MASCULIN;SCOLAIRE;BAC PROFESSIONNEL;BAC PRO PROD;BAC PRO 25006 MICROTECHNIQUES;26;26;22;2;2;1;1;23;0;1;3;7;12;3
5248.0;2021;17;NANTES;MASCULIN;SCOLAIRE;BAC PROFESSIONNEL;BAC PRO PROD;BAC PRO 25216 MAINT.VEHIC.OPTC MOTOCYCLES;27;27;24;3;0;0;0;24;0;0;5;13;6;3
5251.0;2021;17;NANTES;MASCULIN;SCOLAIRE;BAC PROFESSIONNEL;BAC PRO PROD;BAC PRO 25221 MAINT.MATERIELS OPT.C ESP. VERTS;19;19;17;2;0;0;0;17;0;0;4;7;6;2
5254.0;2021;17;NANTES;MASCULIN;SCOLAIRE;BAC PROFESSIONNEL;BAC PRO PROD;BAC PRO 25410 CONSTRUCTION DES CARROSSERIES;15;15;15;0;0;0;0;15;0;1;3;6;5;0
5255.0;2021;17;NANTES;MASCULIN;SCOLAIRE;BAC PROFESSIONNEL;BAC PRO PROD;BAC PRO 25411 TECH.CHAUDRONNERIE INDUSTRIELLE;83;83;66;13;4;3;1;69;0;3;17;20;29;14
5260.0;2021;17;NANTES;MASCULIN;SCOLAIRE;BAC PROFESSIONNEL;BAC PRO PROD;BAC PRO 25515 SYST.NUM.OPT.C RES.INF.SYST.COMM.;194;194;184;8;2;0;2;184;0;13;44;68;59;10
5263.0;2021;17;NANTES;MASCULIN;SCOLAIRE;BAC PROFESSIONNEL;BAC PRO PROD;BAC PRO AG 21113 CGEVV;10;9;7;2;0;0;0;7;0;0;1;6;0;2
5266.0;2021;17;NANTES;MASCULIN;SCOLAIRE;BAC PROFESSIONNEL;BAC PRO PROD;BAC PRO AG 21204 PROD-AQUACOLES;26;26;25;1;0;0;0;25;0;1;5;8;11;1
5271.0;2021;17;NANTES;MASCULIN;SCOLAIRE;BAC PROFESSIONNEL;BAC PRO PROD;BAC PRO AG 21405 AMENAGEMENTS PAYSAGERS;180;178;172;6;0;0;0;172;0;3;52;73;44;6
5276.0;2021;17;NANTES;MASCULIN;SCOLAIRE;BAC PROFESSIONNEL;BAC PRO SERV;BAC PRO 31106 LOGISTIQUE;81;81;63;5;13;8;5;71;0;0;8;31;32;10
5280.0;2021;17;NANTES;MASCULIN;SCOLAIRE;BAC PROFESSIONNEL;BAC PRO SERV;BAC PRO 31206 VENTE (PROSPECT.NEGO.SUIV.CLIENT;205;205;173;17;15;14;1;187;0;3;26;80;78;18
5282.0;2021;17;NANTES;MASCULIN;SCOLAIRE;BAC PROFESSIONNEL;BAC PRO SERV;BAC PRO 32207 REAL.PR.IMPR.PLURI.OPTA.PR.GRAPH.;23;23;23;0;0;0;0;23;0;1;5;13;4;0
5283.0;2021;17;NANTES;MASCULIN;SCOLAIRE;BAC PROFESSIONNEL;BAC PRO SERV;BAC PRO 32208 REAL.PR.IMPR.PLURI.OPTB.PR.IMPR.;11;11;8;3;0;0;0;8;0;0;1;2;5;3
5291.0;2021;17;NANTES;MASCULIN;SCOLAIRE;BAC PROFESSIONNEL;BAC PRO SERV;BAC PRO 33103 TECHNICIEN APPAREIL. ORTHOPEDIQUE;6;6;6;0;0;0;0;6;0;0;0;4;2;0
5299.0;2021;17;NANTES;MASCULIN;SCOLAIRE;BAC TECHNOLOGIQUE;BAC S2TMD;BAC S2TMD MUSIQUE;12;12;12;0;0;0;0;12;0;2;2;7;1;0
5301.0;2021;17;NANTES;MASCULIN;SCOLAIRE;BAC TECHNOLOGIQUE;BAC STAV;BAC STAV AGRONOMIE ALIM ENV TERRITOI;192;192;190;2;0;0;0;190;0;4;28;87;71;2
5303.0;2021;17;NANTES;MASCULIN;SCOLAIRE;BAC TECHNOLOGIQUE;BAC STHR;BAC STHR SC.&TEC. HOTELLERIE-RESTAURATION;63;63;59;0;4;4;0;63;0;3;15;26;19;0
5305.0;2021;17;NANTES;MASCULIN;SCOLAIRE;BAC TECHNOLOGIQUE;BAC STI2D;BAC STI2D ENERGIES  ET ENVIRONNEMENT;237;237;214;7;16;11;5;225;0;6;45;84;90;12
5309.0;2021;17;NANTES;MASCULIN;SCOLAIRE;BAC TECHNOLOGIQUE;BAC STL;BAC STL SCIENCES PHYSIQUES CHIMIQUES  EN LABORAT.;77;77;64;4;9;4;5;68;0;2;8;29;29;9
5311.0;2021;17;NANTES;MASCULIN;SCOLAIRE;BAC TECHNOLOGIQUE;BAC STMG;BAC STMG MERCATIQUE (MARKETING);1059;1059;952;16;91;57;34;1009;0;2;71;378;558;50
5313.0;2021;17;NANTES;MASCULIN;SCOLAIRE;BAC TECHNOLOGIQUE;BAC STMG;BAC STMG SYSTEMES D'INFORMATION DE GESTION;10;10;9;0;1;0;1;9;0;0;1;6;2;1
5316.0;2021;23;NICE;FEMININ;APPRENTISSAGE;BAC PROFESSIONNEL;BAC PRO PROD;BAC PRO 25216 MAINT.VEHIC.OPTC MOTOCYCLES;1;1;1;0;0;0;0;1;0;0;1;0;0;0
5336.0;2021;23;NICE;FEMININ;ENSEIGNEMENT A DISTANCE;BAC TECHNOLOGIQUE;BAC STMG;BAC STMG GESTION ET FINANCE;3;3;2;1;0;0;0;2;0;0;2;0;0;1
5338.0;2021;23;NICE;FEMININ;ENSEIGNEMENT A DISTANCE;BAC TECHNOLOGIQUE;BAC STMG;BAC STMG RESSOURCES HUMAINES ET COMMUNICATION;8;8;7;1;0;0;0;7;0;0;1;4;2;1
5347.0;2021;23;NICE;FEMININ;INDIVIDUEL;BAC GENERAL;BAC GENERAL;BAC GENE 10019 BAC GENERAL;110;93;62;21;10;6;4;68;2;6;20;15;25;25
5348.0;2021;23;NICE;FEMININ;INDIVIDUEL;BAC PROFESSIONNEL;BAC PRO PROD;BAC PRO AG 21113 CGEVV;3;2;2;0;0;0;0;2;0;0;0;0;2;0
5349.0;2021;23;NICE;FEMININ;INDIVIDUEL;BAC PROFESSIONNEL;BAC PRO PROD;BAC PRO AG 21114 CONDUITE PRODUCTIONS HORTICOLES;3;1;0;1;0;0;0;0;0;0;0;0;0;1
5350.0;2021;23;NICE;FEMININ;INDIVIDUEL;BAC PROFESSIONNEL;BAC PRO PROD;BAC PRO AG 21211 COND GEST ENTR HIPPIQUE;5;3;3;0;0;0;0;3;0;0;0;0;3;0
5352.0;2021;23;NICE;FEMININ;INDIVIDUEL;BAC PROFESSIONNEL;BAC PRO SERV;BAC PRO 31202 COMMERCE;1;0;0;0;0;0;0;0;0;0;0;0;0;0
5354.0;2021;23;NICE;FEMININ;INDIVIDUEL;BAC PROFESSIONNEL;BAC PRO SERV;BAC PRO 33004 ACC.SOINS-S.PERS. OPT.EN STRUCTUR;1;0;0;0;0;0;0;0;0;0;0;0;0;0
5392.0;2021;23;NICE;FEMININ;SCOLAIRE;BAC PROFESSIONNEL;BAC PRO PROD;BAC PRO AG 21113 CGEVV;6;6;3;3;0;0;0;3;0;0;0;0;3;3
5399.0;2021;23;NICE;FEMININ;SCOLAIRE;BAC PROFESSIONNEL;BAC PRO SERV;BAC PRO 31107 CONDUCT. TRANSP.ROUT.MARCHANDISES;1;1;1;0;0;0;0;1;0;0;1;0;0;0
5401.0;2021;23;NICE;FEMININ;SCOLAIRE;BAC PROFESSIONNEL;BAC PRO SERV;BAC PRO 31202 COMMERCE;256;254;220;16;18;7;11;227;0;15;46;74;92;27
5404.0;2021;23;NICE;FEMININ;SCOLAIRE;BAC PROFESSIONNEL;BAC PRO SERV;BAC PRO 32207 REAL.PR.IMPR.PLURI.OPTA.PR.GRAPH.;7;7;7;0;0;0;0;7;0;0;1;1;5;0
5405.0;2021;23;NICE;FEMININ;SCOLAIRE;BAC PROFESSIONNEL;BAC PRO SERV;BAC PRO 32208 REAL.PR.IMPR.PLURI.OPTB.PR.IMPR.;2;2;1;1;0;0;0;1;0;0;0;0;1;1
5416.0;2021;23;NICE;FEMININ;SCOLAIRE;BAC TECHNOLOGIQUE;BAC S2TMD;BAC S2TMD DANSE;1;1;0;0;1;0;1;0;0;0;0;0;0;1
5423.0;2021;23;NICE;FEMININ;SCOLAIRE;BAC TECHNOLOGIQUE;BAC STI2D;BAC STI2D ENERGIES  ET ENVIRONNEMENT;12;12;12;0;0;0;0;12;0;0;2;5;5;0
5442.0;2021;23;NICE;MASCULIN;APPRENTISSAGE;BAC PROFESSIONNEL;BAC PRO PROD;BAC PRO 25107 TECHNICIEN OUTILLEUR;1;1;1;0;0;0;0;1;0;0;0;1;0;0
5444.0;2021;23;NICE;MASCULIN;APPRENTISSAGE;BAC PROFESSIONNEL;BAC PRO PROD;BAC PRO 25216 MAINT.VEHIC.OPTC MOTOCYCLES;16;16;14;1;1;0;1;14;0;2;2;7;3;2
5453.0;2021;23;NICE;MASCULIN;APPRENTISSAGE;BAC PROFESSIONNEL;BAC PRO SERV;BAC PRO 30001 GESTION-ADMINISTRATION;1;1;1;0;0;0;0;1;0;0;0;1;0;0
5458.0;2021;23;NICE;MASCULIN;APPRENTISSAGE;BAC PROFESSIONNEL;BAC PRO SERV;BAC PRO 33102 PROTHESE DENTAIRE;3;3;3;0;0;0;0;3;0;0;2;1;0;0
5467.0;2021;23;NICE;MASCULIN;ENSEIGNEMENT A DISTANCE;BAC TECHNOLOGIQUE;BAC STMG;BAC STMG RESSOURCES HUMAINES ET COMMUNICATION;9;9;9;0;0;0;0;9;0;2;5;2;0;0
5470.0;2021;23;NICE;MASCULIN;FORMATION CONTINUE;BAC PROFESSIONNEL;BAC PRO PROD;BAC PRO 22704 TECHN. MAINT. SYST.ENERG.CLIMATI;1;1;1;0;0;0;0;1;0;1;0;0;0;0
5473.0;2021;23;NICE;MASCULIN;FORMATION CONTINUE;BAC PROFESSIONNEL;BAC PRO SERV;BAC PRO 30001 GESTION-ADMINISTRATION;1;1;1;0;0;0;0;1;0;0;0;1;0;0
5474.0;2021;23;NICE;MASCULIN;FORMATION CONTINUE;BAC PROFESSIONNEL;BAC PRO SERV;BAC PRO 31202 COMMERCE;7;6;4;2;0;0;0;4;0;0;2;1;1;2
5476.0;2021;23;NICE;MASCULIN;FORMATION CONTINUE;BAC PROFESSIONNEL;BAC PRO SERV;BAC PRO 33101 OPTIQUE LUNETTERIE;6;5;5;0;0;0;0;5;0;0;2;2;1;0
5480.0;2021;23;NICE;MASCULIN;INDIVIDUEL;BAC PROFESSIONNEL;BAC PRO PROD;BAC PRO 22704 TECHN. MAINT. SYST.ENERG.CLIMATI;1;0;0;0;0;0;0;0;0;0;0;0;0;0
5485.0;2021;23;NICE;MASCULIN;INDIVIDUEL;BAC PROFESSIONNEL;BAC PRO PROD;BAC PRO 25510 METIERS ELECT. ENVIRON. CONNECTES;3;1;1;0;0;0;0;1;0;0;0;0;1;0
5486.0;2021;23;NICE;MASCULIN;INDIVIDUEL;BAC PROFESSIONNEL;BAC PRO PROD;BAC PRO 25513 SYST.NUM.OPT.A SURETE SECURITE;1;0;0;0;0;0;0;0;0;0;0;0;0;0
5491.0;2021;23;NICE;MASCULIN;INDIVIDUEL;BAC PROFESSIONNEL;BAC PRO SERV;BAC PRO 31108 TRANSPORT;2;1;0;1;0;0;0;0;0;0;0;0;0;1
5496.0;2021;23;NICE;MASCULIN;INDIVIDUEL;BAC TECHNOLOGIQUE;BAC S2TMD;BAC S2TMD MUSIQUE;4;4;3;1;0;0;0;3;0;0;1;1;1;1
5500.0;2021;23;NICE;MASCULIN;INDIVIDUEL;BAC TECHNOLOGIQUE;BAC STI2D;BAC STI2D SYSTÈME D'INFORMATION  ET NUMERIQUE;2;2;0;0;2;0;2;0;0;0;0;0;0;2
5507.0;2021;23;NICE;MASCULIN;SCOLAIRE;BAC PROFESSIONNEL;BAC PRO PROD;BACPRO 20002 ETUD.DEFINITION PRDTS INDUSTRIEL;14;14;11;3;0;0;0;11;0;0;1;5;5;3
5508.0;2021;23;NICE;MASCULIN;SCOLAIRE;BAC PROFESSIONNEL;BAC PRO PROD;BAC PRO 20102 PILOTE DE LIGNE DE PRODUCTION;6;6;6;0;0;0;0;6;0;0;0;0;6;0
5519.0;2021;23;NICE;MASCULIN;SCOLAIRE;BAC PROFESSIONNEL;BAC PRO PROD;BAC PRO 23203 TECHNICIEN BAT. : ORG.REAL.GROS O;14;14;8;4;2;1;1;9;0;0;1;2;6;5
5525.0;2021;23;NICE;MASCULIN;SCOLAIRE;BAC PROFESSIONNEL;BAC PRO PROD;BAC PRO 24202 ARTIS.& MET.ART : TAPIS.D'AMEUBL;5;5;4;0;1;1;0;5;0;0;2;1;2;0
5528.0;2021;23;NICE;MASCULIN;SCOLAIRE;BAC PROFESSIONNEL;BAC PRO PROD;BAC PRO 25006 MICROTECHNIQUES;28;28;24;4;0;0;0;24;0;4;7;6;7;4
5530.0;2021;23;NICE;MASCULIN;SCOLAIRE;BAC PROFESSIONNEL;BAC PRO PROD;BAC PRO 25009 MAINTENANCE NAUTIQUE;51;51;42;4;5;3;2;45;0;0;3;18;24;6
5541.0;2021;23;NICE;MASCULIN;SCOLAIRE;BAC PROFESSIONNEL;BAC PRO PROD;BAC PRO 25510 METIERS ELECT. ENVIRON. CONNECTES;331;328;265;49;14;13;1;278;0;16;47;109;106;50
5545.0;2021;23;NICE;MASCULIN;SCOLAIRE;BAC PROFESSIONNEL;BAC PRO PROD;BAC PRO AG 21004 CGEA;9;9;9;0;0;0;0;9;0;0;2;5;2;0
5550.0;2021;23;NICE;MASCULIN;SCOLAIRE;BAC PROFESSIONNEL;BAC PRO PROD;BAC PRO AG 22105 LABORATOIRE CONTROLE QUALITE;8;8;4;4;0;0;0;4;0;0;0;1;3;4
5559.0;2021;23;NICE;MASCULIN;SCOLAIRE;BAC PROFESSIONNEL;BAC PRO SERV;BAC PRO 32208 REAL.PR.IMPR.PLURI.OPTB.PR.IMPR.;3;3;3;0;0;0;0;3;0;0;0;1;2;0
5563.0;2021;23;NICE;MASCULIN;SCOLAIRE;BAC PROFESSIONNEL;BAC PRO SERV;BAC PRO 33004 ACC.SOINS-S.PERS. OPT.EN STRUCTUR;13;13;12;1;0;0;0;12;0;1;0;5;6;1
5564.0;2021;23;NICE;MASCULIN;SCOLAIRE;BAC PROFESSIONNEL;BAC PRO SERV;BAC PRO 33101 OPTIQUE LUNETTERIE;3;3;3;0;0;0;0;3;0;0;1;2;0;0
5568.0;2021;23;NICE;MASCULIN;SCOLAIRE;BAC PROFESSIONNEL;BAC PRO SERV;BAC PRO AG 33002 SERV PERS TERRIT;8;8;8;0;0;0;0;8;0;0;2;3;3;0
5569.0;2021;23;NICE;MASCULIN;SCOLAIRE;BAC TECHNOLOGIQUE;BAC S2TMD;BAC S2TMD DANSE;1;1;1;0;0;0;0;1;0;0;0;1;0;0
5575.0;2021;23;NICE;MASCULIN;SCOLAIRE;BAC TECHNOLOGIQUE;BAC STI2D;BAC STI2D ARCHITECTURE ET CONSTRUCTION;70;70;65;2;3;1;2;66;0;2;14;29;21;4
5586.0;2021;70;NORMANDIE;FEMININ;APPRENTISSAGE;BAC PROFESSIONNEL;BAC PRO PROD;BAC PRO 22003 BIO-INDUSTRIES DE TRANSFORMATION;4;4;4;0;0;0;0;4;0;1;1;1;1;0
5589.0;2021;70;NORMANDIE;FEMININ;APPRENTISSAGE;BAC PROFESSIONNEL;BAC PRO PROD;BAC PRO 23004 TECHN. ETUDES BAT.A ETUDES & ECO.;1;0;0;0;0;0;0;0;0;0;0;0;0;0
5591.0;2021;70;NORMANDIE;FEMININ;APPRENTISSAGE;BAC PROFESSIONNEL;BAC PRO PROD;BAC PRO 25106 TECHNICIEN D'USINAGE;1;1;1;0;0;0;0;1;0;0;1;0;0;0
5598.0;2021;70;NORMANDIE;FEMININ;APPRENTISSAGE;BAC PROFESSIONNEL;BAC PRO PROD;BAC PRO 25510 METIERS ELECT. ENVIRON. CONNECTES;1;1;1;0;0;0;0;1;0;0;1;0;0;0
5604.0;2021;70;NORMANDIE;FEMININ;APPRENTISSAGE;BAC PROFESSIONNEL;BAC PRO PROD;BAC PRO AG 21406 TEC CONS VTE PROD DES JARDINS;1;1;1;0;0;0;0;1;0;0;0;0;1;0
5619.0;2021;70;NORMANDIE;FEMININ;ENSEIGNEMENT A DISTANCE;BAC PROFESSIONNEL;BAC PRO SERV;BAC PRO 31210 ACCUEIL -RELATION CLIENTS USAGERS;2;2;2;0;0;0;0;2;0;0;1;0;1;0
5624.0;2021;70;NORMANDIE;FEMININ;ENSEIGNEMENT A DISTANCE;BAC TECHNOLOGIQUE;BAC STMG;BAC STMG SYSTEMES D'INFORMATION DE GESTION;1;1;1;0;0;0;0;1;0;0;0;1;0;0
5626.0;2021;70;NORMANDIE;FEMININ;FORMATION CONTINUE;BAC PROFESSIONNEL;BAC PRO PROD;BAC PRO 22004 PROC. CHIMIE EAU PAPIERS-CARTONS;2;2;2;0;0;0;0;2;0;1;1;0;0;0
5628.0;2021;70;NORMANDIE;FEMININ;FORMATION CONTINUE;BAC PROFESSIONNEL;BAC PRO PROD;BAC PRO 25007 MAINTENANCE EQUIPEMENTS INDUST.;4;4;3;1;0;0;0;3;0;0;1;2;0;1
5629.0;2021;70;NORMANDIE;FEMININ;FORMATION CONTINUE;BAC PROFESSIONNEL;BAC PRO PROD;BAC PRO 25106 TECHNICIEN D'USINAGE;2;2;1;1;0;0;0;1;0;1;0;0;0;1
5630.0;2021;70;NORMANDIE;FEMININ;FORMATION CONTINUE;BAC PROFESSIONNEL;BAC PRO PROD;BAC PRO AG 22107 TEC CONS VTE ALIMENTATION P.ALIM;3;2;1;1;0;0;0;1;0;0;1;0;0;1
5631.0;2021;70;NORMANDIE;FEMININ;FORMATION CONTINUE;BAC PROFESSIONNEL;BAC PRO SERV;BAC PRO 30001 GESTION-ADMINISTRATION;40;39;36;0;3;2;1;38;0;12;16;7;3;1
5633.0;2021;70;NORMANDIE;FEMININ;FORMATION CONTINUE;BAC PROFESSIONNEL;BAC PRO SERV;BAC PRO 31202 COMMERCE;26;25;22;2;1;0;1;22;0;2;6;5;9;3
5640.0;2021;70;NORMANDIE;FEMININ;INDIVIDUEL;BAC PROFESSIONNEL;BAC PRO PROD;BAC PRO AG 21114 CONDUITE PRODUCTIONS HORTICOLES;2;2;2;0;0;0;0;2;0;0;0;0;2;0
5644.0;2021;70;NORMANDIE;FEMININ;INDIVIDUEL;BAC PROFESSIONNEL;BAC PRO SERV;BAC PRO 31210 ACCUEIL -RELATION CLIENTS USAGERS;2;1;0;1;0;0;0;0;0;0;0;0;0;1
5656.0;2021;70;NORMANDIE;FEMININ;SCOLAIRE;BAC GENERAL;BAC GENERAL;BAC GENE 10019 BAC GENERAL;10038;10036;9652;62;322;198;124;9850;173;1257;2659;3500;2261;186
5662.0;2021;70;NORMANDIE;FEMININ;SCOLAIRE;BAC PROFESSIONNEL;BAC PRO PROD;BAC PRO 22303 FONDERIE;1;1;1;0;0;0;0;1;0;0;0;1;0;0
5685.0;2021;70;NORMANDIE;FEMININ;SCOLAIRE;BAC PROFESSIONNEL;BAC PRO PROD;BAC PRO 25509 TECHNIC. FROID CONDITIONNEMT AIR;3;3;3;0;0;0;0;3;0;0;2;1;0;0
5703.0;2021;70;NORMANDIE;FEMININ;SCOLAIRE;BAC PROFESSIONNEL;BAC PRO SERV;BAC PRO 31107 CONDUCT. TRANSP.ROUT.MARCHANDISES;11;11;6;5;0;0;0;6;0;1;0;3;2;5
5707.0;2021;70;NORMANDIE;FEMININ;SCOLAIRE;BAC PROFESSIONNEL;BAC PRO SERV;BAC PRO 31210 ACCUEIL -RELATION CLIENTS USAGERS;237;237;214;10;13;8;5;222;0;9;42;82;89;15
5714.0;2021;70;NORMANDIE;FEMININ;SCOLAIRE;BAC PROFESSIONNEL;BAC PRO SERV;BAC PRO 33004 ACC.SOINS-S.PERS. OPT.EN STRUCTUR;568;565;534;15;16;13;3;547;0;36;165;227;119;18
5718.0;2021;70;NORMANDIE;FEMININ;SCOLAIRE;BAC PROFESSIONNEL;BAC PRO SERV;BAC PRO 33602 PERRUQUIER POSTICHEUR;7;7;7;0;0;0;0;7;0;2;4;1;0;0
5720.0;2021;70;NORMANDIE;FEMININ;SCOLAIRE;BAC PROFESSIONNEL;BAC PRO SERV;BAC PRO 34304 HYGIENE PROPRETE STERILISATION;64;63;58;1;4;1;3;59;0;0;13;24;22;4
5723.0;2021;70;NORMANDIE;FEMININ;SCOLAIRE;BAC PROFESSIONNEL;BAC PRO SERV;BAC PRO AG 33002 SERV PERS TERRIT;368;360;331;29;0;0;0;331;0;5;39;123;164;29
5724.0;2021;70;NORMANDIE;FEMININ;SCOLAIRE;BAC TECHNOLOGIQUE;BAC S2TMD;BAC S2TMD DANSE;8;8;8;0;0;0;0;8;1;4;2;1;0;0
5745.0;2021;70;NORMANDIE;MASCULIN;APPRENTISSAGE;BAC PROFESSIONNEL;BAC PRO PROD;BAC PRO 22106 CUISINE;13;13;10;2;1;1;0;11;0;1;1;2;7;2
5749.0;2021;70;NORMANDIE;MASCULIN;APPRENTISSAGE;BAC PROFESSIONNEL;BAC PRO PROD;BAC PRO 23004 TECHN. ETUDES BAT.A ETUDES & ECO.;14;14;12;2;0;0;0;12;0;2;4;4;2;2
5753.0;2021;70;NORMANDIE;MASCULIN;APPRENTISSAGE;BAC PROFESSIONNEL;BAC PRO PROD;BAC PRO 23405 TECHNICIEN MENUISIER AGENCEUR;20;20;17;3;0;0;0;17;0;3;5;6;3;3
5754.0;2021;70;NORMANDIE;MASCULIN;APPRENTISSAGE;BAC PROFESSIONNEL;BAC PRO PROD;BAC PRO 24301 METIERS DU CUIR : CHAUSSURES;2;2;1;0;1;1;0;2;0;0;0;0;2;0
5755.0;2021;70;NORMANDIE;MASCULIN;APPRENTISSAGE;BAC PROFESSIONNEL;BAC PRO PROD;BAC PRO 25007 MAINTENANCE EQUIPEMENTS INDUST.;73;73;69;3;1;0;1;69;0;9;21;19;20;4
5758.0;2021;70;NORMANDIE;MASCULIN;APPRENTISSAGE;BAC PROFESSIONNEL;BAC PRO PROD;BAC PRO 25107 TECHNICIEN OUTILLEUR;10;10;8;1;1;0;1;8;0;0;2;4;2;2
5775.0;2021;70;NORMANDIE;MASCULIN;APPRENTISSAGE;BAC PROFESSIONNEL;BAC PRO PROD;BAC PRO AG 21210 COND GEST ENTR CANIN ET FELIN;1;1;1;0;0;0;0;1;0;0;0;1;0;0
5780.0;2021;70;NORMANDIE;MASCULIN;APPRENTISSAGE;BAC PROFESSIONNEL;BAC PRO PROD;BAC PRO AG 22107 TEC CONS VTE ALIMENTATION P.ALIM;1;1;1;0;0;0;0;1;0;0;0;0;1;0
5784.0;2021;70;NORMANDIE;MASCULIN;APPRENTISSAGE;BAC PROFESSIONNEL;BAC PRO SERV;BAC PRO 31206 VENTE (PROSPECT.NEGO.SUIV.CLIENT;2;2;2;0;0;0;0;2;0;0;0;0;2;0
5790.0;2021;70;NORMANDIE;MASCULIN;ENSEIGNEMENT A DISTANCE;BAC GENERAL;BAC GENERAL;BAC GENE 10019 BAC GENERAL;18;18;15;3;0;0;0;15;0;1;3;4;7;3
5809.0;2021;70;NORMANDIE;MASCULIN;FORMATION CONTINUE;BAC PROFESSIONNEL;BAC PRO PROD;BAC PRO 25509 TECHNIC. FROID CONDITIONNEMT AIR;11;11;11;0;0;0;0;11;0;3;4;1;3;0
5812.0;2021;70;NORMANDIE;MASCULIN;FORMATION CONTINUE;BAC PROFESSIONNEL;BAC PRO PROD;BAC PRO AG 21004 CGEA;1;1;1;0;0;0;0;1;0;0;0;0;1;0
5824.0;2021;70;NORMANDIE;MASCULIN;INDIVIDUEL;BAC PROFESSIONNEL;BAC PRO PROD;BAC PRO 25106 TECHNICIEN D'USINAGE;1;1;0;1;0;0;0;0;0;0;0;0;0;1
5828.0;2021;70;NORMANDIE;MASCULIN;INDIVIDUEL;BAC PROFESSIONNEL;BAC PRO PROD;BAC PRO 25411 TECH.CHAUDRONNERIE INDUSTRIELLE;1;1;0;1;0;0;0;0;0;0;0;0;0;1
5830.0;2021;70;NORMANDIE;MASCULIN;INDIVIDUEL;BAC PROFESSIONNEL;BAC PRO PROD;BAC PRO 25514 SYST.NUM.OPT.B AUD.RES.EQUIP.DOM.;1;0;0;0;0;0;0;0;0;0;0;0;0;0
5833.0;2021;70;NORMANDIE;MASCULIN;INDIVIDUEL;BAC PROFESSIONNEL;BAC PRO PROD;BAC PRO AG 21114 CONDUITE PRODUCTIONS HORTICOLES;3;3;3;0;0;0;0;3;0;0;0;0;3;0
5844.0;2021;70;NORMANDIE;MASCULIN;INDIVIDUEL;BAC TECHNOLOGIQUE;BAC STI2D;BAC STI2D SYSTÈME D'INFORMATION  ET NUMERIQUE;2;1;0;1;0;0;0;0;0;0;0;0;0;1
5847.0;2021;70;NORMANDIE;MASCULIN;INDIVIDUEL;BAC TECHNOLOGIQUE;BAC STMG;BAC STMG RESSOURCES HUMAINES ET COMMUNICATION;7;4;0;4;0;0;0;0;0;0;0;0;0;4
5850.0;2021;70;NORMANDIE;MASCULIN;SCOLAIRE;BAC PROFESSIONNEL;BAC PRO PROD;BACPRO 20002 ETUD.DEFINITION PRDTS INDUSTRIEL;59;59;42;13;4;3;1;45;0;3;7;15;20;14
5851.0;2021;70;NORMANDIE;MASCULIN;SCOLAIRE;BAC PROFESSIONNEL;BAC PRO PROD;BAC PRO 20102 PILOTE DE LIGNE DE PRODUCTION;8;8;7;1;0;0;0;7;0;0;2;1;4;1
5853.0;2021;70;NORMANDIE;MASCULIN;SCOLAIRE;BAC PROFESSIONNEL;BAC PRO PROD;BAC PRO 22004 PROC. CHIMIE EAU PAPIERS-CARTONS;59;59;48;11;0;0;0;48;0;1;5;17;25;11
5867.0;2021;70;NORMANDIE;MASCULIN;SCOLAIRE;BAC PROFESSIONNEL;BAC PRO PROD;BAC PRO 23303 MENUISERIE ALUMINIUM-VERRE;9;9;5;3;1;1;0;6;0;0;1;3;2;3
5885.0;2021;70;NORMANDIE;MASCULIN;SCOLAIRE;BAC PROFESSIONNEL;BAC PRO PROD;BAC PRO 25220 MAINT.MATERIELS OPT.B TP MANUT.;24;24;23;1;0;0;0;23;0;1;10;6;6;1
5892.0;2021;70;NORMANDIE;MASCULIN;SCOLAIRE;BAC PROFESSIONNEL;BAC PRO PROD;BAC PRO 25513 SYST.NUM.OPT.A SURETE SECURITE;71;70;64;3;3;3;0;67;0;3;15;23;26;3
5904.0;2021;70;NORMANDIE;MASCULIN;SCOLAIRE;BAC PROFESSIONNEL;BAC PRO PROD;BAC PRO AG 21405 AMENAGEMENTS PAYSAGERS;82;78;70;8;0;0;0;70;0;0;13;32;25;8
5907.0;2021;70;NORMANDIE;MASCULIN;SCOLAIRE;BAC PROFESSIONNEL;BAC PRO PROD;BAC PRO AG 22107 TEC CONS VTE ALIMENTATION P.ALIM;14;14;13;1;0;0;0;13;0;0;0;1;12;1
5908.0;2021;70;NORMANDIE;MASCULIN;SCOLAIRE;BAC PROFESSIONNEL;BAC PRO SERV;BAC PRO 30001 GESTION-ADMINISTRATION;358;357;251;89;17;13;4;264;0;6;29;96;133;93
5922.0;2021;70;NORMANDIE;MASCULIN;SCOLAIRE;BAC PROFESSIONNEL;BAC PRO SERV;BAC PRO 33101 OPTIQUE LUNETTERIE;4;4;4;0;0;0;0;4;0;0;1;2;1;0
5927.0;2021;70;NORMANDIE;MASCULIN;SCOLAIRE;BAC PROFESSIONNEL;BAC PRO SERV;BAC PRO 34305 TECHN.D'INTERV.SUR INSTALL. NUCL.;10;10;9;1;0;0;0;9;0;0;0;5;4;1
5930.0;2021;70;NORMANDIE;MASCULIN;SCOLAIRE;BAC TECHNOLOGIQUE;BAC S2TMD;BAC S2TMD DANSE;1;1;0;0;1;0;1;0;0;0;0;0;0;1
5940.0;2021;70;NORMANDIE;MASCULIN;SCOLAIRE;BAC TECHNOLOGIQUE;BAC STL;BAC STL BIOCHIM.-BIOLOGIE-BIOTECHNOL.;111;111;96;1;14;10;4;106;0;2;8;37;59;5
5945.0;2021;70;NORMANDIE;MASCULIN;SCOLAIRE;BAC TECHNOLOGIQUE;BAC STMG;BAC STMG SYSTEMES D'INFORMATION DE GESTION;26;26;20;1;5;3;2;23;0;0;1;10;12;3
5947.0;2021;18;ORLEANS-TOURS;FEMININ;APPRENTISSAGE;BAC PROFESSIONNEL;BAC PRO PROD;BAC PRO 22106 CUISINE;3;3;3;0;0;0;0;3;0;0;0;2;1;0
5960.0;2021;18;ORLEANS-TOURS;FEMININ;APPRENTISSAGE;BAC PROFESSIONNEL;BAC PRO PROD;BAC PRO AG 21303 FORET;1;1;1;0;0;0;0;1;0;0;0;0;1;0
5963.0;2021;18;ORLEANS-TOURS;FEMININ;APPRENTISSAGE;BAC PROFESSIONNEL;BAC PRO SERV;BAC PRO 30001 GESTION-ADMINISTRATION;20;19;17;2;0;0;0;17;0;5;9;3;0;2
5966.0;2021;18;ORLEANS-TOURS;FEMININ;APPRENTISSAGE;BAC PROFESSIONNEL;BAC PRO SERV;BAC PRO 31206 VENTE (PROSPECT.NEGO.SUIV.CLIENT;2;2;2;0;0;0;0;2;0;0;2;0;0;0
5970.0;2021;18;ORLEANS-TOURS;FEMININ;APPRENTISSAGE;BAC PROFESSIONNEL;BAC PRO SERV;BAC PRO 34304 HYGIENE PROPRETE STERILISATION;5;5;4;0;1;0;1;4;0;1;0;1;2;1
5971.0;2021;18;ORLEANS-TOURS;FEMININ;APPRENTISSAGE;BAC PROFESSIONNEL;BAC PRO SERV;BAC PRO AG 33002 SERV PERS TERRIT;1;1;1;0;0;0;0;1;0;0;0;0;1;0
5996.0;2021;18;ORLEANS-TOURS;FEMININ;INDIVIDUEL;BAC PROFESSIONNEL;BAC PRO SERV;BAC PRO 33603 ESTHETIQUE COSMETIQUE PARFUMERIE;2;2;1;0;1;1;0;2;0;0;0;0;2;0
6000.0;2021;18;ORLEANS-TOURS;FEMININ;INDIVIDUEL;BAC TECHNOLOGIQUE;BAC STI2D;BAC STI2D INNOVATION TECHNO.  ET ECO CONCEPTION;1;1;0;1;0;0;0;0;0;0;0;0;0;1
6003.0;2021;18;ORLEANS-TOURS;FEMININ;INDIVIDUEL;BAC TECHNOLOGIQUE;BAC STMG;BAC STMG MERCATIQUE (MARKETING);5;5;1;2;2;1;1;2;0;0;0;0;2;3
6010.0;2021;18;ORLEANS-TOURS;FEMININ;SCOLAIRE;BAC PROFESSIONNEL;BAC PRO PROD;BAC PRO 22106 CUISINE;66;66;59;2;5;3;2;62;0;6;13;21;22;4
6011.0;2021;18;ORLEANS-TOURS;FEMININ;SCOLAIRE;BAC PROFESSIONNEL;BAC PRO PROD;BAC PRO 22403 ARTS.& MET.ART:MET.ENSEIGN SIGNA;7;7;7;0;0;0;0;7;0;1;2;2;2;0
6022.0;2021;18;ORLEANS-TOURS;FEMININ;SCOLAIRE;BAC PROFESSIONNEL;BAC PRO PROD;BAC PRO 24302 METIERS DU CUIR : MAROQUINERIE;16;16;13;3;0;0;0;13;0;3;3;4;3;3
6023.0;2021;18;ORLEANS-TOURS;FEMININ;SCOLAIRE;BAC PROFESSIONNEL;BAC PRO PROD;BAC PRO 25007 MAINTENANCE EQUIPEMENTS INDUST.;11;10;9;1;0;0;0;9;0;1;3;2;3;1
6024.0;2021;18;ORLEANS-TOURS;FEMININ;SCOLAIRE;BAC PROFESSIONNEL;BAC PRO PROD;BAC PRO 25106 TECHNICIEN D'USINAGE;3;3;3;0;0;0;0;3;0;0;2;1;0;0
6029.0;2021;18;ORLEANS-TOURS;FEMININ;SCOLAIRE;BAC PROFESSIONNEL;BAC PRO PROD;BAC PRO 25221 MAINT.MATERIELS OPT.C ESP. VERTS;1;1;1;0;0;0;0;1;0;0;1;0;0;0
6036.0;2021;18;ORLEANS-TOURS;FEMININ;SCOLAIRE;BAC PROFESSIONNEL;BAC PRO PROD;BAC PRO AG 21004 CGEA;63;63;52;11;0;0;0;52;0;0;7;20;25;11
6047.0;2021;18;ORLEANS-TOURS;FEMININ;SCOLAIRE;BAC PROFESSIONNEL;BAC PRO PROD;BAC PRO AG 22107 TEC CONS VTE ALIMENTATION P.ALIM;10;9;9;0;0;0;0;9;0;0;0;2;7;0
6048.0;2021;18;ORLEANS-TOURS;FEMININ;SCOLAIRE;BAC PROFESSIONNEL;BAC PRO SERV;BAC PRO 30001 GESTION-ADMINISTRATION;514;514;433;57;24;16;8;449;0;4;78;160;207;65
6054.0;2021;18;ORLEANS-TOURS;FEMININ;SCOLAIRE;BAC PROFESSIONNEL;BAC PRO SERV;BAC PRO 31210 ACCUEIL -RELATION CLIENTS USAGERS;233;233;195;23;15;13;2;208;0;7;42;73;86;25
6059.0;2021;18;ORLEANS-TOURS;FEMININ;SCOLAIRE;BAC PROFESSIONNEL;BAC PRO SERV;BAC PRO 33002 SERVICES DE PROXIMITE  VIE LOCAL;67;67;63;2;2;0;2;63;0;7;15;23;18;4
6061.0;2021;18;ORLEANS-TOURS;FEMININ;SCOLAIRE;BAC PROFESSIONNEL;BAC PRO SERV;BAC PRO 33004 ACC.SOINS-S.PERS. OPT.EN STRUCTUR;458;458;421;21;16;10;6;431;0;23;111;189;108;27
6065.0;2021;18;ORLEANS-TOURS;FEMININ;SCOLAIRE;BAC PROFESSIONNEL;BAC PRO SERV;BAC PRO 34304 HYGIENE PROPRETE STERILISATION;6;6;3;2;1;0;1;3;0;0;0;2;1;3
6066.0;2021;18;ORLEANS-TOURS;FEMININ;SCOLAIRE;BAC PROFESSIONNEL;BAC PRO SERV;BAC PRO 34305 TECHN.D'INTERV.SUR INSTALL. NUCL.;1;1;1;0;0;0;0;1;0;0;0;1;0;0
6070.0;2021;18;ORLEANS-TOURS;FEMININ;SCOLAIRE;BAC TECHNOLOGIQUE;BAC S2TMD;BAC S2TMD MUSIQUE;2;2;2;0;0;0;0;2;0;0;2;0;0;0
6076.0;2021;18;ORLEANS-TOURS;FEMININ;SCOLAIRE;BAC TECHNOLOGIQUE;BAC STI2D;BAC STI2D ENERGIES  ET ENVIRONNEMENT;14;14;12;0;2;1;1;13;0;0;2;3;8;1
6081.0;2021;18;ORLEANS-TOURS;FEMININ;SCOLAIRE;BAC TECHNOLOGIQUE;BAC STMG;BAC STMG GESTION ET FINANCE;203;203;187;6;10;4;6;191;1;10;48;82;50;12
6085.0;2021;18;ORLEANS-TOURS;MASCULIN;APPRENTISSAGE;BAC PROFESSIONNEL;BAC PRO PROD;BAC PRO 22104 BOUCHER CHARCUTIER TRAITEUR;4;4;4;0;0;0;0;4;0;0;1;1;2;0
6095.0;2021;18;ORLEANS-TOURS;MASCULIN;APPRENTISSAGE;BAC PROFESSIONNEL;BAC PRO PROD;BAC PRO 25007 MAINTENANCE EQUIPEMENTS INDUST.;18;16;11;3;2;1;1;12;0;1;2;2;7;4
6100.0;2021;18;ORLEANS-TOURS;MASCULIN;APPRENTISSAGE;BAC PROFESSIONNEL;BAC PRO PROD;BAC PRO 25219 MAINT.MATERIELS OPT.A AGRICOLES;40;40;31;5;4;2;2;33;0;1;9;12;11;7
6104.0;2021;18;ORLEANS-TOURS;MASCULIN;APPRENTISSAGE;BAC PROFESSIONNEL;BAC PRO PROD;BAC PRO 25408 REPARATION DES CARROSSERIES;13;13;10;1;2;0;2;10;0;0;3;2;5;3
6105.0;2021;18;ORLEANS-TOURS;MASCULIN;APPRENTISSAGE;BAC PROFESSIONNEL;BAC PRO PROD;BAC PRO 25410 CONSTRUCTION DES CARROSSERIES;15;15;13;1;1;1;0;14;0;1;4;5;4;1
6106.0;2021;18;ORLEANS-TOURS;MASCULIN;APPRENTISSAGE;BAC PROFESSIONNEL;BAC PRO PROD;BAC PRO 25411 TECH.CHAUDRONNERIE INDUSTRIELLE;19;19;18;1;0;0;0;18;0;2;5;10;1;1
6120.0;2021;18;ORLEANS-TOURS;MASCULIN;APPRENTISSAGE;BAC PROFESSIONNEL;BAC PRO SERV;BAC PRO 31202 COMMERCE;62;60;49;7;4;1;3;50;0;1;10;23;16;10
6130.0;2021;18;ORLEANS-TOURS;MASCULIN;ENSEIGNEMENT A DISTANCE;BAC TECHNOLOGIQUE;BAC STMG;BAC STMG GESTION ET FINANCE;1;0;0;0;0;0;0;0;0;0;0;0;0;0
6138.0;2021;18;ORLEANS-TOURS;MASCULIN;FORMATION CONTINUE;BAC PROFESSIONNEL;BAC PRO PROD;BAC PRO 23404 TECHNICIEN CONSTRUCTEUR BOIS;1;1;1;0;0;0;0;1;0;1;0;0;0;0
6144.0;2021;18;ORLEANS-TOURS;MASCULIN;FORMATION CONTINUE;BAC PROFESSIONNEL;BAC PRO PROD;BAC PRO 25303 AERONAUTIQUE OPTION SYSTEMES;8;8;8;0;0;0;0;8;0;0;6;2;0;0
6146.0;2021;18;ORLEANS-TOURS;MASCULIN;FORMATION CONTINUE;BAC PROFESSIONNEL;BAC PRO PROD;BAC PRO 25411 TECH.CHAUDRONNERIE INDUSTRIELLE;3;3;3;0;0;0;0;3;0;1;2;0;0;0
6151.0;2021;18;ORLEANS-TOURS;MASCULIN;FORMATION CONTINUE;BAC PROFESSIONNEL;BAC PRO SERV;BAC PRO 30001 GESTION-ADMINISTRATION;1;1;1;0;0;0;0;1;0;1;0;0;0;0
6159.0;2021;18;ORLEANS-TOURS;MASCULIN;INDIVIDUEL;BAC PROFESSIONNEL;BAC PRO PROD;BAC PRO 25214 MAINT.VEHIC.OPTA VOIT.PARTICUL.;5;3;1;2;0;0;0;1;0;0;1;0;0;2
6161.0;2021;18;ORLEANS-TOURS;MASCULIN;INDIVIDUEL;BAC PROFESSIONNEL;BAC PRO PROD;BAC PRO 25221 MAINT.MATERIELS OPT.C ESP. VERTS;1;1;0;1;0;0;0;0;0;0;0;0;0;1
6168.0;2021;18;ORLEANS-TOURS;MASCULIN;INDIVIDUEL;BAC PROFESSIONNEL;BAC PRO PROD;BAC PRO AG 21302 GEST MILIEUX NATURELS FAUNE;2;2;0;2;0;0;0;0;0;0;0;0;0;2
6169.0;2021;18;ORLEANS-TOURS;MASCULIN;INDIVIDUEL;BAC PROFESSIONNEL;BAC PRO PROD;BAC PRO AG 21405 AMENAGEMENTS PAYSAGERS;2;1;1;0;0;0;0;1;0;0;0;0;1;0
6174.0;2021;18;ORLEANS-TOURS;MASCULIN;INDIVIDUEL;BAC PROFESSIONNEL;BAC PRO SERV;BAC PRO 31210 ACCUEIL -RELATION CLIENTS USAGERS;2;1;0;0;1;1;0;1;0;0;0;0;1;0
6183.0;2021;18;ORLEANS-TOURS;MASCULIN;INDIVIDUEL;BAC TECHNOLOGIQUE;BAC STMG;BAC STMG GESTION ET FINANCE;4;2;1;1;0;0;0;1;0;0;0;0;1;1
6188.0;2021;18;ORLEANS-TOURS;MASCULIN;SCOLAIRE;BAC PROFESSIONNEL;BAC PRO PROD;BAC PRO 20102 PILOTE DE LIGNE DE PRODUCTION;10;10;9;1;0;0;0;9;0;0;2;3;4;1
6191.0;2021;18;ORLEANS-TOURS;MASCULIN;SCOLAIRE;BAC PROFESSIONNEL;BAC PRO PROD;BAC PRO 22106 CUISINE;128;128;113;10;5;3;2;116;0;4;20;54;38;12
6205.0;2021;18;ORLEANS-TOURS;MASCULIN;SCOLAIRE;BAC PROFESSIONNEL;BAC PRO PROD;BAC PRO 23303 MENUISERIE ALUMINIUM-VERRE;16;16;13;3;0;0;0;13;0;0;1;6;6;3
6209.0;2021;18;ORLEANS-TOURS;MASCULIN;SCOLAIRE;BAC PROFESSIONNEL;BAC PRO PROD;BAC PRO 23408 Etude et réalisation d'agencement;10;10;8;0;2;0;2;8;0;1;2;1;4;2
6213.0;2021;18;ORLEANS-TOURS;MASCULIN;SCOLAIRE;BAC PROFESSIONNEL;BAC PRO PROD;BAC PRO 25005 PRODUCTIQ.MECA. OPT.DECOLLETAGE;8;8;7;0;1;1;0;8;0;1;0;3;4;0
6218.0;2021;18;ORLEANS-TOURS;MASCULIN;SCOLAIRE;BAC PROFESSIONNEL;BAC PRO PROD;BAC PRO 25108 TECHNICIEN MODELEUR;14;14;10;2;2;2;0;12;0;1;2;4;5;2
6236.0;2021;18;ORLEANS-TOURS;MASCULIN;SCOLAIRE;BAC PROFESSIONNEL;BAC PRO PROD;BAC PRO AG 21113 CGEVV;9;9;9;0;0;0;0;9;0;2;3;4;0;0
6237.0;2021;18;ORLEANS-TOURS;MASCULIN;SCOLAIRE;BAC PROFESSIONNEL;BAC PRO PROD;BAC PRO AG 21114 CONDUITE PRODUCTIONS HORTICOLES;14;14;8;6;0;0;0;8;0;0;2;1;5;6
6254.0;2021;18;ORLEANS-TOURS;MASCULIN;SCOLAIRE;BAC PROFESSIONNEL;BAC PRO SERV;BAC PRO 31210 ACCUEIL -RELATION CLIENTS USAGERS;82;82;65;14;3;3;0;68;0;2;10;23;33;14
6256.0;2021;18;ORLEANS-TOURS;MASCULIN;SCOLAIRE;BAC PROFESSIONNEL;BAC PRO SERV;BAC PRO 32208 REAL.PR.IMPR.PLURI.OPTB.PR.IMPR.;9;9;8;0;1;1;0;9;0;0;2;3;4;0
6257.0;2021;18;ORLEANS-TOURS;MASCULIN;SCOLAIRE;BAC PROFESSIONNEL;BAC PRO SERV;BAC PRO 32303 ART.& MET.ART:COM.VIS.VIS.PLURI-M;7;7;7;0;0;0;0;7;0;0;2;2;3;0
6258.0;2021;18;ORLEANS-TOURS;MASCULIN;SCOLAIRE;BAC PROFESSIONNEL;BAC PRO SERV;BAC PRO 32304 PHOTOGRAPHIE;9;9;9;0;0;0;0;9;0;0;3;5;1;0
6264.0;2021;18;ORLEANS-TOURS;MASCULIN;SCOLAIRE;BAC PROFESSIONNEL;BAC PRO SERV;BAC PRO 34304 HYGIENE PROPRETE STERILISATION;7;6;2;4;0;0;0;2;0;0;1;0;1;4
6267.0;2021;18;ORLEANS-TOURS;MASCULIN;SCOLAIRE;BAC PROFESSIONNEL;BAC PRO SERV;BAC PRO AG 33002 SERV PERS TERRIT;29;28;25;3;0;0;0;25;0;0;3;7;15;3
6268.0;2021;18;ORLEANS-TOURS;MASCULIN;SCOLAIRE;BAC TECHNOLOGIQUE;BAC S2TMD;BAC S2TMD DANSE;3;3;3;0;0;0;0;3;0;1;1;0;1;0
6269.0;2021;18;ORLEANS-TOURS;MASCULIN;SCOLAIRE;BAC TECHNOLOGIQUE;BAC ST2S;BAC ST2S SCIENCES & TECHNO. SANTE & SOCIAL;91;91;75;2;14;8;6;83;0;0;6;27;50;8
6273.0;2021;18;ORLEANS-TOURS;MASCULIN;SCOLAIRE;BAC TECHNOLOGIQUE;BAC STI2D;BAC STI2D ARCHITECTURE ET CONSTRUCTION;89;89;83;0;6;3;3;86;0;1;18;30;37;3
6277.0;2021;18;ORLEANS-TOURS;MASCULIN;SCOLAIRE;BAC TECHNOLOGIQUE;BAC STL;BAC STL BIOCHIM.-BIOLOGIE-BIOTECHNOL.;94;94;84;1;9;4;5;88;0;5;17;26;40;6
6279.0;2021;18;ORLEANS-TOURS;MASCULIN;SCOLAIRE;BAC TECHNOLOGIQUE;BAC STMG;BAC STMG GESTION ET FINANCE;302;301;270;5;26;15;11;285;0;6;35;99;145;16
6282.0;2021;18;ORLEANS-TOURS;MASCULIN;SCOLAIRE;BAC TECHNOLOGIQUE;BAC STMG;BAC STMG SYSTEMES D'INFORMATION DE GESTION;19;19;18;0;1;1;0;19;0;0;4;5;10;0
6283.0;2021;01;PARIS;FEMININ;APPRENTISSAGE;BAC PROFESSIONNEL;BAC PRO PROD;BAC PRO 22004 PROC. CHIMIE EAU PAPIERS-CARTONS;1;1;1;0;0;0;0;1;0;0;0;1;0;0
6284.0;2021;01;PARIS;FEMININ;APPRENTISSAGE;BAC PROFESSIONNEL;BAC PRO PROD;BAC PRO 22105 BOULANGER-PÂTISSIER;28;28;28;0;0;0;0;28;0;5;9;10;4;0
6289.0;2021;01;PARIS;FEMININ;APPRENTISSAGE;BAC PROFESSIONNEL;BAC PRO PROD;BAC PRO 24302 METIERS DU CUIR : MAROQUINERIE;13;13;12;1;0;0;0;12;0;2;6;3;1;1
6301.0;2021;01;PARIS;FEMININ;APPRENTISSAGE;BAC PROFESSIONNEL;BAC PRO SERV;BAC PRO 33102 PROTHESE DENTAIRE;2;2;2;0;0;0;0;2;0;0;0;2;0;0
6302.0;2021;01;PARIS;FEMININ;APPRENTISSAGE;BAC PROFESSIONNEL;BAC PRO SERV;BAC PRO 33403 COMMERC. SERVICES EN RESTAURATION;25;25;24;1;0;0;0;24;0;2;7;11;4;1
6303.0;2021;01;PARIS;FEMININ;APPRENTISSAGE;BAC PROFESSIONNEL;BAC PRO SERV;BAC PRO 33603 ESTHETIQUE COSMETIQUE PARFUMERIE;7;7;5;1;1;1;0;6;0;0;1;1;4;1
6309.0;2021;01;PARIS;FEMININ;ENSEIGNEMENT A DISTANCE;BAC TECHNOLOGIQUE;BAC STMG;BAC STMG MERCATIQUE (MARKETING);3;3;2;0;1;0;1;2;0;0;2;0;0;1
6318.0;2021;01;PARIS;FEMININ;INDIVIDUEL;BAC GENERAL;BAC GENERAL;BAC GENE 10019 BAC GENERAL;422;384;319;36;29;22;7;341;2;20;58;119;142;43
6322.0;2021;01;PARIS;FEMININ;INDIVIDUEL;BAC PROFESSIONNEL;BAC PRO PROD;BAC PRO AG 21113 CGEVV;1;1;1;0;0;0;0;1;0;0;0;0;1;0
6329.0;2021;01;PARIS;FEMININ;INDIVIDUEL;BAC PROFESSIONNEL;BAC PRO SERV;BAC PRO 32207 REAL.PR.IMPR.PLURI.OPTA.PR.GRAPH.;1;1;1;0;0;0;0;1;0;0;0;0;1;0
6337.0;2021;01;PARIS;FEMININ;INDIVIDUEL;BAC TECHNOLOGIQUE;BAC STMG;BAC STMG GESTION ET FINANCE;23;22;20;1;1;1;0;21;0;1;12;5;3;1
6339.0;2021;01;PARIS;FEMININ;INDIVIDUEL;BAC TECHNOLOGIQUE;BAC STMG;BAC STMG RESSOURCES HUMAINES ET COMMUNICATION;16;13;13;0;0;0;0;13;0;0;0;3;10;0
6343.0;2021;01;PARIS;FEMININ;SCOLAIRE;BAC PROFESSIONNEL;BAC PRO PROD;BAC PRO 22106 CUISINE;21;21;20;1;0;0;0;20;0;2;6;7;5;1
6359.0;2021;01;PARIS;FEMININ;SCOLAIRE;BAC PROFESSIONNEL;BAC PRO PROD;BAC PRO AG 22105 LABORATOIRE CONTROLE QUALITE;7;7;7;0;0;0;0;7;0;1;0;1;5;0
6361.0;2021;01;PARIS;FEMININ;SCOLAIRE;BAC PROFESSIONNEL;BAC PRO SERV;BAC PRO 31106 LOGISTIQUE;4;4;3;0;1;0;1;3;0;0;1;0;2;1
6362.0;2021;01;PARIS;FEMININ;SCOLAIRE;BAC PROFESSIONNEL;BAC PRO SERV;BAC PRO 31108 TRANSPORT;6;6;4;2;0;0;0;4;0;0;0;1;3;2
6368.0;2021;01;PARIS;FEMININ;SCOLAIRE;BAC PROFESSIONNEL;BAC PRO SERV;BAC PRO 32208 REAL.PR.IMPR.PLURI.OPTB.PR.IMPR.;5;5;5;0;0;0;0;5;0;0;3;2;0;0
6369.0;2021;01;PARIS;FEMININ;SCOLAIRE;BAC PROFESSIONNEL;BAC PRO SERV;BAC PRO 32303 ART.& MET.ART:COM.VIS.VIS.PLURI-M;50;50;48;1;1;1;0;49;0;4;13;24;8;1
6370.0;2021;01;PARIS;FEMININ;SCOLAIRE;BAC PROFESSIONNEL;BAC PRO SERV;BAC PRO 32304 PHOTOGRAPHIE;12;12;8;4;0;0;0;8;0;1;1;3;3;4
6374.0;2021;01;PARIS;FEMININ;SCOLAIRE;BAC PROFESSIONNEL;BAC PRO SERV;BAC PRO 33101 OPTIQUE LUNETTERIE;16;16;14;2;0;0;0;14;0;2;2;5;5;2
6384.0;2021;01;PARIS;FEMININ;SCOLAIRE;BAC TECHNOLOGIQUE;BAC ST2S;BAC ST2S SCIENCES & TECHNO. SANTE & SOCIAL;299;299;276;7;16;10;6;286;1;16;58;106;105;13
6392.0;2021;01;PARIS;FEMININ;SCOLAIRE;BAC TECHNOLOGIQUE;BAC STL;BAC STL SCIENCES PHYSIQUES CHIMIQUES  EN LABORAT.;40;40;33;3;4;3;1;36;1;1;5;8;21;4
6396.0;2021;01;PARIS;FEMININ;SCOLAIRE;BAC TECHNOLOGIQUE;BAC STMG;BAC STMG SYSTEMES D'INFORMATION DE GESTION;43;43;39;3;1;1;0;40;0;0;8;21;11;3
6400.0;2021;01;PARIS;MASCULIN;APPRENTISSAGE;BAC PROFESSIONNEL;BAC PRO PROD;BAC PRO 22703 TECHN.INSTALL.SYST.ENERG.CLIMATI;15;15;8;1;6;1;5;9;0;0;1;1;7;6
6401.0;2021;01;PARIS;MASCULIN;APPRENTISSAGE;BAC PROFESSIONNEL;BAC PRO PROD;BAC PRO 22704 TECHN. MAINT. SYST.ENERG.CLIMATI;25;24;20;3;1;0;1;20;0;0;3;8;9;4
6402.0;2021;01;PARIS;MASCULIN;APPRENTISSAGE;BAC PROFESSIONNEL;BAC PRO PROD;BAC PRO 23004 TECHN. ETUDES BAT.A ETUDES & ECO.;11;9;7;0;2;2;0;9;0;0;2;2;5;0
6434.0;2021;01;PARIS;MASCULIN;FORMATION CONTINUE;BAC PROFESSIONNEL;BAC PRO PROD;BAC PRO 25513 SYST.NUM.OPT.A SURETE SECURITE;4;4;4;0;0;0;0;4;0;2;1;1;0;0
6453.0;2021;01;PARIS;MASCULIN;INDIVIDUEL;BAC PROFESSIONNEL;BAC PRO PROD;BAC PRO AG 21406 TEC CONS VTE PROD DES JARDINS;1;1;0;1;0;0;0;0;0;0;0;0;0;1
6457.0;2021;01;PARIS;MASCULIN;INDIVIDUEL;BAC PROFESSIONNEL;BAC PRO SERV;BAC PRO 31206 VENTE (PROSPECT.NEGO.SUIV.CLIENT;2;1;1;0;0;0;0;1;0;0;0;0;1;0
6459.0;2021;01;PARIS;MASCULIN;INDIVIDUEL;BAC PROFESSIONNEL;BAC PRO SERV;BAC PRO 32304 PHOTOGRAPHIE;1;1;1;0;0;0;0;1;0;0;0;0;1;0
6463.0;2021;01;PARIS;MASCULIN;INDIVIDUEL;BAC TECHNOLOGIQUE;BAC STAV;BAC STAV AGRONOMIE ALIM ENV TERRITOI;2;1;1;0;0;0;0;1;0;0;0;0;1;0
6478.0;2021;01;PARIS;MASCULIN;SCOLAIRE;BAC PROFESSIONNEL;BAC PRO PROD;BAC PRO 22403 ARTS.& MET.ART:MET.ENSEIGN SIGNA;11;11;8;0;3;1;2;9;0;0;0;3;6;2
6484.0;2021;01;PARIS;MASCULIN;SCOLAIRE;BAC PROFESSIONNEL;BAC PRO PROD;BACPRO 23103 TECHNICIEN GEOMETRE-TOPOGRAPHE;9;9;9;0;0;0;0;9;0;1;2;4;2;0
6494.0;2021;01;PARIS;MASCULIN;SCOLAIRE;BAC PROFESSIONNEL;BAC PRO PROD;BAC PRO 24302 METIERS DU CUIR : MAROQUINERIE;6;5;3;2;0;0;0;3;0;0;0;1;2;2
6495.0;2021;01;PARIS;MASCULIN;SCOLAIRE;BAC PROFESSIONNEL;BAC PRO PROD;BAC PRO 25006 MICROTECHNIQUES;34;34;33;0;1;0;1;33;0;1;13;15;4;1
6497.0;2021;01;PARIS;MASCULIN;SCOLAIRE;BAC PROFESSIONNEL;BAC PRO PROD;BAC PRO 25106 TECHNICIEN D'USINAGE;7;7;5;2;0;0;0;5;0;1;1;0;3;2
6508.0;2021;01;PARIS;MASCULIN;SCOLAIRE;BAC PROFESSIONNEL;BAC PRO PROD;BAC PRO AG 21405 AMENAGEMENTS PAYSAGERS;25;25;23;2;0;0;0;23;0;0;3;13;7;2
6513.0;2021;01;PARIS;MASCULIN;SCOLAIRE;BAC PROFESSIONNEL;BAC PRO SERV;BAC PRO 31202 COMMERCE;341;340;239;54;47;30;17;269;0;5;50;93;121;71
6514.0;2021;01;PARIS;MASCULIN;SCOLAIRE;BAC PROFESSIONNEL;BAC PRO SERV;BAC PRO 31206 VENTE (PROSPECT.NEGO.SUIV.CLIENT;83;83;56;21;6;4;2;60;0;6;11;15;28;23
6519.0;2021;01;PARIS;MASCULIN;SCOLAIRE;BAC PROFESSIONNEL;BAC PRO SERV;BAC PRO 32303 ART.& MET.ART:COM.VIS.VIS.PLURI-M;64;64;58;5;1;1;0;59;0;4;19;25;11;5
6520.0;2021;01;PARIS;MASCULIN;SCOLAIRE;BAC PROFESSIONNEL;BAC PRO SERV;BAC PRO 32304 PHOTOGRAPHIE;25;25;20;5;0;0;0;20;0;1;9;6;4;5
6525.0;2021;01;PARIS;MASCULIN;SCOLAIRE;BAC PROFESSIONNEL;BAC PRO SERV;BAC PRO 33102 PROTHESE DENTAIRE;9;9;9;0;0;0;0;9;0;0;1;4;4;0
6529.0;2021;01;PARIS;MASCULIN;SCOLAIRE;BAC PROFESSIONNEL;BAC PRO SERV;BAC PRO 34403 METIERS DE LA SECURITE;75;75;69;3;3;1;2;70;0;5;12;28;25;5
6532.0;2021;01;PARIS;MASCULIN;SCOLAIRE;BAC TECHNOLOGIQUE;BAC ST2S;BAC ST2S SCIENCES & TECHNO. SANTE & SOCIAL;41;41;32;3;6;5;1;37;0;2;5;10;20;4
6547.0;2021;13;POITIERS;FEMININ;APPRENTISSAGE;BAC PROFESSIONNEL;BAC PRO PROD;BAC PRO 23102 TRAVAUX PUBLICS;1;1;1;0;0;0;0;1;0;0;1;0;0;0
6557.0;2021;13;POITIERS;FEMININ;APPRENTISSAGE;BAC PROFESSIONNEL;BAC PRO PROD;BAC PRO AG 21405 AMENAGEMENTS PAYSAGERS;2;2;2;0;0;0;0;2;0;0;0;0;2;0
6559.0;2021;13;POITIERS;FEMININ;APPRENTISSAGE;BAC PROFESSIONNEL;BAC PRO SERV;BAC PRO 30001 GESTION-ADMINISTRATION;15;15;15;0;0;0;0;15;0;2;7;3;3;0
6567.0;2021;13;POITIERS;FEMININ;APPRENTISSAGE;BAC PROFESSIONNEL;BAC PRO SERV;BAC PRO 33603 ESTHETIQUE COSMETIQUE PARFUMERIE;1;1;1;0;0;0;0;1;0;0;0;1;0;0
6570.0;2021;13;POITIERS;FEMININ;ENSEIGNEMENT A DISTANCE;BAC GENERAL;BAC GENERAL;BAC GENE 10019 BAC GENERAL;22;22;20;2;0;0;0;20;2;2;6;7;3;2
6573.0;2021;13;POITIERS;FEMININ;ENSEIGNEMENT A DISTANCE;BAC PROFESSIONNEL;BAC PRO SERV;BAC PRO 33004 ACC.SOINS-S.PERS. OPT.EN STRUCTUR;3;2;1;1;0;0;0;1;0;0;0;0;1;1
6577.0;2021;13;POITIERS;FEMININ;ENSEIGNEMENT A DISTANCE;BAC TECHNOLOGIQUE;BAC STMG;BAC STMG MERCATIQUE (MARKETING);3;3;2;1;0;0;0;2;0;0;0;1;1;1
6580.0;2021;13;POITIERS;FEMININ;FORMATION CONTINUE;BAC PROFESSIONNEL;BAC PRO PROD;BAC PRO 24303 MET. DU CUIR: SELLERIE GARNISSAGE;1;0;0;0;0;0;0;0;0;0;0;0;0;0
6589.0;2021;13;POITIERS;FEMININ;INDIVIDUEL;BAC PROFESSIONNEL;BAC PRO SERV;BAC PRO 32304 PHOTOGRAPHIE;1;0;0;0;0;0;0;0;0;0;0;0;0;0
6593.0;2021;13;POITIERS;FEMININ;INDIVIDUEL;BAC PROFESSIONNEL;BAC PRO SERV;BAC PRO 33603 ESTHETIQUE COSMETIQUE PARFUMERIE;2;1;1;0;0;0;0;1;0;0;0;0;1;0
6595.0;2021;13;POITIERS;FEMININ;INDIVIDUEL;BAC TECHNOLOGIQUE;BAC ST2S;BAC ST2S SCIENCES & TECHNO. SANTE & SOCIAL;12;10;5;2;3;3;0;8;0;0;0;1;7;2
6597.0;2021;13;POITIERS;FEMININ;INDIVIDUEL;BAC TECHNOLOGIQUE;BAC STMG;BAC STMG RESSOURCES HUMAINES ET COMMUNICATION;2;2;1;1;0;0;0;1;0;0;0;1;0;1
6599.0;2021;13;POITIERS;FEMININ;SCOLAIRE;BAC PROFESSIONNEL;BAC PRO PROD;BACPRO 20002 ETUD.DEFINITION PRDTS INDUSTRIEL;1;1;0;0;1;1;0;1;0;0;0;0;1;0
6601.0;2021;13;POITIERS;FEMININ;SCOLAIRE;BAC PROFESSIONNEL;BAC PRO PROD;BAC PRO 22003 BIO-INDUSTRIES DE TRANSFORMATION;8;8;8;0;0;0;0;8;0;0;0;3;5;0
6604.0;2021;13;POITIERS;FEMININ;SCOLAIRE;BAC PROFESSIONNEL;BAC PRO PROD;BAC PRO 22106 CUISINE;39;39;35;1;3;0;3;35;0;1;11;17;6;4
6605.0;2021;13;POITIERS;FEMININ;SCOLAIRE;BAC PROFESSIONNEL;BAC PRO PROD;BAC PRO 22503 PLASTIQUES ET COMPOSITES;1;1;0;1;0;0;0;0;0;0;0;0;0;1
6608.0;2021;13;POITIERS;FEMININ;SCOLAIRE;BAC PROFESSIONNEL;BAC PRO PROD;BACPRO 23103 TECHNICIEN GEOMETRE-TOPOGRAPHE;3;3;2;0;1;1;0;3;0;0;1;0;2;0
6609.0;2021;13;POITIERS;FEMININ;SCOLAIRE;BAC PROFESSIONNEL;BAC PRO PROD;BAC PRO 23304 AMENAGEMENT FINITION BATIMENT;16;16;15;1;0;0;0;15;0;1;8;1;5;1
6610.0;2021;13;POITIERS;FEMININ;SCOLAIRE;BAC PROFESSIONNEL;BAC PRO PROD;BAC PRO 23405 TECHNICIEN MENUISIER AGENCEUR;4;4;4;0;0;0;0;4;0;0;2;2;0;0
6612.0;2021;13;POITIERS;FEMININ;SCOLAIRE;BAC PROFESSIONNEL;BAC PRO PROD;BAC PRO 24302 METIERS DU CUIR : MAROQUINERIE;9;9;9;0;0;0;0;9;0;2;2;4;1;0
6613.0;2021;13;POITIERS;FEMININ;SCOLAIRE;BAC PROFESSIONNEL;BAC PRO PROD;BAC PRO 25007 MAINTENANCE EQUIPEMENTS INDUST.;5;5;5;0;0;0;0;5;0;0;2;2;1;0
6617.0;2021;13;POITIERS;FEMININ;SCOLAIRE;BAC PROFESSIONNEL;BAC PRO PROD;BAC PRO 25216 MAINT.VEHIC.OPTC MOTOCYCLES;2;2;2;0;0;0;0;2;0;0;0;2;0;0
6619.0;2021;13;POITIERS;FEMININ;SCOLAIRE;BAC PROFESSIONNEL;BAC PRO PROD;BAC PRO 25303 AERONAUTIQUE OPTION SYSTEMES;11;11;11;0;0;0;0;11;0;2;6;3;0;0
6623.0;2021;13;POITIERS;FEMININ;SCOLAIRE;BAC PROFESSIONNEL;BAC PRO PROD;BAC PRO 25510 METIERS ELECT. ENVIRON. CONNECTES;2;2;2;0;0;0;0;2;0;0;0;1;1;0
6636.0;2021;13;POITIERS;FEMININ;SCOLAIRE;BAC PROFESSIONNEL;BAC PRO PROD;BAC PRO AG 21406 TEC CONS VTE PROD DES JARDINS;25;25;22;3;0;0;0;22;0;1;5;6;10;3
6639.0;2021;13;POITIERS;FEMININ;SCOLAIRE;BAC PROFESSIONNEL;BAC PRO PROD;BAC PRO AG 22107 TEC CONS VTE ALIMENTATION P.ALIM;19;16;12;4;0;0;0;12;0;0;2;2;8;4
6640.0;2021;13;POITIERS;FEMININ;SCOLAIRE;BAC PROFESSIONNEL;BAC PRO SERV;BAC PRO 30001 GESTION-ADMINISTRATION;262;262;220;29;13;4;9;224;0;5;38;89;92;38
6645.0;2021;13;POITIERS;FEMININ;SCOLAIRE;BAC PROFESSIONNEL;BAC PRO SERV;BAC PRO 31206 VENTE (PROSPECT.NEGO.SUIV.CLIENT;67;67;52;8;7;6;1;58;0;1;13;21;23;9
6650.0;2021;13;POITIERS;FEMININ;SCOLAIRE;BAC PROFESSIONNEL;BAC PRO SERV;BAC PRO 33002 SERVICES DE PROXIMITE  VIE LOCAL;49;49;41;5;3;2;1;43;0;1;10;19;13;6
6651.0;2021;13;POITIERS;FEMININ;SCOLAIRE;BAC PROFESSIONNEL;BAC PRO SERV;BAC PRO 33003 ACC.SOINS-S.PERS. OPT.A DOMICILE;27;26;24;0;2;1;1;25;0;1;3;10;11;1
6653.0;2021;13;POITIERS;FEMININ;SCOLAIRE;BAC PROFESSIONNEL;BAC PRO SERV;BAC PRO 33101 OPTIQUE LUNETTERIE;8;8;7;1;0;0;0;7;0;0;1;3;3;1
6654.0;2021;13;POITIERS;FEMININ;SCOLAIRE;BAC PROFESSIONNEL;BAC PRO SERV;BAC PRO 33403 COMMERC. SERVICES EN RESTAURATION;47;47;44;0;3;1;2;45;0;2;9;18;16;2
6655.0;2021;13;POITIERS;FEMININ;SCOLAIRE;BAC PROFESSIONNEL;BAC PRO SERV;BAC PRO 33603 ESTHETIQUE COSMETIQUE PARFUMERIE;96;95;84;9;2;1;1;85;0;8;14;43;20;10
6657.0;2021;13;POITIERS;FEMININ;SCOLAIRE;BAC PROFESSIONNEL;BAC PRO SERV;BAC PRO 34403 METIERS DE LA SECURITE;12;12;10;1;1;1;0;11;0;0;3;5;3;1
6669.0;2021;13;POITIERS;FEMININ;SCOLAIRE;BAC TECHNOLOGIQUE;BAC STMG;BAC STMG GESTION ET FINANCE;135;135;125;2;8;5;3;130;0;11;33;41;45;5
6676.0;2021;13;POITIERS;MASCULIN;APPRENTISSAGE;BAC PROFESSIONNEL;BAC PRO PROD;BAC PRO 22703 TECHN.INSTALL.SYST.ENERG.CLIMATI;2;2;1;1;0;0;0;1;0;1;0;0;0;1
6680.0;2021;13;POITIERS;MASCULIN;APPRENTISSAGE;BAC PROFESSIONNEL;BAC PRO PROD;BAC PRO 23303 MENUISERIE ALUMINIUM-VERRE;5;5;5;0;0;0;0;5;0;0;2;2;1;0
6683.0;2021;13;POITIERS;MASCULIN;APPRENTISSAGE;BAC PROFESSIONNEL;BAC PRO PROD;BAC PRO 23408 Etude et réalisation d'agencement;2;2;2;0;0;0;0;2;0;0;2;0;0;0
6693.0;2021;13;POITIERS;MASCULIN;APPRENTISSAGE;BAC PROFESSIONNEL;BAC PRO PROD;BAC PRO 25406 OUVRAGES DU BATIMENT METALLERIE;8;8;5;1;2;0;2;5;0;0;3;0;2;3
6695.0;2021;13;POITIERS;MASCULIN;APPRENTISSAGE;BAC PROFESSIONNEL;BAC PRO PROD;BAC PRO 25411 TECH.CHAUDRONNERIE INDUSTRIELLE;46;46;40;2;4;1;3;41;0;2;7;20;12;5
6697.0;2021;13;POITIERS;MASCULIN;APPRENTISSAGE;BAC PROFESSIONNEL;BAC PRO PROD;BAC PRO 25510 METIERS ELECT. ENVIRON. CONNECTES;52;52;48;1;3;2;1;50;0;3;14;14;19;2
6699.0;2021;13;POITIERS;MASCULIN;APPRENTISSAGE;BAC PROFESSIONNEL;BAC PRO PROD;BAC PRO 25515 SYST.NUM.OPT.C RES.INF.SYST.COMM.;9;9;9;0;0;0;0;9;0;1;2;3;3;0
6704.0;2021;13;POITIERS;MASCULIN;APPRENTISSAGE;BAC PROFESSIONNEL;BAC PRO PROD;BAC PRO AG 21405 AMENAGEMENTS PAYSAGERS;60;58;57;1;0;0;0;57;0;1;10;30;16;1
6710.0;2021;13;POITIERS;MASCULIN;APPRENTISSAGE;BAC PROFESSIONNEL;BAC PRO SERV;BAC PRO 32207 REAL.PR.IMPR.PLURI.OPTA.PR.GRAPH.;3;3;2;1;0;0;0;2;0;0;0;1;1;1
6711.0;2021;13;POITIERS;MASCULIN;APPRENTISSAGE;BAC PROFESSIONNEL;BAC PRO SERV;BAC PRO 32208 REAL.PR.IMPR.PLURI.OPTB.PR.IMPR.;5;5;4;0;1;1;0;5;0;0;1;2;2;0
6713.0;2021;13;POITIERS;MASCULIN;APPRENTISSAGE;BAC PROFESSIONNEL;BAC PRO SERV;BAC PRO 33403 COMMERC. SERVICES EN RESTAURATION;6;6;4;1;1;0;1;4;0;0;0;2;2;2
6715.0;2021;13;POITIERS;MASCULIN;ENSEIGNEMENT A DISTANCE;BAC GENERAL;BAC GENERAL;BAC GENE 10019 BAC GENERAL;16;15;13;1;1;0;1;13;0;5;6;1;1;2
6724.0;2021;13;POITIERS;MASCULIN;INDIVIDUEL;BAC GENERAL;BAC GENERAL;BAC GENE 10019 BAC GENERAL;28;17;7;6;4;1;3;8;0;0;2;0;6;9
6727.0;2021;13;POITIERS;MASCULIN;INDIVIDUEL;BAC PROFESSIONNEL;BAC PRO PROD;BAC PRO 25510 METIERS ELECT. ENVIRON. CONNECTES;3;1;1;0;0;0;0;1;0;0;0;0;1;0
6744.0;2021;13;POITIERS;MASCULIN;SCOLAIRE;BAC PROFESSIONNEL;BAC PRO PROD;BAC PRO 22004 PROC. CHIMIE EAU PAPIERS-CARTONS;11;11;9;0;2;2;0;11;0;1;1;3;6;0
6758.0;2021;13;POITIERS;MASCULIN;SCOLAIRE;BAC PROFESSIONNEL;BAC PRO PROD;BAC PRO 23404 TECHNICIEN CONSTRUCTEUR BOIS;5;5;4;1;0;0;0;4;0;0;0;2;2;1
6760.0;2021;13;POITIERS;MASCULIN;SCOLAIRE;BAC PROFESSIONNEL;BAC PRO PROD;BAC PRO 23407 TECHNIC.FAB.BOIS ET MATERX ASSOC;4;4;3;0;1;1;0;4;0;0;0;1;3;0
6761.0;2021;13;POITIERS;MASCULIN;SCOLAIRE;BAC PROFESSIONNEL;BAC PRO PROD;BAC PRO 24203 METIERS DE LA MODE - VÊTEMENT;4;4;4;0;0;0;0;4;0;1;1;2;0;0
6765.0;2021;13;POITIERS;MASCULIN;SCOLAIRE;BAC PROFESSIONNEL;BAC PRO PROD;BAC PRO 25009 MAINTENANCE NAUTIQUE;16;15;9;6;0;0;0;9;0;1;0;1;7;6
6768.0;2021;13;POITIERS;MASCULIN;SCOLAIRE;BAC PROFESSIONNEL;BAC PRO PROD;BAC PRO 25214 MAINT.VEHIC.OPTA VOIT.PARTICUL.;116;115;94;12;9;4;5;98;0;6;27;34;31;17
6770.0;2021;13;POITIERS;MASCULIN;SCOLAIRE;BAC PROFESSIONNEL;BAC PRO PROD;BAC PRO 25216 MAINT.VEHIC.OPTC MOTOCYCLES;13;13;12;0;1;0;1;12;0;1;3;8;0;1
6780.0;2021;13;POITIERS;MASCULIN;SCOLAIRE;BAC PROFESSIONNEL;BAC PRO PROD;BAC PRO 25510 METIERS ELECT. ENVIRON. CONNECTES;199;199;165;25;9;6;3;171;0;7;27;78;59;28
6794.0;2021;13;POITIERS;MASCULIN;SCOLAIRE;BAC PROFESSIONNEL;BAC PRO PROD;BAC PRO AG 21405 AMENAGEMENTS PAYSAGERS;55;54;54;0;0;0;0;54;0;1;13;11;29;0
6801.0;2021;13;POITIERS;MASCULIN;SCOLAIRE;BAC PROFESSIONNEL;BAC PRO SERV;BAC PRO 31107 CONDUCT. TRANSP.ROUT.MARCHANDISES;44;44;41;1;2;2;0;43;0;2;11;19;11;1
6802.0;2021;13;POITIERS;MASCULIN;SCOLAIRE;BAC PROFESSIONNEL;BAC PRO SERV;BAC PRO 31108 TRANSPORT;19;19;17;1;1;0;1;17;0;0;4;6;7;2
6814.0;2021;13;POITIERS;MASCULIN;SCOLAIRE;BAC PROFESSIONNEL;BAC PRO SERV;BAC PRO 34403 METIERS DE LA SECURITE;35;35;35;0;0;0;0;35;0;2;14;12;7;0
6818.0;2021;13;POITIERS;MASCULIN;SCOLAIRE;BAC TECHNOLOGIQUE;BAC STD2A;BAC STD2A SCIENCES & TECHNO. DESIGN-ARTS APPLIQUES;18;18;16;0;2;2;0;18;0;0;5;8;5;0
6819.0;2021;13;POITIERS;MASCULIN;SCOLAIRE;BAC TECHNOLOGIQUE;BAC STHR;BAC STHR SC.&TEC. HOTELLERIE-RESTAURATION;33;33;27;2;4;2;2;29;0;3;6;12;8;4
6820.0;2021;13;POITIERS;MASCULIN;SCOLAIRE;BAC TECHNOLOGIQUE;BAC STI2D;BAC STI2D ARCHITECTURE ET CONSTRUCTION;106;106;102;1;3;0;3;102;0;1;14;51;36;4
6822.0;2021;13;POITIERS;MASCULIN;SCOLAIRE;BAC TECHNOLOGIQUE;BAC STI2D;BAC STI2D INNOVATION TECHNO.  ET ECO CONCEPTION;154;154;147;1;6;4;2;151;0;4;31;60;56;3
6831.0;2021;19;REIMS;FEMININ;APPRENTISSAGE;BAC PROFESSIONNEL;BAC PRO PROD;BAC PRO 22704 TECHN. MAINT. SYST.ENERG.CLIMATI;1;1;1;0;0;0;0;1;0;1;0;0;0;0
6836.0;2021;19;REIMS;FEMININ;APPRENTISSAGE;BAC PROFESSIONNEL;BAC PRO PROD;BAC PRO AG 21004 CGEA;5;4;4;0;0;0;0;4;0;0;0;1;3;0
6840.0;2021;19;REIMS;FEMININ;APPRENTISSAGE;BAC PROFESSIONNEL;BAC PRO SERV;BAC PRO 31106 LOGISTIQUE;2;2;2;0;0;0;0;2;0;1;1;0;0;0
6845.0;2021;19;REIMS;FEMININ;APPRENTISSAGE;BAC PROFESSIONNEL;BAC PRO SERV;BAC PRO 34305 TECHN.D'INTERV.SUR INSTALL. NUCL.;4;4;3;1;0;0;0;3;0;1;2;0;0;1
6856.0;2021;19;REIMS;FEMININ;FORMATION CONTINUE;BAC PROFESSIONNEL;BAC PRO PROD;BAC PRO 23304 AMENAGEMENT FINITION BATIMENT;1;1;1;0;0;0;0;1;0;1;0;0;0;0
6860.0;2021;19;REIMS;FEMININ;FORMATION CONTINUE;BAC PROFESSIONNEL;BAC PRO PROD;BAC PRO 25510 METIERS ELECT. ENVIRON. CONNECTES;1;1;1;0;0;0;0;1;0;1;0;0;0;0
6868.0;2021;19;REIMS;FEMININ;INDIVIDUEL;BAC PROFESSIONNEL;BAC PRO SERV;BAC PRO 30001 GESTION-ADMINISTRATION;4;2;2;0;0;0;0;2;0;0;0;1;1;0
6877.0;2021;19;REIMS;FEMININ;INDIVIDUEL;BAC TECHNOLOGIQUE;BAC STL;BAC STL BIOCHIM.-BIOLOGIE-BIOTECHNOL.;1;1;0;1;0;0;0;0;0;0;0;0;0;1
6881.0;2021;19;REIMS;FEMININ;SCOLAIRE;BAC GENERAL;BAC GENERAL;BAC GENE 10019 BAC GENERAL;3795;3795;3620;33;142;93;49;3713;77;439;1006;1256;935;82
6892.0;2021;19;REIMS;FEMININ;SCOLAIRE;BAC PROFESSIONNEL;BAC PRO PROD;BAC PRO 24202 ARTIS.& MET.ART : TAPIS.D'AMEUBL;7;7;7;0;0;0;0;7;0;0;2;3;2;0
6895.0;2021;19;REIMS;FEMININ;SCOLAIRE;BAC PROFESSIONNEL;BAC PRO PROD;BAC PRO 25106 TECHNICIEN D'USINAGE;2;2;0;2;0;0;0;0;0;0;0;0;0;2
6896.0;2021;19;REIMS;FEMININ;SCOLAIRE;BAC PROFESSIONNEL;BAC PRO PROD;BAC PRO 25214 MAINT.VEHIC.OPTA VOIT.PARTICUL.;7;7;5;1;1;0;1;5;0;0;3;0;2;2
6898.0;2021;19;REIMS;FEMININ;SCOLAIRE;BAC PROFESSIONNEL;BAC PRO PROD;BAC PRO 25219 MAINT.MATERIELS OPT.A AGRICOLES;1;1;1;0;0;0;0;1;0;1;0;0;0;0
6899.0;2021;19;REIMS;FEMININ;SCOLAIRE;BAC PROFESSIONNEL;BAC PRO PROD;BAC PRO 25220 MAINT.MATERIELS OPT.B TP MANUT.;1;1;1;0;0;0;0;1;0;0;0;1;0;0
6905.0;2021;19;REIMS;FEMININ;SCOLAIRE;BAC PROFESSIONNEL;BAC PRO PROD;BAC PRO 25515 SYST.NUM.OPT.C RES.INF.SYST.COMM.;1;1;1;0;0;0;0;1;0;0;0;0;1;0
6907.0;2021;19;REIMS;FEMININ;SCOLAIRE;BAC PROFESSIONNEL;BAC PRO PROD;BAC PRO AG 21113 CGEVV;5;5;5;0;0;0;0;5;0;0;0;1;4;0
6909.0;2021;19;REIMS;FEMININ;SCOLAIRE;BAC PROFESSIONNEL;BAC PRO PROD;BAC PRO AG 21203 TECHN CONSEIL DE VENTE ANIMAL;7;7;7;0;0;0;0;7;0;0;2;3;2;0
6914.0;2021;19;REIMS;FEMININ;SCOLAIRE;BAC PROFESSIONNEL;BAC PRO PROD;BAC PRO AG 22105 LABORATOIRE CONTROLE QUALITE;5;5;4;1;0;0;0;4;0;1;1;0;2;1
6922.0;2021;19;REIMS;FEMININ;SCOLAIRE;BAC PROFESSIONNEL;BAC PRO SERV;BAC PRO 31206 VENTE (PROSPECT.NEGO.SUIV.CLIENT;69;69;41;19;9;8;1;49;0;2;4;12;31;20
6923.0;2021;19;REIMS;FEMININ;SCOLAIRE;BAC PROFESSIONNEL;BAC PRO SERV;BAC PRO 31210 ACCUEIL -RELATION CLIENTS USAGERS;73;73;50;13;10;8;2;58;0;0;13;24;21;15
6933.0;2021;19;REIMS;FEMININ;SCOLAIRE;BAC PROFESSIONNEL;BAC PRO SERV;BAC PRO 33603 ESTHETIQUE COSMETIQUE PARFUMERIE;60;59;57;2;0;0;0;57;0;3;11;26;17;2
6937.0;2021;19;REIMS;FEMININ;SCOLAIRE;BAC PROFESSIONNEL;BAC PRO SERV;BAC PRO AG 33002 SERV PERS TERRIT;104;103;100;3;0;0;0;100;0;3;16;44;37;3
6941.0;2021;19;REIMS;FEMININ;SCOLAIRE;BAC TECHNOLOGIQUE;BAC STAV;BAC STAV AGRONOMIE ALIM ENV TERRITOI;73;73;72;1;0;0;0;72;0;3;15;26;28;1
6943.0;2021;19;REIMS;FEMININ;SCOLAIRE;BAC TECHNOLOGIQUE;BAC STHR;BAC STHR SC.&TEC. HOTELLERIE-RESTAURATION;13;13;13;0;0;0;0;13;0;2;2;4;5;0
6947.0;2021;19;REIMS;FEMININ;SCOLAIRE;BAC TECHNOLOGIQUE;BAC STI2D;BAC STI2D SYSTÈME D'INFORMATION  ET NUMERIQUE;6;6;4;0;2;2;0;6;0;0;0;0;6;0
6948.0;2021;19;REIMS;FEMININ;SCOLAIRE;BAC TECHNOLOGIQUE;BAC STL;BAC STL BIOCHIM.-BIOLOGIE-BIOTECHNOL.;48;48;45;0;3;0;3;45;1;7;8;15;14;3
6953.0;2021;19;REIMS;FEMININ;SCOLAIRE;BAC TECHNOLOGIQUE;BAC STMG;BAC STMG SYSTEMES D'INFORMATION DE GESTION;4;4;4;0;0;0;0;4;0;0;1;0;3;0
6954.0;2021;19;REIMS;MASCULIN;APPRENTISSAGE;BAC PROFESSIONNEL;BAC PRO PROD;BAC PRO 20102 PILOTE DE LIGNE DE PRODUCTION;6;6;6;0;0;0;0;6;0;2;1;0;3;0
6955.0;2021;19;REIMS;MASCULIN;APPRENTISSAGE;BAC PROFESSIONNEL;BAC PRO PROD;BAC PRO 22104 BOUCHER CHARCUTIER TRAITEUR;1;1;0;1;0;0;0;0;0;0;0;0;0;1
6957.0;2021;19;REIMS;MASCULIN;APPRENTISSAGE;BAC PROFESSIONNEL;BAC PRO PROD;BAC PRO 22303 FONDERIE;1;1;1;0;0;0;0;1;0;0;0;0;1;0
6959.0;2021;19;REIMS;MASCULIN;APPRENTISSAGE;BAC PROFESSIONNEL;BAC PRO PROD;BAC PRO 22704 TECHN. MAINT. SYST.ENERG.CLIMATI;17;17;14;1;2;2;0;16;0;0;8;5;3;1
6960.0;2021;19;REIMS;MASCULIN;APPRENTISSAGE;BAC PROFESSIONNEL;BAC PRO PROD;BAC PRO 23102 TRAVAUX PUBLICS;12;12;12;0;0;0;0;12;0;2;4;5;1;0
6963.0;2021;19;REIMS;MASCULIN;APPRENTISSAGE;BAC PROFESSIONNEL;BAC PRO PROD;BAC PRO 23404 TECHNICIEN CONSTRUCTEUR BOIS;1;1;1;0;0;0;0;1;0;0;0;0;1;0
6964.0;2021;19;REIMS;MASCULIN;APPRENTISSAGE;BAC PROFESSIONNEL;BAC PRO PROD;BAC PRO 23405 TECHNICIEN MENUISIER AGENCEUR;5;5;3;2;0;0;0;3;0;1;0;1;1;2
6965.0;2021;19;REIMS;MASCULIN;APPRENTISSAGE;BAC PROFESSIONNEL;BAC PRO PROD;BAC PRO 25007 MAINTENANCE EQUIPEMENTS INDUST.;35;34;29;0;5;5;0;34;0;3;8;7;16;0
6973.0;2021;19;REIMS;MASCULIN;APPRENTISSAGE;BAC PROFESSIONNEL;BAC PRO PROD;BAC PRO 25221 MAINT.MATERIELS OPT.C ESP. VERTS;2;2;2;0;0;0;0;2;0;0;0;0;2;0
6975.0;2021;19;REIMS;MASCULIN;APPRENTISSAGE;BAC PROFESSIONNEL;BAC PRO PROD;BAC PRO 25411 TECH.CHAUDRONNERIE INDUSTRIELLE;25;22;17;5;0;0;0;17;0;2;2;5;8;5
6977.0;2021;19;REIMS;MASCULIN;APPRENTISSAGE;BAC PROFESSIONNEL;BAC PRO PROD;BAC PRO 25514 SYST.NUM.OPT.B AUD.RES.EQUIP.DOM.;1;1;1;0;0;0;0;1;0;0;1;0;0;0
6983.0;2021;19;REIMS;MASCULIN;APPRENTISSAGE;BAC PROFESSIONNEL;BAC PRO SERV;BAC PRO 31106 LOGISTIQUE;6;6;4;0;2;0;2;4;0;0;1;2;1;2
6989.0;2021;19;REIMS;MASCULIN;ENSEIGNEMENT A DISTANCE;BAC PROFESSIONNEL;BAC PRO SERV;BAC PRO 31206 VENTE (PROSPECT.NEGO.SUIV.CLIENT;1;1;1;0;0;0;0;1;0;0;0;1;0;0
6995.0;2021;19;REIMS;MASCULIN;FORMATION CONTINUE;BAC PROFESSIONNEL;BAC PRO PROD;BAC PRO 23405 TECHNICIEN MENUISIER AGENCEUR;2;2;2;0;0;0;0;2;0;0;1;0;1;0
6998.0;2021;19;REIMS;MASCULIN;FORMATION CONTINUE;BAC PROFESSIONNEL;BAC PRO SERV;BAC PRO 31206 VENTE (PROSPECT.NEGO.SUIV.CLIENT;2;2;2;0;0;0;0;2;0;0;2;0;0;0
6999.0;2021;19;REIMS;MASCULIN;FORMATION CONTINUE;BAC PROFESSIONNEL;BAC PRO SERV;BAC PRO 33103 TECHNICIEN APPAREIL. ORTHOPEDIQUE;1;1;1;0;0;0;0;1;0;0;1;0;0;0
7003.0;2021;19;REIMS;MASCULIN;INDIVIDUEL;BAC PROFESSIONNEL;BAC PRO PROD;BAC PRO 25007 MAINTENANCE EQUIPEMENTS INDUST.;1;0;0;0;0;0;0;0;0;0;0;0;0;0
7011.0;2021;19;REIMS;MASCULIN;INDIVIDUEL;BAC TECHNOLOGIQUE;BAC STI2D;BAC STI2D INNOVATION TECHNO.  ET ECO CONCEPTION;2;2;0;2;0;0;0;0;0;0;0;0;0;2
7013.0;2021;19;REIMS;MASCULIN;INDIVIDUEL;BAC TECHNOLOGIQUE;BAC STMG;BAC STMG MERCATIQUE (MARKETING);13;13;10;1;2;2;0;12;0;0;1;5;6;1
7019.0;2021;19;REIMS;MASCULIN;SCOLAIRE;BAC PROFESSIONNEL;BAC PRO PROD;BAC PRO 22105 BOULANGER-PÂTISSIER;12;12;11;0;1;1;0;12;0;1;5;3;3;0
7034.0;2021;19;REIMS;MASCULIN;SCOLAIRE;BAC PROFESSIONNEL;BAC PRO PROD;BAC PRO 23405 TECHNICIEN MENUISIER AGENCEUR;37;37;31;1;5;3;2;34;0;0;7;12;15;3
7041.0;2021;19;REIMS;MASCULIN;SCOLAIRE;BAC PROFESSIONNEL;BAC PRO PROD;BAC PRO 25216 MAINT.VEHIC.OPTC MOTOCYCLES;6;6;3;1;2;2;0;5;0;0;1;0;4;1
7042.0;2021;19;REIMS;MASCULIN;SCOLAIRE;BAC PROFESSIONNEL;BAC PRO PROD;BAC PRO 25219 MAINT.MATERIELS OPT.A AGRICOLES;20;20;16;4;0;0;0;16;0;2;2;7;5;4
7049.0;2021;19;REIMS;MASCULIN;SCOLAIRE;BAC PROFESSIONNEL;BAC PRO PROD;BAC PRO 25513 SYST.NUM.OPT.A SURETE SECURITE;25;25;22;3;0;0;0;22;0;1;3;5;13;3
7052.0;2021;19;REIMS;MASCULIN;SCOLAIRE;BAC PROFESSIONNEL;BAC PRO PROD;BAC PRO AG 21001 AGRO-EQUIPEMENT;27;27;22;5;0;0;0;22;0;2;4;6;10;5
7056.0;2021;19;REIMS;MASCULIN;SCOLAIRE;BAC PROFESSIONNEL;BAC PRO PROD;BAC PRO AG 21203 TECHN CONSEIL DE VENTE ANIMAL;8;8;8;0;0;0;0;8;0;0;1;5;2;0
7058.0;2021;19;REIMS;MASCULIN;SCOLAIRE;BAC PROFESSIONNEL;BAC PRO PROD;BAC PRO AG 21302 GEST MILIEUX NATURELS FAUNE;50;50;43;7;0;0;0;43;0;0;2;21;20;7
7065.0;2021;19;REIMS;MASCULIN;SCOLAIRE;BAC PROFESSIONNEL;BAC PRO SERV;BAC PRO 31106 LOGISTIQUE;49;49;30;13;6;3;3;33;0;2;5;13;13;16
7066.0;2021;19;REIMS;MASCULIN;SCOLAIRE;BAC PROFESSIONNEL;BAC PRO SERV;BAC PRO 31107 CONDUCT. TRANSP.ROUT.MARCHANDISES;59;59;47;12;0;0;0;47;0;4;9;25;9;12
7071.0;2021;19;REIMS;MASCULIN;SCOLAIRE;BAC PROFESSIONNEL;BAC PRO SERV;BAC PRO 32207 REAL.PR.IMPR.PLURI.OPTA.PR.GRAPH.;17;17;13;3;1;1;0;14;0;0;3;5;6;3
7072.0;2021;19;REIMS;MASCULIN;SCOLAIRE;BAC PROFESSIONNEL;BAC PRO SERV;BAC PRO 32208 REAL.PR.IMPR.PLURI.OPTB.PR.IMPR.;9;8;6;2;0;0;0;6;0;0;0;3;3;2
7075.0;2021;19;REIMS;MASCULIN;SCOLAIRE;BAC PROFESSIONNEL;BAC PRO SERV;BAC PRO 33003 ACC.SOINS-S.PERS. OPT.A DOMICILE;7;7;6;0;1;1;0;7;0;0;0;3;4;0
7079.0;2021;19;REIMS;MASCULIN;SCOLAIRE;BAC PROFESSIONNEL;BAC PRO SERV;BAC PRO 33403 COMMERC. SERVICES EN RESTAURATION;42;42;31;8;3;2;1;33;0;2;8;13;10;9
7098.0;2021;19;REIMS;MASCULIN;SCOLAIRE;BAC TECHNOLOGIQUE;BAC STMG;BAC STMG SYSTEMES D'INFORMATION DE GESTION;25;25;19;1;5;4;1;23;0;0;0;6;17;2
7100.0;2021;14;RENNES;FEMININ;APPRENTISSAGE;BAC PROFESSIONNEL;BAC PRO PROD;BAC PRO 22105 BOULANGER-PÂTISSIER;2;2;2;0;0;0;0;2;0;1;0;1;0;0
7103.0;2021;14;RENNES;FEMININ;APPRENTISSAGE;BAC PROFESSIONNEL;BAC PRO PROD;BAC PRO 25106 TECHNICIEN D'USINAGE;1;1;1;0;0;0;0;1;0;0;1;0;0;0
7104.0;2021;14;RENNES;FEMININ;APPRENTISSAGE;BAC PROFESSIONNEL;BAC PRO PROD;BAC PRO 25214 MAINT.VEHIC.OPTA VOIT.PARTICUL.;13;13;10;3;0;0;0;10;0;2;2;4;2;3
7105.0;2021;14;RENNES;FEMININ;APPRENTISSAGE;BAC PROFESSIONNEL;BAC PRO PROD;BAC PRO 25219 MAINT.MATERIELS OPT.A AGRICOLES;2;2;2;0;0;0;0;2;0;0;0;2;0;0
7108.0;2021;14;RENNES;FEMININ;APPRENTISSAGE;BAC PROFESSIONNEL;BAC PRO PROD;BAC PRO 25510 METIERS ELECT. ENVIRON. CONNECTES;1;1;1;0;0;0;0;1;0;0;1;0;0;0
7111.0;2021;14;RENNES;FEMININ;APPRENTISSAGE;BAC PROFESSIONNEL;BAC PRO PROD;BAC PRO AG 21114 CONDUITE PRODUCTIONS HORTICOLES;5;5;4;1;0;0;0;4;0;0;0;1;3;1
7114.0;2021;14;RENNES;FEMININ;APPRENTISSAGE;BAC PROFESSIONNEL;BAC PRO PROD;BAC PRO AG 21405 AMENAGEMENTS PAYSAGERS;3;3;3;0;0;0;0;3;0;0;0;2;1;0
7115.0;2021;14;RENNES;FEMININ;APPRENTISSAGE;BAC PROFESSIONNEL;BAC PRO PROD;BAC PRO AG 22107 TEC CONS VTE ALIMENTATION P.ALIM;4;4;4;0;0;0;0;4;0;0;1;2;1;0
7118.0;2021;14;RENNES;FEMININ;APPRENTISSAGE;BAC PROFESSIONNEL;BAC PRO SERV;BAC PRO 31107 CONDUCT. TRANSP.ROUT.MARCHANDISES;2;2;2;0;0;0;0;2;0;0;1;1;0;0
7125.0;2021;14;RENNES;FEMININ;ENSEIGNEMENT A DISTANCE;BAC GENERAL;BAC GENERAL;BAC GENE 10019 BAC GENERAL;58;51;49;1;1;1;0;50;1;9;16;13;11;1
7134.0;2021;14;RENNES;FEMININ;ENSEIGNEMENT A DISTANCE;BAC TECHNOLOGIQUE;BAC STMG;BAC STMG RESSOURCES HUMAINES ET COMMUNICATION;6;6;5;0;1;1;0;6;0;1;2;1;2;0
7135.0;2021;14;RENNES;FEMININ;FORMATION CONTINUE;BAC PROFESSIONNEL;BAC PRO PROD;BAC PRO 23004 TECHN. ETUDES BAT.A ETUDES & ECO.;2;2;2;0;0;0;0;2;0;1;1;0;0;0
7140.0;2021;14;RENNES;FEMININ;FORMATION CONTINUE;BAC PROFESSIONNEL;BAC PRO SERV;BAC PRO 31202 COMMERCE;13;13;11;1;1;0;1;11;0;0;2;4;5;2
7149.0;2021;14;RENNES;FEMININ;INDIVIDUEL;BAC PROFESSIONNEL;BAC PRO PROD;BAC PRO AG 21406 TEC CONS VTE PROD DES JARDINS;1;0;0;0;0;0;0;0;0;0;0;0;0;0
7152.0;2021;14;RENNES;FEMININ;INDIVIDUEL;BAC PROFESSIONNEL;BAC PRO SERV;BAC PRO 31202 COMMERCE;2;1;0;0;1;1;0;1;0;0;0;0;1;0
7160.0;2021;14;RENNES;FEMININ;INDIVIDUEL;BAC TECHNOLOGIQUE;BAC STAV;BAC STAV AGRONOMIE ALIM ENV TERRITOI;2;0;0;0;0;0;0;0;0;0;0;0;0;0
7165.0;2021;14;RENNES;FEMININ;INDIVIDUEL;BAC TECHNOLOGIQUE;BAC STMG;BAC STMG RESSOURCES HUMAINES ET COMMUNICATION;8;4;0;2;2;1;1;1;0;0;0;0;1;3
7170.0;2021;14;RENNES;FEMININ;SCOLAIRE;BAC PROFESSIONNEL;BAC PRO PROD;BAC PRO 22503 PLASTIQUES ET COMPOSITES;2;2;2;0;0;0;0;2;0;0;0;0;2;0
7172.0;2021;14;RENNES;FEMININ;SCOLAIRE;BAC PROFESSIONNEL;BAC PRO PROD;BAC PRO 23004 TECHN. ETUDES BAT.A ETUDES & ECO.;12;12;11;0;1;0;1;11;0;0;4;5;2;1
7183.0;2021;14;RENNES;FEMININ;SCOLAIRE;BAC PROFESSIONNEL;BAC PRO PROD;BAC PRO 24302 METIERS DU CUIR : MAROQUINERIE;9;9;7;2;0;0;0;7;0;1;3;2;1;2
7184.0;2021;14;RENNES;FEMININ;SCOLAIRE;BAC PROFESSIONNEL;BAC PRO PROD;BAC PRO 25007 MAINTENANCE EQUIPEMENTS INDUST.;9;9;7;1;1;0;1;7;0;1;1;3;2;2
7189.0;2021;14;RENNES;FEMININ;SCOLAIRE;BAC PROFESSIONNEL;BAC PRO PROD;BAC PRO 25216 MAINT.VEHIC.OPTC MOTOCYCLES;3;3;3;0;0;0;0;3;0;0;0;2;1;0
7190.0;2021;14;RENNES;FEMININ;SCOLAIRE;BAC PROFESSIONNEL;BAC PRO PROD;BAC PRO 25219 MAINT.MATERIELS OPT.A AGRICOLES;1;1;1;0;0;0;0;1;0;0;0;1;0;0
7191.0;2021;14;RENNES;FEMININ;SCOLAIRE;BAC PROFESSIONNEL;BAC PRO PROD;BAC PRO 25221 MAINT.MATERIELS OPT.C ESP. VERTS;1;1;0;1;0;0;0;0;0;0;0;0;0;1
7200.0;2021;14;RENNES;FEMININ;SCOLAIRE;BAC PROFESSIONNEL;BAC PRO PROD;BAC PRO AG 21001 AGRO-EQUIPEMENT;2;2;2;0;0;0;0;2;0;0;0;1;1;0
7203.0;2021;14;RENNES;FEMININ;SCOLAIRE;BAC PROFESSIONNEL;BAC PRO PROD;BAC PRO AG 21203 TECHN CONSEIL DE VENTE ANIMAL;51;51;46;5;0;0;0;46;0;0;5;18;23;5
7206.0;2021;14;RENNES;FEMININ;SCOLAIRE;BAC PROFESSIONNEL;BAC PRO PROD;BAC PRO AG 21211 COND GEST ENTR HIPPIQUE;44;43;38;5;0;0;0;38;0;0;6;13;19;5
7212.0;2021;14;RENNES;FEMININ;SCOLAIRE;BAC PROFESSIONNEL;BAC PRO SERV;BAC PRO 30001 GESTION-ADMINISTRATION;432;432;370;37;25;14;11;384;0;13;92;171;108;48
7215.0;2021;14;RENNES;FEMININ;SCOLAIRE;BAC PROFESSIONNEL;BAC PRO SERV;BAC PRO 31108 TRANSPORT;3;3;2;1;0;0;0;2;0;0;0;0;2;1
7218.0;2021;14;RENNES;FEMININ;SCOLAIRE;BAC PROFESSIONNEL;BAC PRO SERV;BAC PRO 31210 ACCUEIL -RELATION CLIENTS USAGERS;208;208;194;6;8;5;3;199;0;8;33;97;61;9
7219.0;2021;14;RENNES;FEMININ;SCOLAIRE;BAC PROFESSIONNEL;BAC PRO SERV;BAC PRO 32207 REAL.PR.IMPR.PLURI.OPTA.PR.GRAPH.;12;12;11;1;0;0;0;11;0;0;6;5;0;1
7221.0;2021;14;RENNES;FEMININ;SCOLAIRE;BAC PROFESSIONNEL;BAC PRO SERV;BAC PRO 32303 ART.& MET.ART:COM.VIS.VIS.PLURI-M;13;13;13;0;0;0;0;13;0;6;3;4;0;0
7226.0;2021;14;RENNES;FEMININ;SCOLAIRE;BAC PROFESSIONNEL;BAC PRO SERV;BAC PRO 33403 COMMERC. SERVICES EN RESTAURATION;84;84;80;3;1;1;0;81;0;4;27;24;26;3
7230.0;2021;14;RENNES;FEMININ;SCOLAIRE;BAC PROFESSIONNEL;BAC PRO SERV;BAC PRO AG 33002 SERV PERS TERRIT;814;801;774;27;0;0;0;774;0;17;130;329;298;27
7241.0;2021;14;RENNES;FEMININ;SCOLAIRE;BAC TECHNOLOGIQUE;BAC STL;BAC STL BIOCHIM.-BIOLOGIE-BIOTECHNOL.;98;98;92;1;5;4;1;96;0;5;26;32;33;2
7243.0;2021;14;RENNES;FEMININ;SCOLAIRE;BAC TECHNOLOGIQUE;BAC STMG;BAC STMG GESTION ET FINANCE;377;376;365;2;9;1;8;366;0;16;89;183;78;10
7249.0;2021;14;RENNES;MASCULIN;APPRENTISSAGE;BAC PROFESSIONNEL;BAC PRO PROD;BAC PRO 22106 CUISINE;40;40;35;2;3;2;1;37;0;0;3;17;17;3
7270.0;2021;14;RENNES;MASCULIN;APPRENTISSAGE;BAC PROFESSIONNEL;BAC PRO PROD;BAC PRO 25410 CONSTRUCTION DES CARROSSERIES;5;5;4;0;1;0;1;4;0;0;1;2;1;1
7271.0;2021;14;RENNES;MASCULIN;APPRENTISSAGE;BAC PROFESSIONNEL;BAC PRO PROD;BAC PRO 25411 TECH.CHAUDRONNERIE INDUSTRIELLE;91;91;79;4;8;2;6;81;0;20;22;25;14;10
7288.0;2021;14;RENNES;MASCULIN;APPRENTISSAGE;BAC PROFESSIONNEL;BAC PRO SERV;BAC PRO 33403 COMMERC. SERVICES EN RESTAURATION;16;16;12;3;1;1;0;13;0;2;3;4;4;3
7292.0;2021;14;RENNES;MASCULIN;ENSEIGNEMENT A DISTANCE;BAC PROFESSIONNEL;BAC PRO SERV;BAC PRO 31206 VENTE (PROSPECT.NEGO.SUIV.CLIENT;2;1;1;0;0;0;0;1;0;0;0;0;1;0
7298.0;2021;14;RENNES;MASCULIN;ENSEIGNEMENT A DISTANCE;BAC TECHNOLOGIQUE;BAC STMG;BAC STMG SYSTEMES D'INFORMATION DE GESTION;1;1;1;0;0;0;0;1;0;0;1;0;0;0
7300.0;2021;14;RENNES;MASCULIN;FORMATION CONTINUE;BAC PROFESSIONNEL;BAC PRO PROD;BAC PRO 23004 TECHN. ETUDES BAT.A ETUDES & ECO.;1;1;1;0;0;0;0;1;0;0;1;0;0;0
7303.0;2021;14;RENNES;MASCULIN;FORMATION CONTINUE;BAC PROFESSIONNEL;BAC PRO PROD;BAC PRO 25406 OUVRAGES DU BATIMENT METALLERIE;2;2;2;0;0;0;0;2;0;0;0;1;1;0
7304.0;2021;14;RENNES;MASCULIN;FORMATION CONTINUE;BAC PROFESSIONNEL;BAC PRO PROD;BAC PRO 25510 METIERS ELECT. ENVIRON. CONNECTES;10;10;10;0;0;0;0;10;0;1;2;3;4;0
7305.0;2021;14;RENNES;MASCULIN;FORMATION CONTINUE;BAC PROFESSIONNEL;BAC PRO PROD;BAC PRO 25515 SYST.NUM.OPT.C RES.INF.SYST.COMM.;1;1;0;1;0;0;0;0;0;0;0;0;0;1
7307.0;2021;14;RENNES;MASCULIN;FORMATION CONTINUE;BAC PROFESSIONNEL;BAC PRO SERV;BAC PRO 34304 HYGIENE PROPRETE STERILISATION;1;1;1;0;0;0;0;1;0;0;0;1;0;0
7315.0;2021;14;RENNES;MASCULIN;INDIVIDUEL;BAC PROFESSIONNEL;BAC PRO PROD;BAC PRO 25214 MAINT.VEHIC.OPTA VOIT.PARTICUL.;3;2;0;2;0;0;0;0;0;0;0;0;0;2
7316.0;2021;14;RENNES;MASCULIN;INDIVIDUEL;BAC PROFESSIONNEL;BAC PRO PROD;BAC PRO 25510 METIERS ELECT. ENVIRON. CONNECTES;2;0;0;0;0;0;0;0;0;0;0;0;0;0
7321.0;2021;14;RENNES;MASCULIN;INDIVIDUEL;BAC PROFESSIONNEL;BAC PRO PROD;BAC PRO AG 21114 CONDUITE PRODUCTIONS HORTICOLES;13;12;11;1;0;0;0;11;0;0;1;0;10;1
7323.0;2021;14;RENNES;MASCULIN;INDIVIDUEL;BAC PROFESSIONNEL;BAC PRO PROD;BAC PRO AG 21405 AMENAGEMENTS PAYSAGERS;1;0;0;0;0;0;0;0;0;0;0;0;0;0
7336.0;2021;14;RENNES;MASCULIN;INDIVIDUEL;BAC TECHNOLOGIQUE;BAC STMG;BAC STMG MERCATIQUE (MARKETING);20;16;13;2;1;0;1;13;0;0;0;4;9;3
7342.0;2021;14;RENNES;MASCULIN;SCOLAIRE;BAC PROFESSIONNEL;BAC PRO PROD;BAC PRO 22106 CUISINE;179;179;172;2;5;2;3;174;0;11;44;79;40;5
7346.0;2021;14;RENNES;MASCULIN;SCOLAIRE;BAC PROFESSIONNEL;BAC PRO PROD;BAC PRO 22704 TECHN. MAINT. SYST.ENERG.CLIMATI;13;13;9;3;1;0;1;9;0;0;1;5;3;4
7361.0;2021;14;RENNES;MASCULIN;SCOLAIRE;BAC PROFESSIONNEL;BAC PRO PROD;BAC PRO 24302 METIERS DU CUIR : MAROQUINERIE;1;1;1;0;0;0;0;1;0;0;1;0;0;0
7366.0;2021;14;RENNES;MASCULIN;SCOLAIRE;BAC PROFESSIONNEL;BAC PRO PROD;BAC PRO 25107 TECHNICIEN OUTILLEUR;3;3;2;1;0;0;0;2;0;0;0;1;1;1
7371.0;2021;14;RENNES;MASCULIN;SCOLAIRE;BAC PROFESSIONNEL;BAC PRO PROD;BAC PRO 25220 MAINT.MATERIELS OPT.B TP MANUT.;20;20;17;1;2;2;0;19;0;1;2;7;9;1
7372.0;2021;14;RENNES;MASCULIN;SCOLAIRE;BAC PROFESSIONNEL;BAC PRO PROD;BAC PRO 25221 MAINT.MATERIELS OPT.C ESP. VERTS;11;11;10;1;0;0;0;10;0;0;1;5;4;1
7376.0;2021;14;RENNES;MASCULIN;SCOLAIRE;BAC PROFESSIONNEL;BAC PRO PROD;BAC PRO 25406 OUVRAGES DU BATIMENT METALLERIE;10;10;9;0;1;0;1;9;0;0;2;6;1;1
7377.0;2021;14;RENNES;MASCULIN;SCOLAIRE;BAC PROFESSIONNEL;BAC PRO PROD;BAC PRO 25408 REPARATION DES CARROSSERIES;24;24;20;1;3;1;2;21;0;2;4;6;9;3
7381.0;2021;14;RENNES;MASCULIN;SCOLAIRE;BAC PROFESSIONNEL;BAC PRO PROD;BAC PRO 25513 SYST.NUM.OPT.A SURETE SECURITE;70;70;59;7;4;3;1;62;0;2;12;28;20;8
7386.0;2021;14;RENNES;MASCULIN;SCOLAIRE;BAC PROFESSIONNEL;BAC PRO PROD;BAC PRO AG 21114 CONDUITE PRODUCTIONS HORTICOLES;20;20;18;2;0;0;0;18;0;0;4;4;10;2
7397.0;2021;14;RENNES;MASCULIN;SCOLAIRE;BAC PROFESSIONNEL;BAC PRO SERV;BAC PRO 30001 GESTION-ADMINISTRATION;192;192;153;36;3;3;0;156;0;2;25;67;62;36
7401.0;2021;14;RENNES;MASCULIN;SCOLAIRE;BAC PROFESSIONNEL;BAC PRO SERV;BAC PRO 31202 COMMERCE;548;545;491;21;33;20;13;511;0;26;119;209;157;34
7405.0;2021;14;RENNES;MASCULIN;SCOLAIRE;BAC PROFESSIONNEL;BAC PRO SERV;BAC PRO 32208 REAL.PR.IMPR.PLURI.OPTB.PR.IMPR.;14;14;12;1;1;0;1;12;0;0;3;6;3;2
7406.0;2021;14;RENNES;MASCULIN;SCOLAIRE;BAC PROFESSIONNEL;BAC PRO SERV;BAC PRO 32303 ART.& MET.ART:COM.VIS.VIS.PLURI-M;12;12;12;0;0;0;0;12;0;5;5;2;0;0
7412.0;2021;14;RENNES;MASCULIN;SCOLAIRE;BAC PROFESSIONNEL;BAC PRO SERV;BAC PRO 34403 METIERS DE LA SECURITE;35;35;34;1;0;0;0;34;0;2;3;24;5;1
7413.0;2021;14;RENNES;MASCULIN;SCOLAIRE;BAC PROFESSIONNEL;BAC PRO SERV;BAC PRO AG 33002 SERV PERS TERRIT;118;114;110;4;0;0;0;110;0;0;11;47;52;4
7419.0;2021;14;RENNES;MASCULIN;SCOLAIRE;BAC TECHNOLOGIQUE;BAC STHR;BAC STHR SC.&TEC. HOTELLERIE-RESTAURATION;26;26;26;0;0;0;0;26;0;2;3;11;10;0
7433.0;2021;15;STRASBOURG;FEMININ;APPRENTISSAGE;BAC PROFESSIONNEL;BAC PRO PROD;BAC PRO 23407 TECHNIC.FAB.BOIS ET MATERX ASSOC;1;1;1;0;0;0;0;1;0;0;1;0;0;0
7435.0;2021;15;STRASBOURG;FEMININ;APPRENTISSAGE;BAC PROFESSIONNEL;BAC PRO PROD;BAC PRO 25106 TECHNICIEN D'USINAGE;2;2;2;0;0;0;0;2;0;2;0;0;0;0
7438.0;2021;15;STRASBOURG;FEMININ;APPRENTISSAGE;BAC PROFESSIONNEL;BAC PRO PROD;BAC PRO 25408 REPARATION DES CARROSSERIES;2;2;1;1;0;0;0;1;0;0;1;0;0;1
7448.0;2021;15;STRASBOURG;FEMININ;APPRENTISSAGE;BAC PROFESSIONNEL;BAC PRO SERV;BAC PRO 31202 COMMERCE;85;84;67;4;13;8;5;75;0;4;16;22;33;9
7455.0;2021;15;STRASBOURG;FEMININ;ENSEIGNEMENT A DISTANCE;BAC PROFESSIONNEL;BAC PRO SERV;BAC PRO 31210 ACCUEIL -RELATION CLIENTS USAGERS;1;0;0;0;0;0;0;0;0;0;0;0;0;0
7472.0;2021;15;STRASBOURG;FEMININ;INDIVIDUEL;BAC PROFESSIONNEL;BAC PRO SERV;BAC PRO 31210 ACCUEIL -RELATION CLIENTS USAGERS;5;2;1;1;0;0;0;1;0;0;0;0;1;1
7474.0;2021;15;STRASBOURG;FEMININ;INDIVIDUEL;BAC PROFESSIONNEL;BAC PRO SERV;BAC PRO 33603 ESTHETIQUE COSMETIQUE PARFUMERIE;1;0;0;0;0;0;0;0;0;0;0;0;0;0
7476.0;2021;15;STRASBOURG;FEMININ;INDIVIDUEL;BAC TECHNOLOGIQUE;BAC STD2A;BAC STD2A SCIENCES & TECHNO. DESIGN-ARTS APPLIQUES;1;0;0;0;0;0;0;0;0;0;0;0;0;0
7484.0;2021;15;STRASBOURG;FEMININ;SCOLAIRE;BAC PROFESSIONNEL;BAC PRO PROD;BAC PRO 22003 BIO-INDUSTRIES DE TRANSFORMATION;22;22;15;3;4;1;3;16;0;0;1;3;12;6
7494.0;2021;15;STRASBOURG;FEMININ;SCOLAIRE;BAC PROFESSIONNEL;BAC PRO PROD;BAC PRO 24203 METIERS DE LA MODE - VÊTEMENT;48;48;41;6;1;1;0;42;0;9;12;13;8;6
7502.0;2021;15;STRASBOURG;FEMININ;SCOLAIRE;BAC PROFESSIONNEL;BAC PRO PROD;BAC PRO 25411 TECH.CHAUDRONNERIE INDUSTRIELLE;3;3;3;0;0;0;0;3;0;1;1;1;0;0
7507.0;2021;15;STRASBOURG;FEMININ;SCOLAIRE;BAC PROFESSIONNEL;BAC PRO PROD;BAC PRO AG 21113 CGEVV;1;1;1;0;0;0;0;1;0;0;0;1;0;0
7512.0;2021;15;STRASBOURG;FEMININ;SCOLAIRE;BAC PROFESSIONNEL;BAC PRO PROD;BAC PRO AG 22107 TEC CONS VTE ALIMENTATION P.ALIM;4;3;3;0;0;0;0;3;0;0;0;1;2;0
7514.0;2021;15;STRASBOURG;FEMININ;SCOLAIRE;BAC PROFESSIONNEL;BAC PRO SERV;BAC PRO 31106 LOGISTIQUE;4;4;3;1;0;0;0;3;0;0;1;1;1;1
7515.0;2021;15;STRASBOURG;FEMININ;SCOLAIRE;BAC PROFESSIONNEL;BAC PRO SERV;BAC PRO 31107 CONDUCT. TRANSP.ROUT.MARCHANDISES;6;6;3;3;0;0;0;3;0;0;1;1;1;3
7521.0;2021;15;STRASBOURG;FEMININ;SCOLAIRE;BAC PROFESSIONNEL;BAC PRO SERV;BAC PRO 32303 ART.& MET.ART:COM.VIS.VIS.PLURI-M;16;16;16;0;0;0;0;16;0;3;8;4;1;0
7523.0;2021;15;STRASBOURG;FEMININ;SCOLAIRE;BAC PROFESSIONNEL;BAC PRO SERV;BAC PRO 33004 ACC.SOINS-S.PERS. OPT.EN STRUCTUR;441;441;379;31;31;20;11;399;0;15;77;142;165;42
7524.0;2021;15;STRASBOURG;FEMININ;SCOLAIRE;BAC PROFESSIONNEL;BAC PRO SERV;BAC PRO 33101 OPTIQUE LUNETTERIE;6;6;6;0;0;0;0;6;0;1;2;2;1;0
7525.0;2021;15;STRASBOURG;FEMININ;SCOLAIRE;BAC PROFESSIONNEL;BAC PRO SERV;BAC PRO 33102 PROTHESE DENTAIRE;8;8;7;1;0;0;0;7;0;0;1;3;3;1
7534.0;2021;15;STRASBOURG;FEMININ;SCOLAIRE;BAC TECHNOLOGIQUE;BAC STHR;BAC STHR SC.&TEC. HOTELLERIE-RESTAURATION;67;67;65;0;2;0;2;65;2;6;16;22;19;2
7539.0;2021;15;STRASBOURG;FEMININ;SCOLAIRE;BAC TECHNOLOGIQUE;BAC STL;BAC STL BIOCHIM.-BIOLOGIE-BIOTECHNOL.;143;143;120;3;20;6;14;126;0;10;22;47;47;17
7543.0;2021;15;STRASBOURG;FEMININ;SCOLAIRE;BAC TECHNOLOGIQUE;BAC STMG;BAC STMG RESSOURCES HUMAINES ET COMMUNICATION;385;385;349;6;30;13;17;362;0;5;54;156;147;23
7545.0;2021;15;STRASBOURG;MASCULIN;APPRENTISSAGE;BAC PROFESSIONNEL;BAC PRO PROD;BAC PRO 20102 PILOTE DE LIGNE DE PRODUCTION;20;20;20;0;0;0;0;20;0;6;7;7;0;0
7547.0;2021;15;STRASBOURG;MASCULIN;APPRENTISSAGE;BAC PROFESSIONNEL;BAC PRO PROD;BAC PRO 22305 ART.MET.ART-FACT.ORG. OPT.TUYAUT.;4;4;4;0;0;0;0;4;0;0;2;1;1;0
7553.0;2021;15;STRASBOURG;MASCULIN;APPRENTISSAGE;BAC PROFESSIONNEL;BAC PRO PROD;BAC PRO 23304 AMENAGEMENT FINITION BATIMENT;1;1;1;0;0;0;0;1;0;0;0;0;1;0
7556.0;2021;15;STRASBOURG;MASCULIN;APPRENTISSAGE;BAC PROFESSIONNEL;BAC PRO PROD;BAC PRO 23407 TECHNIC.FAB.BOIS ET MATERX ASSOC;15;15;10;3;2;1;1;11;0;2;2;3;4;4
7558.0;2021;15;STRASBOURG;MASCULIN;APPRENTISSAGE;BAC PROFESSIONNEL;BAC PRO PROD;BAC PRO 25106 TECHNICIEN D'USINAGE;34;34;30;2;2;1;1;31;0;0;11;11;9;3
7566.0;2021;15;STRASBOURG;MASCULIN;APPRENTISSAGE;BAC PROFESSIONNEL;BAC PRO PROD;BAC PRO 25406 OUVRAGES DU BATIMENT METALLERIE;7;7;3;3;1;1;0;4;0;0;1;0;3;3
7571.0;2021;15;STRASBOURG;MASCULIN;APPRENTISSAGE;BAC PROFESSIONNEL;BAC PRO PROD;BAC PRO 25510 METIERS ELECT. ENVIRON. CONNECTES;86;86;75;4;7;3;4;78;0;8;13;35;22;8
7575.0;2021;15;STRASBOURG;MASCULIN;APPRENTISSAGE;BAC PROFESSIONNEL;BAC PRO PROD;BAC PRO AG 21004 CGEA;9;9;9;0;0;0;0;9;0;0;0;1;8;0
7576.0;2021;15;STRASBOURG;MASCULIN;APPRENTISSAGE;BAC PROFESSIONNEL;BAC PRO PROD;BAC PRO AG 21113 CGEVV;9;9;8;1;0;0;0;8;0;0;2;2;4;1
7578.0;2021;15;STRASBOURG;MASCULIN;APPRENTISSAGE;BAC PROFESSIONNEL;BAC PRO PROD;BAC PRO AG 21203 TECHN CONSEIL DE VENTE ANIMAL;1;1;1;0;0;0;0;1;0;0;0;1;0;0
7582.0;2021;15;STRASBOURG;MASCULIN;APPRENTISSAGE;BAC PROFESSIONNEL;BAC PRO SERV;BAC PRO 31106 LOGISTIQUE;25;25;20;3;2;2;0;22;0;0;6;8;8;3
7583.0;2021;15;STRASBOURG;MASCULIN;APPRENTISSAGE;BAC PROFESSIONNEL;BAC PRO SERV;BAC PRO 31202 COMMERCE;70;70;57;8;5;3;2;60;0;8;8;23;21;10
7596.0;2021;15;STRASBOURG;MASCULIN;FORMATION CONTINUE;BAC PROFESSIONNEL;BAC PRO PROD;BAC PRO 23404 TECHNICIEN CONSTRUCTEUR BOIS;2;2;2;0;0;0;0;2;0;2;0;0;0;0
7600.0;2021;15;STRASBOURG;MASCULIN;FORMATION CONTINUE;BAC PROFESSIONNEL;BAC PRO PROD;BAC PRO 25214 MAINT.VEHIC.OPTA VOIT.PARTICUL.;14;14;14;0;0;0;0;14;0;4;7;2;1;0
7602.0;2021;15;STRASBOURG;MASCULIN;FORMATION CONTINUE;BAC PROFESSIONNEL;BAC PRO PROD;BAC PRO 25411 TECH.CHAUDRONNERIE INDUSTRIELLE;12;11;10;1;0;0;0;10;0;4;3;3;0;1
7604.0;2021;15;STRASBOURG;MASCULIN;FORMATION CONTINUE;BAC PROFESSIONNEL;BAC PRO SERV;BAC PRO 30001 GESTION-ADMINISTRATION;2;1;1;0;0;0;0;1;0;1;0;0;0;0
7618.0;2021;15;STRASBOURG;MASCULIN;INDIVIDUEL;BAC PROFESSIONNEL;BAC PRO PROD;BAC PRO AG 21211 COND GEST ENTR HIPPIQUE;1;1;0;1;0;0;0;0;0;0;0;0;0;1
7622.0;2021;15;STRASBOURG;MASCULIN;INDIVIDUEL;BAC PROFESSIONNEL;BAC PRO SERV;BAC PRO 31206 VENTE (PROSPECT.NEGO.SUIV.CLIENT;1;1;0;1;0;0;0;0;0;0;0;0;0;1
7637.0;2021;15;STRASBOURG;MASCULIN;SCOLAIRE;BAC PROFESSIONNEL;BAC PRO PROD;BAC PRO 22503 PLASTIQUES ET COMPOSITES;17;17;14;1;2;0;2;14;0;0;5;3;6;3
7642.0;2021;15;STRASBOURG;MASCULIN;SCOLAIRE;BAC PROFESSIONNEL;BAC PRO PROD;BAC PRO 23102 TRAVAUX PUBLICS;8;8;7;1;0;0;0;7;0;1;1;5;0;1
7643.0;2021;15;STRASBOURG;MASCULIN;SCOLAIRE;BAC PROFESSIONNEL;BAC PRO PROD;BAC PRO 23203 TECHNICIEN BAT. : ORG.REAL.GROS O;15;15;7;6;2;2;0;9;0;0;3;1;5;6
7667.0;2021;15;STRASBOURG;MASCULIN;SCOLAIRE;BAC PROFESSIONNEL;BAC PRO PROD;BAC PRO 25515 SYST.NUM.OPT.C RES.INF.SYST.COMM.;111;111;84;18;9;8;1;92;0;9;19;35;29;19
7670.0;2021;15;STRASBOURG;MASCULIN;SCOLAIRE;BAC PROFESSIONNEL;BAC PRO PROD;BAC PRO AG 21114 CONDUITE PRODUCTIONS HORTICOLES;7;7;7;0;0;0;0;7;0;1;2;2;2;0
7672.0;2021;15;STRASBOURG;MASCULIN;SCOLAIRE;BAC PROFESSIONNEL;BAC PRO PROD;BAC PRO AG 21303 FORET;10;9;8;1;0;0;0;8;0;0;1;4;3;1
7674.0;2021;15;STRASBOURG;MASCULIN;SCOLAIRE;BAC PROFESSIONNEL;BAC PRO PROD;BAC PRO AG 22105 LABORATOIRE CONTROLE QUALITE;10;10;10;0;0;0;0;10;0;0;1;3;6;0
7680.0;2021;15;STRASBOURG;MASCULIN;SCOLAIRE;BAC PROFESSIONNEL;BAC PRO SERV;BAC PRO 31109 TRANSPORT FLUVIAL;12;12;8;4;0;0;0;8;0;1;3;3;1;4
7681.0;2021;15;STRASBOURG;MASCULIN;SCOLAIRE;BAC PROFESSIONNEL;BAC PRO SERV;BAC PRO 31202 COMMERCE;424;423;341;38;44;27;17;368;0;15;82;129;142;55
7682.0;2021;15;STRASBOURG;MASCULIN;SCOLAIRE;BAC PROFESSIONNEL;BAC PRO SERV;BAC PRO 31206 VENTE (PROSPECT.NEGO.SUIV.CLIENT;50;50;33;10;7;5;2;38;0;0;9;13;16;12
7684.0;2021;15;STRASBOURG;MASCULIN;SCOLAIRE;BAC PROFESSIONNEL;BAC PRO SERV;BAC PRO 32207 REAL.PR.IMPR.PLURI.OPTA.PR.GRAPH.;14;14;13;1;0;0;0;13;0;0;5;7;1;1
7686.0;2021;15;STRASBOURG;MASCULIN;SCOLAIRE;BAC PROFESSIONNEL;BAC PRO SERV;BAC PRO 32303 ART.& MET.ART:COM.VIS.VIS.PLURI-M;8;8;6;2;0;0;0;6;0;0;2;4;0;2
7695.0;2021;15;STRASBOURG;MASCULIN;SCOLAIRE;BAC TECHNOLOGIQUE;BAC ST2S;BAC ST2S SCIENCES & TECHNO. SANTE & SOCIAL;65;65;55;3;7;4;3;59;0;3;7;22;27;6
7706.0;2021;15;STRASBOURG;MASCULIN;SCOLAIRE;BAC TECHNOLOGIQUE;BAC STMG;BAC STMG MERCATIQUE (MARKETING);359;359;304;16;39;21;18;325;0;4;32;115;174;34
7724.0;2021;16;TOULOUSE;FEMININ;APPRENTISSAGE;BAC PROFESSIONNEL;BAC PRO PROD;BAC PRO 25303 AERONAUTIQUE OPTION SYSTEMES;1;1;1;0;0;0;0;1;0;0;0;1;0;0
7727.0;2021;16;TOULOUSE;FEMININ;APPRENTISSAGE;BAC PROFESSIONNEL;BAC PRO PROD;BAC PRO 25510 METIERS ELECT. ENVIRON. CONNECTES;2;2;1;1;0;0;0;1;0;1;0;0;0;1
7733.0;2021;16;TOULOUSE;FEMININ;APPRENTISSAGE;BAC PROFESSIONNEL;BAC PRO SERV;BAC PRO 31202 COMMERCE;83;79;67;6;6;4;2;71;0;4;19;31;17;8
7734.0;2021;16;TOULOUSE;FEMININ;APPRENTISSAGE;BAC PROFESSIONNEL;BAC PRO SERV;BAC PRO 31210 ACCUEIL -RELATION CLIENTS USAGERS;11;11;11;0;0;0;0;11;0;2;2;4;3;0
7737.0;2021;16;TOULOUSE;FEMININ;APPRENTISSAGE;BAC PROFESSIONNEL;BAC PRO SERV;BAC PRO 33004 ACC.SOINS-S.PERS. OPT.EN STRUCTUR;2;2;1;1;0;0;0;1;0;0;0;1;0;1
7741.0;2021;16;TOULOUSE;FEMININ;APPRENTISSAGE;BAC PROFESSIONNEL;BAC PRO SERV;BAC PRO 34304 HYGIENE PROPRETE STERILISATION;12;11;8;3;0;0;0;8;0;0;2;3;3;3
7745.0;2021;16;TOULOUSE;FEMININ;ENSEIGNEMENT A DISTANCE;BAC PROFESSIONNEL;BAC PRO SERV;BAC PRO 31202 COMMERCE;3;3;2;0;1;1;0;3;0;0;0;1;2;0
7747.0;2021;16;TOULOUSE;FEMININ;ENSEIGNEMENT A DISTANCE;BAC PROFESSIONNEL;BAC PRO SERV;BAC PRO 33004 ACC.SOINS-S.PERS. OPT.EN STRUCTUR;2;1;0;1;0;0;0;0;0;0;0;0;0;1
7753.0;2021;16;TOULOUSE;FEMININ;FORMATION CONTINUE;BAC PROFESSIONNEL;BAC PRO PROD;BAC PRO 22703 TECHN.INSTALL.SYST.ENERG.CLIMATI;1;1;1;0;0;0;0;1;0;1;0;0;0;0
7754.0;2021;16;TOULOUSE;FEMININ;FORMATION CONTINUE;BAC PROFESSIONNEL;BAC PRO PROD;BAC PRO 22705 TECHNICIEN GAZ;1;1;1;0;0;0;0;1;0;1;0;0;0;0
7763.0;2021;16;TOULOUSE;FEMININ;INDIVIDUEL;BAC PROFESSIONNEL;BAC PRO PROD;BAC PRO AG 21004 CGEA;2;2;1;1;0;0;0;1;0;0;0;0;1;1
7767.0;2021;16;TOULOUSE;FEMININ;INDIVIDUEL;BAC PROFESSIONNEL;BAC PRO PROD;BAC PRO AG 21302 GEST MILIEUX NATURELS FAUNE;1;0;0;0;0;0;0;0;0;0;0;0;0;0
7770.0;2021;16;TOULOUSE;FEMININ;INDIVIDUEL;BAC PROFESSIONNEL;BAC PRO SERV;BAC PRO 31202 COMMERCE;2;1;1;0;0;0;0;1;0;0;0;1;0;0
7774.0;2021;16;TOULOUSE;FEMININ;INDIVIDUEL;BAC PROFESSIONNEL;BAC PRO SERV;BAC PRO 33004 ACC.SOINS-S.PERS. OPT.EN STRUCTUR;2;0;0;0;0;0;0;0;0;0;0;0;0;0
7786.0;2021;16;TOULOUSE;FEMININ;SCOLAIRE;BAC PROFESSIONNEL;BAC PRO PROD;BAC PRO 22004 PROC. CHIMIE EAU PAPIERS-CARTONS;4;4;2;2;0;0;0;2;0;0;0;1;1;2
7801.0;2021;16;TOULOUSE;FEMININ;SCOLAIRE;BAC PROFESSIONNEL;BAC PRO PROD;BAC PRO 24203 METIERS DE LA MODE - VÊTEMENT;102;102;93;9;0;0;0;93;0;16;30;29;18;9
7804.0;2021;16;TOULOUSE;FEMININ;SCOLAIRE;BAC PROFESSIONNEL;BAC PRO PROD;BAC PRO 25007 MAINTENANCE EQUIPEMENTS INDUST.;9;9;6;2;1;1;0;7;0;1;1;1;4;2
7806.0;2021;16;TOULOUSE;FEMININ;SCOLAIRE;BAC PROFESSIONNEL;BAC PRO PROD;BAC PRO 25108 TECHNICIEN MODELEUR;3;3;3;0;0;0;0;3;0;0;0;2;1;0
7810.0;2021;16;TOULOUSE;FEMININ;SCOLAIRE;BAC PROFESSIONNEL;BAC PRO PROD;BAC PRO 25221 MAINT.MATERIELS OPT.C ESP. VERTS;2;2;2;0;0;0;0;2;0;0;0;2;0;0
7817.0;2021;16;TOULOUSE;FEMININ;SCOLAIRE;BAC PROFESSIONNEL;BAC PRO PROD;BAC PRO 25510 METIERS ELECT. ENVIRON. CONNECTES;1;1;1;0;0;0;0;1;0;0;0;0;1;0
7822.0;2021;16;TOULOUSE;FEMININ;SCOLAIRE;BAC PROFESSIONNEL;BAC PRO PROD;BAC PRO AG 21114 CONDUITE PRODUCTIONS HORTICOLES;15;15;13;2;0;0;0;13;0;1;3;3;6;2
7826.0;2021;16;TOULOUSE;FEMININ;SCOLAIRE;BAC PROFESSIONNEL;BAC PRO PROD;BAC PRO AG 21302 GEST MILIEUX NATURELS FAUNE;15;14;13;1;0;0;0;13;0;0;1;8;4;1
7830.0;2021;16;TOULOUSE;FEMININ;SCOLAIRE;BAC PROFESSIONNEL;BAC PRO PROD;BAC PRO AG 22105 LABORATOIRE CONTROLE QUALITE;15;15;14;1;0;0;0;14;0;2;2;4;6;1
7842.0;2021;16;TOULOUSE;FEMININ;SCOLAIRE;BAC PROFESSIONNEL;BAC PRO SERV;BAC PRO 32304 PHOTOGRAPHIE;9;9;9;0;0;0;0;9;0;0;3;1;5;0
7844.0;2021;16;TOULOUSE;FEMININ;SCOLAIRE;BAC PROFESSIONNEL;BAC PRO SERV;BAC PRO 33003 ACC.SOINS-S.PERS. OPT.A DOMICILE;52;52;41;2;9;6;3;47;0;2;9;19;17;5
7855.0;2021;16;TOULOUSE;FEMININ;SCOLAIRE;BAC TECHNOLOGIQUE;BAC S2TMD;BAC S2TMD MUSIQUE;3;3;3;0;0;0;0;3;1;2;0;0;0;0
7856.0;2021;16;TOULOUSE;FEMININ;SCOLAIRE;BAC TECHNOLOGIQUE;BAC ST2S;BAC ST2S SCIENCES & TECHNO. SANTE & SOCIAL;830;830;762;9;59;30;29;792;0;17;150;342;283;38
7862.0;2021;16;TOULOUSE;FEMININ;SCOLAIRE;BAC TECHNOLOGIQUE;BAC STI2D;BAC STI2D INNOVATION TECHNO.  ET ECO CONCEPTION;33;33;32;0;1;1;0;33;0;3;7;16;7;0
7866.0;2021;16;TOULOUSE;FEMININ;SCOLAIRE;BAC TECHNOLOGIQUE;BAC STMG;BAC STMG GESTION ET FINANCE;220;220;212;3;5;2;3;214;0;13;60;82;59;6
7867.0;2021;16;TOULOUSE;FEMININ;SCOLAIRE;BAC TECHNOLOGIQUE;BAC STMG;BAC STMG MERCATIQUE (MARKETING);668;668;617;6;45;22;23;639;0;12;117;303;207;29
7877.0;2021;16;TOULOUSE;MASCULIN;APPRENTISSAGE;BAC PROFESSIONNEL;BAC PRO PROD;BAC PRO 22705 TECHNICIEN GAZ;5;5;5;0;0;0;0;5;0;1;3;1;0;0
7898.0;2021;16;TOULOUSE;MASCULIN;APPRENTISSAGE;BAC PROFESSIONNEL;BAC PRO PROD;BAC PRO 25303 AERONAUTIQUE OPTION SYSTEMES;11;11;11;0;0;0;0;11;0;2;7;1;1;0
7900.0;2021;16;TOULOUSE;MASCULIN;APPRENTISSAGE;BAC PROFESSIONNEL;BAC PRO PROD;BAC PRO 25406 OUVRAGES DU BATIMENT METALLERIE;1;1;0;1;0;0;0;0;0;0;0;0;0;1
7901.0;2021;16;TOULOUSE;MASCULIN;APPRENTISSAGE;BAC PROFESSIONNEL;BAC PRO PROD;BAC PRO 25408 REPARATION DES CARROSSERIES;19;19;15;2;2;2;0;17;0;0;3;7;7;2
7902.0;2021;16;TOULOUSE;MASCULIN;APPRENTISSAGE;BAC PROFESSIONNEL;BAC PRO PROD;BAC PRO 25411 TECH.CHAUDRONNERIE INDUSTRIELLE;57;56;46;8;2;2;0;48;0;10;15;11;12;8
7908.0;2021;16;TOULOUSE;MASCULIN;APPRENTISSAGE;BAC PROFESSIONNEL;BAC PRO PROD;BAC PRO AG 22107 TEC CONS VTE ALIMENTATION P.ALIM;6;5;5;0;0;0;0;5;0;1;0;3;1;0
7911.0;2021;16;TOULOUSE;MASCULIN;APPRENTISSAGE;BAC PROFESSIONNEL;BAC PRO SERV;BAC PRO 31202 COMMERCE;77;76;54;11;11;7;4;61;0;3;15;25;18;15
7913.0;2021;16;TOULOUSE;MASCULIN;APPRENTISSAGE;BAC PROFESSIONNEL;BAC PRO SERV;BAC PRO 32207 REAL.PR.IMPR.PLURI.OPTA.PR.GRAPH.;3;3;2;1;0;0;0;2;0;0;0;1;1;1
7914.0;2021;16;TOULOUSE;MASCULIN;APPRENTISSAGE;BAC PROFESSIONNEL;BAC PRO SERV;BAC PRO 32208 REAL.PR.IMPR.PLURI.OPTB.PR.IMPR.;4;4;3;1;0;0;0;3;0;0;1;1;1;1
7926.0;2021;16;TOULOUSE;MASCULIN;ENSEIGNEMENT A DISTANCE;BAC TECHNOLOGIQUE;BAC STMG;BAC STMG MERCATIQUE (MARKETING);7;7;7;0;0;0;0;7;0;2;3;1;1;0
7928.0;2021;16;TOULOUSE;MASCULIN;FORMATION CONTINUE;BAC PROFESSIONNEL;BAC PRO PROD;BAC PRO 22106 CUISINE;1;1;1;0;0;0;0;1;0;0;1;0;0;0
7933.0;2021;16;TOULOUSE;MASCULIN;FORMATION CONTINUE;BAC PROFESSIONNEL;BAC PRO PROD;BAC PRO 25106 TECHNICIEN D'USINAGE;2;2;2;0;0;0;0;2;0;1;1;0;0;0
7941.0;2021;16;TOULOUSE;MASCULIN;INDIVIDUEL;BAC PROFESSIONNEL;BAC PRO PROD;BAC PRO 23005 TECHN. ETUDES BAT B ASSIST.ARCHI.;3;3;2;1;0;0;0;2;0;0;0;0;2;1
7948.0;2021;16;TOULOUSE;MASCULIN;INDIVIDUEL;BAC PROFESSIONNEL;BAC PRO PROD;BAC PRO AG 21004 CGEA;4;3;3;0;0;0;0;3;0;0;0;0;3;0
7952.0;2021;16;TOULOUSE;MASCULIN;INDIVIDUEL;BAC PROFESSIONNEL;BAC PRO PROD;BAC PRO AG 21405 AMENAGEMENTS PAYSAGERS;1;1;1;0;0;0;0;1;0;0;0;0;1;0
7953.0;2021;16;TOULOUSE;MASCULIN;INDIVIDUEL;BAC PROFESSIONNEL;BAC PRO SERV;BAC PRO 30001 GESTION-ADMINISTRATION;5;3;1;1;1;1;0;2;0;0;0;0;2;1
7960.0;2021;16;TOULOUSE;MASCULIN;INDIVIDUEL;BAC TECHNOLOGIQUE;BAC STAV;BAC STAV AGRONOMIE ALIM ENV TERRITOI;1;1;1;0;0;0;0;1;0;0;0;0;1;0
7962.0;2021;16;TOULOUSE;MASCULIN;INDIVIDUEL;BAC TECHNOLOGIQUE;BAC STI2D;BAC STI2D ARCHITECTURE ET CONSTRUCTION;3;1;0;0;1;1;0;1;0;0;0;0;1;0
7964.0;2021;16;TOULOUSE;MASCULIN;INDIVIDUEL;BAC TECHNOLOGIQUE;BAC STI2D;BAC STI2D SYSTÈME D'INFORMATION  ET NUMERIQUE;1;0;0;0;0;0;0;0;0;0;0;0;0;0
7968.0;2021;16;TOULOUSE;MASCULIN;INDIVIDUEL;BAC TECHNOLOGIQUE;BAC STMG;BAC STMG MERCATIQUE (MARKETING);12;3;1;0;2;2;0;3;0;0;1;0;2;0
7971.0;2021;16;TOULOUSE;MASCULIN;SCOLAIRE;BAC PROFESSIONNEL;BAC PRO PROD;BACPRO 20002 ETUD.DEFINITION PRDTS INDUSTRIEL;22;22;10;10;2;2;0;12;0;0;2;1;9;10
7972.0;2021;16;TOULOUSE;MASCULIN;SCOLAIRE;BAC PROFESSIONNEL;BAC PRO PROD;BAC PRO 22003 BIO-INDUSTRIES DE TRANSFORMATION;16;16;10;2;4;3;1;13;0;0;1;3;9;3
7973.0;2021;16;TOULOUSE;MASCULIN;SCOLAIRE;BAC PROFESSIONNEL;BAC PRO PROD;BAC PRO 22004 PROC. CHIMIE EAU PAPIERS-CARTONS;6;6;4;2;0;0;0;4;0;1;1;2;0;2
7986.0;2021;16;TOULOUSE;MASCULIN;SCOLAIRE;BAC PROFESSIONNEL;BAC PRO PROD;BAC PRO 23203 TECHNICIEN BAT. : ORG.REAL.GROS O;28;27;19;6;2;1;1;20;0;1;5;8;6;7
7987.0;2021;16;TOULOUSE;MASCULIN;SCOLAIRE;BAC PROFESSIONNEL;BAC PRO PROD;BAC PRO 23205 INTERV. SUR PATRIMOINE BATI OPT.A;3;3;2;1;0;0;0;2;0;0;0;2;0;1
7993.0;2021;16;TOULOUSE;MASCULIN;SCOLAIRE;BAC PROFESSIONNEL;BAC PRO PROD;BAC PRO 23407 TECHNIC.FAB.BOIS ET MATERX ASSOC;13;13;10;0;3;0;3;10;0;1;2;7;0;3
8005.0;2021;16;TOULOUSE;MASCULIN;SCOLAIRE;BAC PROFESSIONNEL;BAC PRO PROD;BAC PRO 25219 MAINT.MATERIELS OPT.A AGRICOLES;44;44;42;2;0;0;0;42;0;3;10;20;9;2
8007.0;2021;16;TOULOUSE;MASCULIN;SCOLAIRE;BAC PROFESSIONNEL;BAC PRO PROD;BAC PRO 25221 MAINT.MATERIELS OPT.C ESP. VERTS;11;11;11;0;0;0;0;11;0;1;2;5;3;0
8013.0;2021;16;TOULOUSE;MASCULIN;SCOLAIRE;BAC PROFESSIONNEL;BAC PRO PROD;BAC PRO 25411 TECH.CHAUDRONNERIE INDUSTRIELLE;89;88;80;6;2;1;1;81;0;8;17;30;26;7
8017.0;2021;16;TOULOUSE;MASCULIN;SCOLAIRE;BAC PROFESSIONNEL;BAC PRO PROD;BAC PRO 25514 SYST.NUM.OPT.B AUD.RES.EQUIP.DOM.;74;74;66;5;3;1;2;67;0;7;13;21;26;7
8018.0;2021;16;TOULOUSE;MASCULIN;SCOLAIRE;BAC PROFESSIONNEL;BAC PRO PROD;BAC PRO 25515 SYST.NUM.OPT.C RES.INF.SYST.COMM.;157;157;143;9;5;3;2;146;0;8;44;53;41;11
8032.0;2021;16;TOULOUSE;MASCULIN;SCOLAIRE;BAC PROFESSIONNEL;BAC PRO SERV;BAC PRO 30001 GESTION-ADMINISTRATION;222;222;160;48;14;10;4;170;0;2;14;71;83;52
8035.0;2021;16;TOULOUSE;MASCULIN;SCOLAIRE;BAC PROFESSIONNEL;BAC PRO SERV;BAC PRO 31108 TRANSPORT;12;12;12;0;0;0;0;12;0;2;1;2;7;0
8037.0;2021;16;TOULOUSE;MASCULIN;SCOLAIRE;BAC PROFESSIONNEL;BAC PRO SERV;BAC PRO 31206 VENTE (PROSPECT.NEGO.SUIV.CLIENT;209;208;166;20;22;18;4;184;0;7;31;66;80;24
8043.0;2021;16;TOULOUSE;MASCULIN;SCOLAIRE;BAC PROFESSIONNEL;BAC PRO SERV;BAC PRO 33002 SERVICES DE PROXIMITE  VIE LOCAL;7;7;7;0;0;0;0;7;0;0;3;2;2;0
8052.0;2021;16;TOULOUSE;MASCULIN;SCOLAIRE;BAC TECHNOLOGIQUE;BAC S2TMD;BAC S2TMD DANSE;1;1;0;1;0;0;0;0;0;0;0;0;0;1
8055.0;2021;16;TOULOUSE;MASCULIN;SCOLAIRE;BAC TECHNOLOGIQUE;BAC STAV;BAC STAV AGRONOMIE ALIM ENV TERRITOI;201;200;200;0;0;0;0;200;0;0;30;108;62;0
8059.0;2021;16;TOULOUSE;MASCULIN;SCOLAIRE;BAC TECHNOLOGIQUE;BAC STI2D;BAC STI2D ENERGIES  ET ENVIRONNEMENT;139;139;126;2;11;4;7;130;0;4;28;59;39;9
8067.0;2021;16;TOULOUSE;MASCULIN;SCOLAIRE;BAC TECHNOLOGIQUE;BAC STMG;BAC STMG SYSTEMES D'INFORMATION DE GESTION;37;37;34;0;3;2;1;36;0;0;1;14;21;1
8069.0;2021;25;VERSAILLES;FEMININ;APPRENTISSAGE;BAC PROFESSIONNEL;BAC PRO PROD;BAC PRO 22106 CUISINE;36;36;34;1;1;0;1;34;0;5;11;13;5;2
8076.0;2021;25;VERSAILLES;FEMININ;APPRENTISSAGE;BAC PROFESSIONNEL;BAC PRO PROD;BAC PRO 25303 AERONAUTIQUE OPTION SYSTEMES;1;1;1;0;0;0;0;1;0;1;0;0;0;0
8079.0;2021;25;VERSAILLES;FEMININ;APPRENTISSAGE;BAC PROFESSIONNEL;BAC PRO PROD;BAC PRO 25510 METIERS ELECT. ENVIRON. CONNECTES;1;1;0;1;0;0;0;0;0;0;0;0;0;1
8085.0;2021;25;VERSAILLES;FEMININ;APPRENTISSAGE;BAC PROFESSIONNEL;BAC PRO SERV;BAC PRO 31106 LOGISTIQUE;1;1;0;0;1;1;0;1;0;0;0;0;1;0
8091.0;2021;25;VERSAILLES;FEMININ;APPRENTISSAGE;BAC PROFESSIONNEL;BAC PRO SERV;BAC PRO 34304 HYGIENE PROPRETE STERILISATION;11;11;4;5;2;1;1;5;0;0;0;2;3;6
8092.0;2021;25;VERSAILLES;FEMININ;APPRENTISSAGE;BAC PROFESSIONNEL;BAC PRO SERV;BAC PRO 34403 METIERS DE LA SECURITE;6;6;5;1;0;0;0;5;0;0;1;1;3;1
8093.0;2021;25;VERSAILLES;FEMININ;ENSEIGNEMENT A DISTANCE;BAC GENERAL;BAC GENERAL;BAC GENE 10019 BAC GENERAL;113;110;105;4;1;1;0;106;2;23;37;22;22;4
8103.0;2021;25;VERSAILLES;FEMININ;ENSEIGNEMENT A DISTANCE;BAC TECHNOLOGIQUE;BAC STMG;BAC STMG RESSOURCES HUMAINES ET COMMUNICATION;7;7;7;0;0;0;0;7;0;0;1;2;4;0
8104.0;2021;25;VERSAILLES;FEMININ;FORMATION CONTINUE;BAC PROFESSIONNEL;BAC PRO PROD;BAC PRO 20102 PILOTE DE LIGNE DE PRODUCTION;1;1;1;0;0;0;0;1;0;1;0;0;0;0
8112.0;2021;25;VERSAILLES;FEMININ;FORMATION CONTINUE;BAC PROFESSIONNEL;BAC PRO SERV;BAC PRO 32303 ART.& MET.ART:COM.VIS.VIS.PLURI-M;4;4;3;1;0;0;0;3;0;1;1;1;0;1
8114.0;2021;25;VERSAILLES;FEMININ;INDIVIDUEL;BAC GENERAL;BAC GENERAL;BAC GENE 10019 BAC GENERAL;386;272;164;70;38;27;11;191;6;23;39;40;83;81
8116.0;2021;25;VERSAILLES;FEMININ;INDIVIDUEL;BAC PROFESSIONNEL;BAC PRO PROD;BAC PRO 23003 ARTIS. & M.ART:MARCHANDISAGE VIS.;1;1;1;0;0;0;0;1;0;0;0;1;0;0
8117.0;2021;25;VERSAILLES;FEMININ;INDIVIDUEL;BAC PROFESSIONNEL;BAC PRO PROD;BAC PRO 23005 TECHN. ETUDES BAT B ASSIST.ARCHI.;1;1;0;0;1;1;0;1;0;0;0;0;1;0
8121.0;2021;25;VERSAILLES;FEMININ;INDIVIDUEL;BAC PROFESSIONNEL;BAC PRO PROD;BAC PRO AG 21114 CONDUITE PRODUCTIONS HORTICOLES;3;2;2;0;0;0;0;2;0;0;0;0;2;0
8128.0;2021;25;VERSAILLES;FEMININ;INDIVIDUEL;BAC PROFESSIONNEL;BAC PRO SERV;BAC PRO 31206 VENTE (PROSPECT.NEGO.SUIV.CLIENT;4;3;2;1;0;0;0;2;0;0;0;0;2;1
8131.0;2021;25;VERSAILLES;FEMININ;INDIVIDUEL;BAC PROFESSIONNEL;BAC PRO SERV;BAC PRO 33004 ACC.SOINS-S.PERS. OPT.EN STRUCTUR;11;7;5;1;1;0;1;5;0;0;0;2;3;2
8132.0;2021;25;VERSAILLES;FEMININ;INDIVIDUEL;BAC PROFESSIONNEL;BAC PRO SERV;BAC PRO 33102 PROTHESE DENTAIRE;1;0;0;0;0;0;0;0;0;0;0;0;0;0
8136.0;2021;25;VERSAILLES;FEMININ;INDIVIDUEL;BAC TECHNOLOGIQUE;BAC STD2A;BAC STD2A SCIENCES & TECHNO. DESIGN-ARTS APPLIQUES;3;1;1;0;0;0;0;1;0;0;0;1;0;0
8137.0;2021;25;VERSAILLES;FEMININ;INDIVIDUEL;BAC TECHNOLOGIQUE;BAC STI2D;BAC STI2D INNOVATION TECHNO.  ET ECO CONCEPTION;1;1;0;0;1;1;0;1;0;0;0;0;1;0
8143.0;2021;25;VERSAILLES;FEMININ;INDIVIDUEL;BAC TECHNOLOGIQUE;BAC STMG;BAC STMG RESSOURCES HUMAINES ET COMMUNICATION;38;24;15;5;4;1;3;16;0;0;1;1;14;8
8148.0;2021;25;VERSAILLES;FEMININ;SCOLAIRE;BAC PROFESSIONNEL;BAC PRO PROD;BAC PRO 22105 BOULANGER-PÂTISSIER;46;46;42;2;2;2;0;44;0;4;13;15;12;2
8152.0;2021;25;VERSAILLES;FEMININ;SCOLAIRE;BAC PROFESSIONNEL;BAC PRO PROD;BAC PRO 23003 ARTIS. & M.ART:MARCHANDISAGE VIS.;63;63;59;2;2;2;0;61;0;5;18;25;13;2
8153.0;2021;25;VERSAILLES;FEMININ;SCOLAIRE;BAC PROFESSIONNEL;BAC PRO PROD;BAC PRO 23004 TECHN. ETUDES BAT.A ETUDES & ECO.;11;11;9;1;1;1;0;10;0;0;0;5;5;1
8155.0;2021;25;VERSAILLES;FEMININ;SCOLAIRE;BAC PROFESSIONNEL;BAC PRO PROD;BACPRO 23103 TECHNICIEN GEOMETRE-TOPOGRAPHE;7;7;5;1;1;1;0;6;0;1;1;3;1;1
8161.0;2021;25;VERSAILLES;FEMININ;SCOLAIRE;BAC PROFESSIONNEL;BAC PRO PROD;BAC PRO 24302 METIERS DU CUIR : MAROQUINERIE;7;7;6;1;0;0;0;6;0;1;2;3;0;1
8163.0;2021;25;VERSAILLES;FEMININ;SCOLAIRE;BAC PROFESSIONNEL;BAC PRO PROD;BAC PRO 25007 MAINTENANCE EQUIPEMENTS INDUST.;3;3;2;0;1;1;0;3;0;0;1;0;2;0
8169.0;2021;25;VERSAILLES;FEMININ;SCOLAIRE;BAC PROFESSIONNEL;BAC PRO PROD;BAC PRO 25408 REPARATION DES CARROSSERIES;3;3;3;0;0;0;0;3;0;0;1;1;1;0
8170.0;2021;25;VERSAILLES;FEMININ;SCOLAIRE;BAC PROFESSIONNEL;BAC PRO PROD;BAC PRO 25510 METIERS ELECT. ENVIRON. CONNECTES;6;6;6;0;0;0;0;6;0;0;4;1;1;0
8171.0;2021;25;VERSAILLES;FEMININ;SCOLAIRE;BAC PROFESSIONNEL;BAC PRO PROD;BAC PRO 25513 SYST.NUM.OPT.A SURETE SECURITE;1;1;1;0;0;0;0;1;0;0;1;0;0;0
8177.0;2021;25;VERSAILLES;FEMININ;SCOLAIRE;BAC PROFESSIONNEL;BAC PRO PROD;BAC PRO AG 21302 GEST MILIEUX NATURELS FAUNE;9;9;8;1;0;0;0;8;0;0;3;1;4;1
8180.0;2021;25;VERSAILLES;FEMININ;SCOLAIRE;BAC PROFESSIONNEL;BAC PRO SERV;BAC PRO 31106 LOGISTIQUE;12;12;9;2;1;0;1;9;0;0;1;7;1;3
8187.0;2021;25;VERSAILLES;FEMININ;SCOLAIRE;BAC PROFESSIONNEL;BAC PRO SERV;BAC PRO 32207 REAL.PR.IMPR.PLURI.OPTA.PR.GRAPH.;12;12;10;2;0;0;0;10;0;1;4;1;4;2
8188.0;2021;25;VERSAILLES;FEMININ;SCOLAIRE;BAC PROFESSIONNEL;BAC PRO SERV;BAC PRO 32208 REAL.PR.IMPR.PLURI.OPTB.PR.IMPR.;2;2;2;0;0;0;0;2;0;1;0;0;1;0
8189.0;2021;25;VERSAILLES;FEMININ;SCOLAIRE;BAC PROFESSIONNEL;BAC PRO SERV;BAC PRO 32303 ART.& MET.ART:COM.VIS.VIS.PLURI-M;63;62;56;5;1;1;0;57;0;5;18;19;15;5
8192.0;2021;25;VERSAILLES;FEMININ;SCOLAIRE;BAC PROFESSIONNEL;BAC PRO SERV;BAC PRO 33003 ACC.SOINS-S.PERS. OPT.A DOMICILE;98;98;94;2;2;1;1;95;0;10;32;32;21;3
8204.0;2021;25;VERSAILLES;FEMININ;SCOLAIRE;BAC TECHNOLOGIQUE;BAC STAV;BAC STAV AGRONOMIE ALIM ENV TERRITOI;35;35;34;1;0;0;0;34;0;1;9;15;9;1
8205.0;2021;25;VERSAILLES;FEMININ;SCOLAIRE;BAC TECHNOLOGIQUE;BAC STD2A;BAC STD2A SCIENCES & TECHNO. DESIGN-ARTS APPLIQUES;164;164;164;0;0;0;0;164;2;9;51;77;25;0
8222.0;2021;25;VERSAILLES;MASCULIN;APPRENTISSAGE;BAC PROFESSIONNEL;BAC PRO PROD;BAC PRO 23203 TECHNICIEN BAT. : ORG.REAL.GROS O;16;16;14;0;2;2;0;16;0;0;2;7;7;0
8234.0;2021;25;VERSAILLES;MASCULIN;APPRENTISSAGE;BAC PROFESSIONNEL;BAC PRO PROD;BAC PRO 25411 TECH.CHAUDRONNERIE INDUSTRIELLE;22;22;16;5;1;1;0;17;0;0;5;7;5;5
8235.0;2021;25;VERSAILLES;MASCULIN;APPRENTISSAGE;BAC PROFESSIONNEL;BAC PRO PROD;BAC PRO 25510 METIERS ELECT. ENVIRON. CONNECTES;193;190;146;39;5;2;3;148;0;16;35;53;44;42
8236.0;2021;25;VERSAILLES;MASCULIN;APPRENTISSAGE;BAC PROFESSIONNEL;BAC PRO PROD;BAC PRO 25513 SYST.NUM.OPT.A SURETE SECURITE;2;2;2;0;0;0;0;2;0;0;0;1;1;0
8244.0;2021;25;VERSAILLES;MASCULIN;APPRENTISSAGE;BAC PROFESSIONNEL;BAC PRO SERV;BAC PRO 31107 CONDUCT. TRANSP.ROUT.MARCHANDISES;12;12;12;0;0;0;0;12;0;0;4;7;1;0
8245.0;2021;25;VERSAILLES;MASCULIN;APPRENTISSAGE;BAC PROFESSIONNEL;BAC PRO SERV;BAC PRO 31109 TRANSPORT FLUVIAL;17;17;16;1;0;0;0;16;0;3;4;8;1;1
8251.0;2021;25;VERSAILLES;MASCULIN;APPRENTISSAGE;BAC PROFESSIONNEL;BAC PRO SERV;BAC PRO 34403 METIERS DE LA SECURITE;20;20;19;0;1;0;1;19;0;3;2;6;8;1
8263.0;2021;25;VERSAILLES;MASCULIN;FORMATION CONTINUE;BAC PROFESSIONNEL;BAC PRO PROD;BAC PRO 22106 CUISINE;2;2;2;0;0;0;0;2;0;1;1;0;0;0
8265.0;2021;25;VERSAILLES;MASCULIN;FORMATION CONTINUE;BAC PROFESSIONNEL;BAC PRO PROD;BAC PRO 23004 TECHN. ETUDES BAT.A ETUDES & ECO.;2;2;2;0;0;0;0;2;0;0;0;2;0;0
8278.0;2021;25;VERSAILLES;MASCULIN;INDIVIDUEL;BAC PROFESSIONNEL;BAC PRO PROD;BAC PRO 22704 TECHN. MAINT. SYST.ENERG.CLIMATI;1;1;0;1;0;0;0;0;0;0;0;0;0;1
8284.0;2021;25;VERSAILLES;MASCULIN;INDIVIDUEL;BAC PROFESSIONNEL;BAC PRO PROD;BAC PRO 25106 TECHNICIEN D'USINAGE;2;1;0;1;0;0;0;0;0;0;0;0;0;1
8294.0;2021;25;VERSAILLES;MASCULIN;INDIVIDUEL;BAC PROFESSIONNEL;BAC PRO PROD;BAC PRO AG 21211 COND GEST ENTR HIPPIQUE;1;1;1;0;0;0;0;1;0;0;0;0;1;0
8301.0;2021;25;VERSAILLES;MASCULIN;INDIVIDUEL;BAC PROFESSIONNEL;BAC PRO SERV;BAC PRO 31206 VENTE (PROSPECT.NEGO.SUIV.CLIENT;7;4;2;2;0;0;0;2;0;0;0;1;1;2
8307.0;2021;25;VERSAILLES;MASCULIN;INDIVIDUEL;BAC PROFESSIONNEL;BAC PRO SERV;BAC PRO 33403 COMMERC. SERVICES EN RESTAURATION;4;1;0;0;1;1;0;1;0;0;0;0;1;0
8309.0;2021;25;VERSAILLES;MASCULIN;INDIVIDUEL;BAC TECHNOLOGIQUE;BAC ST2S;BAC ST2S SCIENCES & TECHNO. SANTE & SOCIAL;10;5;1;3;1;1;0;2;0;0;0;1;1;3
8313.0;2021;25;VERSAILLES;MASCULIN;INDIVIDUEL;BAC TECHNOLOGIQUE;BAC STI2D;BAC STI2D ARCHITECTURE ET CONSTRUCTION;4;1;0;0;1;0;1;0;0;0;0;0;0;1
8318.0;2021;25;VERSAILLES;MASCULIN;INDIVIDUEL;BAC TECHNOLOGIQUE;BAC STMG;BAC STMG MERCATIQUE (MARKETING);75;55;25;15;15;11;4;36;0;0;3;6;27;19
8319.0;2021;25;VERSAILLES;MASCULIN;INDIVIDUEL;BAC TECHNOLOGIQUE;BAC STMG;BAC STMG RESSOURCES HUMAINES ET COMMUNICATION;36;21;6;9;6;6;0;12;0;0;0;1;11;9
8326.0;2021;25;VERSAILLES;MASCULIN;SCOLAIRE;BAC PROFESSIONNEL;BAC PRO PROD;BAC PRO 22106 CUISINE;181;181;144;28;9;4;5;148;0;6;43;58;41;33
8328.0;2021;25;VERSAILLES;MASCULIN;SCOLAIRE;BAC PROFESSIONNEL;BAC PRO PROD;BAC PRO 22703 TECHN.INSTALL.SYST.ENERG.CLIMATI;144;140;88;38;14;7;7;95;0;3;12;37;43;45
8329.0;2021;25;VERSAILLES;MASCULIN;SCOLAIRE;BAC PROFESSIONNEL;BAC PRO PROD;BAC PRO 22704 TECHN. MAINT. SYST.ENERG.CLIMATI;108;108;65;36;7;5;2;70;0;1;11;23;35;38
8333.0;2021;25;VERSAILLES;MASCULIN;SCOLAIRE;BAC PROFESSIONNEL;BAC PRO PROD;BAC PRO 23102 TRAVAUX PUBLICS;11;11;8;3;0;0;0;8;0;0;0;4;4;3
8336.0;2021;25;VERSAILLES;MASCULIN;SCOLAIRE;BAC PROFESSIONNEL;BAC PRO PROD;BAC PRO 23303 MENUISERIE ALUMINIUM-VERRE;18;18;7;7;4;0;4;7;0;1;1;1;4;11
8341.0;2021;25;VERSAILLES;MASCULIN;SCOLAIRE;BAC PROFESSIONNEL;BAC PRO PROD;BAC PRO 24203 METIERS DE LA MODE - VÊTEMENT;13;13;10;3;0;0;0;10;0;2;3;4;1;3
8344.0;2021;25;VERSAILLES;MASCULIN;SCOLAIRE;BAC PROFESSIONNEL;BAC PRO PROD;BAC PRO 25007 MAINTENANCE EQUIPEMENTS INDUST.;242;242;164;54;24;15;9;179;0;7;24;78;70;63
8346.0;2021;25;VERSAILLES;MASCULIN;SCOLAIRE;BAC PROFESSIONNEL;BAC PRO PROD;BAC PRO 25106 TECHNICIEN D'USINAGE;141;139;87;46;6;1;5;88;0;5;14;25;44;51
8347.0;2021;25;VERSAILLES;MASCULIN;SCOLAIRE;BAC PROFESSIONNEL;BAC PRO PROD;BAC PRO 25108 TECHNICIEN MODELEUR;19;19;19;0;0;0;0;19;0;5;4;5;5;0
8348.0;2021;25;VERSAILLES;MASCULIN;SCOLAIRE;BAC PROFESSIONNEL;BAC PRO PROD;BAC PRO 25214 MAINT.VEHIC.OPTA VOIT.PARTICUL.;370;370;306;49;15;14;1;320;0;20;75;125;100;50
8351.0;2021;25;VERSAILLES;MASCULIN;SCOLAIRE;BAC PROFESSIONNEL;BAC PRO PROD;BAC PRO 25219 MAINT.MATERIELS OPT.A AGRICOLES;6;6;3;3;0;0;0;3;0;0;1;1;1;3
8352.0;2021;25;VERSAILLES;MASCULIN;SCOLAIRE;BAC PROFESSIONNEL;BAC PRO PROD;BAC PRO 25220 MAINT.MATERIELS OPT.B TP MANUT.;25;25;16;5;4;3;1;19;0;0;2;11;6;6
8355.0;2021;25;VERSAILLES;MASCULIN;SCOLAIRE;BAC PROFESSIONNEL;BAC PRO PROD;BAC PRO 25303 AERONAUTIQUE OPTION SYSTEMES;35;35;34;0;1;0;1;34;0;0;9;16;9;1
8358.0;2021;25;VERSAILLES;MASCULIN;SCOLAIRE;BAC PROFESSIONNEL;BAC PRO PROD;BAC PRO 25408 REPARATION DES CARROSSERIES;79;79;63;11;5;4;1;67;0;0;3;37;27;12
8362.0;2021;25;VERSAILLES;MASCULIN;SCOLAIRE;BAC PROFESSIONNEL;BAC PRO PROD;BAC PRO 25510 METIERS ELECT. ENVIRON. CONNECTES;1230;1223;937;250;36;20;16;957;0;53;173;344;387;266
8366.0;2021;25;VERSAILLES;MASCULIN;SCOLAIRE;BAC PROFESSIONNEL;BAC PRO PROD;BAC PRO AG 21004 CGEA;10;10;10;0;0;0;0;10;0;0;3;1;6;0
8371.0;2021;25;VERSAILLES;MASCULIN;SCOLAIRE;BAC PROFESSIONNEL;BAC PRO PROD;BAC PRO AG 21405 AMENAGEMENTS PAYSAGERS;43;41;41;0;0;0;0;41;0;0;4;25;12;0
8383.0;2021;25;VERSAILLES;MASCULIN;SCOLAIRE;BAC PROFESSIONNEL;BAC PRO SERV;BAC PRO 32304 PHOTOGRAPHIE;11;10;9;1;0;0;0;9;0;1;1;4;3;1
8388.0;2021;25;VERSAILLES;MASCULIN;SCOLAIRE;BAC PROFESSIONNEL;BAC PRO SERV;BAC PRO 33102 PROTHESE DENTAIRE;3;2;0;2;0;0;0;0;0;0;0;0;0;2
8406.0;2021;25;VERSAILLES;MASCULIN;SCOLAIRE;BAC TECHNOLOGIQUE;BAC STMG;BAC STMG RESSOURCES HUMAINES ET COMMUNICATION;865;864;679;66;119;77;42;756;0;3;48;244;461;108
8410.0;2022;02;AIX-MARSEILLE;FEMININ;APPRENTISSAGE;BAC PROFESSIONNEL;BAC PRO PROD;BAC PRO 25007 MAINTENANCE EQUIPEMENTS INDUST.;1;1;1;0;0;0;0;1;0;1;0;0;0;0
8419.0;2022;02;AIX-MARSEILLE;FEMININ;APPRENTISSAGE;BAC PROFESSIONNEL;BAC PRO PROD;BAC PRO AG 21114 CONDUITE PRODUCTIONS HORTICOLES;4;2;2;0;0;0;0;2;0;0;0;0;2;0
8429.0;2022;02;AIX-MARSEILLE;FEMININ;APPRENTISSAGE;BAC PROFESSIONNEL;BAC PRO SERV;BAC PRO 31212 METIERS DE L'ACCUEIL;20;17;12;4;1;0;1;12;0;0;3;5;4;5
8431.0;2022;02;AIX-MARSEILLE;FEMININ;APPRENTISSAGE;BAC PROFESSIONNEL;BAC PRO SERV;BAC PRO 31214 MET.COM.VEN.OP.B PR.CL.VA.OF.COM.;6;5;4;1;0;0;0;4;0;0;1;2;1;1
8434.0;2022;02;AIX-MARSEILLE;FEMININ;APPRENTISSAGE;BAC PROFESSIONNEL;BAC PRO SERV;BAC PRO 33102 PROTHESE DENTAIRE;17;16;16;0;0;0;0;16;0;2;6;4;4;0
8436.0;2022;02;AIX-MARSEILLE;FEMININ;APPRENTISSAGE;BAC PROFESSIONNEL;BAC PRO SERV;BAC PRO 33603 ESTHETIQUE COSMETIQUE PARFUMERIE;1;1;1;0;0;0;0;1;0;0;0;0;1;0
8437.0;2022;02;AIX-MARSEILLE;FEMININ;APPRENTISSAGE;BAC PROFESSIONNEL;BAC PRO SERV;BAC PRO 34304 HYGIENE PROPRETE STERILISATION;5;5;5;0;0;0;0;5;0;2;0;0;3;0
8440.0;2022;02;AIX-MARSEILLE;FEMININ;ENSEIGNEMENT A DISTANCE;BAC PROFESSIONNEL;BAC PRO SERV;BAC PRO 30001 GESTION-ADMINISTRATION;3;2;2;0;0;0;0;2;0;1;0;0;1;0
8452.0;2022;02;AIX-MARSEILLE;FEMININ;FORMATION CONTINUE;BAC PROFESSIONNEL;BAC PRO PROD;BAC PRO 25510 METIERS ELECT. ENVIRON. CONNECTES;1;1;1;0;0;0;0;1;0;0;1;0;0;0
8453.0;2022;02;AIX-MARSEILLE;FEMININ;FORMATION CONTINUE;BAC PROFESSIONNEL;BAC PRO PROD;BAC PRO 25515 SYST.NUM.OPT.C RES.INF.SYST.COMM.;1;1;1;0;0;0;0;1;0;0;0;1;0;0
8456.0;2022;02;AIX-MARSEILLE;FEMININ;FORMATION CONTINUE;BAC PROFESSIONNEL;BAC PRO SERV;BAC PRO 31213 MET.COM.VEN.OP.A ANI.GES.ESP.COM.;9;6;2;4;0;0;0;2;0;0;1;0;1;4
8458.0;2022;02;AIX-MARSEILLE;FEMININ;FORMATION CONTINUE;BAC PROFESSIONNEL;BAC PRO SERV;BAC PRO 33403 COMMERC. SERVICES EN RESTAURATION;2;2;0;2;0;0;0;0;0;0;0;0;0;2
8459.0;2022;02;AIX-MARSEILLE;FEMININ;FORMATION CONTINUE;BAC PROFESSIONNEL;BAC PRO SERV;BAC PRO 33603 ESTHETIQUE COSMETIQUE PARFUMERIE;7;7;7;0;0;0;0;7;0;0;2;2;3;0
8463.0;2022;02;AIX-MARSEILLE;FEMININ;INDIVIDUEL;BAC PROFESSIONNEL;BAC PRO PROD;BAC PRO AG 21004 CGEA;5;4;4;0;0;0;0;4;0;0;0;0;4;0
8465.0;2022;02;AIX-MARSEILLE;FEMININ;INDIVIDUEL;BAC PROFESSIONNEL;BAC PRO PROD;BAC PRO AG 21114 CONDUITE PRODUCTIONS HORTICOLES;3;3;3;0;0;0;0;3;0;0;0;0;3;0
8468.0;2022;02;AIX-MARSEILLE;FEMININ;INDIVIDUEL;BAC PROFESSIONNEL;BAC PRO SERV;BAC PRO 31213 MET.COM.VEN.OP.A ANI.GES.ESP.COM.;4;0;0;0;0;0;0;0;0;0;0;0;0;0
8472.0;2022;02;AIX-MARSEILLE;FEMININ;INDIVIDUEL;BAC PROFESSIONNEL;BAC PRO SERV;BAC PRO 34304 HYGIENE PROPRETE STERILISATION;2;0;0;0;0;0;0;0;0;0;0;0;0;0
8476.0;2022;02;AIX-MARSEILLE;FEMININ;INDIVIDUEL;BAC TECHNOLOGIQUE;BAC STI2D;BAC STI2D ARCHITECTURE ET CONSTRUCTION;1;1;0;1;0;0;0;0;0;0;0;0;0;1
8482.0;2022;02;AIX-MARSEILLE;FEMININ;SCOLAIRE;BAC PROFESSIONNEL;BAC PRO PROD;BACPRO 20002 ETUD.DEFINITION PRDTS INDUSTRIEL;7;7;5;2;0;0;0;5;0;0;0;4;1;2
8484.0;2022;02;AIX-MARSEILLE;FEMININ;SCOLAIRE;BAC PROFESSIONNEL;BAC PRO PROD;BAC PRO 22003 BIO-INDUSTRIES DE TRANSFORMATION;17;17;10;6;1;1;0;11;0;0;1;6;4;6
8486.0;2022;02;AIX-MARSEILLE;FEMININ;SCOLAIRE;BAC PROFESSIONNEL;BAC PRO PROD;BAC PRO 22105 BOULANGER-PÂTISSIER;10;10;10;0;0;0;0;10;0;1;4;4;1;0
8487.0;2022;02;AIX-MARSEILLE;FEMININ;SCOLAIRE;BAC PROFESSIONNEL;BAC PRO PROD;BAC PRO 22106 CUISINE;44;44;38;5;1;1;0;39;0;2;12;15;10;5
8490.0;2022;02;AIX-MARSEILLE;FEMININ;SCOLAIRE;BAC PROFESSIONNEL;BAC PRO PROD;BAC PRO 23004 TECHN. ETUDES BAT.A ETUDES & ECO.;9;9;9;0;0;0;0;9;0;0;3;1;5;0
8503.0;2022;02;AIX-MARSEILLE;FEMININ;SCOLAIRE;BAC PROFESSIONNEL;BAC PRO PROD;BAC PRO 25215 MAINT.VEHIC.OPTB VEHIC.TRANS.ROUT;1;1;1;0;0;0;0;1;0;0;1;0;0;0
8509.0;2022;02;AIX-MARSEILLE;FEMININ;SCOLAIRE;BAC PROFESSIONNEL;BAC PRO PROD;BAC PRO 25513 SYST.NUM.OPT.A SURETE SECURITE;1;1;1;0;0;0;0;1;0;0;1;0;0;0
8524.0;2022;02;AIX-MARSEILLE;FEMININ;SCOLAIRE;BAC PROFESSIONNEL;BAC PRO PROD;BAC PRO AG 22107 TEC CONS VTE ALIMENTATION P.ALIM;18;18;16;2;0;0;0;16;0;0;0;4;12;2
8525.0;2022;02;AIX-MARSEILLE;FEMININ;SCOLAIRE;BAC PROFESSIONNEL;BAC PRO SERV;BAC PRO 30001 GESTION-ADMINISTRATION;647;646;508;108;30;19;11;527;0;26;81;192;228;119
8529.0;2022;02;AIX-MARSEILLE;FEMININ;SCOLAIRE;BAC PROFESSIONNEL;BAC PRO SERV;BAC PRO 31212 METIERS DE L'ACCUEIL;330;328;263;47;18;13;5;276;0;12;59;92;113;52
8539.0;2022;02;AIX-MARSEILLE;FEMININ;SCOLAIRE;BAC PROFESSIONNEL;BAC PRO SERV;BAC PRO 33101 OPTIQUE LUNETTERIE;12;12;11;1;0;0;0;11;0;2;3;2;4;1
8541.0;2022;02;AIX-MARSEILLE;FEMININ;SCOLAIRE;BAC PROFESSIONNEL;BAC PRO SERV;BAC PRO 33103 TECHNICIEN APPAREIL. ORTHOPEDIQUE;3;3;0;3;0;0;0;0;0;0;0;0;0;3
8543.0;2022;02;AIX-MARSEILLE;FEMININ;SCOLAIRE;BAC PROFESSIONNEL;BAC PRO SERV;BAC PRO 33603 ESTHETIQUE COSMETIQUE PARFUMERIE;164;162;143;15;4;1;3;144;0;9;28;52;55;18
8544.0;2022;02;AIX-MARSEILLE;FEMININ;SCOLAIRE;BAC PROFESSIONNEL;BAC PRO SERV;BAC PRO 34304 HYGIENE PROPRETE STERILISATION;8;8;7;1;0;0;0;7;0;0;1;2;4;1
8546.0;2022;02;AIX-MARSEILLE;FEMININ;SCOLAIRE;BAC PROFESSIONNEL;BAC PRO SERV;BAC PRO AG 33002 SERV PERS TERRIT;207;200;176;24;0;0;0;176;0;1;11;60;104;24
8553.0;2022;02;AIX-MARSEILLE;FEMININ;SCOLAIRE;BAC TECHNOLOGIQUE;BAC STI2D;BAC STI2D ENERGIES  ET ENVIRONNEMENT;13;13;7;1;5;2;3;9;0;0;3;2;4;4
8569.0;2022;02;AIX-MARSEILLE;MASCULIN;APPRENTISSAGE;BAC PROFESSIONNEL;BAC PRO PROD;BAC PRO 23102 TRAVAUX PUBLICS;14;14;13;0;1;0;1;13;0;0;2;8;3;1
8581.0;2022;02;AIX-MARSEILLE;MASCULIN;APPRENTISSAGE;BAC PROFESSIONNEL;BAC PRO PROD;BAC PRO 25219 MAINT.MATERIELS OPT.A AGRICOLES;2;2;1;0;1;1;0;2;0;0;0;0;2;0
8582.0;2022;02;AIX-MARSEILLE;MASCULIN;APPRENTISSAGE;BAC PROFESSIONNEL;BAC PRO PROD;BAC PRO 25220 MAINT.MATERIELS OPT.B TP MANUT.;12;12;9;2;1;1;0;10;0;1;2;1;6;2
8590.0;2022;02;AIX-MARSEILLE;MASCULIN;APPRENTISSAGE;BAC PROFESSIONNEL;BAC PRO PROD;BAC PRO AG 21004 CGEA;7;7;7;0;0;0;0;7;0;0;2;0;5;0
8592.0;2022;02;AIX-MARSEILLE;MASCULIN;APPRENTISSAGE;BAC PROFESSIONNEL;BAC PRO PROD;BAC PRO AG 21114 CONDUITE PRODUCTIONS HORTICOLES;11;11;9;2;0;0;0;9;0;0;1;1;7;2
8605.0;2022;02;AIX-MARSEILLE;MASCULIN;APPRENTISSAGE;BAC PROFESSIONNEL;BAC PRO SERV;BAC PRO 32208 REAL.PR.IMPR.PLURI.OPTB.PR.IMPR.;5;5;3;0;2;1;1;4;0;0;1;1;2;1
8611.0;2022;02;AIX-MARSEILLE;MASCULIN;APPRENTISSAGE;BAC PROFESSIONNEL;BAC PRO SERV;BAC PRO AG 33002 SERV PERS TERRIT;3;3;3;0;0;0;0;3;0;0;1;0;2;0
8622.0;2022;02;AIX-MARSEILLE;MASCULIN;FORMATION CONTINUE;BAC PROFESSIONNEL;BAC PRO PROD;BAC PRO 22704 TECHN. MAINT. SYST.ENERG.CLIMATI;6;6;3;3;0;0;0;3;0;0;2;0;1;3
8624.0;2022;02;AIX-MARSEILLE;MASCULIN;FORMATION CONTINUE;BAC PROFESSIONNEL;BAC PRO PROD;BAC PRO 25411 TECH.CHAUDRONNERIE INDUSTRIELLE;2;2;2;0;0;0;0;2;0;0;0;2;0;0
8628.0;2022;02;AIX-MARSEILLE;MASCULIN;FORMATION CONTINUE;BAC PROFESSIONNEL;BAC PRO SERV;BAC PRO 31212 METIERS DE L'ACCUEIL;3;3;2;1;0;0;0;2;0;0;1;1;0;1
8630.0;2022;02;AIX-MARSEILLE;MASCULIN;FORMATION CONTINUE;BAC PROFESSIONNEL;BAC PRO SERV;BAC PRO 32304 PHOTOGRAPHIE;4;3;3;0;0;0;0;3;0;0;1;0;2;0
8632.0;2022;02;AIX-MARSEILLE;MASCULIN;INDIVIDUEL;BAC PROFESSIONNEL;BAC PRO PROD;BAC PRO 22106 CUISINE;1;1;0;1;0;0;0;0;0;0;0;0;0;1
8634.0;2022;02;AIX-MARSEILLE;MASCULIN;INDIVIDUEL;BAC PROFESSIONNEL;BAC PRO PROD;BAC PRO 25214 MAINT.VEHIC.OPTA VOIT.PARTICUL.;1;1;0;1;0;0;0;0;0;0;0;0;0;1
8635.0;2022;02;AIX-MARSEILLE;MASCULIN;INDIVIDUEL;BAC PROFESSIONNEL;BAC PRO PROD;BAC PRO 25509 TECHNIC. FROID CONDITIONNEMT AIR;2;1;1;0;0;0;0;1;0;0;0;0;1;0
8638.0;2022;02;AIX-MARSEILLE;MASCULIN;INDIVIDUEL;BAC PROFESSIONNEL;BAC PRO PROD;BAC PRO 25514 SYST.NUM.OPT.B AUD.RES.EQUIP.DOM.;1;0;0;0;0;0;0;0;0;0;0;0;0;0
8639.0;2022;02;AIX-MARSEILLE;MASCULIN;INDIVIDUEL;BAC PROFESSIONNEL;BAC PRO PROD;BAC PRO AG 21004 CGEA;6;4;4;0;0;0;0;4;0;0;0;0;4;0
8640.0;2022;02;AIX-MARSEILLE;MASCULIN;INDIVIDUEL;BAC PROFESSIONNEL;BAC PRO PROD;BAC PRO AG 21113 CGEVV;5;3;3;0;0;0;0;3;0;0;0;0;3;0
8643.0;2022;02;AIX-MARSEILLE;MASCULIN;INDIVIDUEL;BAC PROFESSIONNEL;BAC PRO PROD;BAC PRO AG 21211 COND GEST ENTR HIPPIQUE;1;0;0;0;0;0;0;0;0;0;0;0;0;0
8652.0;2022;02;AIX-MARSEILLE;MASCULIN;INDIVIDUEL;BAC PROFESSIONNEL;BAC PRO SERV;BAC PRO 33101 OPTIQUE LUNETTERIE;1;1;1;0;0;0;0;1;0;0;0;1;0;0
8655.0;2022;02;AIX-MARSEILLE;MASCULIN;INDIVIDUEL;BAC TECHNOLOGIQUE;BAC STHR;BAC STHR SC.&TEC. HOTELLERIE-RESTAURATION;9;9;9;0;0;0;0;9;0;0;1;3;5;0
8656.0;2022;02;AIX-MARSEILLE;MASCULIN;INDIVIDUEL;BAC TECHNOLOGIQUE;BAC STI2D;BAC STI2D ARCHITECTURE ET CONSTRUCTION;2;0;0;0;0;0;0;0;0;0;0;0;0;0
8663.0;2022;02;AIX-MARSEILLE;MASCULIN;INDIVIDUEL;BAC TECHNOLOGIQUE;BAC STMG;BAC STMG RESSOURCES HUMAINES ET COMMUNICATION;16;9;6;1;2;1;1;7;0;0;0;2;5;2
8665.0;2022;02;AIX-MARSEILLE;MASCULIN;SCOLAIRE;BAC GENERAL;BAC GENERAL;BAC GENE 10019 BAC GENERAL;7303;7303;6677;121;505;344;161;7021;149;887;1702;2192;2091;282
8667.0;2022;02;AIX-MARSEILLE;MASCULIN;SCOLAIRE;BAC PROFESSIONNEL;BAC PRO PROD;BAC PRO 20102 PILOTE DE LIGNE DE PRODUCTION;3;3;1;1;1;0;1;1;0;0;0;1;0;2
8675.0;2022;02;AIX-MARSEILLE;MASCULIN;SCOLAIRE;BAC PROFESSIONNEL;BAC PRO PROD;BAC PRO 22704 TECHN. MAINT. SYST.ENERG.CLIMATI;52;51;34;15;2;2;0;36;0;0;3;15;18;15
8687.0;2022;02;AIX-MARSEILLE;MASCULIN;SCOLAIRE;BAC PROFESSIONNEL;BAC PRO PROD;BAC PRO 24203 METIERS DE LA MODE - VÊTEMENT;7;7;5;2;0;0;0;5;0;0;2;1;2;2
8693.0;2022;02;AIX-MARSEILLE;MASCULIN;SCOLAIRE;BAC PROFESSIONNEL;BAC PRO PROD;BAC PRO 25214 MAINT.VEHIC.OPTA VOIT.PARTICUL.;130;130;94;26;10;6;4;100;0;5;23;29;43;30
8709.0;2022;02;AIX-MARSEILLE;MASCULIN;SCOLAIRE;BAC PROFESSIONNEL;BAC PRO PROD;BAC PRO 25515 SYST.NUM.OPT.C RES.INF.SYST.COMM.;273;271;219;46;6;6;0;225;0;6;68;82;69;46
8710.0;2022;02;AIX-MARSEILLE;MASCULIN;SCOLAIRE;BAC PROFESSIONNEL;BAC PRO PROD;BAC PRO AG 21001 AGRO-EQUIPEMENT;11;11;10;1;0;0;0;10;0;0;1;3;6;1
8722.0;2022;02;AIX-MARSEILLE;MASCULIN;SCOLAIRE;BAC PROFESSIONNEL;BAC PRO SERV;BAC PRO 30001 GESTION-ADMINISTRATION;277;276;204;64;8;6;2;210;0;3;26;75;106;66
8725.0;2022;02;AIX-MARSEILLE;MASCULIN;SCOLAIRE;BAC PROFESSIONNEL;BAC PRO SERV;BAC PRO 31108 TRANSPORT;44;44;31;12;1;1;0;32;0;3;4;11;14;12
8739.0;2022;02;AIX-MARSEILLE;MASCULIN;SCOLAIRE;BAC PROFESSIONNEL;BAC PRO SERV;BAC PRO 33403 COMMERC. SERVICES EN RESTAURATION;53;53;41;12;0;0;0;41;0;1;5;21;14;12
8741.0;2022;02;AIX-MARSEILLE;MASCULIN;SCOLAIRE;BAC PROFESSIONNEL;BAC PRO SERV;BAC PRO 34403 METIERS DE LA SECURITE;45;45;44;1;0;0;0;44;0;2;10;21;11;1
8743.0;2022;02;AIX-MARSEILLE;MASCULIN;SCOLAIRE;BAC TECHNOLOGIQUE;BAC S2TMD;BAC S2TMD MUSIQUE;6;6;5;1;0;0;0;5;0;0;1;3;1;1
8749.0;2022;02;AIX-MARSEILLE;MASCULIN;SCOLAIRE;BAC TECHNOLOGIQUE;BAC STI2D;BAC STI2D ENERGIES  ET ENVIRONNEMENT;200;200;170;6;24;16;8;186;0;2;19;72;93;14
8750.0;2022;02;AIX-MARSEILLE;MASCULIN;SCOLAIRE;BAC TECHNOLOGIQUE;BAC STI2D;BAC STI2D INNOVATION TECHNO.  ET ECO CONCEPTION;347;347;282;16;49;35;14;317;1;4;36;107;169;30
8752.0;2022;02;AIX-MARSEILLE;MASCULIN;SCOLAIRE;BAC TECHNOLOGIQUE;BAC STL;BAC STL BIOCHIM.-BIOLOGIE-BIOTECHNOL.;67;67;57;2;8;4;4;61;0;1;10;21;29;6
8767.0;2022;20;AMIENS;FEMININ;APPRENTISSAGE;BAC PROFESSIONNEL;BAC PRO PROD;BAC PRO 25510 METIERS ELECT. ENVIRON. CONNECTES;3;3;3;0;0;0;0;3;0;1;0;1;1;0
8769.0;2022;20;AMIENS;FEMININ;APPRENTISSAGE;BAC PROFESSIONNEL;BAC PRO PROD;BAC PRO AG 21114 CONDUITE PRODUCTIONS HORTICOLES;2;2;2;0;0;0;0;2;0;0;0;1;1;0
8771.0;2022;20;AMIENS;FEMININ;APPRENTISSAGE;BAC PROFESSIONNEL;BAC PRO PROD;BAC PRO AG 22106 TEC CONS VTE ALIMENTATION VINS SP;1;1;1;0;0;0;0;1;0;0;0;1;0;0
8773.0;2022;20;AMIENS;FEMININ;APPRENTISSAGE;BAC PROFESSIONNEL;BAC PRO SERV;BAC PRO 30001 GESTION-ADMINISTRATION;20;20;17;3;0;0;0;17;0;2;5;7;3;3
8777.0;2022;20;AMIENS;FEMININ;APPRENTISSAGE;BAC PROFESSIONNEL;BAC PRO SERV;BAC PRO 33403 COMMERC. SERVICES EN RESTAURATION;6;6;5;1;0;0;0;5;0;0;0;3;2;1
8779.0;2022;20;AMIENS;FEMININ;ENSEIGNEMENT A DISTANCE;BAC GENERAL;BAC GENERAL;BAC GENE 10019 BAC GENERAL;27;26;18;4;4;3;1;21;1;3;1;7;9;5
8784.0;2022;20;AMIENS;FEMININ;FORMATION CONTINUE;BAC PROFESSIONNEL;BAC PRO SERV;BAC PRO 31213 MET.COM.VEN.OP.A ANI.GES.ESP.COM.;1;1;0;1;0;0;0;0;0;0;0;0;0;1
8788.0;2022;20;AMIENS;FEMININ;INDIVIDUEL;BAC PROFESSIONNEL;BAC PRO PROD;BAC PRO AG 21114 CONDUITE PRODUCTIONS HORTICOLES;2;1;1;0;0;0;0;1;0;0;0;0;1;0
8795.0;2022;20;AMIENS;FEMININ;INDIVIDUEL;BAC PROFESSIONNEL;BAC PRO SERV;BAC PRO 33003 ACC.SOINS-S.PERS. OPT.A DOMICILE;2;2;1;1;0;0;0;1;0;1;0;0;0;1
8796.0;2022;20;AMIENS;FEMININ;INDIVIDUEL;BAC PROFESSIONNEL;BAC PRO SERV;BAC PRO 33004 ACC.SOINS-S.PERS. OPT.EN STRUCTUR;7;3;3;0;0;0;0;3;0;0;0;1;2;0
8801.0;2022;20;AMIENS;FEMININ;INDIVIDUEL;BAC TECHNOLOGIQUE;BAC STMG;BAC STMG GESTION ET FINANCE;1;1;0;1;0;0;0;0;0;0;0;0;0;1
8820.0;2022;20;AMIENS;FEMININ;SCOLAIRE;BAC PROFESSIONNEL;BAC PRO PROD;BAC PRO 24203 METIERS DE LA MODE - VÊTEMENT;76;76;60;15;1;1;0;61;0;6;16;19;20;15
8821.0;2022;20;AMIENS;FEMININ;SCOLAIRE;BAC PROFESSIONNEL;BAC PRO PROD;BAC PRO 25007 MAINTENANCE EQUIPEMENTS INDUST.;7;7;6;1;0;0;0;6;0;0;2;2;2;1
8829.0;2022;20;AMIENS;FEMININ;SCOLAIRE;BAC PROFESSIONNEL;BAC PRO PROD;BAC PRO 25510 METIERS ELECT. ENVIRON. CONNECTES;4;4;2;0;2;2;0;4;0;0;0;2;2;0
8832.0;2022;20;AMIENS;FEMININ;SCOLAIRE;BAC PROFESSIONNEL;BAC PRO PROD;BAC PRO 25515 SYST.NUM.OPT.C RES.INF.SYST.COMM.;2;2;2;0;0;0;0;2;0;0;1;0;1;0
8835.0;2022;20;AMIENS;FEMININ;SCOLAIRE;BAC PROFESSIONNEL;BAC PRO PROD;BAC PRO AG 21114 CONDUITE PRODUCTIONS HORTICOLES;11;11;10;1;0;0;0;10;0;0;0;3;7;1
8840.0;2022;20;AMIENS;FEMININ;SCOLAIRE;BAC PROFESSIONNEL;BAC PRO PROD;BAC PRO AG 22105 LABORATOIRE CONTROLE QUALITE;3;3;3;0;0;0;0;3;0;0;1;2;0;0
8842.0;2022;20;AMIENS;FEMININ;SCOLAIRE;BAC PROFESSIONNEL;BAC PRO SERV;BAC PRO 30001 GESTION-ADMINISTRATION;395;395;295;71;29;20;9;315;0;6;43;123;143;80
8843.0;2022;20;AMIENS;FEMININ;SCOLAIRE;BAC PROFESSIONNEL;BAC PRO SERV;BAC PRO 31106 LOGISTIQUE;23;23;12;11;0;0;0;12;0;0;4;4;4;11
8844.0;2022;20;AMIENS;FEMININ;SCOLAIRE;BAC PROFESSIONNEL;BAC PRO SERV;BAC PRO 31107 CONDUCT. TRANSP.ROUT.MARCHANDISES;1;1;1;0;0;0;0;1;0;0;0;1;0;0
8871.0;2022;20;AMIENS;FEMININ;SCOLAIRE;BAC TECHNOLOGIQUE;BAC STMG;BAC STMG MERCATIQUE (MARKETING);534;534;432;18;84;58;26;490;0;8;69;161;252;44
8876.0;2022;20;AMIENS;MASCULIN;APPRENTISSAGE;BAC PROFESSIONNEL;BAC PRO PROD;BAC PRO 22503 PLASTIQUES ET COMPOSITES;1;1;1;0;0;0;0;1;0;1;0;0;0;0
8878.0;2022;20;AMIENS;MASCULIN;APPRENTISSAGE;BAC PROFESSIONNEL;BAC PRO PROD;BAC PRO 22704 TECHN. MAINT. SYST.ENERG.CLIMATI;3;3;2;0;1;1;0;3;0;0;1;1;1;0
8883.0;2022;20;AMIENS;MASCULIN;APPRENTISSAGE;BAC PROFESSIONNEL;BAC PRO PROD;BAC PRO 23303 MENUISERIE ALUMINIUM-VERRE;2;2;2;0;0;0;0;2;0;0;1;1;0;0
8885.0;2022;20;AMIENS;MASCULIN;APPRENTISSAGE;BAC PROFESSIONNEL;BAC PRO PROD;BAC PRO 23405 TECHNICIEN MENUISIER AGENCEUR;1;1;1;0;0;0;0;1;0;0;0;1;0;0
8887.0;2022;20;AMIENS;MASCULIN;APPRENTISSAGE;BAC PROFESSIONNEL;BAC PRO PROD;BAC PRO 25009 MAINTENANCE NAUTIQUE;1;1;1;0;0;0;0;1;0;1;0;0;0;0
8889.0;2022;20;AMIENS;MASCULIN;APPRENTISSAGE;BAC PROFESSIONNEL;BAC PRO PROD;BAC PRO 25214 MAINT.VEHIC.OPTA VOIT.PARTICUL.;95;89;72;16;1;1;0;73;0;4;13;27;29;16
8890.0;2022;20;AMIENS;MASCULIN;APPRENTISSAGE;BAC PROFESSIONNEL;BAC PRO PROD;BAC PRO 25215 MAINT.VEHIC.OPTB VEHIC.TRANS.ROUT;17;16;12;3;1;1;0;13;0;0;3;3;7;3
8894.0;2022;20;AMIENS;MASCULIN;APPRENTISSAGE;BAC PROFESSIONNEL;BAC PRO PROD;BAC PRO 25304 AERONAUTIQUE OPTION STRUCTURE;12;12;12;0;0;0;0;12;0;2;9;1;0;0
8896.0;2022;20;AMIENS;MASCULIN;APPRENTISSAGE;BAC PROFESSIONNEL;BAC PRO PROD;BAC PRO 25408 REPARATION DES CARROSSERIES;19;17;13;3;1;0;1;13;0;0;2;4;7;4
8898.0;2022;20;AMIENS;MASCULIN;APPRENTISSAGE;BAC PROFESSIONNEL;BAC PRO PROD;BAC PRO 25509 TECHNIC. FROID CONDITIONNEMT AIR;16;15;14;1;0;0;0;14;0;1;2;7;4;1
8912.0;2022;20;AMIENS;MASCULIN;ENSEIGNEMENT A DISTANCE;BAC PROFESSIONNEL;BAC PRO SERV;BAC PRO 31214 MET.COM.VEN.OP.B PR.CL.VA.OF.COM.;1;0;0;0;0;0;0;0;0;0;0;0;0;0
8923.0;2022;20;AMIENS;MASCULIN;INDIVIDUEL;BAC GENERAL;BAC GENERAL;BAC GENE 10019 BAC GENERAL;38;24;13;2;9;6;3;19;1;2;2;0;14;5
8925.0;2022;20;AMIENS;MASCULIN;INDIVIDUEL;BAC PROFESSIONNEL;BAC PRO PROD;BAC PRO 23304 AMENAGEMENT FINITION BATIMENT;1;1;0;1;0;0;0;0;0;0;0;0;0;1
8926.0;2022;20;AMIENS;MASCULIN;INDIVIDUEL;BAC PROFESSIONNEL;BAC PRO PROD;BAC PRO 25106 TECHNICIEN D'USINAGE;1;0;0;0;0;0;0;0;0;0;0;0;0;0
8935.0;2022;20;AMIENS;MASCULIN;INDIVIDUEL;BAC PROFESSIONNEL;BAC PRO SERV;BAC PRO 31213 MET.COM.VEN.OP.A ANI.GES.ESP.COM.;5;2;1;1;0;0;0;1;0;0;0;1;0;1
8946.0;2022;20;AMIENS;MASCULIN;SCOLAIRE;BAC GENERAL;BAC GENERAL;BAC GENE 10019 BAC GENERAL;4250;4249;3745;110;394;254;140;3999;66;451;846;1293;1343;250
8947.0;2022;20;AMIENS;MASCULIN;SCOLAIRE;BAC PROFESSIONNEL;BAC PRO PROD;BACPRO 20002 ETUD.DEFINITION PRDTS INDUSTRIEL;23;23;17;6;0;0;0;17;0;0;2;10;5;6
8949.0;2022;20;AMIENS;MASCULIN;SCOLAIRE;BAC PROFESSIONNEL;BAC PRO PROD;BAC PRO 22004 PROC. CHIMIE EAU PAPIERS-CARTONS;10;10;9;1;0;0;0;9;0;0;2;3;4;1
8956.0;2022;20;AMIENS;MASCULIN;SCOLAIRE;BAC PROFESSIONNEL;BAC PRO PROD;BAC PRO 22704 TECHN. MAINT. SYST.ENERG.CLIMATI;15;15;12;3;0;0;0;12;0;3;3;3;3;3
8960.0;2022;20;AMIENS;MASCULIN;SCOLAIRE;BAC PROFESSIONNEL;BAC PRO PROD;BACPRO 23103 TECHNICIEN GEOMETRE-TOPOGRAPHE;2;2;2;0;0;0;0;2;0;1;0;0;1;0
8962.0;2022;20;AMIENS;MASCULIN;SCOLAIRE;BAC PROFESSIONNEL;BAC PRO PROD;BAC PRO 23208 METIERS ET ARTS DE LA PIERRE;3;3;3;0;0;0;0;3;0;0;0;1;2;0
8968.0;2022;20;AMIENS;MASCULIN;SCOLAIRE;BAC PROFESSIONNEL;BAC PRO PROD;BAC PRO 24202 ARTIS.& MET.ART : TAPIS.D'AMEUBL;2;2;1;1;0;0;0;1;0;0;0;1;0;1
8971.0;2022;20;AMIENS;MASCULIN;SCOLAIRE;BAC PROFESSIONNEL;BAC PRO PROD;BAC PRO 25006 MICROTECHNIQUES;13;13;7;6;0;0;0;7;0;0;3;0;4;6
8972.0;2022;20;AMIENS;MASCULIN;SCOLAIRE;BAC PROFESSIONNEL;BAC PRO PROD;BAC PRO 25007 MAINTENANCE EQUIPEMENTS INDUST.;208;207;121;78;8;6;2;127;0;3;26;43;55;80
8979.0;2022;20;AMIENS;MASCULIN;SCOLAIRE;BAC PROFESSIONNEL;BAC PRO PROD;BAC PRO 25219 MAINT.MATERIELS OPT.A AGRICOLES;14;14;11;2;1;1;0;12;0;1;3;2;6;2
8981.0;2022;20;AMIENS;MASCULIN;SCOLAIRE;BAC PROFESSIONNEL;BAC PRO PROD;BAC PRO 25221 MAINT.MATERIELS OPT.C ESP. VERTS;10;10;9;1;0;0;0;9;0;1;0;3;5;1
8982.0;2022;20;AMIENS;MASCULIN;SCOLAIRE;BAC PROFESSIONNEL;BAC PRO PROD;BAC PRO 25303 AERONAUTIQUE OPTION SYSTEMES;14;14;11;3;0;0;0;11;0;1;3;3;4;3
8987.0;2022;20;AMIENS;MASCULIN;SCOLAIRE;BAC PROFESSIONNEL;BAC PRO PROD;BAC PRO 25510 METIERS ELECT. ENVIRON. CONNECTES;456;455;329;94;32;25;7;354;0;17;63;135;139;101
8989.0;2022;20;AMIENS;MASCULIN;SCOLAIRE;BAC PROFESSIONNEL;BAC PRO PROD;BAC PRO 25514 SYST.NUM.OPT.B AUD.RES.EQUIP.DOM.;84;84;74;8;2;1;1;75;0;7;17;35;16;9
8991.0;2022;20;AMIENS;MASCULIN;SCOLAIRE;BAC PROFESSIONNEL;BAC PRO PROD;BAC PRO AG 21001 AGRO-EQUIPEMENT;22;22;19;3;0;0;0;19;0;0;2;4;13;3
8993.0;2022;20;AMIENS;MASCULIN;SCOLAIRE;BAC PROFESSIONNEL;BAC PRO PROD;BAC PRO AG 21113 CGEVV;6;6;6;0;0;0;0;6;0;0;0;2;4;0
9005.0;2022;20;AMIENS;MASCULIN;SCOLAIRE;BAC PROFESSIONNEL;BAC PRO SERV;BAC PRO 31108 TRANSPORT;16;16;9;6;1;1;0;10;0;0;2;1;7;6
9011.0;2022;20;AMIENS;MASCULIN;SCOLAIRE;BAC PROFESSIONNEL;BAC PRO SERV;BAC PRO 33002 SERVICES DE PROXIMITE  VIE LOCAL;13;13;7;4;2;1;1;8;0;1;1;4;2;5
9015.0;2022;20;AMIENS;MASCULIN;SCOLAIRE;BAC PROFESSIONNEL;BAC PRO SERV;BAC PRO 33403 COMMERC. SERVICES EN RESTAURATION;62;62;44;12;6;4;2;48;0;2;8;17;21;14
9019.0;2022;20;AMIENS;MASCULIN;SCOLAIRE;BAC PROFESSIONNEL;BAC PRO SERV;BAC PRO AG 33002 SERV PERS TERRIT;6;6;6;0;0;0;0;6;0;0;1;2;3;0
9020.0;2022;20;AMIENS;MASCULIN;SCOLAIRE;BAC TECHNOLOGIQUE;BAC ST2S;BAC ST2S SCIENCES & TECHNO. SANTE & SOCIAL;125;125;95;8;22;15;7;110;0;3;13;31;63;15
9024.0;2022;20;AMIENS;MASCULIN;SCOLAIRE;BAC TECHNOLOGIQUE;BAC STI2D;BAC STI2D ARCHITECTURE ET CONSTRUCTION;85;85;70;5;10;6;4;76;0;2;8;30;36;9
9026.0;2022;20;AMIENS;MASCULIN;SCOLAIRE;BAC TECHNOLOGIQUE;BAC STI2D;BAC STI2D INNOVATION TECHNO.  ET ECO CONCEPTION;238;238;192;5;41;27;14;219;1;5;17;71;125;19
9027.0;2022;20;AMIENS;MASCULIN;SCOLAIRE;BAC TECHNOLOGIQUE;BAC STI2D;BAC STI2D SYSTÈME D'INFORMATION  ET NUMERIQUE;250;250;214;10;26;16;10;230;3;7;45;70;105;20
9032.0;2022;20;AMIENS;MASCULIN;SCOLAIRE;BAC TECHNOLOGIQUE;BAC STMG;BAC STMG RESSOURCES HUMAINES ET COMMUNICATION;229;229;159;15;55;41;14;200;0;1;13;42;144;29
9033.0;2022;20;AMIENS;MASCULIN;SCOLAIRE;BAC TECHNOLOGIQUE;BAC STMG;BAC STMG SYSTEMES D'INFORMATION DE GESTION;23;23;16;2;5;3;2;19;0;0;1;1;17;4
9034.0;2022;03;BESANCON;FEMININ;APPRENTISSAGE;BAC PROFESSIONNEL;BAC PRO PROD;BAC PRO 22003 BIO-INDUSTRIES DE TRANSFORMATION;1;1;1;0;0;0;0;1;0;0;0;1;0;0
9038.0;2022;03;BESANCON;FEMININ;APPRENTISSAGE;BAC PROFESSIONNEL;BAC PRO PROD;BAC PRO 22704 TECHN. MAINT. SYST.ENERG.CLIMATI;1;1;1;0;0;0;0;1;0;0;0;1;0;0
9050.0;2022;03;BESANCON;FEMININ;APPRENTISSAGE;BAC PROFESSIONNEL;BAC PRO PROD;BAC PRO AG 21211 COND GEST ENTR HIPPIQUE;11;11;10;1;0;0;0;10;0;0;1;2;7;1
9051.0;2022;03;BESANCON;FEMININ;APPRENTISSAGE;BAC PROFESSIONNEL;BAC PRO PROD;BAC PRO AG 21302 GEST MILIEUX NATURELS FAUNE;1;1;1;0;0;0;0;1;0;0;0;0;1;0
9054.0;2022;03;BESANCON;FEMININ;APPRENTISSAGE;BAC PROFESSIONNEL;BAC PRO SERV;BAC PRO 30001 GESTION-ADMINISTRATION;9;9;5;1;3;3;0;8;0;0;2;0;6;1
9055.0;2022;03;BESANCON;FEMININ;APPRENTISSAGE;BAC PROFESSIONNEL;BAC PRO SERV;BAC PRO 31106 LOGISTIQUE;3;3;3;0;0;0;0;3;0;0;1;1;1;0
9064.0;2022;03;BESANCON;FEMININ;APPRENTISSAGE;BAC PROFESSIONNEL;BAC PRO SERV;BAC PRO 33603 ESTHETIQUE COSMETIQUE PARFUMERIE;5;5;5;0;0;0;0;5;0;0;1;2;2;0
9065.0;2022;03;BESANCON;FEMININ;APPRENTISSAGE;BAC PROFESSIONNEL;BAC PRO SERV;BAC PRO 34403 METIERS DE LA SECURITE;3;3;3;0;0;0;0;3;0;0;1;2;0;0
9072.0;2022;03;BESANCON;FEMININ;ENSEIGNEMENT A DISTANCE;BAC TECHNOLOGIQUE;BAC STMG;BAC STMG MERCATIQUE (MARKETING);3;3;3;0;0;0;0;3;0;0;0;1;2;0
9080.0;2022;03;BESANCON;FEMININ;INDIVIDUEL;BAC TECHNOLOGIQUE;BAC ST2S;BAC ST2S SCIENCES & TECHNO. SANTE & SOCIAL;3;1;0;1;0;0;0;0;0;0;0;0;0;1
9090.0;2022;03;BESANCON;FEMININ;SCOLAIRE;BAC PROFESSIONNEL;BAC PRO PROD;BAC PRO 23408 Etude et réalisation d'agencement;23;23;22;1;0;0;0;22;0;4;7;10;1;1
9098.0;2022;03;BESANCON;FEMININ;SCOLAIRE;BAC PROFESSIONNEL;BAC PRO PROD;BAC PRO 25408 REPARATION DES CARROSSERIES;3;3;3;0;0;0;0;3;0;1;1;0;1;0
9099.0;2022;03;BESANCON;FEMININ;SCOLAIRE;BAC PROFESSIONNEL;BAC PRO PROD;BAC PRO 25411 TECH.CHAUDRONNERIE INDUSTRIELLE;2;2;2;0;0;0;0;2;0;1;0;0;1;0
9103.0;2022;03;BESANCON;FEMININ;SCOLAIRE;BAC PROFESSIONNEL;BAC PRO PROD;BAC PRO 25515 SYST.NUM.OPT.C RES.INF.SYST.COMM.;1;1;1;0;0;0;0;1;0;0;1;0;0;0
9108.0;2022;03;BESANCON;FEMININ;SCOLAIRE;BAC PROFESSIONNEL;BAC PRO PROD;BAC PRO AG 21302 GEST MILIEUX NATURELS FAUNE;12;12;11;1;0;0;0;11;0;1;5;1;4;1
9110.0;2022;03;BESANCON;FEMININ;SCOLAIRE;BAC PROFESSIONNEL;BAC PRO PROD;BAC PRO AG 21407 TEC CONS VTE UNIVERS JARDINERIE;2;2;2;0;0;0;0;2;0;0;0;0;2;0
9111.0;2022;03;BESANCON;FEMININ;SCOLAIRE;BAC PROFESSIONNEL;BAC PRO PROD;BAC PRO AG 22107 TEC CONS VTE ALIMENTATION P.ALIM;17;15;12;3;0;0;0;12;0;0;2;5;5;3
9112.0;2022;03;BESANCON;FEMININ;SCOLAIRE;BAC PROFESSIONNEL;BAC PRO SERV;BAC PRO 30001 GESTION-ADMINISTRATION;216;216;164;42;10;8;2;172;0;7;23;65;77;44
9115.0;2022;03;BESANCON;FEMININ;SCOLAIRE;BAC PROFESSIONNEL;BAC PRO SERV;BAC PRO 31212 METIERS DE L'ACCUEIL;49;49;46;0;3;2;1;48;0;4;13;17;14;1
9119.0;2022;03;BESANCON;FEMININ;SCOLAIRE;BAC PROFESSIONNEL;BAC PRO SERV;BAC PRO 33003 ACC.SOINS-S.PERS. OPT.A DOMICILE;42;42;38;4;0;0;0;38;0;2;10;20;6;4
9132.0;2022;03;BESANCON;FEMININ;SCOLAIRE;BAC TECHNOLOGIQUE;BAC STHR;BAC STHR SC.&TEC. HOTELLERIE-RESTAURATION;39;39;38;0;1;1;0;39;0;3;17;8;11;0
9133.0;2022;03;BESANCON;FEMININ;SCOLAIRE;BAC TECHNOLOGIQUE;BAC STI2D;BAC STI2D ARCHITECTURE ET CONSTRUCTION;14;14;11;0;3;2;1;13;0;0;1;4;8;1
9134.0;2022;03;BESANCON;FEMININ;SCOLAIRE;BAC TECHNOLOGIQUE;BAC STI2D;BAC STI2D ENERGIES  ET ENVIRONNEMENT;5;5;3;0;2;2;0;5;0;0;0;1;4;0
9157.0;2022;03;BESANCON;MASCULIN;APPRENTISSAGE;BAC PROFESSIONNEL;BAC PRO PROD;BAC PRO 25005 PRODUCTIQ.MECA. OPT.DECOLLETAGE;1;1;1;0;0;0;0;1;0;0;0;1;0;0
9161.0;2022;03;BESANCON;MASCULIN;APPRENTISSAGE;BAC PROFESSIONNEL;BAC PRO PROD;BAC PRO 25107 TECHNICIEN OUTILLEUR;7;7;5;2;0;0;0;5;0;0;0;1;4;2
9168.0;2022;03;BESANCON;MASCULIN;APPRENTISSAGE;BAC PROFESSIONNEL;BAC PRO PROD;BAC PRO 25406 OUVRAGES DU BATIMENT METALLERIE;5;5;5;0;0;0;0;5;0;0;0;2;3;0
9174.0;2022;03;BESANCON;MASCULIN;APPRENTISSAGE;BAC PROFESSIONNEL;BAC PRO PROD;BAC PRO 25515 SYST.NUM.OPT.C RES.INF.SYST.COMM.;5;5;5;0;0;0;0;5;0;0;2;3;0;0
9175.0;2022;03;BESANCON;MASCULIN;APPRENTISSAGE;BAC PROFESSIONNEL;BAC PRO PROD;BAC PRO AG 21001 AGRO-EQUIPEMENT;24;24;20;4;0;0;0;20;0;0;0;4;16;4
9180.0;2022;03;BESANCON;MASCULIN;APPRENTISSAGE;BAC PROFESSIONNEL;BAC PRO PROD;BAC PRO AG 21303 FORET;16;15;15;0;0;0;0;15;0;2;0;6;7;0
9181.0;2022;03;BESANCON;MASCULIN;APPRENTISSAGE;BAC PROFESSIONNEL;BAC PRO PROD;BAC PRO AG 21405 AMENAGEMENTS PAYSAGERS;58;54;44;10;0;0;0;44;0;0;0;21;23;10
9184.0;2022;03;BESANCON;MASCULIN;APPRENTISSAGE;BAC PROFESSIONNEL;BAC PRO SERV;BAC PRO 31106 LOGISTIQUE;19;19;13;5;1;1;0;14;0;1;3;2;8;5
9196.0;2022;03;BESANCON;MASCULIN;FORMATION CONTINUE;BAC PROFESSIONNEL;BAC PRO PROD;BAC PRO 25509 TECHNIC. FROID CONDITIONNEMT AIR;1;1;1;0;0;0;0;1;0;1;0;0;0;0
9198.0;2022;03;BESANCON;MASCULIN;INDIVIDUEL;BAC GENERAL;BAC GENERAL;BAC GENE 10019 BAC GENERAL;19;15;11;4;0;0;0;11;0;0;3;6;2;4
9200.0;2022;03;BESANCON;MASCULIN;INDIVIDUEL;BAC PROFESSIONNEL;BAC PRO PROD;BAC PRO 25007 MAINTENANCE EQUIPEMENTS INDUST.;1;1;1;0;0;0;0;1;0;0;0;0;1;0
9203.0;2022;03;BESANCON;MASCULIN;INDIVIDUEL;BAC PROFESSIONNEL;BAC PRO PROD;BAC PRO 25515 SYST.NUM.OPT.C RES.INF.SYST.COMM.;1;0;0;0;0;0;0;0;0;0;0;0;0;0
9213.0;2022;03;BESANCON;MASCULIN;INDIVIDUEL;BAC TECHNOLOGIQUE;BAC STMG;BAC STMG GESTION ET FINANCE;2;2;0;0;2;2;0;2;0;0;0;0;2;0
9216.0;2022;03;BESANCON;MASCULIN;SCOLAIRE;BAC PROFESSIONNEL;BAC PRO PROD;BAC PRO 22004 PROC. CHIMIE EAU PAPIERS-CARTONS;9;9;9;0;0;0;0;9;0;2;1;4;2;0
9217.0;2022;03;BESANCON;MASCULIN;SCOLAIRE;BAC PROFESSIONNEL;BAC PRO PROD;BAC PRO 22106 CUISINE;67;67;57;9;1;1;0;58;0;3;11;27;17;9
9218.0;2022;03;BESANCON;MASCULIN;SCOLAIRE;BAC PROFESSIONNEL;BAC PRO PROD;BAC PRO 22503 PLASTIQUES ET COMPOSITES;7;7;6;0;1;0;1;6;0;0;3;2;1;1
9223.0;2022;03;BESANCON;MASCULIN;SCOLAIRE;BAC PROFESSIONNEL;BAC PRO PROD;BAC PRO 23102 TRAVAUX PUBLICS;15;15;12;2;1;1;0;13;0;0;3;7;3;2
9226.0;2022;03;BESANCON;MASCULIN;SCOLAIRE;BAC PROFESSIONNEL;BAC PRO PROD;BAC PRO 23207 INTERV. SUR PATRIMOINE BATI OPT.C;4;4;4;0;0;0;0;4;0;0;1;3;0;0
9236.0;2022;03;BESANCON;MASCULIN;SCOLAIRE;BAC PROFESSIONNEL;BAC PRO PROD;BAC PRO 25007 MAINTENANCE EQUIPEMENTS INDUST.;130;130;91;32;7;5;2;96;0;5;16;33;42;34
9247.0;2022;03;BESANCON;MASCULIN;SCOLAIRE;BAC PROFESSIONNEL;BAC PRO PROD;BAC PRO 25513 SYST.NUM.OPT.A SURETE SECURITE;36;36;25;9;2;2;0;27;0;0;4;12;11;9
9248.0;2022;03;BESANCON;MASCULIN;SCOLAIRE;BAC PROFESSIONNEL;BAC PRO PROD;BAC PRO 25514 SYST.NUM.OPT.B AUD.RES.EQUIP.DOM.;50;50;44;4;2;2;0;46;0;4;16;11;15;4
9256.0;2022;03;BESANCON;MASCULIN;SCOLAIRE;BAC PROFESSIONNEL;BAC PRO PROD;BAC PRO AG 21405 AMENAGEMENTS PAYSAGERS;30;29;26;3;0;0;0;26;0;0;2;9;15;3
9260.0;2022;03;BESANCON;MASCULIN;SCOLAIRE;BAC PROFESSIONNEL;BAC PRO SERV;BAC PRO 31106 LOGISTIQUE;20;20;12;8;0;0;0;12;0;1;3;4;4;8
9264.0;2022;03;BESANCON;MASCULIN;SCOLAIRE;BAC PROFESSIONNEL;BAC PRO SERV;BAC PRO 31214 MET.COM.VEN.OP.B PR.CL.VA.OF.COM.;75;75;59;11;5;3;2;62;0;1;16;24;21;13
9265.0;2022;03;BESANCON;MASCULIN;SCOLAIRE;BAC PROFESSIONNEL;BAC PRO SERV;BAC PRO 33002 SERVICES DE PROXIMITE  VIE LOCAL;7;7;6;0;1;1;0;7;0;0;1;3;3;0
9266.0;2022;03;BESANCON;MASCULIN;SCOLAIRE;BAC PROFESSIONNEL;BAC PRO SERV;BAC PRO 33003 ACC.SOINS-S.PERS. OPT.A DOMICILE;4;4;4;0;0;0;0;4;0;1;1;0;2;0
9272.0;2022;03;BESANCON;MASCULIN;SCOLAIRE;BAC PROFESSIONNEL;BAC PRO SERV;BAC PRO 34403 METIERS DE LA SECURITE;55;55;51;4;0;0;0;51;0;1;17;23;10;4
9273.0;2022;03;BESANCON;MASCULIN;SCOLAIRE;BAC PROFESSIONNEL;BAC PRO SERV;BAC PRO AG 33002 SERV PERS TERRIT;16;16;15;1;0;0;0;15;0;0;1;7;7;1
9275.0;2022;03;BESANCON;MASCULIN;SCOLAIRE;BAC TECHNOLOGIQUE;BAC ST2S;BAC ST2S SCIENCES & TECHNO. SANTE & SOCIAL;42;42;35;0;7;4;3;39;0;0;2;13;24;3
9277.0;2022;03;BESANCON;MASCULIN;SCOLAIRE;BAC TECHNOLOGIQUE;BAC STD2A;BAC STD2A SCIENCES & TECHNO. DESIGN-ARTS APPLIQUES;7;7;6;0;1;1;0;7;0;0;1;3;3;0
9278.0;2022;03;BESANCON;MASCULIN;SCOLAIRE;BAC TECHNOLOGIQUE;BAC STHR;BAC STHR SC.&TEC. HOTELLERIE-RESTAURATION;22;22;22;0;0;0;0;22;0;0;8;10;4;0
9289.0;2022;04;BORDEAUX;FEMININ;APPRENTISSAGE;BAC PROFESSIONNEL;BAC PRO PROD;BAC PRO 20102 PILOTE DE LIGNE DE PRODUCTION;2;1;1;0;0;0;0;1;0;0;1;0;0;0
9290.0;2022;04;BORDEAUX;FEMININ;APPRENTISSAGE;BAC PROFESSIONNEL;BAC PRO PROD;BAC PRO 22105 BOULANGER-PÂTISSIER;1;1;1;0;0;0;0;1;0;1;0;0;0;0
9312.0;2022;04;BORDEAUX;FEMININ;APPRENTISSAGE;BAC PROFESSIONNEL;BAC PRO SERV;BAC PRO 31106 LOGISTIQUE;4;4;4;0;0;0;0;4;0;1;1;1;1;0
9319.0;2022;04;BORDEAUX;FEMININ;APPRENTISSAGE;BAC PROFESSIONNEL;BAC PRO SERV;BAC PRO 33102 PROTHESE DENTAIRE;3;3;3;0;0;0;0;3;0;2;1;0;0;0
9321.0;2022;04;BORDEAUX;FEMININ;APPRENTISSAGE;BAC PROFESSIONNEL;BAC PRO SERV;BAC PRO 33603 ESTHETIQUE COSMETIQUE PARFUMERIE;3;3;3;0;0;0;0;3;0;0;0;2;1;0
9327.0;2022;04;BORDEAUX;FEMININ;ENSEIGNEMENT A DISTANCE;BAC PROFESSIONNEL;BAC PRO SERV;BAC PRO 31214 MET.COM.VEN.OP.B PR.CL.VA.OF.COM.;1;1;0;1;0;0;0;0;0;0;0;0;0;1
9346.0;2022;04;BORDEAUX;FEMININ;INDIVIDUEL;BAC PROFESSIONNEL;BAC PRO PROD;BAC PRO AG 21203 TECHN CONSEIL DE VENTE ANIMAL;1;1;1;0;0;0;0;1;0;0;0;0;1;0
9348.0;2022;04;BORDEAUX;FEMININ;INDIVIDUEL;BAC PROFESSIONNEL;BAC PRO SERV;BAC PRO 30001 GESTION-ADMINISTRATION;8;4;1;3;0;0;0;1;0;0;0;0;1;3
9351.0;2022;04;BORDEAUX;FEMININ;INDIVIDUEL;BAC PROFESSIONNEL;BAC PRO SERV;BAC PRO 31213 MET.COM.VEN.OP.A ANI.GES.ESP.COM.;4;1;0;1;0;0;0;0;0;0;0;0;0;1
9354.0;2022;04;BORDEAUX;FEMININ;INDIVIDUEL;BAC PROFESSIONNEL;BAC PRO SERV;BAC PRO 33004 ACC.SOINS-S.PERS. OPT.EN STRUCTUR;7;1;0;1;0;0;0;0;0;0;0;0;0;1
9360.0;2022;04;BORDEAUX;FEMININ;INDIVIDUEL;BAC TECHNOLOGIQUE;BAC STMG;BAC STMG RESSOURCES HUMAINES ET COMMUNICATION;8;3;2;1;0;0;0;2;0;0;1;0;1;1
9362.0;2022;04;BORDEAUX;FEMININ;SCOLAIRE;BAC PROFESSIONNEL;BAC PRO PROD;BACPRO 20002 ETUD.DEFINITION PRDTS INDUSTRIEL;4;4;3;1;0;0;0;3;0;0;1;2;0;1
9367.0;2022;04;BORDEAUX;FEMININ;SCOLAIRE;BAC PROFESSIONNEL;BAC PRO PROD;BAC PRO 22503 PLASTIQUES ET COMPOSITES;3;3;2;1;0;0;0;2;0;0;1;0;1;1
9371.0;2022;04;BORDEAUX;FEMININ;SCOLAIRE;BAC PROFESSIONNEL;BAC PRO PROD;BACPRO 23103 TECHNICIEN GEOMETRE-TOPOGRAPHE;3;3;3;0;0;0;0;3;0;1;1;1;0;0
9373.0;2022;04;BORDEAUX;FEMININ;SCOLAIRE;BAC PROFESSIONNEL;BAC PRO PROD;BAC PRO 23304 AMENAGEMENT FINITION BATIMENT;12;12;12;0;0;0;0;12;0;3;4;2;3;0
9374.0;2022;04;BORDEAUX;FEMININ;SCOLAIRE;BAC PROFESSIONNEL;BAC PRO PROD;BAC PRO 23404 TECHNICIEN CONSTRUCTEUR BOIS;1;1;1;0;0;0;0;1;0;0;0;0;1;0
9377.0;2022;04;BORDEAUX;FEMININ;SCOLAIRE;BAC PROFESSIONNEL;BAC PRO PROD;BAC PRO 23408 Etude et réalisation d'agencement;22;22;22;0;0;0;0;22;0;2;6;11;3;0
9380.0;2022;04;BORDEAUX;FEMININ;SCOLAIRE;BAC PROFESSIONNEL;BAC PRO PROD;BAC PRO 25007 MAINTENANCE EQUIPEMENTS INDUST.;6;6;6;0;0;0;0;6;0;1;0;2;3;0
9381.0;2022;04;BORDEAUX;FEMININ;SCOLAIRE;BAC PROFESSIONNEL;BAC PRO PROD;BAC PRO 25009 MAINTENANCE NAUTIQUE;1;1;1;0;0;0;0;1;0;0;0;0;1;0
9391.0;2022;04;BORDEAUX;FEMININ;SCOLAIRE;BAC PROFESSIONNEL;BAC PRO PROD;BAC PRO 25510 METIERS ELECT. ENVIRON. CONNECTES;6;6;4;2;0;0;0;4;0;2;1;0;1;2
9393.0;2022;04;BORDEAUX;FEMININ;SCOLAIRE;BAC PROFESSIONNEL;BAC PRO PROD;BAC PRO 25515 SYST.NUM.OPT.C RES.INF.SYST.COMM.;7;7;6;0;1;1;0;7;0;0;1;3;3;0
9394.0;2022;04;BORDEAUX;FEMININ;SCOLAIRE;BAC PROFESSIONNEL;BAC PRO PROD;BAC PRO AG 21004 CGEA;72;67;56;11;0;0;0;56;0;4;5;24;23;11
9408.0;2022;04;BORDEAUX;FEMININ;SCOLAIRE;BAC PROFESSIONNEL;BAC PRO SERV;BAC PRO 30001 GESTION-ADMINISTRATION;489;489;357;116;16;15;1;372;0;19;58;140;155;117
9412.0;2022;04;BORDEAUX;FEMININ;SCOLAIRE;BAC PROFESSIONNEL;BAC PRO SERV;BAC PRO 31212 METIERS DE L'ACCUEIL;196;194;168;14;12;9;3;177;0;16;50;65;46;17
9419.0;2022;04;BORDEAUX;FEMININ;SCOLAIRE;BAC PROFESSIONNEL;BAC PRO SERV;BAC PRO 33002 SERVICES DE PROXIMITE  VIE LOCAL;138;138;130;7;1;1;0;131;0;9;36;51;35;7
9435.0;2022;04;BORDEAUX;FEMININ;SCOLAIRE;BAC TECHNOLOGIQUE;BAC STHR;BAC STHR SC.&TEC. HOTELLERIE-RESTAURATION;68;68;65;0;3;3;0;68;1;1;12;23;31;0
9442.0;2022;04;BORDEAUX;FEMININ;SCOLAIRE;BAC TECHNOLOGIQUE;BAC STMG;BAC STMG GESTION ET FINANCE;278;278;249;2;27;20;7;269;0;13;51;96;109;9
9446.0;2022;04;BORDEAUX;MASCULIN;APPRENTISSAGE;BAC PROFESSIONNEL;BAC PRO PROD;BACPRO 20002 ETUD.DEFINITION PRDTS INDUSTRIEL;1;1;1;0;0;0;0;1;0;0;0;1;0;0
9447.0;2022;04;BORDEAUX;MASCULIN;APPRENTISSAGE;BAC PROFESSIONNEL;BAC PRO PROD;BAC PRO 20102 PILOTE DE LIGNE DE PRODUCTION;19;16;10;6;0;0;0;10;0;3;3;1;3;6
9450.0;2022;04;BORDEAUX;MASCULIN;APPRENTISSAGE;BAC PROFESSIONNEL;BAC PRO PROD;BAC PRO 22704 TECHN. MAINT. SYST.ENERG.CLIMATI;7;7;7;0;0;0;0;7;0;3;1;2;1;0
9451.0;2022;04;BORDEAUX;MASCULIN;APPRENTISSAGE;BAC PROFESSIONNEL;BAC PRO PROD;BAC PRO 23004 TECHN. ETUDES BAT.A ETUDES & ECO.;1;1;1;0;0;0;0;1;0;1;0;0;0;0
9462.0;2022;04;BORDEAUX;MASCULIN;APPRENTISSAGE;BAC PROFESSIONNEL;BAC PRO PROD;BAC PRO 24303 MET. DU CUIR: SELLERIE GARNISSAGE;1;1;1;0;0;0;0;1;0;0;1;0;0;0
9463.0;2022;04;BORDEAUX;MASCULIN;APPRENTISSAGE;BAC PROFESSIONNEL;BAC PRO PROD;BAC PRO 25007 MAINTENANCE EQUIPEMENTS INDUST.;51;50;46;3;1;0;1;46;0;1;21;13;11;4
9464.0;2022;04;BORDEAUX;MASCULIN;APPRENTISSAGE;BAC PROFESSIONNEL;BAC PRO PROD;BAC PRO 25009 MAINTENANCE NAUTIQUE;4;4;3;0;1;1;0;4;0;0;1;0;3;0
9467.0;2022;04;BORDEAUX;MASCULIN;APPRENTISSAGE;BAC PROFESSIONNEL;BAC PRO PROD;BAC PRO 25214 MAINT.VEHIC.OPTA VOIT.PARTICUL.;136;129;99;24;6;3;3;102;0;10;13;32;47;27
9468.0;2022;04;BORDEAUX;MASCULIN;APPRENTISSAGE;BAC PROFESSIONNEL;BAC PRO PROD;BAC PRO 25215 MAINT.VEHIC.OPTB VEHIC.TRANS.ROUT;26;26;14;6;6;4;2;18;0;1;3;5;9;8
9482.0;2022;04;BORDEAUX;MASCULIN;APPRENTISSAGE;BAC PROFESSIONNEL;BAC PRO PROD;BAC PRO AG 21113 CGEVV;26;25;21;4;0;0;0;21;0;1;1;8;11;4
9487.0;2022;04;BORDEAUX;MASCULIN;APPRENTISSAGE;BAC PROFESSIONNEL;BAC PRO PROD;BAC PRO AG 21407 TEC CONS VTE UNIVERS JARDINERIE;1;1;0;1;0;0;0;0;0;0;0;0;0;1
9492.0;2022;04;BORDEAUX;MASCULIN;APPRENTISSAGE;BAC PROFESSIONNEL;BAC PRO SERV;BAC PRO 31212 METIERS DE L'ACCUEIL;5;5;5;0;0;0;0;5;0;1;2;1;1;0
9493.0;2022;04;BORDEAUX;MASCULIN;APPRENTISSAGE;BAC PROFESSIONNEL;BAC PRO SERV;BAC PRO 31213 MET.COM.VEN.OP.A ANI.GES.ESP.COM.;94;91;65;23;3;3;0;68;0;4;10;26;28;23
9499.0;2022;04;BORDEAUX;MASCULIN;APPRENTISSAGE;BAC PROFESSIONNEL;BAC PRO SERV;BAC PRO 33403 COMMERC. SERVICES EN RESTAURATION;12;11;8;2;1;0;1;8;0;0;2;3;3;3
9502.0;2022;04;BORDEAUX;MASCULIN;APPRENTISSAGE;BAC PROFESSIONNEL;BAC PRO SERV;BAC PRO AG 33002 SERV PERS TERRIT;2;2;2;0;0;0;0;2;0;0;0;1;1;0
9503.0;2022;04;BORDEAUX;MASCULIN;ENSEIGNEMENT A DISTANCE;BAC GENERAL;BAC GENERAL;BAC GENE 10019 BAC GENERAL;27;24;19;4;1;1;0;20;0;0;3;5;12;4
9505.0;2022;04;BORDEAUX;MASCULIN;ENSEIGNEMENT A DISTANCE;BAC PROFESSIONNEL;BAC PRO SERV;BAC PRO 31213 MET.COM.VEN.OP.A ANI.GES.ESP.COM.;5;3;2;1;0;0;0;2;0;0;0;1;1;1
9506.0;2022;04;BORDEAUX;MASCULIN;ENSEIGNEMENT A DISTANCE;BAC PROFESSIONNEL;BAC PRO SERV;BAC PRO 31214 MET.COM.VEN.OP.B PR.CL.VA.OF.COM.;3;3;1;2;0;0;0;1;0;0;0;0;1;2
9510.0;2022;04;BORDEAUX;MASCULIN;ENSEIGNEMENT A DISTANCE;BAC TECHNOLOGIQUE;BAC STMG;BAC STMG RESSOURCES HUMAINES ET COMMUNICATION;2;2;1;1;0;0;0;1;0;0;0;1;0;1
9515.0;2022;04;BORDEAUX;MASCULIN;FORMATION CONTINUE;BAC PROFESSIONNEL;BAC PRO PROD;BAC PRO AG 21405 AMENAGEMENTS PAYSAGERS;8;8;8;0;0;0;0;8;0;0;0;0;8;0
9526.0;2022;04;BORDEAUX;MASCULIN;INDIVIDUEL;BAC PROFESSIONNEL;BAC PRO PROD;BAC PRO AG 21004 CGEA;6;6;4;2;0;0;0;4;0;0;0;0;4;2
9529.0;2022;04;BORDEAUX;MASCULIN;INDIVIDUEL;BAC PROFESSIONNEL;BAC PRO PROD;BAC PRO AG 21204 PROD-AQUACOLES;1;0;0;0;0;0;0;0;0;0;0;0;0;0
9531.0;2022;04;BORDEAUX;MASCULIN;INDIVIDUEL;BAC PROFESSIONNEL;BAC PRO PROD;BAC PRO AG 22105 LABORATOIRE CONTROLE QUALITE;1;1;0;1;0;0;0;0;0;0;0;0;0;1
9533.0;2022;04;BORDEAUX;MASCULIN;INDIVIDUEL;BAC PROFESSIONNEL;BAC PRO SERV;BAC PRO 31106 LOGISTIQUE;1;1;0;1;0;0;0;0;0;0;0;0;0;1
9536.0;2022;04;BORDEAUX;MASCULIN;INDIVIDUEL;BAC PROFESSIONNEL;BAC PRO SERV;BAC PRO 31214 MET.COM.VEN.OP.B PR.CL.VA.OF.COM.;1;1;0;1;0;0;0;0;0;0;0;0;0;1
9542.0;2022;04;BORDEAUX;MASCULIN;INDIVIDUEL;BAC TECHNOLOGIQUE;BAC STI2D;BAC STI2D SYSTÈME D'INFORMATION  ET NUMERIQUE;1;0;0;0;0;0;0;0;0;0;0;0;0;0
9546.0;2022;04;BORDEAUX;MASCULIN;SCOLAIRE;BAC GENERAL;BAC GENERAL;BAC GENE 10019 BAC GENERAL;8066;8066;7312;125;629;448;181;7760;97;788;1867;2593;2415;306
9547.0;2022;04;BORDEAUX;MASCULIN;SCOLAIRE;BAC PROFESSIONNEL;BAC PRO PROD;BACPRO 20002 ETUD.DEFINITION PRDTS INDUSTRIEL;20;20;10;10;0;0;0;10;0;0;2;4;4;10
9548.0;2022;04;BORDEAUX;MASCULIN;SCOLAIRE;BAC PROFESSIONNEL;BAC PRO PROD;BAC PRO 20102 PILOTE DE LIGNE DE PRODUCTION;15;15;7;5;3;0;3;7;0;0;3;1;3;8
9549.0;2022;04;BORDEAUX;MASCULIN;SCOLAIRE;BAC PROFESSIONNEL;BAC PRO PROD;BAC PRO 22003 BIO-INDUSTRIES DE TRANSFORMATION;17;17;11;6;0;0;0;11;0;1;2;4;4;6
9565.0;2022;04;BORDEAUX;MASCULIN;SCOLAIRE;BAC PROFESSIONNEL;BAC PRO PROD;BAC PRO 23404 TECHNICIEN CONSTRUCTEUR BOIS;59;59;48;11;0;0;0;48;0;1;8;16;23;11
9572.0;2022;04;BORDEAUX;MASCULIN;SCOLAIRE;BAC PROFESSIONNEL;BAC PRO PROD;BAC PRO 25009 MAINTENANCE NAUTIQUE;20;20;16;2;2;2;0;18;0;1;2;7;8;2
9573.0;2022;04;BORDEAUX;MASCULIN;SCOLAIRE;BAC PROFESSIONNEL;BAC PRO PROD;BAC PRO 25106 TECHNICIEN D'USINAGE;116;116;88;25;3;2;1;90;0;5;14;37;34;26
9579.0;2022;04;BORDEAUX;MASCULIN;SCOLAIRE;BAC PROFESSIONNEL;BAC PRO PROD;BAC PRO 25220 MAINT.MATERIELS OPT.B TP MANUT.;39;39;35;2;2;1;1;36;0;1;11;9;15;3
9585.0;2022;04;BORDEAUX;MASCULIN;SCOLAIRE;BAC PROFESSIONNEL;BAC PRO PROD;BAC PRO 25408 REPARATION DES CARROSSERIES;35;35;26;6;3;1;2;27;0;0;5;11;11;8
9586.0;2022;04;BORDEAUX;MASCULIN;SCOLAIRE;BAC PROFESSIONNEL;BAC PRO PROD;BAC PRO 25411 TECH.CHAUDRONNERIE INDUSTRIELLE;132;131;111;15;5;4;1;115;0;9;27;42;37;16
9589.0;2022;04;BORDEAUX;MASCULIN;SCOLAIRE;BAC PROFESSIONNEL;BAC PRO PROD;BAC PRO 25513 SYST.NUM.OPT.A SURETE SECURITE;35;34;28;4;2;2;0;30;0;1;2;11;16;4
9591.0;2022;04;BORDEAUX;MASCULIN;SCOLAIRE;BAC PROFESSIONNEL;BAC PRO PROD;BAC PRO 25515 SYST.NUM.OPT.C RES.INF.SYST.COMM.;241;240;200;32;8;8;0;208;0;21;55;78;54;32
9592.0;2022;04;BORDEAUX;MASCULIN;SCOLAIRE;BAC PROFESSIONNEL;BAC PRO PROD;BAC PRO AG 21001 AGRO-EQUIPEMENT;44;43;34;9;0;0;0;34;0;1;5;11;17;9
9596.0;2022;04;BORDEAUX;MASCULIN;SCOLAIRE;BAC PROFESSIONNEL;BAC PRO PROD;BAC PRO AG 21203 TECHN CONSEIL DE VENTE ANIMAL;11;11;10;1;0;0;0;10;0;0;3;3;4;1
9597.0;2022;04;BORDEAUX;MASCULIN;SCOLAIRE;BAC PROFESSIONNEL;BAC PRO PROD;BAC PRO AG 21204 PROD-AQUACOLES;12;12;10;2;0;0;0;10;0;0;2;3;5;2
9598.0;2022;04;BORDEAUX;MASCULIN;SCOLAIRE;BAC PROFESSIONNEL;BAC PRO PROD;BAC PRO AG 21210 COND GEST ENTR CANIN ET FELIN;9;8;8;0;0;0;0;8;0;0;1;3;4;0
9610.0;2022;04;BORDEAUX;MASCULIN;SCOLAIRE;BAC PROFESSIONNEL;BAC PRO SERV;BAC PRO 31108 TRANSPORT;55;55;38;16;1;1;0;39;0;3;7;14;15;16
9617.0;2022;04;BORDEAUX;MASCULIN;SCOLAIRE;BAC PROFESSIONNEL;BAC PRO SERV;BAC PRO 32304 PHOTOGRAPHIE;14;14;12;2;0;0;0;12;0;2;4;3;3;2
9619.0;2022;04;BORDEAUX;MASCULIN;SCOLAIRE;BAC PROFESSIONNEL;BAC PRO SERV;BAC PRO 33003 ACC.SOINS-S.PERS. OPT.A DOMICILE;25;25;22;2;1;1;0;23;0;0;5;8;10;2
9622.0;2022;04;BORDEAUX;MASCULIN;SCOLAIRE;BAC PROFESSIONNEL;BAC PRO SERV;BAC PRO 33102 PROTHESE DENTAIRE;5;5;2;2;1;0;1;2;0;0;0;2;0;3
9624.0;2022;04;BORDEAUX;MASCULIN;SCOLAIRE;BAC PROFESSIONNEL;BAC PRO SERV;BAC PRO 33603 ESTHETIQUE COSMETIQUE PARFUMERIE;1;1;1;0;0;0;0;1;0;0;0;1;0;0
9626.0;2022;04;BORDEAUX;MASCULIN;SCOLAIRE;BAC PROFESSIONNEL;BAC PRO SERV;BAC PRO 34305 TECHN.D'INTERV.SUR INSTALL. NUCL.;9;9;5;4;0;0;0;5;0;0;1;0;4;4
9631.0;2022;04;BORDEAUX;MASCULIN;SCOLAIRE;BAC TECHNOLOGIQUE;BAC ST2S;BAC ST2S SCIENCES & TECHNO. SANTE & SOCIAL;90;90;69;6;15;15;0;84;0;0;9;24;51;6
9634.0;2022;04;BORDEAUX;MASCULIN;SCOLAIRE;BAC TECHNOLOGIQUE;BAC STHR;BAC STHR SC.&TEC. HOTELLERIE-RESTAURATION;58;58;54;1;3;2;1;56;0;0;9;21;26;2
9635.0;2022;04;BORDEAUX;MASCULIN;SCOLAIRE;BAC TECHNOLOGIQUE;BAC STI2D;BAC STI2D ARCHITECTURE ET CONSTRUCTION;191;191;160;7;24;20;4;180;0;4;13;58;105;11
9640.0;2022;04;BORDEAUX;MASCULIN;SCOLAIRE;BAC TECHNOLOGIQUE;BAC STL;BAC STL SCIENCES PHYSIQUES CHIMIQUES  EN LABORAT.;85;85;70;3;12;10;2;80;0;4;14;26;36;5
9647.0;2022;06;CLERMONT-FERRAND;FEMININ;APPRENTISSAGE;BAC PROFESSIONNEL;BAC PRO PROD;BAC PRO 22704 TECHN. MAINT. SYST.ENERG.CLIMATI;1;1;1;0;0;0;0;1;0;0;1;0;0;0
9669.0;2022;06;CLERMONT-FERRAND;FEMININ;ENSEIGNEMENT A DISTANCE;BAC GENERAL;BAC GENERAL;BAC GENE 10019 BAC GENERAL;25;25;18;4;3;3;0;21;1;1;3;9;7;4
9677.0;2022;06;CLERMONT-FERRAND;FEMININ;ENSEIGNEMENT A DISTANCE;BAC TECHNOLOGIQUE;BAC STMG;BAC STMG RESSOURCES HUMAINES ET COMMUNICATION;1;1;1;0;0;0;0;1;0;0;0;0;1;0
9678.0;2022;06;CLERMONT-FERRAND;FEMININ;FORMATION CONTINUE;BAC PROFESSIONNEL;BAC PRO PROD;BAC PRO 22106 CUISINE;1;1;1;0;0;0;0;1;0;1;0;0;0;0
9683.0;2022;06;CLERMONT-FERRAND;FEMININ;INDIVIDUEL;BAC GENERAL;BAC GENERAL;BAC GENE 10019 BAC GENERAL;36;26;13;9;4;2;2;15;0;1;4;3;7;11
9684.0;2022;06;CLERMONT-FERRAND;FEMININ;INDIVIDUEL;BAC PROFESSIONNEL;BAC PRO PROD;BAC PRO 22106 CUISINE;1;1;0;1;0;0;0;0;0;0;0;0;0;1
9685.0;2022;06;CLERMONT-FERRAND;FEMININ;INDIVIDUEL;BAC PROFESSIONNEL;BAC PRO PROD;BAC PRO AG 21004 CGEA;3;3;2;1;0;0;0;2;0;0;0;0;2;1
9686.0;2022;06;CLERMONT-FERRAND;FEMININ;INDIVIDUEL;BAC PROFESSIONNEL;BAC PRO PROD;BAC PRO AG 21114 CONDUITE PRODUCTIONS HORTICOLES;2;2;2;0;0;0;0;2;0;0;0;0;2;0
9688.0;2022;06;CLERMONT-FERRAND;FEMININ;INDIVIDUEL;BAC PROFESSIONNEL;BAC PRO SERV;BAC PRO 30001 GESTION-ADMINISTRATION;4;3;2;0;1;0;1;2;0;0;0;0;2;1
9689.0;2022;06;CLERMONT-FERRAND;FEMININ;INDIVIDUEL;BAC PROFESSIONNEL;BAC PRO SERV;BAC PRO 31212 METIERS DE L'ACCUEIL;1;0;0;0;0;0;0;0;0;0;0;0;0;0
9690.0;2022;06;CLERMONT-FERRAND;FEMININ;INDIVIDUEL;BAC PROFESSIONNEL;BAC PRO SERV;BAC PRO 31213 MET.COM.VEN.OP.A ANI.GES.ESP.COM.;1;1;0;1;0;0;0;0;0;0;0;0;0;1
9692.0;2022;06;CLERMONT-FERRAND;FEMININ;INDIVIDUEL;BAC TECHNOLOGIQUE;BAC ST2S;BAC ST2S SCIENCES & TECHNO. SANTE & SOCIAL;2;0;0;0;0;0;0;0;0;0;0;0;0;0
9699.0;2022;06;CLERMONT-FERRAND;FEMININ;SCOLAIRE;BAC PROFESSIONNEL;BAC PRO PROD;BAC PRO 20102 PILOTE DE LIGNE DE PRODUCTION;1;1;1;0;0;0;0;1;0;0;0;1;0;0
9703.0;2022;06;CLERMONT-FERRAND;FEMININ;SCOLAIRE;BAC PROFESSIONNEL;BAC PRO PROD;BAC PRO 22703 TECHN.INSTALL.SYST.ENERG.CLIMATI;1;1;1;0;0;0;0;1;0;0;0;1;0;0
9710.0;2022;06;CLERMONT-FERRAND;FEMININ;SCOLAIRE;BAC PROFESSIONNEL;BAC PRO PROD;BAC PRO 23404 TECHNICIEN CONSTRUCTEUR BOIS;2;2;2;0;0;0;0;2;0;0;1;0;1;0
9718.0;2022;06;CLERMONT-FERRAND;FEMININ;SCOLAIRE;BAC PROFESSIONNEL;BAC PRO PROD;BAC PRO 25304 AERONAUTIQUE OPTION STRUCTURE;1;1;0;1;0;0;0;0;0;0;0;0;0;1
9719.0;2022;06;CLERMONT-FERRAND;FEMININ;SCOLAIRE;BAC PROFESSIONNEL;BAC PRO PROD;BAC PRO 25408 REPARATION DES CARROSSERIES;1;1;1;0;0;0;0;1;0;0;0;0;1;0
9722.0;2022;06;CLERMONT-FERRAND;FEMININ;SCOLAIRE;BAC PROFESSIONNEL;BAC PRO PROD;BAC PRO AG 21004 CGEA;55;55;40;15;0;0;0;40;0;1;6;11;22;15
9746.0;2022;06;CLERMONT-FERRAND;FEMININ;SCOLAIRE;BAC PROFESSIONNEL;BAC PRO SERV;BAC PRO 33101 OPTIQUE LUNETTERIE;19;19;18;1;0;0;0;18;0;0;6;10;2;1
9752.0;2022;06;CLERMONT-FERRAND;FEMININ;SCOLAIRE;BAC PROFESSIONNEL;BAC PRO SERV;BAC PRO AG 33002 SERV PERS TERRIT;132;130;123;7;0;0;0;123;0;4;12;42;65;7
9755.0;2022;06;CLERMONT-FERRAND;FEMININ;SCOLAIRE;BAC TECHNOLOGIQUE;BAC STD2A;BAC STD2A SCIENCES & TECHNO. DESIGN-ARTS APPLIQUES;66;66;65;0;1;1;0;66;0;1;27;28;10;0
9757.0;2022;06;CLERMONT-FERRAND;FEMININ;SCOLAIRE;BAC TECHNOLOGIQUE;BAC STI2D;BAC STI2D ARCHITECTURE ET CONSTRUCTION;16;16;13;1;2;2;0;15;0;0;1;7;7;1
9758.0;2022;06;CLERMONT-FERRAND;FEMININ;SCOLAIRE;BAC TECHNOLOGIQUE;BAC STI2D;BAC STI2D ENERGIES  ET ENVIRONNEMENT;3;3;1;0;2;1;1;2;0;0;0;0;2;1
9759.0;2022;06;CLERMONT-FERRAND;FEMININ;SCOLAIRE;BAC TECHNOLOGIQUE;BAC STI2D;BAC STI2D INNOVATION TECHNO.  ET ECO CONCEPTION;9;9;8;0;1;1;0;9;0;0;1;3;5;0
9765.0;2022;06;CLERMONT-FERRAND;FEMININ;SCOLAIRE;BAC TECHNOLOGIQUE;BAC STMG;BAC STMG RESSOURCES HUMAINES ET COMMUNICATION;175;175;137;5;33;23;10;160;0;1;11;51;97;15
9767.0;2022;06;CLERMONT-FERRAND;MASCULIN;APPRENTISSAGE;BAC PROFESSIONNEL;BAC PRO PROD;BACPRO 20002 ETUD.DEFINITION PRDTS INDUSTRIEL;1;1;1;0;0;0;0;1;0;0;1;0;0;0
9772.0;2022;06;CLERMONT-FERRAND;MASCULIN;APPRENTISSAGE;BAC PROFESSIONNEL;BAC PRO PROD;BAC PRO 22704 TECHN. MAINT. SYST.ENERG.CLIMATI;2;2;1;1;0;0;0;1;0;0;0;0;1;1
9775.0;2022;06;CLERMONT-FERRAND;MASCULIN;APPRENTISSAGE;BAC PROFESSIONNEL;BAC PRO PROD;BAC PRO 23304 AMENAGEMENT FINITION BATIMENT;1;1;1;0;0;0;0;1;0;0;0;1;0;0
9780.0;2022;06;CLERMONT-FERRAND;MASCULIN;APPRENTISSAGE;BAC PROFESSIONNEL;BAC PRO PROD;BAC PRO 25007 MAINTENANCE EQUIPEMENTS INDUST.;40;40;38;0;2;2;0;40;0;7;10;14;9;0
9787.0;2022;06;CLERMONT-FERRAND;MASCULIN;APPRENTISSAGE;BAC PROFESSIONNEL;BAC PRO PROD;BAC PRO 25221 MAINT.MATERIELS OPT.C ESP. VERTS;3;3;3;0;0;0;0;3;0;0;0;2;1;0
9794.0;2022;06;CLERMONT-FERRAND;MASCULIN;APPRENTISSAGE;BAC PROFESSIONNEL;BAC PRO PROD;BAC PRO 25510 METIERS ELECT. ENVIRON. CONNECTES;62;61;50;8;3;0;3;50;0;8;13;15;14;11
9810.0;2022;06;CLERMONT-FERRAND;MASCULIN;APPRENTISSAGE;BAC PROFESSIONNEL;BAC PRO SERV;BAC PRO 33403 COMMERC. SERVICES EN RESTAURATION;3;3;3;0;0;0;0;3;0;1;0;0;2;0
9812.0;2022;06;CLERMONT-FERRAND;MASCULIN;ENSEIGNEMENT A DISTANCE;BAC GENERAL;BAC GENERAL;BAC GENE 10019 BAC GENERAL;8;8;5;2;1;1;0;6;0;1;0;2;3;2
9815.0;2022;06;CLERMONT-FERRAND;MASCULIN;ENSEIGNEMENT A DISTANCE;BAC PROFESSIONNEL;BAC PRO SERV;BAC PRO 30001 GESTION-ADMINISTRATION;1;0;0;0;0;0;0;0;0;0;0;0;0;0
9823.0;2022;06;CLERMONT-FERRAND;MASCULIN;FORMATION CONTINUE;BAC PROFESSIONNEL;BAC PRO PROD;BAC PRO 25221 MAINT.MATERIELS OPT.C ESP. VERTS;1;1;1;0;0;0;0;1;0;0;0;1;0;0
9824.0;2022;06;CLERMONT-FERRAND;MASCULIN;FORMATION CONTINUE;BAC PROFESSIONNEL;BAC PRO SERV;BAC PRO 31212 METIERS DE L'ACCUEIL;1;1;1;0;0;0;0;1;0;0;1;0;0;0
9835.0;2022;06;CLERMONT-FERRAND;MASCULIN;INDIVIDUEL;BAC TECHNOLOGIQUE;BAC STAV;BAC STAV AGRONOMIE ALIM ENV TERRITOI;1;1;1;0;0;0;0;1;0;0;0;0;1;0
9836.0;2022;06;CLERMONT-FERRAND;MASCULIN;INDIVIDUEL;BAC TECHNOLOGIQUE;BAC STI2D;BAC STI2D SYSTÈME D'INFORMATION  ET NUMERIQUE;1;0;0;0;0;0;0;0;0;0;0;0;0;0
9837.0;2022;06;CLERMONT-FERRAND;MASCULIN;INDIVIDUEL;BAC TECHNOLOGIQUE;BAC STMG;BAC STMG GESTION ET FINANCE;2;1;1;0;0;0;0;1;0;0;0;0;1;0
9839.0;2022;06;CLERMONT-FERRAND;MASCULIN;INDIVIDUEL;BAC TECHNOLOGIQUE;BAC STMG;BAC STMG RESSOURCES HUMAINES ET COMMUNICATION;4;4;2;2;0;0;0;2;0;0;1;0;1;2
9840.0;2022;06;CLERMONT-FERRAND;MASCULIN;SCOLAIRE;BAC GENERAL;BAC GENERAL;BAC GENE 10019 BAC GENERAL;2853;2853;2570;51;232;168;64;2738;35;307;623;823;950;115
9844.0;2022;06;CLERMONT-FERRAND;MASCULIN;SCOLAIRE;BAC PROFESSIONNEL;BAC PRO PROD;BAC PRO 22106 CUISINE;72;72;60;10;2;2;0;62;0;1;12;24;25;10
9848.0;2022;06;CLERMONT-FERRAND;MASCULIN;SCOLAIRE;BAC PROFESSIONNEL;BAC PRO PROD;BAC PRO 22704 TECHN. MAINT. SYST.ENERG.CLIMATI;11;11;6;5;0;0;0;6;0;0;1;0;5;5
9850.0;2022;06;CLERMONT-FERRAND;MASCULIN;SCOLAIRE;BAC PROFESSIONNEL;BAC PRO PROD;BAC PRO 23004 TECHN. ETUDES BAT.A ETUDES & ECO.;8;8;5;3;0;0;0;5;0;0;0;1;4;3
9854.0;2022;06;CLERMONT-FERRAND;MASCULIN;SCOLAIRE;BAC PROFESSIONNEL;BAC PRO PROD;BAC PRO 23203 TECHNICIEN BAT. : ORG.REAL.GROS O;7;7;6;0;1;1;0;7;0;0;1;3;3;0
9863.0;2022;06;CLERMONT-FERRAND;MASCULIN;SCOLAIRE;BAC PROFESSIONNEL;BAC PRO PROD;BAC PRO 25214 MAINT.VEHIC.OPTA VOIT.PARTICUL.;75;75;49;25;1;0;1;49;0;0;11;11;27;26
9868.0;2022;06;CLERMONT-FERRAND;MASCULIN;SCOLAIRE;BAC PROFESSIONNEL;BAC PRO PROD;BAC PRO 25302 AERONAUTIQUE OPTION AVIONIQUE;8;8;7;0;1;1;0;8;0;0;3;3;2;0
9875.0;2022;06;CLERMONT-FERRAND;MASCULIN;SCOLAIRE;BAC PROFESSIONNEL;BAC PRO PROD;BAC PRO 25510 METIERS ELECT. ENVIRON. CONNECTES;195;195;135;49;11;8;3;143;0;6;25;51;61;52
9884.0;2022;06;CLERMONT-FERRAND;MASCULIN;SCOLAIRE;BAC PROFESSIONNEL;BAC PRO PROD;BAC PRO AG 21211 COND GEST ENTR HIPPIQUE;7;7;7;0;0;0;0;7;0;0;2;3;2;0
9886.0;2022;06;CLERMONT-FERRAND;MASCULIN;SCOLAIRE;BAC PROFESSIONNEL;BAC PRO PROD;BAC PRO AG 21303 FORET;23;23;22;1;0;0;0;22;0;0;8;4;10;1
9904.0;2022;06;CLERMONT-FERRAND;MASCULIN;SCOLAIRE;BAC PROFESSIONNEL;BAC PRO SERV;BAC PRO 33004 ACC.SOINS-S.PERS. OPT.EN STRUCTUR;26;26;24;1;1;0;1;24;0;0;4;10;10;2
9907.0;2022;06;CLERMONT-FERRAND;MASCULIN;SCOLAIRE;BAC PROFESSIONNEL;BAC PRO SERV;BAC PRO 33403 COMMERC. SERVICES EN RESTAURATION;44;43;32;11;0;0;0;32;0;0;1;17;14;11
9908.0;2022;06;CLERMONT-FERRAND;MASCULIN;SCOLAIRE;BAC PROFESSIONNEL;BAC PRO SERV;BAC PRO 33603 ESTHETIQUE COSMETIQUE PARFUMERIE;1;1;0;1;0;0;0;0;0;0;0;0;0;1
9914.0;2022;06;CLERMONT-FERRAND;MASCULIN;SCOLAIRE;BAC TECHNOLOGIQUE;BAC STD2A;BAC STD2A SCIENCES & TECHNO. DESIGN-ARTS APPLIQUES;29;29;29;0;0;0;0;29;0;4;8;10;7;0
9924.0;2022;06;CLERMONT-FERRAND;MASCULIN;SCOLAIRE;BAC TECHNOLOGIQUE;BAC STMG;BAC STMG RESSOURCES HUMAINES ET COMMUNICATION;85;85;63;3;19;12;7;75;0;0;3;16;56;10
9930.0;2022;27;CORSE;FEMININ;ENSEIGNEMENT A DISTANCE;BAC GENERAL;BAC GENERAL;BAC GENE 10019 BAC GENERAL;7;7;2;2;3;2;1;4;0;0;0;0;4;3
9937.0;2022;27;CORSE;FEMININ;INDIVIDUEL;BAC PROFESSIONNEL;BAC PRO PROD;BAC PRO AG 21004 CGEA;9;8;6;2;0;0;0;6;0;0;0;0;6;2
9943.0;2022;27;CORSE;FEMININ;INDIVIDUEL;BAC TECHNOLOGIQUE;BAC STMG;BAC STMG MERCATIQUE (MARKETING);1;1;0;0;1;1;0;1;0;0;0;0;1;0
9947.0;2022;27;CORSE;FEMININ;SCOLAIRE;BAC PROFESSIONNEL;BAC PRO PROD;BAC PRO 23004 TECHN. ETUDES BAT.A ETUDES & ECO.;2;2;1;1;0;0;0;1;0;0;0;1;0;1
9948.0;2022;27;CORSE;FEMININ;SCOLAIRE;BAC PROFESSIONNEL;BAC PRO PROD;BAC PRO 23005 TECHN. ETUDES BAT B ASSIST.ARCHI.;4;4;4;0;0;0;0;4;0;2;0;0;2;0
9952.0;2022;27;CORSE;FEMININ;SCOLAIRE;BAC PROFESSIONNEL;BAC PRO PROD;BAC PRO AG 21405 AMENAGEMENTS PAYSAGERS;2;2;2;0;0;0;0;2;0;1;0;0;1;0
9960.0;2022;27;CORSE;FEMININ;SCOLAIRE;BAC PROFESSIONNEL;BAC PRO SERV;BAC PRO 33403 COMMERC. SERVICES EN RESTAURATION;14;14;10;4;0;0;0;10;0;0;2;6;2;4
9961.0;2022;27;CORSE;FEMININ;SCOLAIRE;BAC PROFESSIONNEL;BAC PRO SERV;BAC PRO 34403 METIERS DE LA SECURITE;3;3;3;0;0;0;0;3;0;0;0;2;1;0
9962.0;2022;27;CORSE;FEMININ;SCOLAIRE;BAC PROFESSIONNEL;BAC PRO SERV;BAC PRO AG 33002 SERV PERS TERRIT;7;7;7;0;0;0;0;7;0;0;1;1;5;0
9968.0;2022;27;CORSE;FEMININ;SCOLAIRE;BAC TECHNOLOGIQUE;BAC STI2D;BAC STI2D SYSTÈME D'INFORMATION  ET NUMERIQUE;1;1;1;0;0;0;0;1;0;0;0;1;0;0
9969.0;2022;27;CORSE;FEMININ;SCOLAIRE;BAC TECHNOLOGIQUE;BAC STL;BAC STL BIOCHIM.-BIOLOGIE-BIOTECHNOL.;4;4;4;0;0;0;0;4;0;0;0;0;4;0
9972.0;2022;27;CORSE;FEMININ;SCOLAIRE;BAC TECHNOLOGIQUE;BAC STMG;BAC STMG RESSOURCES HUMAINES ET COMMUNICATION;79;79;56;5;18;15;3;71;0;2;8;24;37;8
9973.0;2022;27;CORSE;MASCULIN;APPRENTISSAGE;BAC PROFESSIONNEL;BAC PRO PROD;BAC PRO 22106 CUISINE;2;0;0;0;0;0;0;0;0;0;0;0;0;0
9980.0;2022;27;CORSE;MASCULIN;APPRENTISSAGE;BAC PROFESSIONNEL;BAC PRO SERV;BAC PRO 30001 GESTION-ADMINISTRATION;3;2;1;1;0;0;0;1;0;0;0;0;1;1
9989.0;2022;27;CORSE;MASCULIN;INDIVIDUEL;BAC PROFESSIONNEL;BAC PRO PROD;BAC PRO AG 21004 CGEA;6;2;1;1;0;0;0;1;0;0;0;0;1;1
9992.0;2022;27;CORSE;MASCULIN;INDIVIDUEL;BAC PROFESSIONNEL;BAC PRO PROD;BAC PRO AG 21211 COND GEST ENTR HIPPIQUE;1;0;0;0;0;0;0;0;0;0;0;0;0;0
9993.0;2022;27;CORSE;MASCULIN;INDIVIDUEL;BAC TECHNOLOGIQUE;BAC STAV;BAC STAV AGRONOMIE ALIM ENV TERRITOI;1;0;0;0;0;0;0;0;0;0;0;0;0;0
9999.0;2022;27;CORSE;MASCULIN;SCOLAIRE;BAC PROFESSIONNEL;BAC PRO PROD;BAC PRO 23005 TECHN. ETUDES BAT B ASSIST.ARCHI.;6;6;5;1;0;0;0;5;0;1;1;2;1;1
20004.0;2023;28;LA REUNION;MASCULIN;APPRENTISSAGE;BAC PROFESSIONNEL;BAC PRO PROD;BAC PRO 22106 CUISINE;6;6;2;4;0;0;0;2;0;0;0;1;1;4
20005.0;2023;28;LA REUNION;MASCULIN;APPRENTISSAGE;BAC PROFESSIONNEL;BAC PRO PROD;BAC PRO 23102 TRAVAUX PUBLICS;7;7;6;1;0;0;0;6;0;1;0;1;4;1
20007.0;2023;28;LA REUNION;MASCULIN;APPRENTISSAGE;BAC PROFESSIONNEL;BAC PRO PROD;BAC PRO 23206 INTERV. SUR PATRIMOINE BATI OPT.B;1;1;1;0;0;0;0;1;0;0;0;0;1;0
20014.0;2023;28;LA REUNION;MASCULIN;APPRENTISSAGE;BAC PROFESSIONNEL;BAC PRO PROD;BAC PRO 25408 REPARATION DES CARROSSERIES;5;5;4;0;1;1;0;5;0;0;2;2;1;0
20017.0;2023;28;LA REUNION;MASCULIN;APPRENTISSAGE;BAC PROFESSIONNEL;BAC PRO PROD;BAC PRO AG 22108 TEC CONS VTE ALIMENTATION (PAB);1;0;0;0;0;0;0;0;0;0;0;0;0;0
20024.0;2023;28;LA REUNION;MASCULIN;INDIVIDUEL;BAC GENERAL;BAC GENERAL;BAC GENE 10019 BAC GENERAL;13;13;4;8;1;0;1;4;0;0;0;2;2;9
20036.0;2023;28;LA REUNION;MASCULIN;SCOLAIRE;BAC GENERAL;BAC GENERAL;BAC GENE 10019 BAC GENERAL;2307;2307;2019;58;230;189;41;2208;46;244;480;610;828;99
20037.0;2023;28;LA REUNION;MASCULIN;SCOLAIRE;BAC PROFESSIONNEL;BAC PRO PROD;BACPRO 20002 ETUD.DEFINITION PRDTS INDUSTRIEL;3;3;3;0;0;0;0;3;0;0;1;1;1;0
20050.0;2023;28;LA REUNION;MASCULIN;SCOLAIRE;BAC PROFESSIONNEL;BAC PRO PROD;BACPRO 23103 TECHNICIEN GEOMETRE-TOPOGRAPHE;28;28;20;7;1;1;0;21;0;2;1;10;8;7
20051.0;2023;28;LA REUNION;MASCULIN;SCOLAIRE;BAC PROFESSIONNEL;BAC PRO PROD;BAC PRO 23203 TECHNICIEN BAT. : ORG.REAL.GROS O;43;43;32;7;4;1;3;33;0;0;5;18;10;10
20054.0;2023;28;LA REUNION;MASCULIN;SCOLAIRE;BAC PROFESSIONNEL;BAC PRO PROD;BAC PRO 23207 INTERV. SUR PATRIMOINE BATI OPT.C;11;11;9;0;2;2;0;11;0;0;4;4;3;0
20057.0;2023;28;LA REUNION;MASCULIN;SCOLAIRE;BAC PROFESSIONNEL;BAC PRO PROD;BAC PRO 23404 TECHNICIEN CONSTRUCTEUR BOIS;36;36;27;6;3;2;1;29;0;1;4;8;16;7
20060.0;2023;28;LA REUNION;MASCULIN;SCOLAIRE;BAC PROFESSIONNEL;BAC PRO PROD;BAC PRO 23408 Etude et réalisation d'agencement;4;4;3;1;0;0;0;3;0;0;1;1;1;1
20061.0;2023;28;LA REUNION;MASCULIN;SCOLAIRE;BAC PROFESSIONNEL;BAC PRO PROD;BAC PRO 24203 METIERS DE LA MODE - VÊTEMENT;9;9;6;2;1;0;1;6;0;1;0;3;2;3
20064.0;2023;28;LA REUNION;MASCULIN;SCOLAIRE;BAC PROFESSIONNEL;BAC PRO PROD;BAC PRO 25214 MAINT.VEHIC.OPTA VOIT.PARTICUL.;138;138;105;18;15;12;3;117;0;4;22;36;55;21
20068.0;2023;28;LA REUNION;MASCULIN;SCOLAIRE;BAC PROFESSIONNEL;BAC PRO PROD;BAC PRO 25221 MAINT.MATERIELS OPT.C ESP. VERTS;5;5;3;1;1;0;1;3;0;0;0;1;2;2
20077.0;2023;28;LA REUNION;MASCULIN;SCOLAIRE;BAC PROFESSIONNEL;BAC PRO PROD;BAC PRO 25515 SYST.NUM.OPT.C RES.INF.SYST.COMM.;99;99;80;14;5;5;0;85;0;10;19;31;25;14
20078.0;2023;28;LA REUNION;MASCULIN;SCOLAIRE;BAC PROFESSIONNEL;BAC PRO PROD;BAC PRO AG 21001 AGRO-EQUIPEMENT;8;8;7;1;0;0;0;7;0;0;0;2;5;1
20079.0;2023;28;LA REUNION;MASCULIN;SCOLAIRE;BAC PROFESSIONNEL;BAC PRO PROD;BAC PRO AG 21004 CGEA;34;34;21;13;0;0;0;21;0;1;2;2;16;13
20080.0;2023;28;LA REUNION;MASCULIN;SCOLAIRE;BAC PROFESSIONNEL;BAC PRO PROD;BAC PRO AG 21114 CONDUITE PRODUCTIONS HORTICOLES;9;9;9;0;0;0;0;9;0;1;4;3;1;0
20089.0;2023;28;LA REUNION;MASCULIN;SCOLAIRE;BAC PROFESSIONNEL;BAC PRO SERV;BAC PRO 31213 MET.COM.VEN.OP.A ANI.GES.ESP.COM.;214;214;157;34;23;17;6;174;0;2;30;53;89;40
20090.0;2023;28;LA REUNION;MASCULIN;SCOLAIRE;BAC PROFESSIONNEL;BAC PRO SERV;BAC PRO 31214 MET.COM.VEN.OP.B PR.CL.VA.OF.COM.;49;49;38;6;5;4;1;42;0;3;10;11;18;7
20097.0;2023;28;LA REUNION;MASCULIN;SCOLAIRE;BAC PROFESSIONNEL;BAC PRO SERV;BAC PRO 33403 COMMERC. SERVICES EN RESTAURATION;13;13;9;1;3;2;1;11;0;0;3;4;4;2
20114.0;2023;28;LA REUNION;MASCULIN;SCOLAIRE;BAC TECHNOLOGIQUE;BAC STMG;BAC STMG RESSOURCES HUMAINES ET COMMUNICATION;127;127;87;15;25;21;4;108;0;1;8;28;71;19
20129.0;2023;09;LILLE;FEMININ;APPRENTISSAGE;BAC PROFESSIONNEL;BAC PRO PROD;BAC PRO 25510 METIERS ELECT. ENVIRON. CONNECTES;4;4;4;0;0;0;0;4;0;1;1;2;0;0
20139.0;2023;09;LILLE;FEMININ;APPRENTISSAGE;BAC PROFESSIONNEL;BAC PRO SERV;BAC PRO 31209 POISSONIER ECAILLER TRAITEUR;1;1;1;0;0;0;0;1;0;0;1;0;0;0
20142.0;2023;09;LILLE;FEMININ;APPRENTISSAGE;BAC PROFESSIONNEL;BAC PRO SERV;BAC PRO 31214 MET.COM.VEN.OP.B PR.CL.VA.OF.COM.;3;3;3;0;0;0;0;3;0;1;0;1;1;0
20145.0;2023;09;LILLE;FEMININ;APPRENTISSAGE;BAC PROFESSIONNEL;BAC PRO SERV;BAC PRO 33603 ESTHETIQUE COSMETIQUE PARFUMERIE;18;16;16;0;0;0;0;16;0;1;3;5;7;0
20147.0;2023;09;LILLE;FEMININ;APPRENTISSAGE;BAC PROFESSIONNEL;BAC PRO SERV;BAC PRO AG 33002 SERV PERS TERRIT;15;15;15;0;0;0;0;15;0;0;0;7;8;0
20148.0;2023;09;LILLE;FEMININ;ENSEIGNEMENT A DISTANCE;BAC GENERAL;BAC GENERAL;BAC GENE 10019 BAC GENERAL;76;76;48;14;14;12;2;60;1;1;8;15;35;16
20149.0;2023;09;LILLE;FEMININ;ENSEIGNEMENT A DISTANCE;BAC PROFESSIONNEL;BAC PRO PROD;BAC PRO 24203 METIERS DE LA MODE - VÊTEMENT;1;1;1;0;0;0;0;1;0;0;0;1;0;0
20150.0;2023;09;LILLE;FEMININ;ENSEIGNEMENT A DISTANCE;BAC PROFESSIONNEL;BAC PRO SERV;BAC PRO 30004 ASSISTANC.GEST.ORGANIS.ACTIVITES;4;3;1;2;0;0;0;1;0;0;0;0;1;2
20151.0;2023;09;LILLE;FEMININ;ENSEIGNEMENT A DISTANCE;BAC PROFESSIONNEL;BAC PRO SERV;BAC PRO 31213 MET.COM.VEN.OP.A ANI.GES.ESP.COM.;4;2;1;1;0;0;0;1;0;0;0;1;0;1
20158.0;2023;09;LILLE;FEMININ;ENSEIGNEMENT A DISTANCE;BAC TECHNOLOGIQUE;BAC STMG;BAC STMG RESSOURCES HUMAINES ET COMMUNICATION;5;5;2;1;2;1;1;3;0;0;0;0;3;2
20170.0;2023;09;LILLE;FEMININ;INDIVIDUEL;BAC PROFESSIONNEL;BAC PRO PROD;BAC PRO AG 22108 TEC CONS VTE ALIMENTATION (PAB);1;1;0;1;0;0;0;0;0;0;0;0;0;1
20181.0;2023;09;LILLE;FEMININ;INDIVIDUEL;BAC PROFESSIONNEL;BAC PRO SERV;BAC PRO 34403 METIERS DE LA SECURITE;1;1;1;0;0;0;0;1;0;0;0;0;1;0
20194.0;2023;09;LILLE;FEMININ;SCOLAIRE;BAC PROFESSIONNEL;BAC PRO PROD;BAC PRO 22403 ARTS.& MET.ART:MET.ENSEIGN SIGNA;4;4;4;0;0;0;0;4;0;0;0;0;4;0
20199.0;2023;09;LILLE;FEMININ;SCOLAIRE;BAC PROFESSIONNEL;BAC PRO PROD;BAC PRO 23005 TECHN. ETUDES BAT B ASSIST.ARCHI.;12;12;12;0;0;0;0;12;0;0;4;5;3;0
20201.0;2023;09;LILLE;FEMININ;SCOLAIRE;BAC PROFESSIONNEL;BAC PRO PROD;BACPRO 23103 TECHNICIEN GEOMETRE-TOPOGRAPHE;2;2;1;1;0;0;0;1;0;0;0;1;0;1
20207.0;2023;09;LILLE;FEMININ;SCOLAIRE;BAC PROFESSIONNEL;BAC PRO PROD;BAC PRO 23408 Etude et réalisation d'agencement;7;7;6;1;0;0;0;6;0;2;2;0;2;1
20209.0;2023;09;LILLE;FEMININ;SCOLAIRE;BAC PROFESSIONNEL;BAC PRO PROD;BAC PRO 24302 METIERS DU CUIR : MAROQUINERIE;8;8;7;1;0;0;0;7;0;0;2;2;3;1
20213.0;2023;09;LILLE;FEMININ;SCOLAIRE;BAC PROFESSIONNEL;BAC PRO PROD;BAC PRO 25215 MAINT.VEHIC.OPTB VEHIC.TRANS.ROUT;2;2;2;0;0;0;0;2;0;0;0;2;0;0
20221.0;2023;09;LILLE;FEMININ;SCOLAIRE;BAC PROFESSIONNEL;BAC PRO PROD;BAC PRO AG 21114 CONDUITE PRODUCTIONS HORTICOLES;7;7;7;0;0;0;0;7;0;0;0;1;6;0
20226.0;2023;09;LILLE;FEMININ;SCOLAIRE;BAC PROFESSIONNEL;BAC PRO PROD;BAC PRO AG 21303 FORET;1;1;1;0;0;0;0;1;0;0;0;1;0;0
20233.0;2023;09;LILLE;FEMININ;SCOLAIRE;BAC PROFESSIONNEL;BAC PRO SERV;BAC PRO 31107 CONDUCT. TRANSP.ROUT.MARCHANDISES;3;3;3;0;0;0;0;3;0;1;0;2;0;0
20240.0;2023;09;LILLE;FEMININ;SCOLAIRE;BAC PROFESSIONNEL;BAC PRO SERV;BAC PRO 32303 ART.& MET.ART:COM.VIS.VIS.PLURI-M;41;41;37;4;0;0;0;37;0;6;10;13;8;4
20245.0;2023;09;LILLE;FEMININ;SCOLAIRE;BAC PROFESSIONNEL;BAC PRO SERV;BAC PRO 33101 OPTIQUE LUNETTERIE;34;34;31;2;1;0;1;31;0;3;3;15;10;3
20249.0;2023;09;LILLE;FEMININ;SCOLAIRE;BAC PROFESSIONNEL;BAC PRO SERV;BAC PRO 33602 PERRUQUIER POSTICHEUR;3;2;2;0;0;0;0;2;0;0;2;0;0;0
20251.0;2023;09;LILLE;FEMININ;SCOLAIRE;BAC PROFESSIONNEL;BAC PRO SERV;BAC PRO 33604 METIERS DE LA COIFFURE;79;77;59;17;1;1;0;60;0;1;5;25;29;17
20252.0;2023;09;LILLE;FEMININ;SCOLAIRE;BAC PROFESSIONNEL;BAC PRO SERV;BAC PRO 34304 HYGIENE PROPRETE STERILISATION;51;51;43;6;2;1;1;44;0;1;10;19;14;7
20258.0;2023;09;LILLE;FEMININ;SCOLAIRE;BAC TECHNOLOGIQUE;BAC STAV;BAC STAV AGRONOMIE ALIM ENV TERRITOI;139;138;136;2;0;0;0;136;0;1;19;50;66;2
20259.0;2023;09;LILLE;FEMININ;SCOLAIRE;BAC TECHNOLOGIQUE;BAC STD2A;BAC STD2A SCIENCES & TECHNO. DESIGN-ARTS APPLIQUES;173;173;167;2;4;3;1;170;2;35;52;50;31;3
20264.0;2023;09;LILLE;FEMININ;SCOLAIRE;BAC TECHNOLOGIQUE;BAC STI2D;BAC STI2D SYSTÈME D'INFORMATION  ET NUMERIQUE;29;29;26;0;3;1;2;27;0;0;7;10;10;2
20266.0;2023;09;LILLE;FEMININ;SCOLAIRE;BAC TECHNOLOGIQUE;BAC STL;BAC STL SCIENCES PHYSIQUES CHIMIQUES  EN LABORAT.;90;90;81;2;7;4;3;85;0;4;22;29;30;5
20270.0;2023;09;LILLE;FEMININ;SCOLAIRE;BAC TECHNOLOGIQUE;BAC STMG;BAC STMG SYSTEMES D'INFORMATION DE GESTION;5;5;4;0;1;0;1;4;0;0;0;1;3;1
20274.0;2023;09;LILLE;MASCULIN;APPRENTISSAGE;BAC PROFESSIONNEL;BAC PRO PROD;BAC PRO 22106 CUISINE;61;60;39;18;3;1;2;40;0;3;7;16;14;20
20285.0;2023;09;LILLE;MASCULIN;APPRENTISSAGE;BAC PROFESSIONNEL;BAC PRO PROD;BAC PRO 24203 METIERS DE LA MODE - VÊTEMENT;2;2;1;0;1;0;1;1;0;1;0;0;0;1
20286.0;2023;09;LILLE;MASCULIN;APPRENTISSAGE;BAC PROFESSIONNEL;BAC PRO PROD;BAC PRO 25007 MAINTENANCE EQUIPEMENTS INDUST.;65;64;48;13;3;3;0;51;0;4;16;16;15;13
20293.0;2023;09;LILLE;MASCULIN;APPRENTISSAGE;BAC PROFESSIONNEL;BAC PRO PROD;BAC PRO 25221 MAINT.MATERIELS OPT.C ESP. VERTS;8;8;3;3;2;1;1;4;0;0;0;1;3;4
20299.0;2023;09;LILLE;MASCULIN;APPRENTISSAGE;BAC PROFESSIONNEL;BAC PRO PROD;BAC PRO 25510 METIERS ELECT. ENVIRON. CONNECTES;137;136;112;15;9;4;5;116;0;15;24;44;33;20
20300.0;2023;09;LILLE;MASCULIN;APPRENTISSAGE;BAC PROFESSIONNEL;BAC PRO PROD;BAC PRO AG 21001 AGRO-EQUIPEMENT;45;43;40;3;0;0;0;40;0;0;0;7;33;3
20302.0;2023;09;LILLE;MASCULIN;APPRENTISSAGE;BAC PROFESSIONNEL;BAC PRO PROD;BAC PRO AG 21114 CONDUITE PRODUCTIONS HORTICOLES;2;2;1;1;0;0;0;1;0;0;0;0;1;1
20304.0;2023;09;LILLE;MASCULIN;APPRENTISSAGE;BAC PROFESSIONNEL;BAC PRO PROD;BAC PRO AG 21210 COND GEST ENTR CANIN ET FELIN;2;2;2;0;0;0;0;2;0;0;0;0;2;0
20305.0;2023;09;LILLE;MASCULIN;APPRENTISSAGE;BAC PROFESSIONNEL;BAC PRO PROD;BAC PRO AG 21211 COND GEST ENTR HIPPIQUE;8;8;7;1;0;0;0;7;0;0;1;0;6;1
20311.0;2023;09;LILLE;MASCULIN;APPRENTISSAGE;BAC PROFESSIONNEL;BAC PRO SERV;BAC PRO 31209 POISSONIER ECAILLER TRAITEUR;2;2;2;0;0;0;0;2;0;0;1;0;1;0
20322.0;2023;09;LILLE;MASCULIN;ENSEIGNEMENT A DISTANCE;BAC PROFESSIONNEL;BAC PRO SERV;BAC PRO 31214 MET.COM.VEN.OP.B PR.CL.VA.OF.COM.;1;1;1;0;0;0;0;1;0;0;0;1;0;0
20325.0;2023;09;LILLE;MASCULIN;ENSEIGNEMENT A DISTANCE;BAC TECHNOLOGIQUE;BAC STMG;BAC STMG MERCATIQUE (MARKETING);2;2;2;0;0;0;0;2;0;0;0;1;1;0
20338.0;2023;09;LILLE;MASCULIN;INDIVIDUEL;BAC PROFESSIONNEL;BAC PRO PROD;BAC PRO 22105 BOULANGER-PÂTISSIER;1;1;1;0;0;0;0;1;0;0;0;0;1;0
20342.0;2023;09;LILLE;MASCULIN;INDIVIDUEL;BAC PROFESSIONNEL;BAC PRO PROD;BAC PRO 23304 AMENAGEMENT FINITION BATIMENT;1;0;0;0;0;0;0;0;0;0;0;0;0;0
20344.0;2023;09;LILLE;MASCULIN;INDIVIDUEL;BAC PROFESSIONNEL;BAC PRO PROD;BAC PRO 25106 TECHNICIEN D'USINAGE;1;0;0;0;0;0;0;0;0;0;0;0;0;0
20349.0;2023;09;LILLE;MASCULIN;INDIVIDUEL;BAC PROFESSIONNEL;BAC PRO PROD;BAC PRO AG 21004 CGEA;2;1;1;0;0;0;0;1;0;0;0;0;1;0
20359.0;2023;09;LILLE;MASCULIN;INDIVIDUEL;BAC PROFESSIONNEL;BAC PRO SERV;BAC PRO 33403 COMMERC. SERVICES EN RESTAURATION;2;1;1;0;0;0;0;1;0;0;0;0;1;0
20362.0;2023;09;LILLE;MASCULIN;INDIVIDUEL;BAC TECHNOLOGIQUE;BAC STI2D;BAC STI2D ARCHITECTURE ET CONSTRUCTION;1;1;0;1;0;0;0;0;0;0;0;0;0;1
20371.0;2023;09;LILLE;MASCULIN;SCOLAIRE;BAC GENERAL;BAC GENERAL;BAC GENE 10019 BAC GENERAL;10286;10286;9284;187;815;608;207;9892;310;1253;2172;2994;3163;394
20382.0;2023;09;LILLE;MASCULIN;SCOLAIRE;BAC PROFESSIONNEL;BAC PRO PROD;BAC PRO 22704 TECHN. MAINT. SYST.ENERG.CLIMATI;60;60;37;16;7;6;1;43;0;2;2;9;30;17
20386.0;2023;09;LILLE;MASCULIN;SCOLAIRE;BAC PROFESSIONNEL;BAC PRO PROD;BAC PRO 23102 TRAVAUX PUBLICS;39;39;31;6;2;2;0;33;0;2;10;11;10;6
20400.0;2023;09;LILLE;MASCULIN;SCOLAIRE;BAC PROFESSIONNEL;BAC PRO PROD;BAC PRO 25214 MAINT.VEHIC.OPTA VOIT.PARTICUL.;431;430;329;59;42;31;11;360;0;19;73;123;145;70
20408.0;2023;09;LILLE;MASCULIN;SCOLAIRE;BAC PROFESSIONNEL;BAC PRO PROD;BAC PRO 25410 CONSTRUCTION DES CARROSSERIES;8;8;7;0;1;1;0;8;0;1;2;1;4;0
20411.0;2023;09;LILLE;MASCULIN;SCOLAIRE;BAC PROFESSIONNEL;BAC PRO PROD;BAC PRO 25510 METIERS ELECT. ENVIRON. CONNECTES;784;781;608;120;53;37;16;645;0;40;122;246;237;136
20413.0;2023;09;LILLE;MASCULIN;SCOLAIRE;BAC PROFESSIONNEL;BAC PRO PROD;BAC PRO 25514 SYST.NUM.OPT.B AUD.RES.EQUIP.DOM.;129;129;101;17;11;9;2;110;0;3;19;41;47;19
20414.0;2023;09;LILLE;MASCULIN;SCOLAIRE;BAC PROFESSIONNEL;BAC PRO PROD;BAC PRO 25515 SYST.NUM.OPT.C RES.INF.SYST.COMM.;339;339;287;45;7;6;1;293;0;20;74;107;92;46
20416.0;2023;09;LILLE;MASCULIN;SCOLAIRE;BAC PROFESSIONNEL;BAC PRO PROD;BAC PRO AG 21004 CGEA;109;109;105;4;0;0;0;105;0;4;8;33;60;4
20418.0;2023;09;LILLE;MASCULIN;SCOLAIRE;BAC PROFESSIONNEL;BAC PRO PROD;BAC PRO AG 21203 TECHN CONSEIL DE VENTE ANIMAL;34;34;27;7;0;0;0;27;0;0;2;7;18;7
20423.0;2023;09;LILLE;MASCULIN;SCOLAIRE;BAC PROFESSIONNEL;BAC PRO PROD;BAC PRO AG 21303 FORET;10;10;10;0;0;0;0;10;0;0;1;4;5;0
20427.0;2023;09;LILLE;MASCULIN;SCOLAIRE;BAC PROFESSIONNEL;BAC PRO PROD;BAC PRO AG 22108 TEC CONS VTE ALIMENTATION (PAB);7;7;6;1;0;0;0;6;0;0;1;1;4;1
20432.0;2023;09;LILLE;MASCULIN;SCOLAIRE;BAC PROFESSIONNEL;BAC PRO SERV;BAC PRO 31209 POISSONIER ECAILLER TRAITEUR;1;1;1;0;0;0;0;1;0;0;0;1;0;0
20435.0;2023;09;LILLE;MASCULIN;SCOLAIRE;BAC PROFESSIONNEL;BAC PRO SERV;BAC PRO 31214 MET.COM.VEN.OP.B PR.CL.VA.OF.COM.;247;244;193;45;6;5;1;198;0;8;38;78;74;46
20436.0;2023;09;LILLE;MASCULIN;SCOLAIRE;BAC PROFESSIONNEL;BAC PRO SERV;BAC PRO 32207 REAL.PR.IMPR.PLURI.OPTA.PR.GRAPH.;14;14;12;2;0;0;0;12;0;0;3;8;1;2
20442.0;2023;09;LILLE;MASCULIN;SCOLAIRE;BAC PROFESSIONNEL;BAC PRO SERV;BAC PRO 33006 ANIMAT. ENFANCE& PERSONNES AGEES;38;38;35;3;0;0;0;35;0;5;14;13;3;3
20448.0;2023;09;LILLE;MASCULIN;SCOLAIRE;BAC PROFESSIONNEL;BAC PRO SERV;BAC PRO 33604 METIERS DE LA COIFFURE;4;4;3;1;0;0;0;3;0;0;1;2;0;1
20453.0;2023;09;LILLE;MASCULIN;SCOLAIRE;BAC TECHNOLOGIQUE;BAC ST2S;BAC ST2S SCIENCES & TECHNO. SANTE & SOCIAL;339;339;243;22;74;57;17;300;0;5;21;74;200;39
20455.0;2023;09;LILLE;MASCULIN;SCOLAIRE;BAC TECHNOLOGIQUE;BAC STD2A;BAC STD2A SCIENCES & TECHNO. DESIGN-ARTS APPLIQUES;46;46;44;1;1;1;0;45;0;5;7;19;14;1
20456.0;2023;09;LILLE;MASCULIN;SCOLAIRE;BAC TECHNOLOGIQUE;BAC STHR;BAC STHR SC.&TEC. HOTELLERIE-RESTAURATION;50;50;47;1;2;0;2;47;0;2;16;12;17;3
20463.0;2023;09;LILLE;MASCULIN;SCOLAIRE;BAC TECHNOLOGIQUE;BAC STMG;BAC STMG GESTION ET FINANCE;540;540;440;31;69;57;12;497;1;6;58;165;267;43
20464.0;2023;09;LILLE;MASCULIN;SCOLAIRE;BAC TECHNOLOGIQUE;BAC STMG;BAC STMG MERCATIQUE (MARKETING);1112;1112;786;97;229;188;41;974;2;3;71;213;685;138
20471.0;2023;22;LIMOGES;FEMININ;APPRENTISSAGE;BAC PROFESSIONNEL;BAC PRO SERV;BAC PRO 30004 ASSISTANC.GEST.ORGANIS.ACTIVITES;3;3;2;0;1;1;0;3;0;1;1;0;1;0
20473.0;2023;22;LIMOGES;FEMININ;APPRENTISSAGE;BAC PROFESSIONNEL;BAC PRO SERV;BAC PRO 31212 METIERS DE L'ACCUEIL;4;4;4;0;0;0;0;4;0;1;0;2;1;0
20474.0;2023;22;LIMOGES;FEMININ;APPRENTISSAGE;BAC PROFESSIONNEL;BAC PRO SERV;BAC PRO 31213 MET.COM.VEN.OP.A ANI.GES.ESP.COM.;23;22;17;4;1;1;0;18;0;1;2;8;7;4
20479.0;2023;22;LIMOGES;FEMININ;APPRENTISSAGE;BAC PROFESSIONNEL;BAC PRO SERV;BAC PRO 33603 ESTHETIQUE COSMETIQUE PARFUMERIE;1;1;1;0;0;0;0;1;0;0;1;0;0;0
20483.0;2023;22;LIMOGES;FEMININ;ENSEIGNEMENT A DISTANCE;BAC TECHNOLOGIQUE;BAC ST2S;BAC ST2S SCIENCES & TECHNO. SANTE & SOCIAL;2;2;1;0;1;1;0;2;0;0;0;1;1;0
20484.0;2023;22;LIMOGES;FEMININ;ENSEIGNEMENT A DISTANCE;BAC TECHNOLOGIQUE;BAC STMG;BAC STMG MERCATIQUE (MARKETING);1;1;0;1;0;0;0;0;0;0;0;0;0;1
20485.0;2023;22;LIMOGES;FEMININ;FORMATION CONTINUE;BAC PROFESSIONNEL;BAC PRO PROD;BAC PRO 23102 TRAVAUX PUBLICS;2;2;2;0;0;0;0;2;0;0;0;2;0;0
20486.0;2023;22;LIMOGES;FEMININ;FORMATION CONTINUE;BAC PROFESSIONNEL;BAC PRO SERV;BAC PRO 30004 ASSISTANC.GEST.ORGANIS.ACTIVITES;2;2;2;0;0;0;0;2;0;0;0;1;1;0
20489.0;2023;22;LIMOGES;FEMININ;INDIVIDUEL;BAC PROFESSIONNEL;BAC PRO PROD;BAC PRO AG 21114 CONDUITE PRODUCTIONS HORTICOLES;4;4;4;0;0;0;0;4;0;0;0;0;4;0
20490.0;2023;22;LIMOGES;FEMININ;INDIVIDUEL;BAC PROFESSIONNEL;BAC PRO PROD;BAC PRO AG 21211 COND GEST ENTR HIPPIQUE;1;1;1;0;0;0;0;1;0;0;0;0;1;0
20496.0;2023;22;LIMOGES;FEMININ;INDIVIDUEL;BAC TECHNOLOGIQUE;BAC ST2S;BAC ST2S SCIENCES & TECHNO. SANTE & SOCIAL;1;1;1;0;0;0;0;1;0;0;0;0;1;0
20497.0;2023;22;LIMOGES;FEMININ;INDIVIDUEL;BAC TECHNOLOGIQUE;BAC STMG;BAC STMG GESTION ET FINANCE;2;2;0;2;0;0;0;0;0;0;0;0;0;2
20498.0;2023;22;LIMOGES;FEMININ;INDIVIDUEL;BAC TECHNOLOGIQUE;BAC STMG;BAC STMG MERCATIQUE (MARKETING);2;2;0;0;2;0;2;0;0;0;0;0;0;2
20502.0;2023;22;LIMOGES;FEMININ;SCOLAIRE;BAC PROFESSIONNEL;BAC PRO PROD;BAC PRO 22104 BOUCHER CHARCUTIER TRAITEUR;2;2;2;0;0;0;0;2;0;0;0;2;0;0
20504.0;2023;22;LIMOGES;FEMININ;SCOLAIRE;BAC PROFESSIONNEL;BAC PRO PROD;BAC PRO 22106 CUISINE;17;17;11;4;2;2;0;13;0;0;4;7;2;4
20505.0;2023;22;LIMOGES;FEMININ;SCOLAIRE;BAC PROFESSIONNEL;BAC PRO PROD;BAC PRO 23005 TECHN. ETUDES BAT B ASSIST.ARCHI.;5;5;5;0;0;0;0;5;0;0;3;1;1;0
20509.0;2023;22;LIMOGES;FEMININ;SCOLAIRE;BAC PROFESSIONNEL;BAC PRO PROD;BAC PRO 25214 MAINT.VEHIC.OPTA VOIT.PARTICUL.;1;1;1;0;0;0;0;1;0;0;1;0;0;0
20510.0;2023;22;LIMOGES;FEMININ;SCOLAIRE;BAC PROFESSIONNEL;BAC PRO PROD;BAC PRO 25215 MAINT.VEHIC.OPTB VEHIC.TRANS.ROUT;1;1;1;0;0;0;0;1;0;0;0;1;0;0
20524.0;2023;22;LIMOGES;FEMININ;SCOLAIRE;BAC PROFESSIONNEL;BAC PRO SERV;BAC PRO 31114 ORGANIS. TRANSPORT MARCHANDISES;3;3;2;0;1;1;0;3;0;0;0;0;3;0
20527.0;2023;22;LIMOGES;FEMININ;SCOLAIRE;BAC PROFESSIONNEL;BAC PRO SERV;BAC PRO 31214 MET.COM.VEN.OP.B PR.CL.VA.OF.COM.;22;22;21;0;1;0;1;21;0;2;5;5;9;1
20529.0;2023;22;LIMOGES;FEMININ;SCOLAIRE;BAC PROFESSIONNEL;BAC PRO SERV;BAC PRO 32208 REAL.PR.IMPR.PLURI.OPTB.PR.IMPR.;8;8;8;0;0;0;0;8;0;0;0;4;4;0
20533.0;2023;22;LIMOGES;FEMININ;SCOLAIRE;BAC PROFESSIONNEL;BAC PRO SERV;BAC PRO 33006 ANIMAT. ENFANCE& PERSONNES AGEES;24;24;23;1;0;0;0;23;0;4;9;5;5;1
20535.0;2023;22;LIMOGES;FEMININ;SCOLAIRE;BAC PROFESSIONNEL;BAC PRO SERV;BAC PRO 33403 COMMERC. SERVICES EN RESTAURATION;12;12;8;3;1;1;0;9;0;0;2;2;5;3
20537.0;2023;22;LIMOGES;FEMININ;SCOLAIRE;BAC PROFESSIONNEL;BAC PRO SERV;BAC PRO 33604 METIERS DE LA COIFFURE;8;8;7;1;0;0;0;7;0;0;1;3;3;1
20545.0;2023;22;LIMOGES;FEMININ;SCOLAIRE;BAC TECHNOLOGIQUE;BAC STI2D;BAC STI2D ARCHITECTURE ET CONSTRUCTION;13;13;9;2;2;0;2;9;0;0;2;4;3;4
20547.0;2023;22;LIMOGES;FEMININ;SCOLAIRE;BAC TECHNOLOGIQUE;BAC STI2D;BAC STI2D INNOVATION TECHNO.  ET ECO CONCEPTION;7;7;6;0;1;0;1;6;0;1;1;1;3;1
20551.0;2023;22;LIMOGES;FEMININ;SCOLAIRE;BAC TECHNOLOGIQUE;BAC STMG;BAC STMG MERCATIQUE (MARKETING);162;162;125;7;30;23;7;148;0;1;12;37;98;14
20552.0;2023;22;LIMOGES;FEMININ;SCOLAIRE;BAC TECHNOLOGIQUE;BAC STMG;BAC STMG RESSOURCES HUMAINES ET COMMUNICATION;123;123;90;7;26;17;9;107;0;0;4;31;72;16
20554.0;2023;22;LIMOGES;MASCULIN;APPRENTISSAGE;BAC PROFESSIONNEL;BAC PRO PROD;BAC PRO 22106 CUISINE;1;1;1;0;0;0;0;1;0;0;0;0;1;0
20560.0;2023;22;LIMOGES;MASCULIN;APPRENTISSAGE;BAC PROFESSIONNEL;BAC PRO PROD;BAC PRO 23207 INTERV. SUR PATRIMOINE BATI OPT.C;1;1;1;0;0;0;0;1;0;0;0;0;1;0
20566.0;2023;22;LIMOGES;MASCULIN;APPRENTISSAGE;BAC PROFESSIONNEL;BAC PRO PROD;BAC PRO 25106 TECHNICIEN D'USINAGE;12;12;9;3;0;0;0;9;0;0;1;4;4;3
20569.0;2023;22;LIMOGES;MASCULIN;APPRENTISSAGE;BAC PROFESSIONNEL;BAC PRO PROD;BAC PRO 25215 MAINT.VEHIC.OPTB VEHIC.TRANS.ROUT;10;10;5;5;0;0;0;5;0;0;0;2;3;5
20575.0;2023;22;LIMOGES;MASCULIN;APPRENTISSAGE;BAC PROFESSIONNEL;BAC PRO PROD;BAC PRO 25411 TECH.CHAUDRONNERIE INDUSTRIELLE;10;10;9;1;0;0;0;9;0;1;0;4;4;1
20576.0;2023;22;LIMOGES;MASCULIN;APPRENTISSAGE;BAC PROFESSIONNEL;BAC PRO PROD;BAC PRO 25509 TECHNIC. FROID CONDITIONNEMT AIR;4;4;3;1;0;0;0;3;0;0;0;0;3;1
20581.0;2023;22;LIMOGES;MASCULIN;APPRENTISSAGE;BAC PROFESSIONNEL;BAC PRO PROD;BAC PRO AG 21405 AMENAGEMENTS PAYSAGERS;19;19;17;2;0;0;0;17;0;0;0;3;14;2
20596.0;2023;22;LIMOGES;MASCULIN;INDIVIDUEL;BAC PROFESSIONNEL;BAC PRO PROD;BAC PRO 25510 METIERS ELECT. ENVIRON. CONNECTES;1;1;1;0;0;0;0;1;0;0;0;0;1;0
20597.0;2023;22;LIMOGES;MASCULIN;INDIVIDUEL;BAC PROFESSIONNEL;BAC PRO PROD;BAC PRO AG 21004 CGEA;2;1;1;0;0;0;0;1;0;0;0;0;1;0
20598.0;2023;22;LIMOGES;MASCULIN;INDIVIDUEL;BAC PROFESSIONNEL;BAC PRO PROD;BAC PRO AG 21114 CONDUITE PRODUCTIONS HORTICOLES;4;4;4;0;0;0;0;4;0;0;0;0;4;0
20599.0;2023;22;LIMOGES;MASCULIN;INDIVIDUEL;BAC PROFESSIONNEL;BAC PRO PROD;BAC PRO AG 21203 TECHN CONSEIL DE VENTE ANIMAL;1;0;0;0;0;0;0;0;0;0;0;0;0;0
20601.0;2023;22;LIMOGES;MASCULIN;INDIVIDUEL;BAC PROFESSIONNEL;BAC PRO SERV;BAC PRO 31213 MET.COM.VEN.OP.A ANI.GES.ESP.COM.;1;1;0;1;0;0;0;0;0;0;0;0;0;1
20611.0;2023;22;LIMOGES;MASCULIN;SCOLAIRE;BAC PROFESSIONNEL;BAC PRO PROD;BAC PRO 22105 BOULANGER-PÂTISSIER;14;14;10;4;0;0;0;10;0;1;0;5;4;4
20615.0;2023;22;LIMOGES;MASCULIN;SCOLAIRE;BAC PROFESSIONNEL;BAC PRO PROD;BAC PRO 23005 TECHN. ETUDES BAT B ASSIST.ARCHI.;10;10;8;2;0;0;0;8;0;1;0;2;5;2
20621.0;2023;22;LIMOGES;MASCULIN;SCOLAIRE;BAC PROFESSIONNEL;BAC PRO PROD;BAC PRO 23407 TECHNIC.FAB.BOIS ET MATERX ASSOC;7;7;6;1;0;0;0;6;0;0;1;4;1;1
20622.0;2023;22;LIMOGES;MASCULIN;SCOLAIRE;BAC PROFESSIONNEL;BAC PRO PROD;BAC PRO 24203 METIERS DE LA MODE - VÊTEMENT;3;3;3;0;0;0;0;3;0;1;1;0;1;0
20626.0;2023;22;LIMOGES;MASCULIN;SCOLAIRE;BAC PROFESSIONNEL;BAC PRO PROD;BAC PRO 25108 TECHNICIEN MODELEUR;7;7;7;0;0;0;0;7;0;1;1;2;3;0
20627.0;2023;22;LIMOGES;MASCULIN;SCOLAIRE;BAC PROFESSIONNEL;BAC PRO PROD;BAC PRO 25214 MAINT.VEHIC.OPTA VOIT.PARTICUL.;30;30;20;9;1;0;1;20;0;1;8;6;5;10
20628.0;2023;22;LIMOGES;MASCULIN;SCOLAIRE;BAC PROFESSIONNEL;BAC PRO PROD;BAC PRO 25215 MAINT.VEHIC.OPTB VEHIC.TRANS.ROUT;5;5;2;3;0;0;0;2;0;0;1;1;0;3
20641.0;2023;22;LIMOGES;MASCULIN;SCOLAIRE;BAC PROFESSIONNEL;BAC PRO PROD;BAC PRO AG 21004 CGEA;59;59;48;11;0;0;0;48;0;1;5;17;25;11
20645.0;2023;22;LIMOGES;MASCULIN;SCOLAIRE;BAC PROFESSIONNEL;BAC PRO PROD;BAC PRO AG 21302 GEST MILIEUX NATURELS FAUNE;28;27;21;6;0;0;0;21;0;0;3;6;12;6
20652.0;2023;22;LIMOGES;MASCULIN;SCOLAIRE;BAC PROFESSIONNEL;BAC PRO SERV;BAC PRO 31114 ORGANIS. TRANSPORT MARCHANDISES;14;14;9;3;2;1;1;10;0;0;0;2;8;4
20657.0;2023;22;LIMOGES;MASCULIN;SCOLAIRE;BAC PROFESSIONNEL;BAC PRO SERV;BAC PRO 32208 REAL.PR.IMPR.PLURI.OPTB.PR.IMPR.;4;4;3;0;1;1;0;4;0;0;2;1;1;0
20666.0;2023;22;LIMOGES;MASCULIN;SCOLAIRE;BAC PROFESSIONNEL;BAC PRO SERV;BAC PRO 34403 METIERS DE LA SECURITE;31;31;28;1;2;1;1;29;0;0;3;8;18;2
20672.0;2023;22;LIMOGES;MASCULIN;SCOLAIRE;BAC TECHNOLOGIQUE;BAC STI2D;BAC STI2D ARCHITECTURE ET CONSTRUCTION;45;45;33;4;8;5;3;38;0;0;2;10;26;7
20676.0;2023;22;LIMOGES;MASCULIN;SCOLAIRE;BAC TECHNOLOGIQUE;BAC STL;BAC STL BIOCHIM.-BIOLOGIE-BIOTECHNOL.;21;21;17;0;4;1;3;18;0;1;4;6;7;3
20677.0;2023;22;LIMOGES;MASCULIN;SCOLAIRE;BAC TECHNOLOGIQUE;BAC STL;BAC STL SCIENCES PHYSIQUES CHIMIQUES  EN LABORAT.;12;12;11;0;1;0;1;11;0;1;3;4;3;1
20683.0;2023;10;LYON;FEMININ;APPRENTISSAGE;BAC PROFESSIONNEL;BAC PRO PROD;BAC PRO 22003 BIO-INDUSTRIES DE TRANSFORMATION;3;3;1;2;0;0;0;1;0;0;0;1;0;2
20686.0;2023;10;LYON;FEMININ;APPRENTISSAGE;BAC PROFESSIONNEL;BAC PRO PROD;BAC PRO 22403 ARTS.& MET.ART:MET.ENSEIGN SIGNA;1;1;1;0;0;0;0;1;0;0;1;0;0;0
20706.0;2023;10;LYON;FEMININ;APPRENTISSAGE;BAC PROFESSIONNEL;BAC PRO PROD;BAC PRO AG 21211 COND GEST ENTR HIPPIQUE;14;14;13;1;0;0;0;13;0;1;0;5;7;1
20708.0;2023;10;LYON;FEMININ;APPRENTISSAGE;BAC PROFESSIONNEL;BAC PRO PROD;BAC PRO AG 21405 AMENAGEMENTS PAYSAGERS;4;4;4;0;0;0;0;4;0;0;0;2;2;0
20715.0;2023;10;LYON;FEMININ;APPRENTISSAGE;BAC PROFESSIONNEL;BAC PRO SERV;BAC PRO 32207 REAL.PR.IMPR.PLURI.OPTA.PR.GRAPH.;1;1;1;0;0;0;0;1;0;0;0;1;0;0
20717.0;2023;10;LYON;FEMININ;APPRENTISSAGE;BAC PROFESSIONNEL;BAC PRO SERV;BAC PRO 33004 ACC.SOINS-S.PERS. OPT.EN STRUCTUR;2;2;2;0;0;0;0;2;0;1;0;1;0;0
20718.0;2023;10;LYON;FEMININ;APPRENTISSAGE;BAC PROFESSIONNEL;BAC PRO SERV;BAC PRO 33104 TECHNICIEN EN PROTHESE DENTAIRE;11;11;11;0;0;0;0;11;0;4;5;2;0;0
20727.0;2023;10;LYON;FEMININ;ENSEIGNEMENT A DISTANCE;BAC TECHNOLOGIQUE;BAC STMG;BAC STMG MERCATIQUE (MARKETING);5;5;4;0;1;1;0;5;0;0;1;0;4;0
20736.0;2023;10;LYON;FEMININ;INDIVIDUEL;BAC PROFESSIONNEL;BAC PRO PROD;BAC PRO 25106 TECHNICIEN D'USINAGE;1;1;0;1;0;0;0;0;0;0;0;0;0;1
20737.0;2023;10;LYON;FEMININ;INDIVIDUEL;BAC PROFESSIONNEL;BAC PRO PROD;BAC PRO AG 21114 CONDUITE PRODUCTIONS HORTICOLES;3;3;3;0;0;0;0;3;0;0;0;0;3;0
20740.0;2023;10;LYON;FEMININ;INDIVIDUEL;BAC PROFESSIONNEL;BAC PRO SERV;BAC PRO 30004 ASSISTANC.GEST.ORGANIS.ACTIVITES;25;17;13;2;2;2;0;15;0;0;1;1;13;2
20770.0;2023;10;LYON;FEMININ;SCOLAIRE;BAC PROFESSIONNEL;BAC PRO PROD;BAC PRO 23203 TECHNICIEN BAT. : ORG.REAL.GROS O;1;1;0;1;0;0;0;0;0;0;0;0;0;1
20771.0;2023;10;LYON;FEMININ;SCOLAIRE;BAC PROFESSIONNEL;BAC PRO PROD;BAC PRO 23304 AMENAGEMENT FINITION BATIMENT;1;1;1;0;0;0;0;1;0;0;0;1;0;0
20772.0;2023;10;LYON;FEMININ;SCOLAIRE;BAC PROFESSIONNEL;BAC PRO PROD;BAC PRO 23405 TECHNICIEN MENUISIER AGENCEUR;8;8;6;2;0;0;0;6;0;0;0;3;3;2
20774.0;2023;10;LYON;FEMININ;SCOLAIRE;BAC PROFESSIONNEL;BAC PRO PROD;BAC PRO 23407 TECHNIC.FAB.BOIS ET MATERX ASSOC;2;2;1;0;1;1;0;2;0;0;0;1;1;0
20777.0;2023;10;LYON;FEMININ;SCOLAIRE;BAC PROFESSIONNEL;BAC PRO PROD;BAC PRO 24202 ARTIS.& MET.ART : TAPIS.D'AMEUBL;16;16;14;2;0;0;0;14;0;1;4;7;2;2
20781.0;2023;10;LYON;FEMININ;SCOLAIRE;BAC PROFESSIONNEL;BAC PRO PROD;BAC PRO 25007 MAINTENANCE EQUIPEMENTS INDUST.;4;4;4;0;0;0;0;4;0;1;1;1;1;0
20786.0;2023;10;LYON;FEMININ;SCOLAIRE;BAC PROFESSIONNEL;BAC PRO PROD;BAC PRO 25411 TECH.CHAUDRONNERIE INDUSTRIELLE;1;1;1;0;0;0;0;1;0;0;0;1;0;0
20788.0;2023;10;LYON;FEMININ;SCOLAIRE;BAC PROFESSIONNEL;BAC PRO PROD;BAC PRO 25513 SYST.NUM.OPT.A SURETE SECURITE;2;2;2;0;0;0;0;2;0;0;1;0;1;0
20791.0;2023;10;LYON;FEMININ;SCOLAIRE;BAC PROFESSIONNEL;BAC PRO PROD;BAC PRO AG 21004 CGEA;17;16;15;1;0;0;0;15;0;0;4;6;5;1
20792.0;2023;10;LYON;FEMININ;SCOLAIRE;BAC PROFESSIONNEL;BAC PRO PROD;BAC PRO AG 21114 CONDUITE PRODUCTIONS HORTICOLES;10;10;9;1;0;0;0;9;0;0;1;2;6;1
20796.0;2023;10;LYON;FEMININ;SCOLAIRE;BAC PROFESSIONNEL;BAC PRO PROD;BAC PRO AG 21212 TECH EXPE ANIMALE;20;18;14;4;0;0;0;14;0;0;1;8;5;4
20800.0;2023;10;LYON;FEMININ;SCOLAIRE;BAC PROFESSIONNEL;BAC PRO PROD;BAC PRO AG 22105 LABORATOIRE CONTROLE QUALITE;27;27;26;1;0;0;0;26;0;3;4;7;12;1
20807.0;2023;10;LYON;FEMININ;SCOLAIRE;BAC PROFESSIONNEL;BAC PRO SERV;BAC PRO 31213 MET.COM.VEN.OP.A ANI.GES.ESP.COM.;396;396;322;39;35;26;9;348;0;21;71;136;120;48
20808.0;2023;10;LYON;FEMININ;SCOLAIRE;BAC PROFESSIONNEL;BAC PRO SERV;BAC PRO 31214 MET.COM.VEN.OP.B PR.CL.VA.OF.COM.;143;143;129;10;4;4;0;133;0;7;31;52;43;10
20817.0;2023;10;LYON;FEMININ;SCOLAIRE;BAC PROFESSIONNEL;BAC PRO SERV;BAC PRO 33101 OPTIQUE LUNETTERIE;16;16;12;2;2;2;0;14;0;2;4;2;6;2
20822.0;2023;10;LYON;FEMININ;SCOLAIRE;BAC PROFESSIONNEL;BAC PRO SERV;BAC PRO 33604 METIERS DE LA COIFFURE;3;3;2;1;0;0;0;2;0;0;0;1;1;1
20831.0;2023;10;LYON;FEMININ;SCOLAIRE;BAC TECHNOLOGIQUE;BAC STHR;BAC STHR SC.&TEC. HOTELLERIE-RESTAURATION;41;41;40;0;1;1;0;41;1;2;14;13;11;0
20832.0;2023;10;LYON;FEMININ;SCOLAIRE;BAC TECHNOLOGIQUE;BAC STI2D;BAC STI2D ARCHITECTURE ET CONSTRUCTION;88;88;80;3;5;3;2;83;1;5;18;31;28;5
20835.0;2023;10;LYON;FEMININ;SCOLAIRE;BAC TECHNOLOGIQUE;BAC STI2D;BAC STI2D SYSTÈME D'INFORMATION  ET NUMERIQUE;27;27;23;1;3;1;2;24;0;4;4;7;9;3
20836.0;2023;10;LYON;FEMININ;SCOLAIRE;BAC TECHNOLOGIQUE;BAC STL;BAC STL BIOCHIM.-BIOLOGIE-BIOTECHNOL.;117;117;103;5;9;4;5;107;0;11;18;43;35;10
20839.0;2023;10;LYON;FEMININ;SCOLAIRE;BAC TECHNOLOGIQUE;BAC STMG;BAC STMG MERCATIQUE (MARKETING);1082;1082;813;69;200;141;59;954;0;13;69;274;598;128
20841.0;2023;10;LYON;FEMININ;SCOLAIRE;BAC TECHNOLOGIQUE;BAC STMG;BAC STMG SYSTEMES D'INFORMATION DE GESTION;26;26;19;1;6;4;2;23;0;0;1;5;17;3
20851.0;2023;10;LYON;MASCULIN;APPRENTISSAGE;BAC PROFESSIONNEL;BAC PRO PROD;BAC PRO 22705 TECHNICIEN GAZ;9;9;9;0;0;0;0;9;0;4;4;1;0;0
20854.0;2023;10;LYON;MASCULIN;APPRENTISSAGE;BAC PROFESSIONNEL;BAC PRO PROD;BAC PRO 23203 TECHNICIEN BAT. : ORG.REAL.GROS O;17;17;14;0;3;2;1;16;0;3;6;2;5;1
20859.0;2023;10;LYON;MASCULIN;APPRENTISSAGE;BAC PROFESSIONNEL;BAC PRO PROD;BAC PRO 23405 TECHNICIEN MENUISIER AGENCEUR;34;32;27;4;1;0;1;27;0;3;12;6;6;5
20868.0;2023;10;LYON;MASCULIN;APPRENTISSAGE;BAC PROFESSIONNEL;BAC PRO PROD;BAC PRO 25215 MAINT.VEHIC.OPTB VEHIC.TRANS.ROUT;5;5;5;0;0;0;0;5;0;1;1;2;1;0
20869.0;2023;10;LYON;MASCULIN;APPRENTISSAGE;BAC PROFESSIONNEL;BAC PRO PROD;BAC PRO 25216 MAINT.VEHIC.OPTC MOTOCYCLES;6;5;5;0;0;0;0;5;0;3;1;1;0;0
20870.0;2023;10;LYON;MASCULIN;APPRENTISSAGE;BAC PROFESSIONNEL;BAC PRO PROD;BAC PRO 25219 MAINT.MATERIELS OPT.A AGRICOLES;25;25;24;0;1;1;0;25;0;0;8;9;8;0
20871.0;2023;10;LYON;MASCULIN;APPRENTISSAGE;BAC PROFESSIONNEL;BAC PRO PROD;BAC PRO 25220 MAINT.MATERIELS OPT.B TP MANUT.;23;23;22;1;0;0;0;22;0;1;7;6;8;1
20874.0;2023;10;LYON;MASCULIN;APPRENTISSAGE;BAC PROFESSIONNEL;BAC PRO PROD;BAC PRO 25408 REPARATION DES CARROSSERIES;43;43;43;0;0;0;0;43;0;2;12;16;13;0
20875.0;2023;10;LYON;MASCULIN;APPRENTISSAGE;BAC PROFESSIONNEL;BAC PRO PROD;BAC PRO 25410 CONSTRUCTION DES CARROSSERIES;5;5;5;0;0;0;0;5;0;1;2;1;1;0
20881.0;2023;10;LYON;MASCULIN;APPRENTISSAGE;BAC PROFESSIONNEL;BAC PRO PROD;BAC PRO AG 21001 AGRO-EQUIPEMENT;11;11;6;5;0;0;0;6;0;0;1;1;4;5
20885.0;2023;10;LYON;MASCULIN;APPRENTISSAGE;BAC PROFESSIONNEL;BAC PRO PROD;BAC PRO AG 21203 TECHN CONSEIL DE VENTE ANIMAL;2;2;1;1;0;0;0;1;0;0;0;1;0;1
20893.0;2023;10;LYON;MASCULIN;APPRENTISSAGE;BAC PROFESSIONNEL;BAC PRO SERV;BAC PRO 31106 LOGISTIQUE;16;15;11;4;0;0;0;11;0;0;2;4;5;4
20898.0;2023;10;LYON;MASCULIN;APPRENTISSAGE;BAC PROFESSIONNEL;BAC PRO SERV;BAC PRO 32208 REAL.PR.IMPR.PLURI.OPTB.PR.IMPR.;10;9;9;0;0;0;0;9;0;2;1;4;2;0
20902.0;2023;10;LYON;MASCULIN;APPRENTISSAGE;BAC PROFESSIONNEL;BAC PRO SERV;BAC PRO 33604 METIERS DE LA COIFFURE;3;3;2;1;0;0;0;2;0;0;0;1;1;1
20904.0;2023;10;LYON;MASCULIN;ENSEIGNEMENT A DISTANCE;BAC GENERAL;BAC GENERAL;BAC GENE 10019 BAC GENERAL;34;34;17;10;7;3;4;20;0;1;3;7;9;14
20917.0;2023;10;LYON;MASCULIN;INDIVIDUEL;BAC PROFESSIONNEL;BAC PRO PROD;BAC PRO 22003 BIO-INDUSTRIES DE TRANSFORMATION;1;1;1;0;0;0;0;1;0;0;0;0;1;0
20922.0;2023;10;LYON;MASCULIN;INDIVIDUEL;BAC PROFESSIONNEL;BAC PRO PROD;BAC PRO 24203 METIERS DE LA MODE - VÊTEMENT;1;1;0;1;0;0;0;0;0;0;0;0;0;1
20923.0;2023;10;LYON;MASCULIN;INDIVIDUEL;BAC PROFESSIONNEL;BAC PRO PROD;BAC PRO 25007 MAINTENANCE EQUIPEMENTS INDUST.;4;2;1;1;0;0;0;1;0;0;0;0;1;1
20932.0;2023;10;LYON;MASCULIN;INDIVIDUEL;BAC PROFESSIONNEL;BAC PRO PROD;BAC PRO AG 21004 CGEA;2;2;1;1;0;0;0;1;0;0;0;0;1;1
20944.0;2023;10;LYON;MASCULIN;INDIVIDUEL;BAC TECHNOLOGIQUE;BAC S2TMD;BAC S2TMD DANSE;2;2;2;0;0;0;0;2;0;0;0;1;1;0
20945.0;2023;10;LYON;MASCULIN;INDIVIDUEL;BAC TECHNOLOGIQUE;BAC ST2S;BAC ST2S SCIENCES & TECHNO. SANTE & SOCIAL;5;5;2;3;0;0;0;2;0;0;0;0;2;3
20948.0;2023;10;LYON;MASCULIN;INDIVIDUEL;BAC TECHNOLOGIQUE;BAC STHR;BAC STHR SC.&TEC. HOTELLERIE-RESTAURATION;1;1;0;1;0;0;0;0;0;0;0;0;0;1
20951.0;2023;10;LYON;MASCULIN;INDIVIDUEL;BAC TECHNOLOGIQUE;BAC STI2D;BAC STI2D SYSTÈME D'INFORMATION  ET NUMERIQUE;3;3;0;3;0;0;0;0;0;0;0;0;0;3
20954.0;2023;10;LYON;MASCULIN;INDIVIDUEL;BAC TECHNOLOGIQUE;BAC STMG;BAC STMG RESSOURCES HUMAINES ET COMMUNICATION;13;11;0;7;4;3;1;3;0;0;0;0;3;8
20960.0;2023;10;LYON;MASCULIN;SCOLAIRE;BAC PROFESSIONNEL;BAC PRO PROD;BAC PRO 22004 PROC. CHIMIE EAU PAPIERS-CARTONS;15;15;11;2;2;2;0;13;0;0;0;8;5;2
20965.0;2023;10;LYON;MASCULIN;SCOLAIRE;BAC PROFESSIONNEL;BAC PRO PROD;BAC PRO 22503 PLASTIQUES ET COMPOSITES;14;14;11;1;2;1;1;12;0;1;1;3;7;2
20970.0;2023;10;LYON;MASCULIN;SCOLAIRE;BAC PROFESSIONNEL;BAC PRO PROD;BAC PRO 23005 TECHN. ETUDES BAT B ASSIST.ARCHI.;33;33;23;9;1;1;0;24;0;0;6;7;11;9
20973.0;2023;10;LYON;MASCULIN;SCOLAIRE;BAC PROFESSIONNEL;BAC PRO PROD;BAC PRO 23203 TECHNICIEN BAT. : ORG.REAL.GROS O;27;27;10;14;3;3;0;13;0;0;5;2;6;14
20974.0;2023;10;LYON;MASCULIN;SCOLAIRE;BAC PROFESSIONNEL;BAC PRO PROD;BAC PRO 23303 MENUISERIE ALUMINIUM-VERRE;15;15;9;3;3;2;1;11;0;0;1;2;8;4
20982.0;2023;10;LYON;MASCULIN;SCOLAIRE;BAC PROFESSIONNEL;BAC PRO PROD;BAC PRO 24202 ARTIS.& MET.ART : TAPIS.D'AMEUBL;2;2;1;0;1;1;0;2;0;0;1;0;1;0
20984.0;2023;10;LYON;MASCULIN;SCOLAIRE;BAC PROFESSIONNEL;BAC PRO PROD;BAC PRO 24302 METIERS DU CUIR : MAROQUINERIE;2;2;2;0;0;0;0;2;0;0;0;1;1;0
20987.0;2023;10;LYON;MASCULIN;SCOLAIRE;BAC PROFESSIONNEL;BAC PRO PROD;BAC PRO 25007 MAINTENANCE EQUIPEMENTS INDUST.;226;225;144;70;11;9;2;153;0;7;23;54;69;72
20990.0;2023;10;LYON;MASCULIN;SCOLAIRE;BAC PROFESSIONNEL;BAC PRO PROD;BAC PRO 25108 TECHNICIEN MODELEUR;4;4;1;3;0;0;0;1;0;0;1;0;0;3
20991.0;2023;10;LYON;MASCULIN;SCOLAIRE;BAC PROFESSIONNEL;BAC PRO PROD;BAC PRO 25214 MAINT.VEHIC.OPTA VOIT.PARTICUL.;196;194;142;34;18;15;3;157;0;8;31;52;66;37
20999.0;2023;10;LYON;MASCULIN;SCOLAIRE;BAC PROFESSIONNEL;BAC PRO PROD;BAC PRO 25411 TECH.CHAUDRONNERIE INDUSTRIELLE;85;83;70;4;9;6;3;76;0;5;21;29;21;7
21004.0;2023;10;LYON;MASCULIN;SCOLAIRE;BAC PROFESSIONNEL;BAC PRO PROD;BAC PRO 25515 SYST.NUM.OPT.C RES.INF.SYST.COMM.;331;330;257;54;19;18;1;275;0;17;60;106;92;55
21022.0;2023;10;LYON;MASCULIN;SCOLAIRE;BAC PROFESSIONNEL;BAC PRO SERV;BAC PRO 31114 ORGANIS. TRANSPORT MARCHANDISES;81;81;53;27;1;1;0;54;0;6;9;21;18;27
21023.0;2023;10;LYON;MASCULIN;SCOLAIRE;BAC PROFESSIONNEL;BAC PRO SERV;BAC PRO 31212 METIERS DE L'ACCUEIL;64;64;38;15;11;9;2;47;0;1;10;18;18;17
21028.0;2023;10;LYON;MASCULIN;SCOLAIRE;BAC PROFESSIONNEL;BAC PRO SERV;BAC PRO 32303 ART.& MET.ART:COM.VIS.VIS.PLURI-M;28;28;25;3;0;0;0;25;0;3;6;9;7;3
21029.0;2023;10;LYON;MASCULIN;SCOLAIRE;BAC PROFESSIONNEL;BAC PRO SERV;BAC PRO 32304 PHOTOGRAPHIE;10;10;9;1;0;0;0;9;0;1;2;3;3;1
21032.0;2023;10;LYON;MASCULIN;SCOLAIRE;BAC PROFESSIONNEL;BAC PRO SERV;BAC PRO 33006 ANIMAT. ENFANCE& PERSONNES AGEES;18;18;14;2;2;2;0;16;0;1;3;8;4;2
21040.0;2023;10;LYON;MASCULIN;SCOLAIRE;BAC PROFESSIONNEL;BAC PRO SERV;BAC PRO AG 33002 SERV PERS TERRIT;29;29;26;3;0;0;0;26;0;2;0;8;16;3
21042.0;2023;10;LYON;MASCULIN;SCOLAIRE;BAC TECHNOLOGIQUE;BAC ST2S;BAC ST2S SCIENCES & TECHNO. SANTE & SOCIAL;178;178;131;11;36;20;16;151;0;2;14;38;97;27
21052.0;2023;10;LYON;MASCULIN;SCOLAIRE;BAC TECHNOLOGIQUE;BAC STMG;BAC STMG GESTION ET FINANCE;630;630;517;36;77;68;9;585;0;2;41;193;349;45
21054.0;2023;10;LYON;MASCULIN;SCOLAIRE;BAC TECHNOLOGIQUE;BAC STMG;BAC STMG RESSOURCES HUMAINES ET COMMUNICATION;298;298;176;52;70;54;16;230;0;1;10;62;157;68
21068.0;2023;31;MARTINIQUE;FEMININ;INDIVIDUEL;BAC PROFESSIONNEL;BAC PRO SERV;BAC PRO 30004 ASSISTANC.GEST.ORGANIS.ACTIVITES;3;1;0;1;0;0;0;0;0;0;0;0;0;1
21071.0;2023;31;MARTINIQUE;FEMININ;INDIVIDUEL;BAC PROFESSIONNEL;BAC PRO SERV;BAC PRO 33004 ACC.SOINS-S.PERS. OPT.EN STRUCTUR;2;2;0;2;0;0;0;0;0;0;0;0;0;2
21077.0;2023;31;MARTINIQUE;FEMININ;SCOLAIRE;BAC PROFESSIONNEL;BAC PRO PROD;BAC PRO 22003 BIO-INDUSTRIES DE TRANSFORMATION;8;8;4;2;2;1;1;5;0;0;1;1;3;3
21082.0;2023;31;MARTINIQUE;FEMININ;SCOLAIRE;BAC PROFESSIONNEL;BAC PRO PROD;BAC PRO 23004 TECHN. ETUDES BAT.A ETUDES & ECO.;1;1;1;0;0;0;0;1;0;0;0;0;1;0
21085.0;2023;31;MARTINIQUE;FEMININ;SCOLAIRE;BAC PROFESSIONNEL;BAC PRO PROD;BAC PRO 23408 Etude et réalisation d'agencement;2;2;2;0;0;0;0;2;0;0;0;0;2;0
21089.0;2023;31;MARTINIQUE;FEMININ;SCOLAIRE;BAC PROFESSIONNEL;BAC PRO PROD;BAC PRO 25509 TECHNIC. FROID CONDITIONNEMT AIR;1;1;1;0;0;0;0;1;0;0;0;1;0;0
21090.0;2023;31;MARTINIQUE;FEMININ;SCOLAIRE;BAC PROFESSIONNEL;BAC PRO PROD;BAC PRO 25510 METIERS ELECT. ENVIRON. CONNECTES;1;1;0;1;0;0;0;0;0;0;0;0;0;1
21096.0;2023;31;MARTINIQUE;FEMININ;SCOLAIRE;BAC PROFESSIONNEL;BAC PRO SERV;BAC PRO 30004 ASSISTANC.GEST.ORGANIS.ACTIVITES;90;90;61;21;8;3;5;64;0;0;9;26;29;26
21097.0;2023;31;MARTINIQUE;FEMININ;SCOLAIRE;BAC PROFESSIONNEL;BAC PRO SERV;BAC PRO 31106 LOGISTIQUE;2;2;2;0;0;0;0;2;0;0;0;1;1;0
21113.0;2023;31;MARTINIQUE;FEMININ;SCOLAIRE;BAC PROFESSIONNEL;BAC PRO SERV;BAC PRO AG 33002 SERV PERS TERRIT;31;31;31;0;0;0;0;31;0;0;4;12;15;0
21116.0;2023;31;MARTINIQUE;FEMININ;SCOLAIRE;BAC TECHNOLOGIQUE;BAC STD2A;BAC STD2A SCIENCES & TECHNO. DESIGN-ARTS APPLIQUES;25;25;25;0;0;0;0;25;0;1;4;13;7;0
21122.0;2023;31;MARTINIQUE;FEMININ;SCOLAIRE;BAC TECHNOLOGIQUE;BAC STMG;BAC STMG GESTION ET FINANCE;51;51;48;0;3;3;0;51;0;0;6;20;25;0
21126.0;2023;31;MARTINIQUE;MASCULIN;APPRENTISSAGE;BAC PROFESSIONNEL;BAC PRO PROD;BAC PRO 22105 BOULANGER-PÂTISSIER;6;5;2;2;1;1;0;3;0;0;0;0;3;2
21134.0;2023;31;MARTINIQUE;MASCULIN;APPRENTISSAGE;BAC PROFESSIONNEL;BAC PRO PROD;BAC PRO 25408 REPARATION DES CARROSSERIES;6;5;1;2;2;2;0;3;0;0;1;0;2;2
21135.0;2023;31;MARTINIQUE;MASCULIN;APPRENTISSAGE;BAC PROFESSIONNEL;BAC PRO PROD;BAC PRO 25510 METIERS ELECT. ENVIRON. CONNECTES;6;6;4;1;1;1;0;5;0;1;3;0;1;1
21143.0;2023;31;MARTINIQUE;MASCULIN;INDIVIDUEL;BAC PROFESSIONNEL;BAC PRO PROD;BAC PRO 22703 TECHN.INSTALL.SYST.ENERG.CLIMATI;1;1;0;1;0;0;0;0;0;0;0;0;0;1
21147.0;2023;31;MARTINIQUE;MASCULIN;INDIVIDUEL;BAC PROFESSIONNEL;BAC PRO PROD;BAC PRO 25510 METIERS ELECT. ENVIRON. CONNECTES;1;0;0;0;0;0;0;0;0;0;0;0;0;0
21152.0;2023;31;MARTINIQUE;MASCULIN;SCOLAIRE;BAC GENERAL;BAC GENERAL;BAC GENE 10019 BAC GENERAL;807;807;706;19;82;74;8;780;12;69;134;236;329;27
21155.0;2023;31;MARTINIQUE;MASCULIN;SCOLAIRE;BAC PROFESSIONNEL;BAC PRO PROD;BAC PRO 22105 BOULANGER-PÂTISSIER;26;26;18;5;3;3;0;21;0;0;1;6;14;5
21158.0;2023;31;MARTINIQUE;MASCULIN;SCOLAIRE;BAC PROFESSIONNEL;BAC PRO PROD;BAC PRO 23003 ARTIS. & M.ART:MARCHANDISAGE VIS.;8;8;8;0;0;0;0;8;0;0;0;3;5;0
21167.0;2023;31;MARTINIQUE;MASCULIN;SCOLAIRE;BAC PROFESSIONNEL;BAC PRO PROD;BAC PRO 23405 TECHNICIEN MENUISIER AGENCEUR;11;11;5;3;3;2;1;7;0;1;0;2;4;4
21168.0;2023;31;MARTINIQUE;MASCULIN;SCOLAIRE;BAC PROFESSIONNEL;BAC PRO PROD;BAC PRO 23408 Etude et réalisation d'agencement;1;1;1;0;0;0;0;1;0;0;0;1;0;0
21171.0;2023;31;MARTINIQUE;MASCULIN;SCOLAIRE;BAC PROFESSIONNEL;BAC PRO PROD;BAC PRO 25009 MAINTENANCE NAUTIQUE;22;22;11;9;2;2;0;13;0;0;2;1;10;9
21172.0;2023;31;MARTINIQUE;MASCULIN;SCOLAIRE;BAC PROFESSIONNEL;BAC PRO PROD;BAC PRO 25106 TECHNICIEN D'USINAGE;10;10;10;0;0;0;0;10;0;1;0;4;5;0
21175.0;2023;31;MARTINIQUE;MASCULIN;SCOLAIRE;BAC PROFESSIONNEL;BAC PRO PROD;BAC PRO 25220 MAINT.MATERIELS OPT.B TP MANUT.;5;5;3;1;1;1;0;4;0;0;1;2;1;1
21185.0;2023;31;MARTINIQUE;MASCULIN;SCOLAIRE;BAC PROFESSIONNEL;BAC PRO PROD;BAC PRO AG 21004 CGEA;10;10;10;0;0;0;0;10;0;1;0;7;2;0
21200.0;2023;31;MARTINIQUE;MASCULIN;SCOLAIRE;BAC PROFESSIONNEL;BAC PRO SERV;BAC PRO 33604 METIERS DE LA COIFFURE;3;3;1;2;0;0;0;1;0;0;0;0;1;2
21205.0;2023;31;MARTINIQUE;MASCULIN;SCOLAIRE;BAC TECHNOLOGIQUE;BAC ST2S;BAC ST2S SCIENCES & TECHNO. SANTE & SOCIAL;29;29;24;1;4;4;0;28;0;0;5;10;13;1
21207.0;2023;31;MARTINIQUE;MASCULIN;SCOLAIRE;BAC TECHNOLOGIQUE;BAC STD2A;BAC STD2A SCIENCES & TECHNO. DESIGN-ARTS APPLIQUES;10;10;10;0;0;0;0;10;0;0;1;3;6;0
21220.0;2023;43;MAYOTTE;FEMININ;APPRENTISSAGE;BAC PROFESSIONNEL;BAC PRO SERV;BAC PRO 31106 LOGISTIQUE;1;1;0;1;0;0;0;0;0;0;0;0;0;1
21236.0;2023;43;MAYOTTE;FEMININ;INDIVIDUEL;BAC TECHNOLOGIQUE;BAC STI2D;BAC STI2D INNOVATION TECHNO.  ET ECO CONCEPTION;1;1;0;0;1;1;0;1;0;0;0;0;1;0
21241.0;2023;43;MAYOTTE;FEMININ;INDIVIDUEL;BAC TECHNOLOGIQUE;BAC STMG;BAC STMG RESSOURCES HUMAINES ET COMMUNICATION;16;16;1;11;4;2;2;3;0;0;0;0;3;13
21247.0;2023;43;MAYOTTE;FEMININ;SCOLAIRE;BAC PROFESSIONNEL;BAC PRO PROD;BACPRO 23103 TECHNICIEN GEOMETRE-TOPOGRAPHE;1;1;0;1;0;0;0;0;0;0;0;0;0;1
21248.0;2023;43;MAYOTTE;FEMININ;SCOLAIRE;BAC PROFESSIONNEL;BAC PRO PROD;BAC PRO 23203 TECHNICIEN BAT. : ORG.REAL.GROS O;1;1;1;0;0;0;0;1;0;0;0;1;0;0
21254.0;2023;43;MAYOTTE;FEMININ;SCOLAIRE;BAC PROFESSIONNEL;BAC PRO PROD;BAC PRO 25509 TECHNIC. FROID CONDITIONNEMT AIR;1;1;1;0;0;0;0;1;0;0;1;0;0;0
21265.0;2023;43;MAYOTTE;FEMININ;SCOLAIRE;BAC PROFESSIONNEL;BAC PRO SERV;BAC PRO 31213 MET.COM.VEN.OP.A ANI.GES.ESP.COM.;112;112;51;54;7;7;0;58;0;0;6;16;36;54
21282.0;2023;43;MAYOTTE;FEMININ;SCOLAIRE;BAC TECHNOLOGIQUE;BAC STL;BAC STL SCIENCES PHYSIQUES CHIMIQUES  EN LABORAT.;98;98;48;7;43;39;4;87;0;1;3;10;73;11
21289.0;2023;43;MAYOTTE;MASCULIN;APPRENTISSAGE;BAC PROFESSIONNEL;BAC PRO SERV;BAC PRO 31213 MET.COM.VEN.OP.A ANI.GES.ESP.COM.;1;1;1;0;0;0;0;1;0;1;0;0;0;0
21290.0;2023;43;MAYOTTE;MASCULIN;APPRENTISSAGE;BAC PROFESSIONNEL;BAC PRO SERV;BAC PRO 34403 METIERS DE LA SECURITE;4;4;4;0;0;0;0;4;0;0;1;2;1;0
21310.0;2023;43;MAYOTTE;MASCULIN;INDIVIDUEL;BAC TECHNOLOGIQUE;BAC STD2A;BAC STD2A SCIENCES & TECHNO. DESIGN-ARTS APPLIQUES;1;1;0;1;0;0;0;0;0;0;0;0;0;1
21325.0;2023;43;MAYOTTE;MASCULIN;SCOLAIRE;BAC PROFESSIONNEL;BAC PRO PROD;BAC PRO 23405 TECHNICIEN MENUISIER AGENCEUR;15;15;2;13;0;0;0;2;0;0;0;0;2;13
21329.0;2023;43;MAYOTTE;MASCULIN;SCOLAIRE;BAC PROFESSIONNEL;BAC PRO PROD;BAC PRO 25214 MAINT.VEHIC.OPTA VOIT.PARTICUL.;53;53;21;15;17;12;5;33;0;1;3;4;25;20
21333.0;2023;43;MAYOTTE;MASCULIN;SCOLAIRE;BAC PROFESSIONNEL;BAC PRO PROD;BAC PRO 25509 TECHNIC. FROID CONDITIONNEMT AIR;14;14;7;6;1;1;0;8;0;1;1;1;5;6
21335.0;2023;43;MAYOTTE;MASCULIN;SCOLAIRE;BAC PROFESSIONNEL;BAC PRO PROD;BAC PRO 25513 SYST.NUM.OPT.A SURETE SECURITE;19;18;11;4;3;3;0;14;0;0;0;1;13;4
21337.0;2023;43;MAYOTTE;MASCULIN;SCOLAIRE;BAC PROFESSIONNEL;BAC PRO PROD;BAC PRO 25515 SYST.NUM.OPT.C RES.INF.SYST.COMM.;22;22;15;7;0;0;0;15;0;0;1;4;10;7
21344.0;2023;43;MAYOTTE;MASCULIN;SCOLAIRE;BAC PROFESSIONNEL;BAC PRO SERV;BAC PRO 31213 MET.COM.VEN.OP.A ANI.GES.ESP.COM.;89;89;44;38;7;5;2;49;0;0;3;13;33;40
21349.0;2023;43;MAYOTTE;MASCULIN;SCOLAIRE;BAC PROFESSIONNEL;BAC PRO SERV;BAC PRO 33006 ANIMAT. ENFANCE& PERSONNES AGEES;20;20;12;8;0;0;0;12;0;1;4;4;3;8
21357.0;2023;43;MAYOTTE;MASCULIN;SCOLAIRE;BAC TECHNOLOGIQUE;BAC STI2D;BAC STI2D ARCHITECTURE ET CONSTRUCTION;43;43;14;13;16;14;2;28;0;0;2;4;22;15
21360.0;2023;43;MAYOTTE;MASCULIN;SCOLAIRE;BAC TECHNOLOGIQUE;BAC STI2D;BAC STI2D SYSTÈME D'INFORMATION  ET NUMERIQUE;58;58;37;3;18;17;1;54;0;0;2;13;39;4
21365.0;2023;11;MONTPELLIER;FEMININ;APPRENTISSAGE;BAC PROFESSIONNEL;BAC PRO PROD;BAC PRO 22106 CUISINE;8;8;6;2;0;0;0;6;0;0;2;1;3;2
21372.0;2023;11;MONTPELLIER;FEMININ;APPRENTISSAGE;BAC PROFESSIONNEL;BAC PRO PROD;BAC PRO AG 21004 CGEA;1;1;1;0;0;0;0;1;0;0;0;1;0;0
21378.0;2023;11;MONTPELLIER;FEMININ;APPRENTISSAGE;BAC PROFESSIONNEL;BAC PRO SERV;BAC PRO 30004 ASSISTANC.GEST.ORGANIS.ACTIVITES;7;7;7;0;0;0;0;7;0;0;2;2;3;0
21381.0;2023;11;MONTPELLIER;FEMININ;APPRENTISSAGE;BAC PROFESSIONNEL;BAC PRO SERV;BAC PRO 31213 MET.COM.VEN.OP.A ANI.GES.ESP.COM.;44;44;38;4;2;1;1;39;0;1;12;14;12;5
21388.0;2023;11;MONTPELLIER;FEMININ;APPRENTISSAGE;BAC PROFESSIONNEL;BAC PRO SERV;BAC PRO AG 33002 SERV PERS TERRIT;26;26;24;2;0;0;0;24;0;2;4;10;8;2
21393.0;2023;11;MONTPELLIER;FEMININ;ENSEIGNEMENT A DISTANCE;BAC PROFESSIONNEL;BAC PRO SERV;BAC PRO 32304 PHOTOGRAPHIE;1;1;1;0;0;0;0;1;0;0;1;0;0;0
21398.0;2023;11;MONTPELLIER;FEMININ;ENSEIGNEMENT A DISTANCE;BAC TECHNOLOGIQUE;BAC STMG;BAC STMG GESTION ET FINANCE;4;4;1;1;2;2;0;3;0;0;1;0;2;1
21401.0;2023;11;MONTPELLIER;FEMININ;FORMATION CONTINUE;BAC PROFESSIONNEL;BAC PRO PROD;BAC PRO AG 21114 CONDUITE PRODUCTIONS HORTICOLES;1;1;1;0;0;0;0;1;0;0;0;0;1;0
21406.0;2023;11;MONTPELLIER;FEMININ;INDIVIDUEL;BAC PROFESSIONNEL;BAC PRO PROD;BAC PRO 22106 CUISINE;1;1;1;0;0;0;0;1;0;0;1;0;0;0
21412.0;2023;11;MONTPELLIER;FEMININ;INDIVIDUEL;BAC PROFESSIONNEL;BAC PRO SERV;BAC PRO 31106 LOGISTIQUE;2;1;1;0;0;0;0;1;0;0;0;0;1;0
21413.0;2023;11;MONTPELLIER;FEMININ;INDIVIDUEL;BAC PROFESSIONNEL;BAC PRO SERV;BAC PRO 31212 METIERS DE L'ACCUEIL;1;0;0;0;0;0;0;0;0;0;0;0;0;0
21419.0;2023;11;MONTPELLIER;FEMININ;INDIVIDUEL;BAC PROFESSIONNEL;BAC PRO SERV;BAC PRO 33603 ESTHETIQUE COSMETIQUE PARFUMERIE;1;1;0;1;0;0;0;0;0;0;0;0;0;1
21427.0;2023;11;MONTPELLIER;FEMININ;SCOLAIRE;BAC GENERAL;BAC GENERAL;BAC GENE 10019 BAC GENERAL;7967;7967;7452;119;396;289;107;7741;159;1053;2064;2411;2054;226
21434.0;2023;11;MONTPELLIER;FEMININ;SCOLAIRE;BAC PROFESSIONNEL;BAC PRO PROD;BAC PRO 22503 PLASTIQUES ET COMPOSITES;4;4;4;0;0;0;0;4;0;0;0;1;3;0
21438.0;2023;11;MONTPELLIER;FEMININ;SCOLAIRE;BAC PROFESSIONNEL;BAC PRO PROD;BAC PRO 23005 TECHN. ETUDES BAT B ASSIST.ARCHI.;19;19;15;4;0;0;0;15;0;0;2;6;7;4
21441.0;2023;11;MONTPELLIER;FEMININ;SCOLAIRE;BAC PROFESSIONNEL;BAC PRO PROD;BAC PRO 23304 AMENAGEMENT FINITION BATIMENT;3;3;2;1;0;0;0;2;0;1;1;0;0;1
21443.0;2023;11;MONTPELLIER;FEMININ;SCOLAIRE;BAC PROFESSIONNEL;BAC PRO PROD;BAC PRO 23408 Etude et réalisation d'agencement;11;11;7;4;0;0;0;7;0;0;0;2;5;4
21446.0;2023;11;MONTPELLIER;FEMININ;SCOLAIRE;BAC PROFESSIONNEL;BAC PRO PROD;BAC PRO 24302 METIERS DU CUIR : MAROQUINERIE;7;7;5;2;0;0;0;5;0;0;4;1;0;2
21447.0;2023;11;MONTPELLIER;FEMININ;SCOLAIRE;BAC PROFESSIONNEL;BAC PRO PROD;BAC PRO 24303 MET. DU CUIR: SELLERIE GARNISSAGE;16;16;14;2;0;0;0;14;0;3;4;4;3;2
21451.0;2023;11;MONTPELLIER;FEMININ;SCOLAIRE;BAC PROFESSIONNEL;BAC PRO PROD;BAC PRO 25302 AERONAUTIQUE OPTION AVIONIQUE;2;2;2;0;0;0;0;2;0;0;1;0;1;0
21452.0;2023;11;MONTPELLIER;FEMININ;SCOLAIRE;BAC PROFESSIONNEL;BAC PRO PROD;BAC PRO 25303 AERONAUTIQUE OPTION SYSTEMES;1;1;1;0;0;0;0;1;0;0;0;0;1;0
21457.0;2023;11;MONTPELLIER;FEMININ;SCOLAIRE;BAC PROFESSIONNEL;BAC PRO PROD;BAC PRO 25515 SYST.NUM.OPT.C RES.INF.SYST.COMM.;7;7;7;0;0;0;0;7;0;0;1;3;3;0
21472.0;2023;11;MONTPELLIER;FEMININ;SCOLAIRE;BAC PROFESSIONNEL;BAC PRO SERV;BAC PRO 31107 CONDUCT. TRANSP.ROUT.MARCHANDISES;5;5;5;0;0;0;0;5;0;2;2;0;1;0
21492.0;2023;11;MONTPELLIER;FEMININ;SCOLAIRE;BAC TECHNOLOGIQUE;BAC S2TMD;BAC S2TMD DANSE;3;3;3;0;0;0;0;3;0;0;3;0;0;0
21495.0;2023;11;MONTPELLIER;FEMININ;SCOLAIRE;BAC TECHNOLOGIQUE;BAC STAV;BAC STAV AGRONOMIE ALIM ENV TERRITOI;96;95;94;1;0;0;0;94;0;2;10;26;56;1
21502.0;2023;11;MONTPELLIER;FEMININ;SCOLAIRE;BAC TECHNOLOGIQUE;BAC STL;BAC STL BIOCHIM.-BIOLOGIE-BIOTECHNOL.;101;101;96;0;5;4;1;100;1;12;19;36;32;1
21510.0;2023;11;MONTPELLIER;MASCULIN;APPRENTISSAGE;BAC PROFESSIONNEL;BAC PRO PROD;BAC PRO 22106 CUISINE;17;17;14;2;1;1;0;15;0;2;2;4;7;2
21514.0;2023;11;MONTPELLIER;MASCULIN;APPRENTISSAGE;BAC PROFESSIONNEL;BAC PRO PROD;BAC PRO 23004 TECHN. ETUDES BAT.A ETUDES & ECO.;2;2;1;1;0;0;0;1;0;0;0;0;1;1
21517.0;2023;11;MONTPELLIER;MASCULIN;APPRENTISSAGE;BAC PROFESSIONNEL;BAC PRO PROD;BAC PRO 23303 MENUISERIE ALUMINIUM-VERRE;2;2;1;1;0;0;0;1;0;0;0;0;1;1
21518.0;2023;11;MONTPELLIER;MASCULIN;APPRENTISSAGE;BAC PROFESSIONNEL;BAC PRO PROD;BAC PRO 23404 TECHNICIEN CONSTRUCTEUR BOIS;11;10;6;3;1;1;0;7;0;1;2;2;2;3
21529.0;2023;11;MONTPELLIER;MASCULIN;APPRENTISSAGE;BAC PROFESSIONNEL;BAC PRO PROD;BAC PRO 25406 OUVRAGES DU BATIMENT METALLERIE;2;2;1;1;0;0;0;1;0;1;0;0;0;1
21531.0;2023;11;MONTPELLIER;MASCULIN;APPRENTISSAGE;BAC PROFESSIONNEL;BAC PRO PROD;BAC PRO 25411 TECH.CHAUDRONNERIE INDUSTRIELLE;28;27;22;4;1;1;0;23;0;0;5;9;9;4
21534.0;2023;11;MONTPELLIER;MASCULIN;APPRENTISSAGE;BAC PROFESSIONNEL;BAC PRO PROD;BAC PRO 25515 SYST.NUM.OPT.C RES.INF.SYST.COMM.;16;14;11;2;1;0;1;11;0;3;2;3;3;3
21536.0;2023;11;MONTPELLIER;MASCULIN;APPRENTISSAGE;BAC PROFESSIONNEL;BAC PRO PROD;BAC PRO AG 21113 CGEVV;7;7;6;1;0;0;0;6;0;0;2;2;2;1
21537.0;2023;11;MONTPELLIER;MASCULIN;APPRENTISSAGE;BAC PROFESSIONNEL;BAC PRO PROD;BAC PRO AG 21114 CONDUITE PRODUCTIONS HORTICOLES;5;5;4;1;0;0;0;4;0;0;1;3;0;1
21539.0;2023;11;MONTPELLIER;MASCULIN;APPRENTISSAGE;BAC PROFESSIONNEL;BAC PRO PROD;BAC PRO AG 21303 FORET;5;5;5;0;0;0;0;5;0;0;0;2;3;0
21542.0;2023;11;MONTPELLIER;MASCULIN;APPRENTISSAGE;BAC PROFESSIONNEL;BAC PRO SERV;BAC PRO 31106 LOGISTIQUE;31;30;18;10;2;2;0;20;0;0;2;7;11;10
21546.0;2023;11;MONTPELLIER;MASCULIN;APPRENTISSAGE;BAC PROFESSIONNEL;BAC PRO SERV;BAC PRO 33104 TECHNICIEN EN PROTHESE DENTAIRE;2;2;2;0;0;0;0;2;0;0;1;0;1;0
21555.0;2023;11;MONTPELLIER;MASCULIN;ENSEIGNEMENT A DISTANCE;BAC TECHNOLOGIQUE;BAC STMG;BAC STMG MERCATIQUE (MARKETING);14;14;10;3;1;1;0;11;0;0;1;4;6;3
21557.0;2023;11;MONTPELLIER;MASCULIN;FORMATION CONTINUE;BAC PROFESSIONNEL;BAC PRO PROD;BAC PRO 22703 TECHN.INSTALL.SYST.ENERG.CLIMATI;5;5;5;0;0;0;0;5;0;1;1;2;1;0
21564.0;2023;11;MONTPELLIER;MASCULIN;INDIVIDUEL;BAC PROFESSIONNEL;BAC PRO PROD;BAC PRO 22704 TECHN. MAINT. SYST.ENERG.CLIMATI;2;0;0;0;0;0;0;0;0;0;0;0;0;0
21569.0;2023;11;MONTPELLIER;MASCULIN;INDIVIDUEL;BAC PROFESSIONNEL;BAC PRO PROD;BAC PRO 25106 TECHNICIEN D'USINAGE;1;1;1;0;0;0;0;1;0;0;0;0;1;0
21570.0;2023;11;MONTPELLIER;MASCULIN;INDIVIDUEL;BAC PROFESSIONNEL;BAC PRO PROD;BAC PRO 25214 MAINT.VEHIC.OPTA VOIT.PARTICUL.;7;5;1;4;0;0;0;1;0;0;1;0;0;4
21582.0;2023;11;MONTPELLIER;MASCULIN;INDIVIDUEL;BAC PROFESSIONNEL;BAC PRO SERV;BAC PRO 33004 ACC.SOINS-S.PERS. OPT.EN STRUCTUR;1;0;0;0;0;0;0;0;0;0;0;0;0;0
21585.0;2023;11;MONTPELLIER;MASCULIN;INDIVIDUEL;BAC TECHNOLOGIQUE;BAC STI2D;BAC STI2D ARCHITECTURE ET CONSTRUCTION;2;2;1;0;1;1;0;2;0;0;0;1;1;0
21587.0;2023;11;MONTPELLIER;MASCULIN;INDIVIDUEL;BAC TECHNOLOGIQUE;BAC STI2D;BAC STI2D INNOVATION TECHNO.  ET ECO CONCEPTION;3;2;0;2;0;0;0;0;0;0;0;0;0;2
21589.0;2023;11;MONTPELLIER;MASCULIN;INDIVIDUEL;BAC TECHNOLOGIQUE;BAC STL;BAC STL SCIENCES PHYSIQUES CHIMIQUES  EN LABORAT.;2;2;1;1;0;0;0;1;0;0;0;0;1;1
21594.0;2023;11;MONTPELLIER;MASCULIN;SCOLAIRE;BAC GENERAL;BAC GENERAL;BAC GENE 10019 BAC GENERAL;6392;6392;5751;123;518;373;145;6124;106;663;1318;1939;2098;268
21596.0;2023;11;MONTPELLIER;MASCULIN;SCOLAIRE;BAC PROFESSIONNEL;BAC PRO PROD;BAC PRO 20102 PILOTE DE LIGNE DE PRODUCTION;7;7;6;1;0;0;0;6;0;0;1;1;4;1
21597.0;2023;11;MONTPELLIER;MASCULIN;SCOLAIRE;BAC PROFESSIONNEL;BAC PRO PROD;BAC PRO 22003 BIO-INDUSTRIES DE TRANSFORMATION;7;7;5;2;0;0;0;5;0;0;0;1;4;2
21600.0;2023;11;MONTPELLIER;MASCULIN;SCOLAIRE;BAC PROFESSIONNEL;BAC PRO PROD;BAC PRO 22106 CUISINE;132;132;105;21;6;5;1;110;0;9;25;34;42;22
21617.0;2023;11;MONTPELLIER;MASCULIN;SCOLAIRE;BAC PROFESSIONNEL;BAC PRO PROD;BAC PRO 23408 Etude et réalisation d'agencement;4;4;3;1;0;0;0;3;0;2;1;0;0;1
21620.0;2023;11;MONTPELLIER;MASCULIN;SCOLAIRE;BAC PROFESSIONNEL;BAC PRO PROD;BAC PRO 24303 MET. DU CUIR: SELLERIE GARNISSAGE;2;2;1;1;0;0;0;1;0;0;1;0;0;1
21623.0;2023;11;MONTPELLIER;MASCULIN;SCOLAIRE;BAC PROFESSIONNEL;BAC PRO PROD;BAC PRO 25009 MAINTENANCE NAUTIQUE;42;42;30;9;3;2;1;32;0;1;1;18;12;10
21630.0;2023;11;MONTPELLIER;MASCULIN;SCOLAIRE;BAC PROFESSIONNEL;BAC PRO PROD;BAC PRO 25302 AERONAUTIQUE OPTION AVIONIQUE;12;12;12;0;0;0;0;12;0;1;6;1;4;0
21635.0;2023;11;MONTPELLIER;MASCULIN;SCOLAIRE;BAC PROFESSIONNEL;BAC PRO PROD;BAC PRO 25509 TECHNIC. FROID CONDITIONNEMT AIR;70;69;39;29;1;1;0;40;0;1;5;8;26;29
21637.0;2023;11;MONTPELLIER;MASCULIN;SCOLAIRE;BAC PROFESSIONNEL;BAC PRO PROD;BAC PRO 25513 SYST.NUM.OPT.A SURETE SECURITE;11;11;10;1;0;0;0;10;0;2;1;5;2;1
21645.0;2023;11;MONTPELLIER;MASCULIN;SCOLAIRE;BAC PROFESSIONNEL;BAC PRO PROD;BAC PRO AG 21204 PROD-AQUACOLES;9;9;7;2;0;0;0;7;0;0;0;2;5;2
21647.0;2023;11;MONTPELLIER;MASCULIN;SCOLAIRE;BAC PROFESSIONNEL;BAC PRO PROD;BAC PRO AG 21211 COND GEST ENTR HIPPIQUE;1;1;1;0;0;0;0;1;0;0;0;0;1;0
21653.0;2023;11;MONTPELLIER;MASCULIN;SCOLAIRE;BAC PROFESSIONNEL;BAC PRO PROD;BAC PRO AG 22108 TEC CONS VTE ALIMENTATION (PAB);24;23;15;8;0;0;0;15;0;1;0;4;10;8
21657.0;2023;11;MONTPELLIER;MASCULIN;SCOLAIRE;BAC PROFESSIONNEL;BAC PRO SERV;BAC PRO 31114 ORGANIS. TRANSPORT MARCHANDISES;29;28;17;10;1;1;0;18;0;1;3;7;7;10
21664.0;2023;11;MONTPELLIER;MASCULIN;SCOLAIRE;BAC PROFESSIONNEL;BAC PRO SERV;BAC PRO 32304 PHOTOGRAPHIE;7;7;7;0;0;0;0;7;0;1;2;4;0;0
21689.0;2023;11;MONTPELLIER;MASCULIN;SCOLAIRE;BAC TECHNOLOGIQUE;BAC STMG;BAC STMG SYSTEMES D'INFORMATION DE GESTION;28;28;15;7;6;3;3;18;0;0;0;9;9;10
21691.0;2023;12;NANCY-METZ;FEMININ;APPRENTISSAGE;BAC PROFESSIONNEL;BAC PRO PROD;BAC PRO 22106 CUISINE;4;4;3;0;1;1;0;4;0;1;0;1;2;0
21701.0;2023;12;NANCY-METZ;FEMININ;APPRENTISSAGE;BAC PROFESSIONNEL;BAC PRO PROD;BAC PRO 25408 REPARATION DES CARROSSERIES;1;1;1;0;0;0;0;1;0;0;0;1;0;0
21703.0;2023;12;NANCY-METZ;FEMININ;APPRENTISSAGE;BAC PROFESSIONNEL;BAC PRO PROD;BAC PRO 25510 METIERS ELECT. ENVIRON. CONNECTES;1;1;1;0;0;0;0;1;0;1;0;0;0;0
21706.0;2023;12;NANCY-METZ;FEMININ;APPRENTISSAGE;BAC PROFESSIONNEL;BAC PRO PROD;BAC PRO AG 21004 CGEA;13;12;8;4;0;0;0;8;0;0;1;2;5;4
21715.0;2023;12;NANCY-METZ;FEMININ;APPRENTISSAGE;BAC PROFESSIONNEL;BAC PRO SERV;BAC PRO 31212 METIERS DE L'ACCUEIL;4;4;4;0;0;0;0;4;0;3;1;0;0;0
21717.0;2023;12;NANCY-METZ;FEMININ;APPRENTISSAGE;BAC PROFESSIONNEL;BAC PRO SERV;BAC PRO 31214 MET.COM.VEN.OP.B PR.CL.VA.OF.COM.;2;2;2;0;0;0;0;2;0;0;0;1;1;0
21724.0;2023;12;NANCY-METZ;FEMININ;APPRENTISSAGE;BAC PROFESSIONNEL;BAC PRO SERV;BAC PRO AG 33002 SERV PERS TERRIT;6;6;6;0;0;0;0;6;0;0;1;2;3;0
21728.0;2023;12;NANCY-METZ;FEMININ;ENSEIGNEMENT A DISTANCE;BAC PROFESSIONNEL;BAC PRO SERV;BAC PRO 33004 ACC.SOINS-S.PERS. OPT.EN STRUCTUR;3;3;2;1;0;0;0;2;0;0;0;1;1;1
21731.0;2023;12;NANCY-METZ;FEMININ;ENSEIGNEMENT A DISTANCE;BAC TECHNOLOGIQUE;BAC STMG;BAC STMG GESTION ET FINANCE;3;3;2;1;0;0;0;2;0;0;0;0;2;1
21737.0;2023;12;NANCY-METZ;FEMININ;FORMATION CONTINUE;BAC PROFESSIONNEL;BAC PRO PROD;BAC PRO 25214 MAINT.VEHIC.OPTA VOIT.PARTICUL.;1;1;1;0;0;0;0;1;0;1;0;0;0;0
21743.0;2023;12;NANCY-METZ;FEMININ;FORMATION CONTINUE;BAC PROFESSIONNEL;BAC PRO SERV;BAC PRO 31214 MET.COM.VEN.OP.B PR.CL.VA.OF.COM.;4;2;2;0;0;0;0;2;0;0;2;0;0;0
21753.0;2023;12;NANCY-METZ;FEMININ;INDIVIDUEL;BAC PROFESSIONNEL;BAC PRO SERV;BAC PRO 32304 PHOTOGRAPHIE;1;1;1;0;0;0;0;1;0;0;0;0;1;0
21754.0;2023;12;NANCY-METZ;FEMININ;INDIVIDUEL;BAC PROFESSIONNEL;BAC PRO SERV;BAC PRO 33004 ACC.SOINS-S.PERS. OPT.EN STRUCTUR;3;1;0;1;0;0;0;0;0;0;0;0;0;1
21756.0;2023;12;NANCY-METZ;FEMININ;INDIVIDUEL;BAC TECHNOLOGIQUE;BAC S2TMD;BAC S2TMD THEATRE;1;1;1;0;0;0;0;1;0;0;0;0;1;0
21764.0;2023;12;NANCY-METZ;FEMININ;SCOLAIRE;BAC PROFESSIONNEL;BAC PRO PROD;BAC PRO 20102 PILOTE DE LIGNE DE PRODUCTION;1;1;0;0;1;1;0;1;0;0;0;0;1;0
21771.0;2023;12;NANCY-METZ;FEMININ;SCOLAIRE;BAC PROFESSIONNEL;BAC PRO PROD;BAC PRO 23004 TECHN. ETUDES BAT.A ETUDES & ECO.;8;8;6;1;1;1;0;7;0;0;2;2;3;1
21779.0;2023;12;NANCY-METZ;FEMININ;SCOLAIRE;BAC PROFESSIONNEL;BAC PRO PROD;BAC PRO 25007 MAINTENANCE EQUIPEMENTS INDUST.;5;5;5;0;0;0;0;5;0;0;0;5;0;0
21781.0;2023;12;NANCY-METZ;FEMININ;SCOLAIRE;BAC PROFESSIONNEL;BAC PRO PROD;BAC PRO 25214 MAINT.VEHIC.OPTA VOIT.PARTICUL.;12;12;10;2;0;0;0;10;0;3;1;4;2;2
21792.0;2023;12;NANCY-METZ;FEMININ;SCOLAIRE;BAC PROFESSIONNEL;BAC PRO PROD;BAC PRO AG 21203 TECHN CONSEIL DE VENTE ANIMAL;11;11;8;3;0;0;0;8;0;0;1;2;5;3
21794.0;2023;12;NANCY-METZ;FEMININ;SCOLAIRE;BAC PROFESSIONNEL;BAC PRO PROD;BAC PRO AG 21302 GEST MILIEUX NATURELS FAUNE;17;16;14;2;0;0;0;14;0;1;1;5;7;2
21802.0;2023;12;NANCY-METZ;FEMININ;SCOLAIRE;BAC PROFESSIONNEL;BAC PRO SERV;BAC PRO 31213 MET.COM.VEN.OP.A ANI.GES.ESP.COM.;358;358;318;23;17;12;5;330;0;22;83;117;108;28
21809.0;2023;12;NANCY-METZ;FEMININ;SCOLAIRE;BAC PROFESSIONNEL;BAC PRO SERV;BAC PRO 33004 ACC.SOINS-S.PERS. OPT.EN STRUCTUR;556;556;485;44;27;21;6;506;0;34;131;191;150;50
21815.0;2023;12;NANCY-METZ;FEMININ;SCOLAIRE;BAC PROFESSIONNEL;BAC PRO SERV;BAC PRO 33604 METIERS DE LA COIFFURE;43;43;38;5;0;0;0;38;0;0;12;9;17;5
21817.0;2023;12;NANCY-METZ;FEMININ;SCOLAIRE;BAC PROFESSIONNEL;BAC PRO SERV;BAC PRO 34304 HYGIENE PROPRETE STERILISATION;10;10;8;2;0;0;0;8;0;1;4;2;1;2
21819.0;2023;12;NANCY-METZ;FEMININ;SCOLAIRE;BAC PROFESSIONNEL;BAC PRO SERV;BAC PRO AG 33002 SERV PERS TERRIT;76;71;66;5;0;0;0;66;0;1;11;23;31;5
21821.0;2023;12;NANCY-METZ;FEMININ;SCOLAIRE;BAC TECHNOLOGIQUE;BAC S2TMD;BAC S2TMD MUSIQUE;7;7;7;0;0;0;0;7;2;2;1;2;0;0
21840.0;2023;12;NANCY-METZ;MASCULIN;APPRENTISSAGE;BAC PROFESSIONNEL;BAC PRO PROD;BAC PRO 22703 TECHN.INSTALL.SYST.ENERG.CLIMATI;22;22;22;0;0;0;0;22;0;1;6;14;1;0
21842.0;2023;12;NANCY-METZ;MASCULIN;APPRENTISSAGE;BAC PROFESSIONNEL;BAC PRO PROD;BAC PRO 22705 TECHNICIEN GAZ;10;10;10;0;0;0;0;10;0;1;4;4;1;0
21848.0;2023;12;NANCY-METZ;MASCULIN;APPRENTISSAGE;BAC PROFESSIONNEL;BAC PRO PROD;BAC PRO 23405 TECHNICIEN MENUISIER AGENCEUR;14;14;10;4;0;0;0;10;0;1;0;7;2;4
21849.0;2023;12;NANCY-METZ;MASCULIN;APPRENTISSAGE;BAC PROFESSIONNEL;BAC PRO PROD;BAC PRO 23406 TECHNICIEN DE SCIERIE;2;2;1;1;0;0;0;1;0;0;0;0;1;1
21861.0;2023;12;NANCY-METZ;MASCULIN;APPRENTISSAGE;BAC PROFESSIONNEL;BAC PRO PROD;BAC PRO 25303 AERONAUTIQUE OPTION SYSTEMES;4;4;4;0;0;0;0;4;0;2;2;0;0;0
21871.0;2023;12;NANCY-METZ;MASCULIN;APPRENTISSAGE;BAC PROFESSIONNEL;BAC PRO PROD;BAC PRO AG 21004 CGEA;65;62;43;19;0;0;0;43;0;0;4;12;27;19
21873.0;2023;12;NANCY-METZ;MASCULIN;APPRENTISSAGE;BAC PROFESSIONNEL;BAC PRO PROD;BAC PRO AG 21203 TECHN CONSEIL DE VENTE ANIMAL;1;1;1;0;0;0;0;1;0;0;0;0;1;0
21878.0;2023;12;NANCY-METZ;MASCULIN;APPRENTISSAGE;BAC PROFESSIONNEL;BAC PRO PROD;BAC PRO AG 21405 AMENAGEMENTS PAYSAGERS;64;58;53;5;0;0;0;53;0;0;10;17;26;5
21883.0;2023;12;NANCY-METZ;MASCULIN;APPRENTISSAGE;BAC PROFESSIONNEL;BAC PRO SERV;BAC PRO 31214 MET.COM.VEN.OP.B PR.CL.VA.OF.COM.;2;2;2;0;0;0;0;2;0;0;1;1;0;0
21886.0;2023;12;NANCY-METZ;MASCULIN;APPRENTISSAGE;BAC PROFESSIONNEL;BAC PRO SERV;BAC PRO 33403 COMMERC. SERVICES EN RESTAURATION;3;3;2;1;0;0;0;2;0;1;1;0;0;1
21889.0;2023;12;NANCY-METZ;MASCULIN;ENSEIGNEMENT A DISTANCE;BAC PROFESSIONNEL;BAC PRO SERV;BAC PRO 30004 ASSISTANC.GEST.ORGANIS.ACTIVITES;1;0;0;0;0;0;0;0;0;0;0;0;0;0
21897.0;2023;12;NANCY-METZ;MASCULIN;FORMATION CONTINUE;BAC PROFESSIONNEL;BAC PRO PROD;BAC PRO 23407 TECHNIC.FAB.BOIS ET MATERX ASSOC;1;0;0;0;0;0;0;0;0;0;0;0;0;0
21902.0;2023;12;NANCY-METZ;MASCULIN;FORMATION CONTINUE;BAC PROFESSIONNEL;BAC PRO PROD;BAC PRO AG 22108 TEC CONS VTE ALIMENTATION (PAB);4;4;2;2;0;0;0;2;0;0;0;1;1;2
21905.0;2023;12;NANCY-METZ;MASCULIN;FORMATION CONTINUE;BAC PROFESSIONNEL;BAC PRO SERV;BAC PRO 31214 MET.COM.VEN.OP.B PR.CL.VA.OF.COM.;5;5;4;1;0;0;0;4;0;0;2;1;1;1
21908.0;2023;12;NANCY-METZ;MASCULIN;INDIVIDUEL;BAC PROFESSIONNEL;BAC PRO PROD;BAC PRO 20102 PILOTE DE LIGNE DE PRODUCTION;1;1;0;0;1;0;1;0;0;0;0;0;0;1
21914.0;2023;12;NANCY-METZ;MASCULIN;INDIVIDUEL;BAC PROFESSIONNEL;BAC PRO PROD;BAC PRO AG 21114 CONDUITE PRODUCTIONS HORTICOLES;1;1;0;1;0;0;0;0;0;0;0;0;0;1
21916.0;2023;12;NANCY-METZ;MASCULIN;INDIVIDUEL;BAC PROFESSIONNEL;BAC PRO SERV;BAC PRO 30004 ASSISTANC.GEST.ORGANIS.ACTIVITES;1;0;0;0;0;0;0;0;0;0;0;0;0;0
21919.0;2023;12;NANCY-METZ;MASCULIN;INDIVIDUEL;BAC PROFESSIONNEL;BAC PRO SERV;BAC PRO 31214 MET.COM.VEN.OP.B PR.CL.VA.OF.COM.;2;1;0;1;0;0;0;0;0;0;0;0;0;1
21923.0;2023;12;NANCY-METZ;MASCULIN;INDIVIDUEL;BAC TECHNOLOGIQUE;BAC STI2D;BAC STI2D INNOVATION TECHNO.  ET ECO CONCEPTION;6;6;1;5;0;0;0;1;0;0;0;0;1;5
21926.0;2023;12;NANCY-METZ;MASCULIN;INDIVIDUEL;BAC TECHNOLOGIQUE;BAC STMG;BAC STMG MERCATIQUE (MARKETING);22;22;6;11;5;4;1;10;0;0;0;2;8;12
21928.0;2023;12;NANCY-METZ;MASCULIN;INDIVIDUEL;BAC TECHNOLOGIQUE;BAC STMG;BAC STMG SYSTEMES D'INFORMATION DE GESTION;1;1;0;1;0;0;0;0;0;0;0;0;0;1
21936.0;2023;12;NANCY-METZ;MASCULIN;SCOLAIRE;BAC PROFESSIONNEL;BAC PRO PROD;BAC PRO 22403 ARTS.& MET.ART:MET.ENSEIGN SIGNA;11;11;9;2;0;0;0;9;0;0;0;3;6;2
21943.0;2023;12;NANCY-METZ;MASCULIN;SCOLAIRE;BAC PROFESSIONNEL;BAC PRO PROD;BACPRO 23103 TECHNICIEN GEOMETRE-TOPOGRAPHE;6;6;5;1;0;0;0;5;0;0;1;0;4;1
21946.0;2023;12;NANCY-METZ;MASCULIN;SCOLAIRE;BAC PROFESSIONNEL;BAC PRO PROD;BAC PRO 23303 MENUISERIE ALUMINIUM-VERRE;3;3;2;1;0;0;0;2;0;1;0;1;0;1
21948.0;2023;12;NANCY-METZ;MASCULIN;SCOLAIRE;BAC PROFESSIONNEL;BAC PRO PROD;BAC PRO 23404 TECHNICIEN CONSTRUCTEUR BOIS;8;8;5;3;0;0;0;5;0;1;1;1;2;3
21954.0;2023;12;NANCY-METZ;MASCULIN;SCOLAIRE;BAC PROFESSIONNEL;BAC PRO PROD;BAC PRO 25007 MAINTENANCE EQUIPEMENTS INDUST.;207;205;129;59;17;14;3;143;0;4;19;53;67;62
21955.0;2023;12;NANCY-METZ;MASCULIN;SCOLAIRE;BAC PROFESSIONNEL;BAC PRO PROD;BAC PRO 25106 TECHNICIEN D'USINAGE;70;69;50;13;6;2;4;52;0;2;7;16;27;17
21956.0;2023;12;NANCY-METZ;MASCULIN;SCOLAIRE;BAC PROFESSIONNEL;BAC PRO PROD;BAC PRO 25214 MAINT.VEHIC.OPTA VOIT.PARTICUL.;201;201;147;32;22;18;4;165;0;8;43;48;66;36
21965.0;2023;12;NANCY-METZ;MASCULIN;SCOLAIRE;BAC PROFESSIONNEL;BAC PRO PROD;BAC PRO 25408 REPARATION DES CARROSSERIES;56;56;36;14;6;4;2;40;0;1;5;15;19;16
21969.0;2023;12;NANCY-METZ;MASCULIN;SCOLAIRE;BAC PROFESSIONNEL;BAC PRO PROD;BAC PRO 25510 METIERS ELECT. ENVIRON. CONNECTES;453;451;321;99;31;22;9;343;0;34;56;100;153;108
21972.0;2023;12;NANCY-METZ;MASCULIN;SCOLAIRE;BAC PROFESSIONNEL;BAC PRO PROD;BAC PRO 25515 SYST.NUM.OPT.C RES.INF.SYST.COMM.;138;138;108;25;5;5;0;113;0;4;30;39;40;25
21977.0;2023;12;NANCY-METZ;MASCULIN;SCOLAIRE;BAC PROFESSIONNEL;BAC PRO PROD;BAC PRO AG 21210 COND GEST ENTR CANIN ET FELIN;2;2;2;0;0;0;0;2;0;0;0;0;2;0
21981.0;2023;12;NANCY-METZ;MASCULIN;SCOLAIRE;BAC PROFESSIONNEL;BAC PRO PROD;BAC PRO AG 21405 AMENAGEMENTS PAYSAGERS;19;19;17;2;0;0;0;17;0;0;3;6;8;2
21987.0;2023;12;NANCY-METZ;MASCULIN;SCOLAIRE;BAC PROFESSIONNEL;BAC PRO SERV;BAC PRO 31212 METIERS DE L'ACCUEIL;24;24;15;8;1;0;1;15;0;2;3;7;3;9
21996.0;2023;12;NANCY-METZ;MASCULIN;SCOLAIRE;BAC PROFESSIONNEL;BAC PRO SERV;BAC PRO 33006 ANIMAT. ENFANCE& PERSONNES AGEES;28;28;28;0;0;0;0;28;0;1;10;8;9;0
21999.0;2023;12;NANCY-METZ;MASCULIN;SCOLAIRE;BAC PROFESSIONNEL;BAC PRO SERV;BAC PRO 33403 COMMERC. SERVICES EN RESTAURATION;78;78;51;17;10;6;4;57;0;3;13;18;23;21
22000.0;2023;12;NANCY-METZ;MASCULIN;SCOLAIRE;BAC PROFESSIONNEL;BAC PRO SERV;BAC PRO 33603 ESTHETIQUE COSMETIQUE PARFUMERIE;2;2;0;2;0;0;0;0;0;0;0;0;0;2
22002.0;2023;12;NANCY-METZ;MASCULIN;SCOLAIRE;BAC PROFESSIONNEL;BAC PRO SERV;BAC PRO 34303 GEST. POLLUTIONS PROTEC. ENVIRON.;3;3;3;0;0;0;0;3;0;0;1;0;2;0
22007.0;2023;12;NANCY-METZ;MASCULIN;SCOLAIRE;BAC TECHNOLOGIQUE;BAC S2TMD;BAC S2TMD MUSIQUE;9;9;9;0;0;0;0;9;1;1;4;2;1;0
22010.0;2023;12;NANCY-METZ;MASCULIN;SCOLAIRE;BAC TECHNOLOGIQUE;BAC STAV;BAC STAV AGRONOMIE ALIM ENV TERRITOI;79;79;76;3;0;0;0;76;0;0;4;27;45;3
22014.0;2023;12;NANCY-METZ;MASCULIN;SCOLAIRE;BAC TECHNOLOGIQUE;BAC STI2D;BAC STI2D ENERGIES  ET ENVIRONNEMENT;195;195;148;6;41;25;16;173;0;6;14;54;99;22
22015.0;2023;12;NANCY-METZ;MASCULIN;SCOLAIRE;BAC TECHNOLOGIQUE;BAC STI2D;BAC STI2D INNOVATION TECHNO.  ET ECO CONCEPTION;333;333;270;11;52;29;23;299;0;5;42;82;170;34
22016.0;2023;12;NANCY-METZ;MASCULIN;SCOLAIRE;BAC TECHNOLOGIQUE;BAC STI2D;BAC STI2D SYSTÈME D'INFORMATION  ET NUMERIQUE;324;324;279;9;36;27;9;306;2;9;51;99;145;18
22017.0;2023;12;NANCY-METZ;MASCULIN;SCOLAIRE;BAC TECHNOLOGIQUE;BAC STL;BAC STL BIOCHIM.-BIOLOGIE-BIOTECHNOL.;51;51;42;1;8;3;5;45;0;1;6;13;25;6
22028.0;2023;17;NANTES;FEMININ;APPRENTISSAGE;BAC PROFESSIONNEL;BAC PRO PROD;BAC PRO 23004 TECHN. ETUDES BAT.A ETUDES & ECO.;2;2;1;1;0;0;0;1;0;0;0;0;1;1
22030.0;2023;17;NANTES;FEMININ;APPRENTISSAGE;BAC PROFESSIONNEL;BAC PRO PROD;BAC PRO 23102 TRAVAUX PUBLICS;1;1;1;0;0;0;0;1;0;0;0;1;0;0
22044.0;2023;17;NANTES;FEMININ;APPRENTISSAGE;BAC PROFESSIONNEL;BAC PRO PROD;BAC PRO 25411 TECH.CHAUDRONNERIE INDUSTRIELLE;1;1;1;0;0;0;0;1;0;0;0;1;0;0
22045.0;2023;17;NANTES;FEMININ;APPRENTISSAGE;BAC PROFESSIONNEL;BAC PRO PROD;BAC PRO 25510 METIERS ELECT. ENVIRON. CONNECTES;4;4;4;0;0;0;0;4;0;2;1;0;1;0
22047.0;2023;17;NANTES;FEMININ;APPRENTISSAGE;BAC PROFESSIONNEL;BAC PRO PROD;BAC PRO AG 21004 CGEA;34;33;26;7;0;0;0;26;0;0;1;8;17;7
22048.0;2023;17;NANTES;FEMININ;APPRENTISSAGE;BAC PROFESSIONNEL;BAC PRO PROD;BAC PRO AG 21113 CGEVV;3;3;3;0;0;0;0;3;0;0;0;0;3;0
22050.0;2023;17;NANTES;FEMININ;APPRENTISSAGE;BAC PROFESSIONNEL;BAC PRO PROD;BAC PRO AG 21203 TECHN CONSEIL DE VENTE ANIMAL;3;3;3;0;0;0;0;3;0;0;0;1;2;0
22053.0;2023;17;NANTES;FEMININ;APPRENTISSAGE;BAC PROFESSIONNEL;BAC PRO PROD;BAC PRO AG 21211 COND GEST ENTR HIPPIQUE;23;23;20;3;0;0;0;20;0;0;6;5;9;3
22058.0;2023;17;NANTES;FEMININ;APPRENTISSAGE;BAC PROFESSIONNEL;BAC PRO SERV;BAC PRO 31106 LOGISTIQUE;6;6;4;1;1;1;0;5;0;0;1;2;2;1
22068.0;2023;17;NANTES;FEMININ;APPRENTISSAGE;BAC PROFESSIONNEL;BAC PRO SERV;BAC PRO 33104 TECHNICIEN EN PROTHESE DENTAIRE;6;6;6;0;0;0;0;6;0;3;2;1;0;0
22071.0;2023;17;NANTES;FEMININ;APPRENTISSAGE;BAC PROFESSIONNEL;BAC PRO SERV;BAC PRO 33604 METIERS DE LA COIFFURE;7;7;6;1;0;0;0;6;0;0;0;3;3;1
22075.0;2023;17;NANTES;FEMININ;ENSEIGNEMENT A DISTANCE;BAC PROFESSIONNEL;BAC PRO PROD;BAC PRO AG 21114 CONDUITE PRODUCTIONS HORTICOLES;9;9;9;0;0;0;0;9;0;0;0;1;8;0
22076.0;2023;17;NANTES;FEMININ;ENSEIGNEMENT A DISTANCE;BAC PROFESSIONNEL;BAC PRO SERV;BAC PRO 30004 ASSISTANC.GEST.ORGANIS.ACTIVITES;3;2;1;1;0;0;0;1;0;0;0;0;1;1
22077.0;2023;17;NANTES;FEMININ;ENSEIGNEMENT A DISTANCE;BAC PROFESSIONNEL;BAC PRO SERV;BAC PRO 31213 MET.COM.VEN.OP.A ANI.GES.ESP.COM.;3;2;1;1;0;0;0;1;0;0;0;1;0;1
22082.0;2023;17;NANTES;FEMININ;ENSEIGNEMENT A DISTANCE;BAC TECHNOLOGIQUE;BAC STMG;BAC STMG MERCATIQUE (MARKETING);10;10;5;3;2;1;1;6;0;0;1;1;4;4
22084.0;2023;17;NANTES;FEMININ;ENSEIGNEMENT A DISTANCE;BAC TECHNOLOGIQUE;BAC STMG;BAC STMG SYSTEMES D'INFORMATION DE GESTION;1;1;0;1;0;0;0;0;0;0;0;0;0;1
22086.0;2023;17;NANTES;FEMININ;FORMATION CONTINUE;BAC PROFESSIONNEL;BAC PRO PROD;BAC PRO 25510 METIERS ELECT. ENVIRON. CONNECTES;2;2;2;0;0;0;0;2;0;1;0;1;0;0
22088.0;2023;17;NANTES;FEMININ;FORMATION CONTINUE;BAC PROFESSIONNEL;BAC PRO PROD;BAC PRO AG 21113 CGEVV;2;2;2;0;0;0;0;2;0;0;0;0;2;0
22095.0;2023;17;NANTES;FEMININ;INDIVIDUEL;BAC PROFESSIONNEL;BAC PRO PROD;BAC PRO AG 21004 CGEA;4;3;2;1;0;0;0;2;0;0;0;0;2;1
22103.0;2023;17;NANTES;FEMININ;INDIVIDUEL;BAC PROFESSIONNEL;BAC PRO SERV;BAC PRO 31214 MET.COM.VEN.OP.B PR.CL.VA.OF.COM.;2;1;0;1;0;0;0;0;0;0;0;0;0;1
22117.0;2023;17;NANTES;FEMININ;SCOLAIRE;BAC PROFESSIONNEL;BAC PRO PROD;BAC PRO 22004 PROC. CHIMIE EAU PAPIERS-CARTONS;6;6;5;1;0;0;0;5;0;1;0;3;1;1
22119.0;2023;17;NANTES;FEMININ;SCOLAIRE;BAC PROFESSIONNEL;BAC PRO PROD;BAC PRO 22106 CUISINE;91;91;83;7;1;1;0;84;0;8;27;27;22;7
22120.0;2023;17;NANTES;FEMININ;SCOLAIRE;BAC PROFESSIONNEL;BAC PRO PROD;BAC PRO 22403 ARTS.& MET.ART:MET.ENSEIGN SIGNA;6;6;6;0;0;0;0;6;0;0;0;4;2;0
22122.0;2023;17;NANTES;FEMININ;SCOLAIRE;BAC PROFESSIONNEL;BAC PRO PROD;BAC PRO 23004 TECHN. ETUDES BAT.A ETUDES & ECO.;21;21;18;3;0;0;0;18;0;0;5;5;8;3
22123.0;2023;17;NANTES;FEMININ;SCOLAIRE;BAC PROFESSIONNEL;BAC PRO PROD;BAC PRO 23005 TECHN. ETUDES BAT B ASSIST.ARCHI.;50;50;48;2;0;0;0;48;0;4;12;21;11;2
22127.0;2023;17;NANTES;FEMININ;SCOLAIRE;BAC PROFESSIONNEL;BAC PRO PROD;BAC PRO 23304 AMENAGEMENT FINITION BATIMENT;15;15;14;1;0;0;0;14;0;2;2;7;3;1
22128.0;2023;17;NANTES;FEMININ;SCOLAIRE;BAC PROFESSIONNEL;BAC PRO PROD;BAC PRO 23404 TECHNICIEN CONSTRUCTEUR BOIS;1;1;1;0;0;0;0;1;0;1;0;0;0;0
22134.0;2023;17;NANTES;FEMININ;SCOLAIRE;BAC PROFESSIONNEL;BAC PRO PROD;BAC PRO 24302 METIERS DU CUIR : MAROQUINERIE;11;11;9;2;0;0;0;9;0;2;0;4;3;2
22138.0;2023;17;NANTES;FEMININ;SCOLAIRE;BAC PROFESSIONNEL;BAC PRO PROD;BAC PRO 25214 MAINT.VEHIC.OPTA VOIT.PARTICUL.;9;9;9;0;0;0;0;9;0;1;2;3;3;0
22147.0;2023;17;NANTES;FEMININ;SCOLAIRE;BAC PROFESSIONNEL;BAC PRO PROD;BAC PRO 25515 SYST.NUM.OPT.C RES.INF.SYST.COMM.;2;2;2;0;0;0;0;2;0;0;1;1;0;0
22156.0;2023;17;NANTES;FEMININ;SCOLAIRE;BAC PROFESSIONNEL;BAC PRO PROD;BAC PRO AG 21302 GEST MILIEUX NATURELS FAUNE;14;14;13;1;0;0;0;13;0;1;5;2;5;1
22159.0;2023;17;NANTES;FEMININ;SCOLAIRE;BAC PROFESSIONNEL;BAC PRO PROD;BAC PRO AG 22105 LABORATOIRE CONTROLE QUALITE;12;12;12;0;0;0;0;12;0;0;1;8;3;0
22168.0;2023;17;NANTES;FEMININ;SCOLAIRE;BAC PROFESSIONNEL;BAC PRO SERV;BAC PRO 32207 REAL.PR.IMPR.PLURI.OPTA.PR.GRAPH.;14;14;14;0;0;0;0;14;0;0;4;3;7;0
22169.0;2023;17;NANTES;FEMININ;SCOLAIRE;BAC PROFESSIONNEL;BAC PRO SERV;BAC PRO 32303 ART.& MET.ART:COM.VIS.VIS.PLURI-M;49;49;47;2;0;0;0;47;0;7;19;16;5;2
22185.0;2023;17;NANTES;FEMININ;SCOLAIRE;BAC TECHNOLOGIQUE;BAC S2TMD;BAC S2TMD MUSIQUE;7;7;7;0;0;0;0;7;0;2;1;4;0;0
22187.0;2023;17;NANTES;FEMININ;SCOLAIRE;BAC TECHNOLOGIQUE;BAC STAV;BAC STAV AGRONOMIE ALIM ENV TERRITOI;166;166;164;2;0;0;0;164;0;0;13;70;81;2
22198.0;2023;17;NANTES;FEMININ;SCOLAIRE;BAC TECHNOLOGIQUE;BAC STMG;BAC STMG RESSOURCES HUMAINES ET COMMUNICATION;723;723;558;27;138;97;41;655;0;3;41;190;421;68
22201.0;2023;17;NANTES;MASCULIN;APPRENTISSAGE;BAC PROFESSIONNEL;BAC PRO PROD;BAC PRO 20102 PILOTE DE LIGNE DE PRODUCTION;11;11;9;1;1;0;1;9;0;0;1;1;7;2
22203.0;2023;17;NANTES;MASCULIN;APPRENTISSAGE;BAC PROFESSIONNEL;BAC PRO PROD;BAC PRO 22106 CUISINE;48;48;42;4;2;0;2;42;0;1;12;12;17;6
22208.0;2023;17;NANTES;MASCULIN;APPRENTISSAGE;BAC PROFESSIONNEL;BAC PRO PROD;BAC PRO 22705 TECHNICIEN GAZ;3;3;3;0;0;0;0;3;0;2;1;0;0;0
22214.0;2023;17;NANTES;MASCULIN;APPRENTISSAGE;BAC PROFESSIONNEL;BAC PRO PROD;BAC PRO 23404 TECHNICIEN CONSTRUCTEUR BOIS;5;5;3;2;0;0;0;3;0;1;0;0;2;2
22218.0;2023;17;NANTES;MASCULIN;APPRENTISSAGE;BAC PROFESSIONNEL;BAC PRO PROD;BAC PRO 25006 MICROTECHNIQUES;9;9;8;0;1;0;1;8;0;0;3;5;0;1
22220.0;2023;17;NANTES;MASCULIN;APPRENTISSAGE;BAC PROFESSIONNEL;BAC PRO PROD;BAC PRO 25009 MAINTENANCE NAUTIQUE;3;3;2;0;1;1;0;3;0;0;1;1;1;0
22228.0;2023;17;NANTES;MASCULIN;APPRENTISSAGE;BAC PROFESSIONNEL;BAC PRO PROD;BAC PRO 25302 AERONAUTIQUE OPTION AVIONIQUE;6;6;6;0;0;0;0;6;0;2;2;2;0;0
22229.0;2023;17;NANTES;MASCULIN;APPRENTISSAGE;BAC PROFESSIONNEL;BAC PRO PROD;BAC PRO 25303 AERONAUTIQUE OPTION SYSTEMES;7;7;4;3;0;0;0;4;0;1;2;0;1;3
22236.0;2023;17;NANTES;MASCULIN;APPRENTISSAGE;BAC PROFESSIONNEL;BAC PRO PROD;BAC PRO 25509 TECHNIC. FROID CONDITIONNEMT AIR;22;20;19;1;0;0;0;19;0;1;4;6;8;1
22240.0;2023;17;NANTES;MASCULIN;APPRENTISSAGE;BAC PROFESSIONNEL;BAC PRO PROD;BAC PRO 25515 SYST.NUM.OPT.C RES.INF.SYST.COMM.;32;32;29;3;0;0;0;29;0;6;10;8;5;3
22241.0;2023;17;NANTES;MASCULIN;APPRENTISSAGE;BAC PROFESSIONNEL;BAC PRO PROD;BAC PRO AG 21001 AGRO-EQUIPEMENT;81;80;64;16;0;0;0;64;0;0;4;21;39;16
22248.0;2023;17;NANTES;MASCULIN;APPRENTISSAGE;BAC PROFESSIONNEL;BAC PRO PROD;BAC PRO AG 21211 COND GEST ENTR HIPPIQUE;7;7;5;2;0;0;0;5;0;0;0;2;3;2
22256.0;2023;17;NANTES;MASCULIN;APPRENTISSAGE;BAC PROFESSIONNEL;BAC PRO SERV;BAC PRO 31212 METIERS DE L'ACCUEIL;2;2;1;1;0;0;0;1;0;0;0;1;0;1
22258.0;2023;17;NANTES;MASCULIN;APPRENTISSAGE;BAC PROFESSIONNEL;BAC PRO SERV;BAC PRO 31214 MET.COM.VEN.OP.B PR.CL.VA.OF.COM.;4;4;3;1;0;0;0;3;0;0;0;2;1;1
22266.0;2023;17;NANTES;MASCULIN;APPRENTISSAGE;BAC PROFESSIONNEL;BAC PRO SERV;BAC PRO AG 33002 SERV PERS TERRIT;16;16;16;0;0;0;0;16;0;1;0;8;7;0
22271.0;2023;17;NANTES;MASCULIN;ENSEIGNEMENT A DISTANCE;BAC PROFESSIONNEL;BAC PRO SERV;BAC PRO 31213 MET.COM.VEN.OP.A ANI.GES.ESP.COM.;1;1;1;0;0;0;0;1;0;0;0;0;1;0
22272.0;2023;17;NANTES;MASCULIN;ENSEIGNEMENT A DISTANCE;BAC PROFESSIONNEL;BAC PRO SERV;BAC PRO 31214 MET.COM.VEN.OP.B PR.CL.VA.OF.COM.;1;1;1;0;0;0;0;1;0;0;0;0;1;0
22273.0;2023;17;NANTES;MASCULIN;ENSEIGNEMENT A DISTANCE;BAC TECHNOLOGIQUE;BAC ST2S;BAC ST2S SCIENCES & TECHNO. SANTE & SOCIAL;1;1;0;1;0;0;0;0;0;0;0;0;0;1
22287.0;2023;17;NANTES;MASCULIN;FORMATION CONTINUE;BAC PROFESSIONNEL;BAC PRO PROD;BAC PRO AG 21113 CGEVV;5;3;3;0;0;0;0;3;0;0;0;2;1;0
22288.0;2023;17;NANTES;MASCULIN;FORMATION CONTINUE;BAC PROFESSIONNEL;BAC PRO PROD;BAC PRO AG 21114 CONDUITE PRODUCTIONS HORTICOLES;3;3;3;0;0;0;0;3;0;0;0;0;3;0
22292.0;2023;17;NANTES;MASCULIN;FORMATION CONTINUE;BAC PROFESSIONNEL;BAC PRO SERV;BAC PRO 32304 PHOTOGRAPHIE;1;1;1;0;0;0;0;1;0;0;1;0;0;0
22297.0;2023;17;NANTES;MASCULIN;INDIVIDUEL;BAC PROFESSIONNEL;BAC PRO PROD;BAC PRO 23004 TECHN. ETUDES BAT.A ETUDES & ECO.;1;0;0;0;0;0;0;0;0;0;0;0;0;0
22298.0;2023;17;NANTES;MASCULIN;INDIVIDUEL;BAC PROFESSIONNEL;BAC PRO PROD;BAC PRO 23405 TECHNICIEN MENUISIER AGENCEUR;1;1;1;0;0;0;0;1;0;0;1;0;0;0
22308.0;2023;17;NANTES;MASCULIN;INDIVIDUEL;BAC PROFESSIONNEL;BAC PRO PROD;BAC PRO AG 21004 CGEA;14;11;10;1;0;0;0;10;0;0;0;0;10;1
22311.0;2023;17;NANTES;MASCULIN;INDIVIDUEL;BAC PROFESSIONNEL;BAC PRO PROD;BAC PRO AG 21210 COND GEST ENTR CANIN ET FELIN;1;0;0;0;0;0;0;0;0;0;0;0;0;0
22319.0;2023;17;NANTES;MASCULIN;INDIVIDUEL;BAC TECHNOLOGIQUE;BAC S2TMD;BAC S2TMD MUSIQUE;1;1;1;0;0;0;0;1;0;0;1;0;0;0
22325.0;2023;17;NANTES;MASCULIN;INDIVIDUEL;BAC TECHNOLOGIQUE;BAC STL;BAC STL SCIENCES PHYSIQUES CHIMIQUES  EN LABORAT.;1;1;0;1;0;0;0;0;0;0;0;0;0;1
22333.0;2023;17;NANTES;MASCULIN;SCOLAIRE;BAC PROFESSIONNEL;BAC PRO PROD;BAC PRO 22105 BOULANGER-PÂTISSIER;34;34;31;2;1;1;0;32;0;2;12;13;5;2
22342.0;2023;17;NANTES;MASCULIN;SCOLAIRE;BAC PROFESSIONNEL;BAC PRO PROD;BAC PRO 23102 TRAVAUX PUBLICS;10;10;9;1;0;0;0;9;0;1;3;3;2;1
22347.0;2023;17;NANTES;MASCULIN;SCOLAIRE;BAC PROFESSIONNEL;BAC PRO PROD;BAC PRO 23304 AMENAGEMENT FINITION BATIMENT;27;27;22;2;3;2;1;24;0;0;3;10;11;3
22352.0;2023;17;NANTES;MASCULIN;SCOLAIRE;BAC PROFESSIONNEL;BAC PRO PROD;BAC PRO 24203 METIERS DE LA MODE - VÊTEMENT;18;18;14;4;0;0;0;14;0;4;4;3;3;4
22355.0;2023;17;NANTES;MASCULIN;SCOLAIRE;BAC PROFESSIONNEL;BAC PRO PROD;BAC PRO 25009 MAINTENANCE NAUTIQUE;11;11;7;3;1;1;0;8;0;0;0;3;5;3
22360.0;2023;17;NANTES;MASCULIN;SCOLAIRE;BAC PROFESSIONNEL;BAC PRO PROD;BAC PRO 25216 MAINT.VEHIC.OPTC MOTOCYCLES;28;28;26;2;0;0;0;26;0;3;8;13;2;2
22363.0;2023;17;NANTES;MASCULIN;SCOLAIRE;BAC PROFESSIONNEL;BAC PRO PROD;BAC PRO 25221 MAINT.MATERIELS OPT.C ESP. VERTS;19;19;14;4;1;1;0;15;0;0;2;5;8;4
22367.0;2023;17;NANTES;MASCULIN;SCOLAIRE;BAC PROFESSIONNEL;BAC PRO PROD;BAC PRO 25411 TECH.CHAUDRONNERIE INDUSTRIELLE;70;70;54;12;4;3;1;57;0;3;12;15;27;13
22383.0;2023;17;NANTES;MASCULIN;SCOLAIRE;BAC PROFESSIONNEL;BAC PRO PROD;BAC PRO AG 21407 TEC CONS VTE UNIVERS JARDINERIE;1;1;0;1;0;0;0;0;0;0;0;0;0;1
22385.0;2023;17;NANTES;MASCULIN;SCOLAIRE;BAC PROFESSIONNEL;BAC PRO PROD;BAC PRO AG 22108 TEC CONS VTE ALIMENTATION (PAB);93;93;75;18;0;0;0;75;0;0;12;26;37;18
22386.0;2023;17;NANTES;MASCULIN;SCOLAIRE;BAC PROFESSIONNEL;BAC PRO SERV;BAC PRO 30004 ASSISTANC.GEST.ORGANIS.ACTIVITES;235;235;168;55;12;9;3;177;0;6;26;71;74;58
22396.0;2023;17;NANTES;MASCULIN;SCOLAIRE;BAC PROFESSIONNEL;BAC PRO SERV;BAC PRO 32304 PHOTOGRAPHIE;7;7;7;0;0;0;0;7;0;3;2;2;0;0
22400.0;2023;17;NANTES;MASCULIN;SCOLAIRE;BAC PROFESSIONNEL;BAC PRO SERV;BAC PRO 33101 OPTIQUE LUNETTERIE;2;2;2;0;0;0;0;2;0;0;1;1;0;0
22401.0;2023;17;NANTES;MASCULIN;SCOLAIRE;BAC PROFESSIONNEL;BAC PRO SERV;BAC PRO 33103 TECHNICIEN APPAREIL. ORTHOPEDIQUE;3;3;3;0;0;0;0;3;0;0;1;2;0;0
22404.0;2023;17;NANTES;MASCULIN;SCOLAIRE;BAC PROFESSIONNEL;BAC PRO SERV;BAC PRO 33604 METIERS DE LA COIFFURE;3;3;2;1;0;0;0;2;0;0;0;0;2;1
22407.0;2023;17;NANTES;MASCULIN;SCOLAIRE;BAC PROFESSIONNEL;BAC PRO SERV;BAC PRO 34403 METIERS DE LA SECURITE;84;84;82;2;0;0;0;82;0;9;25;25;23;2
22408.0;2023;17;NANTES;MASCULIN;SCOLAIRE;BAC PROFESSIONNEL;BAC PRO SERV;BAC PRO AG 33002 SERV PERS TERRIT;117;116;103;13;0;0;0;103;0;2;12;34;55;13
22409.0;2023;17;NANTES;MASCULIN;SCOLAIRE;BAC TECHNOLOGIQUE;BAC S2TMD;BAC S2TMD DANSE;3;3;3;0;0;0;0;3;0;1;1;1;0;0
22410.0;2023;17;NANTES;MASCULIN;SCOLAIRE;BAC TECHNOLOGIQUE;BAC S2TMD;BAC S2TMD MUSIQUE;10;10;9;0;1;1;0;10;0;2;1;4;3;0
22414.0;2023;17;NANTES;MASCULIN;SCOLAIRE;BAC TECHNOLOGIQUE;BAC STHR;BAC STHR SC.&TEC. HOTELLERIE-RESTAURATION;73;73;69;0;4;3;1;72;1;2;15;27;27;1
22416.0;2023;17;NANTES;MASCULIN;SCOLAIRE;BAC TECHNOLOGIQUE;BAC STI2D;BAC STI2D ENERGIES  ET ENVIRONNEMENT;263;263;233;5;25;14;11;247;0;7;27;98;115;16
22421.0;2023;17;NANTES;MASCULIN;SCOLAIRE;BAC TECHNOLOGIQUE;BAC STMG;BAC STMG GESTION ET FINANCE;477;477;376;23;78;60;18;436;0;1;45;129;261;41
22427.0;2023;23;NICE;FEMININ;APPRENTISSAGE;BAC PROFESSIONNEL;BAC PRO PROD;BAC PRO 24002 METIERS PRESSING BLANCHISSERIE;4;4;4;0;0;0;0;4;0;1;1;0;2;0
22451.0;2023;23;NICE;FEMININ;FORMATION CONTINUE;BAC PROFESSIONNEL;BAC PRO SERV;BAC PRO 31213 MET.COM.VEN.OP.A ANI.GES.ESP.COM.;8;8;5;2;1;1;0;6;0;1;1;2;2;2
22453.0;2023;23;NICE;FEMININ;FORMATION CONTINUE;BAC PROFESSIONNEL;BAC PRO SERV;BAC PRO 33101 OPTIQUE LUNETTERIE;7;7;6;1;0;0;0;6;0;1;0;1;4;1
22456.0;2023;23;NICE;FEMININ;INDIVIDUEL;BAC PROFESSIONNEL;BAC PRO PROD;BAC PRO 22106 CUISINE;1;1;0;1;0;0;0;0;0;0;0;0;0;1
22458.0;2023;23;NICE;FEMININ;INDIVIDUEL;BAC PROFESSIONNEL;BAC PRO PROD;BAC PRO AG 21004 CGEA;3;3;2;1;0;0;0;2;0;0;0;0;2;1
22460.0;2023;23;NICE;FEMININ;INDIVIDUEL;BAC PROFESSIONNEL;BAC PRO PROD;BAC PRO AG 21114 CONDUITE PRODUCTIONS HORTICOLES;4;4;4;0;0;0;0;4;0;0;0;0;4;0
22462.0;2023;23;NICE;FEMININ;INDIVIDUEL;BAC PROFESSIONNEL;BAC PRO SERV;BAC PRO 30004 ASSISTANC.GEST.ORGANIS.ACTIVITES;4;3;0;3;0;0;0;0;0;0;0;0;0;3
22463.0;2023;23;NICE;FEMININ;INDIVIDUEL;BAC PROFESSIONNEL;BAC PRO SERV;BAC PRO 31106 LOGISTIQUE;1;0;0;0;0;0;0;0;0;0;0;0;0;0
22464.0;2023;23;NICE;FEMININ;INDIVIDUEL;BAC PROFESSIONNEL;BAC PRO SERV;BAC PRO 31212 METIERS DE L'ACCUEIL;3;0;0;0;0;0;0;0;0;0;0;0;0;0
22467.0;2023;23;NICE;FEMININ;INDIVIDUEL;BAC PROFESSIONNEL;BAC PRO SERV;BAC PRO 33603 ESTHETIQUE COSMETIQUE PARFUMERIE;3;3;1;1;1;1;0;2;0;0;0;0;2;1
22468.0;2023;23;NICE;FEMININ;INDIVIDUEL;BAC PROFESSIONNEL;BAC PRO SERV;BAC PRO 34304 HYGIENE PROPRETE STERILISATION;1;0;0;0;0;0;0;0;0;0;0;0;0;0
22478.0;2023;23;NICE;FEMININ;SCOLAIRE;BAC PROFESSIONNEL;BAC PRO PROD;BAC PRO 22106 CUISINE;53;53;47;1;5;3;2;50;0;5;11;16;18;3
22479.0;2023;23;NICE;FEMININ;SCOLAIRE;BAC PROFESSIONNEL;BAC PRO PROD;BAC PRO 22403 ARTS.& MET.ART:MET.ENSEIGN SIGNA;7;7;7;0;0;0;0;7;0;0;5;2;0;0
22480.0;2023;23;NICE;FEMININ;SCOLAIRE;BAC PROFESSIONNEL;BAC PRO PROD;BAC PRO 22704 TECHN. MAINT. SYST.ENERG.CLIMATI;1;1;1;0;0;0;0;1;0;0;0;1;0;0
22483.0;2023;23;NICE;FEMININ;SCOLAIRE;BAC PROFESSIONNEL;BAC PRO PROD;BAC PRO 23005 TECHN. ETUDES BAT B ASSIST.ARCHI.;15;15;12;3;0;0;0;12;0;0;2;4;6;3
22488.0;2023;23;NICE;FEMININ;SCOLAIRE;BAC PROFESSIONNEL;BAC PRO PROD;BAC PRO 23408 Etude et réalisation d'agencement;11;11;9;2;0;0;0;9;0;0;1;4;4;2
22489.0;2023;23;NICE;FEMININ;SCOLAIRE;BAC PROFESSIONNEL;BAC PRO PROD;BAC PRO 24202 ARTIS.& MET.ART : TAPIS.D'AMEUBL;6;6;5;1;0;0;0;5;0;1;0;1;3;1
22495.0;2023;23;NICE;FEMININ;SCOLAIRE;BAC PROFESSIONNEL;BAC PRO PROD;BAC PRO 25214 MAINT.VEHIC.OPTA VOIT.PARTICUL.;4;4;3;1;0;0;0;3;0;0;1;1;1;1
22498.0;2023;23;NICE;FEMININ;SCOLAIRE;BAC PROFESSIONNEL;BAC PRO PROD;BAC PRO 25510 METIERS ELECT. ENVIRON. CONNECTES;2;2;2;0;0;0;0;2;0;0;0;0;2;0
22504.0;2023;23;NICE;FEMININ;SCOLAIRE;BAC PROFESSIONNEL;BAC PRO PROD;BAC PRO AG 21405 AMENAGEMENTS PAYSAGERS;4;4;4;0;0;0;0;4;0;1;0;1;2;0
22507.0;2023;23;NICE;FEMININ;SCOLAIRE;BAC PROFESSIONNEL;BAC PRO SERV;BAC PRO 31106 LOGISTIQUE;7;7;6;1;0;0;0;6;0;2;0;2;2;1
22510.0;2023;23;NICE;FEMININ;SCOLAIRE;BAC PROFESSIONNEL;BAC PRO SERV;BAC PRO 31213 MET.COM.VEN.OP.A ANI.GES.ESP.COM.;268;268;229;23;16;12;4;241;0;11;56;85;89;27
22513.0;2023;23;NICE;FEMININ;SCOLAIRE;BAC PROFESSIONNEL;BAC PRO SERV;BAC PRO 32208 REAL.PR.IMPR.PLURI.OPTB.PR.IMPR.;2;2;2;0;0;0;0;2;0;0;2;0;0;0
22516.0;2023;23;NICE;FEMININ;SCOLAIRE;BAC PROFESSIONNEL;BAC PRO SERV;BAC PRO 33004 ACC.SOINS-S.PERS. OPT.EN STRUCTUR;279;277;230;37;10;7;3;237;0;10;39;95;93;40
22521.0;2023;23;NICE;FEMININ;SCOLAIRE;BAC PROFESSIONNEL;BAC PRO SERV;BAC PRO 33604 METIERS DE LA COIFFURE;9;9;9;0;0;0;0;9;0;0;1;3;5;0
22528.0;2023;23;NICE;FEMININ;SCOLAIRE;BAC TECHNOLOGIQUE;BAC STAV;BAC STAV AGRONOMIE ALIM ENV TERRITOI;51;49;46;3;0;0;0;46;0;0;5;16;25;3
22538.0;2023;23;NICE;FEMININ;SCOLAIRE;BAC TECHNOLOGIQUE;BAC STMG;BAC STMG MERCATIQUE (MARKETING);606;606;489;27;90;54;36;543;1;11;81;166;284;63
22548.0;2023;23;NICE;MASCULIN;APPRENTISSAGE;BAC PROFESSIONNEL;BAC PRO PROD;BAC PRO 23405 TECHNICIEN MENUISIER AGENCEUR;4;4;2;1;1;1;0;3;0;0;0;1;2;1
22555.0;2023;23;NICE;MASCULIN;APPRENTISSAGE;BAC PROFESSIONNEL;BAC PRO PROD;BAC PRO 25406 OUVRAGES DU BATIMENT METALLERIE;4;4;4;0;0;0;0;4;0;2;0;2;0;0
22564.0;2023;23;NICE;MASCULIN;APPRENTISSAGE;BAC PROFESSIONNEL;BAC PRO SERV;BAC PRO 30004 ASSISTANC.GEST.ORGANIS.ACTIVITES;2;2;0;2;0;0;0;0;0;0;0;0;0;2
22565.0;2023;23;NICE;MASCULIN;APPRENTISSAGE;BAC PROFESSIONNEL;BAC PRO SERV;BAC PRO 31106 LOGISTIQUE;4;4;4;0;0;0;0;4;0;0;1;1;2;0
22569.0;2023;23;NICE;MASCULIN;ENSEIGNEMENT A DISTANCE;BAC GENERAL;BAC GENERAL;BAC GENE 10019 BAC GENERAL;43;43;30;7;6;4;2;34;0;3;3;13;15;9
22571.0;2023;23;NICE;MASCULIN;ENSEIGNEMENT A DISTANCE;BAC PROFESSIONNEL;BAC PRO SERV;BAC PRO 31213 MET.COM.VEN.OP.A ANI.GES.ESP.COM.;3;2;1;1;0;0;0;1;0;0;0;0;1;1
22574.0;2023;23;NICE;MASCULIN;ENSEIGNEMENT A DISTANCE;BAC TECHNOLOGIQUE;BAC STMG;BAC STMG MERCATIQUE (MARKETING);3;3;2;0;1;1;0;3;0;0;0;1;2;0
22582.0;2023;23;NICE;MASCULIN;INDIVIDUEL;BAC GENERAL;BAC GENERAL;BAC GENE 10019 BAC GENERAL;132;131;78;34;19;16;3;94;0;7;11;26;50;37
22584.0;2023;23;NICE;MASCULIN;INDIVIDUEL;BAC PROFESSIONNEL;BAC PRO PROD;BAC PRO 22703 TECHN.INSTALL.SYST.ENERG.CLIMATI;1;0;0;0;0;0;0;0;0;0;0;0;0;0
22585.0;2023;23;NICE;MASCULIN;INDIVIDUEL;BAC PROFESSIONNEL;BAC PRO PROD;BAC PRO 22704 TECHN. MAINT. SYST.ENERG.CLIMATI;1;1;1;0;0;0;0;1;0;0;0;1;0;0
22594.0;2023;23;NICE;MASCULIN;INDIVIDUEL;BAC PROFESSIONNEL;BAC PRO PROD;BAC PRO AG 21405 AMENAGEMENTS PAYSAGERS;1;1;1;0;0;0;0;1;0;0;0;0;1;0
22599.0;2023;23;NICE;MASCULIN;INDIVIDUEL;BAC PROFESSIONNEL;BAC PRO SERV;BAC PRO 32303 ART.& MET.ART:COM.VIS.VIS.PLURI-M;1;1;0;1;0;0;0;0;0;0;0;0;0;1
22600.0;2023;23;NICE;MASCULIN;INDIVIDUEL;BAC PROFESSIONNEL;BAC PRO SERV;BAC PRO 33403 COMMERC. SERVICES EN RESTAURATION;1;1;1;0;0;0;0;1;0;0;0;1;0;0
22607.0;2023;23;NICE;MASCULIN;INDIVIDUEL;BAC TECHNOLOGIQUE;BAC STMG;BAC STMG RESSOURCES HUMAINES ET COMMUNICATION;10;10;5;2;3;2;1;7;0;0;0;3;4;3
22610.0;2023;23;NICE;MASCULIN;SCOLAIRE;BAC PROFESSIONNEL;BAC PRO PROD;BAC PRO 20102 PILOTE DE LIGNE DE PRODUCTION;9;9;6;3;0;0;0;6;0;0;1;3;2;3
22615.0;2023;23;NICE;MASCULIN;SCOLAIRE;BAC PROFESSIONNEL;BAC PRO PROD;BAC PRO 22704 TECHN. MAINT. SYST.ENERG.CLIMATI;64;64;49;7;8;7;1;56;0;2;7;16;31;8
22622.0;2023;23;NICE;MASCULIN;SCOLAIRE;BAC PROFESSIONNEL;BAC PRO PROD;BAC PRO 23303 MENUISERIE ALUMINIUM-VERRE;5;5;5;0;0;0;0;5;0;0;0;1;4;0
22624.0;2023;23;NICE;MASCULIN;SCOLAIRE;BAC PROFESSIONNEL;BAC PRO PROD;BAC PRO 23404 TECHNICIEN CONSTRUCTEUR BOIS;5;5;3;2;0;0;0;3;0;1;1;1;0;2
22635.0;2023;23;NICE;MASCULIN;SCOLAIRE;BAC PROFESSIONNEL;BAC PRO PROD;BAC PRO 25107 TECHNICIEN OUTILLEUR;8;8;6;1;1;1;0;7;0;1;2;0;4;1
22641.0;2023;23;NICE;MASCULIN;SCOLAIRE;BAC PROFESSIONNEL;BAC PRO PROD;BAC PRO 25408 REPARATION DES CARROSSERIES;30;30;19;11;0;0;0;19;0;1;2;4;12;11
22642.0;2023;23;NICE;MASCULIN;SCOLAIRE;BAC PROFESSIONNEL;BAC PRO PROD;BAC PRO 25411 TECH.CHAUDRONNERIE INDUSTRIELLE;17;17;12;3;2;1;1;13;0;1;3;4;5;4
22643.0;2023;23;NICE;MASCULIN;SCOLAIRE;BAC PROFESSIONNEL;BAC PRO PROD;BAC PRO 25509 TECHNIC. FROID CONDITIONNEMT AIR;25;25;13;9;3;2;1;15;0;0;4;4;7;10
22646.0;2023;23;NICE;MASCULIN;SCOLAIRE;BAC PROFESSIONNEL;BAC PRO PROD;BAC PRO 25514 SYST.NUM.OPT.B AUD.RES.EQUIP.DOM.;65;65;55;9;1;1;0;56;0;1;11;23;21;9
22650.0;2023;23;NICE;MASCULIN;SCOLAIRE;BAC PROFESSIONNEL;BAC PRO PROD;BAC PRO AG 21114 CONDUITE PRODUCTIONS HORTICOLES;9;9;6;3;0;0;0;6;0;0;0;2;4;3
22656.0;2023;23;NICE;MASCULIN;SCOLAIRE;BAC PROFESSIONNEL;BAC PRO SERV;BAC PRO 31114 ORGANIS. TRANSPORT MARCHANDISES;24;24;11;13;0;0;0;11;0;0;1;4;6;13
22661.0;2023;23;NICE;MASCULIN;SCOLAIRE;BAC PROFESSIONNEL;BAC PRO SERV;BAC PRO 32208 REAL.PR.IMPR.PLURI.OPTB.PR.IMPR.;2;2;2;0;0;0;0;2;0;1;1;0;0;0
22668.0;2023;23;NICE;MASCULIN;SCOLAIRE;BAC PROFESSIONNEL;BAC PRO SERV;BAC PRO 33604 METIERS DE LA COIFFURE;1;1;1;0;0;0;0;1;0;0;0;1;0;0
22669.0;2023;23;NICE;MASCULIN;SCOLAIRE;BAC PROFESSIONNEL;BAC PRO SERV;BAC PRO 34304 HYGIENE PROPRETE STERILISATION;3;3;2;1;0;0;0;2;0;1;0;0;1;1
22679.0;2023;23;NICE;MASCULIN;SCOLAIRE;BAC TECHNOLOGIQUE;BAC STI2D;BAC STI2D INNOVATION TECHNO.  ET ECO CONCEPTION;286;286;254;7;25;12;13;266;0;11;48;92;115;20
22689.0;2023;70;NORMANDIE;FEMININ;APPRENTISSAGE;BAC PROFESSIONNEL;BAC PRO PROD;BAC PRO 22004 PROC. CHIMIE EAU PAPIERS-CARTONS;2;2;2;0;0;0;0;2;0;1;0;1;0;0
22692.0;2023;70;NORMANDIE;FEMININ;APPRENTISSAGE;BAC PROFESSIONNEL;BAC PRO PROD;BAC PRO 23004 TECHN. ETUDES BAT.A ETUDES & ECO.;2;2;2;0;0;0;0;2;0;1;0;0;1;0
22697.0;2023;70;NORMANDIE;FEMININ;APPRENTISSAGE;BAC PROFESSIONNEL;BAC PRO PROD;BAC PRO 23405 TECHNICIEN MENUISIER AGENCEUR;1;1;1;0;0;0;0;1;0;0;0;0;1;0
22700.0;2023;70;NORMANDIE;FEMININ;APPRENTISSAGE;BAC PROFESSIONNEL;BAC PRO PROD;BAC PRO 25007 MAINTENANCE EQUIPEMENTS INDUST.;2;2;2;0;0;0;0;2;0;2;0;0;0;0
22704.0;2023;70;NORMANDIE;FEMININ;APPRENTISSAGE;BAC PROFESSIONNEL;BAC PRO PROD;BAC PRO 25216 MAINT.VEHIC.OPTC MOTOCYCLES;1;1;1;0;0;0;0;1;0;0;0;1;0;0
22711.0;2023;70;NORMANDIE;FEMININ;APPRENTISSAGE;BAC PROFESSIONNEL;BAC PRO PROD;BAC PRO AG 21114 CONDUITE PRODUCTIONS HORTICOLES;2;2;2;0;0;0;0;2;0;0;0;2;0;0
22715.0;2023;70;NORMANDIE;FEMININ;APPRENTISSAGE;BAC PROFESSIONNEL;BAC PRO PROD;BAC PRO AG 21405 AMENAGEMENTS PAYSAGERS;6;6;5;1;0;0;0;5;0;0;0;3;2;1
22716.0;2023;70;NORMANDIE;FEMININ;APPRENTISSAGE;BAC PROFESSIONNEL;BAC PRO PROD;BAC PRO AG 22108 TEC CONS VTE ALIMENTATION (PAB);4;4;3;1;0;0;0;3;0;0;0;0;3;1
22722.0;2023;70;NORMANDIE;FEMININ;APPRENTISSAGE;BAC PROFESSIONNEL;BAC PRO SERV;BAC PRO 33004 ACC.SOINS-S.PERS. OPT.EN STRUCTUR;3;3;3;0;0;0;0;3;0;0;3;0;0;0
22726.0;2023;70;NORMANDIE;FEMININ;APPRENTISSAGE;BAC PROFESSIONNEL;BAC PRO SERV;BAC PRO 34305 TECHN.D'INTERV.SUR INSTALL. NUCL.;2;2;2;0;0;0;0;2;0;2;0;0;0;0
22729.0;2023;70;NORMANDIE;FEMININ;ENSEIGNEMENT A DISTANCE;BAC PROFESSIONNEL;BAC PRO SERV;BAC PRO 30004 ASSISTANC.GEST.ORGANIS.ACTIVITES;1;0;0;0;0;0;0;0;0;0;0;0;0;0
22742.0;2023;70;NORMANDIE;FEMININ;FORMATION CONTINUE;BAC PROFESSIONNEL;BAC PRO PROD;BAC PRO 23004 TECHN. ETUDES BAT.A ETUDES & ECO.;3;3;2;0;1;1;0;3;0;0;1;1;1;0
22743.0;2023;70;NORMANDIE;FEMININ;FORMATION CONTINUE;BAC PROFESSIONNEL;BAC PRO PROD;BAC PRO 25007 MAINTENANCE EQUIPEMENTS INDUST.;3;3;2;1;0;0;0;2;0;0;1;1;0;1
22745.0;2023;70;NORMANDIE;FEMININ;FORMATION CONTINUE;BAC PROFESSIONNEL;BAC PRO PROD;BAC PRO 25214 MAINT.VEHIC.OPTA VOIT.PARTICUL.;2;2;2;0;0;0;0;2;0;1;0;0;1;0
22751.0;2023;70;NORMANDIE;FEMININ;FORMATION CONTINUE;BAC PROFESSIONNEL;BAC PRO SERV;BAC PRO 34304 HYGIENE PROPRETE STERILISATION;5;5;5;0;0;0;0;5;0;0;3;1;1;0
22758.0;2023;70;NORMANDIE;FEMININ;INDIVIDUEL;BAC PROFESSIONNEL;BAC PRO SERV;BAC PRO 31213 MET.COM.VEN.OP.A ANI.GES.ESP.COM.;4;4;3;1;0;0;0;3;0;0;0;0;3;1
22769.0;2023;70;NORMANDIE;FEMININ;INDIVIDUEL;BAC TECHNOLOGIQUE;BAC STMG;BAC STMG GESTION ET FINANCE;4;4;1;3;0;0;0;1;0;0;0;0;1;3
22778.0;2023;70;NORMANDIE;FEMININ;SCOLAIRE;BAC PROFESSIONNEL;BAC PRO PROD;BAC PRO 22106 CUISINE;63;63;52;9;2;1;1;53;0;4;13;25;11;10
22788.0;2023;70;NORMANDIE;FEMININ;SCOLAIRE;BAC PROFESSIONNEL;BAC PRO PROD;BAC PRO 23408 Etude et réalisation d'agencement;16;16;15;1;0;0;0;15;0;1;5;4;5;1
22789.0;2023;70;NORMANDIE;FEMININ;SCOLAIRE;BAC PROFESSIONNEL;BAC PRO PROD;BAC PRO 24202 ARTIS.& MET.ART : TAPIS.D'AMEUBL;13;13;9;4;0;0;0;9;0;1;0;3;5;4
22791.0;2023;70;NORMANDIE;FEMININ;SCOLAIRE;BAC PROFESSIONNEL;BAC PRO PROD;BAC PRO 24302 METIERS DU CUIR : MAROQUINERIE;12;12;12;0;0;0;0;12;0;4;2;4;2;0
22796.0;2023;70;NORMANDIE;FEMININ;SCOLAIRE;BAC PROFESSIONNEL;BAC PRO PROD;BAC PRO 25214 MAINT.VEHIC.OPTA VOIT.PARTICUL.;7;7;6;1;0;0;0;6;0;0;3;1;2;1
22802.0;2023;70;NORMANDIE;FEMININ;SCOLAIRE;BAC PROFESSIONNEL;BAC PRO PROD;BAC PRO 25411 TECH.CHAUDRONNERIE INDUSTRIELLE;6;6;6;0;0;0;0;6;0;1;2;2;1;0
22804.0;2023;70;NORMANDIE;FEMININ;SCOLAIRE;BAC PROFESSIONNEL;BAC PRO PROD;BAC PRO 25510 METIERS ELECT. ENVIRON. CONNECTES;12;12;10;0;2;2;0;12;0;0;3;6;3;0
22808.0;2023;70;NORMANDIE;FEMININ;SCOLAIRE;BAC PROFESSIONNEL;BAC PRO PROD;BAC PRO AG 21001 AGRO-EQUIPEMENT;2;2;2;0;0;0;0;2;0;0;0;0;2;0
22811.0;2023;70;NORMANDIE;FEMININ;SCOLAIRE;BAC PROFESSIONNEL;BAC PRO PROD;BAC PRO AG 21203 TECHN CONSEIL DE VENTE ANIMAL;7;7;7;0;0;0;0;7;0;1;2;0;4;0
22820.0;2023;70;NORMANDIE;FEMININ;SCOLAIRE;BAC PROFESSIONNEL;BAC PRO SERV;BAC PRO 30004 ASSISTANC.GEST.ORGANIS.ACTIVITES;475;474;364;85;25;19;6;383;0;17;51;140;175;91
22822.0;2023;70;NORMANDIE;FEMININ;SCOLAIRE;BAC PROFESSIONNEL;BAC PRO SERV;BAC PRO 31107 CONDUCT. TRANSP.ROUT.MARCHANDISES;14;14;10;3;1;1;0;11;0;1;2;5;3;3
22826.0;2023;70;NORMANDIE;FEMININ;SCOLAIRE;BAC PROFESSIONNEL;BAC PRO SERV;BAC PRO 31214 MET.COM.VEN.OP.B PR.CL.VA.OF.COM.;113;113;99;10;4;4;0;103;0;4;16;46;37;10
22832.0;2023;70;NORMANDIE;FEMININ;SCOLAIRE;BAC PROFESSIONNEL;BAC PRO SERV;BAC PRO 33004 ACC.SOINS-S.PERS. OPT.EN STRUCTUR;604;604;543;35;26;20;6;563;0;30;130;221;182;41
22833.0;2023;70;NORMANDIE;FEMININ;SCOLAIRE;BAC PROFESSIONNEL;BAC PRO SERV;BAC PRO 33006 ANIMAT. ENFANCE& PERSONNES AGEES;73;73;64;5;4;2;2;66;0;6;19;19;22;7
22836.0;2023;70;NORMANDIE;FEMININ;SCOLAIRE;BAC PROFESSIONNEL;BAC PRO SERV;BAC PRO 33403 COMMERC. SERVICES EN RESTAURATION;65;65;54;10;1;1;0;55;0;1;15;13;26;10
22838.0;2023;70;NORMANDIE;FEMININ;SCOLAIRE;BAC PROFESSIONNEL;BAC PRO SERV;BAC PRO 33603 ESTHETIQUE COSMETIQUE PARFUMERIE;138;138;119;9;10;7;3;126;0;3;25;45;53;12
22844.0;2023;70;NORMANDIE;FEMININ;SCOLAIRE;BAC TECHNOLOGIQUE;BAC S2TMD;BAC S2TMD DANSE;8;8;6;2;0;0;0;6;0;1;3;1;1;2
22852.0;2023;70;NORMANDIE;FEMININ;SCOLAIRE;BAC TECHNOLOGIQUE;BAC STI2D;BAC STI2D INNOVATION TECHNO.  ET ECO CONCEPTION;36;36;33;1;2;1;1;34;0;2;8;9;15;2
22853.0;2023;70;NORMANDIE;FEMININ;SCOLAIRE;BAC TECHNOLOGIQUE;BAC STI2D;BAC STI2D SYSTÈME D'INFORMATION  ET NUMERIQUE;17;17;15;1;1;1;0;16;0;0;2;12;2;1
22859.0;2023;70;NORMANDIE;FEMININ;SCOLAIRE;BAC TECHNOLOGIQUE;BAC STMG;BAC STMG SYSTEMES D'INFORMATION DE GESTION;3;3;2;0;1;1;0;3;0;0;0;0;3;0
22862.0;2023;70;NORMANDIE;MASCULIN;APPRENTISSAGE;BAC PROFESSIONNEL;BAC PRO PROD;BAC PRO 22004 PROC. CHIMIE EAU PAPIERS-CARTONS;13;13;13;0;0;0;0;13;0;11;2;0;0;0
22863.0;2023;70;NORMANDIE;MASCULIN;APPRENTISSAGE;BAC PROFESSIONNEL;BAC PRO PROD;BAC PRO 22106 CUISINE;16;16;13;1;2;2;0;15;0;0;1;7;7;1
22868.0;2023;70;NORMANDIE;MASCULIN;APPRENTISSAGE;BAC PROFESSIONNEL;BAC PRO PROD;BAC PRO 23203 TECHNICIEN BAT. : ORG.REAL.GROS O;15;15;14;1;0;0;0;14;0;3;4;4;3;1
22869.0;2023;70;NORMANDIE;MASCULIN;APPRENTISSAGE;BAC PROFESSIONNEL;BAC PRO PROD;BAC PRO 23303 MENUISERIE ALUMINIUM-VERRE;2;2;1;0;1;1;0;2;0;0;0;0;2;0
22872.0;2023;70;NORMANDIE;MASCULIN;APPRENTISSAGE;BAC PROFESSIONNEL;BAC PRO PROD;BAC PRO 23405 TECHNICIEN MENUISIER AGENCEUR;33;33;28;2;3;1;2;29;0;2;7;13;7;4
22874.0;2023;70;NORMANDIE;MASCULIN;APPRENTISSAGE;BAC PROFESSIONNEL;BAC PRO PROD;BAC PRO 23407 TECHNIC.FAB.BOIS ET MATERX ASSOC;3;3;3;0;0;0;0;3;0;1;1;1;0;0
22875.0;2023;70;NORMANDIE;MASCULIN;APPRENTISSAGE;BAC PROFESSIONNEL;BAC PRO PROD;BAC PRO 23408 Etude et réalisation d'agencement;1;1;1;0;0;0;0;1;0;0;1;0;0;0
22881.0;2023;70;NORMANDIE;MASCULIN;APPRENTISSAGE;BAC PROFESSIONNEL;BAC PRO PROD;BAC PRO 25214 MAINT.VEHIC.OPTA VOIT.PARTICUL.;224;221;189;15;17;7;10;196;0;25;53;64;54;25
22890.0;2023;70;NORMANDIE;MASCULIN;APPRENTISSAGE;BAC PROFESSIONNEL;BAC PRO PROD;BAC PRO 25411 TECH.CHAUDRONNERIE INDUSTRIELLE;119;117;98;16;3;2;1;100;0;10;24;35;31;17
22897.0;2023;70;NORMANDIE;MASCULIN;APPRENTISSAGE;BAC PROFESSIONNEL;BAC PRO PROD;BAC PRO AG 21004 CGEA;126;120;78;42;0;0;0;78;0;0;5;10;63;42
22905.0;2023;70;NORMANDIE;MASCULIN;APPRENTISSAGE;BAC PROFESSIONNEL;BAC PRO SERV;BAC PRO 31106 LOGISTIQUE;36;36;29;4;3;1;2;30;0;1;12;6;11;6
22911.0;2023;70;NORMANDIE;MASCULIN;APPRENTISSAGE;BAC PROFESSIONNEL;BAC PRO SERV;BAC PRO 34305 TECHN.D'INTERV.SUR INSTALL. NUCL.;6;6;6;0;0;0;0;6;0;4;0;2;0;0
22914.0;2023;70;NORMANDIE;MASCULIN;ENSEIGNEMENT A DISTANCE;BAC PROFESSIONNEL;BAC PRO SERV;BAC PRO 31213 MET.COM.VEN.OP.A ANI.GES.ESP.COM.;5;4;1;2;1;1;0;2;0;0;0;0;2;2
22929.0;2023;70;NORMANDIE;MASCULIN;FORMATION CONTINUE;BAC PROFESSIONNEL;BAC PRO PROD;BAC PRO 25214 MAINT.VEHIC.OPTA VOIT.PARTICUL.;23;21;17;2;2;2;0;19;0;4;4;8;3;2
22930.0;2023;70;NORMANDIE;MASCULIN;FORMATION CONTINUE;BAC PROFESSIONNEL;BAC PRO PROD;BAC PRO 25509 TECHNIC. FROID CONDITIONNEMT AIR;8;7;6;1;0;0;0;6;0;0;2;2;2;1
22932.0;2023;70;NORMANDIE;MASCULIN;FORMATION CONTINUE;BAC PROFESSIONNEL;BAC PRO PROD;BAC PRO 25513 SYST.NUM.OPT.A SURETE SECURITE;1;1;1;0;0;0;0;1;0;0;0;1;0;0
22938.0;2023;70;NORMANDIE;MASCULIN;INDIVIDUEL;BAC PROFESSIONNEL;BAC PRO PROD;BAC PRO 22004 PROC. CHIMIE EAU PAPIERS-CARTONS;4;2;2;0;0;0;0;2;0;0;0;0;2;0
22945.0;2023;70;NORMANDIE;MASCULIN;INDIVIDUEL;BAC PROFESSIONNEL;BAC PRO PROD;BAC PRO 25411 TECH.CHAUDRONNERIE INDUSTRIELLE;1;1;0;0;1;1;0;1;0;0;0;0;1;0
22947.0;2023;70;NORMANDIE;MASCULIN;INDIVIDUEL;BAC PROFESSIONNEL;BAC PRO PROD;BAC PRO 25515 SYST.NUM.OPT.C RES.INF.SYST.COMM.;2;2;2;0;0;0;0;2;0;0;0;1;1;0
22948.0;2023;70;NORMANDIE;MASCULIN;INDIVIDUEL;BAC PROFESSIONNEL;BAC PRO PROD;BAC PRO AG 21001 AGRO-EQUIPEMENT;1;0;0;0;0;0;0;0;0;0;0;0;0;0
22953.0;2023;70;NORMANDIE;MASCULIN;INDIVIDUEL;BAC PROFESSIONNEL;BAC PRO SERV;BAC PRO 31106 LOGISTIQUE;1;0;0;0;0;0;0;0;0;0;0;0;0;0
22955.0;2023;70;NORMANDIE;MASCULIN;INDIVIDUEL;BAC PROFESSIONNEL;BAC PRO SERV;BAC PRO 31213 MET.COM.VEN.OP.A ANI.GES.ESP.COM.;10;7;5;2;0;0;0;5;0;0;0;0;5;2
22963.0;2023;70;NORMANDIE;MASCULIN;INDIVIDUEL;BAC TECHNOLOGIQUE;BAC ST2S;BAC ST2S SCIENCES & TECHNO. SANTE & SOCIAL;1;1;0;1;0;0;0;0;0;0;0;0;0;1
22977.0;2023;70;NORMANDIE;MASCULIN;SCOLAIRE;BAC PROFESSIONNEL;BAC PRO PROD;BAC PRO 22106 CUISINE;153;153;133;14;6;5;1;138;0;6;31;50;51;15
22981.0;2023;70;NORMANDIE;MASCULIN;SCOLAIRE;BAC PROFESSIONNEL;BAC PRO PROD;BAC PRO 22704 TECHN. MAINT. SYST.ENERG.CLIMATI;61;59;38;18;3;2;1;40;0;0;8;13;19;19
22985.0;2023;70;NORMANDIE;MASCULIN;SCOLAIRE;BAC PROFESSIONNEL;BAC PRO PROD;BAC PRO 23102 TRAVAUX PUBLICS;38;38;32;6;0;0;0;32;0;1;8;13;10;6
22992.0;2023;70;NORMANDIE;MASCULIN;SCOLAIRE;BAC PROFESSIONNEL;BAC PRO PROD;BAC PRO 23405 TECHNICIEN MENUISIER AGENCEUR;76;76;63;7;6;4;2;67;0;8;11;24;24;9
22994.0;2023;70;NORMANDIE;MASCULIN;SCOLAIRE;BAC PROFESSIONNEL;BAC PRO PROD;BAC PRO 23407 TECHNIC.FAB.BOIS ET MATERX ASSOC;30;29;26;2;1;0;1;26;0;1;5;10;10;3
22995.0;2023;70;NORMANDIE;MASCULIN;SCOLAIRE;BAC PROFESSIONNEL;BAC PRO PROD;BAC PRO 23408 Etude et réalisation d'agencement;4;4;4;0;0;0;0;4;0;0;1;2;1;0
23003.0;2023;70;NORMANDIE;MASCULIN;SCOLAIRE;BAC PROFESSIONNEL;BAC PRO PROD;BAC PRO 25215 MAINT.VEHIC.OPTB VEHIC.TRANS.ROUT;23;23;17;5;1;0;1;17;0;1;2;4;10;6
23006.0;2023;70;NORMANDIE;MASCULIN;SCOLAIRE;BAC PROFESSIONNEL;BAC PRO PROD;BAC PRO 25220 MAINT.MATERIELS OPT.B TP MANUT.;12;12;10;1;1;0;1;10;0;3;1;3;3;2
23008.0;2023;70;NORMANDIE;MASCULIN;SCOLAIRE;BAC PROFESSIONNEL;BAC PRO PROD;BAC PRO 25304 AERONAUTIQUE OPTION STRUCTURE;12;12;12;0;0;0;0;12;0;2;2;7;1;0
23016.0;2023;70;NORMANDIE;MASCULIN;SCOLAIRE;BAC PROFESSIONNEL;BAC PRO PROD;BAC PRO 25515 SYST.NUM.OPT.C RES.INF.SYST.COMM.;160;160;141;14;5;4;1;145;0;10;33;60;42;15
23018.0;2023;70;NORMANDIE;MASCULIN;SCOLAIRE;BAC PROFESSIONNEL;BAC PRO PROD;BAC PRO AG 21004 CGEA;207;205;178;27;0;0;0;178;0;3;24;57;94;27
23021.0;2023;70;NORMANDIE;MASCULIN;SCOLAIRE;BAC PROFESSIONNEL;BAC PRO PROD;BAC PRO AG 21204 PROD-AQUACOLES;5;5;3;2;0;0;0;3;0;0;1;1;1;2
23034.0;2023;70;NORMANDIE;MASCULIN;SCOLAIRE;BAC PROFESSIONNEL;BAC PRO SERV;BAC PRO 31212 METIERS DE L'ACCUEIL;75;75;58;11;6;6;0;64;0;1;9;26;28;11
23042.0;2023;70;NORMANDIE;MASCULIN;SCOLAIRE;BAC PROFESSIONNEL;BAC PRO SERV;BAC PRO 33004 ACC.SOINS-S.PERS. OPT.EN STRUCTUR;28;28;28;0;0;0;0;28;0;0;3;13;12;0
23043.0;2023;70;NORMANDIE;MASCULIN;SCOLAIRE;BAC PROFESSIONNEL;BAC PRO SERV;BAC PRO 33006 ANIMAT. ENFANCE& PERSONNES AGEES;39;39;36;2;1;0;1;36;0;2;11;11;12;3
23046.0;2023;70;NORMANDIE;MASCULIN;SCOLAIRE;BAC PROFESSIONNEL;BAC PRO SERV;BAC PRO 33403 COMMERC. SERVICES EN RESTAURATION;88;88;69;16;3;3;0;72;0;4;14;15;39;16
23047.0;2023;70;NORMANDIE;MASCULIN;SCOLAIRE;BAC PROFESSIONNEL;BAC PRO SERV;BAC PRO 33604 METIERS DE LA COIFFURE;7;7;5;2;0;0;0;5;0;0;0;2;3;2
23048.0;2023;70;NORMANDIE;MASCULIN;SCOLAIRE;BAC PROFESSIONNEL;BAC PRO SERV;BAC PRO 34303 GEST. POLLUTIONS PROTEC. ENVIRON.;2;2;1;1;0;0;0;1;0;0;1;0;0;1
23059.0;2023;70;NORMANDIE;MASCULIN;SCOLAIRE;BAC TECHNOLOGIQUE;BAC STI2D;BAC STI2D ARCHITECTURE ET CONSTRUCTION;120;120;97;3;20;14;6;111;0;4;16;36;55;9
23064.0;2023;70;NORMANDIE;MASCULIN;SCOLAIRE;BAC TECHNOLOGIQUE;BAC STL;BAC STL SCIENCES PHYSIQUES CHIMIQUES  EN LABORAT.;56;56;42;9;5;2;3;44;0;1;7;18;18;12
23066.0;2023;70;NORMANDIE;MASCULIN;SCOLAIRE;BAC TECHNOLOGIQUE;BAC STMG;BAC STMG MERCATIQUE (MARKETING);820;820;520;77;223;155;68;675;0;0;19;133;523;145
23067.0;2023;70;NORMANDIE;MASCULIN;SCOLAIRE;BAC TECHNOLOGIQUE;BAC STMG;BAC STMG RESSOURCES HUMAINES ET COMMUNICATION;306;306;181;45;80;55;25;236;0;0;5;48;183;70
23074.0;2023;18;ORLEANS-TOURS;FEMININ;APPRENTISSAGE;BAC PROFESSIONNEL;BAC PRO PROD;BAC PRO 25106 TECHNICIEN D'USINAGE;1;1;1;0;0;0;0;1;0;0;0;1;0;0
23078.0;2023;18;ORLEANS-TOURS;FEMININ;APPRENTISSAGE;BAC PROFESSIONNEL;BAC PRO PROD;BAC PRO 25510 METIERS ELECT. ENVIRON. CONNECTES;1;1;1;0;0;0;0;1;0;1;0;0;0;0
23084.0;2023;18;ORLEANS-TOURS;FEMININ;APPRENTISSAGE;BAC PROFESSIONNEL;BAC PRO PROD;BAC PRO AG 21405 AMENAGEMENTS PAYSAGERS;2;2;2;0;0;0;0;2;0;0;0;1;1;0
23092.0;2023;18;ORLEANS-TOURS;FEMININ;APPRENTISSAGE;BAC PROFESSIONNEL;BAC PRO SERV;BAC PRO 32207 REAL.PR.IMPR.PLURI.OPTA.PR.GRAPH.;2;2;2;0;0;0;0;2;0;1;1;0;0;0
23098.0;2023;18;ORLEANS-TOURS;FEMININ;ENSEIGNEMENT A DISTANCE;BAC GENERAL;BAC GENERAL;BAC GENE 10019 BAC GENERAL;61;61;38;10;13;8;5;46;1;2;6;9;28;15
23101.0;2023;18;ORLEANS-TOURS;FEMININ;ENSEIGNEMENT A DISTANCE;BAC TECHNOLOGIQUE;BAC STMG;BAC STMG RESSOURCES HUMAINES ET COMMUNICATION;5;5;2;2;1;0;1;2;0;0;0;1;1;3
23114.0;2023;18;ORLEANS-TOURS;FEMININ;INDIVIDUEL;BAC PROFESSIONNEL;BAC PRO PROD;BAC PRO AG 21004 CGEA;6;5;5;0;0;0;0;5;0;0;0;0;5;0
23115.0;2023;18;ORLEANS-TOURS;FEMININ;INDIVIDUEL;BAC PROFESSIONNEL;BAC PRO PROD;BAC PRO AG 21114 CONDUITE PRODUCTIONS HORTICOLES;3;2;2;0;0;0;0;2;0;0;0;0;2;0
23118.0;2023;18;ORLEANS-TOURS;FEMININ;INDIVIDUEL;BAC PROFESSIONNEL;BAC PRO PROD;BAC PRO AG 21211 COND GEST ENTR HIPPIQUE;6;4;1;3;0;0;0;1;0;0;0;0;1;3
23121.0;2023;18;ORLEANS-TOURS;FEMININ;INDIVIDUEL;BAC PROFESSIONNEL;BAC PRO SERV;BAC PRO 31212 METIERS DE L'ACCUEIL;6;5;0;3;2;2;0;2;0;0;0;0;2;3
23123.0;2023;18;ORLEANS-TOURS;FEMININ;INDIVIDUEL;BAC PROFESSIONNEL;BAC PRO SERV;BAC PRO 31214 MET.COM.VEN.OP.B PR.CL.VA.OF.COM.;5;3;2;0;1;1;0;3;0;0;0;0;3;0
23124.0;2023;18;ORLEANS-TOURS;FEMININ;INDIVIDUEL;BAC PROFESSIONNEL;BAC PRO SERV;BAC PRO 33003 ACC.SOINS-S.PERS. OPT.A DOMICILE;3;1;0;0;1;1;0;1;0;0;0;0;1;0
23129.0;2023;18;ORLEANS-TOURS;FEMININ;INDIVIDUEL;BAC TECHNOLOGIQUE;BAC ST2S;BAC ST2S SCIENCES & TECHNO. SANTE & SOCIAL;7;7;1;4;2;2;0;3;0;0;0;1;2;4
23144.0;2023;18;ORLEANS-TOURS;FEMININ;SCOLAIRE;BAC PROFESSIONNEL;BAC PRO PROD;BAC PRO 23005 TECHN. ETUDES BAT B ASSIST.ARCHI.;15;15;12;3;0;0;0;12;0;0;1;6;5;3
23147.0;2023;18;ORLEANS-TOURS;FEMININ;SCOLAIRE;BAC PROFESSIONNEL;BAC PRO PROD;BAC PRO 23208 METIERS ET ARTS DE LA PIERRE;2;2;2;0;0;0;0;2;0;1;0;0;1;0
23154.0;2023;18;ORLEANS-TOURS;FEMININ;SCOLAIRE;BAC PROFESSIONNEL;BAC PRO PROD;BAC PRO 25006 MICROTECHNIQUES;1;1;1;0;0;0;0;1;0;0;0;1;0;0
23156.0;2023;18;ORLEANS-TOURS;FEMININ;SCOLAIRE;BAC PROFESSIONNEL;BAC PRO PROD;BAC PRO 25106 TECHNICIEN D'USINAGE;1;1;1;0;0;0;0;1;0;0;0;1;0;0
23167.0;2023;18;ORLEANS-TOURS;FEMININ;SCOLAIRE;BAC PROFESSIONNEL;BAC PRO PROD;BAC PRO 25515 SYST.NUM.OPT.C RES.INF.SYST.COMM.;4;4;4;0;0;0;0;4;0;2;0;0;2;0
23173.0;2023;18;ORLEANS-TOURS;FEMININ;SCOLAIRE;BAC PROFESSIONNEL;BAC PRO PROD;BAC PRO AG 21211 COND GEST ENTR HIPPIQUE;49;49;43;6;0;0;0;43;0;2;0;13;28;6
23175.0;2023;18;ORLEANS-TOURS;FEMININ;SCOLAIRE;BAC PROFESSIONNEL;BAC PRO PROD;BAC PRO AG 21302 GEST MILIEUX NATURELS FAUNE;9;9;9;0;0;0;0;9;0;1;2;4;2;0
23178.0;2023;18;ORLEANS-TOURS;FEMININ;SCOLAIRE;BAC PROFESSIONNEL;BAC PRO PROD;BAC PRO AG 21407 TEC CONS VTE UNIVERS JARDINERIE;18;17;14;3;0;0;0;14;0;0;1;5;8;3
23193.0;2023;18;ORLEANS-TOURS;FEMININ;SCOLAIRE;BAC PROFESSIONNEL;BAC PRO SERV;BAC PRO 33004 ACC.SOINS-S.PERS. OPT.EN STRUCTUR;460;459;398;40;21;12;9;410;0;14;93;166;137;49
23200.0;2023;18;ORLEANS-TOURS;FEMININ;SCOLAIRE;BAC PROFESSIONNEL;BAC PRO SERV;BAC PRO 34403 METIERS DE LA SECURITE;36;36;32;4;0;0;0;32;0;3;8;13;8;4
23203.0;2023;18;ORLEANS-TOURS;FEMININ;SCOLAIRE;BAC TECHNOLOGIQUE;BAC S2TMD;BAC S2TMD MUSIQUE;2;2;2;0;0;0;0;2;1;0;0;1;0;0
23207.0;2023;18;ORLEANS-TOURS;FEMININ;SCOLAIRE;BAC TECHNOLOGIQUE;BAC STHR;BAC STHR SC.&TEC. HOTELLERIE-RESTAURATION;62;62;58;2;2;0;2;58;0;2;18;19;19;4
23208.0;2023;18;ORLEANS-TOURS;FEMININ;SCOLAIRE;BAC TECHNOLOGIQUE;BAC STI2D;BAC STI2D ARCHITECTURE ET CONSTRUCTION;29;29;25;1;3;2;1;27;0;2;1;12;12;2
23209.0;2023;18;ORLEANS-TOURS;FEMININ;SCOLAIRE;BAC TECHNOLOGIQUE;BAC STI2D;BAC STI2D ENERGIES  ET ENVIRONNEMENT;7;7;5;1;1;1;0;6;0;0;2;2;2;1
23222.0;2023;18;ORLEANS-TOURS;MASCULIN;APPRENTISSAGE;BAC PROFESSIONNEL;BAC PRO PROD;BAC PRO 23102 TRAVAUX PUBLICS;40;40;29;8;3;2;1;31;0;0;5;8;18;9
23226.0;2023;18;ORLEANS-TOURS;MASCULIN;APPRENTISSAGE;BAC PROFESSIONNEL;BAC PRO PROD;BAC PRO 23207 INTERV. SUR PATRIMOINE BATI OPT.C;2;2;1;1;0;0;0;1;0;0;1;0;0;1
23231.0;2023;18;ORLEANS-TOURS;MASCULIN;APPRENTISSAGE;BAC PROFESSIONNEL;BAC PRO PROD;BAC PRO 25005 PRODUCTIQ.MECA. OPT.DECOLLETAGE;1;1;1;0;0;0;0;1;0;1;0;0;0;0
23232.0;2023;18;ORLEANS-TOURS;MASCULIN;APPRENTISSAGE;BAC PROFESSIONNEL;BAC PRO PROD;BAC PRO 25007 MAINTENANCE EQUIPEMENTS INDUST.;26;26;17;6;3;0;3;17;0;1;4;5;7;9
23233.0;2023;18;ORLEANS-TOURS;MASCULIN;APPRENTISSAGE;BAC PROFESSIONNEL;BAC PRO PROD;BAC PRO 25106 TECHNICIEN D'USINAGE;23;23;20;1;2;2;0;22;0;3;5;8;6;1
23234.0;2023;18;ORLEANS-TOURS;MASCULIN;APPRENTISSAGE;BAC PROFESSIONNEL;BAC PRO PROD;BAC PRO 25107 TECHNICIEN OUTILLEUR;1;1;1;0;0;0;0;1;0;0;0;1;0;0
23239.0;2023;18;ORLEANS-TOURS;MASCULIN;APPRENTISSAGE;BAC PROFESSIONNEL;BAC PRO PROD;BAC PRO 25221 MAINT.MATERIELS OPT.C ESP. VERTS;16;16;10;4;2;1;1;11;0;0;2;1;8;5
23241.0;2023;18;ORLEANS-TOURS;MASCULIN;APPRENTISSAGE;BAC PROFESSIONNEL;BAC PRO PROD;BAC PRO 25408 REPARATION DES CARROSSERIES;34;34;25;8;1;1;0;26;0;0;6;9;11;8
23242.0;2023;18;ORLEANS-TOURS;MASCULIN;APPRENTISSAGE;BAC PROFESSIONNEL;BAC PRO PROD;BAC PRO 25410 CONSTRUCTION DES CARROSSERIES;14;13;9;2;2;1;1;10;0;1;1;4;4;3
23245.0;2023;18;ORLEANS-TOURS;MASCULIN;APPRENTISSAGE;BAC PROFESSIONNEL;BAC PRO PROD;BAC PRO 25510 METIERS ELECT. ENVIRON. CONNECTES;67;66;49;9;8;7;1;56;0;5;9;14;28;10
23248.0;2023;18;ORLEANS-TOURS;MASCULIN;APPRENTISSAGE;BAC PROFESSIONNEL;BAC PRO PROD;BAC PRO AG 21001 AGRO-EQUIPEMENT;5;5;4;1;0;0;0;4;0;0;0;1;3;1
23250.0;2023;18;ORLEANS-TOURS;MASCULIN;APPRENTISSAGE;BAC PROFESSIONNEL;BAC PRO PROD;BAC PRO AG 21114 CONDUITE PRODUCTIONS HORTICOLES;4;4;4;0;0;0;0;4;0;0;1;1;2;0
23251.0;2023;18;ORLEANS-TOURS;MASCULIN;APPRENTISSAGE;BAC PROFESSIONNEL;BAC PRO PROD;BAC PRO AG 21203 TECHN CONSEIL DE VENTE ANIMAL;2;2;2;0;0;0;0;2;0;0;1;1;0;0
23253.0;2023;18;ORLEANS-TOURS;MASCULIN;APPRENTISSAGE;BAC PROFESSIONNEL;BAC PRO PROD;BAC PRO AG 21302 GEST MILIEUX NATURELS FAUNE;1;1;1;0;0;0;0;1;0;0;0;1;0;0
23260.0;2023;18;ORLEANS-TOURS;MASCULIN;APPRENTISSAGE;BAC PROFESSIONNEL;BAC PRO SERV;BAC PRO 31213 MET.COM.VEN.OP.A ANI.GES.ESP.COM.;88;85;63;18;4;2;2;65;0;2;11;22;30;20
23261.0;2023;18;ORLEANS-TOURS;MASCULIN;APPRENTISSAGE;BAC PROFESSIONNEL;BAC PRO SERV;BAC PRO 31214 MET.COM.VEN.OP.B PR.CL.VA.OF.COM.;21;21;16;4;1;1;0;17;0;0;1;7;9;4
23267.0;2023;18;ORLEANS-TOURS;MASCULIN;ENSEIGNEMENT A DISTANCE;BAC TECHNOLOGIQUE;BAC ST2S;BAC ST2S SCIENCES & TECHNO. SANTE & SOCIAL;1;1;0;1;0;0;0;0;0;0;0;0;0;1
23268.0;2023;18;ORLEANS-TOURS;MASCULIN;ENSEIGNEMENT A DISTANCE;BAC TECHNOLOGIQUE;BAC STMG;BAC STMG GESTION ET FINANCE;4;4;1;0;3;1;2;2;0;0;0;1;1;2
23270.0;2023;18;ORLEANS-TOURS;MASCULIN;FORMATION CONTINUE;BAC PROFESSIONNEL;BAC PRO PROD;BAC PRO 22704 TECHN. MAINT. SYST.ENERG.CLIMATI;3;3;3;0;0;0;0;3;0;0;1;0;2;0
23281.0;2023;18;ORLEANS-TOURS;MASCULIN;FORMATION CONTINUE;BAC PROFESSIONNEL;BAC PRO PROD;BAC PRO 25408 REPARATION DES CARROSSERIES;2;2;2;0;0;0;0;2;0;0;1;1;0;0
23283.0;2023;18;ORLEANS-TOURS;MASCULIN;FORMATION CONTINUE;BAC PROFESSIONNEL;BAC PRO PROD;BAC PRO 25510 METIERS ELECT. ENVIRON. CONNECTES;1;1;1;0;0;0;0;1;0;0;1;0;0;0
23286.0;2023;18;ORLEANS-TOURS;MASCULIN;FORMATION CONTINUE;BAC PROFESSIONNEL;BAC PRO SERV;BAC PRO 31213 MET.COM.VEN.OP.A ANI.GES.ESP.COM.;1;1;0;1;0;0;0;0;0;0;0;0;0;1
23292.0;2023;18;ORLEANS-TOURS;MASCULIN;INDIVIDUEL;BAC PROFESSIONNEL;BAC PRO PROD;BAC PRO 25106 TECHNICIEN D'USINAGE;1;1;1;0;0;0;0;1;0;0;0;0;1;0
23296.0;2023;18;ORLEANS-TOURS;MASCULIN;INDIVIDUEL;BAC PROFESSIONNEL;BAC PRO PROD;BAC PRO 25510 METIERS ELECT. ENVIRON. CONNECTES;3;2;0;2;0;0;0;0;0;0;0;0;0;2
23297.0;2023;18;ORLEANS-TOURS;MASCULIN;INDIVIDUEL;BAC PROFESSIONNEL;BAC PRO PROD;BAC PRO 25515 SYST.NUM.OPT.C RES.INF.SYST.COMM.;3;2;1;1;0;0;0;1;0;0;0;0;1;1
23313.0;2023;18;ORLEANS-TOURS;MASCULIN;INDIVIDUEL;BAC TECHNOLOGIQUE;BAC STI2D;BAC STI2D SYSTÈME D'INFORMATION  ET NUMERIQUE;1;1;0;1;0;0;0;0;0;0;0;0;0;1
23319.0;2023;18;ORLEANS-TOURS;MASCULIN;SCOLAIRE;BAC PROFESSIONNEL;BAC PRO PROD;BAC PRO 20102 PILOTE DE LIGNE DE PRODUCTION;6;6;3;3;0;0;0;3;0;0;1;1;1;3
23321.0;2023;18;ORLEANS-TOURS;MASCULIN;SCOLAIRE;BAC PROFESSIONNEL;BAC PRO PROD;BAC PRO 22105 BOULANGER-PÂTISSIER;16;16;14;2;0;0;0;14;0;1;5;5;3;2
23325.0;2023;18;ORLEANS-TOURS;MASCULIN;SCOLAIRE;BAC PROFESSIONNEL;BAC PRO PROD;BAC PRO 22503 PLASTIQUES ET COMPOSITES;16;16;15;1;0;0;0;15;0;1;5;2;7;1
23327.0;2023;18;ORLEANS-TOURS;MASCULIN;SCOLAIRE;BAC PROFESSIONNEL;BAC PRO PROD;BAC PRO 22704 TECHN. MAINT. SYST.ENERG.CLIMATI;58;58;33;22;3;3;0;36;0;2;4;8;22;22
23337.0;2023;18;ORLEANS-TOURS;MASCULIN;SCOLAIRE;BAC PROFESSIONNEL;BAC PRO PROD;BAC PRO 23304 AMENAGEMENT FINITION BATIMENT;25;24;12;5;7;4;3;16;0;0;2;4;10;8
23338.0;2023;18;ORLEANS-TOURS;MASCULIN;SCOLAIRE;BAC PROFESSIONNEL;BAC PRO PROD;BAC PRO 23404 TECHNICIEN CONSTRUCTEUR BOIS;10;10;7;3;0;0;0;7;0;0;1;1;5;3
23352.0;2023;18;ORLEANS-TOURS;MASCULIN;SCOLAIRE;BAC PROFESSIONNEL;BAC PRO PROD;BAC PRO 25216 MAINT.VEHIC.OPTC MOTOCYCLES;19;19;18;0;1;1;0;19;0;6;8;3;2;0
23364.0;2023;18;ORLEANS-TOURS;MASCULIN;SCOLAIRE;BAC PROFESSIONNEL;BAC PRO PROD;BAC PRO 25515 SYST.NUM.OPT.C RES.INF.SYST.COMM.;187;187;148;34;5;5;0;153;0;15;29;61;48;34
23370.0;2023;18;ORLEANS-TOURS;MASCULIN;SCOLAIRE;BAC PROFESSIONNEL;BAC PRO PROD;BAC PRO AG 21211 COND GEST ENTR HIPPIQUE;3;3;2;1;0;0;0;2;0;0;0;1;1;1
23378.0;2023;18;ORLEANS-TOURS;MASCULIN;SCOLAIRE;BAC PROFESSIONNEL;BAC PRO SERV;BAC PRO 30004 ASSISTANC.GEST.ORGANIS.ACTIVITES;180;180;122;47;11;10;1;132;0;2;13;47;70;48
23385.0;2023;18;ORLEANS-TOURS;MASCULIN;SCOLAIRE;BAC PROFESSIONNEL;BAC PRO SERV;BAC PRO 32207 REAL.PR.IMPR.PLURI.OPTA.PR.GRAPH.;15;15;15;0;0;0;0;15;0;1;4;8;2;0
23389.0;2023;18;ORLEANS-TOURS;MASCULIN;SCOLAIRE;BAC PROFESSIONNEL;BAC PRO SERV;BAC PRO 33002 SERVICES DE PROXIMITE  VIE LOCAL;1;1;0;1;0;0;0;0;0;0;0;0;0;1
23397.0;2023;18;ORLEANS-TOURS;MASCULIN;SCOLAIRE;BAC PROFESSIONNEL;BAC PRO SERV;BAC PRO 34305 TECHN.D'INTERV.SUR INSTALL. NUCL.;14;14;10;4;0;0;0;10;0;0;1;1;8;4
23399.0;2023;18;ORLEANS-TOURS;MASCULIN;SCOLAIRE;BAC PROFESSIONNEL;BAC PRO SERV;BAC PRO AG 33002 SERV PERS TERRIT;24;24;22;2;0;0;0;22;0;1;3;10;8;2
23400.0;2023;18;ORLEANS-TOURS;MASCULIN;SCOLAIRE;BAC TECHNOLOGIQUE;BAC S2TMD;BAC S2TMD DANSE;1;1;1;0;0;0;0;1;0;0;1;0;0;0
23404.0;2023;18;ORLEANS-TOURS;MASCULIN;SCOLAIRE;BAC TECHNOLOGIQUE;BAC STD2A;BAC STD2A SCIENCES & TECHNO. DESIGN-ARTS APPLIQUES;40;40;39;0;1;1;0;40;0;2;8;18;12;0
23406.0;2023;18;ORLEANS-TOURS;MASCULIN;SCOLAIRE;BAC TECHNOLOGIQUE;BAC STI2D;BAC STI2D ARCHITECTURE ET CONSTRUCTION;85;85;75;0;10;8;2;83;0;2;16;33;32;2
23412.0;2023;18;ORLEANS-TOURS;MASCULIN;SCOLAIRE;BAC TECHNOLOGIQUE;BAC STMG;BAC STMG GESTION ET FINANCE;334;334;267;18;49;32;17;299;0;4;33;84;178;35
23415.0;2023;18;ORLEANS-TOURS;MASCULIN;SCOLAIRE;BAC TECHNOLOGIQUE;BAC STMG;BAC STMG SYSTEMES D'INFORMATION DE GESTION;23;23;18;2;3;3;0;21;0;0;1;6;14;2
23424.0;2023;01;PARIS;FEMININ;APPRENTISSAGE;BAC PROFESSIONNEL;BAC PRO SERV;BAC PRO 31209 POISSONIER ECAILLER TRAITEUR;1;1;0;0;1;0;1;0;0;0;0;0;0;1
23427.0;2023;01;PARIS;FEMININ;APPRENTISSAGE;BAC PROFESSIONNEL;BAC PRO SERV;BAC PRO 31214 MET.COM.VEN.OP.B PR.CL.VA.OF.COM.;4;4;4;0;0;0;0;4;0;0;1;2;1;0
23432.0;2023;01;PARIS;FEMININ;APPRENTISSAGE;BAC PROFESSIONNEL;BAC PRO SERV;BAC PRO 33104 TECHNICIEN EN PROTHESE DENTAIRE;5;5;5;0;0;0;0;5;0;2;1;2;0;0
23437.0;2023;01;PARIS;FEMININ;ENSEIGNEMENT A DISTANCE;BAC PROFESSIONNEL;BAC PRO SERV;BAC PRO 31213 MET.COM.VEN.OP.A ANI.GES.ESP.COM.;2;1;0;1;0;0;0;0;0;0;0;0;0;1
23439.0;2023;01;PARIS;FEMININ;ENSEIGNEMENT A DISTANCE;BAC TECHNOLOGIQUE;BAC ST2S;BAC ST2S SCIENCES & TECHNO. SANTE & SOCIAL;1;1;0;0;1;0;1;0;0;0;0;0;0;1
23442.0;2023;01;PARIS;FEMININ;FORMATION CONTINUE;BAC PROFESSIONNEL;BAC PRO PROD;BAC PRO 25106 TECHNICIEN D'USINAGE;1;1;1;0;0;0;0;1;0;0;0;1;0;0
23443.0;2023;01;PARIS;FEMININ;FORMATION CONTINUE;BAC PROFESSIONNEL;BAC PRO PROD;BAC PRO AG 21405 AMENAGEMENTS PAYSAGERS;12;12;12;0;0;0;0;12;0;0;0;0;12;0
23450.0;2023;01;PARIS;FEMININ;INDIVIDUEL;BAC PROFESSIONNEL;BAC PRO PROD;BAC PRO AG 21113 CGEVV;2;2;2;0;0;0;0;2;0;0;0;0;2;0
23451.0;2023;01;PARIS;FEMININ;INDIVIDUEL;BAC PROFESSIONNEL;BAC PRO PROD;BAC PRO AG 21114 CONDUITE PRODUCTIONS HORTICOLES;5;5;5;0;0;0;0;5;0;0;0;0;5;0
23456.0;2023;01;PARIS;FEMININ;INDIVIDUEL;BAC PROFESSIONNEL;BAC PRO SERV;BAC PRO 31213 MET.COM.VEN.OP.A ANI.GES.ESP.COM.;3;1;1;0;0;0;0;1;0;0;0;0;1;0
23457.0;2023;01;PARIS;FEMININ;INDIVIDUEL;BAC PROFESSIONNEL;BAC PRO SERV;BAC PRO 31214 MET.COM.VEN.OP.B PR.CL.VA.OF.COM.;1;1;0;1;0;0;0;0;0;0;0;0;0;1
23470.0;2023;01;PARIS;FEMININ;INDIVIDUEL;BAC TECHNOLOGIQUE;BAC STMG;BAC STMG MERCATIQUE (MARKETING);62;60;30;12;18;16;2;46;0;0;2;9;35;14
23480.0;2023;01;PARIS;FEMININ;SCOLAIRE;BAC PROFESSIONNEL;BAC PRO PROD;BAC PRO 22403 ARTS.& MET.ART:MET.ENSEIGN SIGNA;5;5;5;0;0;0;0;5;0;0;2;3;0;0
23486.0;2023;01;PARIS;FEMININ;SCOLAIRE;BAC PROFESSIONNEL;BAC PRO PROD;BAC PRO 23405 TECHNICIEN MENUISIER AGENCEUR;2;2;1;1;0;0;0;1;0;0;0;0;1;1
23496.0;2023;01;PARIS;FEMININ;SCOLAIRE;BAC PROFESSIONNEL;BAC PRO PROD;BAC PRO AG 21405 AMENAGEMENTS PAYSAGERS;10;10;10;0;0;0;0;10;0;0;3;5;2;0
23499.0;2023;01;PARIS;FEMININ;SCOLAIRE;BAC PROFESSIONNEL;BAC PRO SERV;BAC PRO 31106 LOGISTIQUE;2;2;2;0;0;0;0;2;0;0;1;0;1;0
23502.0;2023;01;PARIS;FEMININ;SCOLAIRE;BAC PROFESSIONNEL;BAC PRO SERV;BAC PRO 31213 MET.COM.VEN.OP.A ANI.GES.ESP.COM.;229;229;195;24;10;8;2;203;0;19;46;68;70;26
23506.0;2023;01;PARIS;FEMININ;SCOLAIRE;BAC PROFESSIONNEL;BAC PRO SERV;BAC PRO 32208 REAL.PR.IMPR.PLURI.OPTB.PR.IMPR.;1;1;1;0;0;0;0;1;0;0;0;1;0;0
23507.0;2023;01;PARIS;FEMININ;SCOLAIRE;BAC PROFESSIONNEL;BAC PRO SERV;BAC PRO 32303 ART.& MET.ART:COM.VIS.VIS.PLURI-M;46;46;43;3;0;0;0;43;0;7;13;17;6;3
23511.0;2023;01;PARIS;FEMININ;SCOLAIRE;BAC PROFESSIONNEL;BAC PRO SERV;BAC PRO 33006 ANIMAT. ENFANCE& PERSONNES AGEES;63;63;50;5;8;6;2;56;0;3;11;17;25;7
23515.0;2023;01;PARIS;FEMININ;SCOLAIRE;BAC PROFESSIONNEL;BAC PRO SERV;BAC PRO 33403 COMMERC. SERVICES EN RESTAURATION;18;18;16;1;1;1;0;17;0;0;2;7;8;1
23518.0;2023;01;PARIS;FEMININ;SCOLAIRE;BAC PROFESSIONNEL;BAC PRO SERV;BAC PRO 33604 METIERS DE LA COIFFURE;19;19;15;3;1;1;0;16;0;0;5;7;4;3
23519.0;2023;01;PARIS;FEMININ;SCOLAIRE;BAC PROFESSIONNEL;BAC PRO SERV;BAC PRO 34304 HYGIENE PROPRETE STERILISATION;6;6;4;2;0;0;0;4;0;0;1;1;2;2
23521.0;2023;01;PARIS;FEMININ;SCOLAIRE;BAC TECHNOLOGIQUE;BAC S2TMD;BAC S2TMD DANSE;9;9;9;0;0;0;0;9;1;2;1;4;1;0
23524.0;2023;01;PARIS;FEMININ;SCOLAIRE;BAC TECHNOLOGIQUE;BAC ST2S;BAC ST2S SCIENCES & TECHNO. SANTE & SOCIAL;257;257;200;17;40;25;15;225;1;8;33;82;101;32
23544.0;2023;01;PARIS;MASCULIN;APPRENTISSAGE;BAC PROFESSIONNEL;BAC PRO PROD;BAC PRO 25007 MAINTENANCE EQUIPEMENTS INDUST.;19;19;18;0;1;0;1;18;0;0;6;7;5;1
23545.0;2023;01;PARIS;MASCULIN;APPRENTISSAGE;BAC PROFESSIONNEL;BAC PRO PROD;BAC PRO 25214 MAINT.VEHIC.OPTA VOIT.PARTICUL.;16;16;10;1;5;3;2;13;0;0;4;4;5;3
23548.0;2023;01;PARIS;MASCULIN;APPRENTISSAGE;BAC PROFESSIONNEL;BAC PRO PROD;BAC PRO 25510 METIERS ELECT. ENVIRON. CONNECTES;45;45;38;6;1;0;1;38;0;3;12;8;15;7
23554.0;2023;01;PARIS;MASCULIN;APPRENTISSAGE;BAC PROFESSIONNEL;BAC PRO SERV;BAC PRO 31214 MET.COM.VEN.OP.B PR.CL.VA.OF.COM.;14;14;9;4;1;1;0;10;0;0;4;2;4;4
23555.0;2023;01;PARIS;MASCULIN;APPRENTISSAGE;BAC PROFESSIONNEL;BAC PRO SERV;BAC PRO 32207 REAL.PR.IMPR.PLURI.OPTA.PR.GRAPH.;7;7;6;1;0;0;0;6;0;1;0;3;2;1
23556.0;2023;01;PARIS;MASCULIN;APPRENTISSAGE;BAC PROFESSIONNEL;BAC PRO SERV;BAC PRO 32208 REAL.PR.IMPR.PLURI.OPTB.PR.IMPR.;5;5;5;0;0;0;0;5;0;0;2;2;1;0
23563.0;2023;01;PARIS;MASCULIN;ENSEIGNEMENT A DISTANCE;BAC PROFESSIONNEL;BAC PRO SERV;BAC PRO 31214 MET.COM.VEN.OP.B PR.CL.VA.OF.COM.;1;0;0;0;0;0;0;0;0;0;0;0;0;0
23568.0;2023;01;PARIS;MASCULIN;FORMATION CONTINUE;BAC PROFESSIONNEL;BAC PRO PROD;BAC PRO 22704 TECHN. MAINT. SYST.ENERG.CLIMATI;10;10;10;0;0;0;0;10;0;1;2;5;2;0
23572.0;2023;01;PARIS;MASCULIN;FORMATION CONTINUE;BAC PROFESSIONNEL;BAC PRO PROD;BAC PRO 25510 METIERS ELECT. ENVIRON. CONNECTES;24;22;22;0;0;0;0;22;0;9;3;3;7;0
23574.0;2023;01;PARIS;MASCULIN;FORMATION CONTINUE;BAC PROFESSIONNEL;BAC PRO PROD;BAC PRO AG 21405 AMENAGEMENTS PAYSAGERS;10;9;9;0;0;0;0;9;0;0;0;0;9;0
23592.0;2023;01;PARIS;MASCULIN;INDIVIDUEL;BAC TECHNOLOGIQUE;BAC STD2A;BAC STD2A SCIENCES & TECHNO. DESIGN-ARTS APPLIQUES;9;9;7;0;2;2;0;9;0;0;0;1;8;0
23594.0;2023;01;PARIS;MASCULIN;INDIVIDUEL;BAC TECHNOLOGIQUE;BAC STI2D;BAC STI2D INNOVATION TECHNO.  ET ECO CONCEPTION;3;3;0;3;0;0;0;0;0;0;0;0;0;3
23596.0;2023;01;PARIS;MASCULIN;INDIVIDUEL;BAC TECHNOLOGIQUE;BAC STL;BAC STL BIOCHIM.-BIOLOGIE-BIOTECHNOL.;2;2;0;2;0;0;0;0;0;0;0;0;0;2
23602.0;2023;01;PARIS;MASCULIN;SCOLAIRE;BAC GENERAL;BAC GENERAL;BAC GENE 10019 BAC GENERAL;7463;7463;6957;139;367;256;111;7213;188;1425;2089;1913;1598;250
23614.0;2023;01;PARIS;MASCULIN;SCOLAIRE;BAC PROFESSIONNEL;BAC PRO PROD;BAC PRO 23004 TECHN. ETUDES BAT.A ETUDES & ECO.;6;6;5;1;0;0;0;5;0;0;1;1;3;1
23617.0;2023;01;PARIS;MASCULIN;SCOLAIRE;BAC PROFESSIONNEL;BAC PRO PROD;BAC PRO 23203 TECHNICIEN BAT. : ORG.REAL.GROS O;7;7;3;3;1;0;1;3;0;0;0;3;0;4
23618.0;2023;01;PARIS;MASCULIN;SCOLAIRE;BAC PROFESSIONNEL;BAC PRO PROD;BAC PRO 23205 INTERV. SUR PATRIMOINE BATI OPT.A;1;1;0;1;0;0;0;0;0;0;0;0;0;1
23622.0;2023;01;PARIS;MASCULIN;SCOLAIRE;BAC PROFESSIONNEL;BAC PRO PROD;BAC PRO 23407 TECHNIC.FAB.BOIS ET MATERX ASSOC;6;6;6;0;0;0;0;6;0;0;2;1;3;0
23624.0;2023;01;PARIS;MASCULIN;SCOLAIRE;BAC PROFESSIONNEL;BAC PRO PROD;BAC PRO 24202 ARTIS.& MET.ART : TAPIS.D'AMEUBL;2;2;0;2;0;0;0;0;0;0;0;0;0;2
23626.0;2023;01;PARIS;MASCULIN;SCOLAIRE;BAC PROFESSIONNEL;BAC PRO PROD;BAC PRO 24301 METIERS DU CUIR : CHAUSSURES;2;2;0;2;0;0;0;0;0;0;0;0;0;2
23630.0;2023;01;PARIS;MASCULIN;SCOLAIRE;BAC PROFESSIONNEL;BAC PRO PROD;BAC PRO 25106 TECHNICIEN D'USINAGE;7;7;5;1;1;1;0;6;0;0;3;2;1;1
23632.0;2023;01;PARIS;MASCULIN;SCOLAIRE;BAC PROFESSIONNEL;BAC PRO PROD;BAC PRO 25214 MAINT.VEHIC.OPTA VOIT.PARTICUL.;39;39;29;7;3;3;0;32;0;3;8;5;16;7
23638.0;2023;01;PARIS;MASCULIN;SCOLAIRE;BAC PROFESSIONNEL;BAC PRO PROD;BAC PRO 25513 SYST.NUM.OPT.A SURETE SECURITE;36;36;19;14;3;3;0;22;0;0;3;5;14;14
23643.0;2023;01;PARIS;MASCULIN;SCOLAIRE;BAC PROFESSIONNEL;BAC PRO SERV;BAC PRO 30004 ASSISTANC.GEST.ORGANIS.ACTIVITES;271;271;184;76;11;10;1;194;0;1;31;70;92;77
23644.0;2023;01;PARIS;MASCULIN;SCOLAIRE;BAC PROFESSIONNEL;BAC PRO SERV;BAC PRO 31106 LOGISTIQUE;19;19;11;6;2;1;1;12;0;0;0;4;8;7
23651.0;2023;01;PARIS;MASCULIN;SCOLAIRE;BAC PROFESSIONNEL;BAC PRO SERV;BAC PRO 32208 REAL.PR.IMPR.PLURI.OPTB.PR.IMPR.;14;14;8;6;0;0;0;8;0;0;0;2;6;6
23652.0;2023;01;PARIS;MASCULIN;SCOLAIRE;BAC PROFESSIONNEL;BAC PRO SERV;BAC PRO 32303 ART.& MET.ART:COM.VIS.VIS.PLURI-M;46;46;38;7;1;1;0;39;0;1;12;11;15;7
23654.0;2023;01;PARIS;MASCULIN;SCOLAIRE;BAC PROFESSIONNEL;BAC PRO SERV;BAC PRO 33003 ACC.SOINS-S.PERS. OPT.A DOMICILE;1;1;1;0;0;0;0;1;0;0;0;1;0;0
23662.0;2023;01;PARIS;MASCULIN;SCOLAIRE;BAC PROFESSIONNEL;BAC PRO SERV;BAC PRO 33604 METIERS DE LA COIFFURE;3;3;3;0;0;0;0;3;0;0;0;0;3;0
23670.0;2023;01;PARIS;MASCULIN;SCOLAIRE;BAC TECHNOLOGIQUE;BAC STHR;BAC STHR SC.&TEC. HOTELLERIE-RESTAURATION;40;40;32;1;7;5;2;37;0;2;6;15;14;3
23671.0;2023;01;PARIS;MASCULIN;SCOLAIRE;BAC TECHNOLOGIQUE;BAC STI2D;BAC STI2D ARCHITECTURE ET CONSTRUCTION;65;65;52;3;10;7;3;59;0;5;15;17;22;6
23681.0;2023;13;POITIERS;FEMININ;APPRENTISSAGE;BAC PROFESSIONNEL;BAC PRO PROD;BAC PRO 20102 PILOTE DE LIGNE DE PRODUCTION;1;1;1;0;0;0;0;1;0;1;0;0;0;0
23691.0;2023;13;POITIERS;FEMININ;APPRENTISSAGE;BAC PROFESSIONNEL;BAC PRO PROD;BAC PRO AG 21001 AGRO-EQUIPEMENT;1;1;1;0;0;0;0;1;0;0;0;0;1;0
23702.0;2023;13;POITIERS;FEMININ;APPRENTISSAGE;BAC PROFESSIONNEL;BAC PRO SERV;BAC PRO 31214 MET.COM.VEN.OP.B PR.CL.VA.OF.COM.;2;2;1;1;0;0;0;1;0;0;0;1;0;1
23704.0;2023;13;POITIERS;FEMININ;APPRENTISSAGE;BAC PROFESSIONNEL;BAC PRO SERV;BAC PRO 32208 REAL.PR.IMPR.PLURI.OPTB.PR.IMPR.;2;2;2;0;0;0;0;2;0;0;1;0;1;0
23709.0;2023;13;POITIERS;FEMININ;APPRENTISSAGE;BAC PROFESSIONNEL;BAC PRO SERV;BAC PRO AG 33002 SERV PERS TERRIT;30;28;23;5;0;0;0;23;0;0;2;7;14;5
23711.0;2023;13;POITIERS;FEMININ;ENSEIGNEMENT A DISTANCE;BAC PROFESSIONNEL;BAC PRO SERV;BAC PRO 31213 MET.COM.VEN.OP.A ANI.GES.ESP.COM.;3;1;0;0;1;1;0;1;0;0;0;0;1;0
23724.0;2023;13;POITIERS;FEMININ;INDIVIDUEL;BAC PROFESSIONNEL;BAC PRO SERV;BAC PRO 31212 METIERS DE L'ACCUEIL;1;0;0;0;0;0;0;0;0;0;0;0;0;0
23726.0;2023;13;POITIERS;FEMININ;INDIVIDUEL;BAC PROFESSIONNEL;BAC PRO SERV;BAC PRO 31214 MET.COM.VEN.OP.B PR.CL.VA.OF.COM.;1;0;0;0;0;0;0;0;0;0;0;0;0;0
23730.0;2023;13;POITIERS;FEMININ;INDIVIDUEL;BAC PROFESSIONNEL;BAC PRO SERV;BAC PRO AG 33002 SERV PERS TERRIT;2;1;0;1;0;0;0;0;0;0;0;0;0;1
23734.0;2023;13;POITIERS;FEMININ;INDIVIDUEL;BAC TECHNOLOGIQUE;BAC STMG;BAC STMG SYSTEMES D'INFORMATION DE GESTION;1;1;0;1;0;0;0;0;0;0;0;0;0;1
23735.0;2023;13;POITIERS;FEMININ;SCOLAIRE;BAC GENERAL;BAC GENERAL;BAC GENE 10019 BAC GENERAL;5084;5084;4762;58;264;181;83;4943;103;632;1238;1592;1378;141
23738.0;2023;13;POITIERS;FEMININ;SCOLAIRE;BAC PROFESSIONNEL;BAC PRO PROD;BAC PRO 22003 BIO-INDUSTRIES DE TRANSFORMATION;4;4;4;0;0;0;0;4;0;0;1;1;2;0
23750.0;2023;13;POITIERS;FEMININ;SCOLAIRE;BAC PROFESSIONNEL;BAC PRO PROD;BAC PRO 24203 METIERS DE LA MODE - VÊTEMENT;58;58;53;5;0;0;0;53;0;8;16;23;6;5
23757.0;2023;13;POITIERS;FEMININ;SCOLAIRE;BAC PROFESSIONNEL;BAC PRO PROD;BAC PRO 25216 MAINT.VEHIC.OPTC MOTOCYCLES;1;1;1;0;0;0;0;1;0;0;0;0;1;0
23762.0;2023;13;POITIERS;FEMININ;SCOLAIRE;BAC PROFESSIONNEL;BAC PRO PROD;BAC PRO 25510 METIERS ELECT. ENVIRON. CONNECTES;1;1;1;0;0;0;0;1;0;0;0;0;1;0
23764.0;2023;13;POITIERS;FEMININ;SCOLAIRE;BAC PROFESSIONNEL;BAC PRO PROD;BAC PRO 25515 SYST.NUM.OPT.C RES.INF.SYST.COMM.;2;2;2;0;0;0;0;2;0;0;0;1;1;0
23766.0;2023;13;POITIERS;FEMININ;SCOLAIRE;BAC PROFESSIONNEL;BAC PRO PROD;BAC PRO AG 21113 CGEVV;1;1;1;0;0;0;0;1;0;0;0;0;1;0
23776.0;2023;13;POITIERS;FEMININ;SCOLAIRE;BAC PROFESSIONNEL;BAC PRO PROD;BAC PRO AG 22105 LABORATOIRE CONTROLE QUALITE;13;13;11;2;0;0;0;11;0;0;0;8;3;2
23777.0;2023;13;POITIERS;FEMININ;SCOLAIRE;BAC PROFESSIONNEL;BAC PRO PROD;BAC PRO AG 22108 TEC CONS VTE ALIMENTATION (PAB);24;24;21;3;0;0;0;21;0;0;1;10;10;3
23782.0;2023;13;POITIERS;FEMININ;SCOLAIRE;BAC PROFESSIONNEL;BAC PRO SERV;BAC PRO 31212 METIERS DE L'ACCUEIL;63;63;50;10;3;1;2;51;0;2;8;25;16;12
23788.0;2023;13;POITIERS;FEMININ;SCOLAIRE;BAC PROFESSIONNEL;BAC PRO SERV;BAC PRO 33003 ACC.SOINS-S.PERS. OPT.A DOMICILE;43;43;35;3;5;4;1;39;0;0;3;19;17;4
23789.0;2023;13;POITIERS;FEMININ;SCOLAIRE;BAC PROFESSIONNEL;BAC PRO SERV;BAC PRO 33004 ACC.SOINS-S.PERS. OPT.EN STRUCTUR;263;262;227;22;13;10;3;237;0;7;60;95;75;25
23791.0;2023;13;POITIERS;FEMININ;SCOLAIRE;BAC PROFESSIONNEL;BAC PRO SERV;BAC PRO 33101 OPTIQUE LUNETTERIE;3;3;3;0;0;0;0;3;0;0;0;2;1;0
23792.0;2023;13;POITIERS;FEMININ;SCOLAIRE;BAC PROFESSIONNEL;BAC PRO SERV;BAC PRO 33403 COMMERC. SERVICES EN RESTAURATION;27;27;22;3;2;1;1;23;0;0;5;11;7;4
23794.0;2023;13;POITIERS;FEMININ;SCOLAIRE;BAC PROFESSIONNEL;BAC PRO SERV;BAC PRO 33604 METIERS DE LA COIFFURE;13;13;13;0;0;0;0;13;0;1;3;6;3;0
23795.0;2023;13;POITIERS;FEMININ;SCOLAIRE;BAC PROFESSIONNEL;BAC PRO SERV;BAC PRO 34303 GEST. POLLUTIONS PROTEC. ENVIRON.;2;2;2;0;0;0;0;2;0;0;0;2;0;0
23796.0;2023;13;POITIERS;FEMININ;SCOLAIRE;BAC PROFESSIONNEL;BAC PRO SERV;BAC PRO 34403 METIERS DE LA SECURITE;22;22;21;0;1;1;0;22;0;0;4;11;7;0
23800.0;2023;13;POITIERS;FEMININ;SCOLAIRE;BAC TECHNOLOGIQUE;BAC STD2A;BAC STD2A SCIENCES & TECHNO. DESIGN-ARTS APPLIQUES;111;111;108;2;1;0;1;108;0;5;26;53;24;3
23802.0;2023;13;POITIERS;FEMININ;SCOLAIRE;BAC TECHNOLOGIQUE;BAC STI2D;BAC STI2D ARCHITECTURE ET CONSTRUCTION;12;12;9;0;3;2;1;11;0;0;3;4;4;1
23804.0;2023;13;POITIERS;FEMININ;SCOLAIRE;BAC TECHNOLOGIQUE;BAC STI2D;BAC STI2D INNOVATION TECHNO.  ET ECO CONCEPTION;7;7;5;1;1;1;0;6;0;0;0;3;3;1
23806.0;2023;13;POITIERS;FEMININ;SCOLAIRE;BAC TECHNOLOGIQUE;BAC STL;BAC STL BIOCHIM.-BIOLOGIE-BIOTECHNOL.;57;57;52;1;4;4;0;56;2;6;12;23;13;1
23814.0;2023;13;POITIERS;MASCULIN;APPRENTISSAGE;BAC PROFESSIONNEL;BAC PRO PROD;BAC PRO 22106 CUISINE;15;15;13;1;1;1;0;14;0;1;2;3;8;1
23820.0;2023;13;POITIERS;MASCULIN;APPRENTISSAGE;BAC PROFESSIONNEL;BAC PRO PROD;BAC PRO 23303 MENUISERIE ALUMINIUM-VERRE;3;3;1;0;2;2;0;3;0;0;0;1;2;0
23821.0;2023;13;POITIERS;MASCULIN;APPRENTISSAGE;BAC PROFESSIONNEL;BAC PRO PROD;BAC PRO 23404 TECHNICIEN CONSTRUCTEUR BOIS;12;12;9;3;0;0;0;9;0;0;0;6;3;3
23831.0;2023;13;POITIERS;MASCULIN;APPRENTISSAGE;BAC PROFESSIONNEL;BAC PRO PROD;BAC PRO 25221 MAINT.MATERIELS OPT.C ESP. VERTS;3;3;2;1;0;0;0;2;0;0;0;1;1;1
23837.0;2023;13;POITIERS;MASCULIN;APPRENTISSAGE;BAC PROFESSIONNEL;BAC PRO PROD;BAC PRO 25510 METIERS ELECT. ENVIRON. CONNECTES;59;58;50;4;4;2;2;52;0;4;9;15;24;6
23840.0;2023;13;POITIERS;MASCULIN;APPRENTISSAGE;BAC PROFESSIONNEL;BAC PRO PROD;BAC PRO AG 21001 AGRO-EQUIPEMENT;19;19;16;3;0;0;0;16;0;0;0;4;12;3
23849.0;2023;13;POITIERS;MASCULIN;APPRENTISSAGE;BAC PROFESSIONNEL;BAC PRO SERV;BAC PRO 31106 LOGISTIQUE;14;14;9;3;2;1;1;10;0;0;1;1;8;4
23854.0;2023;13;POITIERS;MASCULIN;APPRENTISSAGE;BAC PROFESSIONNEL;BAC PRO SERV;BAC PRO 33004 ACC.SOINS-S.PERS. OPT.EN STRUCTUR;1;1;0;1;0;0;0;0;0;0;0;0;0;1
23857.0;2023;13;POITIERS;MASCULIN;APPRENTISSAGE;BAC PROFESSIONNEL;BAC PRO SERV;BAC PRO 33403 COMMERC. SERVICES EN RESTAURATION;6;6;4;0;2;0;2;4;0;1;0;1;2;2
23863.0;2023;13;POITIERS;MASCULIN;ENSEIGNEMENT A DISTANCE;BAC TECHNOLOGIQUE;BAC STMG;BAC STMG GESTION ET FINANCE;1;1;0;0;1;1;0;1;0;0;0;0;1;0
23871.0;2023;13;POITIERS;MASCULIN;INDIVIDUEL;BAC PROFESSIONNEL;BAC PRO PROD;BAC PRO 25006 MICROTECHNIQUES;1;0;0;0;0;0;0;0;0;0;0;0;0;0
23875.0;2023;13;POITIERS;MASCULIN;INDIVIDUEL;BAC PROFESSIONNEL;BAC PRO PROD;BAC PRO 25408 REPARATION DES CARROSSERIES;1;0;0;0;0;0;0;0;0;0;0;0;0;0
23879.0;2023;13;POITIERS;MASCULIN;INDIVIDUEL;BAC PROFESSIONNEL;BAC PRO PROD;BAC PRO AG 21004 CGEA;4;4;4;0;0;0;0;4;0;0;0;0;4;0
23884.0;2023;13;POITIERS;MASCULIN;INDIVIDUEL;BAC PROFESSIONNEL;BAC PRO SERV;BAC PRO 33006 ANIMAT. ENFANCE& PERSONNES AGEES;1;0;0;0;0;0;0;0;0;0;0;0;0;0
23885.0;2023;13;POITIERS;MASCULIN;INDIVIDUEL;BAC PROFESSIONNEL;BAC PRO SERV;BAC PRO 34403 METIERS DE LA SECURITE;1;0;0;0;0;0;0;0;0;0;0;0;0;0
23888.0;2023;13;POITIERS;MASCULIN;INDIVIDUEL;BAC TECHNOLOGIQUE;BAC STI2D;BAC STI2D INNOVATION TECHNO.  ET ECO CONCEPTION;1;1;0;1;0;0;0;0;0;0;0;0;0;1
23891.0;2023;13;POITIERS;MASCULIN;INDIVIDUEL;BAC TECHNOLOGIQUE;BAC STMG;BAC STMG RESSOURCES HUMAINES ET COMMUNICATION;4;4;0;4;0;0;0;0;0;0;0;0;0;4
23894.0;2023;13;POITIERS;MASCULIN;SCOLAIRE;BAC PROFESSIONNEL;BAC PRO PROD;BACPRO 20002 ETUD.DEFINITION PRDTS INDUSTRIEL;6;6;5;0;1;0;1;5;0;0;2;1;2;1
23901.0;2023;13;POITIERS;MASCULIN;SCOLAIRE;BAC PROFESSIONNEL;BAC PRO PROD;BAC PRO 22703 TECHN.INSTALL.SYST.ENERG.CLIMATI;27;27;20;5;2;1;1;21;0;2;3;9;7;6
23902.0;2023;13;POITIERS;MASCULIN;SCOLAIRE;BAC PROFESSIONNEL;BAC PRO PROD;BAC PRO 22704 TECHN. MAINT. SYST.ENERG.CLIMATI;8;8;4;3;1;1;0;5;0;0;1;1;3;3
23914.0;2023;13;POITIERS;MASCULIN;SCOLAIRE;BAC PROFESSIONNEL;BAC PRO PROD;BAC PRO 24203 METIERS DE LA MODE - VÊTEMENT;4;4;3;1;0;0;0;3;0;0;0;3;0;1
23916.0;2023;13;POITIERS;MASCULIN;SCOLAIRE;BAC PROFESSIONNEL;BAC PRO PROD;BAC PRO 25006 MICROTECHNIQUES;11;11;11;0;0;0;0;11;0;1;3;5;2;0
23922.0;2023;13;POITIERS;MASCULIN;SCOLAIRE;BAC PROFESSIONNEL;BAC PRO PROD;BAC PRO 25215 MAINT.VEHIC.OPTB VEHIC.TRANS.ROUT;28;28;20;8;0;0;0;20;0;1;3;9;7;8
23926.0;2023;13;POITIERS;MASCULIN;SCOLAIRE;BAC PROFESSIONNEL;BAC PRO PROD;BAC PRO 25221 MAINT.MATERIELS OPT.C ESP. VERTS;5;5;3;2;0;0;0;3;0;0;0;1;2;2
23930.0;2023;13;POITIERS;MASCULIN;SCOLAIRE;BAC PROFESSIONNEL;BAC PRO PROD;BAC PRO 25408 REPARATION DES CARROSSERIES;15;15;9;2;4;2;2;11;0;0;1;3;7;4
23941.0;2023;13;POITIERS;MASCULIN;SCOLAIRE;BAC PROFESSIONNEL;BAC PRO PROD;BAC PRO AG 21203 TECHN CONSEIL DE VENTE ANIMAL;11;10;9;1;0;0;0;9;0;0;1;3;5;1
23950.0;2023;13;POITIERS;MASCULIN;SCOLAIRE;BAC PROFESSIONNEL;BAC PRO PROD;BAC PRO AG 22108 TEC CONS VTE ALIMENTATION (PAB);15;15;15;0;0;0;0;15;0;0;3;4;8;0
23951.0;2023;13;POITIERS;MASCULIN;SCOLAIRE;BAC PROFESSIONNEL;BAC PRO SERV;BAC PRO 30004 ASSISTANC.GEST.ORGANIS.ACTIVITES;69;69;46;21;2;1;1;47;0;1;4;19;23;22
23954.0;2023;13;POITIERS;MASCULIN;SCOLAIRE;BAC PROFESSIONNEL;BAC PRO SERV;BAC PRO 31114 ORGANIS. TRANSPORT MARCHANDISES;18;18;12;6;0;0;0;12;0;0;3;4;5;6
23955.0;2023;13;POITIERS;MASCULIN;SCOLAIRE;BAC PROFESSIONNEL;BAC PRO SERV;BAC PRO 31212 METIERS DE L'ACCUEIL;11;11;9;2;0;0;0;9;0;1;2;2;4;2
23958.0;2023;13;POITIERS;MASCULIN;SCOLAIRE;BAC PROFESSIONNEL;BAC PRO SERV;BAC PRO 32207 REAL.PR.IMPR.PLURI.OPTA.PR.GRAPH.;6;6;6;0;0;0;0;6;0;2;2;1;1;0
23960.0;2023;13;POITIERS;MASCULIN;SCOLAIRE;BAC PROFESSIONNEL;BAC PRO SERV;BAC PRO 32303 ART.& MET.ART:COM.VIS.VIS.PLURI-M;20;20;20;0;0;0;0;20;0;5;1;7;7;0
23962.0;2023;13;POITIERS;MASCULIN;SCOLAIRE;BAC PROFESSIONNEL;BAC PRO SERV;BAC PRO 33003 ACC.SOINS-S.PERS. OPT.A DOMICILE;4;4;3;0;1;1;0;4;0;0;0;1;3;0
23964.0;2023;13;POITIERS;MASCULIN;SCOLAIRE;BAC PROFESSIONNEL;BAC PRO SERV;BAC PRO 33006 ANIMAT. ENFANCE& PERSONNES AGEES;27;27;22;3;2;2;0;24;0;1;3;9;11;3
23965.0;2023;13;POITIERS;MASCULIN;SCOLAIRE;BAC PROFESSIONNEL;BAC PRO SERV;BAC PRO 33101 OPTIQUE LUNETTERIE;7;7;6;1;0;0;0;6;0;0;1;4;1;1
23966.0;2023;13;POITIERS;MASCULIN;SCOLAIRE;BAC PROFESSIONNEL;BAC PRO SERV;BAC PRO 33403 COMMERC. SERVICES EN RESTAURATION;54;54;49;5;0;0;0;49;0;3;13;15;18;5
23971.0;2023;13;POITIERS;MASCULIN;SCOLAIRE;BAC TECHNOLOGIQUE;BAC ST2S;BAC ST2S SCIENCES & TECHNO. SANTE & SOCIAL;62;62;56;1;5;3;2;59;0;0;7;23;29;3
23997.0;2023;19;REIMS;FEMININ;APPRENTISSAGE;BAC PROFESSIONNEL;BAC PRO SERV;BAC PRO 31213 MET.COM.VEN.OP.A ANI.GES.ESP.COM.;43;43;29;5;9;7;2;36;0;0;7;11;18;7
23998.0;2023;19;REIMS;FEMININ;APPRENTISSAGE;BAC PROFESSIONNEL;BAC PRO SERV;BAC PRO 33403 COMMERC. SERVICES EN RESTAURATION;1;1;1;0;0;0;0;1;0;0;0;1;0;0
24022.0;2023;19;REIMS;FEMININ;INDIVIDUEL;BAC PROFESSIONNEL;BAC PRO SERV;BAC PRO 30004 ASSISTANC.GEST.ORGANIS.ACTIVITES;5;4;1;1;2;1;1;2;0;0;0;0;2;2
24024.0;2023;19;REIMS;FEMININ;INDIVIDUEL;BAC PROFESSIONNEL;BAC PRO SERV;BAC PRO 32303 ART.& MET.ART:COM.VIS.VIS.PLURI-M;1;1;1;0;0;0;0;1;0;0;0;0;1;0
24032.0;2023;19;REIMS;FEMININ;INDIVIDUEL;BAC TECHNOLOGIQUE;BAC STMG;BAC STMG RESSOURCES HUMAINES ET COMMUNICATION;6;5;1;4;0;0;0;1;0;0;0;1;0;4
24038.0;2023;19;REIMS;FEMININ;SCOLAIRE;BAC PROFESSIONNEL;BAC PRO PROD;BAC PRO 22302 Traitement des matériaux;1;1;1;0;0;0;0;1;0;0;0;0;1;0
24039.0;2023;19;REIMS;FEMININ;SCOLAIRE;BAC PROFESSIONNEL;BAC PRO PROD;BAC PRO 23004 TECHN. ETUDES BAT.A ETUDES & ECO.;8;8;7;1;0;0;0;7;0;1;0;4;2;1
24045.0;2023;19;REIMS;FEMININ;SCOLAIRE;BAC PROFESSIONNEL;BAC PRO PROD;BAC PRO 24202 ARTIS.& MET.ART : TAPIS.D'AMEUBL;4;4;4;0;0;0;0;4;0;1;1;1;1;0
24051.0;2023;19;REIMS;FEMININ;SCOLAIRE;BAC PROFESSIONNEL;BAC PRO PROD;BAC PRO 25510 METIERS ELECT. ENVIRON. CONNECTES;4;4;2;2;0;0;0;2;0;0;0;0;2;2
24053.0;2023;19;REIMS;FEMININ;SCOLAIRE;BAC PROFESSIONNEL;BAC PRO PROD;BAC PRO 25515 SYST.NUM.OPT.C RES.INF.SYST.COMM.;2;2;2;0;0;0;0;2;0;0;2;0;0;0
24055.0;2023;19;REIMS;FEMININ;SCOLAIRE;BAC PROFESSIONNEL;BAC PRO PROD;BAC PRO AG 21113 CGEVV;8;8;6;2;0;0;0;6;0;0;1;1;4;2
24067.0;2023;19;REIMS;FEMININ;SCOLAIRE;BAC PROFESSIONNEL;BAC PRO SERV;BAC PRO 31212 METIERS DE L'ACCUEIL;73;73;53;10;10;6;4;59;0;3;12;13;31;14
24074.0;2023;19;REIMS;FEMININ;SCOLAIRE;BAC PROFESSIONNEL;BAC PRO SERV;BAC PRO 33003 ACC.SOINS-S.PERS. OPT.A DOMICILE;78;78;63;13;2;2;0;65;0;3;11;30;21;13
24077.0;2023;19;REIMS;FEMININ;SCOLAIRE;BAC PROFESSIONNEL;BAC PRO SERV;BAC PRO 33101 OPTIQUE LUNETTERIE;5;5;5;0;0;0;0;5;0;0;2;1;2;0
24087.0;2023;19;REIMS;FEMININ;SCOLAIRE;BAC TECHNOLOGIQUE;BAC STAV;BAC STAV AGRONOMIE ALIM ENV TERRITOI;64;63;61;2;0;0;0;61;0;0;6;20;35;2
24091.0;2023;19;REIMS;FEMININ;SCOLAIRE;BAC TECHNOLOGIQUE;BAC STI2D;BAC STI2D ENERGIES  ET ENVIRONNEMENT;7;7;4;0;3;1;2;5;0;0;1;2;2;2
24092.0;2023;19;REIMS;FEMININ;SCOLAIRE;BAC TECHNOLOGIQUE;BAC STI2D;BAC STI2D INNOVATION TECHNO.  ET ECO CONCEPTION;8;8;7;0;1;1;0;8;0;0;3;2;3;0
24096.0;2023;19;REIMS;FEMININ;SCOLAIRE;BAC TECHNOLOGIQUE;BAC STMG;BAC STMG GESTION ET FINANCE;135;135;118;5;12;10;2;128;0;0;14;34;80;7
24103.0;2023;19;REIMS;MASCULIN;APPRENTISSAGE;BAC PROFESSIONNEL;BAC PRO PROD;BAC PRO 22303 FONDERIE;1;1;1;0;0;0;0;1;0;1;0;0;0;0
24104.0;2023;19;REIMS;MASCULIN;APPRENTISSAGE;BAC PROFESSIONNEL;BAC PRO PROD;BAC PRO 22703 TECHN.INSTALL.SYST.ENERG.CLIMATI;7;7;5;0;2;0;2;5;0;0;1;2;2;2
24109.0;2023;19;REIMS;MASCULIN;APPRENTISSAGE;BAC PROFESSIONNEL;BAC PRO PROD;BAC PRO 23304 AMENAGEMENT FINITION BATIMENT;3;3;3;0;0;0;0;3;0;1;0;1;1;0
24124.0;2023;19;REIMS;MASCULIN;APPRENTISSAGE;BAC PROFESSIONNEL;BAC PRO PROD;BAC PRO 25510 METIERS ELECT. ENVIRON. CONNECTES;38;38;29;7;2;2;0;31;0;0;9;10;12;7
24127.0;2023;19;REIMS;MASCULIN;APPRENTISSAGE;BAC PROFESSIONNEL;BAC PRO PROD;BAC PRO AG 21001 AGRO-EQUIPEMENT;10;10;4;6;0;0;0;4;0;0;0;1;3;6
24131.0;2023;19;REIMS;MASCULIN;APPRENTISSAGE;BAC PROFESSIONNEL;BAC PRO PROD;BAC PRO AG 21405 AMENAGEMENTS PAYSAGERS;20;19;18;1;0;0;0;18;0;0;0;6;12;1
24132.0;2023;19;REIMS;MASCULIN;APPRENTISSAGE;BAC PROFESSIONNEL;BAC PRO SERV;BAC PRO 30004 ASSISTANC.GEST.ORGANIS.ACTIVITES;2;2;2;0;0;0;0;2;0;1;0;0;1;0
24134.0;2023;19;REIMS;MASCULIN;APPRENTISSAGE;BAC PROFESSIONNEL;BAC PRO SERV;BAC PRO 31213 MET.COM.VEN.OP.A ANI.GES.ESP.COM.;25;25;23;0;2;2;0;25;0;1;4;9;11;0
24137.0;2023;19;REIMS;MASCULIN;APPRENTISSAGE;BAC PROFESSIONNEL;BAC PRO SERV;BAC PRO 33403 COMMERC. SERVICES EN RESTAURATION;2;2;1;0;1;1;0;2;0;0;0;0;2;0
24138.0;2023;19;REIMS;MASCULIN;APPRENTISSAGE;BAC PROFESSIONNEL;BAC PRO SERV;BAC PRO 34305 TECHN.D'INTERV.SUR INSTALL. NUCL.;3;3;3;0;0;0;0;3;0;2;0;1;0;0
24144.0;2023;19;REIMS;MASCULIN;FORMATION CONTINUE;BAC PROFESSIONNEL;BAC PRO PROD;BAC PRO 22106 CUISINE;1;1;1;0;0;0;0;1;0;0;0;0;1;0
24148.0;2023;19;REIMS;MASCULIN;FORMATION CONTINUE;BAC PROFESSIONNEL;BAC PRO PROD;BAC PRO 25510 METIERS ELECT. ENVIRON. CONNECTES;1;1;1;0;0;0;0;1;0;1;0;0;0;0
24149.0;2023;19;REIMS;MASCULIN;INDIVIDUEL;BAC GENERAL;BAC GENERAL;BAC GENE 10019 BAC GENERAL;29;27;7;15;5;1;4;8;0;0;2;2;4;19
24154.0;2023;19;REIMS;MASCULIN;INDIVIDUEL;BAC PROFESSIONNEL;BAC PRO PROD;BAC PRO 25408 REPARATION DES CARROSSERIES;1;1;1;0;0;0;0;1;0;0;0;1;0;0
24161.0;2023;19;REIMS;MASCULIN;INDIVIDUEL;BAC TECHNOLOGIQUE;BAC STI2D;BAC STI2D ARCHITECTURE ET CONSTRUCTION;1;1;0;1;0;0;0;0;0;0;0;0;0;1
24163.0;2023;19;REIMS;MASCULIN;INDIVIDUEL;BAC TECHNOLOGIQUE;BAC STI2D;BAC STI2D INNOVATION TECHNO.  ET ECO CONCEPTION;1;1;0;1;0;0;0;0;0;0;0;0;0;1
24170.0;2023;19;REIMS;MASCULIN;SCOLAIRE;BAC PROFESSIONNEL;BAC PRO PROD;BAC PRO 22003 BIO-INDUSTRIES DE TRANSFORMATION;12;12;10;2;0;0;0;10;0;1;0;5;4;2
24184.0;2023;19;REIMS;MASCULIN;SCOLAIRE;BAC PROFESSIONNEL;BAC PRO PROD;BAC PRO 23304 AMENAGEMENT FINITION BATIMENT;14;14;12;2;0;0;0;12;0;0;2;6;4;2
24186.0;2023;19;REIMS;MASCULIN;SCOLAIRE;BAC PROFESSIONNEL;BAC PRO PROD;BAC PRO 23405 TECHNICIEN MENUISIER AGENCEUR;23;23;14;7;2;2;0;16;0;0;3;4;9;7
24188.0;2023;19;REIMS;MASCULIN;SCOLAIRE;BAC PROFESSIONNEL;BAC PRO PROD;BAC PRO 24203 METIERS DE LA MODE - VÊTEMENT;5;5;5;0;0;0;0;5;0;1;1;2;1;0
24206.0;2023;19;REIMS;MASCULIN;SCOLAIRE;BAC PROFESSIONNEL;BAC PRO PROD;BAC PRO AG 21114 CONDUITE PRODUCTIONS HORTICOLES;8;8;7;1;0;0;0;7;0;0;0;2;5;1
24218.0;2023;19;REIMS;MASCULIN;SCOLAIRE;BAC PROFESSIONNEL;BAC PRO SERV;BAC PRO 31213 MET.COM.VEN.OP.A ANI.GES.ESP.COM.;166;166;114;30;22;14;8;128;0;5;19;43;61;38
24219.0;2023;19;REIMS;MASCULIN;SCOLAIRE;BAC PROFESSIONNEL;BAC PRO SERV;BAC PRO 31214 MET.COM.VEN.OP.B PR.CL.VA.OF.COM.;159;159;105;40;14;11;3;116;0;5;16;39;56;43
24224.0;2023;19;REIMS;MASCULIN;SCOLAIRE;BAC PROFESSIONNEL;BAC PRO SERV;BAC PRO 33003 ACC.SOINS-S.PERS. OPT.A DOMICILE;6;6;3;3;0;0;0;3;0;0;0;2;1;3
24230.0;2023;19;REIMS;MASCULIN;SCOLAIRE;BAC PROFESSIONNEL;BAC PRO SERV;BAC PRO 34304 HYGIENE PROPRETE STERILISATION;3;3;2;0;1;1;0;3;0;1;1;0;1;0
24233.0;2023;19;REIMS;MASCULIN;SCOLAIRE;BAC PROFESSIONNEL;BAC PRO SERV;BAC PRO AG 33002 SERV PERS TERRIT;4;4;3;1;0;0;0;3;0;0;0;1;2;1
24237.0;2023;19;REIMS;MASCULIN;SCOLAIRE;BAC TECHNOLOGIQUE;BAC STD2A;BAC STD2A SCIENCES & TECHNO. DESIGN-ARTS APPLIQUES;20;20;16;1;3;3;0;19;0;0;1;9;9;1
24241.0;2023;19;REIMS;MASCULIN;SCOLAIRE;BAC TECHNOLOGIQUE;BAC STI2D;BAC STI2D INNOVATION TECHNO.  ET ECO CONCEPTION;111;111;83;4;24;15;9;98;0;3;9;22;64;13
24243.0;2023;19;REIMS;MASCULIN;SCOLAIRE;BAC TECHNOLOGIQUE;BAC STL;BAC STL BIOCHIM.-BIOLOGIE-BIOTECHNOL.;22;22;18;1;3;1;2;19;0;0;4;10;5;3
24246.0;2023;19;REIMS;MASCULIN;SCOLAIRE;BAC TECHNOLOGIQUE;BAC STMG;BAC STMG MERCATIQUE (MARKETING);324;324;204;35;85;62;23;266;0;0;9;53;204;58
24266.0;2023;14;RENNES;FEMININ;APPRENTISSAGE;BAC PROFESSIONNEL;BAC PRO PROD;BAC PRO AG 21001 AGRO-EQUIPEMENT;4;4;3;1;0;0;0;3;0;0;0;2;1;1
24278.0;2023;14;RENNES;FEMININ;APPRENTISSAGE;BAC PROFESSIONNEL;BAC PRO SERV;BAC PRO 33403 COMMERC. SERVICES EN RESTAURATION;18;17;14;1;2;1;1;15;0;2;5;4;4;2
24296.0;2023;14;RENNES;FEMININ;INDIVIDUEL;BAC PROFESSIONNEL;BAC PRO PROD;BAC PRO AG 21211 COND GEST ENTR HIPPIQUE;12;8;6;2;0;0;0;6;0;0;0;3;3;2
24303.0;2023;14;RENNES;FEMININ;INDIVIDUEL;BAC PROFESSIONNEL;BAC PRO SERV;BAC PRO 33004 ACC.SOINS-S.PERS. OPT.EN STRUCTUR;2;1;1;0;0;0;0;1;0;0;0;0;1;0
24305.0;2023;14;RENNES;FEMININ;INDIVIDUEL;BAC TECHNOLOGIQUE;BAC ST2S;BAC ST2S SCIENCES & TECHNO. SANTE & SOCIAL;6;5;0;4;1;1;0;1;0;0;0;0;1;4
24314.0;2023;14;RENNES;FEMININ;SCOLAIRE;BAC PROFESSIONNEL;BAC PRO PROD;BAC PRO 22403 ARTS.& MET.ART:MET.ENSEIGN SIGNA;2;2;2;0;0;0;0;2;0;0;0;2;0;0
24320.0;2023;14;RENNES;FEMININ;SCOLAIRE;BAC PROFESSIONNEL;BAC PRO PROD;BACPRO 23103 TECHNICIEN GEOMETRE-TOPOGRAPHE;3;3;2;1;0;0;0;2;0;0;0;2;0;1
24323.0;2023;14;RENNES;FEMININ;SCOLAIRE;BAC PROFESSIONNEL;BAC PRO PROD;BAC PRO 23405 TECHNICIEN MENUISIER AGENCEUR;18;18;12;5;1;0;1;12;0;1;3;5;3;6
24329.0;2023;14;RENNES;FEMININ;SCOLAIRE;BAC PROFESSIONNEL;BAC PRO PROD;BAC PRO 25006 MICROTECHNIQUES;3;3;3;0;0;0;0;3;0;0;1;2;0;0
24330.0;2023;14;RENNES;FEMININ;SCOLAIRE;BAC PROFESSIONNEL;BAC PRO PROD;BAC PRO 25007 MAINTENANCE EQUIPEMENTS INDUST.;10;10;9;1;0;0;0;9;0;0;3;3;3;1
24346.0;2023;14;RENNES;FEMININ;SCOLAIRE;BAC PROFESSIONNEL;BAC PRO PROD;BAC PRO AG 21114 CONDUITE PRODUCTIONS HORTICOLES;13;13;10;3;0;0;0;10;0;2;2;5;1;3
24347.0;2023;14;RENNES;FEMININ;SCOLAIRE;BAC PROFESSIONNEL;BAC PRO PROD;BAC PRO AG 21203 TECHN CONSEIL DE VENTE ANIMAL;59;59;48;11;0;0;0;48;0;0;5;20;23;11
24350.0;2023;14;RENNES;FEMININ;SCOLAIRE;BAC PROFESSIONNEL;BAC PRO PROD;BAC PRO AG 21211 COND GEST ENTR HIPPIQUE;45;45;39;6;0;0;0;39;0;0;4;12;23;6
24353.0;2023;14;RENNES;FEMININ;SCOLAIRE;BAC PROFESSIONNEL;BAC PRO PROD;BAC PRO AG 21407 TEC CONS VTE UNIVERS JARDINERIE;19;18;12;6;0;0;0;12;0;0;0;6;6;6
24362.0;2023;14;RENNES;FEMININ;SCOLAIRE;BAC PROFESSIONNEL;BAC PRO SERV;BAC PRO 31214 MET.COM.VEN.OP.B PR.CL.VA.OF.COM.;197;197;180;11;6;5;1;185;0;5;42;69;69;12
24363.0;2023;14;RENNES;FEMININ;SCOLAIRE;BAC PROFESSIONNEL;BAC PRO SERV;BAC PRO 32207 REAL.PR.IMPR.PLURI.OPTA.PR.GRAPH.;17;17;16;1;0;0;0;16;0;0;8;6;2;1
24367.0;2023;14;RENNES;FEMININ;SCOLAIRE;BAC PROFESSIONNEL;BAC PRO SERV;BAC PRO 33004 ACC.SOINS-S.PERS. OPT.EN STRUCTUR;508;508;463;35;10;7;3;470;0;22;119;211;118;38
24368.0;2023;14;RENNES;FEMININ;SCOLAIRE;BAC PROFESSIONNEL;BAC PRO SERV;BAC PRO 33006 ANIMAT. ENFANCE& PERSONNES AGEES;67;67;63;3;1;1;0;64;0;7;17;26;14;3
24370.0;2023;14;RENNES;FEMININ;SCOLAIRE;BAC PROFESSIONNEL;BAC PRO SERV;BAC PRO 33403 COMMERC. SERVICES EN RESTAURATION;109;109;98;4;7;5;2;103;0;5;24;37;37;6
24378.0;2023;14;RENNES;FEMININ;SCOLAIRE;BAC TECHNOLOGIQUE;BAC S2TMD;BAC S2TMD MUSIQUE;2;2;2;0;0;0;0;2;0;0;2;0;0;0
24379.0;2023;14;RENNES;FEMININ;SCOLAIRE;BAC TECHNOLOGIQUE;BAC S2TMD;BAC S2TMD THEATRE;3;3;3;0;0;0;0;3;0;0;3;0;0;0
24382.0;2023;14;RENNES;FEMININ;SCOLAIRE;BAC TECHNOLOGIQUE;BAC STD2A;BAC STD2A SCIENCES & TECHNO. DESIGN-ARTS APPLIQUES;119;119;119;0;0;0;0;119;0;19;55;39;6;0
24391.0;2023;14;RENNES;FEMININ;SCOLAIRE;BAC TECHNOLOGIQUE;BAC STMG;BAC STMG MERCATIQUE (MARKETING);1281;1281;1090;23;168;122;46;1212;0;14;117;457;624;69
24393.0;2023;14;RENNES;FEMININ;SCOLAIRE;BAC TECHNOLOGIQUE;BAC STMG;BAC STMG SYSTEMES D'INFORMATION DE GESTION;6;6;4;0;2;1;1;5;0;0;1;1;3;1
24403.0;2023;14;RENNES;MASCULIN;APPRENTISSAGE;BAC PROFESSIONNEL;BAC PRO PROD;BAC PRO 23404 TECHNICIEN CONSTRUCTEUR BOIS;16;16;15;0;1;1;0;16;0;1;4;6;5;0
24405.0;2023;14;RENNES;MASCULIN;APPRENTISSAGE;BAC PROFESSIONNEL;BAC PRO PROD;BAC PRO 25007 MAINTENANCE EQUIPEMENTS INDUST.;42;42;29;10;3;2;1;31;0;3;4;10;14;11
24413.0;2023;14;RENNES;MASCULIN;APPRENTISSAGE;BAC PROFESSIONNEL;BAC PRO PROD;BAC PRO 25220 MAINT.MATERIELS OPT.B TP MANUT.;27;26;19;4;3;2;1;21;0;3;7;7;4;5
24414.0;2023;14;RENNES;MASCULIN;APPRENTISSAGE;BAC PROFESSIONNEL;BAC PRO PROD;BAC PRO 25221 MAINT.MATERIELS OPT.C ESP. VERTS;24;23;20;3;0;0;0;20;0;0;0;9;11;3
24422.0;2023;14;RENNES;MASCULIN;APPRENTISSAGE;BAC PROFESSIONNEL;BAC PRO PROD;BAC PRO AG 21004 CGEA;77;76;52;24;0;0;0;52;0;1;5;7;39;24
24423.0;2023;14;RENNES;MASCULIN;APPRENTISSAGE;BAC PROFESSIONNEL;BAC PRO PROD;BAC PRO AG 21114 CONDUITE PRODUCTIONS HORTICOLES;6;5;5;0;0;0;0;5;0;1;1;1;2;0
24426.0;2023;14;RENNES;MASCULIN;APPRENTISSAGE;BAC PROFESSIONNEL;BAC PRO PROD;BAC PRO AG 21405 AMENAGEMENTS PAYSAGERS;91;83;70;13;0;0;0;70;0;0;8;15;47;13
24428.0;2023;14;RENNES;MASCULIN;APPRENTISSAGE;BAC PROFESSIONNEL;BAC PRO SERV;BAC PRO 30004 ASSISTANC.GEST.ORGANIS.ACTIVITES;1;1;1;0;0;0;0;1;0;0;0;1;0;0
24431.0;2023;14;RENNES;MASCULIN;APPRENTISSAGE;BAC PROFESSIONNEL;BAC PRO SERV;BAC PRO 31213 MET.COM.VEN.OP.A ANI.GES.ESP.COM.;155;154;114;32;8;3;5;117;0;3;21;43;50;37
24446.0;2023;14;RENNES;MASCULIN;FORMATION CONTINUE;BAC PROFESSIONNEL;BAC PRO PROD;BAC PRO 25411 TECH.CHAUDRONNERIE INDUSTRIELLE;1;1;1;0;0;0;0;1;0;0;1;0;0;0
24450.0;2023;14;RENNES;MASCULIN;INDIVIDUEL;BAC PROFESSIONNEL;BAC PRO PROD;BAC PRO 23405 TECHNICIEN MENUISIER AGENCEUR;1;0;0;0;0;0;0;0;0;0;0;0;0;0
24455.0;2023;14;RENNES;MASCULIN;INDIVIDUEL;BAC PROFESSIONNEL;BAC PRO PROD;BAC PRO 25509 TECHNIC. FROID CONDITIONNEMT AIR;1;1;0;0;1;1;0;1;0;0;0;0;1;0
24467.0;2023;14;RENNES;MASCULIN;INDIVIDUEL;BAC PROFESSIONNEL;BAC PRO SERV;BAC PRO 33403 COMMERC. SERVICES EN RESTAURATION;1;1;1;0;0;0;0;1;0;0;0;1;0;0
24471.0;2023;14;RENNES;MASCULIN;INDIVIDUEL;BAC TECHNOLOGIQUE;BAC STMG;BAC STMG GESTION ET FINANCE;1;1;0;1;0;0;0;0;0;0;0;0;0;1
24473.0;2023;14;RENNES;MASCULIN;INDIVIDUEL;BAC TECHNOLOGIQUE;BAC STMG;BAC STMG RESSOURCES HUMAINES ET COMMUNICATION;3;3;0;2;1;0;1;0;0;0;0;0;0;3
24475.0;2023;14;RENNES;MASCULIN;SCOLAIRE;BAC PROFESSIONNEL;BAC PRO PROD;BACPRO 20002 ETUD.DEFINITION PRDTS INDUSTRIEL;14;14;11;3;0;0;0;11;0;0;2;7;2;3
24478.0;2023;14;RENNES;MASCULIN;SCOLAIRE;BAC PROFESSIONNEL;BAC PRO PROD;BAC PRO 22403 ARTS.& MET.ART:MET.ENSEIGN SIGNA;13;13;11;1;1;0;1;11;0;1;4;1;5;2
24493.0;2023;14;RENNES;MASCULIN;SCOLAIRE;BAC PROFESSIONNEL;BAC PRO PROD;BAC PRO 23408 Etude et réalisation d'agencement;7;7;7;0;0;0;0;7;0;0;3;1;3;0
24494.0;2023;14;RENNES;MASCULIN;SCOLAIRE;BAC PROFESSIONNEL;BAC PRO PROD;BAC PRO 24202 ARTIS.& MET.ART : TAPIS.D'AMEUBL;6;6;3;2;1;1;0;4;0;0;0;3;1;2
24499.0;2023;14;RENNES;MASCULIN;SCOLAIRE;BAC PROFESSIONNEL;BAC PRO PROD;BAC PRO 25009 MAINTENANCE NAUTIQUE;44;44;33;11;0;0;0;33;0;0;8;10;15;11
24506.0;2023;14;RENNES;MASCULIN;SCOLAIRE;BAC PROFESSIONNEL;BAC PRO PROD;BAC PRO 25220 MAINT.MATERIELS OPT.B TP MANUT.;10;10;7;2;1;0;1;7;0;0;2;3;2;3
24510.0;2023;14;RENNES;MASCULIN;SCOLAIRE;BAC PROFESSIONNEL;BAC PRO PROD;BAC PRO 25304 AERONAUTIQUE OPTION STRUCTURE;26;26;24;2;0;0;0;24;0;3;4;5;12;2
24513.0;2023;14;RENNES;MASCULIN;SCOLAIRE;BAC PROFESSIONNEL;BAC PRO PROD;BAC PRO 25411 TECH.CHAUDRONNERIE INDUSTRIELLE;111;111;96;13;2;2;0;98;0;4;20;37;37;13
24515.0;2023;14;RENNES;MASCULIN;SCOLAIRE;BAC PROFESSIONNEL;BAC PRO PROD;BAC PRO 25510 METIERS ELECT. ENVIRON. CONNECTES;466;466;391;55;20;15;5;406;0;13;70;167;156;60
24517.0;2023;14;RENNES;MASCULIN;SCOLAIRE;BAC PROFESSIONNEL;BAC PRO PROD;BAC PRO 25514 SYST.NUM.OPT.B AUD.RES.EQUIP.DOM.;137;137;124;9;4;4;0;128;0;8;29;52;39;9
24519.0;2023;14;RENNES;MASCULIN;SCOLAIRE;BAC PROFESSIONNEL;BAC PRO PROD;BAC PRO AG 21001 AGRO-EQUIPEMENT;105;103;90;13;0;0;0;90;0;2;8;32;48;13
24520.0;2023;14;RENNES;MASCULIN;SCOLAIRE;BAC PROFESSIONNEL;BAC PRO PROD;BAC PRO AG 21004 CGEA;281;276;254;22;0;0;0;254;0;2;31;91;130;22
24521.0;2023;14;RENNES;MASCULIN;SCOLAIRE;BAC PROFESSIONNEL;BAC PRO PROD;BAC PRO AG 21114 CONDUITE PRODUCTIONS HORTICOLES;11;8;5;3;0;0;0;5;0;1;0;3;1;3
24522.0;2023;14;RENNES;MASCULIN;SCOLAIRE;BAC PROFESSIONNEL;BAC PRO PROD;BAC PRO AG 21203 TECHN CONSEIL DE VENTE ANIMAL;21;19;18;1;0;0;0;18;0;0;3;4;11;1
24524.0;2023;14;RENNES;MASCULIN;SCOLAIRE;BAC PROFESSIONNEL;BAC PRO PROD;BAC PRO AG 21210 COND GEST ENTR CANIN ET FELIN;13;13;12;1;0;0;0;12;0;0;1;5;6;1
24525.0;2023;14;RENNES;MASCULIN;SCOLAIRE;BAC PROFESSIONNEL;BAC PRO PROD;BAC PRO AG 21211 COND GEST ENTR HIPPIQUE;7;7;6;1;0;0;0;6;0;0;0;2;4;1
24529.0;2023;14;RENNES;MASCULIN;SCOLAIRE;BAC PROFESSIONNEL;BAC PRO PROD;BAC PRO AG 21407 TEC CONS VTE UNIVERS JARDINERIE;7;7;5;2;0;0;0;5;0;0;0;1;4;2
24532.0;2023;14;RENNES;MASCULIN;SCOLAIRE;BAC PROFESSIONNEL;BAC PRO SERV;BAC PRO 30004 ASSISTANC.GEST.ORGANIS.ACTIVITES;179;178;134;36;8;8;0;142;0;5;29;47;61;36
24533.0;2023;14;RENNES;MASCULIN;SCOLAIRE;BAC PROFESSIONNEL;BAC PRO SERV;BAC PRO 31106 LOGISTIQUE;97;97;76;13;8;6;2;82;0;0;15;28;39;15
24539.0;2023;14;RENNES;MASCULIN;SCOLAIRE;BAC PROFESSIONNEL;BAC PRO SERV;BAC PRO 32207 REAL.PR.IMPR.PLURI.OPTA.PR.GRAPH.;16;16;15;1;0;0;0;15;0;0;3;6;6;1
24548.0;2023;14;RENNES;MASCULIN;SCOLAIRE;BAC PROFESSIONNEL;BAC PRO SERV;BAC PRO 34303 GEST. POLLUTIONS PROTEC. ENVIRON.;5;5;5;0;0;0;0;5;0;0;2;0;3;0
24550.0;2023;14;RENNES;MASCULIN;SCOLAIRE;BAC PROFESSIONNEL;BAC PRO SERV;BAC PRO 34403 METIERS DE LA SECURITE;53;53;49;3;1;1;0;50;0;10;16;17;7;3
24559.0;2023;14;RENNES;MASCULIN;SCOLAIRE;BAC TECHNOLOGIQUE;BAC STI2D;BAC STI2D ENERGIES  ET ENVIRONNEMENT;257;257;242;3;12;4;8;246;1;11;56;101;77;11
24570.0;2023;15;STRASBOURG;FEMININ;APPRENTISSAGE;BAC PROFESSIONNEL;BAC PRO PROD;BAC PRO 22105 BOULANGER-PÂTISSIER;1;1;1;0;0;0;0;1;0;0;0;0;1;0
24575.0;2023;15;STRASBOURG;FEMININ;APPRENTISSAGE;BAC PROFESSIONNEL;BAC PRO PROD;BAC PRO 25106 TECHNICIEN D'USINAGE;2;2;2;0;0;0;0;2;0;1;0;1;0;0
24578.0;2023;15;STRASBOURG;FEMININ;APPRENTISSAGE;BAC PROFESSIONNEL;BAC PRO PROD;BAC PRO 25411 TECH.CHAUDRONNERIE INDUSTRIELLE;4;4;4;0;0;0;0;4;0;1;2;1;0;0
24585.0;2023;15;STRASBOURG;FEMININ;APPRENTISSAGE;BAC PROFESSIONNEL;BAC PRO PROD;BAC PRO AG 21407 TEC CONS VTE UNIVERS JARDINERIE;2;2;2;0;0;0;0;2;0;0;1;0;1;0
24588.0;2023;15;STRASBOURG;FEMININ;APPRENTISSAGE;BAC PROFESSIONNEL;BAC PRO SERV;BAC PRO 31212 METIERS DE L'ACCUEIL;6;5;5;0;0;0;0;5;0;1;1;0;3;0
24592.0;2023;15;STRASBOURG;FEMININ;APPRENTISSAGE;BAC PROFESSIONNEL;BAC PRO SERV;BAC PRO 33004 ACC.SOINS-S.PERS. OPT.EN STRUCTUR;1;1;1;0;0;0;0;1;0;0;1;0;0;0
24593.0;2023;15;STRASBOURG;FEMININ;APPRENTISSAGE;BAC PROFESSIONNEL;BAC PRO SERV;BAC PRO 33403 COMMERC. SERVICES EN RESTAURATION;13;13;12;1;0;0;0;12;0;3;2;5;2;1
24596.0;2023;15;STRASBOURG;FEMININ;ENSEIGNEMENT A DISTANCE;BAC PROFESSIONNEL;BAC PRO SERV;BAC PRO 30004 ASSISTANC.GEST.ORGANIS.ACTIVITES;2;1;1;0;0;0;0;1;0;0;0;1;0;0
24599.0;2023;15;STRASBOURG;FEMININ;ENSEIGNEMENT A DISTANCE;BAC TECHNOLOGIQUE;BAC ST2S;BAC ST2S SCIENCES & TECHNO. SANTE & SOCIAL;1;1;1;0;0;0;0;1;0;0;0;0;1;0
24608.0;2023;15;STRASBOURG;FEMININ;FORMATION CONTINUE;BAC PROFESSIONNEL;BAC PRO SERV;BAC PRO 33603 ESTHETIQUE COSMETIQUE PARFUMERIE;1;1;1;0;0;0;0;1;0;0;0;1;0;0
24616.0;2023;15;STRASBOURG;FEMININ;INDIVIDUEL;BAC PROFESSIONNEL;BAC PRO SERV;BAC PRO 31214 MET.COM.VEN.OP.B PR.CL.VA.OF.COM.;2;1;0;1;0;0;0;0;0;0;0;0;0;1
24621.0;2023;15;STRASBOURG;FEMININ;INDIVIDUEL;BAC PROFESSIONNEL;BAC PRO SERV;BAC PRO 34403 METIERS DE LA SECURITE;1;1;0;1;0;0;0;0;0;0;0;0;0;1
24625.0;2023;15;STRASBOURG;FEMININ;INDIVIDUEL;BAC TECHNOLOGIQUE;BAC STMG;BAC STMG MERCATIQUE (MARKETING);10;10;5;3;2;0;2;5;0;0;0;1;4;5
24626.0;2023;15;STRASBOURG;FEMININ;INDIVIDUEL;BAC TECHNOLOGIQUE;BAC STMG;BAC STMG RESSOURCES HUMAINES ET COMMUNICATION;5;5;1;3;1;0;1;1;0;0;0;0;1;4
24630.0;2023;15;STRASBOURG;FEMININ;SCOLAIRE;BAC PROFESSIONNEL;BAC PRO PROD;BAC PRO 22105 BOULANGER-PÂTISSIER;9;9;8;1;0;0;0;8;0;1;2;3;2;1
24632.0;2023;15;STRASBOURG;FEMININ;SCOLAIRE;BAC PROFESSIONNEL;BAC PRO PROD;BAC PRO 22503 PLASTIQUES ET COMPOSITES;3;3;3;0;0;0;0;3;0;0;1;2;0;0
24636.0;2023;15;STRASBOURG;FEMININ;SCOLAIRE;BAC PROFESSIONNEL;BAC PRO PROD;BAC PRO 23404 TECHNICIEN CONSTRUCTEUR BOIS;1;1;1;0;0;0;0;1;0;0;0;0;1;0
24639.0;2023;15;STRASBOURG;FEMININ;SCOLAIRE;BAC PROFESSIONNEL;BAC PRO PROD;BAC PRO 24203 METIERS DE LA MODE - VÊTEMENT;50;50;45;2;3;1;2;46;0;12;14;13;7;4
24642.0;2023;15;STRASBOURG;FEMININ;SCOLAIRE;BAC PROFESSIONNEL;BAC PRO PROD;BAC PRO 25214 MAINT.VEHIC.OPTA VOIT.PARTICUL.;4;4;4;0;0;0;0;4;0;0;3;1;0;0
24643.0;2023;15;STRASBOURG;FEMININ;SCOLAIRE;BAC PROFESSIONNEL;BAC PRO PROD;BAC PRO 25216 MAINT.VEHIC.OPTC MOTOCYCLES;2;2;2;0;0;0;0;2;0;1;0;0;1;0
24646.0;2023;15;STRASBOURG;FEMININ;SCOLAIRE;BAC PROFESSIONNEL;BAC PRO PROD;BAC PRO 25411 TECH.CHAUDRONNERIE INDUSTRIELLE;3;3;3;0;0;0;0;3;0;0;1;2;0;0
24654.0;2023;15;STRASBOURG;FEMININ;SCOLAIRE;BAC PROFESSIONNEL;BAC PRO PROD;BAC PRO AG 22105 LABORATOIRE CONTROLE QUALITE;8;8;7;1;0;0;0;7;0;0;1;3;3;1
24659.0;2023;15;STRASBOURG;FEMININ;SCOLAIRE;BAC PROFESSIONNEL;BAC PRO SERV;BAC PRO 31109 TRANSPORT FLUVIAL;1;1;1;0;0;0;0;1;0;0;0;1;0;0
24660.0;2023;15;STRASBOURG;FEMININ;SCOLAIRE;BAC PROFESSIONNEL;BAC PRO SERV;BAC PRO 31114 ORGANIS. TRANSPORT MARCHANDISES;4;4;3;1;0;0;0;3;0;0;0;2;1;1
24661.0;2023;15;STRASBOURG;FEMININ;SCOLAIRE;BAC PROFESSIONNEL;BAC PRO SERV;BAC PRO 31212 METIERS DE L'ACCUEIL;138;138;114;11;13;9;4;123;0;5;27;40;51;15
24662.0;2023;15;STRASBOURG;FEMININ;SCOLAIRE;BAC PROFESSIONNEL;BAC PRO SERV;BAC PRO 31213 MET.COM.VEN.OP.A ANI.GES.ESP.COM.;386;386;309;45;32;25;7;334;0;14;62;123;135;52
24668.0;2023;15;STRASBOURG;FEMININ;SCOLAIRE;BAC PROFESSIONNEL;BAC PRO SERV;BAC PRO 33006 ANIMAT. ENFANCE& PERSONNES AGEES;100;100;83;11;6;5;1;88;0;8;12;36;32;12
24669.0;2023;15;STRASBOURG;FEMININ;SCOLAIRE;BAC PROFESSIONNEL;BAC PRO SERV;BAC PRO 33101 OPTIQUE LUNETTERIE;4;4;4;0;0;0;0;4;0;1;1;1;1;0
24681.0;2023;15;STRASBOURG;FEMININ;SCOLAIRE;BAC TECHNOLOGIQUE;BAC STI2D;BAC STI2D ARCHITECTURE ET CONSTRUCTION;31;31;27;3;1;1;0;28;0;0;6;12;10;3
24684.0;2023;15;STRASBOURG;FEMININ;SCOLAIRE;BAC TECHNOLOGIQUE;BAC STI2D;BAC STI2D SYSTÈME D'INFORMATION  ET NUMERIQUE;14;14;14;0;0;0;0;14;1;1;2;3;7;0
24687.0;2023;15;STRASBOURG;FEMININ;SCOLAIRE;BAC TECHNOLOGIQUE;BAC STMG;BAC STMG GESTION ET FINANCE;168;168;143;7;18;14;4;157;0;11;24;47;75;11
24696.0;2023;15;STRASBOURG;MASCULIN;APPRENTISSAGE;BAC PROFESSIONNEL;BAC PRO PROD;BAC PRO 22503 PLASTIQUES ET COMPOSITES;1;1;1;0;0;0;0;1;0;0;0;1;0;0
24705.0;2023;15;STRASBOURG;MASCULIN;APPRENTISSAGE;BAC PROFESSIONNEL;BAC PRO PROD;BAC PRO 25007 MAINTENANCE EQUIPEMENTS INDUST.;50;50;39;10;1;0;1;39;0;4;10;10;15;11
24718.0;2023;15;STRASBOURG;MASCULIN;APPRENTISSAGE;BAC PROFESSIONNEL;BAC PRO PROD;BAC PRO 25509 TECHNIC. FROID CONDITIONNEMT AIR;6;6;4;1;1;1;0;5;0;0;1;2;2;1
24721.0;2023;15;STRASBOURG;MASCULIN;APPRENTISSAGE;BAC PROFESSIONNEL;BAC PRO PROD;BAC PRO 25515 SYST.NUM.OPT.C RES.INF.SYST.COMM.;5;5;5;0;0;0;0;5;0;0;3;2;0;0
24726.0;2023;15;STRASBOURG;MASCULIN;APPRENTISSAGE;BAC PROFESSIONNEL;BAC PRO PROD;BAC PRO AG 21203 TECHN CONSEIL DE VENTE ANIMAL;4;4;3;1;0;0;0;3;0;0;0;1;2;1
24727.0;2023;15;STRASBOURG;MASCULIN;APPRENTISSAGE;BAC PROFESSIONNEL;BAC PRO PROD;BAC PRO AG 21211 COND GEST ENTR HIPPIQUE;1;1;1;0;0;0;0;1;0;0;0;0;1;0
24730.0;2023;15;STRASBOURG;MASCULIN;APPRENTISSAGE;BAC PROFESSIONNEL;BAC PRO SERV;BAC PRO 30004 ASSISTANC.GEST.ORGANIS.ACTIVITES;4;4;1;3;0;0;0;1;0;1;0;0;0;3
24737.0;2023;15;STRASBOURG;MASCULIN;APPRENTISSAGE;BAC PROFESSIONNEL;BAC PRO SERV;BAC PRO 33403 COMMERC. SERVICES EN RESTAURATION;9;9;7;1;1;0;1;7;0;0;2;2;3;2
24751.0;2023;15;STRASBOURG;MASCULIN;FORMATION CONTINUE;BAC PROFESSIONNEL;BAC PRO PROD;BAC PRO 25106 TECHNICIEN D'USINAGE;4;4;2;2;0;0;0;2;0;0;1;1;0;2
24755.0;2023;15;STRASBOURG;MASCULIN;FORMATION CONTINUE;BAC PROFESSIONNEL;BAC PRO PROD;BAC PRO 25510 METIERS ELECT. ENVIRON. CONNECTES;8;8;8;0;0;0;0;8;0;1;5;2;0;0
24778.0;2023;15;STRASBOURG;MASCULIN;INDIVIDUEL;BAC TECHNOLOGIQUE;BAC STI2D;BAC STI2D ENERGIES  ET ENVIRONNEMENT;1;1;0;1;0;0;0;0;0;0;0;0;0;1
24785.0;2023;15;STRASBOURG;MASCULIN;SCOLAIRE;BAC PROFESSIONNEL;BAC PRO PROD;BAC PRO 22004 PROC. CHIMIE EAU PAPIERS-CARTONS;13;13;8;5;0;0;0;8;0;2;0;2;4;5
24800.0;2023;15;STRASBOURG;MASCULIN;SCOLAIRE;BAC PROFESSIONNEL;BAC PRO PROD;BAC PRO 24203 METIERS DE LA MODE - VÊTEMENT;9;9;9;0;0;0;0;9;0;1;3;4;1;0
24802.0;2023;15;STRASBOURG;MASCULIN;SCOLAIRE;BAC PROFESSIONNEL;BAC PRO PROD;BAC PRO 25007 MAINTENANCE EQUIPEMENTS INDUST.;196;196;141;46;9;7;2;148;0;4;19;51;74;48
24803.0;2023;15;STRASBOURG;MASCULIN;SCOLAIRE;BAC PROFESSIONNEL;BAC PRO PROD;BAC PRO 25106 TECHNICIEN D'USINAGE;57;57;39;16;2;2;0;41;0;2;7;12;20;16
24814.0;2023;15;STRASBOURG;MASCULIN;SCOLAIRE;BAC PROFESSIONNEL;BAC PRO PROD;BAC PRO 25509 TECHNIC. FROID CONDITIONNEMT AIR;12;12;5;6;1;0;1;5;0;0;0;1;4;7
24818.0;2023;15;STRASBOURG;MASCULIN;SCOLAIRE;BAC PROFESSIONNEL;BAC PRO PROD;BAC PRO 25515 SYST.NUM.OPT.C RES.INF.SYST.COMM.;122;122;103;14;5;4;1;107;0;5;25;44;33;15
24821.0;2023;15;STRASBOURG;MASCULIN;SCOLAIRE;BAC PROFESSIONNEL;BAC PRO PROD;BAC PRO AG 21114 CONDUITE PRODUCTIONS HORTICOLES;4;4;4;0;0;0;0;4;0;0;0;3;1;0
24827.0;2023;15;STRASBOURG;MASCULIN;SCOLAIRE;BAC PROFESSIONNEL;BAC PRO SERV;BAC PRO 30004 ASSISTANC.GEST.ORGANIS.ACTIVITES;130;130;78;44;8;5;3;83;0;1;8;32;42;47
24830.0;2023;15;STRASBOURG;MASCULIN;SCOLAIRE;BAC PROFESSIONNEL;BAC PRO SERV;BAC PRO 31109 TRANSPORT FLUVIAL;8;8;6;1;1;1;0;7;0;3;2;1;1;1
24839.0;2023;15;STRASBOURG;MASCULIN;SCOLAIRE;BAC PROFESSIONNEL;BAC PRO SERV;BAC PRO 33006 ANIMAT. ENFANCE& PERSONNES AGEES;22;22;18;3;1;1;0;19;0;3;5;5;6;3
24841.0;2023;15;STRASBOURG;MASCULIN;SCOLAIRE;BAC PROFESSIONNEL;BAC PRO SERV;BAC PRO 33104 TECHNICIEN EN PROTHESE DENTAIRE;7;7;4;3;0;0;0;4;0;0;2;0;2;3
24842.0;2023;15;STRASBOURG;MASCULIN;SCOLAIRE;BAC PROFESSIONNEL;BAC PRO SERV;BAC PRO 33403 COMMERC. SERVICES EN RESTAURATION;22;22;19;3;0;0;0;19;0;2;8;2;7;3
24854.0;2023;15;STRASBOURG;MASCULIN;SCOLAIRE;BAC TECHNOLOGIQUE;BAC STI2D;BAC STI2D SYSTÈME D'INFORMATION  ET NUMERIQUE;231;231;193;11;27;22;5;215;0;2;32;85;96;16
24858.0;2023;15;STRASBOURG;MASCULIN;SCOLAIRE;BAC TECHNOLOGIQUE;BAC STMG;BAC STMG MERCATIQUE (MARKETING);410;410;282;41;87;59;28;341;0;2;22;99;218;69
24863.0;2023;16;TOULOUSE;FEMININ;APPRENTISSAGE;BAC PROFESSIONNEL;BAC PRO PROD;BAC PRO 22106 CUISINE;5;5;4;1;0;0;0;4;0;0;1;0;3;1
24874.0;2023;16;TOULOUSE;FEMININ;APPRENTISSAGE;BAC PROFESSIONNEL;BAC PRO PROD;BAC PRO 25408 REPARATION DES CARROSSERIES;2;1;1;0;0;0;0;1;0;1;0;0;0;0
24876.0;2023;16;TOULOUSE;FEMININ;APPRENTISSAGE;BAC PROFESSIONNEL;BAC PRO PROD;BAC PRO 25510 METIERS ELECT. ENVIRON. CONNECTES;1;1;1;0;0;0;0;1;0;0;0;1;0;0
24885.0;2023;16;TOULOUSE;FEMININ;APPRENTISSAGE;BAC PROFESSIONNEL;BAC PRO SERV;BAC PRO 32207 REAL.PR.IMPR.PLURI.OPTA.PR.GRAPH.;1;1;1;0;0;0;0;1;0;0;0;0;1;0
24888.0;2023;16;TOULOUSE;FEMININ;APPRENTISSAGE;BAC PROFESSIONNEL;BAC PRO SERV;BAC PRO 33003 ACC.SOINS-S.PERS. OPT.A DOMICILE;1;1;1;0;0;0;0;1;0;0;1;0;0;0
24889.0;2023;16;TOULOUSE;FEMININ;APPRENTISSAGE;BAC PROFESSIONNEL;BAC PRO SERV;BAC PRO 33004 ACC.SOINS-S.PERS. OPT.EN STRUCTUR;14;14;11;1;2;2;0;13;0;2;6;1;4;1
24896.0;2023;16;TOULOUSE;FEMININ;ENSEIGNEMENT A DISTANCE;BAC PROFESSIONNEL;BAC PRO SERV;BAC PRO 30004 ASSISTANC.GEST.ORGANIS.ACTIVITES;4;4;4;0;0;0;0;4;0;0;1;1;2;0
24897.0;2023;16;TOULOUSE;FEMININ;ENSEIGNEMENT A DISTANCE;BAC PROFESSIONNEL;BAC PRO SERV;BAC PRO 31213 MET.COM.VEN.OP.A ANI.GES.ESP.COM.;5;4;3;1;0;0;0;3;0;0;1;0;2;1
24898.0;2023;16;TOULOUSE;FEMININ;ENSEIGNEMENT A DISTANCE;BAC PROFESSIONNEL;BAC PRO SERV;BAC PRO 31214 MET.COM.VEN.OP.B PR.CL.VA.OF.COM.;1;1;1;0;0;0;0;1;0;0;0;1;0;0
24900.0;2023;16;TOULOUSE;FEMININ;ENSEIGNEMENT A DISTANCE;BAC PROFESSIONNEL;BAC PRO SERV;BAC PRO 33603 ESTHETIQUE COSMETIQUE PARFUMERIE;1;1;1;0;0;0;0;1;0;0;0;1;0;0
24908.0;2023;16;TOULOUSE;FEMININ;FORMATION CONTINUE;BAC PROFESSIONNEL;BAC PRO PROD;BAC PRO 25106 TECHNICIEN D'USINAGE;2;2;2;0;0;0;0;2;0;1;1;0;0;0
24909.0;2023;16;TOULOUSE;FEMININ;FORMATION CONTINUE;BAC PROFESSIONNEL;BAC PRO PROD;BAC PRO AG 21004 CGEA;4;4;1;3;0;0;0;1;0;0;0;1;0;3
24916.0;2023;16;TOULOUSE;FEMININ;INDIVIDUEL;BAC PROFESSIONNEL;BAC PRO PROD;BAC PRO AG 21113 CGEVV;1;1;1;0;0;0;0;1;0;0;0;0;1;0
24921.0;2023;16;TOULOUSE;FEMININ;INDIVIDUEL;BAC PROFESSIONNEL;BAC PRO SERV;BAC PRO 31212 METIERS DE L'ACCUEIL;3;0;0;0;0;0;0;0;0;0;0;0;0;0
24927.0;2023;16;TOULOUSE;FEMININ;INDIVIDUEL;BAC PROFESSIONNEL;BAC PRO SERV;BAC PRO 33603 ESTHETIQUE COSMETIQUE PARFUMERIE;3;3;1;1;1;1;0;2;0;0;0;0;2;1
24929.0;2023;16;TOULOUSE;FEMININ;INDIVIDUEL;BAC TECHNOLOGIQUE;BAC ST2S;BAC ST2S SCIENCES & TECHNO. SANTE & SOCIAL;14;14;4;9;1;1;0;5;0;0;0;1;4;9
24933.0;2023;16;TOULOUSE;FEMININ;SCOLAIRE;BAC GENERAL;BAC GENERAL;BAC GENE 10019 BAC GENERAL;9161;9161;8678;87;396;282;114;8960;225;1298;2400;2902;2135;201
24936.0;2023;16;TOULOUSE;FEMININ;SCOLAIRE;BAC PROFESSIONNEL;BAC PRO PROD;BAC PRO 22003 BIO-INDUSTRIES DE TRANSFORMATION;19;19;15;2;2;1;1;16;0;0;1;7;8;3
24949.0;2023;16;TOULOUSE;FEMININ;SCOLAIRE;BAC PROFESSIONNEL;BAC PRO PROD;BAC PRO 23408 Etude et réalisation d'agencement;12;12;10;2;0;0;0;10;0;0;6;3;1;2
24953.0;2023;16;TOULOUSE;FEMININ;SCOLAIRE;BAC PROFESSIONNEL;BAC PRO PROD;BAC PRO 25006 MICROTECHNIQUES;1;1;1;0;0;0;0;1;0;0;0;1;0;0
24957.0;2023;16;TOULOUSE;FEMININ;SCOLAIRE;BAC PROFESSIONNEL;BAC PRO PROD;BAC PRO 25214 MAINT.VEHIC.OPTA VOIT.PARTICUL.;10;10;8;1;1;1;0;9;0;0;1;5;3;1
24962.0;2023;16;TOULOUSE;FEMININ;SCOLAIRE;BAC PROFESSIONNEL;BAC PRO PROD;BAC PRO 25303 AERONAUTIQUE OPTION SYSTEMES;5;5;5;0;0;0;0;5;0;1;2;2;0;0
24963.0;2023;16;TOULOUSE;FEMININ;SCOLAIRE;BAC PROFESSIONNEL;BAC PRO PROD;BAC PRO 25304 AERONAUTIQUE OPTION STRUCTURE;5;5;3;0;2;1;1;4;0;0;2;1;1;1
24964.0;2023;16;TOULOUSE;FEMININ;SCOLAIRE;BAC PROFESSIONNEL;BAC PRO PROD;BAC PRO 25408 REPARATION DES CARROSSERIES;3;3;2;1;0;0;0;2;0;0;0;1;1;1
24965.0;2023;16;TOULOUSE;FEMININ;SCOLAIRE;BAC PROFESSIONNEL;BAC PRO PROD;BAC PRO 25411 TECH.CHAUDRONNERIE INDUSTRIELLE;4;4;4;0;0;0;0;4;0;1;1;1;1;0
24966.0;2023;16;TOULOUSE;FEMININ;SCOLAIRE;BAC PROFESSIONNEL;BAC PRO PROD;BAC PRO 25510 METIERS ELECT. ENVIRON. CONNECTES;7;7;6;1;0;0;0;6;0;0;1;2;3;1
24968.0;2023;16;TOULOUSE;FEMININ;SCOLAIRE;BAC PROFESSIONNEL;BAC PRO PROD;BAC PRO 25515 SYST.NUM.OPT.C RES.INF.SYST.COMM.;5;5;1;3;1;1;0;2;0;0;0;1;1;3
24969.0;2023;16;TOULOUSE;FEMININ;SCOLAIRE;BAC PROFESSIONNEL;BAC PRO PROD;BAC PRO AG 21004 CGEA;106;102;81;21;0;0;0;81;0;5;10;25;41;21
24971.0;2023;16;TOULOUSE;FEMININ;SCOLAIRE;BAC PROFESSIONNEL;BAC PRO PROD;BAC PRO AG 21114 CONDUITE PRODUCTIONS HORTICOLES;19;19;16;3;0;0;0;16;0;1;1;6;8;3
24978.0;2023;16;TOULOUSE;FEMININ;SCOLAIRE;BAC PROFESSIONNEL;BAC PRO PROD;BAC PRO AG 22105 LABORATOIRE CONTROLE QUALITE;10;10;10;0;0;0;0;10;0;0;2;7;1;0
24983.0;2023;16;TOULOUSE;FEMININ;SCOLAIRE;BAC PROFESSIONNEL;BAC PRO SERV;BAC PRO 31114 ORGANIS. TRANSPORT MARCHANDISES;8;8;3;5;0;0;0;3;0;0;1;2;0;5
24986.0;2023;16;TOULOUSE;FEMININ;SCOLAIRE;BAC PROFESSIONNEL;BAC PRO SERV;BAC PRO 31214 MET.COM.VEN.OP.B PR.CL.VA.OF.COM.;156;156;129;20;7;6;1;135;0;8;32;56;39;21
24988.0;2023;16;TOULOUSE;FEMININ;SCOLAIRE;BAC PROFESSIONNEL;BAC PRO SERV;BAC PRO 32208 REAL.PR.IMPR.PLURI.OPTB.PR.IMPR.;1;1;1;0;0;0;0;1;0;0;1;0;0;0
25002.0;2023;16;TOULOUSE;FEMININ;SCOLAIRE;BAC PROFESSIONNEL;BAC PRO SERV;BAC PRO 34403 METIERS DE LA SECURITE;29;28;23;5;0;0;0;23;0;2;3;10;8;5
25003.0;2023;16;TOULOUSE;FEMININ;SCOLAIRE;BAC PROFESSIONNEL;BAC PRO SERV;BAC PRO AG 33002 SERV PERS TERRIT;294;291;269;22;0;0;0;269;0;3;33;92;141;22
25012.0;2023;16;TOULOUSE;FEMININ;SCOLAIRE;BAC TECHNOLOGIQUE;BAC STI2D;BAC STI2D ENERGIES  ET ENVIRONNEMENT;15;15;14;0;1;0;1;14;0;1;4;4;5;1
25023.0;2023;16;TOULOUSE;MASCULIN;APPRENTISSAGE;BAC PROFESSIONNEL;BAC PRO PROD;BAC PRO 22104 BOUCHER CHARCUTIER TRAITEUR;3;3;3;0;0;0;0;3;0;0;1;0;2;0
25024.0;2023;16;TOULOUSE;MASCULIN;APPRENTISSAGE;BAC PROFESSIONNEL;BAC PRO PROD;BAC PRO 22105 BOULANGER-PÂTISSIER;3;3;2;1;0;0;0;2;0;0;0;2;0;1
25029.0;2023;16;TOULOUSE;MASCULIN;APPRENTISSAGE;BAC PROFESSIONNEL;BAC PRO PROD;BAC PRO 23004 TECHN. ETUDES BAT.A ETUDES & ECO.;2;2;0;2;0;0;0;0;0;0;0;0;0;2
25034.0;2023;16;TOULOUSE;MASCULIN;APPRENTISSAGE;BAC PROFESSIONNEL;BAC PRO PROD;BAC PRO 23205 INTERV. SUR PATRIMOINE BATI OPT.A;3;3;3;0;0;0;0;3;0;0;0;2;1;0
25037.0;2023;16;TOULOUSE;MASCULIN;APPRENTISSAGE;BAC PROFESSIONNEL;BAC PRO PROD;BAC PRO 23304 AMENAGEMENT FINITION BATIMENT;8;8;6;2;0;0;0;6;0;1;0;3;2;2
25054.0;2023;16;TOULOUSE;MASCULIN;APPRENTISSAGE;BAC PROFESSIONNEL;BAC PRO PROD;BAC PRO 25406 OUVRAGES DU BATIMENT METALLERIE;11;11;6;5;0;0;0;6;0;1;1;0;4;5
25061.0;2023;16;TOULOUSE;MASCULIN;APPRENTISSAGE;BAC PROFESSIONNEL;BAC PRO PROD;BAC PRO AG 21405 AMENAGEMENTS PAYSAGERS;22;20;20;0;0;0;0;20;0;0;2;11;7;0
25067.0;2023;16;TOULOUSE;MASCULIN;APPRENTISSAGE;BAC PROFESSIONNEL;BAC PRO SERV;BAC PRO 31214 MET.COM.VEN.OP.B PR.CL.VA.OF.COM.;11;11;10;1;0;0;0;10;0;0;3;2;5;1
25070.0;2023;16;TOULOUSE;MASCULIN;APPRENTISSAGE;BAC PROFESSIONNEL;BAC PRO SERV;BAC PRO 32303 ART.& MET.ART:COM.VIS.VIS.PLURI-M;2;2;2;0;0;0;0;2;0;1;1;0;0;0
25074.0;2023;16;TOULOUSE;MASCULIN;APPRENTISSAGE;BAC PROFESSIONNEL;BAC PRO SERV;BAC PRO 34304 HYGIENE PROPRETE STERILISATION;8;8;5;3;0;0;0;5;0;1;2;0;2;3
25080.0;2023;16;TOULOUSE;MASCULIN;ENSEIGNEMENT A DISTANCE;BAC PROFESSIONNEL;BAC PRO SERV;BAC PRO 33403 COMMERC. SERVICES EN RESTAURATION;1;0;0;0;0;0;0;0;0;0;0;0;0;0
25081.0;2023;16;TOULOUSE;MASCULIN;ENSEIGNEMENT A DISTANCE;BAC TECHNOLOGIQUE;BAC ST2S;BAC ST2S SCIENCES & TECHNO. SANTE & SOCIAL;1;1;1;0;0;0;0;1;0;0;0;0;1;0
25087.0;2023;16;TOULOUSE;MASCULIN;FORMATION CONTINUE;BAC PROFESSIONNEL;BAC PRO PROD;BAC PRO 23005 TECHN. ETUDES BAT B ASSIST.ARCHI.;4;3;1;2;0;0;0;1;0;0;0;0;1;2
25089.0;2023;16;TOULOUSE;MASCULIN;FORMATION CONTINUE;BAC PROFESSIONNEL;BAC PRO PROD;BAC PRO 25106 TECHNICIEN D'USINAGE;1;1;1;0;0;0;0;1;0;0;1;0;0;0
25091.0;2023;16;TOULOUSE;MASCULIN;FORMATION CONTINUE;BAC PROFESSIONNEL;BAC PRO PROD;BAC PRO 25215 MAINT.VEHIC.OPTB VEHIC.TRANS.ROUT;1;1;1;0;0;0;0;1;0;1;0;0;0;0
25092.0;2023;16;TOULOUSE;MASCULIN;FORMATION CONTINUE;BAC PROFESSIONNEL;BAC PRO PROD;BAC PRO 25219 MAINT.MATERIELS OPT.A AGRICOLES;1;1;1;0;0;0;0;1;0;1;0;0;0;0
25097.0;2023;16;TOULOUSE;MASCULIN;INDIVIDUEL;BAC PROFESSIONNEL;BAC PRO PROD;BAC PRO 22004 PROC. CHIMIE EAU PAPIERS-CARTONS;1;1;0;1;0;0;0;0;0;0;0;0;0;1
25102.0;2023;16;TOULOUSE;MASCULIN;INDIVIDUEL;BAC PROFESSIONNEL;BAC PRO PROD;BAC PRO 25214 MAINT.VEHIC.OPTA VOIT.PARTICUL.;5;4;4;0;0;0;0;4;0;0;1;1;2;0
25104.0;2023;16;TOULOUSE;MASCULIN;INDIVIDUEL;BAC PROFESSIONNEL;BAC PRO PROD;BAC PRO 25216 MAINT.VEHIC.OPTC MOTOCYCLES;2;1;1;0;0;0;0;1;0;0;0;1;0;0
25111.0;2023;16;TOULOUSE;MASCULIN;INDIVIDUEL;BAC PROFESSIONNEL;BAC PRO PROD;BAC PRO AG 21004 CGEA;1;1;1;0;0;0;0;1;0;0;0;0;1;0
25118.0;2023;16;TOULOUSE;MASCULIN;INDIVIDUEL;BAC PROFESSIONNEL;BAC PRO SERV;BAC PRO 31212 METIERS DE L'ACCUEIL;3;0;0;0;0;0;0;0;0;0;0;0;0;0
25120.0;2023;16;TOULOUSE;MASCULIN;INDIVIDUEL;BAC PROFESSIONNEL;BAC PRO SERV;BAC PRO 31214 MET.COM.VEN.OP.B PR.CL.VA.OF.COM.;1;0;0;0;0;0;0;0;0;0;0;0;0;0
25121.0;2023;16;TOULOUSE;MASCULIN;INDIVIDUEL;BAC TECHNOLOGIQUE;BAC ST2S;BAC ST2S SCIENCES & TECHNO. SANTE & SOCIAL;4;4;0;1;3;1;2;1;0;0;0;0;1;3
25127.0;2023;16;TOULOUSE;MASCULIN;INDIVIDUEL;BAC TECHNOLOGIQUE;BAC STMG;BAC STMG RESSOURCES HUMAINES ET COMMUNICATION;7;7;0;6;1;1;0;1;0;0;0;0;1;6
25134.0;2023;16;TOULOUSE;MASCULIN;SCOLAIRE;BAC PROFESSIONNEL;BAC PRO PROD;BAC PRO 22105 BOULANGER-PÂTISSIER;37;37;34;3;0;0;0;34;0;2;8;19;5;3
25138.0;2023;16;TOULOUSE;MASCULIN;SCOLAIRE;BAC PROFESSIONNEL;BAC PRO PROD;BAC PRO 22703 TECHN.INSTALL.SYST.ENERG.CLIMATI;88;86;61;16;9;6;3;67;0;3;10;21;33;19
25147.0;2023;16;TOULOUSE;MASCULIN;SCOLAIRE;BAC PROFESSIONNEL;BAC PRO PROD;BAC PRO 23303 MENUISERIE ALUMINIUM-VERRE;8;8;6;2;0;0;0;6;0;0;1;2;3;2
25150.0;2023;16;TOULOUSE;MASCULIN;SCOLAIRE;BAC PROFESSIONNEL;BAC PRO PROD;BAC PRO 23405 TECHNICIEN MENUISIER AGENCEUR;36;36;30;5;1;1;0;31;0;1;7;15;8;5
25152.0;2023;16;TOULOUSE;MASCULIN;SCOLAIRE;BAC PROFESSIONNEL;BAC PRO PROD;BAC PRO 23407 TECHNIC.FAB.BOIS ET MATERX ASSOC;16;16;15;0;1;1;0;16;0;2;6;6;2;0
25155.0;2023;16;TOULOUSE;MASCULIN;SCOLAIRE;BAC PROFESSIONNEL;BAC PRO PROD;BAC PRO 24203 METIERS DE LA MODE - VÊTEMENT;4;4;4;0;0;0;0;4;0;1;3;0;0;0
25156.0;2023;16;TOULOUSE;MASCULIN;SCOLAIRE;BAC PROFESSIONNEL;BAC PRO PROD;BAC PRO 24302 METIERS DU CUIR : MAROQUINERIE;4;4;4;0;0;0;0;4;0;1;1;0;2;0
25159.0;2023;16;TOULOUSE;MASCULIN;SCOLAIRE;BAC PROFESSIONNEL;BAC PRO PROD;BAC PRO 25106 TECHNICIEN D'USINAGE;137;137;103;32;2;2;0;105;0;8;23;35;39;32
25166.0;2023;16;TOULOUSE;MASCULIN;SCOLAIRE;BAC PROFESSIONNEL;BAC PRO PROD;BAC PRO 25220 MAINT.MATERIELS OPT.B TP MANUT.;26;26;20;4;2;1;1;21;0;1;5;6;9;5
25177.0;2023;16;TOULOUSE;MASCULIN;SCOLAIRE;BAC PROFESSIONNEL;BAC PRO PROD;BAC PRO 25514 SYST.NUM.OPT.B AUD.RES.EQUIP.DOM.;69;69;63;2;4;3;1;66;0;0;8;35;23;3
25180.0;2023;16;TOULOUSE;MASCULIN;SCOLAIRE;BAC PROFESSIONNEL;BAC PRO PROD;BAC PRO AG 21004 CGEA;183;180;158;22;0;0;0;158;0;3;25;57;73;22
25183.0;2023;16;TOULOUSE;MASCULIN;SCOLAIRE;BAC PROFESSIONNEL;BAC PRO PROD;BAC PRO AG 21203 TECHN CONSEIL DE VENTE ANIMAL;27;26;25;1;0;0;0;25;0;0;3;11;11;1
25187.0;2023;16;TOULOUSE;MASCULIN;SCOLAIRE;BAC PROFESSIONNEL;BAC PRO PROD;BAC PRO AG 21303 FORET;24;23;23;0;0;0;0;23;0;0;1;10;12;0
25192.0;2023;16;TOULOUSE;MASCULIN;SCOLAIRE;BAC PROFESSIONNEL;BAC PRO SERV;BAC PRO 30004 ASSISTANC.GEST.ORGANIS.ACTIVITES;232;232;181;39;12;9;3;190;0;5;26;77;82;42
25226.0;2023;16;TOULOUSE;MASCULIN;SCOLAIRE;BAC TECHNOLOGIQUE;BAC STL;BAC STL BIOCHIM.-BIOLOGIE-BIOTECHNOL.;56;56;51;1;4;1;3;52;1;2;11;15;23;4
25227.0;2023;16;TOULOUSE;MASCULIN;SCOLAIRE;BAC TECHNOLOGIQUE;BAC STL;BAC STL SCIENCES PHYSIQUES CHIMIQUES  EN LABORAT.;75;75;71;1;3;3;0;74;0;2;18;28;26;1
25235.0;2023;25;VERSAILLES;FEMININ;APPRENTISSAGE;BAC PROFESSIONNEL;BAC PRO PROD;BAC PRO 25214 MAINT.VEHIC.OPTA VOIT.PARTICUL.;8;8;5;3;0;0;0;5;0;2;2;1;0;3
25236.0;2023;25;VERSAILLES;FEMININ;APPRENTISSAGE;BAC PROFESSIONNEL;BAC PRO PROD;BAC PRO 25215 MAINT.VEHIC.OPTB VEHIC.TRANS.ROUT;1;1;1;0;0;0;0;1;0;0;0;0;1;0
25240.0;2023;25;VERSAILLES;FEMININ;APPRENTISSAGE;BAC PROFESSIONNEL;BAC PRO PROD;BAC PRO 25408 REPARATION DES CARROSSERIES;4;4;3;1;0;0;0;3;0;3;0;0;0;1
25245.0;2023;25;VERSAILLES;FEMININ;APPRENTISSAGE;BAC PROFESSIONNEL;BAC PRO PROD;BAC PRO AG 21405 AMENAGEMENTS PAYSAGERS;9;8;8;0;0;0;0;8;0;0;1;2;5;0
25246.0;2023;25;VERSAILLES;FEMININ;APPRENTISSAGE;BAC PROFESSIONNEL;BAC PRO SERV;BAC PRO 30004 ASSISTANC.GEST.ORGANIS.ACTIVITES;26;26;17;8;1;1;0;18;0;0;4;7;7;8
25248.0;2023;25;VERSAILLES;FEMININ;APPRENTISSAGE;BAC PROFESSIONNEL;BAC PRO SERV;BAC PRO 31109 TRANSPORT FLUVIAL;4;4;4;0;0;0;0;4;0;1;2;1;0;0
25253.0;2023;25;VERSAILLES;FEMININ;APPRENTISSAGE;BAC PROFESSIONNEL;BAC PRO SERV;BAC PRO 33104 TECHNICIEN EN PROTHESE DENTAIRE;2;2;2;0;0;0;0;2;0;1;0;1;0;0
25266.0;2023;25;VERSAILLES;FEMININ;ENSEIGNEMENT A DISTANCE;BAC TECHNOLOGIQUE;BAC ST2S;BAC ST2S SCIENCES & TECHNO. SANTE & SOCIAL;16;16;8;3;5;2;3;10;0;0;0;5;5;6
25273.0;2023;25;VERSAILLES;FEMININ;FORMATION CONTINUE;BAC PROFESSIONNEL;BAC PRO SERV;BAC PRO 31212 METIERS DE L'ACCUEIL;4;4;4;0;0;0;0;4;0;1;0;3;0;0
25282.0;2023;25;VERSAILLES;FEMININ;INDIVIDUEL;BAC PROFESSIONNEL;BAC PRO PROD;BAC PRO AG 21004 CGEA;5;5;4;1;0;0;0;4;0;0;0;0;4;1
25284.0;2023;25;VERSAILLES;FEMININ;INDIVIDUEL;BAC PROFESSIONNEL;BAC PRO PROD;BAC PRO AG 21114 CONDUITE PRODUCTIONS HORTICOLES;3;3;3;0;0;0;0;3;0;0;0;0;3;0
25288.0;2023;25;VERSAILLES;FEMININ;INDIVIDUEL;BAC PROFESSIONNEL;BAC PRO SERV;BAC PRO 31213 MET.COM.VEN.OP.A ANI.GES.ESP.COM.;5;1;1;0;0;0;0;1;0;0;0;0;1;0
25289.0;2023;25;VERSAILLES;FEMININ;INDIVIDUEL;BAC PROFESSIONNEL;BAC PRO SERV;BAC PRO 33002 SERVICES DE PROXIMITE  VIE LOCAL;4;3;1;2;0;0;0;1;0;0;0;0;1;2
25291.0;2023;25;VERSAILLES;FEMININ;INDIVIDUEL;BAC PROFESSIONNEL;BAC PRO SERV;BAC PRO 33004 ACC.SOINS-S.PERS. OPT.EN STRUCTUR;16;10;4;5;1;1;0;5;0;0;0;0;5;5
25292.0;2023;25;VERSAILLES;FEMININ;INDIVIDUEL;BAC PROFESSIONNEL;BAC PRO SERV;BAC PRO 33603 ESTHETIQUE COSMETIQUE PARFUMERIE;1;1;0;1;0;0;0;0;0;0;0;0;0;1
25294.0;2023;25;VERSAILLES;FEMININ;INDIVIDUEL;BAC TECHNOLOGIQUE;BAC STD2A;BAC STD2A SCIENCES & TECHNO. DESIGN-ARTS APPLIQUES;8;8;6;0;2;2;0;8;0;0;1;2;5;0
25305.0;2023;25;VERSAILLES;FEMININ;SCOLAIRE;BAC PROFESSIONNEL;BAC PRO PROD;BAC PRO 22105 BOULANGER-PÂTISSIER;46;46;38;5;3;2;1;40;0;3;12;12;13;6
25306.0;2023;25;VERSAILLES;FEMININ;SCOLAIRE;BAC PROFESSIONNEL;BAC PRO PROD;BAC PRO 22106 CUISINE;72;72;57;12;3;3;0;60;0;11;8;16;25;12
25307.0;2023;25;VERSAILLES;FEMININ;SCOLAIRE;BAC PROFESSIONNEL;BAC PRO PROD;BAC PRO 23003 ARTIS. & M.ART:MARCHANDISAGE VIS.;52;52;50;2;0;0;0;50;0;2;19;15;14;2
25316.0;2023;25;VERSAILLES;FEMININ;SCOLAIRE;BAC PROFESSIONNEL;BAC PRO PROD;BAC PRO 24202 ARTIS.& MET.ART : TAPIS.D'AMEUBL;8;8;6;2;0;0;0;6;0;2;1;0;3;2
25317.0;2023;25;VERSAILLES;FEMININ;SCOLAIRE;BAC PROFESSIONNEL;BAC PRO PROD;BAC PRO 24203 METIERS DE LA MODE - VÊTEMENT;120;120;95;21;4;4;0;99;0;8;19;26;46;21
25322.0;2023;25;VERSAILLES;FEMININ;SCOLAIRE;BAC PROFESSIONNEL;BAC PRO PROD;BAC PRO 25106 TECHNICIEN D'USINAGE;1;1;1;0;0;0;0;1;0;0;0;1;0;0
25330.0;2023;25;VERSAILLES;FEMININ;SCOLAIRE;BAC PROFESSIONNEL;BAC PRO PROD;BAC PRO 25514 SYST.NUM.OPT.B AUD.RES.EQUIP.DOM.;3;3;1;2;0;0;0;1;0;0;0;1;0;2
25332.0;2023;25;VERSAILLES;FEMININ;SCOLAIRE;BAC PROFESSIONNEL;BAC PRO PROD;BAC PRO AG 21004 CGEA;12;12;12;0;0;0;0;12;0;0;2;3;7;0
25342.0;2023;25;VERSAILLES;FEMININ;SCOLAIRE;BAC PROFESSIONNEL;BAC PRO SERV;BAC PRO 31212 METIERS DE L'ACCUEIL;434;434;338;72;24;20;4;358;0;25;70;116;147;76
25352.0;2023;25;VERSAILLES;FEMININ;SCOLAIRE;BAC PROFESSIONNEL;BAC PRO SERV;BAC PRO 33004 ACC.SOINS-S.PERS. OPT.EN STRUCTUR;1072;1072;869;125;78;63;15;932;0;30;180;352;370;140
25358.0;2023;25;VERSAILLES;FEMININ;SCOLAIRE;BAC PROFESSIONNEL;BAC PRO SERV;BAC PRO 34304 HYGIENE PROPRETE STERILISATION;21;21;15;1;5;1;4;16;0;0;2;7;7;5
25362.0;2023;25;VERSAILLES;FEMININ;SCOLAIRE;BAC TECHNOLOGIQUE;BAC S2TMD;BAC S2TMD MUSIQUE;6;6;6;0;0;0;0;6;1;2;3;0;0;0
25370.0;2023;25;VERSAILLES;FEMININ;SCOLAIRE;BAC TECHNOLOGIQUE;BAC STI2D;BAC STI2D SYSTÈME D'INFORMATION  ET NUMERIQUE;61;61;50;3;8;4;4;54;0;5;9;14;26;7
25383.0;2023;25;VERSAILLES;MASCULIN;APPRENTISSAGE;BAC PROFESSIONNEL;BAC PRO PROD;BAC PRO 23205 INTERV. SUR PATRIMOINE BATI OPT.A;1;1;0;1;0;0;0;0;0;0;0;0;0;1
25387.0;2023;25;VERSAILLES;MASCULIN;APPRENTISSAGE;BAC PROFESSIONNEL;BAC PRO PROD;BAC PRO 25007 MAINTENANCE EQUIPEMENTS INDUST.;31;31;26;4;1;1;0;27;0;5;6;8;8;4
25389.0;2023;25;VERSAILLES;MASCULIN;APPRENTISSAGE;BAC PROFESSIONNEL;BAC PRO PROD;BAC PRO 25214 MAINT.VEHIC.OPTA VOIT.PARTICUL.;256;256;200;35;21;13;8;213;0;24;45;80;64;43
25391.0;2023;25;VERSAILLES;MASCULIN;APPRENTISSAGE;BAC PROFESSIONNEL;BAC PRO PROD;BAC PRO 25216 MAINT.VEHIC.OPTC MOTOCYCLES;31;31;28;2;1;0;1;28;0;5;7;10;6;3
25393.0;2023;25;VERSAILLES;MASCULIN;APPRENTISSAGE;BAC PROFESSIONNEL;BAC PRO PROD;BAC PRO 25220 MAINT.MATERIELS OPT.B TP MANUT.;20;20;14;2;4;2;2;16;0;0;1;7;8;4
25396.0;2023;25;VERSAILLES;MASCULIN;APPRENTISSAGE;BAC PROFESSIONNEL;BAC PRO PROD;BAC PRO 25304 AERONAUTIQUE OPTION STRUCTURE;10;10;9;1;0;0;0;9;0;1;5;3;0;1
25399.0;2023;25;VERSAILLES;MASCULIN;APPRENTISSAGE;BAC PROFESSIONNEL;BAC PRO PROD;BAC PRO 25411 TECH.CHAUDRONNERIE INDUSTRIELLE;41;41;34;4;3;2;1;36;0;9;8;12;7;5
25401.0;2023;25;VERSAILLES;MASCULIN;APPRENTISSAGE;BAC PROFESSIONNEL;BAC PRO PROD;BAC PRO 25510 METIERS ELECT. ENVIRON. CONNECTES;199;199;132;47;20;8;12;140;0;8;23;37;72;59
25408.0;2023;25;VERSAILLES;MASCULIN;APPRENTISSAGE;BAC PROFESSIONNEL;BAC PRO SERV;BAC PRO 30004 ASSISTANC.GEST.ORGANIS.ACTIVITES;7;7;7;0;0;0;0;7;0;0;1;1;5;0
25417.0;2023;25;VERSAILLES;MASCULIN;APPRENTISSAGE;BAC PROFESSIONNEL;BAC PRO SERV;BAC PRO 33104 TECHNICIEN EN PROTHESE DENTAIRE;6;6;5;1;0;0;0;5;0;0;2;2;1;1
25418.0;2023;25;VERSAILLES;MASCULIN;APPRENTISSAGE;BAC PROFESSIONNEL;BAC PRO SERV;BAC PRO 33403 COMMERC. SERVICES EN RESTAURATION;35;35;21;11;3;2;1;23;0;1;11;8;3;12
25425.0;2023;25;VERSAILLES;MASCULIN;ENSEIGNEMENT A DISTANCE;BAC PROFESSIONNEL;BAC PRO SERV;BAC PRO 31214 MET.COM.VEN.OP.B PR.CL.VA.OF.COM.;6;3;1;1;1;1;0;2;0;0;0;1;1;1
25432.0;2023;25;VERSAILLES;MASCULIN;FORMATION CONTINUE;BAC PROFESSIONNEL;BAC PRO PROD;BAC PRO 20102 PILOTE DE LIGNE DE PRODUCTION;9;9;8;1;0;0;0;8;0;0;2;5;1;1
25445.0;2023;25;VERSAILLES;MASCULIN;FORMATION CONTINUE;BAC PROFESSIONNEL;BAC PRO SERV;BAC PRO 32303 ART.& MET.ART:COM.VIS.VIS.PLURI-M;4;4;3;1;0;0;0;3;0;0;2;1;0;1
25453.0;2023;25;VERSAILLES;MASCULIN;INDIVIDUEL;BAC PROFESSIONNEL;BAC PRO PROD;BAC PRO 25006 MICROTECHNIQUES;3;3;2;1;0;0;0;2;0;0;0;1;1;1
25455.0;2023;25;VERSAILLES;MASCULIN;INDIVIDUEL;BAC PROFESSIONNEL;BAC PRO PROD;BAC PRO 25106 TECHNICIEN D'USINAGE;2;1;0;1;0;0;0;0;0;0;0;0;0;1
25459.0;2023;25;VERSAILLES;MASCULIN;INDIVIDUEL;BAC PROFESSIONNEL;BAC PRO PROD;BAC PRO 25302 AERONAUTIQUE OPTION AVIONIQUE;2;1;0;1;0;0;0;0;0;0;0;0;0;1
25461.0;2023;25;VERSAILLES;MASCULIN;INDIVIDUEL;BAC PROFESSIONNEL;BAC PRO PROD;BAC PRO 25509 TECHNIC. FROID CONDITIONNEMT AIR;1;0;0;0;0;0;0;0;0;0;0;0;0;0
25469.0;2023;25;VERSAILLES;MASCULIN;INDIVIDUEL;BAC PROFESSIONNEL;BAC PRO SERV;BAC PRO 30004 ASSISTANC.GEST.ORGANIS.ACTIVITES;40;15;2;10;3;3;0;5;0;0;0;0;5;10
25472.0;2023;25;VERSAILLES;MASCULIN;INDIVIDUEL;BAC PROFESSIONNEL;BAC PRO SERV;BAC PRO 31114 ORGANIS. TRANSPORT MARCHANDISES;1;0;0;0;0;0;0;0;0;0;0;0;0;0
25474.0;2023;25;VERSAILLES;MASCULIN;INDIVIDUEL;BAC PROFESSIONNEL;BAC PRO SERV;BAC PRO 31213 MET.COM.VEN.OP.A ANI.GES.ESP.COM.;22;9;4;4;1;0;1;4;0;0;0;1;3;5
25483.0;2023;25;VERSAILLES;MASCULIN;INDIVIDUEL;BAC PROFESSIONNEL;BAC PRO SERV;BAC PRO 34403 METIERS DE LA SECURITE;2;2;2;0;0;0;0;2;0;0;0;0;2;0
25484.0;2023;25;VERSAILLES;MASCULIN;INDIVIDUEL;BAC TECHNOLOGIQUE;BAC ST2S;BAC ST2S SCIENCES & TECHNO. SANTE & SOCIAL;8;8;1;6;1;0;1;1;0;0;0;0;1;7
25487.0;2023;25;VERSAILLES;MASCULIN;INDIVIDUEL;BAC TECHNOLOGIQUE;BAC STI2D;BAC STI2D ENERGIES  ET ENVIRONNEMENT;8;8;0;5;3;0;3;0;0;0;0;0;0;8
25488.0;2023;25;VERSAILLES;MASCULIN;INDIVIDUEL;BAC TECHNOLOGIQUE;BAC STI2D;BAC STI2D INNOVATION TECHNO.  ET ECO CONCEPTION;6;6;0;6;0;0;0;0;0;0;0;0;0;6
25494.0;2023;25;VERSAILLES;MASCULIN;INDIVIDUEL;BAC TECHNOLOGIQUE;BAC STMG;BAC STMG SYSTEMES D'INFORMATION DE GESTION;5;5;1;3;1;1;0;2;0;0;0;0;2;3
25496.0;2023;25;VERSAILLES;MASCULIN;SCOLAIRE;BAC PROFESSIONNEL;BAC PRO PROD;BACPRO 20002 ETUD.DEFINITION PRDTS INDUSTRIEL;57;57;36;18;3;2;1;38;0;0;6;17;15;19
25517.0;2023;25;VERSAILLES;MASCULIN;SCOLAIRE;BAC PROFESSIONNEL;BAC PRO PROD;BAC PRO 25007 MAINTENANCE EQUIPEMENTS INDUST.;271;271;175;70;26;20;6;195;0;6;23;59;107;76
25527.0;2023;25;VERSAILLES;MASCULIN;SCOLAIRE;BAC PROFESSIONNEL;BAC PRO PROD;BAC PRO 25302 AERONAUTIQUE OPTION AVIONIQUE;22;22;18;4;0;0;0;18;0;3;5;4;6;4
25536.0;2023;25;VERSAILLES;MASCULIN;SCOLAIRE;BAC PROFESSIONNEL;BAC PRO PROD;BAC PRO 25513 SYST.NUM.OPT.A SURETE SECURITE;111;111;67;32;12;8;4;75;0;0;8;27;40;36
25540.0;2023;25;VERSAILLES;MASCULIN;SCOLAIRE;BAC PROFESSIONNEL;BAC PRO PROD;BAC PRO AG 21004 CGEA;5;5;4;1;0;0;0;4;0;0;1;2;1;1
25542.0;2023;25;VERSAILLES;MASCULIN;SCOLAIRE;BAC PROFESSIONNEL;BAC PRO PROD;BAC PRO AG 21203 TECHN CONSEIL DE VENTE ANIMAL;22;21;20;1;0;0;0;20;0;0;1;4;15;1
25550.0;2023;25;VERSAILLES;MASCULIN;SCOLAIRE;BAC PROFESSIONNEL;BAC PRO SERV;BAC PRO 31212 METIERS DE L'ACCUEIL;230;230;143;71;16;14;2;157;0;6;16;48;87;73
25558.0;2023;25;VERSAILLES;MASCULIN;SCOLAIRE;BAC PROFESSIONNEL;BAC PRO SERV;BAC PRO 33003 ACC.SOINS-S.PERS. OPT.A DOMICILE;6;6;5;1;0;0;0;5;0;0;0;3;2;1
25567.0;2023;25;VERSAILLES;MASCULIN;SCOLAIRE;BAC PROFESSIONNEL;BAC PRO SERV;BAC PRO AG 33002 SERV PERS TERRIT;21;21;16;5;0;0;0;16;0;0;0;5;11;5
25568.0;2023;25;VERSAILLES;MASCULIN;SCOLAIRE;BAC TECHNOLOGIQUE;BAC S2TMD;BAC S2TMD MUSIQUE;7;7;7;0;0;0;0;7;1;0;2;4;0;0
25580.0;2023;25;VERSAILLES;MASCULIN;SCOLAIRE;BAC TECHNOLOGIQUE;BAC STMG;BAC STMG MERCATIQUE (MARKETING);1590;1590;1126;152;312;255;57;1381;0;3;97;396;885;209
25582.0;2023;25;VERSAILLES;MASCULIN;SCOLAIRE;BAC TECHNOLOGIQUE;BAC STMG;BAC STMG SYSTEMES D'INFORMATION DE GESTION;314;314;164;51;99;64;35;228;0;1;6;48;173;86
10006.0;2022;27;CORSE;MASCULIN;SCOLAIRE;BAC PROFESSIONNEL;BAC PRO PROD;BAC PRO 25513 SYST.NUM.OPT.A SURETE SECURITE;11;11;10;1;0;0;0;10;0;0;1;4;5;1
10010.0;2022;27;CORSE;MASCULIN;SCOLAIRE;BAC PROFESSIONNEL;BAC PRO PROD;BAC PRO AG 21302 GEST MILIEUX NATURELS FAUNE;7;7;7;0;0;0;0;7;0;0;0;1;6;0
10015.0;2022;27;CORSE;MASCULIN;SCOLAIRE;BAC PROFESSIONNEL;BAC PRO SERV;BAC PRO 31107 CONDUCT. TRANSP.ROUT.MARCHANDISES;10;10;7;2;1;1;0;8;0;0;3;2;3;2
10021.0;2022;27;CORSE;MASCULIN;SCOLAIRE;BAC PROFESSIONNEL;BAC PRO SERV;BAC PRO 34403 METIERS DE LA SECURITE;11;11;10;1;0;0;0;10;0;2;5;2;1;1
10026.0;2022;27;CORSE;MASCULIN;SCOLAIRE;BAC TECHNOLOGIQUE;BAC STI2D;BAC STI2D ENERGIES  ET ENVIRONNEMENT;13;13;11;1;1;1;0;12;0;1;1;0;10;1
10029.0;2022;27;CORSE;MASCULIN;SCOLAIRE;BAC TECHNOLOGIQUE;BAC STL;BAC STL BIOCHIM.-BIOLOGIE-BIOTECHNOL.;8;8;2;2;4;3;1;5;0;0;1;0;4;3
10030.0;2022;27;CORSE;MASCULIN;SCOLAIRE;BAC TECHNOLOGIQUE;BAC STMG;BAC STMG GESTION ET FINANCE;43;43;36;3;4;4;0;40;0;0;3;17;20;3
10043.0;2022;24;CRETEIL;FEMININ;APPRENTISSAGE;BAC PROFESSIONNEL;BAC PRO PROD;BAC PRO AG 21211 COND GEST ENTR HIPPIQUE;16;16;11;5;0;0;0;11;0;1;0;3;7;5
10054.0;2022;24;CRETEIL;FEMININ;APPRENTISSAGE;BAC PROFESSIONNEL;BAC PRO SERV;BAC PRO 34403 METIERS DE LA SECURITE;1;1;1;0;0;0;0;1;0;0;0;1;0;0
10055.0;2022;24;CRETEIL;FEMININ;APPRENTISSAGE;BAC PROFESSIONNEL;BAC PRO SERV;BAC PRO AG 33002 SERV PERS TERRIT;1;1;1;0;0;0;0;1;0;0;0;0;1;0
10057.0;2022;24;CRETEIL;FEMININ;ENSEIGNEMENT A DISTANCE;BAC PROFESSIONNEL;BAC PRO SERV;BAC PRO 30001 GESTION-ADMINISTRATION;9;7;5;2;0;0;0;5;0;0;1;1;3;2
10059.0;2022;24;CRETEIL;FEMININ;ENSEIGNEMENT A DISTANCE;BAC PROFESSIONNEL;BAC PRO SERV;BAC PRO 31214 MET.COM.VEN.OP.B PR.CL.VA.OF.COM.;1;1;1;0;0;0;0;1;0;0;0;0;1;0
10061.0;2022;24;CRETEIL;FEMININ;ENSEIGNEMENT A DISTANCE;BAC TECHNOLOGIQUE;BAC ST2S;BAC ST2S SCIENCES & TECHNO. SANTE & SOCIAL;8;7;5;1;1;0;1;5;0;0;0;1;4;2
10070.0;2022;24;CRETEIL;FEMININ;FORMATION CONTINUE;BAC PROFESSIONNEL;BAC PRO SERV;BAC PRO 31213 MET.COM.VEN.OP.A ANI.GES.ESP.COM.;1;1;1;0;0;0;0;1;0;1;0;0;0;0
10079.0;2022;24;CRETEIL;FEMININ;INDIVIDUEL;BAC PROFESSIONNEL;BAC PRO PROD;BAC PRO AG 21203 TECHN CONSEIL DE VENTE ANIMAL;1;1;0;1;0;0;0;0;0;0;0;0;0;1
10080.0;2022;24;CRETEIL;FEMININ;INDIVIDUEL;BAC PROFESSIONNEL;BAC PRO PROD;BAC PRO AG 21211 COND GEST ENTR HIPPIQUE;3;3;2;1;0;0;0;2;0;0;0;0;2;1
10084.0;2022;24;CRETEIL;FEMININ;INDIVIDUEL;BAC PROFESSIONNEL;BAC PRO SERV;BAC PRO 31214 MET.COM.VEN.OP.B PR.CL.VA.OF.COM.;1;1;0;1;0;0;0;0;0;0;0;0;0;1
10088.0;2022;24;CRETEIL;FEMININ;INDIVIDUEL;BAC PROFESSIONNEL;BAC PRO SERV;BAC PRO 33403 COMMERC. SERVICES EN RESTAURATION;2;2;0;0;2;2;0;2;0;0;0;0;2;0
10092.0;2022;24;CRETEIL;FEMININ;INDIVIDUEL;BAC TECHNOLOGIQUE;BAC STI2D;BAC STI2D INNOVATION TECHNO.  ET ECO CONCEPTION;1;1;0;1;0;0;0;0;0;0;0;0;0;1
10097.0;2022;24;CRETEIL;FEMININ;INDIVIDUEL;BAC TECHNOLOGIQUE;BAC STMG;BAC STMG RESSOURCES HUMAINES ET COMMUNICATION;27;24;10;7;7;6;1;16;0;1;0;4;11;8
10099.0;2022;24;CRETEIL;FEMININ;SCOLAIRE;BAC PROFESSIONNEL;BAC PRO PROD;BACPRO 20002 ETUD.DEFINITION PRDTS INDUSTRIEL;2;2;2;0;0;0;0;2;0;0;0;0;2;0
10102.0;2022;24;CRETEIL;FEMININ;SCOLAIRE;BAC PROFESSIONNEL;BAC PRO PROD;BAC PRO 22703 TECHN.INSTALL.SYST.ENERG.CLIMATI;1;1;1;0;0;0;0;1;0;0;0;1;0;0
10104.0;2022;24;CRETEIL;FEMININ;SCOLAIRE;BAC PROFESSIONNEL;BAC PRO PROD;BAC PRO 23004 TECHN. ETUDES BAT.A ETUDES & ECO.;10;10;10;0;0;0;0;10;0;0;2;5;3;0
10105.0;2022;24;CRETEIL;FEMININ;SCOLAIRE;BAC PROFESSIONNEL;BAC PRO PROD;BAC PRO 23005 TECHN. ETUDES BAT B ASSIST.ARCHI.;14;14;12;2;0;0;0;12;0;0;1;4;7;2
10111.0;2022;24;CRETEIL;FEMININ;SCOLAIRE;BAC PROFESSIONNEL;BAC PRO PROD;BAC PRO 23408 Etude et réalisation d'agencement;4;4;3;1;0;0;0;3;0;0;1;1;1;1
10117.0;2022;24;CRETEIL;FEMININ;SCOLAIRE;BAC PROFESSIONNEL;BAC PRO PROD;BAC PRO 25107 TECHNICIEN OUTILLEUR;1;1;1;0;0;0;0;1;0;0;1;0;0;0
10122.0;2022;24;CRETEIL;FEMININ;SCOLAIRE;BAC PROFESSIONNEL;BAC PRO PROD;BAC PRO 25408 REPARATION DES CARROSSERIES;1;1;1;0;0;0;0;1;0;0;1;0;0;0
10123.0;2022;24;CRETEIL;FEMININ;SCOLAIRE;BAC PROFESSIONNEL;BAC PRO PROD;BAC PRO 25411 TECH.CHAUDRONNERIE INDUSTRIELLE;2;2;1;1;0;0;0;1;0;1;0;0;0;1
10124.0;2022;24;CRETEIL;FEMININ;SCOLAIRE;BAC PROFESSIONNEL;BAC PRO PROD;BAC PRO 25510 METIERS ELECT. ENVIRON. CONNECTES;4;4;3;1;0;0;0;3;0;2;0;1;0;1
10125.0;2022;24;CRETEIL;FEMININ;SCOLAIRE;BAC PROFESSIONNEL;BAC PRO PROD;BAC PRO 25513 SYST.NUM.OPT.A SURETE SECURITE;1;1;1;0;0;0;0;1;0;0;0;0;1;0
10126.0;2022;24;CRETEIL;FEMININ;SCOLAIRE;BAC PROFESSIONNEL;BAC PRO PROD;BAC PRO 25514 SYST.NUM.OPT.B AUD.RES.EQUIP.DOM.;3;3;3;0;0;0;0;3;0;0;0;3;0;0
10130.0;2022;24;CRETEIL;FEMININ;SCOLAIRE;BAC PROFESSIONNEL;BAC PRO PROD;BAC PRO AG 21405 AMENAGEMENTS PAYSAGERS;7;7;6;1;0;0;0;6;0;0;1;3;2;1
10132.0;2022;24;CRETEIL;FEMININ;SCOLAIRE;BAC PROFESSIONNEL;BAC PRO PROD;BAC PRO AG 22105 LABORATOIRE CONTROLE QUALITE;15;13;6;7;0;0;0;6;0;0;0;2;4;7
10135.0;2022;24;CRETEIL;FEMININ;SCOLAIRE;BAC PROFESSIONNEL;BAC PRO SERV;BAC PRO 31106 LOGISTIQUE;19;19;15;3;1;1;0;16;0;1;2;4;9;3
10150.0;2022;24;CRETEIL;FEMININ;SCOLAIRE;BAC PROFESSIONNEL;BAC PRO SERV;BAC PRO 33603 ESTHETIQUE COSMETIQUE PARFUMERIE;148;146;113;30;3;2;1;115;0;5;23;39;48;31
10154.0;2022;24;CRETEIL;FEMININ;SCOLAIRE;BAC TECHNOLOGIQUE;BAC ST2S;BAC ST2S SCIENCES & TECHNO. SANTE & SOCIAL;1398;1398;1150;59;189;117;72;1267;4;36;170;445;612;131
10156.0;2022;24;CRETEIL;FEMININ;SCOLAIRE;BAC TECHNOLOGIQUE;BAC STD2A;BAC STD2A SCIENCES & TECHNO. DESIGN-ARTS APPLIQUES;219;219;187;15;17;6;11;193;0;7;34;81;71;26
10160.0;2022;24;CRETEIL;FEMININ;SCOLAIRE;BAC TECHNOLOGIQUE;BAC STI2D;BAC STI2D INNOVATION TECHNO.  ET ECO CONCEPTION;43;43;36;1;6;5;1;41;0;2;4;12;23;2
10167.0;2022;24;CRETEIL;FEMININ;SCOLAIRE;BAC TECHNOLOGIQUE;BAC STMG;BAC STMG SYSTEMES D'INFORMATION DE GESTION;70;70;54;3;13;10;3;64;0;0;4;17;43;6
10168.0;2022;24;CRETEIL;MASCULIN;APPRENTISSAGE;BAC PROFESSIONNEL;BAC PRO PROD;BAC PRO 22105 BOULANGER-PÂTISSIER;8;8;8;0;0;0;0;8;0;0;2;5;1;0
10176.0;2022;24;CRETEIL;MASCULIN;APPRENTISSAGE;BAC PROFESSIONNEL;BAC PRO PROD;BAC PRO 25106 TECHNICIEN D'USINAGE;5;5;5;0;0;0;0;5;0;0;0;5;0;0
10187.0;2022;24;CRETEIL;MASCULIN;APPRENTISSAGE;BAC PROFESSIONNEL;BAC PRO PROD;BAC PRO 25510 METIERS ELECT. ENVIRON. CONNECTES;152;145;115;18;12;8;4;123;0;8;23;48;44;22
10195.0;2022;24;CRETEIL;MASCULIN;APPRENTISSAGE;BAC PROFESSIONNEL;BAC PRO SERV;BAC PRO 31214 MET.COM.VEN.OP.B PR.CL.VA.OF.COM.;7;6;5;0;1;0;1;5;0;0;1;1;3;1
10200.0;2022;24;CRETEIL;MASCULIN;APPRENTISSAGE;BAC PROFESSIONNEL;BAC PRO SERV;BAC PRO 34403 METIERS DE LA SECURITE;4;4;1;2;1;0;1;1;0;0;0;1;0;3
10203.0;2022;24;CRETEIL;MASCULIN;ENSEIGNEMENT A DISTANCE;BAC PROFESSIONNEL;BAC PRO PROD;BAC PRO 25510 METIERS ELECT. ENVIRON. CONNECTES;1;0;0;0;0;0;0;0;0;0;0;0;0;0
10207.0;2022;24;CRETEIL;MASCULIN;ENSEIGNEMENT A DISTANCE;BAC TECHNOLOGIQUE;BAC ST2S;BAC ST2S SCIENCES & TECHNO. SANTE & SOCIAL;1;1;1;0;0;0;0;1;0;0;0;0;1;0
10221.0;2022;24;CRETEIL;MASCULIN;FORMATION CONTINUE;BAC PROFESSIONNEL;BAC PRO SERV;BAC PRO 32304 PHOTOGRAPHIE;2;2;1;1;0;0;0;1;0;0;1;0;0;1
10222.0;2022;24;CRETEIL;MASCULIN;INDIVIDUEL;BAC GENERAL;BAC GENERAL;BAC GENE 10019 BAC GENERAL;190;110;38;50;22;15;7;53;0;1;2;8;42;57
10223.0;2022;24;CRETEIL;MASCULIN;INDIVIDUEL;BAC PROFESSIONNEL;BAC PRO PROD;BAC PRO 22106 CUISINE;1;1;1;0;0;0;0;1;0;0;0;0;1;0
10227.0;2022;24;CRETEIL;MASCULIN;INDIVIDUEL;BAC PROFESSIONNEL;BAC PRO PROD;BAC PRO 23203 TECHNICIEN BAT. : ORG.REAL.GROS O;2;2;1;1;0;0;0;1;0;0;0;1;0;1
10228.0;2022;24;CRETEIL;MASCULIN;INDIVIDUEL;BAC PROFESSIONNEL;BAC PRO PROD;BAC PRO 23408 Etude et réalisation d'agencement;1;1;0;1;0;0;0;0;0;0;0;0;0;1
10232.0;2022;24;CRETEIL;MASCULIN;INDIVIDUEL;BAC PROFESSIONNEL;BAC PRO PROD;BAC PRO 25303 AERONAUTIQUE OPTION SYSTEMES;1;1;0;1;0;0;0;0;0;0;0;0;0;1
10233.0;2022;24;CRETEIL;MASCULIN;INDIVIDUEL;BAC PROFESSIONNEL;BAC PRO PROD;BAC PRO 25304 AERONAUTIQUE OPTION STRUCTURE;2;1;0;1;0;0;0;0;0;0;0;0;0;1
10237.0;2022;24;CRETEIL;MASCULIN;INDIVIDUEL;BAC PROFESSIONNEL;BAC PRO PROD;BAC PRO 25510 METIERS ELECT. ENVIRON. CONNECTES;11;9;7;1;1;0;1;7;0;0;0;4;3;2
10239.0;2022;24;CRETEIL;MASCULIN;INDIVIDUEL;BAC PROFESSIONNEL;BAC PRO PROD;BAC PRO 25515 SYST.NUM.OPT.C RES.INF.SYST.COMM.;7;5;4;0;1;1;0;5;0;0;0;1;4;0
10243.0;2022;24;CRETEIL;MASCULIN;INDIVIDUEL;BAC PROFESSIONNEL;BAC PRO PROD;BAC PRO AG 21405 AMENAGEMENTS PAYSAGERS;1;1;0;1;0;0;0;0;0;0;0;0;0;1
10246.0;2022;24;CRETEIL;MASCULIN;INDIVIDUEL;BAC PROFESSIONNEL;BAC PRO SERV;BAC PRO 31106 LOGISTIQUE;2;0;0;0;0;0;0;0;0;0;0;0;0;0
10249.0;2022;24;CRETEIL;MASCULIN;INDIVIDUEL;BAC PROFESSIONNEL;BAC PRO SERV;BAC PRO 31214 MET.COM.VEN.OP.B PR.CL.VA.OF.COM.;4;1;1;0;0;0;0;1;0;0;0;0;1;0
10253.0;2022;24;CRETEIL;MASCULIN;INDIVIDUEL;BAC PROFESSIONNEL;BAC PRO SERV;BAC PRO 34403 METIERS DE LA SECURITE;2;1;1;0;0;0;0;1;0;0;0;0;1;0
10258.0;2022;24;CRETEIL;MASCULIN;INDIVIDUEL;BAC TECHNOLOGIQUE;BAC STL;BAC STL SCIENCES PHYSIQUES CHIMIQUES  EN LABORAT.;1;0;0;0;0;0;0;0;0;0;0;0;0;0
10263.0;2022;24;CRETEIL;MASCULIN;SCOLAIRE;BAC GENERAL;BAC GENERAL;BAC GENE 10019 BAC GENERAL;11397;11397;9657;390;1350;939;411;10596;110;907;2116;3284;4179;801
10264.0;2022;24;CRETEIL;MASCULIN;SCOLAIRE;BAC PROFESSIONNEL;BAC PRO PROD;BACPRO 20002 ETUD.DEFINITION PRDTS INDUSTRIEL;42;42;28;14;0;0;0;28;0;1;8;12;7;14
10270.0;2022;24;CRETEIL;MASCULIN;SCOLAIRE;BAC PROFESSIONNEL;BAC PRO PROD;BAC PRO 23003 ARTIS. & M.ART:MARCHANDISAGE VIS.;7;7;5;2;0;0;0;5;0;1;1;2;1;2
10303.0;2022;24;CRETEIL;MASCULIN;SCOLAIRE;BAC PROFESSIONNEL;BAC PRO PROD;BAC PRO 25510 METIERS ELECT. ENVIRON. CONNECTES;1258;1250;953;217;80;46;34;999;0;59;190;363;387;251
10308.0;2022;24;CRETEIL;MASCULIN;SCOLAIRE;BAC PROFESSIONNEL;BAC PRO PROD;BAC PRO AG 21114 CONDUITE PRODUCTIONS HORTICOLES;9;9;7;2;0;0;0;7;0;0;0;2;5;2
10309.0;2022;24;CRETEIL;MASCULIN;SCOLAIRE;BAC PROFESSIONNEL;BAC PRO PROD;BAC PRO AG 21405 AMENAGEMENTS PAYSAGERS;30;27;23;4;0;0;0;23;0;0;4;10;9;4
10317.0;2022;24;CRETEIL;MASCULIN;SCOLAIRE;BAC PROFESSIONNEL;BAC PRO SERV;BAC PRO 31212 METIERS DE L'ACCUEIL;235;233;153;62;18;11;7;164;0;4;29;50;81;69
10320.0;2022;24;CRETEIL;MASCULIN;SCOLAIRE;BAC PROFESSIONNEL;BAC PRO SERV;BAC PRO 32206 FACONNAGE PRODTS IMPRIMES ROUTAGE;10;10;8;2;0;0;0;8;0;3;3;1;1;2
10321.0;2022;24;CRETEIL;MASCULIN;SCOLAIRE;BAC PROFESSIONNEL;BAC PRO SERV;BAC PRO 32207 REAL.PR.IMPR.PLURI.OPTA.PR.GRAPH.;35;35;25;7;3;2;1;27;0;1;6;12;8;8
10322.0;2022;24;CRETEIL;MASCULIN;SCOLAIRE;BAC PROFESSIONNEL;BAC PRO SERV;BAC PRO 32208 REAL.PR.IMPR.PLURI.OPTB.PR.IMPR.;15;15;12;3;0;0;0;12;0;0;3;5;4;3
10323.0;2022;24;CRETEIL;MASCULIN;SCOLAIRE;BAC PROFESSIONNEL;BAC PRO SERV;BAC PRO 32303 ART.& MET.ART:COM.VIS.VIS.PLURI-M;118;118;100;14;4;4;0;104;0;4;13;51;36;14
10325.0;2022;24;CRETEIL;MASCULIN;SCOLAIRE;BAC PROFESSIONNEL;BAC PRO SERV;BAC PRO 33002 SERVICES DE PROXIMITE  VIE LOCAL;115;112;82;25;5;5;0;87;0;2;16;33;36;25
10327.0;2022;24;CRETEIL;MASCULIN;SCOLAIRE;BAC PROFESSIONNEL;BAC PRO SERV;BAC PRO 33101 OPTIQUE LUNETTERIE;26;26;17;7;2;2;0;19;0;0;2;8;9;7
10336.0;2022;24;CRETEIL;MASCULIN;SCOLAIRE;BAC TECHNOLOGIQUE;BAC STAV;BAC STAV AGRONOMIE ALIM ENV TERRITOI;18;18;18;0;0;0;0;18;0;0;3;5;10;0
10338.0;2022;24;CRETEIL;MASCULIN;SCOLAIRE;BAC TECHNOLOGIQUE;BAC STHR;BAC STHR SC.&TEC. HOTELLERIE-RESTAURATION;38;38;32;2;4;4;0;36;0;2;2;11;21;2
10339.0;2022;24;CRETEIL;MASCULIN;SCOLAIRE;BAC TECHNOLOGIQUE;BAC STI2D;BAC STI2D ARCHITECTURE ET CONSTRUCTION;197;197;153;15;29;19;10;172;0;2;14;61;95;25
10340.0;2022;24;CRETEIL;MASCULIN;SCOLAIRE;BAC TECHNOLOGIQUE;BAC STI2D;BAC STI2D ENERGIES  ET ENVIRONNEMENT;328;328;243;24;61;40;21;283;0;2;23;91;167;45
10345.0;2022;24;CRETEIL;MASCULIN;SCOLAIRE;BAC TECHNOLOGIQUE;BAC STMG;BAC STMG GESTION ET FINANCE;1110;1110;866;84;160;105;55;971;1;7;90;334;539;139
10347.0;2022;24;CRETEIL;MASCULIN;SCOLAIRE;BAC TECHNOLOGIQUE;BAC STMG;BAC STMG RESSOURCES HUMAINES ET COMMUNICATION;571;571;381;61;129;96;33;477;0;1;19;134;323;94
10357.0;2022;07;DIJON;FEMININ;APPRENTISSAGE;BAC PROFESSIONNEL;BAC PRO PROD;BAC PRO 25214 MAINT.VEHIC.OPTA VOIT.PARTICUL.;2;2;2;0;0;0;0;2;0;1;0;0;1;0
10358.0;2022;07;DIJON;FEMININ;APPRENTISSAGE;BAC PROFESSIONNEL;BAC PRO PROD;BAC PRO 25215 MAINT.VEHIC.OPTB VEHIC.TRANS.ROUT;1;1;1;0;0;0;0;1;0;1;0;0;0;0
10366.0;2022;07;DIJON;FEMININ;APPRENTISSAGE;BAC PROFESSIONNEL;BAC PRO PROD;BAC PRO AG 22107 TEC CONS VTE ALIMENTATION P.ALIM;1;1;1;0;0;0;0;1;0;0;0;0;1;0
10369.0;2022;07;DIJON;FEMININ;APPRENTISSAGE;BAC PROFESSIONNEL;BAC PRO SERV;BAC PRO 31212 METIERS DE L'ACCUEIL;2;2;1;1;0;0;0;1;0;0;0;0;1;1
10370.0;2022;07;DIJON;FEMININ;APPRENTISSAGE;BAC PROFESSIONNEL;BAC PRO SERV;BAC PRO 31213 MET.COM.VEN.OP.A ANI.GES.ESP.COM.;76;75;53;19;3;2;1;55;0;2;8;21;24;20
10372.0;2022;07;DIJON;FEMININ;APPRENTISSAGE;BAC PROFESSIONNEL;BAC PRO SERV;BAC PRO 33002 SERVICES DE PROXIMITE  VIE LOCAL;2;2;2;0;0;0;0;2;0;0;0;1;1;0
10373.0;2022;07;DIJON;FEMININ;APPRENTISSAGE;BAC PROFESSIONNEL;BAC PRO SERV;BAC PRO 33403 COMMERC. SERVICES EN RESTAURATION;8;7;5;1;1;0;1;5;0;0;0;3;2;2
10380.0;2022;07;DIJON;FEMININ;ENSEIGNEMENT A DISTANCE;BAC PROFESSIONNEL;BAC PRO SERV;BAC PRO 33603 ESTHETIQUE COSMETIQUE PARFUMERIE;1;1;1;0;0;0;0;1;0;0;1;0;0;0
10384.0;2022;07;DIJON;FEMININ;FORMATION CONTINUE;BAC PROFESSIONNEL;BAC PRO SERV;BAC PRO 30001 GESTION-ADMINISTRATION;5;5;5;0;0;0;0;5;0;4;0;1;0;0
10389.0;2022;07;DIJON;FEMININ;INDIVIDUEL;BAC PROFESSIONNEL;BAC PRO PROD;BAC PRO AG 21211 COND GEST ENTR HIPPIQUE;1;0;0;0;0;0;0;0;0;0;0;0;0;0
10390.0;2022;07;DIJON;FEMININ;INDIVIDUEL;BAC PROFESSIONNEL;BAC PRO SERV;BAC PRO 30001 GESTION-ADMINISTRATION;6;6;6;0;0;0;0;6;0;0;0;1;5;0
10395.0;2022;07;DIJON;FEMININ;INDIVIDUEL;BAC TECHNOLOGIQUE;BAC ST2S;BAC ST2S SCIENCES & TECHNO. SANTE & SOCIAL;5;3;1;0;2;0;2;1;0;0;0;0;1;2
10396.0;2022;07;DIJON;FEMININ;INDIVIDUEL;BAC TECHNOLOGIQUE;BAC STMG;BAC STMG GESTION ET FINANCE;2;2;2;0;0;0;0;2;0;0;0;0;2;0
10398.0;2022;07;DIJON;FEMININ;SCOLAIRE;BAC GENERAL;BAC GENERAL;BAC GENE 10019 BAC GENERAL;4700;4700;4352;42;306;209;97;4561;96;564;1126;1450;1325;139
10401.0;2022;07;DIJON;FEMININ;SCOLAIRE;BAC PROFESSIONNEL;BAC PRO PROD;BAC PRO 22003 BIO-INDUSTRIES DE TRANSFORMATION;14;14;14;0;0;0;0;14;0;0;1;8;5;0
10404.0;2022;07;DIJON;FEMININ;SCOLAIRE;BAC PROFESSIONNEL;BAC PRO PROD;BAC PRO 22503 PLASTIQUES ET COMPOSITES;1;1;1;0;0;0;0;1;0;0;0;1;0;0
10415.0;2022;07;DIJON;FEMININ;SCOLAIRE;BAC PROFESSIONNEL;BAC PRO PROD;BAC PRO 24302 METIERS DU CUIR : MAROQUINERIE;8;8;8;0;0;0;0;8;0;1;1;3;3;0
10426.0;2022;07;DIJON;FEMININ;SCOLAIRE;BAC PROFESSIONNEL;BAC PRO PROD;BAC PRO AG 21114 CONDUITE PRODUCTIONS HORTICOLES;9;9;8;1;0;0;0;8;0;0;1;3;4;1
10435.0;2022;07;DIJON;FEMININ;SCOLAIRE;BAC PROFESSIONNEL;BAC PRO SERV;BAC PRO 31106 LOGISTIQUE;11;11;8;2;1;1;0;9;0;0;1;3;5;2
10440.0;2022;07;DIJON;FEMININ;SCOLAIRE;BAC PROFESSIONNEL;BAC PRO SERV;BAC PRO 32207 REAL.PR.IMPR.PLURI.OPTA.PR.GRAPH.;1;1;1;0;0;0;0;1;0;0;0;0;1;0
10442.0;2022;07;DIJON;FEMININ;SCOLAIRE;BAC PROFESSIONNEL;BAC PRO SERV;BAC PRO 33002 SERVICES DE PROXIMITE  VIE LOCAL;56;56;50;4;2;1;1;51;0;3;11;23;14;5
10445.0;2022;07;DIJON;FEMININ;SCOLAIRE;BAC PROFESSIONNEL;BAC PRO SERV;BAC PRO 33101 OPTIQUE LUNETTERIE;8;8;8;0;0;0;0;8;0;0;1;3;4;0
10446.0;2022;07;DIJON;FEMININ;SCOLAIRE;BAC PROFESSIONNEL;BAC PRO SERV;BAC PRO 33102 PROTHESE DENTAIRE;9;9;7;2;0;0;0;7;0;0;3;1;3;2
10465.0;2022;07;DIJON;FEMININ;SCOLAIRE;BAC TECHNOLOGIQUE;BAC STL;BAC STL SCIENCES PHYSIQUES CHIMIQUES  EN LABORAT.;38;38;36;0;2;1;1;37;1;2;6;9;19;1
10472.0;2022;07;DIJON;MASCULIN;APPRENTISSAGE;BAC PROFESSIONNEL;BAC PRO PROD;BAC PRO 22503 PLASTIQUES ET COMPOSITES;1;1;0;0;1;0;1;0;0;0;0;0;0;1
10477.0;2022;07;DIJON;MASCULIN;APPRENTISSAGE;BAC PROFESSIONNEL;BAC PRO PROD;BACPRO 23103 TECHNICIEN GEOMETRE-TOPOGRAPHE;2;2;0;1;1;1;0;1;0;0;0;0;1;1
10485.0;2022;07;DIJON;MASCULIN;APPRENTISSAGE;BAC PROFESSIONNEL;BAC PRO PROD;BAC PRO 24302 METIERS DU CUIR : MAROQUINERIE;2;2;2;0;0;0;0;2;0;2;0;0;0;0
10489.0;2022;07;DIJON;MASCULIN;APPRENTISSAGE;BAC PROFESSIONNEL;BAC PRO PROD;BAC PRO 25107 TECHNICIEN OUTILLEUR;1;1;1;0;0;0;0;1;0;0;0;0;1;0
10492.0;2022;07;DIJON;MASCULIN;APPRENTISSAGE;BAC PROFESSIONNEL;BAC PRO PROD;BAC PRO 25216 MAINT.VEHIC.OPTC MOTOCYCLES;11;11;7;3;1;1;0;8;0;0;2;4;2;3
10504.0;2022;07;DIJON;MASCULIN;APPRENTISSAGE;BAC PROFESSIONNEL;BAC PRO PROD;BAC PRO AG 21210 COND GEST ENTR CANIN ET FELIN;2;2;2;0;0;0;0;2;0;0;0;2;0;0
10509.0;2022;07;DIJON;MASCULIN;APPRENTISSAGE;BAC PROFESSIONNEL;BAC PRO SERV;BAC PRO 30001 GESTION-ADMINISTRATION;1;1;1;0;0;0;0;1;0;0;0;1;0;0
10515.0;2022;07;DIJON;MASCULIN;APPRENTISSAGE;BAC PROFESSIONNEL;BAC PRO SERV;BAC PRO 33002 SERVICES DE PROXIMITE  VIE LOCAL;1;1;1;0;0;0;0;1;0;0;1;0;0;0
10523.0;2022;07;DIJON;MASCULIN;FORMATION CONTINUE;BAC PROFESSIONNEL;BAC PRO PROD;BAC PRO 23004 TECHN. ETUDES BAT.A ETUDES & ECO.;2;2;2;0;0;0;0;2;0;0;0;2;0;0
10526.0;2022;07;DIJON;MASCULIN;FORMATION CONTINUE;BAC PROFESSIONNEL;BAC PRO SERV;BAC PRO 33403 COMMERC. SERVICES EN RESTAURATION;2;2;2;0;0;0;0;2;0;0;1;0;1;0
10527.0;2022;07;DIJON;MASCULIN;INDIVIDUEL;BAC GENERAL;BAC GENERAL;BAC GENE 10019 BAC GENERAL;37;27;8;10;9;5;4;13;0;0;1;2;10;14
10528.0;2022;07;DIJON;MASCULIN;INDIVIDUEL;BAC PROFESSIONNEL;BAC PRO PROD;BAC PRO 22703 TECHN.INSTALL.SYST.ENERG.CLIMATI;1;1;0;0;1;0;1;0;0;0;0;0;0;1
10531.0;2022;07;DIJON;MASCULIN;INDIVIDUEL;BAC PROFESSIONNEL;BAC PRO PROD;BAC PRO 25214 MAINT.VEHIC.OPTA VOIT.PARTICUL.;2;0;0;0;0;0;0;0;0;0;0;0;0;0
10542.0;2022;07;DIJON;MASCULIN;INDIVIDUEL;BAC PROFESSIONNEL;BAC PRO SERV;BAC PRO 33101 OPTIQUE LUNETTERIE;1;1;1;0;0;0;0;1;0;0;0;0;1;0
10546.0;2022;07;DIJON;MASCULIN;INDIVIDUEL;BAC TECHNOLOGIQUE;BAC STI2D;BAC STI2D ENERGIES  ET ENVIRONNEMENT;1;1;0;1;0;0;0;0;0;0;0;0;0;1
10547.0;2022;07;DIJON;MASCULIN;INDIVIDUEL;BAC TECHNOLOGIQUE;BAC STI2D;BAC STI2D INNOVATION TECHNO.  ET ECO CONCEPTION;1;1;0;0;1;0;1;0;0;0;0;0;0;1
10553.0;2022;07;DIJON;MASCULIN;SCOLAIRE;BAC PROFESSIONNEL;BAC PRO PROD;BACPRO 20002 ETUD.DEFINITION PRDTS INDUSTRIEL;12;12;10;2;0;0;0;10;0;3;0;2;5;2
10560.0;2022;07;DIJON;MASCULIN;SCOLAIRE;BAC PROFESSIONNEL;BAC PRO PROD;BAC PRO 22703 TECHN.INSTALL.SYST.ENERG.CLIMATI;26;26;17;8;1;0;1;17;0;1;1;6;9;9
10563.0;2022;07;DIJON;MASCULIN;SCOLAIRE;BAC PROFESSIONNEL;BAC PRO PROD;BAC PRO 23005 TECHN. ETUDES BAT B ASSIST.ARCHI.;7;7;4;3;0;0;0;4;0;0;1;1;2;3
10566.0;2022;07;DIJON;MASCULIN;SCOLAIRE;BAC PROFESSIONNEL;BAC PRO PROD;BAC PRO 23203 TECHNICIEN BAT. : ORG.REAL.GROS O;13;13;7;2;4;1;3;8;0;0;0;5;3;5
10571.0;2022;07;DIJON;MASCULIN;SCOLAIRE;BAC PROFESSIONNEL;BAC PRO PROD;BAC PRO 23405 TECHNICIEN MENUISIER AGENCEUR;51;51;43;6;2;1;1;44;0;1;11;20;12;7
10574.0;2022;07;DIJON;MASCULIN;SCOLAIRE;BAC PROFESSIONNEL;BAC PRO PROD;BAC PRO 24203 METIERS DE LA MODE - VÊTEMENT;9;9;8;1;0;0;0;8;0;1;0;2;5;1
10579.0;2022;07;DIJON;MASCULIN;SCOLAIRE;BAC PROFESSIONNEL;BAC PRO PROD;BAC PRO 25108 TECHNICIEN MODELEUR;6;6;4;2;0;0;0;4;0;0;1;3;0;2
10580.0;2022;07;DIJON;MASCULIN;SCOLAIRE;BAC PROFESSIONNEL;BAC PRO PROD;BAC PRO 25214 MAINT.VEHIC.OPTA VOIT.PARTICUL.;140;140;100;32;8;4;4;104;0;1;23;36;44;36
10582.0;2022;07;DIJON;MASCULIN;SCOLAIRE;BAC PROFESSIONNEL;BAC PRO PROD;BAC PRO 25219 MAINT.MATERIELS OPT.A AGRICOLES;14;14;14;0;0;0;0;14;0;3;3;5;3;0
10583.0;2022;07;DIJON;MASCULIN;SCOLAIRE;BAC PROFESSIONNEL;BAC PRO PROD;BAC PRO 25220 MAINT.MATERIELS OPT.B TP MANUT.;7;7;6;1;0;0;0;6;0;0;1;2;3;1
10588.0;2022;07;DIJON;MASCULIN;SCOLAIRE;BAC PROFESSIONNEL;BAC PRO PROD;BAC PRO 25408 REPARATION DES CARROSSERIES;19;19;17;2;0;0;0;17;0;0;2;9;6;2
10599.0;2022;07;DIJON;MASCULIN;SCOLAIRE;BAC PROFESSIONNEL;BAC PRO PROD;BAC PRO AG 21203 TECHN CONSEIL DE VENTE ANIMAL;4;4;3;1;0;0;0;3;0;0;0;2;1;1
10603.0;2022;07;DIJON;MASCULIN;SCOLAIRE;BAC PROFESSIONNEL;BAC PRO PROD;BAC PRO AG 21302 GEST MILIEUX NATURELS FAUNE;10;10;9;1;0;0;0;9;0;0;3;2;4;1
10610.0;2022;07;DIJON;MASCULIN;SCOLAIRE;BAC PROFESSIONNEL;BAC PRO SERV;BAC PRO 31107 CONDUCT. TRANSP.ROUT.MARCHANDISES;27;27;26;1;0;0;0;26;0;3;8;12;3;1
10613.0;2022;07;DIJON;MASCULIN;SCOLAIRE;BAC PROFESSIONNEL;BAC PRO SERV;BAC PRO 31213 MET.COM.VEN.OP.A ANI.GES.ESP.COM.;211;211;165;39;7;5;2;170;0;1;25;58;86;41
10620.0;2022;07;DIJON;MASCULIN;SCOLAIRE;BAC PROFESSIONNEL;BAC PRO SERV;BAC PRO 33101 OPTIQUE LUNETTERIE;6;6;6;0;0;0;0;6;0;0;2;2;2;0
10628.0;2022;07;DIJON;MASCULIN;SCOLAIRE;BAC TECHNOLOGIQUE;BAC S2TMD;BAC S2TMD MUSIQUE;2;2;2;0;0;0;0;2;0;0;0;2;0;0
10633.0;2022;07;DIJON;MASCULIN;SCOLAIRE;BAC TECHNOLOGIQUE;BAC STI2D;BAC STI2D ARCHITECTURE ET CONSTRUCTION;72;72;51;6;15;11;4;62;0;2;2;16;42;10
10643.0;2022;08;GRENOBLE;FEMININ;APPRENTISSAGE;BAC PROFESSIONNEL;BAC PRO PROD;BAC PRO 20102 PILOTE DE LIGNE DE PRODUCTION;1;1;1;0;0;0;0;1;0;0;1;0;0;0
10647.0;2022;08;GRENOBLE;FEMININ;APPRENTISSAGE;BAC PROFESSIONNEL;BAC PRO PROD;BAC PRO 23203 TECHNICIEN BAT. : ORG.REAL.GROS O;2;2;2;0;0;0;0;2;0;1;1;0;0;0
10649.0;2022;08;GRENOBLE;FEMININ;APPRENTISSAGE;BAC PROFESSIONNEL;BAC PRO PROD;BAC PRO 25006 MICROTECHNIQUES;2;2;2;0;0;0;0;2;0;0;1;0;1;0
10650.0;2022;08;GRENOBLE;FEMININ;APPRENTISSAGE;BAC PROFESSIONNEL;BAC PRO PROD;BAC PRO 25007 MAINTENANCE EQUIPEMENTS INDUST.;2;2;2;0;0;0;0;2;0;1;1;0;0;0
10651.0;2022;08;GRENOBLE;FEMININ;APPRENTISSAGE;BAC PROFESSIONNEL;BAC PRO PROD;BAC PRO 25106 TECHNICIEN D'USINAGE;3;3;2;1;0;0;0;2;0;0;0;2;0;1
10654.0;2022;08;GRENOBLE;FEMININ;APPRENTISSAGE;BAC PROFESSIONNEL;BAC PRO PROD;BAC PRO 25216 MAINT.VEHIC.OPTC MOTOCYCLES;2;2;2;0;0;0;0;2;0;0;1;0;1;0
10655.0;2022;08;GRENOBLE;FEMININ;APPRENTISSAGE;BAC PROFESSIONNEL;BAC PRO PROD;BAC PRO 25220 MAINT.MATERIELS OPT.B TP MANUT.;1;1;1;0;0;0;0;1;0;0;0;1;0;0
10656.0;2022;08;GRENOBLE;FEMININ;APPRENTISSAGE;BAC PROFESSIONNEL;BAC PRO PROD;BAC PRO 25408 REPARATION DES CARROSSERIES;3;3;2;0;1;1;0;3;0;0;1;1;1;0
10657.0;2022;08;GRENOBLE;FEMININ;APPRENTISSAGE;BAC PROFESSIONNEL;BAC PRO PROD;BAC PRO 25411 TECH.CHAUDRONNERIE INDUSTRIELLE;2;2;2;0;0;0;0;2;0;0;1;1;0;0
10659.0;2022;08;GRENOBLE;FEMININ;APPRENTISSAGE;BAC PROFESSIONNEL;BAC PRO PROD;BAC PRO AG 21210 COND GEST ENTR CANIN ET FELIN;3;3;3;0;0;0;0;3;0;0;0;0;3;0
10698.0;2022;08;GRENOBLE;FEMININ;INDIVIDUEL;BAC PROFESSIONNEL;BAC PRO PROD;BAC PRO AG 22105 LABORATOIRE CONTROLE QUALITE;1;1;0;1;0;0;0;0;0;0;0;0;0;1
10700.0;2022;08;GRENOBLE;FEMININ;INDIVIDUEL;BAC PROFESSIONNEL;BAC PRO SERV;BAC PRO 31212 METIERS DE L'ACCUEIL;2;0;0;0;0;0;0;0;0;0;0;0;0;0
10708.0;2022;08;GRENOBLE;FEMININ;INDIVIDUEL;BAC TECHNOLOGIQUE;BAC STMG;BAC STMG MERCATIQUE (MARKETING);10;7;2;4;1;0;1;2;0;0;0;1;1;5
10709.0;2022;08;GRENOBLE;FEMININ;INDIVIDUEL;BAC TECHNOLOGIQUE;BAC STMG;BAC STMG RESSOURCES HUMAINES ET COMMUNICATION;15;12;2;8;2;1;1;3;0;0;0;0;3;9
10715.0;2022;08;GRENOBLE;FEMININ;SCOLAIRE;BAC PROFESSIONNEL;BAC PRO PROD;BAC PRO 22004 PROC. CHIMIE EAU PAPIERS-CARTONS;14;14;12;2;0;0;0;12;0;0;2;5;5;2
10719.0;2022;08;GRENOBLE;FEMININ;SCOLAIRE;BAC PROFESSIONNEL;BAC PRO PROD;BAC PRO 23003 ARTIS. & M.ART:MARCHANDISAGE VIS.;9;9;9;0;0;0;0;9;0;1;1;4;3;0
10720.0;2022;08;GRENOBLE;FEMININ;SCOLAIRE;BAC PROFESSIONNEL;BAC PRO PROD;BAC PRO 23004 TECHN. ETUDES BAT.A ETUDES & ECO.;12;12;6;6;0;0;0;6;0;0;1;2;3;6
10741.0;2022;08;GRENOBLE;FEMININ;SCOLAIRE;BAC PROFESSIONNEL;BAC PRO PROD;BAC PRO 25513 SYST.NUM.OPT.A SURETE SECURITE;3;3;2;1;0;0;0;2;0;0;1;1;0;1
10750.0;2022;08;GRENOBLE;FEMININ;SCOLAIRE;BAC PROFESSIONNEL;BAC PRO PROD;BAC PRO AG 21211 COND GEST ENTR HIPPIQUE;88;87;75;12;0;0;0;75;0;1;7;28;39;12
10770.0;2022;08;GRENOBLE;FEMININ;SCOLAIRE;BAC PROFESSIONNEL;BAC PRO SERV;BAC PRO 33004 ACC.SOINS-S.PERS. OPT.EN STRUCTUR;527;527;466;45;16;9;7;475;0;25;119;189;142;52
10771.0;2022;08;GRENOBLE;FEMININ;SCOLAIRE;BAC PROFESSIONNEL;BAC PRO SERV;BAC PRO 33101 OPTIQUE LUNETTERIE;21;21;17;4;0;0;0;17;0;0;4;6;7;4
10773.0;2022;08;GRENOBLE;FEMININ;SCOLAIRE;BAC PROFESSIONNEL;BAC PRO SERV;BAC PRO 33603 ESTHETIQUE COSMETIQUE PARFUMERIE;125;124;111;13;0;0;0;111;0;4;21;48;38;13
10775.0;2022;08;GRENOBLE;FEMININ;SCOLAIRE;BAC PROFESSIONNEL;BAC PRO SERV;BAC PRO 34305 TECHN.D'INTERV.SUR INSTALL. NUCL.;1;1;0;1;0;0;0;0;0;0;0;0;0;1
10779.0;2022;08;GRENOBLE;FEMININ;SCOLAIRE;BAC TECHNOLOGIQUE;BAC S2TMD;BAC S2TMD MUSIQUE;5;5;5;0;0;0;0;5;1;0;1;3;0;0
10780.0;2022;08;GRENOBLE;FEMININ;SCOLAIRE;BAC TECHNOLOGIQUE;BAC ST2S;BAC ST2S SCIENCES & TECHNO. SANTE & SOCIAL;769;769;683;14;72;48;24;731;0;27;130;277;297;38
10781.0;2022;08;GRENOBLE;FEMININ;SCOLAIRE;BAC TECHNOLOGIQUE;BAC STAV;BAC STAV AGRONOMIE ALIM ENV TERRITOI;164;164;164;0;0;0;0;164;0;9;26;75;54;0
10783.0;2022;08;GRENOBLE;FEMININ;SCOLAIRE;BAC TECHNOLOGIQUE;BAC STHR;BAC STHR SC.&TEC. HOTELLERIE-RESTAURATION;74;74;70;1;3;3;0;73;2;7;16;26;22;1
10793.0;2022;08;GRENOBLE;FEMININ;SCOLAIRE;BAC TECHNOLOGIQUE;BAC STMG;BAC STMG SYSTEMES D'INFORMATION DE GESTION;23;23;22;0;1;1;0;23;0;0;5;6;12;0
10796.0;2022;08;GRENOBLE;MASCULIN;APPRENTISSAGE;BAC PROFESSIONNEL;BAC PRO PROD;BAC PRO 22003 BIO-INDUSTRIES DE TRANSFORMATION;7;7;7;0;0;0;0;7;0;2;0;2;3;0
10805.0;2022;08;GRENOBLE;MASCULIN;APPRENTISSAGE;BAC PROFESSIONNEL;BAC PRO PROD;BAC PRO 23205 INTERV. SUR PATRIMOINE BATI OPT.A;2;2;2;0;0;0;0;2;0;0;0;2;0;0
10806.0;2022;08;GRENOBLE;MASCULIN;APPRENTISSAGE;BAC PROFESSIONNEL;BAC PRO PROD;BAC PRO 23304 AMENAGEMENT FINITION BATIMENT;15;15;11;4;0;0;0;11;0;1;2;6;2;4
10813.0;2022;08;GRENOBLE;MASCULIN;APPRENTISSAGE;BAC PROFESSIONNEL;BAC PRO PROD;BAC PRO 25009 MAINTENANCE NAUTIQUE;2;2;1;0;1;0;1;1;0;0;1;0;0;1
10842.0;2022;08;GRENOBLE;MASCULIN;APPRENTISSAGE;BAC PROFESSIONNEL;BAC PRO SERV;BAC PRO 31214 MET.COM.VEN.OP.B PR.CL.VA.OF.COM.;10;9;9;0;0;0;0;9;0;0;4;3;2;0
10843.0;2022;08;GRENOBLE;MASCULIN;APPRENTISSAGE;BAC PROFESSIONNEL;BAC PRO SERV;BAC PRO 33004 ACC.SOINS-S.PERS. OPT.EN STRUCTUR;1;1;1;0;0;0;0;1;0;0;0;0;1;0
10852.0;2022;08;GRENOBLE;MASCULIN;ENSEIGNEMENT A DISTANCE;BAC TECHNOLOGIQUE;BAC STMG;BAC STMG GESTION ET FINANCE;2;1;1;0;0;0;0;1;0;0;0;0;1;0
10861.0;2022;08;GRENOBLE;MASCULIN;INDIVIDUEL;BAC PROFESSIONNEL;BAC PRO PROD;BAC PRO 22703 TECHN.INSTALL.SYST.ENERG.CLIMATI;2;1;1;0;0;0;0;1;0;0;0;1;0;0
10867.0;2022;08;GRENOBLE;MASCULIN;INDIVIDUEL;BAC PROFESSIONNEL;BAC PRO PROD;BAC PRO 25214 MAINT.VEHIC.OPTA VOIT.PARTICUL.;2;0;0;0;0;0;0;0;0;0;0;0;0;0
10872.0;2022;08;GRENOBLE;MASCULIN;INDIVIDUEL;BAC PROFESSIONNEL;BAC PRO PROD;BAC PRO AG 21114 CONDUITE PRODUCTIONS HORTICOLES;6;6;5;1;0;0;0;5;0;0;0;0;5;1
10875.0;2022;08;GRENOBLE;MASCULIN;INDIVIDUEL;BAC PROFESSIONNEL;BAC PRO SERV;BAC PRO 30001 GESTION-ADMINISTRATION;1;0;0;0;0;0;0;0;0;0;0;0;0;0
10877.0;2022;08;GRENOBLE;MASCULIN;INDIVIDUEL;BAC PROFESSIONNEL;BAC PRO SERV;BAC PRO 31212 METIERS DE L'ACCUEIL;1;0;0;0;0;0;0;0;0;0;0;0;0;0
10894.0;2022;08;GRENOBLE;MASCULIN;SCOLAIRE;BAC PROFESSIONNEL;BAC PRO PROD;BAC PRO 20102 PILOTE DE LIGNE DE PRODUCTION;29;29;17;10;2;1;1;18;0;0;4;4;10;11
10922.0;2022;08;GRENOBLE;MASCULIN;SCOLAIRE;BAC PROFESSIONNEL;BAC PRO PROD;BAC PRO 25215 MAINT.VEHIC.OPTB VEHIC.TRANS.ROUT;20;20;17;3;0;0;0;17;0;1;2;10;4;3
10923.0;2022;08;GRENOBLE;MASCULIN;SCOLAIRE;BAC PROFESSIONNEL;BAC PRO PROD;BAC PRO 25216 MAINT.VEHIC.OPTC MOTOCYCLES;9;9;7;0;2;2;0;9;0;1;2;2;4;0
10925.0;2022;08;GRENOBLE;MASCULIN;SCOLAIRE;BAC PROFESSIONNEL;BAC PRO PROD;BAC PRO 25406 OUVRAGES DU BATIMENT METALLERIE;32;32;20;10;2;2;0;22;0;2;3;10;7;10
10933.0;2022;08;GRENOBLE;MASCULIN;SCOLAIRE;BAC PROFESSIONNEL;BAC PRO PROD;BAC PRO AG 21001 AGRO-EQUIPEMENT;58;57;49;8;0;0;0;49;0;0;5;12;32;8
10937.0;2022;08;GRENOBLE;MASCULIN;SCOLAIRE;BAC PROFESSIONNEL;BAC PRO PROD;BAC PRO AG 21204 PROD-AQUACOLES;16;16;15;1;0;0;0;15;0;0;4;4;7;1
10940.0;2022;08;GRENOBLE;MASCULIN;SCOLAIRE;BAC PROFESSIONNEL;BAC PRO PROD;BAC PRO AG 21302 GEST MILIEUX NATURELS FAUNE;78;78;73;5;0;0;0;73;0;5;17;25;26;5
10942.0;2022;08;GRENOBLE;MASCULIN;SCOLAIRE;BAC PROFESSIONNEL;BAC PRO PROD;BAC PRO AG 21405 AMENAGEMENTS PAYSAGERS;117;114;107;7;0;0;0;107;0;6;26;34;41;7
10950.0;2022;08;GRENOBLE;MASCULIN;SCOLAIRE;BAC PROFESSIONNEL;BAC PRO SERV;BAC PRO 31109 TRANSPORT FLUVIAL;8;8;7;0;1;1;0;8;0;1;1;5;1;0
10954.0;2022;08;GRENOBLE;MASCULIN;SCOLAIRE;BAC PROFESSIONNEL;BAC PRO SERV;BAC PRO 32207 REAL.PR.IMPR.PLURI.OPTA.PR.GRAPH.;6;6;6;0;0;0;0;6;0;0;2;2;2;0
10959.0;2022;08;GRENOBLE;MASCULIN;SCOLAIRE;BAC PROFESSIONNEL;BAC PRO SERV;BAC PRO 33004 ACC.SOINS-S.PERS. OPT.EN STRUCTUR;31;31;26;3;2;2;0;28;0;0;9;7;12;3
10964.0;2022;08;GRENOBLE;MASCULIN;SCOLAIRE;BAC PROFESSIONNEL;BAC PRO SERV;BAC PRO 34305 TECHN.D'INTERV.SUR INSTALL. NUCL.;22;22;18;2;2;2;0;20;0;1;2;8;9;2
10965.0;2022;08;GRENOBLE;MASCULIN;SCOLAIRE;BAC PROFESSIONNEL;BAC PRO SERV;BAC PRO 34403 METIERS DE LA SECURITE;50;50;49;1;0;0;0;49;0;3;19;16;11;1
10974.0;2022;08;GRENOBLE;MASCULIN;SCOLAIRE;BAC TECHNOLOGIQUE;BAC STI2D;BAC STI2D ENERGIES  ET ENVIRONNEMENT;270;270;241;5;24;14;10;255;0;7;41;95;112;15
10977.0;2022;08;GRENOBLE;MASCULIN;SCOLAIRE;BAC TECHNOLOGIQUE;BAC STL;BAC STL BIOCHIM.-BIOLOGIE-BIOTECHNOL.;74;74;60;1;13;6;7;66;0;1;10;17;38;8
10978.0;2022;08;GRENOBLE;MASCULIN;SCOLAIRE;BAC TECHNOLOGIQUE;BAC STL;BAC STL SCIENCES PHYSIQUES CHIMIQUES  EN LABORAT.;61;61;58;0;3;1;2;59;0;4;16;17;22;2
10981.0;2022;08;GRENOBLE;MASCULIN;SCOLAIRE;BAC TECHNOLOGIQUE;BAC STMG;BAC STMG RESSOURCES HUMAINES ET COMMUNICATION;258;258;190;13;55;44;11;234;0;0;8;65;161;24
10989.0;2022;32;GUADELOUPE;FEMININ;ENSEIGNEMENT A DISTANCE;BAC PROFESSIONNEL;BAC PRO SERV;BAC PRO 33004 ACC.SOINS-S.PERS. OPT.EN STRUCTUR;1;1;0;1;0;0;0;0;0;0;0;0;0;1
10991.0;2022;32;GUADELOUPE;FEMININ;FORMATION CONTINUE;BAC PROFESSIONNEL;BAC PRO SERV;BAC PRO 30001 GESTION-ADMINISTRATION;4;3;0;3;0;0;0;0;0;0;0;0;0;3
10996.0;2022;32;GUADELOUPE;FEMININ;INDIVIDUEL;BAC GENERAL;BAC GENERAL;BAC GENE 10019 BAC GENERAL;18;16;9;6;1;0;1;9;0;3;3;2;1;7
11009.0;2022;32;GUADELOUPE;FEMININ;SCOLAIRE;BAC PROFESSIONNEL;BAC PRO PROD;BAC PRO 22104 BOUCHER CHARCUTIER TRAITEUR;4;4;4;0;0;0;0;4;0;0;0;3;1;0
11015.0;2022;32;GUADELOUPE;FEMININ;SCOLAIRE;BAC PROFESSIONNEL;BAC PRO PROD;BAC PRO 23005 TECHN. ETUDES BAT B ASSIST.ARCHI.;3;3;2;1;0;0;0;2;0;0;0;0;2;1
11020.0;2022;32;GUADELOUPE;FEMININ;SCOLAIRE;BAC PROFESSIONNEL;BAC PRO PROD;BAC PRO 25007 MAINTENANCE EQUIPEMENTS INDUST.;1;1;1;0;0;0;0;1;0;0;0;1;0;0
11030.0;2022;32;GUADELOUPE;FEMININ;SCOLAIRE;BAC PROFESSIONNEL;BAC PRO PROD;BAC PRO 25515 SYST.NUM.OPT.C RES.INF.SYST.COMM.;6;6;6;0;0;0;0;6;0;0;1;3;2;0
11045.0;2022;32;GUADELOUPE;FEMININ;SCOLAIRE;BAC PROFESSIONNEL;BAC PRO SERV;BAC PRO 33403 COMMERC. SERVICES EN RESTAURATION;23;23;19;3;1;1;0;20;0;1;7;6;6;3
11046.0;2022;32;GUADELOUPE;FEMININ;SCOLAIRE;BAC PROFESSIONNEL;BAC PRO SERV;BAC PRO 33603 ESTHETIQUE COSMETIQUE PARFUMERIE;34;33;24;9;0;0;0;24;0;0;2;12;10;9
11049.0;2022;32;GUADELOUPE;FEMININ;SCOLAIRE;BAC PROFESSIONNEL;BAC PRO SERV;BAC PRO AG 33002 SERV PERS TERRIT;70;64;60;4;0;0;0;60;0;2;10;14;34;4
11054.0;2022;32;GUADELOUPE;FEMININ;SCOLAIRE;BAC TECHNOLOGIQUE;BAC STD2A;BAC STD2A SCIENCES & TECHNO. DESIGN-ARTS APPLIQUES;22;22;22;0;0;0;0;22;0;0;9;9;4;0
11059.0;2022;32;GUADELOUPE;FEMININ;SCOLAIRE;BAC TECHNOLOGIQUE;BAC STI2D;BAC STI2D SYSTÈME D'INFORMATION  ET NUMERIQUE;8;8;6;0;2;2;0;8;0;0;0;3;5;0
11064.0;2022;32;GUADELOUPE;FEMININ;SCOLAIRE;BAC TECHNOLOGIQUE;BAC STMG;BAC STMG RESSOURCES HUMAINES ET COMMUNICATION;115;115;98;3;14;13;1;111;0;5;10;34;62;4
11065.0;2022;32;GUADELOUPE;FEMININ;SCOLAIRE;BAC TECHNOLOGIQUE;BAC STMG;BAC STMG SYSTEMES D'INFORMATION DE GESTION;6;6;4;0;2;2;0;6;0;1;1;0;4;0
11068.0;2022;32;GUADELOUPE;MASCULIN;APPRENTISSAGE;BAC PROFESSIONNEL;BAC PRO PROD;BAC PRO 25214 MAINT.VEHIC.OPTA VOIT.PARTICUL.;4;4;3;1;0;0;0;3;0;0;0;1;2;1
11070.0;2022;32;GUADELOUPE;MASCULIN;APPRENTISSAGE;BAC PROFESSIONNEL;BAC PRO PROD;BAC PRO 25509 TECHNIC. FROID CONDITIONNEMT AIR;1;1;1;0;0;0;0;1;0;0;1;0;0;0
11081.0;2022;32;GUADELOUPE;MASCULIN;FORMATION CONTINUE;BAC PROFESSIONNEL;BAC PRO SERV;BAC PRO 31213 MET.COM.VEN.OP.A ANI.GES.ESP.COM.;2;1;1;0;0;0;0;1;0;0;0;0;1;0
11086.0;2022;32;GUADELOUPE;MASCULIN;INDIVIDUEL;BAC PROFESSIONNEL;BAC PRO PROD;BAC PRO 25514 SYST.NUM.OPT.B AUD.RES.EQUIP.DOM.;1;0;0;0;0;0;0;0;0;0;0;0;0;0
11087.0;2022;32;GUADELOUPE;MASCULIN;INDIVIDUEL;BAC PROFESSIONNEL;BAC PRO PROD;BAC PRO AG 21114 CONDUITE PRODUCTIONS HORTICOLES;1;1;1;0;0;0;0;1;0;0;0;0;1;0
11093.0;2022;32;GUADELOUPE;MASCULIN;INDIVIDUEL;BAC TECHNOLOGIQUE;BAC ST2S;BAC ST2S SCIENCES & TECHNO. SANTE & SOCIAL;2;1;1;0;0;0;0;1;0;0;0;0;1;0
11097.0;2022;32;GUADELOUPE;MASCULIN;SCOLAIRE;BAC GENERAL;BAC GENERAL;BAC GENE 10019 BAC GENERAL;1142;1142;955;29;158;128;30;1083;11;71;195;315;491;59
11117.0;2022;32;GUADELOUPE;MASCULIN;SCOLAIRE;BAC PROFESSIONNEL;BAC PRO PROD;BAC PRO 25219 MAINT.MATERIELS OPT.A AGRICOLES;8;8;2;3;3;2;1;4;0;0;0;1;3;4
11124.0;2022;32;GUADELOUPE;MASCULIN;SCOLAIRE;BAC PROFESSIONNEL;BAC PRO PROD;BAC PRO 25510 METIERS ELECT. ENVIRON. CONNECTES;185;182;135;25;22;13;9;148;0;8;16;48;76;34
11127.0;2022;32;GUADELOUPE;MASCULIN;SCOLAIRE;BAC PROFESSIONNEL;BAC PRO PROD;BAC PRO 25515 SYST.NUM.OPT.C RES.INF.SYST.COMM.;39;38;31;6;1;0;1;31;0;2;10;10;9;7
11131.0;2022;32;GUADELOUPE;MASCULIN;SCOLAIRE;BAC PROFESSIONNEL;BAC PRO PROD;BAC PRO AG 22107 TEC CONS VTE ALIMENTATION P.ALIM;10;10;7;3;0;0;0;7;0;0;0;1;6;3
11140.0;2022;32;GUADELOUPE;MASCULIN;SCOLAIRE;BAC PROFESSIONNEL;BAC PRO SERV;BAC PRO 33003 ACC.SOINS-S.PERS. OPT.A DOMICILE;4;4;3;1;0;0;0;3;0;0;0;1;2;1
11149.0;2022;32;GUADELOUPE;MASCULIN;SCOLAIRE;BAC TECHNOLOGIQUE;BAC ST2S;BAC ST2S SCIENCES & TECHNO. SANTE & SOCIAL;39;39;32;1;6;6;0;38;0;0;4;9;25;1
11153.0;2022;32;GUADELOUPE;MASCULIN;SCOLAIRE;BAC TECHNOLOGIQUE;BAC STI2D;BAC STI2D ARCHITECTURE ET CONSTRUCTION;37;37;28;1;8;6;2;34;0;0;1;15;18;3
11168.0;2022;33;GUYANE;FEMININ;FORMATION CONTINUE;BAC PROFESSIONNEL;BAC PRO PROD;BAC PRO AG 21114 CONDUITE PRODUCTIONS HORTICOLES;2;2;2;0;0;0;0;2;0;0;0;0;2;0
11169.0;2022;33;GUYANE;FEMININ;FORMATION CONTINUE;BAC PROFESSIONNEL;BAC PRO SERV;BAC PRO 31213 MET.COM.VEN.OP.A ANI.GES.ESP.COM.;20;20;6;10;4;4;0;10;0;0;2;2;6;10
11180.0;2022;33;GUYANE;FEMININ;INDIVIDUEL;BAC PROFESSIONNEL;BAC PRO SERV;BAC PRO 34304 HYGIENE PROPRETE STERILISATION;1;1;0;1;0;0;0;0;0;0;0;0;0;1
11183.0;2022;33;GUYANE;FEMININ;INDIVIDUEL;BAC TECHNOLOGIQUE;BAC STMG;BAC STMG RESSOURCES HUMAINES ET COMMUNICATION;1;1;1;0;0;0;0;1;0;0;0;0;1;0
11192.0;2022;33;GUYANE;FEMININ;SCOLAIRE;BAC PROFESSIONNEL;BAC PRO PROD;BAC PRO 23203 TECHNICIEN BAT. : ORG.REAL.GROS O;1;1;0;1;0;0;0;0;0;0;0;0;0;1
11195.0;2022;33;GUYANE;FEMININ;SCOLAIRE;BAC PROFESSIONNEL;BAC PRO PROD;BAC PRO 23404 TECHNICIEN CONSTRUCTEUR BOIS;4;4;2;1;1;1;0;3;0;0;0;0;3;1
11196.0;2022;33;GUYANE;FEMININ;SCOLAIRE;BAC PROFESSIONNEL;BAC PRO PROD;BAC PRO 24002 METIERS PRESSING BLANCHISSERIE;5;5;3;2;0;0;0;3;0;0;2;0;1;2
11203.0;2022;33;GUYANE;FEMININ;SCOLAIRE;BAC PROFESSIONNEL;BAC PRO PROD;BAC PRO AG 21405 AMENAGEMENTS PAYSAGERS;3;2;1;1;0;0;0;1;0;0;0;0;1;1
11209.0;2022;33;GUYANE;FEMININ;SCOLAIRE;BAC PROFESSIONNEL;BAC PRO SERV;BAC PRO 31213 MET.COM.VEN.OP.A ANI.GES.ESP.COM.;101;101;53;37;11;10;1;63;0;0;4;12;47;38
11212.0;2022;33;GUYANE;FEMININ;SCOLAIRE;BAC PROFESSIONNEL;BAC PRO SERV;BAC PRO 33002 SERVICES DE PROXIMITE  VIE LOCAL;59;59;35;22;2;1;1;36;0;1;3;6;26;23
11214.0;2022;33;GUYANE;FEMININ;SCOLAIRE;BAC PROFESSIONNEL;BAC PRO SERV;BAC PRO 33004 ACC.SOINS-S.PERS. OPT.EN STRUCTUR;67;67;52;14;1;1;0;53;0;0;8;21;24;14
11218.0;2022;33;GUYANE;FEMININ;SCOLAIRE;BAC PROFESSIONNEL;BAC PRO SERV;BAC PRO 34403 METIERS DE LA SECURITE;9;9;3;2;4;2;2;5;0;0;1;1;3;4
11222.0;2022;33;GUYANE;FEMININ;SCOLAIRE;BAC TECHNOLOGIQUE;BAC STHR;BAC STHR SC.&TEC. HOTELLERIE-RESTAURATION;18;18;10;5;3;3;0;13;0;0;2;2;9;5
11227.0;2022;33;GUYANE;FEMININ;SCOLAIRE;BAC TECHNOLOGIQUE;BAC STL;BAC STL BIOCHIM.-BIOLOGIE-BIOTECHNOL.;18;18;9;1;8;5;3;14;0;0;0;3;11;4
11228.0;2022;33;GUYANE;FEMININ;SCOLAIRE;BAC TECHNOLOGIQUE;BAC STL;BAC STL SCIENCES PHYSIQUES CHIMIQUES  EN LABORAT.;11;11;4;2;5;5;0;9;0;0;0;3;6;2
11230.0;2022;33;GUYANE;FEMININ;SCOLAIRE;BAC TECHNOLOGIQUE;BAC STMG;BAC STMG MERCATIQUE (MARKETING);62;62;45;5;12;12;0;57;0;0;2;14;41;5
11235.0;2022;33;GUYANE;MASCULIN;FORMATION CONTINUE;BAC PROFESSIONNEL;BAC PRO SERV;BAC PRO 31213 MET.COM.VEN.OP.A ANI.GES.ESP.COM.;9;9;1;5;3;2;1;3;0;0;0;0;3;6
11238.0;2022;33;GUYANE;MASCULIN;INDIVIDUEL;BAC PROFESSIONNEL;BAC PRO PROD;BAC PRO 22704 TECHN. MAINT. SYST.ENERG.CLIMATI;1;1;1;0;0;0;0;1;0;0;0;0;1;0
11239.0;2022;33;GUYANE;MASCULIN;INDIVIDUEL;BAC PROFESSIONNEL;BAC PRO PROD;BAC PRO 23004 TECHN. ETUDES BAT.A ETUDES & ECO.;1;1;0;1;0;0;0;0;0;0;0;0;0;1
11244.0;2022;33;GUYANE;MASCULIN;INDIVIDUEL;BAC PROFESSIONNEL;BAC PRO SERV;BAC PRO 31213 MET.COM.VEN.OP.A ANI.GES.ESP.COM.;2;1;0;1;0;0;0;0;0;0;0;0;0;1
11246.0;2022;33;GUYANE;MASCULIN;INDIVIDUEL;BAC TECHNOLOGIQUE;BAC STMG;BAC STMG RESSOURCES HUMAINES ET COMMUNICATION;2;1;1;0;0;0;0;1;0;0;0;0;1;0
11248.0;2022;33;GUYANE;MASCULIN;SCOLAIRE;BAC PROFESSIONNEL;BAC PRO PROD;BAC PRO 22004 PROC. CHIMIE EAU PAPIERS-CARTONS;9;9;3;5;1;1;0;4;0;0;0;0;4;5
11250.0;2022;33;GUYANE;MASCULIN;SCOLAIRE;BAC PROFESSIONNEL;BAC PRO PROD;BAC PRO 22106 CUISINE;14;14;8;4;2;2;0;10;0;0;1;0;9;4
11251.0;2022;33;GUYANE;MASCULIN;SCOLAIRE;BAC PROFESSIONNEL;BAC PRO PROD;BAC PRO 22704 TECHN. MAINT. SYST.ENERG.CLIMATI;13;12;8;3;1;1;0;9;0;0;0;1;8;3
11258.0;2022;33;GUYANE;MASCULIN;SCOLAIRE;BAC PROFESSIONNEL;BAC PRO PROD;BAC PRO 23303 MENUISERIE ALUMINIUM-VERRE;9;9;7;1;1;0;1;7;0;0;0;1;6;2
11260.0;2022;33;GUYANE;MASCULIN;SCOLAIRE;BAC PROFESSIONNEL;BAC PRO PROD;BAC PRO 23404 TECHNICIEN CONSTRUCTEUR BOIS;20;20;6;11;3;3;0;9;0;0;0;0;9;11
11280.0;2022;33;GUYANE;MASCULIN;SCOLAIRE;BAC PROFESSIONNEL;BAC PRO SERV;BAC PRO 31213 MET.COM.VEN.OP.A ANI.GES.ESP.COM.;84;84;52;26;6;4;2;56;0;1;1;20;34;28
11282.0;2022;33;GUYANE;MASCULIN;SCOLAIRE;BAC PROFESSIONNEL;BAC PRO SERV;BAC PRO 32303 ART.& MET.ART:COM.VIS.VIS.PLURI-M;6;6;1;5;0;0;0;1;0;0;0;1;0;5
11287.0;2022;33;GUYANE;MASCULIN;SCOLAIRE;BAC PROFESSIONNEL;BAC PRO SERV;BAC PRO 34303 GEST. POLLUTIONS PROTEC. ENVIRON.;7;7;1;6;0;0;0;1;0;0;0;1;0;6
11307.0;2022;28;LA REUNION;FEMININ;APPRENTISSAGE;BAC PROFESSIONNEL;BAC PRO SERV;BAC PRO 30001 GESTION-ADMINISTRATION;2;2;2;0;0;0;0;2;0;0;1;1;0;0
11310.0;2022;28;LA REUNION;FEMININ;ENSEIGNEMENT A DISTANCE;BAC TECHNOLOGIQUE;BAC ST2S;BAC ST2S SCIENCES & TECHNO. SANTE & SOCIAL;1;1;0;1;0;0;0;0;0;0;0;0;0;1
11313.0;2022;28;LA REUNION;FEMININ;INDIVIDUEL;BAC PROFESSIONNEL;BAC PRO PROD;BAC PRO AG 21004 CGEA;6;5;3;2;0;0;0;3;0;0;0;0;3;2
11316.0;2022;28;LA REUNION;FEMININ;INDIVIDUEL;BAC PROFESSIONNEL;BAC PRO SERV;BAC PRO 31213 MET.COM.VEN.OP.A ANI.GES.ESP.COM.;1;1;1;0;0;0;0;1;0;0;0;1;0;0
11319.0;2022;28;LA REUNION;FEMININ;INDIVIDUEL;BAC PROFESSIONNEL;BAC PRO SERV;BAC PRO 33603 ESTHETIQUE COSMETIQUE PARFUMERIE;1;1;1;0;0;0;0;1;0;1;0;0;0;0
11323.0;2022;28;LA REUNION;FEMININ;INDIVIDUEL;BAC TECHNOLOGIQUE;BAC STMG;BAC STMG GESTION ET FINANCE;2;1;1;0;0;0;0;1;0;0;0;0;1;0
11333.0;2022;28;LA REUNION;FEMININ;SCOLAIRE;BAC PROFESSIONNEL;BAC PRO PROD;BAC PRO 22703 TECHN.INSTALL.SYST.ENERG.CLIMATI;1;1;1;0;0;0;0;1;0;0;0;1;0;0
11336.0;2022;28;LA REUNION;FEMININ;SCOLAIRE;BAC PROFESSIONNEL;BAC PRO PROD;BAC PRO 23005 TECHN. ETUDES BAT B ASSIST.ARCHI.;8;8;7;1;0;0;0;7;0;0;0;5;2;1
11337.0;2022;28;LA REUNION;FEMININ;SCOLAIRE;BAC PROFESSIONNEL;BAC PRO PROD;BACPRO 23103 TECHNICIEN GEOMETRE-TOPOGRAPHE;1;1;1;0;0;0;0;1;0;0;0;1;0;0
11364.0;2022;28;LA REUNION;FEMININ;SCOLAIRE;BAC PROFESSIONNEL;BAC PRO SERV;BAC PRO 32303 ART.& MET.ART:COM.VIS.VIS.PLURI-M;8;8;4;4;0;0;0;4;0;0;0;1;3;4
11377.0;2022;28;LA REUNION;FEMININ;SCOLAIRE;BAC TECHNOLOGIQUE;BAC STD2A;BAC STD2A SCIENCES & TECHNO. DESIGN-ARTS APPLIQUES;29;29;29;0;0;0;0;29;0;5;11;12;1;0
11378.0;2022;28;LA REUNION;FEMININ;SCOLAIRE;BAC TECHNOLOGIQUE;BAC STHR;BAC STHR SC.&TEC. HOTELLERIE-RESTAURATION;16;16;12;0;4;4;0;16;0;0;3;4;9;0
11381.0;2022;28;LA REUNION;FEMININ;SCOLAIRE;BAC TECHNOLOGIQUE;BAC STI2D;BAC STI2D INNOVATION TECHNO.  ET ECO CONCEPTION;9;9;6;0;3;2;1;8;0;1;0;1;6;1
11385.0;2022;28;LA REUNION;FEMININ;SCOLAIRE;BAC TECHNOLOGIQUE;BAC STMG;BAC STMG GESTION ET FINANCE;203;203;171;9;23;15;8;186;1;7;29;72;77;17
11394.0;2022;28;LA REUNION;MASCULIN;APPRENTISSAGE;BAC PROFESSIONNEL;BAC PRO PROD;BAC PRO 25007 MAINTENANCE EQUIPEMENTS INDUST.;4;4;3;1;0;0;0;3;0;1;0;2;0;1
11397.0;2022;28;LA REUNION;MASCULIN;APPRENTISSAGE;BAC PROFESSIONNEL;BAC PRO PROD;BAC PRO 25215 MAINT.VEHIC.OPTB VEHIC.TRANS.ROUT;6;6;5;0;1;1;0;6;0;1;1;2;2;0
11399.0;2022;28;LA REUNION;MASCULIN;APPRENTISSAGE;BAC PROFESSIONNEL;BAC PRO PROD;BAC PRO 25408 REPARATION DES CARROSSERIES;6;6;4;1;1;1;0;5;0;1;0;2;2;1
11411.0;2022;28;LA REUNION;MASCULIN;INDIVIDUEL;BAC PROFESSIONNEL;BAC PRO PROD;BAC PRO 25214 MAINT.VEHIC.OPTA VOIT.PARTICUL.;1;0;0;0;0;0;0;0;0;0;0;0;0;0
11416.0;2022;28;LA REUNION;MASCULIN;INDIVIDUEL;BAC PROFESSIONNEL;BAC PRO PROD;BAC PRO AG 22107 TEC CONS VTE ALIMENTATION P.ALIM;1;1;1;0;0;0;0;1;0;0;0;0;1;0
11420.0;2022;28;LA REUNION;MASCULIN;INDIVIDUEL;BAC TECHNOLOGIQUE;BAC STI2D;BAC STI2D INNOVATION TECHNO.  ET ECO CONCEPTION;1;1;0;1;0;0;0;0;0;0;0;0;0;1
11428.0;2022;28;LA REUNION;MASCULIN;SCOLAIRE;BAC PROFESSIONNEL;BAC PRO PROD;BAC PRO 22004 PROC. CHIMIE EAU PAPIERS-CARTONS;13;13;11;0;2;2;0;13;0;0;2;5;6;0
11429.0;2022;28;LA REUNION;MASCULIN;SCOLAIRE;BAC PROFESSIONNEL;BAC PRO PROD;BAC PRO 22105 BOULANGER-PÂTISSIER;9;9;9;0;0;0;0;9;0;0;1;7;1;0
11432.0;2022;28;LA REUNION;MASCULIN;SCOLAIRE;BAC PROFESSIONNEL;BAC PRO PROD;BAC PRO 22703 TECHN.INSTALL.SYST.ENERG.CLIMATI;18;18;14;4;0;0;0;14;0;0;0;8;6;4
11434.0;2022;28;LA REUNION;MASCULIN;SCOLAIRE;BAC PROFESSIONNEL;BAC PRO PROD;BAC PRO 23003 ARTIS. & M.ART:MARCHANDISAGE VIS.;1;1;1;0;0;0;0;1;0;0;0;1;0;0
11436.0;2022;28;LA REUNION;MASCULIN;SCOLAIRE;BAC PROFESSIONNEL;BAC PRO PROD;BAC PRO 23005 TECHN. ETUDES BAT B ASSIST.ARCHI.;46;46;44;1;1;1;0;45;0;0;8;18;19;1
11437.0;2022;28;LA REUNION;MASCULIN;SCOLAIRE;BAC PROFESSIONNEL;BAC PRO PROD;BAC PRO 23102 TRAVAUX PUBLICS;27;27;18;8;1;1;0;19;0;0;1;10;8;8
11441.0;2022;28;LA REUNION;MASCULIN;SCOLAIRE;BAC PROFESSIONNEL;BAC PRO PROD;BAC PRO 23206 INTERV. SUR PATRIMOINE BATI OPT.B;6;6;5;1;0;0;0;5;0;0;1;1;3;1
11444.0;2022;28;LA REUNION;MASCULIN;SCOLAIRE;BAC PROFESSIONNEL;BAC PRO PROD;BAC PRO 23304 AMENAGEMENT FINITION BATIMENT;47;47;32;12;3;1;2;33;0;0;2;10;21;14
11446.0;2022;28;LA REUNION;MASCULIN;SCOLAIRE;BAC PROFESSIONNEL;BAC PRO PROD;BAC PRO 23405 TECHNICIEN MENUISIER AGENCEUR;40;40;31;8;1;1;0;32;0;0;5;5;22;8
11447.0;2022;28;LA REUNION;MASCULIN;SCOLAIRE;BAC PROFESSIONNEL;BAC PRO PROD;BAC PRO 23407 TECHNIC.FAB.BOIS ET MATERX ASSOC;18;18;7;7;4;4;0;11;0;0;0;2;9;7
11448.0;2022;28;LA REUNION;MASCULIN;SCOLAIRE;BAC PROFESSIONNEL;BAC PRO PROD;BAC PRO 23408 Etude et réalisation d'agencement;7;7;5;2;0;0;0;5;0;0;0;3;2;2
11461.0;2022;28;LA REUNION;MASCULIN;SCOLAIRE;BAC PROFESSIONNEL;BAC PRO PROD;BAC PRO 25509 TECHNIC. FROID CONDITIONNEMT AIR;21;21;17;2;2;1;1;18;0;0;3;6;9;3
11462.0;2022;28;LA REUNION;MASCULIN;SCOLAIRE;BAC PROFESSIONNEL;BAC PRO PROD;BAC PRO 25510 METIERS ELECT. ENVIRON. CONNECTES;252;252;205;31;16;12;4;217;0;14;26;73;104;35
11466.0;2022;28;LA REUNION;MASCULIN;SCOLAIRE;BAC PROFESSIONNEL;BAC PRO PROD;BAC PRO AG 21001 AGRO-EQUIPEMENT;10;8;5;3;0;0;0;5;0;0;0;2;3;3
11479.0;2022;28;LA REUNION;MASCULIN;SCOLAIRE;BAC PROFESSIONNEL;BAC PRO SERV;BAC PRO 32207 REAL.PR.IMPR.PLURI.OPTA.PR.GRAPH.;9;9;8;1;0;0;0;8;0;0;2;3;3;1
11484.0;2022;28;LA REUNION;MASCULIN;SCOLAIRE;BAC PROFESSIONNEL;BAC PRO SERV;BAC PRO 33004 ACC.SOINS-S.PERS. OPT.EN STRUCTUR;10;10;7;2;1;1;0;8;0;1;0;5;2;2
11488.0;2022;28;LA REUNION;MASCULIN;SCOLAIRE;BAC PROFESSIONNEL;BAC PRO SERV;BAC PRO 34304 HYGIENE PROPRETE STERILISATION;11;11;11;0;0;0;0;11;0;0;1;6;4;0
11496.0;2022;28;LA REUNION;MASCULIN;SCOLAIRE;BAC TECHNOLOGIQUE;BAC STI2D;BAC STI2D ENERGIES  ET ENVIRONNEMENT;117;117;90;3;24;19;5;109;0;4;10;29;66;8
11500.0;2022;28;LA REUNION;MASCULIN;SCOLAIRE;BAC TECHNOLOGIQUE;BAC STL;BAC STL SCIENCES PHYSIQUES CHIMIQUES  EN LABORAT.;11;11;10;0;1;0;1;10;0;0;1;4;5;1
11501.0;2022;28;LA REUNION;MASCULIN;SCOLAIRE;BAC TECHNOLOGIQUE;BAC STMG;BAC STMG GESTION ET FINANCE;165;165;126;16;23;19;4;145;0;5;14;55;71;20
11512.0;2022;09;LILLE;FEMININ;APPRENTISSAGE;BAC PROFESSIONNEL;BAC PRO PROD;BAC PRO 23405 TECHNICIEN MENUISIER AGENCEUR;1;1;1;0;0;0;0;1;0;0;0;1;0;0
11516.0;2022;09;LILLE;FEMININ;APPRENTISSAGE;BAC PROFESSIONNEL;BAC PRO PROD;BAC PRO 25214 MAINT.VEHIC.OPTA VOIT.PARTICUL.;3;3;3;0;0;0;0;3;0;0;1;0;2;0
11521.0;2022;09;LILLE;FEMININ;APPRENTISSAGE;BAC PROFESSIONNEL;BAC PRO PROD;BAC PRO 25510 METIERS ELECT. ENVIRON. CONNECTES;3;3;3;0;0;0;0;3;0;3;0;0;0;0
11526.0;2022;09;LILLE;FEMININ;APPRENTISSAGE;BAC PROFESSIONNEL;BAC PRO PROD;BAC PRO AG 21405 AMENAGEMENTS PAYSAGERS;2;1;0;1;0;0;0;0;0;0;0;0;0;1
11528.0;2022;09;LILLE;FEMININ;APPRENTISSAGE;BAC PROFESSIONNEL;BAC PRO SERV;BAC PRO 30001 GESTION-ADMINISTRATION;17;16;14;1;1;1;0;15;0;5;3;5;2;1
11529.0;2022;09;LILLE;FEMININ;APPRENTISSAGE;BAC PROFESSIONNEL;BAC PRO SERV;BAC PRO 31106 LOGISTIQUE;6;5;5;0;0;0;0;5;0;0;2;2;1;0
11530.0;2022;09;LILLE;FEMININ;APPRENTISSAGE;BAC PROFESSIONNEL;BAC PRO SERV;BAC PRO 31212 METIERS DE L'ACCUEIL;6;6;5;1;0;0;0;5;0;3;2;0;0;1
11533.0;2022;09;LILLE;FEMININ;APPRENTISSAGE;BAC PROFESSIONNEL;BAC PRO SERV;BAC PRO 32303 ART.& MET.ART:COM.VIS.VIS.PLURI-M;3;3;3;0;0;0;0;3;0;1;0;1;1;0
11536.0;2022;09;LILLE;FEMININ;APPRENTISSAGE;BAC PROFESSIONNEL;BAC PRO SERV;BAC PRO AG 33002 SERV PERS TERRIT;9;8;7;1;0;0;0;7;0;0;1;3;3;1
11537.0;2022;09;LILLE;FEMININ;ENSEIGNEMENT A DISTANCE;BAC GENERAL;BAC GENERAL;BAC GENE 10019 BAC GENERAL;59;58;41;8;9;4;5;45;0;3;9;13;20;13
11540.0;2022;09;LILLE;FEMININ;ENSEIGNEMENT A DISTANCE;BAC PROFESSIONNEL;BAC PRO SERV;BAC PRO 32304 PHOTOGRAPHIE;1;0;0;0;0;0;0;0;0;0;0;0;0;0
11545.0;2022;09;LILLE;FEMININ;ENSEIGNEMENT A DISTANCE;BAC TECHNOLOGIQUE;BAC STMG;BAC STMG MERCATIQUE (MARKETING);1;1;1;0;0;0;0;1;0;0;0;0;1;0
11547.0;2022;09;LILLE;FEMININ;FORMATION CONTINUE;BAC PROFESSIONNEL;BAC PRO PROD;BAC PRO 25007 MAINTENANCE EQUIPEMENTS INDUST.;1;1;1;0;0;0;0;1;0;0;0;1;0;0
11554.0;2022;09;LILLE;FEMININ;FORMATION CONTINUE;BAC PROFESSIONNEL;BAC PRO SERV;BAC PRO 33102 PROTHESE DENTAIRE;1;1;0;1;0;0;0;0;0;0;0;0;0;1
11557.0;2022;09;LILLE;FEMININ;INDIVIDUEL;BAC PROFESSIONNEL;BAC PRO PROD;BAC PRO 25510 METIERS ELECT. ENVIRON. CONNECTES;1;1;0;1;0;0;0;0;0;0;0;0;0;1
11560.0;2022;09;LILLE;FEMININ;INDIVIDUEL;BAC PROFESSIONNEL;BAC PRO PROD;BAC PRO AG 21211 COND GEST ENTR HIPPIQUE;4;3;3;0;0;0;0;3;0;0;0;0;3;0
11567.0;2022;09;LILLE;FEMININ;INDIVIDUEL;BAC PROFESSIONNEL;BAC PRO SERV;BAC PRO 33004 ACC.SOINS-S.PERS. OPT.EN STRUCTUR;2;2;1;1;0;0;0;1;0;0;0;1;0;1
11569.0;2022;09;LILLE;FEMININ;INDIVIDUEL;BAC PROFESSIONNEL;BAC PRO SERV;BAC PRO 34304 HYGIENE PROPRETE STERILISATION;1;0;0;0;0;0;0;0;0;0;0;0;0;0
11571.0;2022;09;LILLE;FEMININ;INDIVIDUEL;BAC TECHNOLOGIQUE;BAC STI2D;BAC STI2D SYSTÈME D'INFORMATION  ET NUMERIQUE;1;1;1;0;0;0;0;1;0;0;0;0;1;0
11574.0;2022;09;LILLE;FEMININ;INDIVIDUEL;BAC TECHNOLOGIQUE;BAC STMG;BAC STMG RESSOURCES HUMAINES ET COMMUNICATION;10;3;1;1;1;1;0;2;0;0;0;0;2;1
11578.0;2022;09;LILLE;FEMININ;SCOLAIRE;BAC PROFESSIONNEL;BAC PRO PROD;BAC PRO 22004 PROC. CHIMIE EAU PAPIERS-CARTONS;8;8;8;0;0;0;0;8;0;0;4;2;2;0
11589.0;2022;09;LILLE;FEMININ;SCOLAIRE;BAC PROFESSIONNEL;BAC PRO PROD;BAC PRO 23304 AMENAGEMENT FINITION BATIMENT;14;14;12;2;0;0;0;12;0;0;3;4;5;2
11590.0;2022;09;LILLE;FEMININ;SCOLAIRE;BAC PROFESSIONNEL;BAC PRO PROD;BAC PRO 23405 TECHNICIEN MENUISIER AGENCEUR;8;7;5;2;0;0;0;5;0;2;0;2;1;2
11592.0;2022;09;LILLE;FEMININ;SCOLAIRE;BAC PROFESSIONNEL;BAC PRO PROD;BAC PRO 23408 Etude et réalisation d'agencement;8;8;8;0;0;0;0;8;0;0;1;3;4;0
11596.0;2022;09;LILLE;FEMININ;SCOLAIRE;BAC PROFESSIONNEL;BAC PRO PROD;BAC PRO 25214 MAINT.VEHIC.OPTA VOIT.PARTICUL.;10;10;9;1;0;0;0;9;0;0;3;3;3;1
11597.0;2022;09;LILLE;FEMININ;SCOLAIRE;BAC PROFESSIONNEL;BAC PRO PROD;BAC PRO 25215 MAINT.VEHIC.OPTB VEHIC.TRANS.ROUT;1;1;1;0;0;0;0;1;0;0;0;1;0;0
11598.0;2022;09;LILLE;FEMININ;SCOLAIRE;BAC PROFESSIONNEL;BAC PRO PROD;BAC PRO 25216 MAINT.VEHIC.OPTC MOTOCYCLES;2;2;1;1;0;0;0;1;0;1;0;0;0;1
11601.0;2022;09;LILLE;FEMININ;SCOLAIRE;BAC PROFESSIONNEL;BAC PRO PROD;BAC PRO 25408 REPARATION DES CARROSSERIES;13;13;12;1;0;0;0;12;0;0;2;5;5;1
11602.0;2022;09;LILLE;FEMININ;SCOLAIRE;BAC PROFESSIONNEL;BAC PRO PROD;BAC PRO 25411 TECH.CHAUDRONNERIE INDUSTRIELLE;4;4;4;0;0;0;0;4;0;2;0;1;1;0
11609.0;2022;09;LILLE;FEMININ;SCOLAIRE;BAC PROFESSIONNEL;BAC PRO PROD;BAC PRO AG 21210 COND GEST ENTR CANIN ET FELIN;16;16;14;2;0;0;0;14;0;0;2;7;5;2
11611.0;2022;09;LILLE;FEMININ;SCOLAIRE;BAC PROFESSIONNEL;BAC PRO PROD;BAC PRO AG 21302 GEST MILIEUX NATURELS FAUNE;9;9;8;1;0;0;0;8;0;1;1;3;3;1
11615.0;2022;09;LILLE;FEMININ;SCOLAIRE;BAC PROFESSIONNEL;BAC PRO PROD;BAC PRO AG 22105 LABORATOIRE CONTROLE QUALITE;17;17;17;0;0;0;0;17;0;0;5;8;4;0
11616.0;2022;09;LILLE;FEMININ;SCOLAIRE;BAC PROFESSIONNEL;BAC PRO PROD;BAC PRO AG 22107 TEC CONS VTE ALIMENTATION P.ALIM;5;5;4;1;0;0;0;4;0;0;1;1;2;1
11625.0;2022;09;LILLE;FEMININ;SCOLAIRE;BAC PROFESSIONNEL;BAC PRO SERV;BAC PRO 32208 REAL.PR.IMPR.PLURI.OPTB.PR.IMPR.;2;2;2;0;0;0;0;2;0;1;1;0;0;0
11631.0;2022;09;LILLE;FEMININ;SCOLAIRE;BAC PROFESSIONNEL;BAC PRO SERV;BAC PRO 33101 OPTIQUE LUNETTERIE;34;34;28;5;1;1;0;29;0;2;11;10;6;5
11632.0;2022;09;LILLE;FEMININ;SCOLAIRE;BAC PROFESSIONNEL;BAC PRO SERV;BAC PRO 33102 PROTHESE DENTAIRE;13;13;9;3;1;1;0;10;0;2;5;1;2;3
11635.0;2022;09;LILLE;FEMININ;SCOLAIRE;BAC PROFESSIONNEL;BAC PRO SERV;BAC PRO 33602 PERRUQUIER POSTICHEUR;3;3;2;1;0;0;0;2;0;0;0;0;2;1
11644.0;2022;09;LILLE;FEMININ;SCOLAIRE;BAC TECHNOLOGIQUE;BAC STD2A;BAC STD2A SCIENCES & TECHNO. DESIGN-ARTS APPLIQUES;162;162;152;3;7;6;1;158;2;18;46;59;33;4
11648.0;2022;09;LILLE;FEMININ;SCOLAIRE;BAC TECHNOLOGIQUE;BAC STI2D;BAC STI2D INNOVATION TECHNO.  ET ECO CONCEPTION;16;16;14;0;2;1;1;15;0;1;3;3;8;1
11651.0;2022;09;LILLE;FEMININ;SCOLAIRE;BAC TECHNOLOGIQUE;BAC STL;BAC STL SCIENCES PHYSIQUES CHIMIQUES  EN LABORAT.;101;101;87;3;11;6;5;93;3;12;14;29;35;8
11663.0;2022;09;LILLE;MASCULIN;APPRENTISSAGE;BAC PROFESSIONNEL;BAC PRO PROD;BAC PRO 23004 TECHN. ETUDES BAT.A ETUDES & ECO.;1;1;0;1;0;0;0;0;0;0;0;0;0;1
11664.0;2022;09;LILLE;MASCULIN;APPRENTISSAGE;BAC PROFESSIONNEL;BAC PRO PROD;BAC PRO 23102 TRAVAUX PUBLICS;68;68;53;11;4;2;2;55;0;2;10;25;18;13
11665.0;2022;09;LILLE;MASCULIN;APPRENTISSAGE;BAC PROFESSIONNEL;BAC PRO PROD;BAC PRO 23203 TECHNICIEN BAT. : ORG.REAL.GROS O;23;23;19;2;2;1;1;20;0;2;3;6;9;3
11667.0;2022;09;LILLE;MASCULIN;APPRENTISSAGE;BAC PROFESSIONNEL;BAC PRO PROD;BAC PRO 23304 AMENAGEMENT FINITION BATIMENT;10;10;7;2;1;1;0;8;0;0;1;5;2;2
11677.0;2022;09;LILLE;MASCULIN;APPRENTISSAGE;BAC PROFESSIONNEL;BAC PRO PROD;BAC PRO 25216 MAINT.VEHIC.OPTC MOTOCYCLES;10;10;8;2;0;0;0;8;0;0;1;5;2;2
11679.0;2022;09;LILLE;MASCULIN;APPRENTISSAGE;BAC PROFESSIONNEL;BAC PRO PROD;BAC PRO 25220 MAINT.MATERIELS OPT.B TP MANUT.;6;5;2;2;1;1;0;3;0;0;0;1;2;2
11680.0;2022;09;LILLE;MASCULIN;APPRENTISSAGE;BAC PROFESSIONNEL;BAC PRO PROD;BAC PRO 25221 MAINT.MATERIELS OPT.C ESP. VERTS;5;5;5;0;0;0;0;5;0;0;1;1;3;0
11681.0;2022;09;LILLE;MASCULIN;APPRENTISSAGE;BAC PROFESSIONNEL;BAC PRO PROD;BAC PRO 25303 AERONAUTIQUE OPTION SYSTEMES;13;13;13;0;0;0;0;13;0;4;4;4;1;0
11684.0;2022;09;LILLE;MASCULIN;APPRENTISSAGE;BAC PROFESSIONNEL;BAC PRO PROD;BAC PRO 25410 CONSTRUCTION DES CARROSSERIES;1;1;0;1;0;0;0;0;0;0;0;0;0;1
11694.0;2022;09;LILLE;MASCULIN;APPRENTISSAGE;BAC PROFESSIONNEL;BAC PRO PROD;BAC PRO AG 21405 AMENAGEMENTS PAYSAGERS;58;55;42;13;0;0;0;42;0;1;5;10;26;13
11708.0;2022;09;LILLE;MASCULIN;ENSEIGNEMENT A DISTANCE;BAC TECHNOLOGIQUE;BAC ST2S;BAC ST2S SCIENCES & TECHNO. SANTE & SOCIAL;1;1;0;1;0;0;0;0;0;0;0;0;0;1
11711.0;2022;09;LILLE;MASCULIN;ENSEIGNEMENT A DISTANCE;BAC TECHNOLOGIQUE;BAC STMG;BAC STMG RESSOURCES HUMAINES ET COMMUNICATION;2;2;1;1;0;0;0;1;0;0;1;0;0;1
11714.0;2022;09;LILLE;MASCULIN;FORMATION CONTINUE;BAC PROFESSIONNEL;BAC PRO PROD;BAC PRO 22704 TECHN. MAINT. SYST.ENERG.CLIMATI;8;7;7;0;0;0;0;7;0;0;2;3;2;0
11724.0;2022;09;LILLE;MASCULIN;FORMATION CONTINUE;BAC PROFESSIONNEL;BAC PRO PROD;BAC PRO 25515 SYST.NUM.OPT.C RES.INF.SYST.COMM.;8;8;6;2;0;0;0;6;0;3;0;2;1;2
11727.0;2022;09;LILLE;MASCULIN;FORMATION CONTINUE;BAC PROFESSIONNEL;BAC PRO SERV;BAC PRO 31213 MET.COM.VEN.OP.A ANI.GES.ESP.COM.;4;3;1;2;0;0;0;1;0;0;0;1;0;2
11728.0;2022;09;LILLE;MASCULIN;INDIVIDUEL;BAC GENERAL;BAC GENERAL;BAC GENE 10019 BAC GENERAL;108;61;33;13;15;11;4;44;1;6;7;6;24;17
11730.0;2022;09;LILLE;MASCULIN;INDIVIDUEL;BAC PROFESSIONNEL;BAC PRO PROD;BAC PRO 23004 TECHN. ETUDES BAT.A ETUDES & ECO.;2;1;1;0;0;0;0;1;0;0;0;0;1;0
11733.0;2022;09;LILLE;MASCULIN;INDIVIDUEL;BAC PROFESSIONNEL;BAC PRO PROD;BAC PRO 23408 Etude et réalisation d'agencement;1;0;0;0;0;0;0;0;0;0;0;0;0;0
11735.0;2022;09;LILLE;MASCULIN;INDIVIDUEL;BAC PROFESSIONNEL;BAC PRO PROD;BAC PRO 25216 MAINT.VEHIC.OPTC MOTOCYCLES;1;0;0;0;0;0;0;0;0;0;0;0;0;0
11741.0;2022;09;LILLE;MASCULIN;INDIVIDUEL;BAC PROFESSIONNEL;BAC PRO PROD;BAC PRO AG 21114 CONDUITE PRODUCTIONS HORTICOLES;1;0;0;0;0;0;0;0;0;0;0;0;0;0
11744.0;2022;09;LILLE;MASCULIN;INDIVIDUEL;BAC PROFESSIONNEL;BAC PRO PROD;BAC PRO AG 21407 TEC CONS VTE UNIVERS JARDINERIE;1;0;0;0;0;0;0;0;0;0;0;0;0;0
11745.0;2022;09;LILLE;MASCULIN;INDIVIDUEL;BAC PROFESSIONNEL;BAC PRO SERV;BAC PRO 30001 GESTION-ADMINISTRATION;3;3;1;2;0;0;0;1;0;0;0;1;0;2
11747.0;2022;09;LILLE;MASCULIN;INDIVIDUEL;BAC PROFESSIONNEL;BAC PRO SERV;BAC PRO 31213 MET.COM.VEN.OP.A ANI.GES.ESP.COM.;2;0;0;0;0;0;0;0;0;0;0;0;0;0
11748.0;2022;09;LILLE;MASCULIN;INDIVIDUEL;BAC PROFESSIONNEL;BAC PRO SERV;BAC PRO 31214 MET.COM.VEN.OP.B PR.CL.VA.OF.COM.;1;0;0;0;0;0;0;0;0;0;0;0;0;0
11754.0;2022;09;LILLE;MASCULIN;INDIVIDUEL;BAC TECHNOLOGIQUE;BAC STI2D;BAC STI2D ENERGIES  ET ENVIRONNEMENT;1;1;1;0;0;0;0;1;0;0;0;0;1;0
11764.0;2022;09;LILLE;MASCULIN;SCOLAIRE;BAC PROFESSIONNEL;BAC PRO PROD;BAC PRO 22105 BOULANGER-PÂTISSIER;83;83;71;11;1;0;1;71;0;3;22;26;20;12
11770.0;2022;09;LILLE;MASCULIN;SCOLAIRE;BAC PROFESSIONNEL;BAC PRO PROD;BAC PRO 22704 TECHN. MAINT. SYST.ENERG.CLIMATI;56;55;32;22;1;0;1;32;0;0;6;11;15;23
11774.0;2022;09;LILLE;MASCULIN;SCOLAIRE;BAC PROFESSIONNEL;BAC PRO PROD;BAC PRO 23102 TRAVAUX PUBLICS;35;35;28;5;2;2;0;30;0;3;8;7;12;5
11791.0;2022;09;LILLE;MASCULIN;SCOLAIRE;BAC PROFESSIONNEL;BAC PRO PROD;BAC PRO 25220 MAINT.MATERIELS OPT.B TP MANUT.;30;30;28;2;0;0;0;28;0;0;2;11;15;2
11803.0;2022;09;LILLE;MASCULIN;SCOLAIRE;BAC PROFESSIONNEL;BAC PRO PROD;BAC PRO AG 21004 CGEA;134;133;111;22;0;0;0;111;0;2;16;31;62;22
11819.0;2022;09;LILLE;MASCULIN;SCOLAIRE;BAC PROFESSIONNEL;BAC PRO SERV;BAC PRO 31212 METIERS DE L'ACCUEIL;108;108;81;21;6;4;2;85;0;3;18;29;35;23
11820.0;2022;09;LILLE;MASCULIN;SCOLAIRE;BAC PROFESSIONNEL;BAC PRO SERV;BAC PRO 31213 MET.COM.VEN.OP.A ANI.GES.ESP.COM.;1014;996;689;263;44;27;17;716;0;13;120;216;367;280
11823.0;2022;09;LILLE;MASCULIN;SCOLAIRE;BAC PROFESSIONNEL;BAC PRO SERV;BAC PRO 32208 REAL.PR.IMPR.PLURI.OPTB.PR.IMPR.;7;7;2;3;2;1;1;3;0;0;1;0;2;4
11828.0;2022;09;LILLE;MASCULIN;SCOLAIRE;BAC PROFESSIONNEL;BAC PRO SERV;BAC PRO 33004 ACC.SOINS-S.PERS. OPT.EN STRUCTUR;112;112;97;14;1;0;1;97;0;4;20;39;34;15
11832.0;2022;09;LILLE;MASCULIN;SCOLAIRE;BAC PROFESSIONNEL;BAC PRO SERV;BAC PRO 33403 COMMERC. SERVICES EN RESTAURATION;116;116;84;28;4;3;1;87;0;5;14;21;47;29
11833.0;2022;09;LILLE;MASCULIN;SCOLAIRE;BAC PROFESSIONNEL;BAC PRO SERV;BAC PRO 33603 ESTHETIQUE COSMETIQUE PARFUMERIE;1;1;1;0;0;0;0;1;0;0;0;0;1;0
11835.0;2022;09;LILLE;MASCULIN;SCOLAIRE;BAC PROFESSIONNEL;BAC PRO SERV;BAC PRO 34403 METIERS DE LA SECURITE;197;197;174;11;12;9;3;183;0;3;29;71;80;14
11838.0;2022;09;LILLE;MASCULIN;SCOLAIRE;BAC TECHNOLOGIQUE;BAC S2TMD;BAC S2TMD MUSIQUE;10;10;9;0;1;1;0;10;1;0;1;5;3;0
11840.0;2022;09;LILLE;MASCULIN;SCOLAIRE;BAC TECHNOLOGIQUE;BAC STAV;BAC STAV AGRONOMIE ALIM ENV TERRITOI;190;190;187;3;0;0;0;187;0;1;23;65;98;3
11844.0;2022;09;LILLE;MASCULIN;SCOLAIRE;BAC TECHNOLOGIQUE;BAC STI2D;BAC STI2D ENERGIES  ET ENVIRONNEMENT;229;229;186;7;36;25;11;211;0;5;28;62;116;18
11850.0;2022;09;LILLE;MASCULIN;SCOLAIRE;BAC TECHNOLOGIQUE;BAC STMG;BAC STMG MERCATIQUE (MARKETING);1040;1040;721;96;223;168;55;889;0;8;56;231;594;151
11860.0;2022;22;LIMOGES;FEMININ;APPRENTISSAGE;BAC PROFESSIONNEL;BAC PRO SERV;BAC PRO 30001 GESTION-ADMINISTRATION;3;3;3;0;0;0;0;3;0;0;1;2;0;0
11863.0;2022;22;LIMOGES;FEMININ;APPRENTISSAGE;BAC PROFESSIONNEL;BAC PRO SERV;BAC PRO 33101 OPTIQUE LUNETTERIE;1;1;1;0;0;0;0;1;0;0;1;0;0;0
11869.0;2022;22;LIMOGES;FEMININ;FORMATION CONTINUE;BAC PROFESSIONNEL;BAC PRO PROD;BAC PRO 23102 TRAVAUX PUBLICS;1;1;1;0;0;0;0;1;0;0;0;1;0;0
11871.0;2022;22;LIMOGES;FEMININ;INDIVIDUEL;BAC GENERAL;BAC GENERAL;BAC GENE 10019 BAC GENERAL;10;7;1;3;3;1;2;2;0;1;0;0;1;5
11874.0;2022;22;LIMOGES;FEMININ;INDIVIDUEL;BAC PROFESSIONNEL;BAC PRO PROD;BAC PRO AG 22105 LABORATOIRE CONTROLE QUALITE;1;0;0;0;0;0;0;0;0;0;0;0;0;0
11878.0;2022;22;LIMOGES;FEMININ;INDIVIDUEL;BAC TECHNOLOGIQUE;BAC ST2S;BAC ST2S SCIENCES & TECHNO. SANTE & SOCIAL;2;2;1;1;0;0;0;1;0;0;0;1;0;1
11884.0;2022;22;LIMOGES;FEMININ;SCOLAIRE;BAC PROFESSIONNEL;BAC PRO PROD;BAC PRO 23004 TECHN. ETUDES BAT.A ETUDES & ECO.;1;1;0;1;0;0;0;0;0;0;0;0;0;1
11894.0;2022;22;LIMOGES;FEMININ;SCOLAIRE;BAC PROFESSIONNEL;BAC PRO PROD;BAC PRO 25214 MAINT.VEHIC.OPTA VOIT.PARTICUL.;1;1;1;0;0;0;0;1;0;0;0;0;1;0
11905.0;2022;22;LIMOGES;FEMININ;SCOLAIRE;BAC PROFESSIONNEL;BAC PRO SERV;BAC PRO 30001 GESTION-ADMINISTRATION;83;83;60;19;4;1;3;61;0;1;8;23;29;22
11913.0;2022;22;LIMOGES;FEMININ;SCOLAIRE;BAC PROFESSIONNEL;BAC PRO SERV;BAC PRO 32303 ART.& MET.ART:COM.VIS.VIS.PLURI-M;7;7;5;2;0;0;0;5;0;0;2;2;1;2
11916.0;2022;22;LIMOGES;FEMININ;SCOLAIRE;BAC PROFESSIONNEL;BAC PRO SERV;BAC PRO 33004 ACC.SOINS-S.PERS. OPT.EN STRUCTUR;131;130;107;21;2;2;0;109;0;6;17;53;33;21
11919.0;2022;22;LIMOGES;FEMININ;SCOLAIRE;BAC PROFESSIONNEL;BAC PRO SERV;BAC PRO 33603 ESTHETIQUE COSMETIQUE PARFUMERIE;35;35;31;4;0;0;0;31;0;2;5;12;12;4
11931.0;2022;22;LIMOGES;FEMININ;SCOLAIRE;BAC TECHNOLOGIQUE;BAC STL;BAC STL BIOCHIM.-BIOLOGIE-BIOTECHNOL.;49;49;42;2;5;4;1;46;0;1;7;21;17;3
11935.0;2022;22;LIMOGES;FEMININ;SCOLAIRE;BAC TECHNOLOGIQUE;BAC STMG;BAC STMG RESSOURCES HUMAINES ET COMMUNICATION;104;104;84;4;16;9;7;93;0;0;7;40;46;11
11936.0;2022;22;LIMOGES;FEMININ;SCOLAIRE;BAC TECHNOLOGIQUE;BAC STMG;BAC STMG SYSTEMES D'INFORMATION DE GESTION;4;4;1;0;3;1;2;2;0;0;0;0;2;2
11937.0;2022;22;LIMOGES;MASCULIN;APPRENTISSAGE;BAC PROFESSIONNEL;BAC PRO PROD;BAC PRO 20102 PILOTE DE LIGNE DE PRODUCTION;1;1;1;0;0;0;0;1;0;0;1;0;0;0
11938.0;2022;22;LIMOGES;MASCULIN;APPRENTISSAGE;BAC PROFESSIONNEL;BAC PRO PROD;BAC PRO 22106 CUISINE;2;2;0;1;1;0;1;0;0;0;0;0;0;2
11943.0;2022;22;LIMOGES;MASCULIN;APPRENTISSAGE;BAC PROFESSIONNEL;BAC PRO PROD;BAC PRO 23207 INTERV. SUR PATRIMOINE BATI OPT.C;1;1;1;0;0;0;0;1;0;0;0;1;0;0
11953.0;2022;22;LIMOGES;MASCULIN;APPRENTISSAGE;BAC PROFESSIONNEL;BAC PRO PROD;BAC PRO 25216 MAINT.VEHIC.OPTC MOTOCYCLES;3;3;3;0;0;0;0;3;0;0;0;1;2;0
11954.0;2022;22;LIMOGES;MASCULIN;APPRENTISSAGE;BAC PROFESSIONNEL;BAC PRO PROD;BAC PRO 25219 MAINT.MATERIELS OPT.A AGRICOLES;3;3;3;0;0;0;0;3;0;1;1;0;1;0
11955.0;2022;22;LIMOGES;MASCULIN;APPRENTISSAGE;BAC PROFESSIONNEL;BAC PRO PROD;BAC PRO 25220 MAINT.MATERIELS OPT.B TP MANUT.;1;1;0;1;0;0;0;0;0;0;0;0;0;1
11958.0;2022;22;LIMOGES;MASCULIN;APPRENTISSAGE;BAC PROFESSIONNEL;BAC PRO PROD;BAC PRO 25411 TECH.CHAUDRONNERIE INDUSTRIELLE;3;3;2;0;1;1;0;3;0;0;1;1;1;0
11961.0;2022;22;LIMOGES;MASCULIN;APPRENTISSAGE;BAC PROFESSIONNEL;BAC PRO PROD;BAC PRO AG 21004 CGEA;24;24;20;4;0;0;0;20;0;0;0;3;17;4
11962.0;2022;22;LIMOGES;MASCULIN;APPRENTISSAGE;BAC PROFESSIONNEL;BAC PRO PROD;BAC PRO AG 21405 AMENAGEMENTS PAYSAGERS;12;12;10;2;0;0;0;10;0;0;1;1;8;2
11974.0;2022;22;LIMOGES;MASCULIN;FORMATION CONTINUE;BAC PROFESSIONNEL;BAC PRO SERV;BAC PRO 30001 GESTION-ADMINISTRATION;2;2;2;0;0;0;0;2;0;0;1;1;0;0
11977.0;2022;22;LIMOGES;MASCULIN;INDIVIDUEL;BAC PROFESSIONNEL;BAC PRO PROD;BAC PRO 25219 MAINT.MATERIELS OPT.A AGRICOLES;1;1;1;0;0;0;0;1;0;0;0;0;1;0
11980.0;2022;22;LIMOGES;MASCULIN;INDIVIDUEL;BAC PROFESSIONNEL;BAC PRO PROD;BAC PRO AG 21114 CONDUITE PRODUCTIONS HORTICOLES;7;4;4;0;0;0;0;4;0;0;0;0;4;0
11985.0;2022;22;LIMOGES;MASCULIN;INDIVIDUEL;BAC TECHNOLOGIQUE;BAC STMG;BAC STMG GESTION ET FINANCE;1;1;0;1;0;0;0;0;0;0;0;0;0;1
11993.0;2022;22;LIMOGES;MASCULIN;SCOLAIRE;BAC PROFESSIONNEL;BAC PRO PROD;BAC PRO 23004 TECHN. ETUDES BAT.A ETUDES & ECO.;5;5;5;0;0;0;0;5;0;0;3;2;0;0
11996.0;2022;22;LIMOGES;MASCULIN;SCOLAIRE;BAC PROFESSIONNEL;BAC PRO PROD;BAC PRO 23203 TECHNICIEN BAT. : ORG.REAL.GROS O;4;4;4;0;0;0;0;4;0;2;0;2;0;0
11999.0;2022;22;LIMOGES;MASCULIN;SCOLAIRE;BAC PROFESSIONNEL;BAC PRO PROD;BAC PRO 23405 TECHNICIEN MENUISIER AGENCEUR;14;14;13;1;0;0;0;13;0;4;4;2;3;1
12004.0;2022;22;LIMOGES;MASCULIN;SCOLAIRE;BAC PROFESSIONNEL;BAC PRO PROD;BAC PRO 25108 TECHNICIEN MODELEUR;7;7;7;0;0;0;0;7;0;0;2;2;3;0
12008.0;2022;22;LIMOGES;MASCULIN;SCOLAIRE;BAC PROFESSIONNEL;BAC PRO PROD;BAC PRO 25219 MAINT.MATERIELS OPT.A AGRICOLES;26;26;20;5;1;0;1;20;0;0;4;9;7;6
12016.0;2022;22;LIMOGES;MASCULIN;SCOLAIRE;BAC PROFESSIONNEL;BAC PRO PROD;BAC PRO 25514 SYST.NUM.OPT.B AUD.RES.EQUIP.DOM.;32;32;25;5;2;1;1;26;0;0;4;8;14;6
12027.0;2022;22;LIMOGES;MASCULIN;SCOLAIRE;BAC PROFESSIONNEL;BAC PRO SERV;BAC PRO 30001 GESTION-ADMINISTRATION;42;42;22;18;2;0;2;22;0;0;4;8;10;20
12035.0;2022;22;LIMOGES;MASCULIN;SCOLAIRE;BAC PROFESSIONNEL;BAC PRO SERV;BAC PRO 32208 REAL.PR.IMPR.PLURI.OPTB.PR.IMPR.;9;9;9;0;0;0;0;9;0;1;4;2;2;0
12036.0;2022;22;LIMOGES;MASCULIN;SCOLAIRE;BAC PROFESSIONNEL;BAC PRO SERV;BAC PRO 32303 ART.& MET.ART:COM.VIS.VIS.PLURI-M;4;4;2;2;0;0;0;2;0;0;0;1;1;2
12045.0;2022;22;LIMOGES;MASCULIN;SCOLAIRE;BAC TECHNOLOGIQUE;BAC ST2S;BAC ST2S SCIENCES & TECHNO. SANTE & SOCIAL;44;44;33;2;9;5;4;38;0;1;3;11;23;6
12049.0;2022;22;LIMOGES;MASCULIN;SCOLAIRE;BAC TECHNOLOGIQUE;BAC STI2D;BAC STI2D ARCHITECTURE ET CONSTRUCTION;46;46;32;4;10;8;2;40;0;0;6;9;25;6
12061.0;2022;10;LYON;FEMININ;APPRENTISSAGE;BAC PROFESSIONNEL;BAC PRO PROD;BAC PRO 22106 CUISINE;4;4;3;0;1;1;0;4;0;0;0;2;2;0
12064.0;2022;10;LYON;FEMININ;APPRENTISSAGE;BAC PROFESSIONNEL;BAC PRO PROD;BACPRO 23103 TECHNICIEN GEOMETRE-TOPOGRAPHE;1;1;1;0;0;0;0;1;0;0;0;1;0;0
12069.0;2022;10;LYON;FEMININ;APPRENTISSAGE;BAC PROFESSIONNEL;BAC PRO PROD;BAC PRO 24203 METIERS DE LA MODE - VÊTEMENT;4;4;3;0;1;1;0;4;0;1;1;0;2;0
12073.0;2022;10;LYON;FEMININ;APPRENTISSAGE;BAC PROFESSIONNEL;BAC PRO PROD;BAC PRO 25214 MAINT.VEHIC.OPTA VOIT.PARTICUL.;7;7;7;0;0;0;0;7;0;2;2;2;1;0
12074.0;2022;10;LYON;FEMININ;APPRENTISSAGE;BAC PROFESSIONNEL;BAC PRO PROD;BAC PRO 25216 MAINT.VEHIC.OPTC MOTOCYCLES;1;1;1;0;0;0;0;1;0;1;0;0;0;0
12079.0;2022;10;LYON;FEMININ;APPRENTISSAGE;BAC PROFESSIONNEL;BAC PRO PROD;BAC PRO 25510 METIERS ELECT. ENVIRON. CONNECTES;1;1;1;0;0;0;0;1;0;1;0;0;0;0
12081.0;2022;10;LYON;FEMININ;APPRENTISSAGE;BAC PROFESSIONNEL;BAC PRO PROD;BAC PRO AG 21004 CGEA;3;3;2;1;0;0;0;2;0;0;0;1;1;1
12088.0;2022;10;LYON;FEMININ;APPRENTISSAGE;BAC PROFESSIONNEL;BAC PRO PROD;BAC PRO AG 22107 TEC CONS VTE ALIMENTATION P.ALIM;7;7;6;1;0;0;0;6;0;0;0;1;5;1
12091.0;2022;10;LYON;FEMININ;APPRENTISSAGE;BAC PROFESSIONNEL;BAC PRO SERV;BAC PRO 31212 METIERS DE L'ACCUEIL;8;8;8;0;0;0;0;8;0;1;3;4;0;0
12092.0;2022;10;LYON;FEMININ;APPRENTISSAGE;BAC PROFESSIONNEL;BAC PRO SERV;BAC PRO 31213 MET.COM.VEN.OP.A ANI.GES.ESP.COM.;101;96;76;8;12;9;3;85;0;7;21;23;34;11
12094.0;2022;10;LYON;FEMININ;APPRENTISSAGE;BAC PROFESSIONNEL;BAC PRO SERV;BAC PRO 32207 REAL.PR.IMPR.PLURI.OPTA.PR.GRAPH.;1;1;1;0;0;0;0;1;0;1;0;0;0;0
12101.0;2022;10;LYON;FEMININ;APPRENTISSAGE;BAC PROFESSIONNEL;BAC PRO SERV;BAC PRO AG 33002 SERV PERS TERRIT;7;7;7;0;0;0;0;7;0;1;2;3;1;0
12102.0;2022;10;LYON;FEMININ;ENSEIGNEMENT A DISTANCE;BAC GENERAL;BAC GENERAL;BAC GENE 10019 BAC GENERAL;60;60;40;11;9;4;5;44;1;3;5;15;20;16
12107.0;2022;10;LYON;FEMININ;ENSEIGNEMENT A DISTANCE;BAC TECHNOLOGIQUE;BAC STMG;BAC STMG SYSTEMES D'INFORMATION DE GESTION;1;1;1;0;0;0;0;1;0;0;1;0;0;0
12108.0;2022;10;LYON;FEMININ;FORMATION CONTINUE;BAC PROFESSIONNEL;BAC PRO PROD;BAC PRO AG 21114 CONDUITE PRODUCTIONS HORTICOLES;1;1;1;0;0;0;0;1;0;0;0;0;1;0
12111.0;2022;10;LYON;FEMININ;FORMATION CONTINUE;BAC PROFESSIONNEL;BAC PRO SERV;BAC PRO 33102 PROTHESE DENTAIRE;3;2;1;1;0;0;0;1;0;0;1;0;0;1
12114.0;2022;10;LYON;FEMININ;INDIVIDUEL;BAC PROFESSIONNEL;BAC PRO PROD;BAC PRO AG 21114 CONDUITE PRODUCTIONS HORTICOLES;7;6;6;0;0;0;0;6;0;0;0;0;6;0
12125.0;2022;10;LYON;FEMININ;INDIVIDUEL;BAC PROFESSIONNEL;BAC PRO SERV;BAC PRO 33603 ESTHETIQUE COSMETIQUE PARFUMERIE;3;1;0;1;0;0;0;0;0;0;0;0;0;1
12126.0;2022;10;LYON;FEMININ;INDIVIDUEL;BAC PROFESSIONNEL;BAC PRO SERV;BAC PRO 34304 HYGIENE PROPRETE STERILISATION;1;1;0;1;0;0;0;0;0;0;0;0;0;1
12127.0;2022;10;LYON;FEMININ;INDIVIDUEL;BAC TECHNOLOGIQUE;BAC S2TMD;BAC S2TMD DANSE;1;1;1;0;0;0;0;1;0;1;0;0;0;0
12130.0;2022;10;LYON;FEMININ;INDIVIDUEL;BAC TECHNOLOGIQUE;BAC STI2D;BAC STI2D ARCHITECTURE ET CONSTRUCTION;1;1;0;1;0;0;0;0;0;0;0;0;0;1
12132.0;2022;10;LYON;FEMININ;INDIVIDUEL;BAC TECHNOLOGIQUE;BAC STMG;BAC STMG GESTION ET FINANCE;3;3;1;0;2;1;1;2;0;0;0;0;2;1
12137.0;2022;10;LYON;FEMININ;SCOLAIRE;BAC PROFESSIONNEL;BAC PRO PROD;BAC PRO 20102 PILOTE DE LIGNE DE PRODUCTION;2;2;2;0;0;0;0;2;0;0;2;0;0;0
12139.0;2022;10;LYON;FEMININ;SCOLAIRE;BAC PROFESSIONNEL;BAC PRO PROD;BAC PRO 22004 PROC. CHIMIE EAU PAPIERS-CARTONS;2;2;2;0;0;0;0;2;0;0;0;1;1;0
12144.0;2022;10;LYON;FEMININ;SCOLAIRE;BAC PROFESSIONNEL;BAC PRO PROD;BAC PRO 23004 TECHN. ETUDES BAT.A ETUDES & ECO.;4;4;3;1;0;0;0;3;0;0;0;0;3;1
12145.0;2022;10;LYON;FEMININ;SCOLAIRE;BAC PROFESSIONNEL;BAC PRO PROD;BAC PRO 23005 TECHN. ETUDES BAT B ASSIST.ARCHI.;11;11;10;1;0;0;0;10;0;1;2;4;3;1
12146.0;2022;10;LYON;FEMININ;SCOLAIRE;BAC PROFESSIONNEL;BAC PRO PROD;BAC PRO 23203 TECHNICIEN BAT. : ORG.REAL.GROS O;1;1;0;1;0;0;0;0;0;0;0;0;0;1
12152.0;2022;10;LYON;FEMININ;SCOLAIRE;BAC PROFESSIONNEL;BAC PRO PROD;BAC PRO 24203 METIERS DE LA MODE - VÊTEMENT;129;129;103;22;4;2;2;105;0;13;24;47;21;24
12156.0;2022;10;LYON;FEMININ;SCOLAIRE;BAC PROFESSIONNEL;BAC PRO PROD;BAC PRO 25106 TECHNICIEN D'USINAGE;5;5;4;1;0;0;0;4;0;0;2;1;1;1
12157.0;2022;10;LYON;FEMININ;SCOLAIRE;BAC PROFESSIONNEL;BAC PRO PROD;BAC PRO 25108 TECHNICIEN MODELEUR;1;1;1;0;0;0;0;1;0;0;1;0;0;0
12168.0;2022;10;LYON;FEMININ;SCOLAIRE;BAC PROFESSIONNEL;BAC PRO PROD;BAC PRO AG 21113 CGEVV;2;2;2;0;0;0;0;2;0;0;0;1;1;0
12169.0;2022;10;LYON;FEMININ;SCOLAIRE;BAC PROFESSIONNEL;BAC PRO PROD;BAC PRO AG 21114 CONDUITE PRODUCTIONS HORTICOLES;17;17;15;2;0;0;0;15;0;0;3;4;8;2
12174.0;2022;10;LYON;FEMININ;SCOLAIRE;BAC PROFESSIONNEL;BAC PRO PROD;BAC PRO AG 21302 GEST MILIEUX NATURELS FAUNE;9;9;9;0;0;0;0;9;0;0;2;4;3;0
12175.0;2022;10;LYON;FEMININ;SCOLAIRE;BAC PROFESSIONNEL;BAC PRO PROD;BAC PRO AG 21405 AMENAGEMENTS PAYSAGERS;3;3;3;0;0;0;0;3;0;0;2;1;0;0
12193.0;2022;10;LYON;FEMININ;SCOLAIRE;BAC PROFESSIONNEL;BAC PRO SERV;BAC PRO 33101 OPTIQUE LUNETTERIE;19;19;18;1;0;0;0;18;0;3;6;5;4;1
12197.0;2022;10;LYON;FEMININ;SCOLAIRE;BAC PROFESSIONNEL;BAC PRO SERV;BAC PRO 33603 ESTHETIQUE COSMETIQUE PARFUMERIE;189;188;157;29;2;1;1;158;0;2;25;52;79;30
12204.0;2022;10;LYON;FEMININ;SCOLAIRE;BAC TECHNOLOGIQUE;BAC STAV;BAC STAV AGRONOMIE ALIM ENV TERRITOI;101;101;100;1;0;0;0;100;0;1;12;42;45;1
12207.0;2022;10;LYON;FEMININ;SCOLAIRE;BAC TECHNOLOGIQUE;BAC STI2D;BAC STI2D ARCHITECTURE ET CONSTRUCTION;54;54;41;4;9;5;4;46;0;1;7;19;19;8
12209.0;2022;10;LYON;FEMININ;SCOLAIRE;BAC TECHNOLOGIQUE;BAC STI2D;BAC STI2D INNOVATION TECHNO.  ET ECO CONCEPTION;36;36;23;5;8;7;1;30;0;2;4;8;16;6
12212.0;2022;10;LYON;FEMININ;SCOLAIRE;BAC TECHNOLOGIQUE;BAC STL;BAC STL SCIENCES PHYSIQUES CHIMIQUES  EN LABORAT.;85;85;67;4;14;6;8;73;0;2;11;22;38;12
12215.0;2022;10;LYON;FEMININ;SCOLAIRE;BAC TECHNOLOGIQUE;BAC STMG;BAC STMG RESSOURCES HUMAINES ET COMMUNICATION;612;612;444;47;121;85;36;529;1;5;45;157;321;83
12217.0;2022;10;LYON;MASCULIN;APPRENTISSAGE;BAC PROFESSIONNEL;BAC PRO PROD;BAC PRO 20102 PILOTE DE LIGNE DE PRODUCTION;3;3;3;0;0;0;0;3;0;0;0;0;3;0
12224.0;2022;10;LYON;MASCULIN;APPRENTISSAGE;BAC PROFESSIONNEL;BAC PRO PROD;BAC PRO 22703 TECHN.INSTALL.SYST.ENERG.CLIMATI;52;52;37;10;5;3;2;40;0;0;8;19;13;12
12234.0;2022;10;LYON;MASCULIN;APPRENTISSAGE;BAC PROFESSIONNEL;BAC PRO PROD;BAC PRO 23405 TECHNICIEN MENUISIER AGENCEUR;29;27;25;1;1;1;0;26;0;3;8;9;6;1
12241.0;2022;10;LYON;MASCULIN;APPRENTISSAGE;BAC PROFESSIONNEL;BAC PRO PROD;BAC PRO 25106 TECHNICIEN D'USINAGE;40;40;32;8;0;0;0;32;0;0;8;10;14;8
12242.0;2022;10;LYON;MASCULIN;APPRENTISSAGE;BAC PROFESSIONNEL;BAC PRO PROD;BAC PRO 25107 TECHNICIEN OUTILLEUR;7;7;3;3;1;1;0;4;0;0;0;2;2;3
12245.0;2022;10;LYON;MASCULIN;APPRENTISSAGE;BAC PROFESSIONNEL;BAC PRO PROD;BAC PRO 25216 MAINT.VEHIC.OPTC MOTOCYCLES;13;13;8;4;1;1;0;9;0;1;4;2;2;4
12247.0;2022;10;LYON;MASCULIN;APPRENTISSAGE;BAC PROFESSIONNEL;BAC PRO PROD;BAC PRO 25220 MAINT.MATERIELS OPT.B TP MANUT.;26;26;24;1;1;1;0;25;0;1;8;5;11;1
12250.0;2022;10;LYON;MASCULIN;APPRENTISSAGE;BAC PROFESSIONNEL;BAC PRO PROD;BAC PRO 25408 REPARATION DES CARROSSERIES;44;42;37;3;2;2;0;39;0;2;4;17;16;3
12253.0;2022;10;LYON;MASCULIN;APPRENTISSAGE;BAC PROFESSIONNEL;BAC PRO PROD;BAC PRO 25509 TECHNIC. FROID CONDITIONNEMT AIR;22;22;13;9;0;0;0;13;0;0;3;4;6;9
12254.0;2022;10;LYON;MASCULIN;APPRENTISSAGE;BAC PROFESSIONNEL;BAC PRO PROD;BAC PRO 25510 METIERS ELECT. ENVIRON. CONNECTES;111;111;90;17;4;4;0;94;0;17;27;24;26;17
12262.0;2022;10;LYON;MASCULIN;APPRENTISSAGE;BAC PROFESSIONNEL;BAC PRO PROD;BAC PRO AG 21211 COND GEST ENTR HIPPIQUE;3;3;3;0;0;0;0;3;0;0;0;1;2;0
12265.0;2022;10;LYON;MASCULIN;APPRENTISSAGE;BAC PROFESSIONNEL;BAC PRO PROD;BAC PRO AG 21405 AMENAGEMENTS PAYSAGERS;70;67;61;6;0;0;0;61;0;1;4;13;43;6
12274.0;2022;10;LYON;MASCULIN;APPRENTISSAGE;BAC PROFESSIONNEL;BAC PRO SERV;BAC PRO 32303 ART.& MET.ART:COM.VIS.VIS.PLURI-M;6;6;5;1;0;0;0;5;0;0;2;2;1;1
12278.0;2022;10;LYON;MASCULIN;ENSEIGNEMENT A DISTANCE;BAC GENERAL;BAC GENERAL;BAC GENE 10019 BAC GENERAL;29;29;25;1;3;3;0;28;0;4;4;9;11;1
12279.0;2022;10;LYON;MASCULIN;ENSEIGNEMENT A DISTANCE;BAC TECHNOLOGIQUE;BAC STMG;BAC STMG GESTION ET FINANCE;2;2;1;0;1;1;0;2;0;0;0;0;2;0
12284.0;2022;10;LYON;MASCULIN;FORMATION CONTINUE;BAC PROFESSIONNEL;BAC PRO PROD;BAC PRO 22705 TECHNICIEN GAZ;2;2;2;0;0;0;0;2;0;0;2;0;0;0
12292.0;2022;10;LYON;MASCULIN;INDIVIDUEL;BAC PROFESSIONNEL;BAC PRO PROD;BAC PRO 22106 CUISINE;1;1;1;0;0;0;0;1;0;0;0;1;0;0
12293.0;2022;10;LYON;MASCULIN;INDIVIDUEL;BAC PROFESSIONNEL;BAC PRO PROD;BAC PRO 23004 TECHN. ETUDES BAT.A ETUDES & ECO.;1;1;1;0;0;0;0;1;0;0;0;1;0;0
12302.0;2022;10;LYON;MASCULIN;INDIVIDUEL;BAC PROFESSIONNEL;BAC PRO PROD;BAC PRO AG 21004 CGEA;2;1;1;0;0;0;0;1;0;0;0;0;1;0
12304.0;2022;10;LYON;MASCULIN;INDIVIDUEL;BAC PROFESSIONNEL;BAC PRO PROD;BAC PRO AG 21114 CONDUITE PRODUCTIONS HORTICOLES;2;2;2;0;0;0;0;2;0;0;0;0;2;0
12306.0;2022;10;LYON;MASCULIN;INDIVIDUEL;BAC PROFESSIONNEL;BAC PRO PROD;BAC PRO AG 22107 TEC CONS VTE ALIMENTATION P.ALIM;1;0;0;0;0;0;0;0;0;0;0;0;0;0
12307.0;2022;10;LYON;MASCULIN;INDIVIDUEL;BAC PROFESSIONNEL;BAC PRO SERV;BAC PRO 30001 GESTION-ADMINISTRATION;13;7;2;5;0;0;0;2;0;0;0;0;2;5
12313.0;2022;10;LYON;MASCULIN;INDIVIDUEL;BAC PROFESSIONNEL;BAC PRO SERV;BAC PRO 33004 ACC.SOINS-S.PERS. OPT.EN STRUCTUR;2;2;2;0;0;0;0;2;0;0;0;1;1;0
12317.0;2022;10;LYON;MASCULIN;INDIVIDUEL;BAC TECHNOLOGIQUE;BAC STD2A;BAC STD2A SCIENCES & TECHNO. DESIGN-ARTS APPLIQUES;7;7;6;0;1;1;0;7;0;0;0;5;2;0
12327.0;2022;10;LYON;MASCULIN;SCOLAIRE;BAC PROFESSIONNEL;BAC PRO PROD;BACPRO 20002 ETUD.DEFINITION PRDTS INDUSTRIEL;36;36;24;12;0;0;0;24;0;1;9;6;8;12
12333.0;2022;10;LYON;MASCULIN;SCOLAIRE;BAC PROFESSIONNEL;BAC PRO PROD;BAC PRO 22106 CUISINE;100;100;90;7;3;2;1;92;0;6;22;42;22;8
12344.0;2022;10;LYON;MASCULIN;SCOLAIRE;BAC PROFESSIONNEL;BAC PRO PROD;BAC PRO 23303 MENUISERIE ALUMINIUM-VERRE;16;16;11;3;2;2;0;13;0;0;1;1;11;3
12350.0;2022;10;LYON;MASCULIN;SCOLAIRE;BAC PROFESSIONNEL;BAC PRO PROD;BAC PRO 23408 Etude et réalisation d'agencement;9;9;8;1;0;0;0;8;0;0;1;4;3;1
12357.0;2022;10;LYON;MASCULIN;SCOLAIRE;BAC PROFESSIONNEL;BAC PRO PROD;BAC PRO 25107 TECHNICIEN OUTILLEUR;25;25;18;4;3;1;2;19;0;2;2;5;10;6
12359.0;2022;10;LYON;MASCULIN;SCOLAIRE;BAC PROFESSIONNEL;BAC PRO PROD;BAC PRO 25214 MAINT.VEHIC.OPTA VOIT.PARTICUL.;206;206;136;64;6;5;1;141;0;3;17;50;71;65
12368.0;2022;10;LYON;MASCULIN;SCOLAIRE;BAC PROFESSIONNEL;BAC PRO PROD;BAC PRO 25411 TECH.CHAUDRONNERIE INDUSTRIELLE;78;78;73;3;2;1;1;74;0;6;13;30;25;4
12369.0;2022;10;LYON;MASCULIN;SCOLAIRE;BAC PROFESSIONNEL;BAC PRO PROD;BAC PRO 25509 TECHNIC. FROID CONDITIONNEMT AIR;42;42;22;17;3;1;2;23;0;0;3;9;11;19
12376.0;2022;10;LYON;MASCULIN;SCOLAIRE;BAC PROFESSIONNEL;BAC PRO PROD;BAC PRO AG 21113 CGEVV;8;8;8;0;0;0;0;8;0;1;2;2;3;0
12377.0;2022;10;LYON;MASCULIN;SCOLAIRE;BAC PROFESSIONNEL;BAC PRO PROD;BAC PRO AG 21114 CONDUITE PRODUCTIONS HORTICOLES;22;22;16;6;0;0;0;16;0;0;1;5;10;6
12379.0;2022;10;LYON;MASCULIN;SCOLAIRE;BAC PROFESSIONNEL;BAC PRO PROD;BAC PRO AG 21204 PROD-AQUACOLES;11;11;9;2;0;0;0;9;0;0;0;1;8;2
12391.0;2022;10;LYON;MASCULIN;SCOLAIRE;BAC PROFESSIONNEL;BAC PRO SERV;BAC PRO 31107 CONDUCT. TRANSP.ROUT.MARCHANDISES;85;85;70;15;0;0;0;70;0;3;20;32;15;15
12403.0;2022;10;LYON;MASCULIN;SCOLAIRE;BAC PROFESSIONNEL;BAC PRO SERV;BAC PRO 33101 OPTIQUE LUNETTERIE;8;8;8;0;0;0;0;8;0;1;2;3;2;0
12406.0;2022;10;LYON;MASCULIN;SCOLAIRE;BAC PROFESSIONNEL;BAC PRO SERV;BAC PRO 33602 PERRUQUIER POSTICHEUR;1;1;1;0;0;0;0;1;0;0;1;0;0;0
12412.0;2022;10;LYON;MASCULIN;SCOLAIRE;BAC TECHNOLOGIQUE;BAC STAV;BAC STAV AGRONOMIE ALIM ENV TERRITOI;96;95;92;3;0;0;0;92;0;3;9;40;40;3
12431.0;2022;31;MARTINIQUE;FEMININ;APPRENTISSAGE;BAC PROFESSIONNEL;BAC PRO SERV;BAC PRO 31213 MET.COM.VEN.OP.A ANI.GES.ESP.COM.;5;5;1;4;0;0;0;1;0;0;0;0;1;4
12439.0;2022;31;MARTINIQUE;FEMININ;INDIVIDUEL;BAC PROFESSIONNEL;BAC PRO SERV;BAC PRO 33004 ACC.SOINS-S.PERS. OPT.EN STRUCTUR;1;0;0;0;0;0;0;0;0;0;0;0;0;0
12440.0;2022;31;MARTINIQUE;FEMININ;INDIVIDUEL;BAC PROFESSIONNEL;BAC PRO SERV;BAC PRO 33403 COMMERC. SERVICES EN RESTAURATION;1;0;0;0;0;0;0;0;0;0;0;0;0;0
12443.0;2022;31;MARTINIQUE;FEMININ;INDIVIDUEL;BAC TECHNOLOGIQUE;BAC STMG;BAC STMG MERCATIQUE (MARKETING);1;1;0;0;1;0;1;0;0;0;0;0;0;1
12444.0;2022;31;MARTINIQUE;FEMININ;INDIVIDUEL;BAC TECHNOLOGIQUE;BAC STMG;BAC STMG RESSOURCES HUMAINES ET COMMUNICATION;1;0;0;0;0;0;0;0;0;0;0;0;0;0
12446.0;2022;31;MARTINIQUE;FEMININ;SCOLAIRE;BAC PROFESSIONNEL;BAC PRO PROD;BAC PRO 22003 BIO-INDUSTRIES DE TRANSFORMATION;7;7;3;4;0;0;0;3;0;0;0;1;2;4
12450.0;2022;31;MARTINIQUE;FEMININ;SCOLAIRE;BAC PROFESSIONNEL;BAC PRO PROD;BAC PRO 22703 TECHN.INSTALL.SYST.ENERG.CLIMATI;1;1;1;0;0;0;0;1;0;1;0;0;0;0
12452.0;2022;31;MARTINIQUE;FEMININ;SCOLAIRE;BAC PROFESSIONNEL;BAC PRO PROD;BAC PRO 23005 TECHN. ETUDES BAT B ASSIST.ARCHI.;4;4;2;2;0;0;0;2;0;0;0;0;2;2
12465.0;2022;31;MARTINIQUE;FEMININ;SCOLAIRE;BAC PROFESSIONNEL;BAC PRO PROD;BAC PRO AG 21114 CONDUITE PRODUCTIONS HORTICOLES;2;2;2;0;0;0;0;2;0;0;1;1;0;0
12476.0;2022;31;MARTINIQUE;FEMININ;SCOLAIRE;BAC PROFESSIONNEL;BAC PRO SERV;BAC PRO 33004 ACC.SOINS-S.PERS. OPT.EN STRUCTUR;84;84;68;13;3;3;0;71;0;0;17;21;33;13
12477.0;2022;31;MARTINIQUE;FEMININ;SCOLAIRE;BAC PROFESSIONNEL;BAC PRO SERV;BAC PRO 33403 COMMERC. SERVICES EN RESTAURATION;22;22;17;3;2;2;0;19;0;0;0;7;12;3
12489.0;2022;31;MARTINIQUE;FEMININ;SCOLAIRE;BAC TECHNOLOGIQUE;BAC STI2D;BAC STI2D SYSTÈME D'INFORMATION  ET NUMERIQUE;5;5;4;0;1;1;0;5;0;0;0;1;4;0
12496.0;2022;31;MARTINIQUE;MASCULIN;APPRENTISSAGE;BAC PROFESSIONNEL;BAC PRO PROD;BAC PRO 22106 CUISINE;4;3;2;0;1;1;0;3;0;0;0;1;2;0
12499.0;2022;31;MARTINIQUE;MASCULIN;APPRENTISSAGE;BAC PROFESSIONNEL;BAC PRO PROD;BAC PRO 23203 TECHNICIEN BAT. : ORG.REAL.GROS O;7;7;6;1;0;0;0;6;0;0;1;1;4;1
12509.0;2022;31;MARTINIQUE;MASCULIN;APPRENTISSAGE;BAC PROFESSIONNEL;BAC PRO SERV;BAC PRO 31213 MET.COM.VEN.OP.A ANI.GES.ESP.COM.;4;4;2;2;0;0;0;2;0;0;2;0;0;2
12517.0;2022;31;MARTINIQUE;MASCULIN;INDIVIDUEL;BAC PROFESSIONNEL;BAC PRO PROD;BAC PRO 22703 TECHN.INSTALL.SYST.ENERG.CLIMATI;1;0;0;0;0;0;0;0;0;0;0;0;0;0
12524.0;2022;31;MARTINIQUE;MASCULIN;INDIVIDUEL;BAC PROFESSIONNEL;BAC PRO PROD;BAC PRO AG 21004 CGEA;1;0;0;0;0;0;0;0;0;0;0;0;0;0
12525.0;2022;31;MARTINIQUE;MASCULIN;INDIVIDUEL;BAC PROFESSIONNEL;BAC PRO SERV;BAC PRO 30001 GESTION-ADMINISTRATION;1;1;1;0;0;0;0;1;0;0;0;0;1;0
12529.0;2022;31;MARTINIQUE;MASCULIN;SCOLAIRE;BAC GENERAL;BAC GENERAL;BAC GENE 10019 BAC GENERAL;750;750;622;18;110;97;13;719;7;53;120;214;325;31
12532.0;2022;31;MARTINIQUE;MASCULIN;SCOLAIRE;BAC PROFESSIONNEL;BAC PRO PROD;BAC PRO 22105 BOULANGER-PÂTISSIER;23;23;16;7;0;0;0;16;0;0;2;7;7;7
12533.0;2022;31;MARTINIQUE;MASCULIN;SCOLAIRE;BAC PROFESSIONNEL;BAC PRO PROD;BAC PRO 22106 CUISINE;29;29;27;1;1;1;0;28;0;1;9;7;11;1
12535.0;2022;31;MARTINIQUE;MASCULIN;SCOLAIRE;BAC PROFESSIONNEL;BAC PRO PROD;BAC PRO 22704 TECHN. MAINT. SYST.ENERG.CLIMATI;15;15;4;11;0;0;0;4;0;0;0;1;3;11
12538.0;2022;31;MARTINIQUE;MASCULIN;SCOLAIRE;BAC PROFESSIONNEL;BAC PRO PROD;BAC PRO 23102 TRAVAUX PUBLICS;7;7;3;3;1;0;1;3;0;0;1;0;2;4
12546.0;2022;31;MARTINIQUE;MASCULIN;SCOLAIRE;BAC PROFESSIONNEL;BAC PRO PROD;BAC PRO 24203 METIERS DE LA MODE - VÊTEMENT;2;2;2;0;0;0;0;2;0;0;1;0;1;0
12550.0;2022;31;MARTINIQUE;MASCULIN;SCOLAIRE;BAC PROFESSIONNEL;BAC PRO PROD;BAC PRO 25214 MAINT.VEHIC.OPTA VOIT.PARTICUL.;70;70;52;8;10;9;1;61;0;1;6;19;35;9
12552.0;2022;31;MARTINIQUE;MASCULIN;SCOLAIRE;BAC PROFESSIONNEL;BAC PRO PROD;BAC PRO 25220 MAINT.MATERIELS OPT.B TP MANUT.;8;8;7;1;0;0;0;7;0;0;2;3;2;1
12555.0;2022;31;MARTINIQUE;MASCULIN;SCOLAIRE;BAC PROFESSIONNEL;BAC PRO PROD;BAC PRO 25411 TECH.CHAUDRONNERIE INDUSTRIELLE;8;8;5;3;0;0;0;5;0;0;1;3;1;3
12556.0;2022;31;MARTINIQUE;MASCULIN;SCOLAIRE;BAC PROFESSIONNEL;BAC PRO PROD;BAC PRO 25509 TECHNIC. FROID CONDITIONNEMT AIR;5;5;4;0;1;1;0;5;0;0;1;2;2;0
12560.0;2022;31;MARTINIQUE;MASCULIN;SCOLAIRE;BAC PROFESSIONNEL;BAC PRO PROD;BAC PRO 25515 SYST.NUM.OPT.C RES.INF.SYST.COMM.;15;15;14;1;0;0;0;14;0;0;4;7;3;1
12564.0;2022;31;MARTINIQUE;MASCULIN;SCOLAIRE;BAC PROFESSIONNEL;BAC PRO PROD;BAC PRO AG 21405 AMENAGEMENTS PAYSAGERS;8;8;7;1;0;0;0;7;0;0;2;2;3;1
12566.0;2022;31;MARTINIQUE;MASCULIN;SCOLAIRE;BAC PROFESSIONNEL;BAC PRO SERV;BAC PRO 30001 GESTION-ADMINISTRATION;42;42;22;18;2;2;0;24;0;0;4;7;13;18
12567.0;2022;31;MARTINIQUE;MASCULIN;SCOLAIRE;BAC PROFESSIONNEL;BAC PRO SERV;BAC PRO 31106 LOGISTIQUE;16;16;9;5;2;2;0;11;0;0;2;3;6;5
12576.0;2022;31;MARTINIQUE;MASCULIN;SCOLAIRE;BAC PROFESSIONNEL;BAC PRO SERV;BAC PRO 33403 COMMERC. SERVICES EN RESTAURATION;21;21;18;1;2;1;1;19;0;0;4;8;7;2
12577.0;2022;31;MARTINIQUE;MASCULIN;SCOLAIRE;BAC PROFESSIONNEL;BAC PRO SERV;BAC PRO 33603 ESTHETIQUE COSMETIQUE PARFUMERIE;1;1;1;0;0;0;0;1;0;0;0;0;1;0
12578.0;2022;31;MARTINIQUE;MASCULIN;SCOLAIRE;BAC PROFESSIONNEL;BAC PRO SERV;BAC PRO 34303 GEST. POLLUTIONS PROTEC. ENVIRON.;8;8;7;1;0;0;0;7;0;0;2;2;3;1
12580.0;2022;31;MARTINIQUE;MASCULIN;SCOLAIRE;BAC PROFESSIONNEL;BAC PRO SERV;BAC PRO AG 33002 SERV PERS TERRIT;4;4;4;0;0;0;0;4;0;0;1;2;1;0
12584.0;2022;31;MARTINIQUE;MASCULIN;SCOLAIRE;BAC TECHNOLOGIQUE;BAC STHR;BAC STHR SC.&TEC. HOTELLERIE-RESTAURATION;11;11;8;0;3;2;1;10;0;0;1;3;6;1
12594.0;2022;43;MAYOTTE;FEMININ;APPRENTISSAGE;BAC PROFESSIONNEL;BAC PRO SERV;BAC PRO 31106 LOGISTIQUE;2;2;1;0;1;1;0;2;0;0;0;0;2;0
12596.0;2022;43;MAYOTTE;FEMININ;ENSEIGNEMENT A DISTANCE;BAC GENERAL;BAC GENERAL;BAC GENE 10019 BAC GENERAL;1;1;1;0;0;0;0;1;0;0;1;0;0;0
12599.0;2022;43;MAYOTTE;FEMININ;INDIVIDUEL;BAC PROFESSIONNEL;BAC PRO PROD;BAC PRO 22106 CUISINE;1;1;0;1;0;0;0;0;0;0;0;0;0;1
12603.0;2022;43;MAYOTTE;FEMININ;INDIVIDUEL;BAC PROFESSIONNEL;BAC PRO SERV;BAC PRO 31214 MET.COM.VEN.OP.B PR.CL.VA.OF.COM.;2;1;0;1;0;0;0;0;0;0;0;0;0;1
12608.0;2022;43;MAYOTTE;FEMININ;SCOLAIRE;BAC GENERAL;BAC GENERAL;BAC GENE 10019 BAC GENERAL;1463;1463;931;178;354;201;153;1132;5;50;157;306;614;331
12609.0;2022;43;MAYOTTE;FEMININ;SCOLAIRE;BAC PROFESSIONNEL;BAC PRO PROD;BAC PRO 22106 CUISINE;16;16;11;3;2;2;0;13;0;0;0;3;10;3
12621.0;2022;43;MAYOTTE;FEMININ;SCOLAIRE;BAC PROFESSIONNEL;BAC PRO SERV;BAC PRO 31106 LOGISTIQUE;5;5;2;2;1;0;1;2;0;0;0;0;2;3
12626.0;2022;43;MAYOTTE;FEMININ;SCOLAIRE;BAC PROFESSIONNEL;BAC PRO SERV;BAC PRO 32303 ART.& MET.ART:COM.VIS.VIS.PLURI-M;4;4;4;0;0;0;0;4;0;0;1;1;2;0
12630.0;2022;43;MAYOTTE;FEMININ;SCOLAIRE;BAC PROFESSIONNEL;BAC PRO SERV;BAC PRO 33403 COMMERC. SERVICES EN RESTAURATION;17;17;10;5;2;2;0;12;0;1;0;5;6;5
12631.0;2022;43;MAYOTTE;FEMININ;SCOLAIRE;BAC PROFESSIONNEL;BAC PRO SERV;BAC PRO 34403 METIERS DE LA SECURITE;12;12;9;0;3;3;0;12;0;0;1;5;6;0
12638.0;2022;43;MAYOTTE;FEMININ;SCOLAIRE;BAC TECHNOLOGIQUE;BAC STI2D;BAC STI2D INNOVATION TECHNO.  ET ECO CONCEPTION;12;12;1;2;9;3;6;4;0;0;0;0;4;8
12641.0;2022;43;MAYOTTE;FEMININ;SCOLAIRE;BAC TECHNOLOGIQUE;BAC STMG;BAC STMG GESTION ET FINANCE;134;134;56;29;49;40;9;96;0;0;7;13;76;38
12643.0;2022;43;MAYOTTE;FEMININ;SCOLAIRE;BAC TECHNOLOGIQUE;BAC STMG;BAC STMG RESSOURCES HUMAINES ET COMMUNICATION;359;359;154;80;125;98;27;252;0;0;3;33;216;107
12650.0;2022;43;MAYOTTE;MASCULIN;INDIVIDUEL;BAC PROFESSIONNEL;BAC PRO PROD;BAC PRO 23102 TRAVAUX PUBLICS;1;1;0;1;0;0;0;0;0;0;0;0;0;1
12655.0;2022;43;MAYOTTE;MASCULIN;INDIVIDUEL;BAC PROFESSIONNEL;BAC PRO PROD;BAC PRO 25513 SYST.NUM.OPT.A SURETE SECURITE;1;1;0;1;0;0;0;0;0;0;0;0;0;1
12663.0;2022;43;MAYOTTE;MASCULIN;INDIVIDUEL;BAC TECHNOLOGIQUE;BAC STMG;BAC STMG RESSOURCES HUMAINES ET COMMUNICATION;6;3;0;2;1;1;0;1;0;0;0;0;1;2
12667.0;2022;43;MAYOTTE;MASCULIN;SCOLAIRE;BAC PROFESSIONNEL;BAC PRO PROD;BAC PRO 23004 TECHN. ETUDES BAT.A ETUDES & ECO.;27;27;20;2;5;4;1;24;0;0;2;5;17;3
12670.0;2022;43;MAYOTTE;MASCULIN;SCOLAIRE;BAC PROFESSIONNEL;BAC PRO PROD;BACPRO 23103 TECHNICIEN GEOMETRE-TOPOGRAPHE;16;16;8;6;2;2;0;10;0;0;0;2;8;6
12680.0;2022;43;MAYOTTE;MASCULIN;SCOLAIRE;BAC PROFESSIONNEL;BAC PRO PROD;BAC PRO 25221 MAINT.MATERIELS OPT.C ESP. VERTS;13;12;2;10;0;0;0;2;0;0;1;0;1;10
12682.0;2022;43;MAYOTTE;MASCULIN;SCOLAIRE;BAC PROFESSIONNEL;BAC PRO PROD;BAC PRO 25509 TECHNIC. FROID CONDITIONNEMT AIR;17;17;15;1;1;1;0;16;0;0;0;3;13;1
12686.0;2022;43;MAYOTTE;MASCULIN;SCOLAIRE;BAC PROFESSIONNEL;BAC PRO PROD;BAC PRO 25515 SYST.NUM.OPT.C RES.INF.SYST.COMM.;12;12;7;5;0;0;0;7;0;0;1;2;4;5
12692.0;2022;43;MAYOTTE;MASCULIN;SCOLAIRE;BAC PROFESSIONNEL;BAC PRO SERV;BAC PRO 31212 METIERS DE L'ACCUEIL;23;23;15;2;6;4;2;19;0;0;1;3;15;4
12704.0;2022;43;MAYOTTE;MASCULIN;SCOLAIRE;BAC TECHNOLOGIQUE;BAC STHR;BAC STHR SC.&TEC. HOTELLERIE-RESTAURATION;2;2;1;0;1;1;0;2;0;0;0;1;1;0
12707.0;2022;43;MAYOTTE;MASCULIN;SCOLAIRE;BAC TECHNOLOGIQUE;BAC STI2D;BAC STI2D INNOVATION TECHNO.  ET ECO CONCEPTION;27;27;4;9;14;13;1;17;0;0;0;2;15;10
12711.0;2022;43;MAYOTTE;MASCULIN;SCOLAIRE;BAC TECHNOLOGIQUE;BAC STMG;BAC STMG MERCATIQUE (MARKETING);195;195;73;47;75;61;14;134;0;0;2;15;117;61
12715.0;2022;11;MONTPELLIER;FEMININ;APPRENTISSAGE;BAC PROFESSIONNEL;BAC PRO PROD;BAC PRO 22703 TECHN.INSTALL.SYST.ENERG.CLIMATI;1;1;1;0;0;0;0;1;0;0;1;0;0;0
12719.0;2022;11;MONTPELLIER;FEMININ;APPRENTISSAGE;BAC PROFESSIONNEL;BAC PRO PROD;BAC PRO 25214 MAINT.VEHIC.OPTA VOIT.PARTICUL.;3;3;3;0;0;0;0;3;0;1;1;0;1;0
12723.0;2022;11;MONTPELLIER;FEMININ;APPRENTISSAGE;BAC PROFESSIONNEL;BAC PRO PROD;BAC PRO 25510 METIERS ELECT. ENVIRON. CONNECTES;2;2;2;0;0;0;0;2;0;0;0;1;1;0
12724.0;2022;11;MONTPELLIER;FEMININ;APPRENTISSAGE;BAC PROFESSIONNEL;BAC PRO PROD;BAC PRO AG 21004 CGEA;1;1;1;0;0;0;0;1;0;0;0;1;0;0
12732.0;2022;11;MONTPELLIER;FEMININ;APPRENTISSAGE;BAC PROFESSIONNEL;BAC PRO SERV;BAC PRO 31212 METIERS DE L'ACCUEIL;4;4;4;0;0;0;0;4;0;0;2;1;1;0
12740.0;2022;11;MONTPELLIER;FEMININ;APPRENTISSAGE;BAC PROFESSIONNEL;BAC PRO SERV;BAC PRO AG 33002 SERV PERS TERRIT;15;15;15;0;0;0;0;15;0;2;4;3;6;0
12747.0;2022;11;MONTPELLIER;FEMININ;ENSEIGNEMENT A DISTANCE;BAC TECHNOLOGIQUE;BAC STMG;BAC STMG GESTION ET FINANCE;2;2;2;0;0;0;0;2;0;0;0;1;1;0
12749.0;2022;11;MONTPELLIER;FEMININ;ENSEIGNEMENT A DISTANCE;BAC TECHNOLOGIQUE;BAC STMG;BAC STMG RESSOURCES HUMAINES ET COMMUNICATION;4;4;4;0;0;0;0;4;0;0;3;1;0;0
12752.0;2022;11;MONTPELLIER;FEMININ;FORMATION CONTINUE;BAC PROFESSIONNEL;BAC PRO PROD;BAC PRO AG 21114 CONDUITE PRODUCTIONS HORTICOLES;9;8;8;0;0;0;0;8;0;0;0;2;6;0
12753.0;2022;11;MONTPELLIER;FEMININ;FORMATION CONTINUE;BAC PROFESSIONNEL;BAC PRO SERV;BAC PRO 31213 MET.COM.VEN.OP.A ANI.GES.ESP.COM.;6;6;6;0;0;0;0;6;0;3;1;0;2;0
12766.0;2022;11;MONTPELLIER;FEMININ;INDIVIDUEL;BAC PROFESSIONNEL;BAC PRO SERV;BAC PRO 33002 SERVICES DE PROXIMITE  VIE LOCAL;1;0;0;0;0;0;0;0;0;0;0;0;0;0
12770.0;2022;11;MONTPELLIER;FEMININ;INDIVIDUEL;BAC TECHNOLOGIQUE;BAC STAV;BAC STAV AGRONOMIE ALIM ENV TERRITOI;1;1;0;1;0;0;0;0;0;0;0;0;0;1
12772.0;2022;11;MONTPELLIER;FEMININ;INDIVIDUEL;BAC TECHNOLOGIQUE;BAC STHR;BAC STHR SC.&TEC. HOTELLERIE-RESTAURATION;1;1;1;0;0;0;0;1;0;0;0;1;0;0
12776.0;2022;11;MONTPELLIER;FEMININ;INDIVIDUEL;BAC TECHNOLOGIQUE;BAC STMG;BAC STMG MERCATIQUE (MARKETING);12;10;3;2;5;2;3;5;0;0;0;0;5;5
12780.0;2022;11;MONTPELLIER;FEMININ;SCOLAIRE;BAC PROFESSIONNEL;BAC PRO PROD;BAC PRO 22003 BIO-INDUSTRIES DE TRANSFORMATION;13;13;5;8;0;0;0;5;0;0;0;3;2;8
12781.0;2022;11;MONTPELLIER;FEMININ;SCOLAIRE;BAC PROFESSIONNEL;BAC PRO PROD;BAC PRO 22004 PROC. CHIMIE EAU PAPIERS-CARTONS;9;9;6;1;2;2;0;8;0;1;0;5;2;1
12785.0;2022;11;MONTPELLIER;FEMININ;SCOLAIRE;BAC PROFESSIONNEL;BAC PRO PROD;BAC PRO 22503 PLASTIQUES ET COMPOSITES;1;1;1;0;0;0;0;1;0;0;1;0;0;0
12789.0;2022;11;MONTPELLIER;FEMININ;SCOLAIRE;BAC PROFESSIONNEL;BAC PRO PROD;BAC PRO 23208 METIERS ET ARTS DE LA PIERRE;1;1;1;0;0;0;0;1;0;0;0;0;1;0
12793.0;2022;11;MONTPELLIER;FEMININ;SCOLAIRE;BAC PROFESSIONNEL;BAC PRO PROD;BAC PRO 23405 TECHNICIEN MENUISIER AGENCEUR;7;7;7;0;0;0;0;7;0;0;3;1;3;0
12798.0;2022;11;MONTPELLIER;FEMININ;SCOLAIRE;BAC PROFESSIONNEL;BAC PRO PROD;BAC PRO 24303 MET. DU CUIR: SELLERIE GARNISSAGE;16;16;16;0;0;0;0;16;0;2;5;5;4;0
12807.0;2022;11;MONTPELLIER;FEMININ;SCOLAIRE;BAC PROFESSIONNEL;BAC PRO PROD;BAC PRO 25509 TECHNIC. FROID CONDITIONNEMT AIR;1;1;0;1;0;0;0;0;0;0;0;0;0;1
12813.0;2022;11;MONTPELLIER;FEMININ;SCOLAIRE;BAC PROFESSIONNEL;BAC PRO PROD;BAC PRO AG 21114 CONDUITE PRODUCTIONS HORTICOLES;24;23;18;5;0;0;0;18;0;1;0;5;12;5
12821.0;2022;11;MONTPELLIER;FEMININ;SCOLAIRE;BAC PROFESSIONNEL;BAC PRO PROD;BAC PRO AG 22107 TEC CONS VTE ALIMENTATION P.ALIM;15;15;12;3;0;0;0;12;0;0;2;4;6;3
12829.0;2022;11;MONTPELLIER;FEMININ;SCOLAIRE;BAC PROFESSIONNEL;BAC PRO SERV;BAC PRO 32207 REAL.PR.IMPR.PLURI.OPTA.PR.GRAPH.;1;1;0;1;0;0;0;0;0;0;0;0;0;1
12834.0;2022;11;MONTPELLIER;FEMININ;SCOLAIRE;BAC PROFESSIONNEL;BAC PRO SERV;BAC PRO 33003 ACC.SOINS-S.PERS. OPT.A DOMICILE;79;79;54;18;7;4;3;58;0;4;11;16;27;21
12839.0;2022;11;MONTPELLIER;FEMININ;SCOLAIRE;BAC PROFESSIONNEL;BAC PRO SERV;BAC PRO 33603 ESTHETIQUE COSMETIQUE PARFUMERIE;165;165;145;19;1;1;0;146;0;8;28;63;47;19
12841.0;2022;11;MONTPELLIER;FEMININ;SCOLAIRE;BAC PROFESSIONNEL;BAC PRO SERV;BAC PRO 34403 METIERS DE LA SECURITE;50;50;47;1;2;0;2;47;0;6;12;21;8;3
12842.0;2022;11;MONTPELLIER;FEMININ;SCOLAIRE;BAC PROFESSIONNEL;BAC PRO SERV;BAC PRO AG 33002 SERV PERS TERRIT;320;308;271;37;0;0;0;271;0;5;44;77;145;37
12844.0;2022;11;MONTPELLIER;FEMININ;SCOLAIRE;BAC TECHNOLOGIQUE;BAC S2TMD;BAC S2TMD MUSIQUE;1;1;1;0;0;0;0;1;0;0;0;1;0;0
12845.0;2022;11;MONTPELLIER;FEMININ;SCOLAIRE;BAC TECHNOLOGIQUE;BAC ST2S;BAC ST2S SCIENCES & TECHNO. SANTE & SOCIAL;814;814;728;19;67;30;37;758;0;31;126;299;302;56
12859.0;2022;11;MONTPELLIER;MASCULIN;APPRENTISSAGE;BAC PROFESSIONNEL;BAC PRO PROD;BAC PRO 20102 PILOTE DE LIGNE DE PRODUCTION;5;5;5;0;0;0;0;5;0;2;3;0;0;0
12866.0;2022;11;MONTPELLIER;MASCULIN;APPRENTISSAGE;BAC PROFESSIONNEL;BAC PRO PROD;BAC PRO 23005 TECHN. ETUDES BAT B ASSIST.ARCHI.;3;3;3;0;0;0;0;3;0;0;3;0;0;0
12869.0;2022;11;MONTPELLIER;MASCULIN;APPRENTISSAGE;BAC PROFESSIONNEL;BAC PRO PROD;BAC PRO 23303 MENUISERIE ALUMINIUM-VERRE;4;4;1;1;2;2;0;3;0;0;0;0;3;1
12883.0;2022;11;MONTPELLIER;MASCULIN;APPRENTISSAGE;BAC PROFESSIONNEL;BAC PRO PROD;BAC PRO 25411 TECH.CHAUDRONNERIE INDUSTRIELLE;28;28;22;5;1;1;0;23;0;0;6;9;8;5
12884.0;2022;11;MONTPELLIER;MASCULIN;APPRENTISSAGE;BAC PROFESSIONNEL;BAC PRO PROD;BAC PRO 25509 TECHNIC. FROID CONDITIONNEMT AIR;4;4;4;0;0;0;0;4;0;0;0;3;1;0
12904.0;2022;11;MONTPELLIER;MASCULIN;ENSEIGNEMENT A DISTANCE;BAC PROFESSIONNEL;BAC PRO SERV;BAC PRO 33003 ACC.SOINS-S.PERS. OPT.A DOMICILE;2;1;1;0;0;0;0;1;0;0;1;0;0;0
12909.0;2022;11;MONTPELLIER;MASCULIN;FORMATION CONTINUE;BAC PROFESSIONNEL;BAC PRO PROD;BAC PRO 22004 PROC. CHIMIE EAU PAPIERS-CARTONS;1;1;1;0;0;0;0;1;0;1;0;0;0;0
12916.0;2022;11;MONTPELLIER;MASCULIN;FORMATION CONTINUE;BAC PROFESSIONNEL;BAC PRO PROD;BAC PRO AG 21114 CONDUITE PRODUCTIONS HORTICOLES;4;4;4;0;0;0;0;4;0;0;0;0;4;0
12932.0;2022;11;MONTPELLIER;MASCULIN;INDIVIDUEL;BAC PROFESSIONNEL;BAC PRO SERV;BAC PRO 31213 MET.COM.VEN.OP.A ANI.GES.ESP.COM.;1;1;0;1;0;0;0;0;0;0;0;0;0;1
12936.0;2022;11;MONTPELLIER;MASCULIN;INDIVIDUEL;BAC TECHNOLOGIQUE;BAC ST2S;BAC ST2S SCIENCES & TECHNO. SANTE & SOCIAL;1;1;0;1;0;0;0;0;0;0;0;0;0;1
12939.0;2022;11;MONTPELLIER;MASCULIN;INDIVIDUEL;BAC TECHNOLOGIQUE;BAC STI2D;BAC STI2D ENERGIES  ET ENVIRONNEMENT;1;1;0;1;0;0;0;0;0;0;0;0;0;1
12941.0;2022;11;MONTPELLIER;MASCULIN;INDIVIDUEL;BAC TECHNOLOGIQUE;BAC STI2D;BAC STI2D SYSTÈME D'INFORMATION  ET NUMERIQUE;1;1;1;0;0;0;0;1;0;0;0;0;1;0
12947.0;2022;11;MONTPELLIER;MASCULIN;SCOLAIRE;BAC GENERAL;BAC GENERAL;BAC GENE 10019 BAC GENERAL;6320;6320;5739;134;447;314;133;6053;104;721;1374;1947;1907;267
12952.0;2022;11;MONTPELLIER;MASCULIN;SCOLAIRE;BAC PROFESSIONNEL;BAC PRO PROD;BAC PRO 22105 BOULANGER-PÂTISSIER;21;21;19;2;0;0;0;19;0;0;3;10;6;2
12954.0;2022;11;MONTPELLIER;MASCULIN;SCOLAIRE;BAC PROFESSIONNEL;BAC PRO PROD;BAC PRO 22403 ARTS.& MET.ART:MET.ENSEIGN SIGNA;10;10;8;2;0;0;0;8;0;2;2;2;2;2
12959.0;2022;11;MONTPELLIER;MASCULIN;SCOLAIRE;BAC PROFESSIONNEL;BAC PRO PROD;BAC PRO 23004 TECHN. ETUDES BAT.A ETUDES & ECO.;48;48;32;16;0;0;0;32;0;0;2;14;16;16
12960.0;2022;11;MONTPELLIER;MASCULIN;SCOLAIRE;BAC PROFESSIONNEL;BAC PRO PROD;BAC PRO 23005 TECHN. ETUDES BAT B ASSIST.ARCHI.;35;35;32;3;0;0;0;32;0;1;6;11;14;3
12986.0;2022;11;MONTPELLIER;MASCULIN;SCOLAIRE;BAC PROFESSIONNEL;BAC PRO PROD;BAC PRO 25406 OUVRAGES DU BATIMENT METALLERIE;5;5;1;4;0;0;0;1;0;1;0;0;0;4
12987.0;2022;11;MONTPELLIER;MASCULIN;SCOLAIRE;BAC PROFESSIONNEL;BAC PRO PROD;BAC PRO 25408 REPARATION DES CARROSSERIES;35;34;25;8;1;1;0;26;0;1;2;13;10;8
12991.0;2022;11;MONTPELLIER;MASCULIN;SCOLAIRE;BAC PROFESSIONNEL;BAC PRO PROD;BAC PRO 25513 SYST.NUM.OPT.A SURETE SECURITE;12;12;10;2;0;0;0;10;0;1;0;5;4;2
12992.0;2022;11;MONTPELLIER;MASCULIN;SCOLAIRE;BAC PROFESSIONNEL;BAC PRO PROD;BAC PRO 25514 SYST.NUM.OPT.B AUD.RES.EQUIP.DOM.;110;109;91;12;6;4;2;95;0;4;22;37;32;14
12993.0;2022;11;MONTPELLIER;MASCULIN;SCOLAIRE;BAC PROFESSIONNEL;BAC PRO PROD;BAC PRO 25515 SYST.NUM.OPT.C RES.INF.SYST.COMM.;222;222;190;27;5;3;2;193;0;5;39;95;54;29
12998.0;2022;11;MONTPELLIER;MASCULIN;SCOLAIRE;BAC PROFESSIONNEL;BAC PRO PROD;BAC PRO AG 21203 TECHN CONSEIL DE VENTE ANIMAL;15;15;13;2;0;0;0;13;0;0;1;2;10;2
13003.0;2022;11;MONTPELLIER;MASCULIN;SCOLAIRE;BAC PROFESSIONNEL;BAC PRO PROD;BAC PRO AG 21303 FORET;15;14;14;0;0;0;0;14;0;0;2;6;6;0
13007.0;2022;11;MONTPELLIER;MASCULIN;SCOLAIRE;BAC PROFESSIONNEL;BAC PRO PROD;BAC PRO AG 22107 TEC CONS VTE ALIMENTATION P.ALIM;12;8;3;5;0;0;0;3;0;0;0;0;3;5
13008.0;2022;11;MONTPELLIER;MASCULIN;SCOLAIRE;BAC PROFESSIONNEL;BAC PRO SERV;BAC PRO 30001 GESTION-ADMINISTRATION;253;253;184;59;10;9;1;193;0;6;31;76;80;60
13012.0;2022;11;MONTPELLIER;MASCULIN;SCOLAIRE;BAC PROFESSIONNEL;BAC PRO SERV;BAC PRO 31212 METIERS DE L'ACCUEIL;62;62;54;5;3;3;0;57;0;1;9;25;22;5
13014.0;2022;11;MONTPELLIER;MASCULIN;SCOLAIRE;BAC PROFESSIONNEL;BAC PRO SERV;BAC PRO 31214 MET.COM.VEN.OP.B PR.CL.VA.OF.COM.;128;128;88;38;2;2;0;90;0;2;9;43;36;38
13015.0;2022;11;MONTPELLIER;MASCULIN;SCOLAIRE;BAC PROFESSIONNEL;BAC PRO SERV;BAC PRO 32207 REAL.PR.IMPR.PLURI.OPTA.PR.GRAPH.;14;14;13;0;1;0;1;13;0;1;7;3;2;1
13019.0;2022;11;MONTPELLIER;MASCULIN;SCOLAIRE;BAC PROFESSIONNEL;BAC PRO SERV;BAC PRO 33002 SERVICES DE PROXIMITE  VIE LOCAL;24;24;20;3;1;1;0;21;0;3;2;9;7;3
13029.0;2022;11;MONTPELLIER;MASCULIN;SCOLAIRE;BAC TECHNOLOGIQUE;BAC ST2S;BAC ST2S SCIENCES & TECHNO. SANTE & SOCIAL;256;256;213;5;38;16;22;229;0;3;30;78;118;27
13030.0;2022;11;MONTPELLIER;MASCULIN;SCOLAIRE;BAC TECHNOLOGIQUE;BAC STAV;BAC STAV AGRONOMIE ALIM ENV TERRITOI;120;120;113;7;0;0;0;113;0;0;14;42;57;7
13032.0;2022;11;MONTPELLIER;MASCULIN;SCOLAIRE;BAC TECHNOLOGIQUE;BAC STHR;BAC STHR SC.&TEC. HOTELLERIE-RESTAURATION;46;46;39;2;5;4;1;43;0;1;10;15;17;3
13045.0;2022;12;NANCY-METZ;FEMININ;APPRENTISSAGE;BAC PROFESSIONNEL;BAC PRO PROD;BAC PRO 22105 BOULANGER-PÂTISSIER;1;1;1;0;0;0;0;1;0;0;1;0;0;0
13047.0;2022;12;NANCY-METZ;FEMININ;APPRENTISSAGE;BAC PROFESSIONNEL;BAC PRO PROD;BAC PRO 23404 TECHNICIEN CONSTRUCTEUR BOIS;1;1;0;1;0;0;0;0;0;0;0;0;0;1
13049.0;2022;12;NANCY-METZ;FEMININ;APPRENTISSAGE;BAC PROFESSIONNEL;BAC PRO PROD;BAC PRO 25007 MAINTENANCE EQUIPEMENTS INDUST.;2;2;2;0;0;0;0;2;0;1;0;0;1;0
13054.0;2022;12;NANCY-METZ;FEMININ;APPRENTISSAGE;BAC PROFESSIONNEL;BAC PRO PROD;BAC PRO 25410 CONSTRUCTION DES CARROSSERIES;1;1;1;0;0;0;0;1;0;0;0;0;1;0
13064.0;2022;12;NANCY-METZ;FEMININ;APPRENTISSAGE;BAC PROFESSIONNEL;BAC PRO SERV;BAC PRO 30001 GESTION-ADMINISTRATION;27;26;25;1;0;0;0;25;0;14;8;0;3;1
13068.0;2022;12;NANCY-METZ;FEMININ;APPRENTISSAGE;BAC PROFESSIONNEL;BAC PRO SERV;BAC PRO 32303 ART.& MET.ART:COM.VIS.VIS.PLURI-M;1;1;1;0;0;0;0;1;0;0;1;0;0;0
13074.0;2022;12;NANCY-METZ;FEMININ;APPRENTISSAGE;BAC PROFESSIONNEL;BAC PRO SERV;BAC PRO AG 33002 SERV PERS TERRIT;3;2;2;0;0;0;0;2;0;0;0;1;1;0
13078.0;2022;12;NANCY-METZ;FEMININ;ENSEIGNEMENT A DISTANCE;BAC TECHNOLOGIQUE;BAC STMG;BAC STMG RESSOURCES HUMAINES ET COMMUNICATION;6;6;3;2;1;0;1;3;0;0;1;2;0;3
13082.0;2022;12;NANCY-METZ;FEMININ;FORMATION CONTINUE;BAC PROFESSIONNEL;BAC PRO PROD;BAC PRO 24203 METIERS DE LA MODE - VÊTEMENT;1;1;1;0;0;0;0;1;0;1;0;0;0;0
13091.0;2022;12;NANCY-METZ;FEMININ;INDIVIDUEL;BAC GENERAL;BAC GENERAL;BAC GENE 10019 BAC GENERAL;36;19;5;5;9;6;3;11;0;0;2;0;9;8
13092.0;2022;12;NANCY-METZ;FEMININ;INDIVIDUEL;BAC PROFESSIONNEL;BAC PRO PROD;BAC PRO 22105 BOULANGER-PÂTISSIER;1;0;0;0;0;0;0;0;0;0;0;0;0;0
13093.0;2022;12;NANCY-METZ;FEMININ;INDIVIDUEL;BAC PROFESSIONNEL;BAC PRO PROD;BAC PRO 24203 METIERS DE LA MODE - VÊTEMENT;1;1;1;0;0;0;0;1;0;0;0;0;1;0
13097.0;2022;12;NANCY-METZ;FEMININ;INDIVIDUEL;BAC PROFESSIONNEL;BAC PRO PROD;BAC PRO AG 21211 COND GEST ENTR HIPPIQUE;5;3;3;0;0;0;0;3;0;0;0;0;3;0
13099.0;2022;12;NANCY-METZ;FEMININ;INDIVIDUEL;BAC PROFESSIONNEL;BAC PRO PROD;BAC PRO AG 21405 AMENAGEMENTS PAYSAGERS;1;1;1;0;0;0;0;1;0;0;0;0;1;0
13100.0;2022;12;NANCY-METZ;FEMININ;INDIVIDUEL;BAC PROFESSIONNEL;BAC PRO SERV;BAC PRO 30001 GESTION-ADMINISTRATION;7;6;3;3;0;0;0;3;0;0;0;0;3;3
13104.0;2022;12;NANCY-METZ;FEMININ;INDIVIDUEL;BAC PROFESSIONNEL;BAC PRO SERV;BAC PRO 33002 SERVICES DE PROXIMITE  VIE LOCAL;1;0;0;0;0;0;0;0;0;0;0;0;0;0
13105.0;2022;12;NANCY-METZ;FEMININ;INDIVIDUEL;BAC PROFESSIONNEL;BAC PRO SERV;BAC PRO 33003 ACC.SOINS-S.PERS. OPT.A DOMICILE;1;1;0;1;0;0;0;0;0;0;0;0;0;1
13113.0;2022;12;NANCY-METZ;FEMININ;INDIVIDUEL;BAC TECHNOLOGIQUE;BAC STL;BAC STL SCIENCES PHYSIQUES CHIMIQUES  EN LABORAT.;1;0;0;0;0;0;0;0;0;0;0;0;0;0
13114.0;2022;12;NANCY-METZ;FEMININ;INDIVIDUEL;BAC TECHNOLOGIQUE;BAC STMG;BAC STMG MERCATIQUE (MARKETING);5;5;1;1;3;1;2;2;0;0;1;0;1;3
13118.0;2022;12;NANCY-METZ;FEMININ;SCOLAIRE;BAC PROFESSIONNEL;BAC PRO PROD;BAC PRO 22004 PROC. CHIMIE EAU PAPIERS-CARTONS;6;6;5;1;0;0;0;5;0;0;1;3;1;1
13122.0;2022;12;NANCY-METZ;FEMININ;SCOLAIRE;BAC PROFESSIONNEL;BAC PRO PROD;BAC PRO 22503 PLASTIQUES ET COMPOSITES;1;1;1;0;0;0;0;1;0;1;0;0;0;0
13126.0;2022;12;NANCY-METZ;FEMININ;SCOLAIRE;BAC PROFESSIONNEL;BAC PRO PROD;BAC PRO 23208 METIERS ET ARTS DE LA PIERRE;3;3;3;0;0;0;0;3;0;0;2;1;0;0
13135.0;2022;12;NANCY-METZ;FEMININ;SCOLAIRE;BAC PROFESSIONNEL;BAC PRO PROD;BAC PRO 25214 MAINT.VEHIC.OPTA VOIT.PARTICUL.;7;7;7;0;0;0;0;7;0;1;2;2;2;0
13137.0;2022;12;NANCY-METZ;FEMININ;SCOLAIRE;BAC PROFESSIONNEL;BAC PRO PROD;BAC PRO 25216 MAINT.VEHIC.OPTC MOTOCYCLES;4;4;4;0;0;0;0;4;0;1;1;2;0;0
13139.0;2022;12;NANCY-METZ;FEMININ;SCOLAIRE;BAC PROFESSIONNEL;BAC PRO PROD;BAC PRO 25408 REPARATION DES CARROSSERIES;2;2;2;0;0;0;0;2;0;0;1;1;0;0
13148.0;2022;12;NANCY-METZ;FEMININ;SCOLAIRE;BAC PROFESSIONNEL;BAC PRO PROD;BAC PRO AG 21211 COND GEST ENTR HIPPIQUE;81;75;64;11;0;0;0;64;0;3;7;18;36;11
13149.0;2022;12;NANCY-METZ;FEMININ;SCOLAIRE;BAC PROFESSIONNEL;BAC PRO PROD;BAC PRO AG 21302 GEST MILIEUX NATURELS FAUNE;18;18;13;5;0;0;0;13;0;0;1;2;10;5
13159.0;2022;12;NANCY-METZ;FEMININ;SCOLAIRE;BAC PROFESSIONNEL;BAC PRO SERV;BAC PRO 32207 REAL.PR.IMPR.PLURI.OPTA.PR.GRAPH.;11;11;10;1;0;0;0;10;0;0;0;6;4;1
13166.0;2022;12;NANCY-METZ;FEMININ;SCOLAIRE;BAC PROFESSIONNEL;BAC PRO SERV;BAC PRO 33101 OPTIQUE LUNETTERIE;6;6;6;0;0;0;0;6;0;0;1;3;2;0
13168.0;2022;12;NANCY-METZ;FEMININ;SCOLAIRE;BAC PROFESSIONNEL;BAC PRO SERV;BAC PRO 33403 COMMERC. SERVICES EN RESTAURATION;74;74;61;10;3;2;1;63;0;3;13;18;29;11
13174.0;2022;12;NANCY-METZ;FEMININ;SCOLAIRE;BAC TECHNOLOGIQUE;BAC S2TMD;BAC S2TMD MUSIQUE;4;4;4;0;0;0;0;4;0;1;0;2;1;0
13178.0;2022;12;NANCY-METZ;FEMININ;SCOLAIRE;BAC TECHNOLOGIQUE;BAC STD2A;BAC STD2A SCIENCES & TECHNO. DESIGN-ARTS APPLIQUES;77;77;76;0;1;1;0;77;2;8;21;34;12;0
13184.0;2022;12;NANCY-METZ;FEMININ;SCOLAIRE;BAC TECHNOLOGIQUE;BAC STL;BAC STL BIOCHIM.-BIOLOGIE-BIOTECHNOL.;54;54;49;1;4;3;1;52;0;2;12;17;21;2
13189.0;2022;12;NANCY-METZ;FEMININ;SCOLAIRE;BAC TECHNOLOGIQUE;BAC STMG;BAC STMG SYSTEMES D'INFORMATION DE GESTION;3;3;3;0;0;0;0;3;0;0;0;2;1;0
13193.0;2022;12;NANCY-METZ;MASCULIN;APPRENTISSAGE;BAC PROFESSIONNEL;BAC PRO PROD;BAC PRO 22106 CUISINE;4;4;2;0;2;0;2;2;0;0;0;1;1;2
13194.0;2022;12;NANCY-METZ;MASCULIN;APPRENTISSAGE;BAC PROFESSIONNEL;BAC PRO PROD;BAC PRO 22503 PLASTIQUES ET COMPOSITES;2;2;1;1;0;0;0;1;0;0;0;1;0;1
13206.0;2022;12;NANCY-METZ;MASCULIN;APPRENTISSAGE;BAC PROFESSIONNEL;BAC PRO PROD;BAC PRO 25007 MAINTENANCE EQUIPEMENTS INDUST.;38;37;31;5;1;1;0;32;0;5;8;8;11;5
13208.0;2022;12;NANCY-METZ;MASCULIN;APPRENTISSAGE;BAC PROFESSIONNEL;BAC PRO PROD;BAC PRO 25107 TECHNICIEN OUTILLEUR;3;3;3;0;0;0;0;3;0;0;1;2;0;0
13217.0;2022;12;NANCY-METZ;MASCULIN;APPRENTISSAGE;BAC PROFESSIONNEL;BAC PRO PROD;BAC PRO 25406 OUVRAGES DU BATIMENT METALLERIE;4;4;2;0;2;1;1;3;0;1;0;0;2;1
13224.0;2022;12;NANCY-METZ;MASCULIN;APPRENTISSAGE;BAC PROFESSIONNEL;BAC PRO PROD;BAC PRO AG 21001 AGRO-EQUIPEMENT;16;15;12;3;0;0;0;12;0;0;1;0;11;3
13230.0;2022;12;NANCY-METZ;MASCULIN;APPRENTISSAGE;BAC PROFESSIONNEL;BAC PRO PROD;BAC PRO AG 21302 GEST MILIEUX NATURELS FAUNE;2;2;2;0;0;0;0;2;0;0;0;1;1;0
13231.0;2022;12;NANCY-METZ;MASCULIN;APPRENTISSAGE;BAC PROFESSIONNEL;BAC PRO PROD;BAC PRO AG 21303 FORET;15;15;14;1;0;0;0;14;0;0;2;5;7;1
13232.0;2022;12;NANCY-METZ;MASCULIN;APPRENTISSAGE;BAC PROFESSIONNEL;BAC PRO PROD;BAC PRO AG 21405 AMENAGEMENTS PAYSAGERS;58;58;54;4;0;0;0;54;0;0;7;27;20;4
13235.0;2022;12;NANCY-METZ;MASCULIN;APPRENTISSAGE;BAC PROFESSIONNEL;BAC PRO SERV;BAC PRO 31106 LOGISTIQUE;23;23;17;3;3;0;3;17;0;1;5;7;4;6
13239.0;2022;12;NANCY-METZ;MASCULIN;APPRENTISSAGE;BAC PROFESSIONNEL;BAC PRO SERV;BAC PRO 32208 REAL.PR.IMPR.PLURI.OPTB.PR.IMPR.;1;1;0;0;1;1;0;1;0;0;0;0;1;0
13247.0;2022;12;NANCY-METZ;MASCULIN;ENSEIGNEMENT A DISTANCE;BAC TECHNOLOGIQUE;BAC STMG;BAC STMG SYSTEMES D'INFORMATION DE GESTION;1;1;1;0;0;0;0;1;0;0;0;0;1;0
13250.0;2022;12;NANCY-METZ;MASCULIN;FORMATION CONTINUE;BAC PROFESSIONNEL;BAC PRO PROD;BAC PRO 22703 TECHN.INSTALL.SYST.ENERG.CLIMATI;6;6;6;0;0;0;0;6;0;0;3;3;0;0
13261.0;2022;12;NANCY-METZ;MASCULIN;FORMATION CONTINUE;BAC PROFESSIONNEL;BAC PRO SERV;BAC PRO 31106 LOGISTIQUE;9;9;6;2;1;0;1;6;0;1;2;2;1;3
13266.0;2022;12;NANCY-METZ;MASCULIN;INDIVIDUEL;BAC GENERAL;BAC GENERAL;BAC GENE 10019 BAC GENERAL;76;56;41;7;8;7;1;48;0;5;9;16;18;8
13267.0;2022;12;NANCY-METZ;MASCULIN;INDIVIDUEL;BAC PROFESSIONNEL;BAC PRO PROD;BAC PRO 22105 BOULANGER-PÂTISSIER;1;1;0;1;0;0;0;0;0;0;0;0;0;1
13268.0;2022;12;NANCY-METZ;MASCULIN;INDIVIDUEL;BAC PROFESSIONNEL;BAC PRO PROD;BAC PRO 22704 TECHN. MAINT. SYST.ENERG.CLIMATI;1;1;0;1;0;0;0;0;0;0;0;0;0;1
13273.0;2022;12;NANCY-METZ;MASCULIN;INDIVIDUEL;BAC PROFESSIONNEL;BAC PRO PROD;BAC PRO 25216 MAINT.VEHIC.OPTC MOTOCYCLES;1;1;0;1;0;0;0;0;0;0;0;0;0;1
13274.0;2022;12;NANCY-METZ;MASCULIN;INDIVIDUEL;BAC PROFESSIONNEL;BAC PRO PROD;BAC PRO AG 21004 CGEA;1;1;1;0;0;0;0;1;0;0;0;0;1;0
13275.0;2022;12;NANCY-METZ;MASCULIN;INDIVIDUEL;BAC PROFESSIONNEL;BAC PRO PROD;BAC PRO AG 21114 CONDUITE PRODUCTIONS HORTICOLES;1;1;1;0;0;0;0;1;0;0;0;0;1;0
13286.0;2022;12;NANCY-METZ;MASCULIN;INDIVIDUEL;BAC TECHNOLOGIQUE;BAC STMG;BAC STMG GESTION ET FINANCE;5;3;1;1;1;1;0;2;0;0;0;1;1;1
13287.0;2022;12;NANCY-METZ;MASCULIN;INDIVIDUEL;BAC TECHNOLOGIQUE;BAC STMG;BAC STMG MERCATIQUE (MARKETING);15;11;6;4;1;1;0;7;0;0;2;2;3;4
13289.0;2022;12;NANCY-METZ;MASCULIN;INDIVIDUEL;BAC TECHNOLOGIQUE;BAC STMG;BAC STMG SYSTEMES D'INFORMATION DE GESTION;3;2;1;0;1;1;0;2;0;0;0;0;2;0
13291.0;2022;12;NANCY-METZ;MASCULIN;SCOLAIRE;BAC PROFESSIONNEL;BAC PRO PROD;BAC PRO 20102 PILOTE DE LIGNE DE PRODUCTION;20;20;16;4;0;0;0;16;0;1;1;7;7;4
13293.0;2022;12;NANCY-METZ;MASCULIN;SCOLAIRE;BAC PROFESSIONNEL;BAC PRO PROD;BAC PRO 22004 PROC. CHIMIE EAU PAPIERS-CARTONS;18;18;15;3;0;0;0;15;0;0;1;8;6;3
13294.0;2022;12;NANCY-METZ;MASCULIN;SCOLAIRE;BAC PROFESSIONNEL;BAC PRO PROD;BAC PRO 22105 BOULANGER-PÂTISSIER;55;55;47;6;2;2;0;49;0;3;12;14;20;6
13299.0;2022;12;NANCY-METZ;MASCULIN;SCOLAIRE;BAC PROFESSIONNEL;BAC PRO PROD;BAC PRO 22703 TECHN.INSTALL.SYST.ENERG.CLIMATI;37;37;19;16;2;1;1;20;0;1;2;5;12;17
13301.0;2022;12;NANCY-METZ;MASCULIN;SCOLAIRE;BAC PROFESSIONNEL;BAC PRO PROD;BAC PRO 23004 TECHN. ETUDES BAT.A ETUDES & ECO.;34;34;26;7;1;1;0;27;0;1;1;7;18;7
13302.0;2022;12;NANCY-METZ;MASCULIN;SCOLAIRE;BAC PROFESSIONNEL;BAC PRO PROD;BAC PRO 23005 TECHN. ETUDES BAT B ASSIST.ARCHI.;19;19;16;3;0;0;0;16;0;0;2;6;8;3
13309.0;2022;12;NANCY-METZ;MASCULIN;SCOLAIRE;BAC PROFESSIONNEL;BAC PRO PROD;BAC PRO 23405 TECHNICIEN MENUISIER AGENCEUR;42;42;24;14;4;4;0;28;0;1;3;10;14;14
13310.0;2022;12;NANCY-METZ;MASCULIN;SCOLAIRE;BAC PROFESSIONNEL;BAC PRO PROD;BAC PRO 23406 TECHNICIEN DE SCIERIE;1;1;1;0;0;0;0;1;0;1;0;0;0;0
13318.0;2022;12;NANCY-METZ;MASCULIN;SCOLAIRE;BAC PROFESSIONNEL;BAC PRO PROD;BAC PRO 25215 MAINT.VEHIC.OPTB VEHIC.TRANS.ROUT;29;29;20;4;5;1;4;21;0;0;5;6;10;8
13324.0;2022;12;NANCY-METZ;MASCULIN;SCOLAIRE;BAC PROFESSIONNEL;BAC PRO PROD;BAC PRO 25406 OUVRAGES DU BATIMENT METALLERIE;14;14;10;2;2;2;0;12;0;1;1;5;5;2
13339.0;2022;12;NANCY-METZ;MASCULIN;SCOLAIRE;BAC PROFESSIONNEL;BAC PRO PROD;BAC PRO AG 21303 FORET;15;15;14;1;0;0;0;14;0;0;0;6;8;1
13341.0;2022;12;NANCY-METZ;MASCULIN;SCOLAIRE;BAC PROFESSIONNEL;BAC PRO PROD;BAC PRO AG 22107 TEC CONS VTE ALIMENTATION P.ALIM;2;1;1;0;0;0;0;1;0;0;0;1;0;0
13342.0;2022;12;NANCY-METZ;MASCULIN;SCOLAIRE;BAC PROFESSIONNEL;BAC PRO SERV;BAC PRO 30001 GESTION-ADMINISTRATION;237;236;167;57;12;9;3;176;0;8;27;65;76;60
13354.0;2022;12;NANCY-METZ;MASCULIN;SCOLAIRE;BAC PROFESSIONNEL;BAC PRO SERV;BAC PRO 33003 ACC.SOINS-S.PERS. OPT.A DOMICILE;8;8;8;0;0;0;0;8;0;0;3;2;3;0
13355.0;2022;12;NANCY-METZ;MASCULIN;SCOLAIRE;BAC PROFESSIONNEL;BAC PRO SERV;BAC PRO 33004 ACC.SOINS-S.PERS. OPT.EN STRUCTUR;38;38;34;4;0;0;0;34;0;2;11;13;8;4
13363.0;2022;12;NANCY-METZ;MASCULIN;SCOLAIRE;BAC TECHNOLOGIQUE;BAC S2TMD;BAC S2TMD MUSIQUE;7;7;7;0;0;0;0;7;2;0;5;0;0;0
13370.0;2022;12;NANCY-METZ;MASCULIN;SCOLAIRE;BAC TECHNOLOGIQUE;BAC STI2D;BAC STI2D ENERGIES  ET ENVIRONNEMENT;190;190;148;6;36;25;11;173;0;1;17;54;101;17
13376.0;2022;12;NANCY-METZ;MASCULIN;SCOLAIRE;BAC TECHNOLOGIQUE;BAC STMG;BAC STMG MERCATIQUE (MARKETING);532;532;420;25;87;61;26;481;0;6;31;166;278;51
13379.0;2022;17;NANTES;FEMININ;APPRENTISSAGE;BAC PROFESSIONNEL;BAC PRO PROD;BAC PRO 22105 BOULANGER-PÂTISSIER;9;9;9;0;0;0;0;9;0;1;2;6;0;0
13381.0;2022;17;NANTES;FEMININ;APPRENTISSAGE;BAC PROFESSIONNEL;BAC PRO PROD;BAC PRO 22302 Traitement des matériaux;1;1;1;0;0;0;0;1;0;0;0;1;0;0
13383.0;2022;17;NANTES;FEMININ;APPRENTISSAGE;BAC PROFESSIONNEL;BAC PRO PROD;BAC PRO 22704 TECHN. MAINT. SYST.ENERG.CLIMATI;2;2;2;0;0;0;0;2;0;2;0;0;0;0
13385.0;2022;17;NANTES;FEMININ;APPRENTISSAGE;BAC PROFESSIONNEL;BAC PRO PROD;BAC PRO 23004 TECHN. ETUDES BAT.A ETUDES & ECO.;1;1;1;0;0;0;0;1;0;1;0;0;0;0
13389.0;2022;17;NANTES;FEMININ;APPRENTISSAGE;BAC PROFESSIONNEL;BAC PRO PROD;BAC PRO 24203 METIERS DE LA MODE - VÊTEMENT;10;10;10;0;0;0;0;10;0;0;6;4;0;0
13393.0;2022;17;NANTES;FEMININ;APPRENTISSAGE;BAC PROFESSIONNEL;BAC PRO PROD;BAC PRO 25216 MAINT.VEHIC.OPTC MOTOCYCLES;2;2;2;0;0;0;0;2;0;1;1;0;0;0
13401.0;2022;17;NANTES;FEMININ;APPRENTISSAGE;BAC PROFESSIONNEL;BAC PRO PROD;BAC PRO AG 21004 CGEA;21;21;15;6;0;0;0;15;0;0;0;4;11;6
13405.0;2022;17;NANTES;FEMININ;APPRENTISSAGE;BAC PROFESSIONNEL;BAC PRO PROD;BAC PRO AG 21210 COND GEST ENTR CANIN ET FELIN;7;7;7;0;0;0;0;7;0;0;0;0;7;0
13409.0;2022;17;NANTES;FEMININ;APPRENTISSAGE;BAC PROFESSIONNEL;BAC PRO PROD;BAC PRO AG 22107 TEC CONS VTE ALIMENTATION P.ALIM;17;17;17;0;0;0;0;17;0;0;1;9;7;0
13419.0;2022;17;NANTES;FEMININ;APPRENTISSAGE;BAC PROFESSIONNEL;BAC PRO SERV;BAC PRO 33003 ACC.SOINS-S.PERS. OPT.A DOMICILE;2;2;2;0;0;0;0;2;0;0;0;0;2;0
13428.0;2022;17;NANTES;FEMININ;ENSEIGNEMENT A DISTANCE;BAC PROFESSIONNEL;BAC PRO SERV;BAC PRO 30001 GESTION-ADMINISTRATION;1;1;0;1;0;0;0;0;0;0;0;0;0;1
13432.0;2022;17;NANTES;FEMININ;ENSEIGNEMENT A DISTANCE;BAC TECHNOLOGIQUE;BAC ST2S;BAC ST2S SCIENCES & TECHNO. SANTE & SOCIAL;10;10;7;2;1;0;1;7;0;0;0;1;6;3
13434.0;2022;17;NANTES;FEMININ;ENSEIGNEMENT A DISTANCE;BAC TECHNOLOGIQUE;BAC STMG;BAC STMG MERCATIQUE (MARKETING);4;4;3;1;0;0;0;3;0;0;0;1;2;1
13440.0;2022;17;NANTES;FEMININ;FORMATION CONTINUE;BAC PROFESSIONNEL;BAC PRO SERV;BAC PRO 31106 LOGISTIQUE;8;8;8;0;0;0;0;8;0;1;3;3;1;0
13447.0;2022;17;NANTES;FEMININ;INDIVIDUEL;BAC PROFESSIONNEL;BAC PRO PROD;BAC PRO AG 21211 COND GEST ENTR HIPPIQUE;8;4;3;1;0;0;0;3;0;0;0;0;3;1
13453.0;2022;17;NANTES;FEMININ;INDIVIDUEL;BAC PROFESSIONNEL;BAC PRO SERV;BAC PRO 33003 ACC.SOINS-S.PERS. OPT.A DOMICILE;2;1;1;0;0;0;0;1;0;0;0;1;0;0
13465.0;2022;17;NANTES;FEMININ;SCOLAIRE;BAC PROFESSIONNEL;BAC PRO PROD;BAC PRO 22403 ARTS.& MET.ART:MET.ENSEIGN SIGNA;5;5;5;0;0;0;0;5;0;0;0;2;3;0
13470.0;2022;17;NANTES;FEMININ;SCOLAIRE;BAC PROFESSIONNEL;BAC PRO PROD;BACPRO 23103 TECHNICIEN GEOMETRE-TOPOGRAPHE;5;5;4;1;0;0;0;4;0;0;1;2;1;1
13479.0;2022;17;NANTES;FEMININ;SCOLAIRE;BAC PROFESSIONNEL;BAC PRO PROD;BAC PRO 25106 TECHNICIEN D'USINAGE;4;4;3;1;0;0;0;3;0;0;0;1;2;1
13485.0;2022;17;NANTES;FEMININ;SCOLAIRE;BAC PROFESSIONNEL;BAC PRO PROD;BAC PRO 25408 REPARATION DES CARROSSERIES;1;1;1;0;0;0;0;1;0;0;0;1;0;0
13496.0;2022;17;NANTES;FEMININ;SCOLAIRE;BAC PROFESSIONNEL;BAC PRO PROD;BAC PRO AG 21210 COND GEST ENTR CANIN ET FELIN;37;37;36;1;0;0;0;36;0;0;5;11;20;1
13501.0;2022;17;NANTES;FEMININ;SCOLAIRE;BAC PROFESSIONNEL;BAC PRO PROD;BAC PRO AG 22105 LABORATOIRE CONTROLE QUALITE;9;9;8;1;0;0;0;8;0;1;3;2;2;1
13503.0;2022;17;NANTES;FEMININ;SCOLAIRE;BAC PROFESSIONNEL;BAC PRO PROD;BAC PRO AG 22107 TEC CONS VTE ALIMENTATION P.ALIM;74;73;60;13;0;0;0;60;0;0;9;17;34;13
13506.0;2022;17;NANTES;FEMININ;SCOLAIRE;BAC PROFESSIONNEL;BAC PRO SERV;BAC PRO 31107 CONDUCT. TRANSP.ROUT.MARCHANDISES;12;12;10;2;0;0;0;10;0;1;2;7;0;2
13515.0;2022;17;NANTES;FEMININ;SCOLAIRE;BAC PROFESSIONNEL;BAC PRO SERV;BAC PRO 33002 SERVICES DE PROXIMITE  VIE LOCAL;66;66;64;1;1;1;0;65;0;6;19;29;11;1
13520.0;2022;17;NANTES;FEMININ;SCOLAIRE;BAC PROFESSIONNEL;BAC PRO SERV;BAC PRO 33103 TECHNICIEN APPAREIL. ORTHOPEDIQUE;8;8;8;0;0;0;0;8;0;0;1;3;4;0
13522.0;2022;17;NANTES;FEMININ;SCOLAIRE;BAC PROFESSIONNEL;BAC PRO SERV;BAC PRO 33603 ESTHETIQUE COSMETIQUE PARFUMERIE;190;190;168;20;2;2;0;170;0;5;26;61;78;20
13523.0;2022;17;NANTES;FEMININ;SCOLAIRE;BAC PROFESSIONNEL;BAC PRO SERV;BAC PRO 34303 GEST. POLLUTIONS PROTEC. ENVIRON.;1;1;1;0;0;0;0;1;0;0;1;0;0;0
13524.0;2022;17;NANTES;FEMININ;SCOLAIRE;BAC PROFESSIONNEL;BAC PRO SERV;BAC PRO 34304 HYGIENE PROPRETE STERILISATION;9;9;7;2;0;0;0;7;0;0;2;3;2;2
13527.0;2022;17;NANTES;FEMININ;SCOLAIRE;BAC TECHNOLOGIQUE;BAC S2TMD;BAC S2TMD DANSE;18;18;18;0;0;0;0;18;1;8;4;3;2;0
13528.0;2022;17;NANTES;FEMININ;SCOLAIRE;BAC TECHNOLOGIQUE;BAC S2TMD;BAC S2TMD MUSIQUE;9;9;9;0;0;0;0;9;0;4;1;2;2;0
13535.0;2022;17;NANTES;FEMININ;SCOLAIRE;BAC TECHNOLOGIQUE;BAC STI2D;BAC STI2D INNOVATION TECHNO.  ET ECO CONCEPTION;21;21;19;1;1;1;0;20;0;1;7;4;8;1
13540.0;2022;17;NANTES;FEMININ;SCOLAIRE;BAC TECHNOLOGIQUE;BAC STMG;BAC STMG MERCATIQUE (MARKETING);1026;1026;868;27;131;83;48;951;0;15;139;333;464;75
13541.0;2022;17;NANTES;FEMININ;SCOLAIRE;BAC TECHNOLOGIQUE;BAC STMG;BAC STMG RESSOURCES HUMAINES ET COMMUNICATION;623;623;500;20;103;65;38;565;0;5;54;191;315;58
13553.0;2022;17;NANTES;MASCULIN;APPRENTISSAGE;BAC PROFESSIONNEL;BAC PRO PROD;BAC PRO 23102 TRAVAUX PUBLICS;81;81;65;15;1;0;1;65;0;4;16;24;21;16
13557.0;2022;17;NANTES;MASCULIN;APPRENTISSAGE;BAC PROFESSIONNEL;BAC PRO PROD;BAC PRO 23304 AMENAGEMENT FINITION BATIMENT;5;5;4;1;0;0;0;4;0;1;1;1;1;1
13563.0;2022;17;NANTES;MASCULIN;APPRENTISSAGE;BAC PROFESSIONNEL;BAC PRO PROD;BAC PRO 25009 MAINTENANCE NAUTIQUE;5;5;5;0;0;0;0;5;0;0;2;3;0;0
13565.0;2022;17;NANTES;MASCULIN;APPRENTISSAGE;BAC PROFESSIONNEL;BAC PRO PROD;BAC PRO 25214 MAINT.VEHIC.OPTA VOIT.PARTICUL.;253;252;192;30;30;17;13;209;0;12;39;58;100;43
13568.0;2022;17;NANTES;MASCULIN;APPRENTISSAGE;BAC PROFESSIONNEL;BAC PRO PROD;BAC PRO 25219 MAINT.MATERIELS OPT.A AGRICOLES;68;68;63;4;1;0;1;63;0;6;19;20;18;5
13580.0;2022;17;NANTES;MASCULIN;APPRENTISSAGE;BAC PROFESSIONNEL;BAC PRO PROD;BAC PRO 25513 SYST.NUM.OPT.A SURETE SECURITE;3;3;3;0;0;0;0;3;0;0;2;1;0;0
13585.0;2022;17;NANTES;MASCULIN;APPRENTISSAGE;BAC PROFESSIONNEL;BAC PRO PROD;BAC PRO AG 21113 CGEVV;18;18;14;4;0;0;0;14;0;0;1;1;12;4
13586.0;2022;17;NANTES;MASCULIN;APPRENTISSAGE;BAC PROFESSIONNEL;BAC PRO PROD;BAC PRO AG 21114 CONDUITE PRODUCTIONS HORTICOLES;22;22;19;3;0;0;0;19;0;0;2;5;12;3
13596.0;2022;17;NANTES;MASCULIN;APPRENTISSAGE;BAC PROFESSIONNEL;BAC PRO SERV;BAC PRO 31106 LOGISTIQUE;44;43;31;9;3;2;1;33;0;2;5;13;13;10
13598.0;2022;17;NANTES;MASCULIN;APPRENTISSAGE;BAC PROFESSIONNEL;BAC PRO SERV;BAC PRO 31209 POISSONIER ECAILLER TRAITEUR;3;3;2;1;0;0;0;2;0;1;1;0;0;1
13610.0;2022;17;NANTES;MASCULIN;ENSEIGNEMENT A DISTANCE;BAC PROFESSIONNEL;BAC PRO PROD;BAC PRO AG 21004 CGEA;10;10;8;2;0;0;0;8;0;0;0;0;8;2
13617.0;2022;17;NANTES;MASCULIN;FORMATION CONTINUE;BAC PROFESSIONNEL;BAC PRO PROD;BAC PRO 22106 CUISINE;1;0;0;0;0;0;0;0;0;0;0;0;0;0
13619.0;2022;17;NANTES;MASCULIN;FORMATION CONTINUE;BAC PROFESSIONNEL;BAC PRO PROD;BAC PRO 22704 TECHN. MAINT. SYST.ENERG.CLIMATI;1;1;1;0;0;0;0;1;0;1;0;0;0;0
13623.0;2022;17;NANTES;MASCULIN;FORMATION CONTINUE;BAC PROFESSIONNEL;BAC PRO PROD;BAC PRO 25007 MAINTENANCE EQUIPEMENTS INDUST.;11;11;11;0;0;0;0;11;0;4;2;4;1;0
13626.0;2022;17;NANTES;MASCULIN;FORMATION CONTINUE;BAC PROFESSIONNEL;BAC PRO PROD;BAC PRO 25509 TECHNIC. FROID CONDITIONNEMT AIR;3;3;3;0;0;0;0;3;0;0;2;1;0;0
13637.0;2022;17;NANTES;MASCULIN;INDIVIDUEL;BAC PROFESSIONNEL;BAC PRO PROD;BAC PRO 22704 TECHN. MAINT. SYST.ENERG.CLIMATI;1;1;1;0;0;0;0;1;0;0;0;0;1;0
13655.0;2022;17;NANTES;MASCULIN;INDIVIDUEL;BAC PROFESSIONNEL;BAC PRO SERV;BAC PRO 31107 CONDUCT. TRANSP.ROUT.MARCHANDISES;1;0;0;0;0;0;0;0;0;0;0;0;0;0
13657.0;2022;17;NANTES;MASCULIN;INDIVIDUEL;BAC PROFESSIONNEL;BAC PRO SERV;BAC PRO 32208 REAL.PR.IMPR.PLURI.OPTB.PR.IMPR.;1;1;1;0;0;0;0;1;0;0;1;0;0;0
13666.0;2022;17;NANTES;MASCULIN;INDIVIDUEL;BAC TECHNOLOGIQUE;BAC STI2D;BAC STI2D SYSTÈME D'INFORMATION  ET NUMERIQUE;3;3;0;2;1;0;1;0;0;0;0;0;0;3
13667.0;2022;17;NANTES;MASCULIN;INDIVIDUEL;BAC TECHNOLOGIQUE;BAC STL;BAC STL BIOCHIM.-BIOLOGIE-BIOTECHNOL.;1;0;0;0;0;0;0;0;0;0;0;0;0;0
13668.0;2022;17;NANTES;MASCULIN;INDIVIDUEL;BAC TECHNOLOGIQUE;BAC STL;BAC STL SCIENCES PHYSIQUES CHIMIQUES  EN LABORAT.;1;0;0;0;0;0;0;0;0;0;0;0;0;0
13669.0;2022;17;NANTES;MASCULIN;INDIVIDUEL;BAC TECHNOLOGIQUE;BAC STMG;BAC STMG GESTION ET FINANCE;7;7;3;3;1;0;1;3;0;0;0;0;3;4
13673.0;2022;17;NANTES;MASCULIN;SCOLAIRE;BAC GENERAL;BAC GENERAL;BAC GENE 10019 BAC GENERAL;9227;9227;8513;118;596;419;177;8932;101;953;2129;2988;2761;295
13675.0;2022;17;NANTES;MASCULIN;SCOLAIRE;BAC PROFESSIONNEL;BAC PRO PROD;BAC PRO 20102 PILOTE DE LIGNE DE PRODUCTION;27;27;21;3;3;1;2;22;0;1;6;6;9;5
13677.0;2022;17;NANTES;MASCULIN;SCOLAIRE;BAC PROFESSIONNEL;BAC PRO PROD;BAC PRO 22105 BOULANGER-PÂTISSIER;30;30;27;2;1;1;0;28;0;1;8;9;10;2
13684.0;2022;17;NANTES;MASCULIN;SCOLAIRE;BAC PROFESSIONNEL;BAC PRO PROD;BAC PRO 23004 TECHN. ETUDES BAT.A ETUDES & ECO.;74;74;62;12;0;0;0;62;0;1;9;30;22;12
13685.0;2022;17;NANTES;MASCULIN;SCOLAIRE;BAC PROFESSIONNEL;BAC PRO PROD;BAC PRO 23005 TECHN. ETUDES BAT B ASSIST.ARCHI.;48;48;40;6;2;2;0;42;0;2;10;16;14;6
13687.0;2022;17;NANTES;MASCULIN;SCOLAIRE;BAC PROFESSIONNEL;BAC PRO PROD;BACPRO 23103 TECHNICIEN GEOMETRE-TOPOGRAPHE;14;14;8;6;0;0;0;8;0;0;0;7;1;6
13689.0;2022;17;NANTES;MASCULIN;SCOLAIRE;BAC PROFESSIONNEL;BAC PRO PROD;BAC PRO 23205 INTERV. SUR PATRIMOINE BATI OPT.A;4;4;2;2;0;0;0;2;0;0;0;1;1;2
13700.0;2022;17;NANTES;MASCULIN;SCOLAIRE;BAC PROFESSIONNEL;BAC PRO PROD;BAC PRO 25007 MAINTENANCE EQUIPEMENTS INDUST.;279;279;226;48;5;3;2;229;0;5;48;105;71;50
13712.0;2022;17;NANTES;MASCULIN;SCOLAIRE;BAC PROFESSIONNEL;BAC PRO PROD;BAC PRO 25410 CONSTRUCTION DES CARROSSERIES;14;14;12;0;2;0;2;12;0;2;5;1;4;2
13715.0;2022;17;NANTES;MASCULIN;SCOLAIRE;BAC PROFESSIONNEL;BAC PRO PROD;BAC PRO 25510 METIERS ELECT. ENVIRON. CONNECTES;400;400;320;63;17;7;10;327;0;14;67;110;136;73
13726.0;2022;17;NANTES;MASCULIN;SCOLAIRE;BAC PROFESSIONNEL;BAC PRO PROD;BAC PRO AG 21211 COND GEST ENTR HIPPIQUE;10;10;10;0;0;0;0;10;0;0;0;3;7;0
13732.0;2022;17;NANTES;MASCULIN;SCOLAIRE;BAC PROFESSIONNEL;BAC PRO PROD;BAC PRO AG 22106 TEC CONS VTE ALIMENTATION VINS SP;7;7;7;0;0;0;0;7;0;1;0;2;4;0
13738.0;2022;17;NANTES;MASCULIN;SCOLAIRE;BAC PROFESSIONNEL;BAC PRO SERV;BAC PRO 31212 METIERS DE L'ACCUEIL;98;98;76;17;5;5;0;81;0;1;17;31;32;17
13744.0;2022;17;NANTES;MASCULIN;SCOLAIRE;BAC PROFESSIONNEL;BAC PRO SERV;BAC PRO 32304 PHOTOGRAPHIE;5;5;4;1;0;0;0;4;0;1;2;0;1;1
13745.0;2022;17;NANTES;MASCULIN;SCOLAIRE;BAC PROFESSIONNEL;BAC PRO SERV;BAC PRO 33002 SERVICES DE PROXIMITE  VIE LOCAL;49;49;43;4;2;2;0;45;0;3;8;19;15;4
13747.0;2022;17;NANTES;MASCULIN;SCOLAIRE;BAC PROFESSIONNEL;BAC PRO SERV;BAC PRO 33004 ACC.SOINS-S.PERS. OPT.EN STRUCTUR;60;60;55;5;0;0;0;55;0;5;13;18;19;5
13752.0;2022;17;NANTES;MASCULIN;SCOLAIRE;BAC PROFESSIONNEL;BAC PRO SERV;BAC PRO 34303 GEST. POLLUTIONS PROTEC. ENVIRON.;2;2;2;0;0;0;0;2;0;0;0;1;1;0
13756.0;2022;17;NANTES;MASCULIN;SCOLAIRE;BAC TECHNOLOGIQUE;BAC S2TMD;BAC S2TMD DANSE;5;5;5;0;0;0;0;5;0;0;1;3;1;0
13759.0;2022;17;NANTES;MASCULIN;SCOLAIRE;BAC TECHNOLOGIQUE;BAC STAV;BAC STAV AGRONOMIE ALIM ENV TERRITOI;166;166;160;6;0;0;0;160;0;4;18;72;66;6
13761.0;2022;17;NANTES;MASCULIN;SCOLAIRE;BAC TECHNOLOGIQUE;BAC STHR;BAC STHR SC.&TEC. HOTELLERIE-RESTAURATION;61;61;56;1;4;3;1;59;0;1;16;23;19;2
13771.0;2022;17;NANTES;MASCULIN;SCOLAIRE;BAC TECHNOLOGIQUE;BAC STMG;BAC STMG SYSTEMES D'INFORMATION DE GESTION;18;18;16;0;2;2;0;18;0;0;0;7;11;0
13773.0;2022;23;NICE;FEMININ;APPRENTISSAGE;BAC PROFESSIONNEL;BAC PRO PROD;BAC PRO 22403 ARTS.& MET.ART:MET.ENSEIGN SIGNA;1;1;1;0;0;0;0;1;0;0;1;0;0;0
13774.0;2022;23;NICE;FEMININ;APPRENTISSAGE;BAC PROFESSIONNEL;BAC PRO PROD;BAC PRO 23004 TECHN. ETUDES BAT.A ETUDES & ECO.;1;1;1;0;0;0;0;1;0;0;0;0;1;0
13780.0;2022;23;NICE;FEMININ;APPRENTISSAGE;BAC PROFESSIONNEL;BAC PRO PROD;BAC PRO 25408 REPARATION DES CARROSSERIES;1;1;0;0;1;1;0;1;0;0;0;0;1;0
13781.0;2022;23;NICE;FEMININ;APPRENTISSAGE;BAC PROFESSIONNEL;BAC PRO PROD;BAC PRO 25510 METIERS ELECT. ENVIRON. CONNECTES;3;3;2;1;0;0;0;2;0;0;2;0;0;1
13786.0;2022;23;NICE;FEMININ;APPRENTISSAGE;BAC PROFESSIONNEL;BAC PRO SERV;BAC PRO 31106 LOGISTIQUE;3;3;2;1;0;0;0;2;0;0;0;1;1;1
13789.0;2022;23;NICE;FEMININ;APPRENTISSAGE;BAC PROFESSIONNEL;BAC PRO SERV;BAC PRO 31214 MET.COM.VEN.OP.B PR.CL.VA.OF.COM.;3;3;3;0;0;0;0;3;0;0;0;2;1;0
13790.0;2022;23;NICE;FEMININ;APPRENTISSAGE;BAC PROFESSIONNEL;BAC PRO SERV;BAC PRO 33004 ACC.SOINS-S.PERS. OPT.EN STRUCTUR;5;5;4;1;0;0;0;4;0;1;0;1;2;1
13794.0;2022;23;NICE;FEMININ;ENSEIGNEMENT A DISTANCE;BAC PROFESSIONNEL;BAC PRO SERV;BAC PRO 30001 GESTION-ADMINISTRATION;6;6;5;1;0;0;0;5;0;1;0;2;2;1
13798.0;2022;23;NICE;FEMININ;ENSEIGNEMENT A DISTANCE;BAC PROFESSIONNEL;BAC PRO SERV;BAC PRO 33603 ESTHETIQUE COSMETIQUE PARFUMERIE;2;2;2;0;0;0;0;2;0;0;0;0;2;0
13804.0;2022;23;NICE;FEMININ;FORMATION CONTINUE;BAC PROFESSIONNEL;BAC PRO PROD;BAC PRO 22106 CUISINE;5;5;4;1;0;0;0;4;0;2;1;1;0;1
13817.0;2022;23;NICE;FEMININ;INDIVIDUEL;BAC PROFESSIONNEL;BAC PRO SERV;BAC PRO 31108 TRANSPORT;1;0;0;0;0;0;0;0;0;0;0;0;0;0
13824.0;2022;23;NICE;FEMININ;INDIVIDUEL;BAC TECHNOLOGIQUE;BAC STMG;BAC STMG GESTION ET FINANCE;2;2;1;1;0;0;0;1;0;1;0;0;0;1
13830.0;2022;23;NICE;FEMININ;SCOLAIRE;BAC PROFESSIONNEL;BAC PRO PROD;BAC PRO 22105 BOULANGER-PÂTISSIER;30;30;30;0;0;0;0;30;0;4;6;10;10;0
13833.0;2022;23;NICE;FEMININ;SCOLAIRE;BAC PROFESSIONNEL;BAC PRO PROD;BAC PRO 23003 ARTIS. & M.ART:MARCHANDISAGE VIS.;6;6;6;0;0;0;0;6;0;0;2;2;2;0
13834.0;2022;23;NICE;FEMININ;SCOLAIRE;BAC PROFESSIONNEL;BAC PRO PROD;BAC PRO 23004 TECHN. ETUDES BAT.A ETUDES & ECO.;9;9;7;2;0;0;0;7;0;0;3;4;0;2
13839.0;2022;23;NICE;FEMININ;SCOLAIRE;BAC PROFESSIONNEL;BAC PRO PROD;BAC PRO 23408 Etude et réalisation d'agencement;3;3;3;0;0;0;0;3;0;2;0;1;0;0
13843.0;2022;23;NICE;FEMININ;SCOLAIRE;BAC PROFESSIONNEL;BAC PRO PROD;BAC PRO 25006 MICROTECHNIQUES;5;5;5;0;0;0;0;5;0;2;3;0;0;0
13846.0;2022;23;NICE;FEMININ;SCOLAIRE;BAC PROFESSIONNEL;BAC PRO PROD;BAC PRO 25214 MAINT.VEHIC.OPTA VOIT.PARTICUL.;6;6;4;2;0;0;0;4;0;0;2;1;1;2
13853.0;2022;23;NICE;FEMININ;SCOLAIRE;BAC PROFESSIONNEL;BAC PRO PROD;BAC PRO 25514 SYST.NUM.OPT.B AUD.RES.EQUIP.DOM.;4;4;3;1;0;0;0;3;0;0;0;2;1;1
13854.0;2022;23;NICE;FEMININ;SCOLAIRE;BAC PROFESSIONNEL;BAC PRO PROD;BAC PRO 25515 SYST.NUM.OPT.C RES.INF.SYST.COMM.;3;3;3;0;0;0;0;3;0;0;2;0;1;0
13858.0;2022;23;NICE;FEMININ;SCOLAIRE;BAC PROFESSIONNEL;BAC PRO PROD;BAC PRO AG 21405 AMENAGEMENTS PAYSAGERS;4;4;4;0;0;0;0;4;0;0;0;3;1;0
13859.0;2022;23;NICE;FEMININ;SCOLAIRE;BAC PROFESSIONNEL;BAC PRO PROD;BAC PRO AG 22105 LABORATOIRE CONTROLE QUALITE;7;7;5;2;0;0;0;5;0;0;0;2;3;2
13874.0;2022;23;NICE;FEMININ;SCOLAIRE;BAC PROFESSIONNEL;BAC PRO SERV;BAC PRO 33603 ESTHETIQUE COSMETIQUE PARFUMERIE;100;99;82;16;1;1;0;83;0;4;23;27;29;16
13876.0;2022;23;NICE;FEMININ;SCOLAIRE;BAC PROFESSIONNEL;BAC PRO SERV;BAC PRO 34403 METIERS DE LA SECURITE;21;21;21;0;0;0;0;21;0;0;5;12;4;0
13880.0;2022;23;NICE;FEMININ;SCOLAIRE;BAC TECHNOLOGIQUE;BAC ST2S;BAC ST2S SCIENCES & TECHNO. SANTE & SOCIAL;375;375;315;7;53;26;27;341;1;11;46;127;156;34
13882.0;2022;23;NICE;FEMININ;SCOLAIRE;BAC TECHNOLOGIQUE;BAC STD2A;BAC STD2A SCIENCES & TECHNO. DESIGN-ARTS APPLIQUES;105;105;100;1;4;3;1;103;0;10;39;34;20;2
13886.0;2022;23;NICE;FEMININ;SCOLAIRE;BAC TECHNOLOGIQUE;BAC STI2D;BAC STI2D INNOVATION TECHNO.  ET ECO CONCEPTION;22;22;22;0;0;0;0;22;0;1;6;7;8;0
13887.0;2022;23;NICE;FEMININ;SCOLAIRE;BAC TECHNOLOGIQUE;BAC STI2D;BAC STI2D SYSTÈME D'INFORMATION  ET NUMERIQUE;10;10;8;1;1;0;1;8;0;1;0;1;6;2
13894.0;2022;23;NICE;MASCULIN;APPRENTISSAGE;BAC PROFESSIONNEL;BAC PRO PROD;BAC PRO 22106 CUISINE;6;5;4;1;0;0;0;4;0;1;0;1;2;1
13899.0;2022;23;NICE;MASCULIN;APPRENTISSAGE;BAC PROFESSIONNEL;BAC PRO PROD;BAC PRO 23303 MENUISERIE ALUMINIUM-VERRE;10;10;6;2;2;0;2;6;0;0;0;0;6;4
13905.0;2022;23;NICE;MASCULIN;APPRENTISSAGE;BAC PROFESSIONNEL;BAC PRO PROD;BAC PRO 25214 MAINT.VEHIC.OPTA VOIT.PARTICUL.;82;75;60;6;9;5;4;65;0;7;14;20;24;10
13906.0;2022;23;NICE;MASCULIN;APPRENTISSAGE;BAC PROFESSIONNEL;BAC PRO PROD;BAC PRO 25215 MAINT.VEHIC.OPTB VEHIC.TRANS.ROUT;6;6;4;1;1;0;1;4;0;0;0;1;3;2
13909.0;2022;23;NICE;MASCULIN;APPRENTISSAGE;BAC PROFESSIONNEL;BAC PRO PROD;BAC PRO 25406 OUVRAGES DU BATIMENT METALLERIE;3;3;2;1;0;0;0;2;0;0;0;1;1;1
13910.0;2022;23;NICE;MASCULIN;APPRENTISSAGE;BAC PROFESSIONNEL;BAC PRO PROD;BAC PRO 25408 REPARATION DES CARROSSERIES;12;12;9;3;0;0;0;9;0;0;3;3;3;3
13919.0;2022;23;NICE;MASCULIN;APPRENTISSAGE;BAC PROFESSIONNEL;BAC PRO PROD;BAC PRO AG 21405 AMENAGEMENTS PAYSAGERS;24;24;22;2;0;0;0;22;0;1;2;4;15;2
13921.0;2022;23;NICE;MASCULIN;APPRENTISSAGE;BAC PROFESSIONNEL;BAC PRO SERV;BAC PRO 31106 LOGISTIQUE;8;8;6;2;0;0;0;6;0;0;0;2;4;2
13922.0;2022;23;NICE;MASCULIN;APPRENTISSAGE;BAC PROFESSIONNEL;BAC PRO SERV;BAC PRO 31212 METIERS DE L'ACCUEIL;1;1;0;1;0;0;0;0;0;0;0;0;0;1
13936.0;2022;23;NICE;MASCULIN;FORMATION CONTINUE;BAC PROFESSIONNEL;BAC PRO PROD;BAC PRO 22106 CUISINE;1;1;1;0;0;0;0;1;0;0;0;1;0;0
13938.0;2022;23;NICE;MASCULIN;FORMATION CONTINUE;BAC PROFESSIONNEL;BAC PRO SERV;BAC PRO 31212 METIERS DE L'ACCUEIL;1;0;0;0;0;0;0;0;0;0;0;0;0;0
13943.0;2022;23;NICE;MASCULIN;INDIVIDUEL;BAC PROFESSIONNEL;BAC PRO PROD;BAC PRO 23004 TECHN. ETUDES BAT.A ETUDES & ECO.;1;1;0;1;0;0;0;0;0;0;0;0;0;1
13950.0;2022;23;NICE;MASCULIN;INDIVIDUEL;BAC PROFESSIONNEL;BAC PRO PROD;BAC PRO 25514 SYST.NUM.OPT.B AUD.RES.EQUIP.DOM.;1;1;1;0;0;0;0;1;0;0;0;0;1;0
13951.0;2022;23;NICE;MASCULIN;INDIVIDUEL;BAC PROFESSIONNEL;BAC PRO PROD;BAC PRO 25515 SYST.NUM.OPT.C RES.INF.SYST.COMM.;1;1;1;0;0;0;0;1;0;0;0;0;1;0
13953.0;2022;23;NICE;MASCULIN;INDIVIDUEL;BAC PROFESSIONNEL;BAC PRO PROD;BAC PRO AG 21113 CGEVV;1;1;1;0;0;0;0;1;0;0;0;0;1;0
13958.0;2022;23;NICE;MASCULIN;INDIVIDUEL;BAC PROFESSIONNEL;BAC PRO SERV;BAC PRO 31214 MET.COM.VEN.OP.B PR.CL.VA.OF.COM.;5;2;1;1;0;0;0;1;0;0;0;1;0;1
13959.0;2022;23;NICE;MASCULIN;INDIVIDUEL;BAC TECHNOLOGIQUE;BAC STAV;BAC STAV AGRONOMIE ALIM ENV TERRITOI;1;1;1;0;0;0;0;1;0;0;0;0;1;0
13963.0;2022;23;NICE;MASCULIN;INDIVIDUEL;BAC TECHNOLOGIQUE;BAC STI2D;BAC STI2D INNOVATION TECHNO.  ET ECO CONCEPTION;1;1;0;1;0;0;0;0;0;0;0;0;0;1
13970.0;2022;23;NICE;MASCULIN;SCOLAIRE;BAC PROFESSIONNEL;BAC PRO PROD;BAC PRO 20102 PILOTE DE LIGNE DE PRODUCTION;6;5;2;1;2;2;0;4;0;1;0;1;2;1
13972.0;2022;23;NICE;MASCULIN;SCOLAIRE;BAC PROFESSIONNEL;BAC PRO PROD;BAC PRO 22106 CUISINE;138;136;112;16;8;5;3;117;0;2;16;49;50;19
13974.0;2022;23;NICE;MASCULIN;SCOLAIRE;BAC PROFESSIONNEL;BAC PRO PROD;BAC PRO 22703 TECHN.INSTALL.SYST.ENERG.CLIMATI;49;49;41;6;2;1;1;42;0;1;6;16;19;7
13979.0;2022;23;NICE;MASCULIN;SCOLAIRE;BAC PROFESSIONNEL;BAC PRO PROD;BACPRO 23103 TECHNICIEN GEOMETRE-TOPOGRAPHE;15;15;14;1;0;0;0;14;0;1;1;7;5;1
13982.0;2022;23;NICE;MASCULIN;SCOLAIRE;BAC PROFESSIONNEL;BAC PRO PROD;BAC PRO 23303 MENUISERIE ALUMINIUM-VERRE;9;9;6;3;0;0;0;6;0;0;0;2;4;3
13986.0;2022;23;NICE;MASCULIN;SCOLAIRE;BAC PROFESSIONNEL;BAC PRO PROD;BAC PRO 23408 Etude et réalisation d'agencement;6;6;5;1;0;0;0;5;0;0;0;3;2;1
13987.0;2022;23;NICE;MASCULIN;SCOLAIRE;BAC PROFESSIONNEL;BAC PRO PROD;BAC PRO 24202 ARTIS.& MET.ART : TAPIS.D'AMEUBL;4;4;3;1;0;0;0;3;0;0;0;2;1;1
13995.0;2022;23;NICE;MASCULIN;SCOLAIRE;BAC PROFESSIONNEL;BAC PRO PROD;BAC PRO 25214 MAINT.VEHIC.OPTA VOIT.PARTICUL.;124;123;81;39;3;3;0;84;0;0;15;29;40;39
13996.0;2022;23;NICE;MASCULIN;SCOLAIRE;BAC PROFESSIONNEL;BAC PRO PROD;BAC PRO 25215 MAINT.VEHIC.OPTB VEHIC.TRANS.ROUT;22;20;15;3;2;2;0;17;0;0;1;6;10;3
14011.0;2022;23;NICE;MASCULIN;SCOLAIRE;BAC PROFESSIONNEL;BAC PRO PROD;BAC PRO AG 21405 AMENAGEMENTS PAYSAGERS;43;42;35;7;0;0;0;35;0;0;4;12;19;7
14017.0;2022;23;NICE;MASCULIN;SCOLAIRE;BAC PROFESSIONNEL;BAC PRO SERV;BAC PRO 31212 METIERS DE L'ACCUEIL;76;75;51;15;9;6;3;57;0;2;6;22;27;18
14018.0;2022;23;NICE;MASCULIN;SCOLAIRE;BAC PROFESSIONNEL;BAC PRO SERV;BAC PRO 31213 MET.COM.VEN.OP.A ANI.GES.ESP.COM.;289;285;207;62;16;12;4;219;0;5;29;86;99;66
14030.0;2022;23;NICE;MASCULIN;SCOLAIRE;BAC PROFESSIONNEL;BAC PRO SERV;BAC PRO 34403 METIERS DE LA SECURITE;59;59;51;4;4;4;0;55;0;2;14;23;16;4
14033.0;2022;23;NICE;MASCULIN;SCOLAIRE;BAC TECHNOLOGIQUE;BAC ST2S;BAC ST2S SCIENCES & TECHNO. SANTE & SOCIAL;64;64;53;2;9;1;8;54;0;1;4;21;28;10
14041.0;2022;23;NICE;MASCULIN;SCOLAIRE;BAC TECHNOLOGIQUE;BAC STL;BAC STL BIOCHIM.-BIOLOGIE-BIOTECHNOL.;37;37;30;4;3;3;0;33;0;1;3;14;15;4
14042.0;2022;23;NICE;MASCULIN;SCOLAIRE;BAC TECHNOLOGIQUE;BAC STL;BAC STL SCIENCES PHYSIQUES CHIMIQUES  EN LABORAT.;47;47;43;0;4;2;2;45;0;3;13;13;16;2
14045.0;2022;23;NICE;MASCULIN;SCOLAIRE;BAC TECHNOLOGIQUE;BAC STMG;BAC STMG RESSOURCES HUMAINES ET COMMUNICATION;164;164;110;15;39;22;17;132;0;0;6;36;90;32
14052.0;2022;70;NORMANDIE;FEMININ;APPRENTISSAGE;BAC PROFESSIONNEL;BAC PRO PROD;BAC PRO 23405 TECHNICIEN MENUISIER AGENCEUR;1;1;1;0;0;0;0;1;0;0;0;1;0;0
14062.0;2022;70;NORMANDIE;FEMININ;APPRENTISSAGE;BAC PROFESSIONNEL;BAC PRO PROD;BAC PRO AG 21114 CONDUITE PRODUCTIONS HORTICOLES;3;3;3;0;0;0;0;3;0;0;0;3;0;0
14066.0;2022;70;NORMANDIE;FEMININ;APPRENTISSAGE;BAC PROFESSIONNEL;BAC PRO PROD;BAC PRO AG 21405 AMENAGEMENTS PAYSAGERS;4;4;4;0;0;0;0;4;0;0;1;1;2;0
14067.0;2022;70;NORMANDIE;FEMININ;APPRENTISSAGE;BAC PROFESSIONNEL;BAC PRO PROD;BAC PRO AG 22107 TEC CONS VTE ALIMENTATION P.ALIM;5;5;1;4;0;0;0;1;0;0;0;0;1;4
14071.0;2022;70;NORMANDIE;FEMININ;APPRENTISSAGE;BAC PROFESSIONNEL;BAC PRO SERV;BAC PRO 31213 MET.COM.VEN.OP.A ANI.GES.ESP.COM.;145;141;114;21;6;5;1;119;0;4;26;51;38;22
14077.0;2022;70;NORMANDIE;FEMININ;ENSEIGNEMENT A DISTANCE;BAC PROFESSIONNEL;BAC PRO SERV;BAC PRO 30001 GESTION-ADMINISTRATION;6;4;0;4;0;0;0;0;0;0;0;0;0;4
14087.0;2022;70;NORMANDIE;FEMININ;FORMATION CONTINUE;BAC PROFESSIONNEL;BAC PRO PROD;BAC PRO 22004 PROC. CHIMIE EAU PAPIERS-CARTONS;1;1;1;0;0;0;0;1;0;1;0;0;0;0
14093.0;2022;70;NORMANDIE;FEMININ;FORMATION CONTINUE;BAC PROFESSIONNEL;BAC PRO PROD;BAC PRO AG 22107 TEC CONS VTE ALIMENTATION P.ALIM;2;1;1;0;0;0;0;1;0;0;0;0;1;0
14095.0;2022;70;NORMANDIE;FEMININ;FORMATION CONTINUE;BAC PROFESSIONNEL;BAC PRO SERV;BAC PRO 31212 METIERS DE L'ACCUEIL;10;9;9;0;0;0;0;9;0;2;4;1;2;0
14100.0;2022;70;NORMANDIE;FEMININ;FORMATION CONTINUE;BAC PROFESSIONNEL;BAC PRO SERV;BAC PRO 34304 HYGIENE PROPRETE STERILISATION;6;6;4;2;0;0;0;4;0;0;0;3;1;2
14105.0;2022;70;NORMANDIE;FEMININ;INDIVIDUEL;BAC PROFESSIONNEL;BAC PRO PROD;BAC PRO AG 21114 CONDUITE PRODUCTIONS HORTICOLES;1;1;1;0;0;0;0;1;0;0;0;0;1;0
14108.0;2022;70;NORMANDIE;FEMININ;INDIVIDUEL;BAC PROFESSIONNEL;BAC PRO SERV;BAC PRO 31212 METIERS DE L'ACCUEIL;1;0;0;0;0;0;0;0;0;0;0;0;0;0
14114.0;2022;70;NORMANDIE;FEMININ;INDIVIDUEL;BAC TECHNOLOGIQUE;BAC STI2D;BAC STI2D INNOVATION TECHNO.  ET ECO CONCEPTION;1;1;0;1;0;0;0;0;0;0;0;0;0;1
14120.0;2022;70;NORMANDIE;FEMININ;SCOLAIRE;BAC PROFESSIONNEL;BAC PRO PROD;BAC PRO 22003 BIO-INDUSTRIES DE TRANSFORMATION;20;20;9;11;0;0;0;9;0;0;0;2;7;11
14125.0;2022;70;NORMANDIE;FEMININ;SCOLAIRE;BAC PROFESSIONNEL;BAC PRO PROD;BAC PRO 22503 PLASTIQUES ET COMPOSITES;3;3;0;2;1;1;0;1;0;0;0;0;1;2
14127.0;2022;70;NORMANDIE;FEMININ;SCOLAIRE;BAC PROFESSIONNEL;BAC PRO PROD;BAC PRO 23003 ARTIS. & M.ART:MARCHANDISAGE VIS.;12;12;12;0;0;0;0;12;0;0;4;5;3;0
14142.0;2022;70;NORMANDIE;FEMININ;SCOLAIRE;BAC PROFESSIONNEL;BAC PRO PROD;BAC PRO 25214 MAINT.VEHIC.OPTA VOIT.PARTICUL.;13;13;12;1;0;0;0;12;0;0;2;1;9;1
14146.0;2022;70;NORMANDIE;FEMININ;SCOLAIRE;BAC PROFESSIONNEL;BAC PRO PROD;BAC PRO 25408 REPARATION DES CARROSSERIES;4;4;4;0;0;0;0;4;0;0;0;3;1;0
14150.0;2022;70;NORMANDIE;FEMININ;SCOLAIRE;BAC PROFESSIONNEL;BAC PRO PROD;BAC PRO 25513 SYST.NUM.OPT.A SURETE SECURITE;2;2;2;0;0;0;0;2;0;0;2;0;0;0
14165.0;2022;70;NORMANDIE;FEMININ;SCOLAIRE;BAC PROFESSIONNEL;BAC PRO SERV;BAC PRO 31106 LOGISTIQUE;46;46;41;5;0;0;0;41;0;2;10;11;18;5
14166.0;2022;70;NORMANDIE;FEMININ;SCOLAIRE;BAC PROFESSIONNEL;BAC PRO SERV;BAC PRO 31107 CONDUCT. TRANSP.ROUT.MARCHANDISES;10;10;8;2;0;0;0;8;0;2;4;1;1;2
14167.0;2022;70;NORMANDIE;FEMININ;SCOLAIRE;BAC PROFESSIONNEL;BAC PRO SERV;BAC PRO 31108 TRANSPORT;22;22;17;5;0;0;0;17;0;1;4;7;5;5
14171.0;2022;70;NORMANDIE;FEMININ;SCOLAIRE;BAC PROFESSIONNEL;BAC PRO SERV;BAC PRO 32207 REAL.PR.IMPR.PLURI.OPTA.PR.GRAPH.;8;8;5;3;0;0;0;5;0;0;1;3;1;3
14172.0;2022;70;NORMANDIE;FEMININ;SCOLAIRE;BAC PROFESSIONNEL;BAC PRO SERV;BAC PRO 32208 REAL.PR.IMPR.PLURI.OPTB.PR.IMPR.;9;9;6;3;0;0;0;6;0;0;2;2;2;3
14177.0;2022;70;NORMANDIE;FEMININ;SCOLAIRE;BAC PROFESSIONNEL;BAC PRO SERV;BAC PRO 33004 ACC.SOINS-S.PERS. OPT.EN STRUCTUR;596;595;534;45;16;8;8;542;0;36;172;197;137;53
14190.0;2022;70;NORMANDIE;FEMININ;SCOLAIRE;BAC TECHNOLOGIQUE;BAC STAV;BAC STAV AGRONOMIE ALIM ENV TERRITOI;147;144;138;6;0;0;0;138;0;0;11;45;82;6
14195.0;2022;70;NORMANDIE;FEMININ;SCOLAIRE;BAC TECHNOLOGIQUE;BAC STI2D;BAC STI2D INNOVATION TECHNO.  ET ECO CONCEPTION;30;30;24;0;6;5;1;29;0;0;4;7;18;1
14197.0;2022;70;NORMANDIE;FEMININ;SCOLAIRE;BAC TECHNOLOGIQUE;BAC STL;BAC STL BIOCHIM.-BIOLOGIE-BIOTECHNOL.;128;128;106;4;18;15;3;121;1;5;19;32;64;7
14199.0;2022;70;NORMANDIE;FEMININ;SCOLAIRE;BAC TECHNOLOGIQUE;BAC STMG;BAC STMG GESTION ET FINANCE;367;367;325;7;35;26;9;351;0;8;62;134;147;16
14203.0;2022;70;NORMANDIE;MASCULIN;APPRENTISSAGE;BAC PROFESSIONNEL;BAC PRO PROD;BAC PRO 20102 PILOTE DE LIGNE DE PRODUCTION;10;9;8;1;0;0;0;8;0;3;1;3;1;1
14207.0;2022;70;NORMANDIE;MASCULIN;APPRENTISSAGE;BAC PROFESSIONNEL;BAC PRO PROD;BAC PRO 22106 CUISINE;13;12;8;3;1;0;1;8;0;0;1;2;5;4
14218.0;2022;70;NORMANDIE;MASCULIN;APPRENTISSAGE;BAC PROFESSIONNEL;BAC PRO PROD;BAC PRO 25009 MAINTENANCE NAUTIQUE;3;3;2;1;0;0;0;2;0;0;1;0;1;1
14225.0;2022;70;NORMANDIE;MASCULIN;APPRENTISSAGE;BAC PROFESSIONNEL;BAC PRO PROD;BAC PRO 25220 MAINT.MATERIELS OPT.B TP MANUT.;6;6;4;2;0;0;0;4;0;0;0;3;1;2
14227.0;2022;70;NORMANDIE;MASCULIN;APPRENTISSAGE;BAC PROFESSIONNEL;BAC PRO PROD;BAC PRO 25303 AERONAUTIQUE OPTION SYSTEMES;8;8;7;1;0;0;0;7;0;3;3;1;0;1
14233.0;2022;70;NORMANDIE;MASCULIN;APPRENTISSAGE;BAC PROFESSIONNEL;BAC PRO PROD;BAC PRO 25514 SYST.NUM.OPT.B AUD.RES.EQUIP.DOM.;1;1;1;0;0;0;0;1;0;0;0;1;0;0
14236.0;2022;70;NORMANDIE;MASCULIN;APPRENTISSAGE;BAC PROFESSIONNEL;BAC PRO PROD;BAC PRO AG 21004 CGEA;103;100;69;31;0;0;0;69;0;0;2;18;49;31
14253.0;2022;70;NORMANDIE;MASCULIN;APPRENTISSAGE;BAC PROFESSIONNEL;BAC PRO SERV;BAC PRO AG 33002 SERV PERS TERRIT;1;1;1;0;0;0;0;1;0;0;0;0;1;0
14268.0;2022;70;NORMANDIE;MASCULIN;FORMATION CONTINUE;BAC PROFESSIONNEL;BAC PRO PROD;BAC PRO 23004 TECHN. ETUDES BAT.A ETUDES & ECO.;7;6;6;0;0;0;0;6;0;1;1;2;2;0
14269.0;2022;70;NORMANDIE;MASCULIN;FORMATION CONTINUE;BAC PROFESSIONNEL;BAC PRO PROD;BAC PRO 23404 TECHNICIEN CONSTRUCTEUR BOIS;2;2;2;0;0;0;0;2;0;1;0;1;0;0
14270.0;2022;70;NORMANDIE;MASCULIN;FORMATION CONTINUE;BAC PROFESSIONNEL;BAC PRO PROD;BAC PRO 23405 TECHNICIEN MENUISIER AGENCEUR;2;2;2;0;0;0;0;2;0;1;1;0;0;0
14271.0;2022;70;NORMANDIE;MASCULIN;FORMATION CONTINUE;BAC PROFESSIONNEL;BAC PRO PROD;BAC PRO 25007 MAINTENANCE EQUIPEMENTS INDUST.;25;21;19;2;0;0;0;19;0;3;4;7;5;2
14272.0;2022;70;NORMANDIE;MASCULIN;FORMATION CONTINUE;BAC PROFESSIONNEL;BAC PRO PROD;BAC PRO 25106 TECHNICIEN D'USINAGE;3;3;3;0;0;0;0;3;0;0;3;0;0;0
14273.0;2022;70;NORMANDIE;MASCULIN;FORMATION CONTINUE;BAC PROFESSIONNEL;BAC PRO PROD;BAC PRO 25214 MAINT.VEHIC.OPTA VOIT.PARTICUL.;11;10;8;1;1;1;0;9;0;1;2;3;3;1
14275.0;2022;70;NORMANDIE;MASCULIN;FORMATION CONTINUE;BAC PROFESSIONNEL;BAC PRO PROD;BAC PRO 25509 TECHNIC. FROID CONDITIONNEMT AIR;4;4;4;0;0;0;0;4;0;2;1;0;1;0
14277.0;2022;70;NORMANDIE;MASCULIN;FORMATION CONTINUE;BAC PROFESSIONNEL;BAC PRO PROD;BAC PRO 25513 SYST.NUM.OPT.A SURETE SECURITE;1;1;1;0;0;0;0;1;0;0;0;0;1;0
14280.0;2022;70;NORMANDIE;MASCULIN;FORMATION CONTINUE;BAC PROFESSIONNEL;BAC PRO SERV;BAC PRO 31213 MET.COM.VEN.OP.A ANI.GES.ESP.COM.;10;9;6;3;0;0;0;6;0;0;1;2;3;3
14301.0;2022;70;NORMANDIE;MASCULIN;INDIVIDUEL;BAC PROFESSIONNEL;BAC PRO SERV;BAC PRO 30001 GESTION-ADMINISTRATION;6;3;2;1;0;0;0;2;0;0;0;1;1;1
14302.0;2022;70;NORMANDIE;MASCULIN;INDIVIDUEL;BAC PROFESSIONNEL;BAC PRO SERV;BAC PRO 31106 LOGISTIQUE;3;1;1;0;0;0;0;1;0;0;0;0;1;0
14303.0;2022;70;NORMANDIE;MASCULIN;INDIVIDUEL;BAC PROFESSIONNEL;BAC PRO SERV;BAC PRO 31213 MET.COM.VEN.OP.A ANI.GES.ESP.COM.;3;3;2;1;0;0;0;2;0;0;0;0;2;1
14309.0;2022;70;NORMANDIE;MASCULIN;INDIVIDUEL;BAC TECHNOLOGIQUE;BAC STI2D;BAC STI2D INNOVATION TECHNO.  ET ECO CONCEPTION;3;1;0;1;0;0;0;0;0;0;0;0;0;1
14314.0;2022;70;NORMANDIE;MASCULIN;INDIVIDUEL;BAC TECHNOLOGIQUE;BAC STMG;BAC STMG MERCATIQUE (MARKETING);17;13;2;11;0;0;0;2;0;0;0;0;2;11
14315.0;2022;70;NORMANDIE;MASCULIN;INDIVIDUEL;BAC TECHNOLOGIQUE;BAC STMG;BAC STMG RESSOURCES HUMAINES ET COMMUNICATION;5;4;0;4;0;0;0;0;0;0;0;0;0;4
14323.0;2022;70;NORMANDIE;MASCULIN;SCOLAIRE;BAC PROFESSIONNEL;BAC PRO PROD;BAC PRO 22303 FONDERIE;8;8;5;1;2;1;1;6;0;0;1;2;3;2
14331.0;2022;70;NORMANDIE;MASCULIN;SCOLAIRE;BAC PROFESSIONNEL;BAC PRO PROD;BACPRO 23103 TECHNICIEN GEOMETRE-TOPOGRAPHE;24;24;20;3;1;1;0;21;0;1;7;7;6;3
14344.0;2022;70;NORMANDIE;MASCULIN;SCOLAIRE;BAC PROFESSIONNEL;BAC PRO PROD;BAC PRO 25006 MICROTECHNIQUES;44;44;37;3;4;2;2;39;0;2;9;13;15;5
14346.0;2022;70;NORMANDIE;MASCULIN;SCOLAIRE;BAC PROFESSIONNEL;BAC PRO PROD;BAC PRO 25009 MAINTENANCE NAUTIQUE;16;16;14;2;0;0;0;14;0;1;4;5;4;2
14348.0;2022;70;NORMANDIE;MASCULIN;SCOLAIRE;BAC PROFESSIONNEL;BAC PRO PROD;BAC PRO 25107 TECHNICIEN OUTILLEUR;18;18;12;6;0;0;0;12;0;0;0;8;4;6
14364.0;2022;70;NORMANDIE;MASCULIN;SCOLAIRE;BAC PROFESSIONNEL;BAC PRO PROD;BAC PRO AG 21001 AGRO-EQUIPEMENT;66;64;52;12;0;0;0;52;0;0;3;20;29;12
14369.0;2022;70;NORMANDIE;MASCULIN;SCOLAIRE;BAC PROFESSIONNEL;BAC PRO PROD;BAC PRO AG 21210 COND GEST ENTR CANIN ET FELIN;21;21;18;3;0;0;0;18;0;0;0;7;11;3
14373.0;2022;70;NORMANDIE;MASCULIN;SCOLAIRE;BAC PROFESSIONNEL;BAC PRO PROD;BAC PRO AG 21405 AMENAGEMENTS PAYSAGERS;83;79;69;10;0;0;0;69;0;1;5;29;34;10
14375.0;2022;70;NORMANDIE;MASCULIN;SCOLAIRE;BAC PROFESSIONNEL;BAC PRO PROD;BAC PRO AG 22105 LABORATOIRE CONTROLE QUALITE;9;9;8;1;0;0;0;8;0;0;2;1;5;1
14378.0;2022;70;NORMANDIE;MASCULIN;SCOLAIRE;BAC PROFESSIONNEL;BAC PRO SERV;BAC PRO 31106 LOGISTIQUE;151;151;123;20;8;5;3;128;0;7;36;44;41;23
14383.0;2022;70;NORMANDIE;MASCULIN;SCOLAIRE;BAC PROFESSIONNEL;BAC PRO SERV;BAC PRO 31214 MET.COM.VEN.OP.B PR.CL.VA.OF.COM.;128;128;97;23;8;5;3;102;0;2;23;29;48;26
14386.0;2022;70;NORMANDIE;MASCULIN;SCOLAIRE;BAC PROFESSIONNEL;BAC PRO SERV;BAC PRO 32303 ART.& MET.ART:COM.VIS.VIS.PLURI-M;20;20;15;5;0;0;0;15;0;0;1;6;8;5
14388.0;2022;70;NORMANDIE;MASCULIN;SCOLAIRE;BAC PROFESSIONNEL;BAC PRO SERV;BAC PRO 33002 SERVICES DE PROXIMITE  VIE LOCAL;28;28;24;2;2;1;1;25;0;1;7;6;11;3
14390.0;2022;70;NORMANDIE;MASCULIN;SCOLAIRE;BAC PROFESSIONNEL;BAC PRO SERV;BAC PRO 33004 ACC.SOINS-S.PERS. OPT.EN STRUCTUR;33;33;28;5;0;0;0;28;0;4;5;11;8;5
14392.0;2022;70;NORMANDIE;MASCULIN;SCOLAIRE;BAC PROFESSIONNEL;BAC PRO SERV;BAC PRO 33102 PROTHESE DENTAIRE;4;4;2;1;1;1;0;3;0;0;0;1;2;1
14396.0;2022;70;NORMANDIE;MASCULIN;SCOLAIRE;BAC PROFESSIONNEL;BAC PRO SERV;BAC PRO 34305 TECHN.D'INTERV.SUR INSTALL. NUCL.;11;11;3;6;2;2;0;5;0;0;0;1;4;6
14399.0;2022;70;NORMANDIE;MASCULIN;SCOLAIRE;BAC TECHNOLOGIQUE;BAC S2TMD;BAC S2TMD DANSE;3;3;3;0;0;0;0;3;0;0;1;0;2;0
14400.0;2022;70;NORMANDIE;MASCULIN;SCOLAIRE;BAC TECHNOLOGIQUE;BAC S2TMD;BAC S2TMD MUSIQUE;11;11;11;0;0;0;0;11;2;1;3;0;5;0
14417.0;2022;18;ORLEANS-TOURS;FEMININ;APPRENTISSAGE;BAC PROFESSIONNEL;BAC PRO PROD;BAC PRO 23303 MENUISERIE ALUMINIUM-VERRE;2;2;0;2;0;0;0;0;0;0;0;0;0;2
14423.0;2022;18;ORLEANS-TOURS;FEMININ;APPRENTISSAGE;BAC PROFESSIONNEL;BAC PRO PROD;BAC PRO 25215 MAINT.VEHIC.OPTB VEHIC.TRANS.ROUT;1;1;1;0;0;0;0;1;0;0;1;0;0;0
14433.0;2022;18;ORLEANS-TOURS;FEMININ;APPRENTISSAGE;BAC PROFESSIONNEL;BAC PRO PROD;BAC PRO AG 22105 LABORATOIRE CONTROLE QUALITE;1;1;1;0;0;0;0;1;0;0;0;1;0;0
14440.0;2022;18;ORLEANS-TOURS;FEMININ;APPRENTISSAGE;BAC PROFESSIONNEL;BAC PRO SERV;BAC PRO 32208 REAL.PR.IMPR.PLURI.OPTB.PR.IMPR.;1;1;1;0;0;0;0;1;0;1;0;0;0;0
14449.0;2022;18;ORLEANS-TOURS;FEMININ;ENSEIGNEMENT A DISTANCE;BAC TECHNOLOGIQUE;BAC STMG;BAC STMG MERCATIQUE (MARKETING);5;5;4;1;0;0;0;4;0;0;0;1;3;1
14450.0;2022;18;ORLEANS-TOURS;FEMININ;ENSEIGNEMENT A DISTANCE;BAC TECHNOLOGIQUE;BAC STMG;BAC STMG RESSOURCES HUMAINES ET COMMUNICATION;5;5;4;0;1;1;0;5;0;0;0;2;3;0
14459.0;2022;18;ORLEANS-TOURS;FEMININ;FORMATION CONTINUE;BAC PROFESSIONNEL;BAC PRO SERV;BAC PRO 31213 MET.COM.VEN.OP.A ANI.GES.ESP.COM.;2;2;2;0;0;0;0;2;0;0;0;0;2;0
14465.0;2022;18;ORLEANS-TOURS;FEMININ;INDIVIDUEL;BAC PROFESSIONNEL;BAC PRO SERV;BAC PRO 30001 GESTION-ADMINISTRATION;7;3;0;3;0;0;0;0;0;0;0;0;0;3
14468.0;2022;18;ORLEANS-TOURS;FEMININ;INDIVIDUEL;BAC PROFESSIONNEL;BAC PRO SERV;BAC PRO 33004 ACC.SOINS-S.PERS. OPT.EN STRUCTUR;10;5;3;0;2;1;1;4;0;0;0;1;3;1
14469.0;2022;18;ORLEANS-TOURS;FEMININ;INDIVIDUEL;BAC PROFESSIONNEL;BAC PRO SERV;BAC PRO 33403 COMMERC. SERVICES EN RESTAURATION;2;0;0;0;0;0;0;0;0;0;0;0;0;0
14470.0;2022;18;ORLEANS-TOURS;FEMININ;INDIVIDUEL;BAC PROFESSIONNEL;BAC PRO SERV;BAC PRO 33603 ESTHETIQUE COSMETIQUE PARFUMERIE;3;3;1;2;0;0;0;1;0;0;0;0;1;2
14472.0;2022;18;ORLEANS-TOURS;FEMININ;INDIVIDUEL;BAC PROFESSIONNEL;BAC PRO SERV;BAC PRO AG 33002 SERV PERS TERRIT;2;0;0;0;0;0;0;0;0;0;0;0;0;0
14474.0;2022;18;ORLEANS-TOURS;FEMININ;INDIVIDUEL;BAC TECHNOLOGIQUE;BAC STAV;BAC STAV AGRONOMIE ALIM ENV TERRITOI;1;0;0;0;0;0;0;0;0;0;0;0;0;0
14476.0;2022;18;ORLEANS-TOURS;FEMININ;INDIVIDUEL;BAC TECHNOLOGIQUE;BAC STI2D;BAC STI2D ENERGIES  ET ENVIRONNEMENT;1;1;0;0;1;1;0;1;0;0;0;0;1;0
14482.0;2022;18;ORLEANS-TOURS;FEMININ;INDIVIDUEL;BAC TECHNOLOGIQUE;BAC STMG;BAC STMG SYSTEMES D'INFORMATION DE GESTION;2;2;2;0;0;0;0;2;0;0;0;0;2;0
14483.0;2022;18;ORLEANS-TOURS;FEMININ;SCOLAIRE;BAC GENERAL;BAC GENERAL;BAC GENE 10019 BAC GENERAL;7488;7488;7016;70;402;256;146;7272;168;1013;1973;2267;1851;216
14490.0;2022;18;ORLEANS-TOURS;FEMININ;SCOLAIRE;BAC PROFESSIONNEL;BAC PRO PROD;BAC PRO 22403 ARTS.& MET.ART:MET.ENSEIGN SIGNA;4;4;4;0;0;0;0;4;0;0;1;2;1;0
14495.0;2022;18;ORLEANS-TOURS;FEMININ;SCOLAIRE;BAC PROFESSIONNEL;BAC PRO PROD;BAC PRO 23005 TECHN. ETUDES BAT B ASSIST.ARCHI.;24;24;19;4;1;1;0;20;0;0;3;9;8;4
14505.0;2022;18;ORLEANS-TOURS;FEMININ;SCOLAIRE;BAC PROFESSIONNEL;BAC PRO PROD;BAC PRO 25006 MICROTECHNIQUES;2;2;1;1;0;0;0;1;0;0;1;0;0;1
14510.0;2022;18;ORLEANS-TOURS;FEMININ;SCOLAIRE;BAC PROFESSIONNEL;BAC PRO PROD;BAC PRO 25216 MAINT.VEHIC.OPTC MOTOCYCLES;2;2;1;1;0;0;0;1;0;0;0;1;0;1
14518.0;2022;18;ORLEANS-TOURS;FEMININ;SCOLAIRE;BAC PROFESSIONNEL;BAC PRO PROD;BAC PRO AG 21004 CGEA;84;83;64;19;0;0;0;64;0;0;4;20;40;19
14529.0;2022;18;ORLEANS-TOURS;FEMININ;SCOLAIRE;BAC PROFESSIONNEL;BAC PRO PROD;BAC PRO AG 22106 TEC CONS VTE ALIMENTATION VINS SP;4;3;3;0;0;0;0;3;0;0;0;0;3;0
14530.0;2022;18;ORLEANS-TOURS;FEMININ;SCOLAIRE;BAC PROFESSIONNEL;BAC PRO PROD;BAC PRO AG 22107 TEC CONS VTE ALIMENTATION P.ALIM;14;10;5;5;0;0;0;5;0;0;0;0;5;5
14531.0;2022;18;ORLEANS-TOURS;FEMININ;SCOLAIRE;BAC PROFESSIONNEL;BAC PRO SERV;BAC PRO 30001 GESTION-ADMINISTRATION;418;418;325;70;23;18;5;343;0;9;55;124;155;75
14532.0;2022;18;ORLEANS-TOURS;FEMININ;SCOLAIRE;BAC PROFESSIONNEL;BAC PRO SERV;BAC PRO 31106 LOGISTIQUE;26;26;15;10;1;0;1;15;0;0;4;3;8;11
14546.0;2022;18;ORLEANS-TOURS;FEMININ;SCOLAIRE;BAC PROFESSIONNEL;BAC PRO SERV;BAC PRO 33403 COMMERC. SERVICES EN RESTAURATION;58;58;48;8;2;1;1;49;0;2;13;19;15;9
14552.0;2022;18;ORLEANS-TOURS;FEMININ;SCOLAIRE;BAC TECHNOLOGIQUE;BAC S2TMD;BAC S2TMD MUSIQUE;2;2;2;0;0;0;0;2;0;0;0;2;0;0
14553.0;2022;18;ORLEANS-TOURS;FEMININ;SCOLAIRE;BAC TECHNOLOGIQUE;BAC ST2S;BAC ST2S SCIENCES & TECHNO. SANTE & SOCIAL;584;584;510;16;58;36;22;546;6;23;85;202;230;38
14555.0;2022;18;ORLEANS-TOURS;FEMININ;SCOLAIRE;BAC TECHNOLOGIQUE;BAC STD2A;BAC STD2A SCIENCES & TECHNO. DESIGN-ARTS APPLIQUES;189;189;186;0;3;2;1;188;1;10;52;81;44;1
14557.0;2022;18;ORLEANS-TOURS;FEMININ;SCOLAIRE;BAC TECHNOLOGIQUE;BAC STI2D;BAC STI2D ARCHITECTURE ET CONSTRUCTION;31;31;28;1;2;2;0;30;0;2;3;13;12;1
14563.0;2022;18;ORLEANS-TOURS;FEMININ;SCOLAIRE;BAC TECHNOLOGIQUE;BAC STMG;BAC STMG GESTION ET FINANCE;256;256;228;9;19;11;8;239;0;6;47;91;95;17
14564.0;2022;18;ORLEANS-TOURS;FEMININ;SCOLAIRE;BAC TECHNOLOGIQUE;BAC STMG;BAC STMG MERCATIQUE (MARKETING);736;736;620;25;91;64;27;684;0;15;90;241;338;52
14565.0;2022;18;ORLEANS-TOURS;FEMININ;SCOLAIRE;BAC TECHNOLOGIQUE;BAC STMG;BAC STMG RESSOURCES HUMAINES ET COMMUNICATION;486;486;406;20;60;44;16;450;1;5;43;141;260;36
14584.0;2022;18;ORLEANS-TOURS;MASCULIN;APPRENTISSAGE;BAC PROFESSIONNEL;BAC PRO PROD;BAC PRO 25220 MAINT.MATERIELS OPT.B TP MANUT.;13;13;11;1;1;1;0;12;0;0;3;6;3;1
14593.0;2022;18;ORLEANS-TOURS;MASCULIN;APPRENTISSAGE;BAC PROFESSIONNEL;BAC PRO PROD;BAC PRO 25514 SYST.NUM.OPT.B AUD.RES.EQUIP.DOM.;2;2;1;1;0;0;0;1;0;0;0;1;0;1
14596.0;2022;18;ORLEANS-TOURS;MASCULIN;APPRENTISSAGE;BAC PROFESSIONNEL;BAC PRO PROD;BAC PRO AG 21004 CGEA;66;65;45;20;0;0;0;45;0;0;4;11;30;20
14597.0;2022;18;ORLEANS-TOURS;MASCULIN;APPRENTISSAGE;BAC PROFESSIONNEL;BAC PRO PROD;BAC PRO AG 21114 CONDUITE PRODUCTIONS HORTICOLES;3;3;3;0;0;0;0;3;0;0;0;1;2;0
14598.0;2022;18;ORLEANS-TOURS;MASCULIN;APPRENTISSAGE;BAC PROFESSIONNEL;BAC PRO PROD;BAC PRO AG 21203 TECHN CONSEIL DE VENTE ANIMAL;5;4;4;0;0;0;0;4;0;0;0;2;2;0
14608.0;2022;18;ORLEANS-TOURS;MASCULIN;APPRENTISSAGE;BAC PROFESSIONNEL;BAC PRO SERV;BAC PRO 31214 MET.COM.VEN.OP.B PR.CL.VA.OF.COM.;15;14;12;1;1;0;1;12;0;0;3;5;4;2
14618.0;2022;18;ORLEANS-TOURS;MASCULIN;ENSEIGNEMENT A DISTANCE;BAC TECHNOLOGIQUE;BAC STMG;BAC STMG MERCATIQUE (MARKETING);4;4;2;0;2;1;1;3;0;0;0;2;1;1
14633.0;2022;18;ORLEANS-TOURS;MASCULIN;INDIVIDUEL;BAC PROFESSIONNEL;BAC PRO PROD;BACPRO 20002 ETUD.DEFINITION PRDTS INDUSTRIEL;1;1;0;1;0;0;0;0;0;0;0;0;0;1
14642.0;2022;18;ORLEANS-TOURS;MASCULIN;INDIVIDUEL;BAC PROFESSIONNEL;BAC PRO PROD;BAC PRO AG 21114 CONDUITE PRODUCTIONS HORTICOLES;6;4;4;0;0;0;0;4;0;0;0;0;4;0
14643.0;2022;18;ORLEANS-TOURS;MASCULIN;INDIVIDUEL;BAC PROFESSIONNEL;BAC PRO PROD;BAC PRO AG 21405 AMENAGEMENTS PAYSAGERS;1;0;0;0;0;0;0;0;0;0;0;0;0;0
14647.0;2022;18;ORLEANS-TOURS;MASCULIN;INDIVIDUEL;BAC PROFESSIONNEL;BAC PRO SERV;BAC PRO 31212 METIERS DE L'ACCUEIL;1;1;0;1;0;0;0;0;0;0;0;0;0;1
14650.0;2022;18;ORLEANS-TOURS;MASCULIN;INDIVIDUEL;BAC PROFESSIONNEL;BAC PRO SERV;BAC PRO 33403 COMMERC. SERVICES EN RESTAURATION;1;0;0;0;0;0;0;0;0;0;0;0;0;0
14651.0;2022;18;ORLEANS-TOURS;MASCULIN;INDIVIDUEL;BAC PROFESSIONNEL;BAC PRO SERV;BAC PRO 34304 HYGIENE PROPRETE STERILISATION;2;2;1;1;0;0;0;1;0;0;0;0;1;1
14661.0;2022;18;ORLEANS-TOURS;MASCULIN;SCOLAIRE;BAC GENERAL;BAC GENERAL;BAC GENE 10019 BAC GENERAL;5828;5828;5302;80;446;279;167;5581;98;636;1303;1774;1770;247
14662.0;2022;18;ORLEANS-TOURS;MASCULIN;SCOLAIRE;BAC PROFESSIONNEL;BAC PRO PROD;BACPRO 20002 ETUD.DEFINITION PRDTS INDUSTRIEL;33;33;26;7;0;0;0;26;0;1;5;12;8;7
14665.0;2022;18;ORLEANS-TOURS;MASCULIN;SCOLAIRE;BAC PROFESSIONNEL;BAC PRO PROD;BAC PRO 22105 BOULANGER-PÂTISSIER;13;13;13;0;0;0;0;13;0;1;6;4;2;0
14669.0;2022;18;ORLEANS-TOURS;MASCULIN;SCOLAIRE;BAC PROFESSIONNEL;BAC PRO PROD;BAC PRO 22503 PLASTIQUES ET COMPOSITES;14;14;12;1;1;0;1;12;0;2;1;7;2;2
14677.0;2022;18;ORLEANS-TOURS;MASCULIN;SCOLAIRE;BAC PROFESSIONNEL;BAC PRO PROD;BAC PRO 23203 TECHNICIEN BAT. : ORG.REAL.GROS O;15;15;9;4;2;0;2;9;0;0;0;5;4;6
14679.0;2022;18;ORLEANS-TOURS;MASCULIN;SCOLAIRE;BAC PROFESSIONNEL;BAC PRO PROD;BAC PRO 23208 METIERS ET ARTS DE LA PIERRE;2;2;1;1;0;0;0;1;0;0;0;0;1;1
14685.0;2022;18;ORLEANS-TOURS;MASCULIN;SCOLAIRE;BAC PROFESSIONNEL;BAC PRO PROD;BAC PRO 24202 ARTIS.& MET.ART : TAPIS.D'AMEUBL;1;1;1;0;0;0;0;1;0;0;1;0;0;0
14697.0;2022;18;ORLEANS-TOURS;MASCULIN;SCOLAIRE;BAC PROFESSIONNEL;BAC PRO PROD;BAC PRO 25219 MAINT.MATERIELS OPT.A AGRICOLES;12;12;10;2;0;0;0;10;0;2;5;1;2;2
14703.0;2022;18;ORLEANS-TOURS;MASCULIN;SCOLAIRE;BAC PROFESSIONNEL;BAC PRO PROD;BAC PRO 25411 TECH.CHAUDRONNERIE INDUSTRIELLE;91;91;63;23;5;5;0;68;0;3;13;30;22;23
14707.0;2022;18;ORLEANS-TOURS;MASCULIN;SCOLAIRE;BAC PROFESSIONNEL;BAC PRO PROD;BAC PRO 25514 SYST.NUM.OPT.B AUD.RES.EQUIP.DOM.;66;66;59;6;1;1;0;60;0;2;15;27;16;6
14717.0;2022;18;ORLEANS-TOURS;MASCULIN;SCOLAIRE;BAC PROFESSIONNEL;BAC PRO PROD;BAC PRO AG 21303 FORET;16;16;15;1;0;0;0;15;0;0;1;9;5;1
14719.0;2022;18;ORLEANS-TOURS;MASCULIN;SCOLAIRE;BAC PROFESSIONNEL;BAC PRO PROD;BAC PRO AG 21407 TEC CONS VTE UNIVERS JARDINERIE;9;9;5;4;0;0;0;5;0;0;1;1;3;4
14722.0;2022;18;ORLEANS-TOURS;MASCULIN;SCOLAIRE;BAC PROFESSIONNEL;BAC PRO PROD;BAC PRO AG 22107 TEC CONS VTE ALIMENTATION P.ALIM;10;8;7;1;0;0;0;7;0;0;0;3;4;1
14730.0;2022;18;ORLEANS-TOURS;MASCULIN;SCOLAIRE;BAC PROFESSIONNEL;BAC PRO SERV;BAC PRO 32207 REAL.PR.IMPR.PLURI.OPTA.PR.GRAPH.;22;22;17;3;2;2;0;19;0;1;3;8;7;3
14732.0;2022;18;ORLEANS-TOURS;MASCULIN;SCOLAIRE;BAC PROFESSIONNEL;BAC PRO SERV;BAC PRO 32303 ART.& MET.ART:COM.VIS.VIS.PLURI-M;7;7;7;0;0;0;0;7;0;4;1;2;0;0
14735.0;2022;18;ORLEANS-TOURS;MASCULIN;SCOLAIRE;BAC PROFESSIONNEL;BAC PRO SERV;BAC PRO 33003 ACC.SOINS-S.PERS. OPT.A DOMICILE;10;10;8;2;0;0;0;8;0;1;0;4;3;2
14736.0;2022;18;ORLEANS-TOURS;MASCULIN;SCOLAIRE;BAC PROFESSIONNEL;BAC PRO SERV;BAC PRO 33004 ACC.SOINS-S.PERS. OPT.EN STRUCTUR;25;25;24;1;0;0;0;24;0;0;8;6;10;1
14740.0;2022;18;ORLEANS-TOURS;MASCULIN;SCOLAIRE;BAC PROFESSIONNEL;BAC PRO SERV;BAC PRO 34305 TECHN.D'INTERV.SUR INSTALL. NUCL.;15;15;11;4;0;0;0;11;0;0;0;3;8;4
14741.0;2022;18;ORLEANS-TOURS;MASCULIN;SCOLAIRE;BAC PROFESSIONNEL;BAC PRO SERV;BAC PRO 34403 METIERS DE LA SECURITE;44;44;42;1;1;0;1;42;0;2;15;19;6;2
14742.0;2022;18;ORLEANS-TOURS;MASCULIN;SCOLAIRE;BAC PROFESSIONNEL;BAC PRO SERV;BAC PRO AG 33002 SERV PERS TERRIT;35;34;30;4;0;0;0;30;0;1;4;10;15;4
14751.0;2022;18;ORLEANS-TOURS;MASCULIN;SCOLAIRE;BAC TECHNOLOGIQUE;BAC STI2D;BAC STI2D INNOVATION TECHNO.  ET ECO CONCEPTION;339;339;281;10;48;33;15;314;1;4;43;109;157;25
14756.0;2022;18;ORLEANS-TOURS;MASCULIN;SCOLAIRE;BAC TECHNOLOGIQUE;BAC STMG;BAC STMG MERCATIQUE (MARKETING);726;726;549;38;139;90;49;639;0;6;56;171;406;87
14757.0;2022;18;ORLEANS-TOURS;MASCULIN;SCOLAIRE;BAC TECHNOLOGIQUE;BAC STMG;BAC STMG RESSOURCES HUMAINES ET COMMUNICATION;184;184;139;8;37;31;6;170;0;1;8;39;122;14
14759.0;2022;01;PARIS;FEMININ;APPRENTISSAGE;BAC PROFESSIONNEL;BAC PRO PROD;BAC PRO 22004 PROC. CHIMIE EAU PAPIERS-CARTONS;2;2;2;0;0;0;0;2;0;1;0;1;0;0
14762.0;2022;01;PARIS;FEMININ;APPRENTISSAGE;BAC PROFESSIONNEL;BAC PRO PROD;BAC PRO 23004 TECHN. ETUDES BAT.A ETUDES & ECO.;2;1;1;0;0;0;0;1;0;0;1;0;0;0
14765.0;2022;01;PARIS;FEMININ;APPRENTISSAGE;BAC PROFESSIONNEL;BAC PRO PROD;BAC PRO 25510 METIERS ELECT. ENVIRON. CONNECTES;1;1;0;1;0;0;0;0;0;0;0;0;0;1
14772.0;2022;01;PARIS;FEMININ;APPRENTISSAGE;BAC PROFESSIONNEL;BAC PRO SERV;BAC PRO 32208 REAL.PR.IMPR.PLURI.OPTB.PR.IMPR.;7;7;7;0;0;0;0;7;0;2;2;2;1;0
14780.0;2022;01;PARIS;FEMININ;ENSEIGNEMENT A DISTANCE;BAC PROFESSIONNEL;BAC PRO SERV;BAC PRO 31213 MET.COM.VEN.OP.A ANI.GES.ESP.COM.;1;1;1;0;0;0;0;1;0;0;0;0;1;0
14783.0;2022;01;PARIS;FEMININ;ENSEIGNEMENT A DISTANCE;BAC PROFESSIONNEL;BAC PRO SERV;BAC PRO 33603 ESTHETIQUE COSMETIQUE PARFUMERIE;1;1;0;1;0;0;0;0;0;0;0;0;0;1
14788.0;2022;01;PARIS;FEMININ;FORMATION CONTINUE;BAC PROFESSIONNEL;BAC PRO PROD;BAC PRO 24203 METIERS DE LA MODE - VÊTEMENT;11;10;9;1;0;0;0;9;0;3;4;1;1;1
14790.0;2022;01;PARIS;FEMININ;FORMATION CONTINUE;BAC PROFESSIONNEL;BAC PRO PROD;BAC PRO 25515 SYST.NUM.OPT.C RES.INF.SYST.COMM.;2;1;1;0;0;0;0;1;0;0;0;0;1;0
14794.0;2022;01;PARIS;FEMININ;FORMATION CONTINUE;BAC PROFESSIONNEL;BAC PRO SERV;BAC PRO 33102 PROTHESE DENTAIRE;1;1;1;0;0;0;0;1;0;0;0;1;0;0
14795.0;2022;01;PARIS;FEMININ;INDIVIDUEL;BAC GENERAL;BAC GENERAL;BAC GENE 10019 BAC GENERAL;381;324;235;41;48;34;14;269;3;23;52;81;110;55
14801.0;2022;01;PARIS;FEMININ;INDIVIDUEL;BAC PROFESSIONNEL;BAC PRO PROD;BAC PRO AG 21302 GEST MILIEUX NATURELS FAUNE;1;0;0;0;0;0;0;0;0;0;0;0;0;0
14803.0;2022;01;PARIS;FEMININ;INDIVIDUEL;BAC PROFESSIONNEL;BAC PRO SERV;BAC PRO 30001 GESTION-ADMINISTRATION;6;3;2;1;0;0;0;2;0;0;0;0;2;1
14821.0;2022;01;PARIS;FEMININ;SCOLAIRE;BAC PROFESSIONNEL;BAC PRO PROD;BAC PRO 22003 BIO-INDUSTRIES DE TRANSFORMATION;4;4;3;1;0;0;0;3;0;0;1;2;0;1
14826.0;2022;01;PARIS;FEMININ;SCOLAIRE;BAC PROFESSIONNEL;BAC PRO PROD;BAC PRO 23003 ARTIS. & M.ART:MARCHANDISAGE VIS.;21;21;19;2;0;0;0;19;0;4;6;5;4;2
14840.0;2022;01;PARIS;FEMININ;SCOLAIRE;BAC PROFESSIONNEL;BAC PRO PROD;BAC PRO 25515 SYST.NUM.OPT.C RES.INF.SYST.COMM.;3;3;3;0;0;0;0;3;0;0;2;0;1;0
14848.0;2022;01;PARIS;FEMININ;SCOLAIRE;BAC PROFESSIONNEL;BAC PRO SERV;BAC PRO 32206 FACONNAGE PRODTS IMPRIMES ROUTAGE;3;3;2;1;0;0;0;2;0;2;0;0;0;1
14849.0;2022;01;PARIS;FEMININ;SCOLAIRE;BAC PROFESSIONNEL;BAC PRO SERV;BAC PRO 32207 REAL.PR.IMPR.PLURI.OPTA.PR.GRAPH.;10;10;7;3;0;0;0;7;0;0;1;2;4;3
14850.0;2022;01;PARIS;FEMININ;SCOLAIRE;BAC PROFESSIONNEL;BAC PRO SERV;BAC PRO 32208 REAL.PR.IMPR.PLURI.OPTB.PR.IMPR.;2;2;0;1;1;1;0;1;0;0;0;0;1;1
14853.0;2022;01;PARIS;FEMININ;SCOLAIRE;BAC PROFESSIONNEL;BAC PRO SERV;BAC PRO 33002 SERVICES DE PROXIMITE  VIE LOCAL;63;63;56;4;3;1;2;57;0;7;13;16;21;6
14855.0;2022;01;PARIS;FEMININ;SCOLAIRE;BAC PROFESSIONNEL;BAC PRO SERV;BAC PRO 33004 ACC.SOINS-S.PERS. OPT.EN STRUCTUR;236;236;216;16;4;2;2;218;0;16;64;94;44;18
14862.0;2022;01;PARIS;FEMININ;SCOLAIRE;BAC PROFESSIONNEL;BAC PRO SERV;BAC PRO 34304 HYGIENE PROPRETE STERILISATION;6;6;5;1;0;0;0;5;0;0;2;2;1;1
14863.0;2022;01;PARIS;FEMININ;SCOLAIRE;BAC PROFESSIONNEL;BAC PRO SERV;BAC PRO 34403 METIERS DE LA SECURITE;17;17;14;3;0;0;0;14;0;3;4;5;2;3
14871.0;2022;01;PARIS;FEMININ;SCOLAIRE;BAC TECHNOLOGIQUE;BAC STI2D;BAC STI2D INNOVATION TECHNO.  ET ECO CONCEPTION;14;14;12;0;2;1;1;13;0;0;2;4;7;1
14881.0;2022;01;PARIS;MASCULIN;APPRENTISSAGE;BAC PROFESSIONNEL;BAC PRO PROD;BAC PRO 22106 CUISINE;114;114;99;13;2;2;0;101;0;6;26;42;27;13
14882.0;2022;01;PARIS;MASCULIN;APPRENTISSAGE;BAC PROFESSIONNEL;BAC PRO PROD;BAC PRO 22703 TECHN.INSTALL.SYST.ENERG.CLIMATI;16;16;12;2;2;1;1;13;0;0;4;4;5;3
14888.0;2022;01;PARIS;MASCULIN;APPRENTISSAGE;BAC PROFESSIONNEL;BAC PRO PROD;BAC PRO 25411 TECH.CHAUDRONNERIE INDUSTRIELLE;17;17;15;1;1;0;1;15;0;0;7;6;2;2
14895.0;2022;01;PARIS;MASCULIN;APPRENTISSAGE;BAC PROFESSIONNEL;BAC PRO SERV;BAC PRO 31214 MET.COM.VEN.OP.B PR.CL.VA.OF.COM.;4;4;2;2;0;0;0;2;0;0;1;0;1;2
14903.0;2022;01;PARIS;MASCULIN;ENSEIGNEMENT A DISTANCE;BAC PROFESSIONNEL;BAC PRO SERV;BAC PRO 30001 GESTION-ADMINISTRATION;3;2;0;2;0;0;0;0;0;0;0;0;0;2
14904.0;2022;01;PARIS;MASCULIN;ENSEIGNEMENT A DISTANCE;BAC PROFESSIONNEL;BAC PRO SERV;BAC PRO 31213 MET.COM.VEN.OP.A ANI.GES.ESP.COM.;1;1;1;0;0;0;0;1;0;0;0;0;1;0
14909.0;2022;01;PARIS;MASCULIN;FORMATION CONTINUE;BAC PROFESSIONNEL;BAC PRO PROD;BAC PRO 24203 METIERS DE LA MODE - VÊTEMENT;1;1;1;0;0;0;0;1;0;0;1;0;0;0
14915.0;2022;01;PARIS;MASCULIN;FORMATION CONTINUE;BAC PROFESSIONNEL;BAC PRO PROD;BAC PRO AG 21405 AMENAGEMENTS PAYSAGERS;12;10;10;0;0;0;0;10;0;0;0;0;10;0
14918.0;2022;01;PARIS;MASCULIN;INDIVIDUEL;BAC PROFESSIONNEL;BAC PRO PROD;BAC PRO 22106 CUISINE;1;1;1;0;0;0;0;1;0;0;0;0;1;0
14919.0;2022;01;PARIS;MASCULIN;INDIVIDUEL;BAC PROFESSIONNEL;BAC PRO PROD;BAC PRO 23004 TECHN. ETUDES BAT.A ETUDES & ECO.;1;0;0;0;0;0;0;0;0;0;0;0;0;0
14931.0;2022;01;PARIS;MASCULIN;INDIVIDUEL;BAC PROFESSIONNEL;BAC PRO SERV;BAC PRO 31213 MET.COM.VEN.OP.A ANI.GES.ESP.COM.;4;1;1;0;0;0;0;1;0;0;0;0;1;0
14936.0;2022;01;PARIS;MASCULIN;INDIVIDUEL;BAC PROFESSIONNEL;BAC PRO SERV;BAC PRO 34403 METIERS DE LA SECURITE;2;2;1;1;0;0;0;1;0;0;0;0;1;1
14938.0;2022;01;PARIS;MASCULIN;INDIVIDUEL;BAC TECHNOLOGIQUE;BAC STD2A;BAC STD2A SCIENCES & TECHNO. DESIGN-ARTS APPLIQUES;10;10;3;4;3;0;3;3;0;0;0;1;2;7
14947.0;2022;01;PARIS;MASCULIN;SCOLAIRE;BAC PROFESSIONNEL;BAC PRO PROD;BACPRO 20002 ETUD.DEFINITION PRDTS INDUSTRIEL;11;11;9;2;0;0;0;9;0;0;1;2;6;2
14952.0;2022;01;PARIS;MASCULIN;SCOLAIRE;BAC PROFESSIONNEL;BAC PRO PROD;BAC PRO 22402 ARTIS.& MET.ART:VERR.SCIENT.TECH;7;7;7;0;0;0;0;7;0;1;2;3;1;0
14953.0;2022;01;PARIS;MASCULIN;SCOLAIRE;BAC PROFESSIONNEL;BAC PRO PROD;BAC PRO 22403 ARTS.& MET.ART:MET.ENSEIGN SIGNA;10;10;8;2;0;0;0;8;0;0;2;4;2;2
14957.0;2022;01;PARIS;MASCULIN;SCOLAIRE;BAC PROFESSIONNEL;BAC PRO PROD;BAC PRO 23004 TECHN. ETUDES BAT.A ETUDES & ECO.;13;13;11;2;0;0;0;11;0;0;0;4;7;2
14958.0;2022;01;PARIS;MASCULIN;SCOLAIRE;BAC PROFESSIONNEL;BAC PRO PROD;BAC PRO 23005 TECHN. ETUDES BAT B ASSIST.ARCHI.;13;13;13;0;0;0;0;13;0;0;4;6;3;0
14971.0;2022;01;PARIS;MASCULIN;SCOLAIRE;BAC PROFESSIONNEL;BAC PRO PROD;BAC PRO 25006 MICROTECHNIQUES;34;33;31;2;0;0;0;31;0;1;3;16;11;2
14972.0;2022;01;PARIS;MASCULIN;SCOLAIRE;BAC PROFESSIONNEL;BAC PRO PROD;BAC PRO 25007 MAINTENANCE EQUIPEMENTS INDUST.;35;35;25;7;3;1;2;26;0;1;7;11;7;9
14974.0;2022;01;PARIS;MASCULIN;SCOLAIRE;BAC PROFESSIONNEL;BAC PRO PROD;BAC PRO 25107 TECHNICIEN OUTILLEUR;7;7;7;0;0;0;0;7;0;0;1;2;4;0
14975.0;2022;01;PARIS;MASCULIN;SCOLAIRE;BAC PROFESSIONNEL;BAC PRO PROD;BAC PRO 25214 MAINT.VEHIC.OPTA VOIT.PARTICUL.;46;46;16;23;7;6;1;22;0;1;2;5;14;24
14979.0;2022;01;PARIS;MASCULIN;SCOLAIRE;BAC PROFESSIONNEL;BAC PRO PROD;BAC PRO 25509 TECHNIC. FROID CONDITIONNEMT AIR;13;13;8;5;0;0;0;8;0;1;1;2;4;5
14985.0;2022;01;PARIS;MASCULIN;SCOLAIRE;BAC PROFESSIONNEL;BAC PRO PROD;BAC PRO AG 22105 LABORATOIRE CONTROLE QUALITE;4;4;3;1;0;0;0;3;0;0;0;2;1;1
15000.0;2022;01;PARIS;MASCULIN;SCOLAIRE;BAC PROFESSIONNEL;BAC PRO SERV;BAC PRO 33101 OPTIQUE LUNETTERIE;8;8;6;2;0;0;0;6;0;0;2;1;3;2
15001.0;2022;01;PARIS;MASCULIN;SCOLAIRE;BAC PROFESSIONNEL;BAC PRO SERV;BAC PRO 33102 PROTHESE DENTAIRE;11;11;5;6;0;0;0;5;0;0;1;1;3;6
15003.0;2022;01;PARIS;MASCULIN;SCOLAIRE;BAC PROFESSIONNEL;BAC PRO SERV;BAC PRO 33403 COMMERC. SERVICES EN RESTAURATION;43;41;37;2;2;0;2;37;0;1;3;14;19;4
15005.0;2022;01;PARIS;MASCULIN;SCOLAIRE;BAC PROFESSIONNEL;BAC PRO SERV;BAC PRO 34304 HYGIENE PROPRETE STERILISATION;4;4;3;1;0;0;0;3;0;0;2;1;0;1
15008.0;2022;01;PARIS;MASCULIN;SCOLAIRE;BAC TECHNOLOGIQUE;BAC S2TMD;BAC S2TMD MUSIQUE;13;13;12;1;0;0;0;12;0;2;7;3;0;1
15010.0;2022;01;PARIS;MASCULIN;SCOLAIRE;BAC TECHNOLOGIQUE;BAC STD2A;BAC STD2A SCIENCES & TECHNO. DESIGN-ARTS APPLIQUES;59;59;57;0;2;0;2;57;0;0;14;25;18;2
15016.0;2022;01;PARIS;MASCULIN;SCOLAIRE;BAC TECHNOLOGIQUE;BAC STL;BAC STL BIOCHIM.-BIOLOGIE-BIOTECHNOL.;43;43;33;1;9;4;5;37;0;1;7;10;19;6
15017.0;2022;01;PARIS;MASCULIN;SCOLAIRE;BAC TECHNOLOGIQUE;BAC STL;BAC STL SCIENCES PHYSIQUES CHIMIQUES  EN LABORAT.;40;40;34;2;4;4;0;38;0;2;8;12;16;2
15019.0;2022;01;PARIS;MASCULIN;SCOLAIRE;BAC TECHNOLOGIQUE;BAC STMG;BAC STMG MERCATIQUE (MARKETING);336;336;272;16;48;30;18;302;0;1;22;116;163;34
15028.0;2022;13;POITIERS;FEMININ;APPRENTISSAGE;BAC PROFESSIONNEL;BAC PRO PROD;BAC PRO 25216 MAINT.VEHIC.OPTC MOTOCYCLES;1;1;1;0;0;0;0;1;0;0;0;0;1;0
15029.0;2022;13;POITIERS;FEMININ;APPRENTISSAGE;BAC PROFESSIONNEL;BAC PRO PROD;BAC PRO 25304 AERONAUTIQUE OPTION STRUCTURE;2;2;2;0;0;0;0;2;0;0;0;0;2;0
15030.0;2022;13;POITIERS;FEMININ;APPRENTISSAGE;BAC PROFESSIONNEL;BAC PRO PROD;BAC PRO 25408 REPARATION DES CARROSSERIES;1;1;1;0;0;0;0;1;0;0;0;0;1;0
15036.0;2022;13;POITIERS;FEMININ;APPRENTISSAGE;BAC PROFESSIONNEL;BAC PRO PROD;BAC PRO AG 21203 TECHN CONSEIL DE VENTE ANIMAL;1;1;1;0;0;0;0;1;0;0;0;0;1;0
15039.0;2022;13;POITIERS;FEMININ;APPRENTISSAGE;BAC PROFESSIONNEL;BAC PRO PROD;BAC PRO AG 22107 TEC CONS VTE ALIMENTATION P.ALIM;14;13;11;2;0;0;0;11;0;0;2;3;6;2
15044.0;2022;13;POITIERS;FEMININ;APPRENTISSAGE;BAC PROFESSIONNEL;BAC PRO SERV;BAC PRO 32208 REAL.PR.IMPR.PLURI.OPTB.PR.IMPR.;2;2;2;0;0;0;0;2;0;1;0;1;0;0
15045.0;2022;13;POITIERS;FEMININ;APPRENTISSAGE;BAC PROFESSIONNEL;BAC PRO SERV;BAC PRO 33004 ACC.SOINS-S.PERS. OPT.EN STRUCTUR;5;5;5;0;0;0;0;5;0;0;3;0;2;0
15046.0;2022;13;POITIERS;FEMININ;APPRENTISSAGE;BAC PROFESSIONNEL;BAC PRO SERV;BAC PRO 33101 OPTIQUE LUNETTERIE;2;2;2;0;0;0;0;2;0;0;0;1;1;0
15062.0;2022;13;POITIERS;FEMININ;FORMATION CONTINUE;BAC PROFESSIONNEL;BAC PRO PROD;BAC PRO AG 21114 CONDUITE PRODUCTIONS HORTICOLES;1;1;1;0;0;0;0;1;0;0;0;0;1;0
15063.0;2022;13;POITIERS;FEMININ;FORMATION CONTINUE;BAC PROFESSIONNEL;BAC PRO PROD;BAC PRO AG 21405 AMENAGEMENTS PAYSAGERS;1;1;1;0;0;0;0;1;0;0;0;0;1;0
15064.0;2022;13;POITIERS;FEMININ;FORMATION CONTINUE;BAC PROFESSIONNEL;BAC PRO SERV;BAC PRO 31212 METIERS DE L'ACCUEIL;1;1;1;0;0;0;0;1;0;0;1;0;0;0
15082.0;2022;13;POITIERS;FEMININ;INDIVIDUEL;BAC TECHNOLOGIQUE;BAC STMG;BAC STMG SYSTEMES D'INFORMATION DE GESTION;1;1;0;0;1;0;1;0;0;0;0;0;0;1
15092.0;2022;13;POITIERS;FEMININ;SCOLAIRE;BAC PROFESSIONNEL;BAC PRO PROD;BAC PRO 23004 TECHN. ETUDES BAT.A ETUDES & ECO.;8;8;6;2;0;0;0;6;0;0;0;4;2;2
15096.0;2022;13;POITIERS;FEMININ;SCOLAIRE;BAC PROFESSIONNEL;BAC PRO PROD;BAC PRO 23304 AMENAGEMENT FINITION BATIMENT;12;12;11;1;0;0;0;11;0;0;1;6;4;1
15100.0;2022;13;POITIERS;FEMININ;SCOLAIRE;BAC PROFESSIONNEL;BAC PRO PROD;BAC PRO 25006 MICROTECHNIQUES;1;1;1;0;0;0;0;1;0;0;0;1;0;0
15105.0;2022;13;POITIERS;FEMININ;SCOLAIRE;BAC PROFESSIONNEL;BAC PRO PROD;BAC PRO 25215 MAINT.VEHIC.OPTB VEHIC.TRANS.ROUT;1;1;1;0;0;0;0;1;0;0;0;0;1;0
15110.0;2022;13;POITIERS;FEMININ;SCOLAIRE;BAC PROFESSIONNEL;BAC PRO PROD;BAC PRO 25411 TECH.CHAUDRONNERIE INDUSTRIELLE;2;2;2;0;0;0;0;2;0;0;1;1;0;0
15121.0;2022;13;POITIERS;FEMININ;SCOLAIRE;BAC PROFESSIONNEL;BAC PRO PROD;BAC PRO AG 21303 FORET;1;1;1;0;0;0;0;1;0;0;0;0;1;0
15127.0;2022;13;POITIERS;FEMININ;SCOLAIRE;BAC PROFESSIONNEL;BAC PRO SERV;BAC PRO 30001 GESTION-ADMINISTRATION;184;184;161;15;8;7;1;168;0;5;38;61;64;16
15132.0;2022;13;POITIERS;FEMININ;SCOLAIRE;BAC PROFESSIONNEL;BAC PRO SERV;BAC PRO 31213 MET.COM.VEN.OP.A ANI.GES.ESP.COM.;214;213;191;13;9;6;3;197;0;9;41;76;71;16
15136.0;2022;13;POITIERS;FEMININ;SCOLAIRE;BAC PROFESSIONNEL;BAC PRO SERV;BAC PRO 32303 ART.& MET.ART:COM.VIS.VIS.PLURI-M;18;18;17;1;0;0;0;17;0;2;2;8;5;1
15137.0;2022;13;POITIERS;FEMININ;SCOLAIRE;BAC PROFESSIONNEL;BAC PRO SERV;BAC PRO 33002 SERVICES DE PROXIMITE  VIE LOCAL;50;50;46;2;2;1;1;47;0;5;13;16;13;3
15147.0;2022;13;POITIERS;FEMININ;SCOLAIRE;BAC TECHNOLOGIQUE;BAC STAV;BAC STAV AGRONOMIE ALIM ENV TERRITOI;75;75;68;7;0;0;0;68;0;1;10;21;36;7
15151.0;2022;13;POITIERS;FEMININ;SCOLAIRE;BAC TECHNOLOGIQUE;BAC STI2D;BAC STI2D ENERGIES  ET ENVIRONNEMENT;4;4;3;0;1;1;0;4;0;0;1;1;2;0
15160.0;2022;13;POITIERS;MASCULIN;APPRENTISSAGE;BAC PROFESSIONNEL;BAC PRO PROD;BAC PRO 20102 PILOTE DE LIGNE DE PRODUCTION;8;8;5;0;3;1;2;6;0;0;0;1;5;2
15164.0;2022;13;POITIERS;MASCULIN;APPRENTISSAGE;BAC PROFESSIONNEL;BAC PRO PROD;BAC PRO 22704 TECHN. MAINT. SYST.ENERG.CLIMATI;13;13;11;2;0;0;0;11;0;0;1;5;5;2
15168.0;2022;13;POITIERS;MASCULIN;APPRENTISSAGE;BAC PROFESSIONNEL;BAC PRO PROD;BAC PRO 23404 TECHNICIEN CONSTRUCTEUR BOIS;6;6;5;1;0;0;0;5;0;0;0;2;3;1
15169.0;2022;13;POITIERS;MASCULIN;APPRENTISSAGE;BAC PROFESSIONNEL;BAC PRO PROD;BAC PRO 23405 TECHNICIEN MENUISIER AGENCEUR;3;3;3;0;0;0;0;3;0;1;1;1;0;0
15177.0;2022;13;POITIERS;MASCULIN;APPRENTISSAGE;BAC PROFESSIONNEL;BAC PRO PROD;BAC PRO 25219 MAINT.MATERIELS OPT.A AGRICOLES;19;19;17;2;0;0;0;17;0;0;5;8;4;2
15178.0;2022;13;POITIERS;MASCULIN;APPRENTISSAGE;BAC PROFESSIONNEL;BAC PRO PROD;BAC PRO 25220 MAINT.MATERIELS OPT.B TP MANUT.;12;12;9;3;0;0;0;9;0;1;3;1;4;3
15183.0;2022;13;POITIERS;MASCULIN;APPRENTISSAGE;BAC PROFESSIONNEL;BAC PRO PROD;BAC PRO 25411 TECH.CHAUDRONNERIE INDUSTRIELLE;64;63;49;6;8;4;4;53;0;4;10;21;18;10
15185.0;2022;13;POITIERS;MASCULIN;APPRENTISSAGE;BAC PROFESSIONNEL;BAC PRO PROD;BAC PRO 25510 METIERS ELECT. ENVIRON. CONNECTES;46;46;41;2;3;3;0;44;0;1;13;13;17;2
15188.0;2022;13;POITIERS;MASCULIN;APPRENTISSAGE;BAC PROFESSIONNEL;BAC PRO PROD;BAC PRO AG 21001 AGRO-EQUIPEMENT;28;28;20;8;0;0;0;20;0;0;3;6;11;8
15193.0;2022;13;POITIERS;MASCULIN;APPRENTISSAGE;BAC PROFESSIONNEL;BAC PRO PROD;BAC PRO AG 21405 AMENAGEMENTS PAYSAGERS;57;55;50;5;0;0;0;50;0;1;6;15;28;5
15195.0;2022;13;POITIERS;MASCULIN;APPRENTISSAGE;BAC PROFESSIONNEL;BAC PRO SERV;BAC PRO 30001 GESTION-ADMINISTRATION;4;4;3;1;0;0;0;3;0;0;2;0;1;1
15198.0;2022;13;POITIERS;MASCULIN;APPRENTISSAGE;BAC PROFESSIONNEL;BAC PRO SERV;BAC PRO 31213 MET.COM.VEN.OP.A ANI.GES.ESP.COM.;96;93;65;20;8;4;4;69;0;1;3;27;38;24
15199.0;2022;13;POITIERS;MASCULIN;APPRENTISSAGE;BAC PROFESSIONNEL;BAC PRO SERV;BAC PRO 31214 MET.COM.VEN.OP.B PR.CL.VA.OF.COM.;4;4;3;1;0;0;0;3;0;0;0;0;3;1
15201.0;2022;13;POITIERS;MASCULIN;APPRENTISSAGE;BAC PROFESSIONNEL;BAC PRO SERV;BAC PRO 32208 REAL.PR.IMPR.PLURI.OPTB.PR.IMPR.;4;4;3;1;0;0;0;3;0;0;1;0;2;1
15202.0;2022;13;POITIERS;MASCULIN;APPRENTISSAGE;BAC PROFESSIONNEL;BAC PRO SERV;BAC PRO 33101 OPTIQUE LUNETTERIE;3;3;3;0;0;0;0;3;0;0;0;3;0;0
15209.0;2022;13;POITIERS;MASCULIN;ENSEIGNEMENT A DISTANCE;BAC PROFESSIONNEL;BAC PRO SERV;BAC PRO 33003 ACC.SOINS-S.PERS. OPT.A DOMICILE;1;1;0;1;0;0;0;0;0;0;0;0;0;1
15210.0;2022;13;POITIERS;MASCULIN;ENSEIGNEMENT A DISTANCE;BAC TECHNOLOGIQUE;BAC STMG;BAC STMG MERCATIQUE (MARKETING);3;2;2;0;0;0;0;2;0;0;0;0;2;0
15217.0;2022;13;POITIERS;MASCULIN;INDIVIDUEL;BAC PROFESSIONNEL;BAC PRO PROD;BAC PRO 23005 TECHN. ETUDES BAT B ASSIST.ARCHI.;1;1;0;1;0;0;0;0;0;0;0;0;0;1
15219.0;2022;13;POITIERS;MASCULIN;INDIVIDUEL;BAC PROFESSIONNEL;BAC PRO PROD;BAC PRO 25215 MAINT.VEHIC.OPTB VEHIC.TRANS.ROUT;2;1;0;1;0;0;0;0;0;0;0;0;0;1
15223.0;2022;13;POITIERS;MASCULIN;INDIVIDUEL;BAC PROFESSIONNEL;BAC PRO PROD;BAC PRO AG 21211 COND GEST ENTR HIPPIQUE;1;1;1;0;0;0;0;1;0;0;0;0;1;0
15226.0;2022;13;POITIERS;MASCULIN;INDIVIDUEL;BAC TECHNOLOGIQUE;BAC STMG;BAC STMG GESTION ET FINANCE;2;1;1;0;0;0;0;1;0;0;0;0;1;0
15227.0;2022;13;POITIERS;MASCULIN;INDIVIDUEL;BAC TECHNOLOGIQUE;BAC STMG;BAC STMG MERCATIQUE (MARKETING);2;1;0;1;0;0;0;0;0;0;0;0;0;1
15238.0;2022;13;POITIERS;MASCULIN;SCOLAIRE;BAC PROFESSIONNEL;BAC PRO PROD;BAC PRO 22703 TECHN.INSTALL.SYST.ENERG.CLIMATI;29;29;16;13;0;0;0;16;0;0;3;7;6;13
15240.0;2022;13;POITIERS;MASCULIN;SCOLAIRE;BAC PROFESSIONNEL;BAC PRO PROD;BAC PRO 23004 TECHN. ETUDES BAT.A ETUDES & ECO.;30;30;21;9;0;0;0;21;0;0;2;9;10;9
15242.0;2022;13;POITIERS;MASCULIN;SCOLAIRE;BAC PROFESSIONNEL;BAC PRO PROD;BAC PRO 23102 TRAVAUX PUBLICS;6;6;4;2;0;0;0;4;0;0;0;3;1;2
15244.0;2022;13;POITIERS;MASCULIN;SCOLAIRE;BAC PROFESSIONNEL;BAC PRO PROD;BAC PRO 23203 TECHNICIEN BAT. : ORG.REAL.GROS O;6;6;1;5;0;0;0;1;0;0;0;1;0;5
15246.0;2022;13;POITIERS;MASCULIN;SCOLAIRE;BAC PROFESSIONNEL;BAC PRO PROD;BAC PRO 23303 MENUISERIE ALUMINIUM-VERRE;18;18;13;5;0;0;0;13;0;1;1;2;9;5
15256.0;2022;13;POITIERS;MASCULIN;SCOLAIRE;BAC PROFESSIONNEL;BAC PRO PROD;BAC PRO 25106 TECHNICIEN D'USINAGE;67;67;50;16;1;0;1;50;0;7;8;20;15;17
15264.0;2022;13;POITIERS;MASCULIN;SCOLAIRE;BAC PROFESSIONNEL;BAC PRO PROD;BAC PRO 25302 AERONAUTIQUE OPTION AVIONIQUE;24;24;22;0;2;1;1;23;0;4;8;6;5;1
15273.0;2022;13;POITIERS;MASCULIN;SCOLAIRE;BAC PROFESSIONNEL;BAC PRO PROD;BAC PRO 25515 SYST.NUM.OPT.C RES.INF.SYST.COMM.;111;111;94;14;3;2;1;96;0;9;34;33;20;15
15275.0;2022;13;POITIERS;MASCULIN;SCOLAIRE;BAC PROFESSIONNEL;BAC PRO PROD;BAC PRO AG 21004 CGEA;122;122;109;13;0;0;0;109;0;3;13;39;54;13
15277.0;2022;13;POITIERS;MASCULIN;SCOLAIRE;BAC PROFESSIONNEL;BAC PRO PROD;BAC PRO AG 21114 CONDUITE PRODUCTIONS HORTICOLES;8;7;6;1;0;0;0;6;0;0;0;1;5;1
15283.0;2022;13;POITIERS;MASCULIN;SCOLAIRE;BAC PROFESSIONNEL;BAC PRO PROD;BAC PRO AG 21303 FORET;7;7;4;3;0;0;0;4;0;0;0;1;3;3
15287.0;2022;13;POITIERS;MASCULIN;SCOLAIRE;BAC PROFESSIONNEL;BAC PRO PROD;BAC PRO AG 22106 TEC CONS VTE ALIMENTATION VINS SP;1;1;1;0;0;0;0;1;0;0;0;0;1;0
15292.0;2022;13;POITIERS;MASCULIN;SCOLAIRE;BAC PROFESSIONNEL;BAC PRO SERV;BAC PRO 31108 TRANSPORT;18;18;12;6;0;0;0;12;0;1;2;3;6;6
15298.0;2022;13;POITIERS;MASCULIN;SCOLAIRE;BAC PROFESSIONNEL;BAC PRO SERV;BAC PRO 32303 ART.& MET.ART:COM.VIS.VIS.PLURI-M;19;19;17;2;0;0;0;17;0;0;3;8;6;2
15302.0;2022;13;POITIERS;MASCULIN;SCOLAIRE;BAC PROFESSIONNEL;BAC PRO SERV;BAC PRO 33101 OPTIQUE LUNETTERIE;2;2;1;1;0;0;0;1;0;0;0;1;0;1
15307.0;2022;13;POITIERS;MASCULIN;SCOLAIRE;BAC TECHNOLOGIQUE;BAC ST2S;BAC ST2S SCIENCES & TECHNO. SANTE & SOCIAL;70;70;57;3;10;7;3;64;0;0;5;18;41;6
15310.0;2022;13;POITIERS;MASCULIN;SCOLAIRE;BAC TECHNOLOGIQUE;BAC STHR;BAC STHR SC.&TEC. HOTELLERIE-RESTAURATION;33;33;30;1;2;2;0;32;0;2;7;12;11;1
15316.0;2022;13;POITIERS;MASCULIN;SCOLAIRE;BAC TECHNOLOGIQUE;BAC STL;BAC STL SCIENCES PHYSIQUES CHIMIQUES  EN LABORAT.;8;8;6;1;1;1;0;7;0;0;0;2;5;1
15318.0;2022;13;POITIERS;MASCULIN;SCOLAIRE;BAC TECHNOLOGIQUE;BAC STMG;BAC STMG MERCATIQUE (MARKETING);541;541;390;32;119;91;28;481;0;2;28;135;316;60
15323.0;2022;19;REIMS;FEMININ;APPRENTISSAGE;BAC PROFESSIONNEL;BAC PRO PROD;BAC PRO 25007 MAINTENANCE EQUIPEMENTS INDUST.;1;1;1;0;0;0;0;1;0;0;0;1;0;0
15329.0;2022;19;REIMS;FEMININ;APPRENTISSAGE;BAC PROFESSIONNEL;BAC PRO PROD;BAC PRO AG 21113 CGEVV;4;4;4;0;0;0;0;4;0;0;1;0;3;0
15333.0;2022;19;REIMS;FEMININ;APPRENTISSAGE;BAC PROFESSIONNEL;BAC PRO SERV;BAC PRO 31106 LOGISTIQUE;1;1;1;0;0;0;0;1;0;0;1;0;0;0
15343.0;2022;19;REIMS;FEMININ;ENSEIGNEMENT A DISTANCE;BAC PROFESSIONNEL;BAC PRO SERV;BAC PRO 31213 MET.COM.VEN.OP.A ANI.GES.ESP.COM.;1;1;0;0;1;0;1;0;0;0;0;0;0;1
15344.0;2022;19;REIMS;FEMININ;ENSEIGNEMENT A DISTANCE;BAC PROFESSIONNEL;BAC PRO SERV;BAC PRO 33003 ACC.SOINS-S.PERS. OPT.A DOMICILE;1;1;0;1;0;0;0;0;0;0;0;0;0;1
15347.0;2022;19;REIMS;FEMININ;ENSEIGNEMENT A DISTANCE;BAC TECHNOLOGIQUE;BAC STMG;BAC STMG RESSOURCES HUMAINES ET COMMUNICATION;2;2;0;0;2;2;0;2;0;0;0;0;2;0
15349.0;2022;19;REIMS;FEMININ;FORMATION CONTINUE;BAC PROFESSIONNEL;BAC PRO PROD;BAC PRO 22703 TECHN.INSTALL.SYST.ENERG.CLIMATI;1;1;1;0;0;0;0;1;0;0;1;0;0;0
15350.0;2022;19;REIMS;FEMININ;FORMATION CONTINUE;BAC PROFESSIONNEL;BAC PRO SERV;BAC PRO 30001 GESTION-ADMINISTRATION;14;13;13;0;0;0;0;13;0;4;5;4;0;0
15355.0;2022;19;REIMS;FEMININ;INDIVIDUEL;BAC GENERAL;BAC GENERAL;BAC GENE 10019 BAC GENERAL;27;15;6;4;5;3;2;9;0;0;0;1;8;6
15366.0;2022;19;REIMS;FEMININ;INDIVIDUEL;BAC TECHNOLOGIQUE;BAC STL;BAC STL BIOCHIM.-BIOLOGIE-BIOTECHNOL.;1;1;0;0;1;1;0;1;0;0;0;0;1;0
15369.0;2022;19;REIMS;FEMININ;SCOLAIRE;BAC GENERAL;BAC GENERAL;BAC GENE 10019 BAC GENERAL;3754;3754;3434;69;251;174;77;3608;59;435;880;1149;1085;146
15371.0;2022;19;REIMS;FEMININ;SCOLAIRE;BAC PROFESSIONNEL;BAC PRO PROD;BAC PRO 20102 PILOTE DE LIGNE DE PRODUCTION;2;2;1;1;0;0;0;1;0;0;0;1;0;1
15375.0;2022;19;REIMS;FEMININ;SCOLAIRE;BAC PROFESSIONNEL;BAC PRO PROD;BAC PRO 22503 PLASTIQUES ET COMPOSITES;2;2;2;0;0;0;0;2;0;0;0;0;2;0
15379.0;2022;19;REIMS;FEMININ;SCOLAIRE;BAC PROFESSIONNEL;BAC PRO PROD;BAC PRO 23405 TECHNICIEN MENUISIER AGENCEUR;2;2;1;1;0;0;0;1;0;0;0;0;1;1
15386.0;2022;19;REIMS;FEMININ;SCOLAIRE;BAC PROFESSIONNEL;BAC PRO PROD;BAC PRO 25411 TECH.CHAUDRONNERIE INDUSTRIELLE;1;1;1;0;0;0;0;1;0;0;0;0;1;0
15388.0;2022;19;REIMS;FEMININ;SCOLAIRE;BAC PROFESSIONNEL;BAC PRO PROD;BAC PRO 25510 METIERS ELECT. ENVIRON. CONNECTES;3;3;1;1;1;0;1;1;0;0;0;0;1;2
15394.0;2022;19;REIMS;FEMININ;SCOLAIRE;BAC PROFESSIONNEL;BAC PRO PROD;BAC PRO AG 21114 CONDUITE PRODUCTIONS HORTICOLES;5;5;4;1;0;0;0;4;0;0;2;2;0;1
15400.0;2022;19;REIMS;FEMININ;SCOLAIRE;BAC PROFESSIONNEL;BAC PRO PROD;BAC PRO AG 21405 AMENAGEMENTS PAYSAGERS;2;2;1;1;0;0;0;1;0;0;0;1;0;1
15409.0;2022;19;REIMS;FEMININ;SCOLAIRE;BAC PROFESSIONNEL;BAC PRO SERV;BAC PRO 31213 MET.COM.VEN.OP.A ANI.GES.ESP.COM.;242;242;180;36;26;15;11;195;0;5;43;66;81;47
15411.0;2022;19;REIMS;FEMININ;SCOLAIRE;BAC PROFESSIONNEL;BAC PRO SERV;BAC PRO 32207 REAL.PR.IMPR.PLURI.OPTA.PR.GRAPH.;9;9;9;0;0;0;0;9;0;1;3;3;2;0
15424.0;2022;19;REIMS;FEMININ;SCOLAIRE;BAC PROFESSIONNEL;BAC PRO SERV;BAC PRO AG 33002 SERV PERS TERRIT;95;94;86;8;0;0;0;86;0;0;13;32;41;8
15442.0;2022;19;REIMS;MASCULIN;APPRENTISSAGE;BAC PROFESSIONNEL;BAC PRO PROD;BAC PRO 22104 BOUCHER CHARCUTIER TRAITEUR;4;4;4;0;0;0;0;4;0;0;0;1;3;0
15443.0;2022;19;REIMS;MASCULIN;APPRENTISSAGE;BAC PROFESSIONNEL;BAC PRO PROD;BAC PRO 22106 CUISINE;1;1;1;0;0;0;0;1;0;1;0;0;0;0
15445.0;2022;19;REIMS;MASCULIN;APPRENTISSAGE;BAC PROFESSIONNEL;BAC PRO PROD;BAC PRO 22703 TECHN.INSTALL.SYST.ENERG.CLIMATI;5;5;2;2;1;1;0;3;0;0;1;1;1;2
15446.0;2022;19;REIMS;MASCULIN;APPRENTISSAGE;BAC PROFESSIONNEL;BAC PRO PROD;BAC PRO 22704 TECHN. MAINT. SYST.ENERG.CLIMATI;20;20;19;0;1;0;1;19;0;1;6;8;4;1
15458.0;2022;19;REIMS;MASCULIN;APPRENTISSAGE;BAC PROFESSIONNEL;BAC PRO PROD;BAC PRO 25216 MAINT.VEHIC.OPTC MOTOCYCLES;6;6;6;0;0;0;0;6;0;1;2;1;2;0
15459.0;2022;19;REIMS;MASCULIN;APPRENTISSAGE;BAC PROFESSIONNEL;BAC PRO PROD;BAC PRO 25219 MAINT.MATERIELS OPT.A AGRICOLES;22;21;10;8;3;2;1;12;0;1;1;6;4;9
15460.0;2022;19;REIMS;MASCULIN;APPRENTISSAGE;BAC PROFESSIONNEL;BAC PRO PROD;BAC PRO 25220 MAINT.MATERIELS OPT.B TP MANUT.;8;7;3;4;0;0;0;3;0;0;0;1;2;4
15466.0;2022;19;REIMS;MASCULIN;APPRENTISSAGE;BAC PROFESSIONNEL;BAC PRO PROD;BAC PRO 25514 SYST.NUM.OPT.B AUD.RES.EQUIP.DOM.;1;1;1;0;0;0;0;1;0;1;0;0;0;0
15468.0;2022;19;REIMS;MASCULIN;APPRENTISSAGE;BAC PROFESSIONNEL;BAC PRO PROD;BAC PRO AG 21001 AGRO-EQUIPEMENT;6;6;6;0;0;0;0;6;0;0;0;2;4;0
15472.0;2022;19;REIMS;MASCULIN;APPRENTISSAGE;BAC PROFESSIONNEL;BAC PRO PROD;BAC PRO AG 21405 AMENAGEMENTS PAYSAGERS;17;16;14;2;0;0;0;14;0;0;0;6;8;2
15474.0;2022;19;REIMS;MASCULIN;APPRENTISSAGE;BAC PROFESSIONNEL;BAC PRO SERV;BAC PRO 31106 LOGISTIQUE;10;9;8;1;0;0;0;8;0;1;1;4;2;1
15482.0;2022;19;REIMS;MASCULIN;ENSEIGNEMENT A DISTANCE;BAC PROFESSIONNEL;BAC PRO SERV;BAC PRO 30001 GESTION-ADMINISTRATION;2;1;0;1;0;0;0;0;0;0;0;0;0;1
15486.0;2022;19;REIMS;MASCULIN;FORMATION CONTINUE;BAC PROFESSIONNEL;BAC PRO PROD;BAC PRO 22703 TECHN.INSTALL.SYST.ENERG.CLIMATI;3;3;3;0;0;0;0;3;0;0;2;0;1;0
15489.0;2022;19;REIMS;MASCULIN;FORMATION CONTINUE;BAC PROFESSIONNEL;BAC PRO PROD;BAC PRO 25214 MAINT.VEHIC.OPTA VOIT.PARTICUL.;1;1;1;0;0;0;0;1;0;0;0;1;0;0
15493.0;2022;19;REIMS;MASCULIN;INDIVIDUEL;BAC PROFESSIONNEL;BAC PRO PROD;BAC PRO 22503 PLASTIQUES ET COMPOSITES;1;1;1;0;0;0;0;1;0;0;0;0;1;0
15495.0;2022;19;REIMS;MASCULIN;INDIVIDUEL;BAC PROFESSIONNEL;BAC PRO PROD;BAC PRO AG 21004 CGEA;2;2;2;0;0;0;0;2;0;0;0;0;2;0
15498.0;2022;19;REIMS;MASCULIN;INDIVIDUEL;BAC PROFESSIONNEL;BAC PRO SERV;BAC PRO 31106 LOGISTIQUE;1;1;0;1;0;0;0;0;0;0;0;0;0;1
15502.0;2022;19;REIMS;MASCULIN;INDIVIDUEL;BAC TECHNOLOGIQUE;BAC STI2D;BAC STI2D SYSTÈME D'INFORMATION  ET NUMERIQUE;1;1;0;0;1;1;0;1;0;0;0;0;1;0
15503.0;2022;19;REIMS;MASCULIN;INDIVIDUEL;BAC TECHNOLOGIQUE;BAC STMG;BAC STMG GESTION ET FINANCE;3;2;0;1;1;1;0;1;0;0;0;0;1;1
15504.0;2022;19;REIMS;MASCULIN;INDIVIDUEL;BAC TECHNOLOGIQUE;BAC STMG;BAC STMG MERCATIQUE (MARKETING);11;10;5;3;2;2;0;7;0;0;0;2;5;3
15505.0;2022;19;REIMS;MASCULIN;INDIVIDUEL;BAC TECHNOLOGIQUE;BAC STMG;BAC STMG RESSOURCES HUMAINES ET COMMUNICATION;8;5;4;0;1;0;1;4;0;0;0;2;2;1
15510.0;2022;19;REIMS;MASCULIN;SCOLAIRE;BAC PROFESSIONNEL;BAC PRO PROD;BAC PRO 22105 BOULANGER-PÂTISSIER;9;9;8;1;0;0;0;8;0;0;1;4;3;1
15512.0;2022;19;REIMS;MASCULIN;SCOLAIRE;BAC PROFESSIONNEL;BAC PRO PROD;BAC PRO 22302 Traitement des matériaux;12;12;5;7;0;0;0;5;0;1;1;1;2;7
15525.0;2022;19;REIMS;MASCULIN;SCOLAIRE;BAC PROFESSIONNEL;BAC PRO PROD;BAC PRO 23405 TECHNICIEN MENUISIER AGENCEUR;39;39;22;17;0;0;0;22;0;1;3;9;9;17
15531.0;2022;19;REIMS;MASCULIN;SCOLAIRE;BAC PROFESSIONNEL;BAC PRO PROD;BAC PRO 25214 MAINT.VEHIC.OPTA VOIT.PARTICUL.;113;113;79;23;11;7;4;86;0;3;20;31;32;27
15532.0;2022;19;REIMS;MASCULIN;SCOLAIRE;BAC PROFESSIONNEL;BAC PRO PROD;BAC PRO 25215 MAINT.VEHIC.OPTB VEHIC.TRANS.ROUT;14;14;7;6;1;0;1;7;0;0;1;4;2;7
15540.0;2022;19;REIMS;MASCULIN;SCOLAIRE;BAC PROFESSIONNEL;BAC PRO PROD;BAC PRO 25510 METIERS ELECT. ENVIRON. CONNECTES;208;208;152;50;6;6;0;158;0;5;17;49;87;50
15554.0;2022;19;REIMS;MASCULIN;SCOLAIRE;BAC PROFESSIONNEL;BAC PRO PROD;BAC PRO AG 22105 LABORATOIRE CONTROLE QUALITE;4;4;4;0;0;0;0;4;0;0;2;2;0;0
15557.0;2022;19;REIMS;MASCULIN;SCOLAIRE;BAC PROFESSIONNEL;BAC PRO SERV;BAC PRO 30001 GESTION-ADMINISTRATION;120;119;85;28;6;3;3;88;0;2;7;32;47;31
15571.0;2022;19;REIMS;MASCULIN;SCOLAIRE;BAC PROFESSIONNEL;BAC PRO SERV;BAC PRO 33403 COMMERC. SERVICES EN RESTAURATION;47;47;37;7;3;2;1;39;0;2;5;15;17;8
15575.0;2022;19;REIMS;MASCULIN;SCOLAIRE;BAC PROFESSIONNEL;BAC PRO SERV;BAC PRO AG 33002 SERV PERS TERRIT;12;11;10;1;0;0;0;10;0;0;0;6;4;1
15583.0;2022;19;REIMS;MASCULIN;SCOLAIRE;BAC TECHNOLOGIQUE;BAC STI2D;BAC STI2D INNOVATION TECHNO.  ET ECO CONCEPTION;94;94;75;4;15;6;9;81;0;2;12;28;39;13
15587.0;2022;19;REIMS;MASCULIN;SCOLAIRE;BAC TECHNOLOGIQUE;BAC STMG;BAC STMG GESTION ET FINANCE;158;158;125;5;28;20;8;145;0;1;10;59;75;13
15589.0;2022;19;REIMS;MASCULIN;SCOLAIRE;BAC TECHNOLOGIQUE;BAC STMG;BAC STMG RESSOURCES HUMAINES ET COMMUNICATION;156;156;79;28;49;29;20;108;0;0;6;25;77;48
15595.0;2022;14;RENNES;FEMININ;APPRENTISSAGE;BAC PROFESSIONNEL;BAC PRO PROD;BAC PRO 25214 MAINT.VEHIC.OPTA VOIT.PARTICUL.;13;13;11;2;0;0;0;11;0;5;4;2;0;2
15597.0;2022;14;RENNES;FEMININ;APPRENTISSAGE;BAC PROFESSIONNEL;BAC PRO PROD;BAC PRO 25411 TECH.CHAUDRONNERIE INDUSTRIELLE;3;3;3;0;0;0;0;3;0;2;0;1;0;0
15605.0;2022;14;RENNES;FEMININ;APPRENTISSAGE;BAC PROFESSIONNEL;BAC PRO PROD;BAC PRO AG 21405 AMENAGEMENTS PAYSAGERS;6;5;4;1;0;0;0;4;0;0;0;1;3;1
15607.0;2022;14;RENNES;FEMININ;APPRENTISSAGE;BAC PROFESSIONNEL;BAC PRO SERV;BAC PRO 30001 GESTION-ADMINISTRATION;4;4;4;0;0;0;0;4;0;0;1;3;0;0
15618.0;2022;14;RENNES;FEMININ;ENSEIGNEMENT A DISTANCE;BAC PROFESSIONNEL;BAC PRO SERV;BAC PRO 31214 MET.COM.VEN.OP.B PR.CL.VA.OF.COM.;2;0;0;0;0;0;0;0;0;0;0;0;0;0
15621.0;2022;14;RENNES;FEMININ;ENSEIGNEMENT A DISTANCE;BAC TECHNOLOGIQUE;BAC STMG;BAC STMG GESTION ET FINANCE;2;2;1;1;0;0;0;1;0;0;0;0;1;1
15634.0;2022;14;RENNES;FEMININ;INDIVIDUEL;BAC PROFESSIONNEL;BAC PRO PROD;BAC PRO AG 22105 LABORATOIRE CONTROLE QUALITE;1;0;0;0;0;0;0;0;0;0;0;0;0;0
15640.0;2022;14;RENNES;FEMININ;INDIVIDUEL;BAC PROFESSIONNEL;BAC PRO SERV;BAC PRO 33003 ACC.SOINS-S.PERS. OPT.A DOMICILE;1;1;1;0;0;0;0;1;0;0;0;0;1;0
15641.0;2022;14;RENNES;FEMININ;INDIVIDUEL;BAC PROFESSIONNEL;BAC PRO SERV;BAC PRO 33004 ACC.SOINS-S.PERS. OPT.EN STRUCTUR;4;4;2;2;0;0;0;2;0;0;0;1;1;2
15661.0;2022;14;RENNES;FEMININ;SCOLAIRE;BAC PROFESSIONNEL;BAC PRO PROD;BAC PRO 23405 TECHNICIEN MENUISIER AGENCEUR;16;16;13;3;0;0;0;13;0;0;5;6;2;3
15662.0;2022;14;RENNES;FEMININ;SCOLAIRE;BAC PROFESSIONNEL;BAC PRO PROD;BAC PRO 23408 Etude et réalisation d'agencement;17;17;17;0;0;0;0;17;0;1;7;8;1;0
15668.0;2022;14;RENNES;FEMININ;SCOLAIRE;BAC PROFESSIONNEL;BAC PRO PROD;BAC PRO 25009 MAINTENANCE NAUTIQUE;4;4;4;0;0;0;0;4;0;0;2;1;1;0
15677.0;2022;14;RENNES;FEMININ;SCOLAIRE;BAC PROFESSIONNEL;BAC PRO PROD;BAC PRO 25408 REPARATION DES CARROSSERIES;2;2;2;0;0;0;0;2;0;0;0;0;2;0
15685.0;2022;14;RENNES;FEMININ;SCOLAIRE;BAC PROFESSIONNEL;BAC PRO PROD;BAC PRO AG 21004 CGEA;133;129;101;28;0;0;0;101;0;1;9;34;57;28
15686.0;2022;14;RENNES;FEMININ;SCOLAIRE;BAC PROFESSIONNEL;BAC PRO PROD;BAC PRO AG 21114 CONDUITE PRODUCTIONS HORTICOLES;12;12;11;1;0;0;0;11;0;0;2;4;5;1
15690.0;2022;14;RENNES;FEMININ;SCOLAIRE;BAC PROFESSIONNEL;BAC PRO PROD;BAC PRO AG 21211 COND GEST ENTR HIPPIQUE;45;43;32;11;0;0;0;32;0;0;3;11;18;11
15702.0;2022;14;RENNES;FEMININ;SCOLAIRE;BAC PROFESSIONNEL;BAC PRO SERV;BAC PRO 31214 MET.COM.VEN.OP.B PR.CL.VA.OF.COM.;203;203;178;19;6;5;1;183;0;4;45;75;59;20
15707.0;2022;14;RENNES;FEMININ;SCOLAIRE;BAC PROFESSIONNEL;BAC PRO SERV;BAC PRO 33003 ACC.SOINS-S.PERS. OPT.A DOMICILE;130;129;107;19;3;3;0;110;0;11;15;49;35;19
15708.0;2022;14;RENNES;FEMININ;SCOLAIRE;BAC PROFESSIONNEL;BAC PRO SERV;BAC PRO 33004 ACC.SOINS-S.PERS. OPT.EN STRUCTUR;547;546;510;29;7;6;1;516;0;22;163;219;112;30
15710.0;2022;14;RENNES;FEMININ;SCOLAIRE;BAC PROFESSIONNEL;BAC PRO SERV;BAC PRO 33403 COMMERC. SERVICES EN RESTAURATION;84;84;68;11;5;3;2;71;0;11;16;18;26;13
15713.0;2022;14;RENNES;FEMININ;SCOLAIRE;BAC PROFESSIONNEL;BAC PRO SERV;BAC PRO 34304 HYGIENE PROPRETE STERILISATION;7;7;4;1;2;0;2;4;0;0;0;3;1;3
15721.0;2022;14;RENNES;FEMININ;SCOLAIRE;BAC TECHNOLOGIQUE;BAC STHR;BAC STHR SC.&TEC. HOTELLERIE-RESTAURATION;53;53;53;0;0;0;0;53;0;2;17;21;13;0
15728.0;2022;14;RENNES;FEMININ;SCOLAIRE;BAC TECHNOLOGIQUE;BAC STMG;BAC STMG GESTION ET FINANCE;370;370;346;6;18;7;11;353;0;10;72;148;123;17
15732.0;2022;14;RENNES;MASCULIN;APPRENTISSAGE;BAC PROFESSIONNEL;BAC PRO PROD;BAC PRO 22104 BOUCHER CHARCUTIER TRAITEUR;12;12;11;1;0;0;0;11;0;1;1;3;6;1
15735.0;2022;14;RENNES;MASCULIN;APPRENTISSAGE;BAC PROFESSIONNEL;BAC PRO PROD;BAC PRO 22703 TECHN.INSTALL.SYST.ENERG.CLIMATI;25;25;19;5;1;1;0;20;0;2;4;8;6;5
15737.0;2022;14;RENNES;MASCULIN;APPRENTISSAGE;BAC PROFESSIONNEL;BAC PRO PROD;BAC PRO 23102 TRAVAUX PUBLICS;32;32;28;4;0;0;0;28;0;0;7;12;9;4
15738.0;2022;14;RENNES;MASCULIN;APPRENTISSAGE;BAC PROFESSIONNEL;BAC PRO PROD;BACPRO 23103 TECHNICIEN GEOMETRE-TOPOGRAPHE;1;1;0;1;0;0;0;0;0;0;0;0;0;1
15744.0;2022;14;RENNES;MASCULIN;APPRENTISSAGE;BAC PROFESSIONNEL;BAC PRO PROD;BAC PRO 25009 MAINTENANCE NAUTIQUE;12;12;8;2;2;1;1;9;0;0;2;2;5;3
15750.0;2022;14;RENNES;MASCULIN;APPRENTISSAGE;BAC PROFESSIONNEL;BAC PRO PROD;BAC PRO 25219 MAINT.MATERIELS OPT.A AGRICOLES;35;34;27;2;5;2;3;29;0;3;7;7;12;5
15763.0;2022;14;RENNES;MASCULIN;APPRENTISSAGE;BAC PROFESSIONNEL;BAC PRO PROD;BAC PRO AG 21210 COND GEST ENTR CANIN ET FELIN;3;3;3;0;0;0;0;3;0;0;0;1;2;0
15765.0;2022;14;RENNES;MASCULIN;APPRENTISSAGE;BAC PROFESSIONNEL;BAC PRO PROD;BAC PRO AG 21303 FORET;7;7;7;0;0;0;0;7;0;0;0;2;5;0
15768.0;2022;14;RENNES;MASCULIN;APPRENTISSAGE;BAC PROFESSIONNEL;BAC PRO SERV;BAC PRO 30001 GESTION-ADMINISTRATION;1;1;1;0;0;0;0;1;0;1;0;0;0;0
15772.0;2022;14;RENNES;MASCULIN;APPRENTISSAGE;BAC PROFESSIONNEL;BAC PRO SERV;BAC PRO 31214 MET.COM.VEN.OP.B PR.CL.VA.OF.COM.;2;1;1;0;0;0;0;1;0;0;0;1;0;0
15774.0;2022;14;RENNES;MASCULIN;APPRENTISSAGE;BAC PROFESSIONNEL;BAC PRO SERV;BAC PRO 34304 HYGIENE PROPRETE STERILISATION;40;40;26;5;9;5;4;31;0;1;4;14;12;9
15775.0;2022;14;RENNES;MASCULIN;APPRENTISSAGE;BAC PROFESSIONNEL;BAC PRO SERV;BAC PRO AG 33002 SERV PERS TERRIT;3;3;3;0;0;0;0;3;0;0;0;1;2;0
15779.0;2022;14;RENNES;MASCULIN;ENSEIGNEMENT A DISTANCE;BAC PROFESSIONNEL;BAC PRO SERV;BAC PRO 31214 MET.COM.VEN.OP.B PR.CL.VA.OF.COM.;2;0;0;0;0;0;0;0;0;0;0;0;0;0
15783.0;2022;14;RENNES;MASCULIN;FORMATION CONTINUE;BAC PROFESSIONNEL;BAC PRO PROD;BAC PRO 23004 TECHN. ETUDES BAT.A ETUDES & ECO.;1;1;0;1;0;0;0;0;0;0;0;0;0;1
15784.0;2022;14;RENNES;MASCULIN;FORMATION CONTINUE;BAC PROFESSIONNEL;BAC PRO PROD;BAC PRO 25214 MAINT.VEHIC.OPTA VOIT.PARTICUL.;1;1;1;0;0;0;0;1;0;0;0;0;1;0
15786.0;2022;14;RENNES;MASCULIN;FORMATION CONTINUE;BAC PROFESSIONNEL;BAC PRO PROD;BAC PRO 25221 MAINT.MATERIELS OPT.C ESP. VERTS;1;1;1;0;0;0;0;1;0;1;0;0;0;0
15787.0;2022;14;RENNES;MASCULIN;FORMATION CONTINUE;BAC PROFESSIONNEL;BAC PRO PROD;BAC PRO 25303 AERONAUTIQUE OPTION SYSTEMES;7;7;7;0;0;0;0;7;0;2;2;3;0;0
15797.0;2022;14;RENNES;MASCULIN;INDIVIDUEL;BAC PROFESSIONNEL;BAC PRO PROD;BAC PRO 25221 MAINT.MATERIELS OPT.C ESP. VERTS;1;0;0;0;0;0;0;0;0;0;0;0;0;0
15799.0;2022;14;RENNES;MASCULIN;INDIVIDUEL;BAC PROFESSIONNEL;BAC PRO PROD;BAC PRO 25510 METIERS ELECT. ENVIRON. CONNECTES;3;2;2;0;0;0;0;2;0;0;1;0;1;0
15802.0;2022;14;RENNES;MASCULIN;INDIVIDUEL;BAC PROFESSIONNEL;BAC PRO PROD;BAC PRO AG 21004 CGEA;10;5;3;2;0;0;0;3;0;0;0;0;3;2
15803.0;2022;14;RENNES;MASCULIN;INDIVIDUEL;BAC PROFESSIONNEL;BAC PRO PROD;BAC PRO AG 21113 CGEVV;1;1;1;0;0;0;0;1;0;0;0;0;1;0
15805.0;2022;14;RENNES;MASCULIN;INDIVIDUEL;BAC PROFESSIONNEL;BAC PRO PROD;BAC PRO AG 21211 COND GEST ENTR HIPPIQUE;4;0;0;0;0;0;0;0;0;0;0;0;0;0
15808.0;2022;14;RENNES;MASCULIN;INDIVIDUEL;BAC PROFESSIONNEL;BAC PRO PROD;BAC PRO AG 22105 LABORATOIRE CONTROLE QUALITE;1;1;1;0;0;0;0;1;0;0;0;0;1;0
15816.0;2022;14;RENNES;MASCULIN;INDIVIDUEL;BAC TECHNOLOGIQUE;BAC STD2A;BAC STD2A SCIENCES & TECHNO. DESIGN-ARTS APPLIQUES;1;1;1;0;0;0;0;1;0;0;0;1;0;0
15822.0;2022;14;RENNES;MASCULIN;SCOLAIRE;BAC GENERAL;BAC GENERAL;BAC GENE 10019 BAC GENERAL;7952;7952;7549;57;346;230;116;7779;87;822;2036;2758;2076;173
15824.0;2022;14;RENNES;MASCULIN;SCOLAIRE;BAC PROFESSIONNEL;BAC PRO PROD;BAC PRO 22105 BOULANGER-PÂTISSIER;49;49;45;4;0;0;0;45;0;6;10;22;7;4
15827.0;2022;14;RENNES;MASCULIN;SCOLAIRE;BAC PROFESSIONNEL;BAC PRO PROD;BAC PRO 22503 PLASTIQUES ET COMPOSITES;20;20;18;2;0;0;0;18;0;0;2;7;9;2
15835.0;2022;14;RENNES;MASCULIN;SCOLAIRE;BAC PROFESSIONNEL;BAC PRO PROD;BAC PRO 23203 TECHNICIEN BAT. : ORG.REAL.GROS O;17;17;12;5;0;0;0;12;0;0;2;6;4;5
15836.0;2022;14;RENNES;MASCULIN;SCOLAIRE;BAC PROFESSIONNEL;BAC PRO PROD;BAC PRO 23303 MENUISERIE ALUMINIUM-VERRE;6;6;4;1;1;0;1;4;0;0;0;3;1;2
15837.0;2022;14;RENNES;MASCULIN;SCOLAIRE;BAC PROFESSIONNEL;BAC PRO PROD;BAC PRO 23304 AMENAGEMENT FINITION BATIMENT;26;26;19;6;1;1;0;20;0;0;2;9;9;6
15841.0;2022;14;RENNES;MASCULIN;SCOLAIRE;BAC PROFESSIONNEL;BAC PRO PROD;BAC PRO 23408 Etude et réalisation d'agencement;9;9;8;1;0;0;0;8;0;2;2;1;3;1
15860.0;2022;14;RENNES;MASCULIN;SCOLAIRE;BAC PROFESSIONNEL;BAC PRO PROD;BAC PRO 25411 TECH.CHAUDRONNERIE INDUSTRIELLE;123;123;98;22;3;2;1;100;0;4;14;41;41;23
15865.0;2022;14;RENNES;MASCULIN;SCOLAIRE;BAC PROFESSIONNEL;BAC PRO PROD;BAC PRO 25515 SYST.NUM.OPT.C RES.INF.SYST.COMM.;225;225;210;12;3;2;1;212;0;19;81;77;35;13
15868.0;2022;14;RENNES;MASCULIN;SCOLAIRE;BAC PROFESSIONNEL;BAC PRO PROD;BAC PRO AG 21114 CONDUITE PRODUCTIONS HORTICOLES;16;14;11;3;0;0;0;11;0;1;1;6;3;3
15875.0;2022;14;RENNES;MASCULIN;SCOLAIRE;BAC PROFESSIONNEL;BAC PRO PROD;BAC PRO AG 21405 AMENAGEMENTS PAYSAGERS;182;179;162;17;0;0;0;162;0;2;14;70;76;17
15887.0;2022;14;RENNES;MASCULIN;SCOLAIRE;BAC PROFESSIONNEL;BAC PRO SERV;BAC PRO 32208 REAL.PR.IMPR.PLURI.OPTB.PR.IMPR.;13;13;12;0;1;1;0;13;0;1;2;5;5;0
15890.0;2022;14;RENNES;MASCULIN;SCOLAIRE;BAC PROFESSIONNEL;BAC PRO SERV;BAC PRO 33003 ACC.SOINS-S.PERS. OPT.A DOMICILE;14;14;9;5;0;0;0;9;0;0;1;5;3;5
15891.0;2022;14;RENNES;MASCULIN;SCOLAIRE;BAC PROFESSIONNEL;BAC PRO SERV;BAC PRO 33004 ACC.SOINS-S.PERS. OPT.EN STRUCTUR;50;50;47;1;2;2;0;49;0;2;10;16;21;1
15893.0;2022;14;RENNES;MASCULIN;SCOLAIRE;BAC PROFESSIONNEL;BAC PRO SERV;BAC PRO 33403 COMMERC. SERVICES EN RESTAURATION;102;102;85;12;5;5;0;90;0;6;21;34;29;12
15894.0;2022;14;RENNES;MASCULIN;SCOLAIRE;BAC PROFESSIONNEL;BAC PRO SERV;BAC PRO 33603 ESTHETIQUE COSMETIQUE PARFUMERIE;1;1;1;0;0;0;0;1;0;0;0;0;1;0
15903.0;2022;14;RENNES;MASCULIN;SCOLAIRE;BAC TECHNOLOGIQUE;BAC STD2A;BAC STD2A SCIENCES & TECHNO. DESIGN-ARTS APPLIQUES;30;30;30;0;0;0;0;30;0;1;9;16;4;0
15904.0;2022;14;RENNES;MASCULIN;SCOLAIRE;BAC TECHNOLOGIQUE;BAC STHR;BAC STHR SC.&TEC. HOTELLERIE-RESTAURATION;47;47;45;0;2;1;1;46;0;1;8;24;13;1
15910.0;2022;14;RENNES;MASCULIN;SCOLAIRE;BAC TECHNOLOGIQUE;BAC STL;BAC STL SCIENCES PHYSIQUES CHIMIQUES  EN LABORAT.;36;36;34;0;2;1;1;35;0;1;8;14;12;1
15916.0;2022;15;STRASBOURG;FEMININ;APPRENTISSAGE;BAC PROFESSIONNEL;BAC PRO PROD;BAC PRO 22304 ART.MET.ART-FACT.ORG. OPT.ORGAN.;1;1;1;0;0;0;0;1;0;0;0;1;0;0
15934.0;2022;15;STRASBOURG;FEMININ;APPRENTISSAGE;BAC PROFESSIONNEL;BAC PRO PROD;BAC PRO AG 21407 TEC CONS VTE UNIVERS JARDINERIE;3;3;3;0;0;0;0;3;0;0;0;0;3;0
15939.0;2022;15;STRASBOURG;FEMININ;APPRENTISSAGE;BAC PROFESSIONNEL;BAC PRO SERV;BAC PRO 32207 REAL.PR.IMPR.PLURI.OPTA.PR.GRAPH.;2;2;2;0;0;0;0;2;0;0;2;0;0;0
15940.0;2022;15;STRASBOURG;FEMININ;APPRENTISSAGE;BAC PROFESSIONNEL;BAC PRO SERV;BAC PRO 33403 COMMERC. SERVICES EN RESTAURATION;8;7;6;1;0;0;0;6;0;1;2;1;2;1
15943.0;2022;15;STRASBOURG;FEMININ;ENSEIGNEMENT A DISTANCE;BAC PROFESSIONNEL;BAC PRO SERV;BAC PRO 30001 GESTION-ADMINISTRATION;6;6;4;2;0;0;0;4;0;0;1;0;3;2
15944.0;2022;15;STRASBOURG;FEMININ;ENSEIGNEMENT A DISTANCE;BAC PROFESSIONNEL;BAC PRO SERV;BAC PRO 31213 MET.COM.VEN.OP.A ANI.GES.ESP.COM.;2;1;0;1;0;0;0;0;0;0;0;0;0;1
15950.0;2022;15;STRASBOURG;FEMININ;FORMATION CONTINUE;BAC PROFESSIONNEL;BAC PRO PROD;BAC PRO 20102 PILOTE DE LIGNE DE PRODUCTION;1;1;1;0;0;0;0;1;0;0;1;0;0;0
15962.0;2022;15;STRASBOURG;FEMININ;INDIVIDUEL;BAC PROFESSIONNEL;BAC PRO PROD;BAC PRO AG 21211 COND GEST ENTR HIPPIQUE;2;2;1;1;0;0;0;1;0;0;0;0;1;1
15966.0;2022;15;STRASBOURG;FEMININ;INDIVIDUEL;BAC PROFESSIONNEL;BAC PRO SERV;BAC PRO 31213 MET.COM.VEN.OP.A ANI.GES.ESP.COM.;6;2;0;2;0;0;0;0;0;0;0;0;0;2
15973.0;2022;15;STRASBOURG;FEMININ;INDIVIDUEL;BAC TECHNOLOGIQUE;BAC STL;BAC STL SCIENCES PHYSIQUES CHIMIQUES  EN LABORAT.;1;1;0;1;0;0;0;0;0;0;0;0;0;1
15975.0;2022;15;STRASBOURG;FEMININ;INDIVIDUEL;BAC TECHNOLOGIQUE;BAC STMG;BAC STMG MERCATIQUE (MARKETING);13;11;9;1;1;1;0;10;0;0;3;3;4;1
15977.0;2022;15;STRASBOURG;FEMININ;INDIVIDUEL;BAC TECHNOLOGIQUE;BAC STMG;BAC STMG SYSTEMES D'INFORMATION DE GESTION;1;1;0;1;0;0;0;0;0;0;0;0;0;1
15982.0;2022;15;STRASBOURG;FEMININ;SCOLAIRE;BAC PROFESSIONNEL;BAC PRO PROD;BAC PRO 22106 CUISINE;25;24;21;3;0;0;0;21;0;5;9;3;4;3
15986.0;2022;15;STRASBOURG;FEMININ;SCOLAIRE;BAC PROFESSIONNEL;BAC PRO PROD;BAC PRO 23205 INTERV. SUR PATRIMOINE BATI OPT.A;1;1;1;0;0;0;0;1;0;0;0;0;1;0
15991.0;2022;15;STRASBOURG;FEMININ;SCOLAIRE;BAC PROFESSIONNEL;BAC PRO PROD;BAC PRO 25007 MAINTENANCE EQUIPEMENTS INDUST.;4;4;2;1;1;1;0;3;0;0;0;1;2;1
15999.0;2022;15;STRASBOURG;FEMININ;SCOLAIRE;BAC PROFESSIONNEL;BAC PRO PROD;BAC PRO 25510 METIERS ELECT. ENVIRON. CONNECTES;1;1;1;0;0;0;0;1;0;0;1;0;0;0
16007.0;2022;15;STRASBOURG;FEMININ;SCOLAIRE;BAC PROFESSIONNEL;BAC PRO PROD;BAC PRO AG 22105 LABORATOIRE CONTROLE QUALITE;8;8;8;0;0;0;0;8;0;1;4;1;2;0
16014.0;2022;15;STRASBOURG;FEMININ;SCOLAIRE;BAC PROFESSIONNEL;BAC PRO SERV;BAC PRO 31212 METIERS DE L'ACCUEIL;149;149;126;17;6;5;1;131;0;9;28;47;47;18
16028.0;2022;15;STRASBOURG;FEMININ;SCOLAIRE;BAC PROFESSIONNEL;BAC PRO SERV;BAC PRO AG 33002 SERV PERS TERRIT;37;36;30;6;0;0;0;30;0;0;6;6;18;6
16029.0;2022;15;STRASBOURG;FEMININ;SCOLAIRE;BAC TECHNOLOGIQUE;BAC ST2S;BAC ST2S SCIENCES & TECHNO. SANTE & SOCIAL;497;497;445;13;39;22;17;467;1;28;90;199;149;30
16035.0;2022;15;STRASBOURG;FEMININ;SCOLAIRE;BAC TECHNOLOGIQUE;BAC STI2D;BAC STI2D INNOVATION TECHNO.  ET ECO CONCEPTION;13;13;10;1;2;1;1;11;0;2;3;3;3;2
16045.0;2022;15;STRASBOURG;MASCULIN;APPRENTISSAGE;BAC PROFESSIONNEL;BAC PRO PROD;BAC PRO 22305 ART.MET.ART-FACT.ORG. OPT.TUYAUT.;1;1;1;0;0;0;0;1;0;0;0;0;1;0
16056.0;2022;15;STRASBOURG;MASCULIN;APPRENTISSAGE;BAC PROFESSIONNEL;BAC PRO PROD;BAC PRO 25106 TECHNICIEN D'USINAGE;37;37;33;2;2;2;0;35;0;4;13;8;10;2
16058.0;2022;15;STRASBOURG;MASCULIN;APPRENTISSAGE;BAC PROFESSIONNEL;BAC PRO PROD;BAC PRO 25214 MAINT.VEHIC.OPTA VOIT.PARTICUL.;99;97;83;10;4;2;2;85;0;10;20;30;25;12
16074.0;2022;15;STRASBOURG;MASCULIN;APPRENTISSAGE;BAC PROFESSIONNEL;BAC PRO PROD;BAC PRO AG 21113 CGEVV;6;6;6;0;0;0;0;6;0;1;1;1;3;0
16077.0;2022;15;STRASBOURG;MASCULIN;APPRENTISSAGE;BAC PROFESSIONNEL;BAC PRO PROD;BAC PRO AG 21211 COND GEST ENTR HIPPIQUE;1;1;0;1;0;0;0;0;0;0;0;0;0;1
16078.0;2022;15;STRASBOURG;MASCULIN;APPRENTISSAGE;BAC PROFESSIONNEL;BAC PRO PROD;BAC PRO AG 21405 AMENAGEMENTS PAYSAGERS;65;65;62;3;0;0;0;62;0;0;6;22;34;3
16079.0;2022;15;STRASBOURG;MASCULIN;APPRENTISSAGE;BAC PROFESSIONNEL;BAC PRO PROD;BAC PRO AG 21407 TEC CONS VTE UNIVERS JARDINERIE;3;3;3;0;0;0;0;3;0;0;0;0;3;0
16086.0;2022;15;STRASBOURG;MASCULIN;ENSEIGNEMENT A DISTANCE;BAC GENERAL;BAC GENERAL;BAC GENE 10019 BAC GENERAL;12;12;7;4;1;0;1;7;0;1;2;2;2;5
16095.0;2022;15;STRASBOURG;MASCULIN;FORMATION CONTINUE;BAC PROFESSIONNEL;BAC PRO PROD;BAC PRO 25007 MAINTENANCE EQUIPEMENTS INDUST.;2;2;1;1;0;0;0;1;0;1;0;0;0;1
16098.0;2022;15;STRASBOURG;MASCULIN;FORMATION CONTINUE;BAC PROFESSIONNEL;BAC PRO PROD;BAC PRO 25215 MAINT.VEHIC.OPTB VEHIC.TRANS.ROUT;1;1;0;0;1;1;0;1;0;0;0;0;1;0
16099.0;2022;15;STRASBOURG;MASCULIN;FORMATION CONTINUE;BAC PROFESSIONNEL;BAC PRO PROD;BAC PRO 25411 TECH.CHAUDRONNERIE INDUSTRIELLE;9;8;8;0;0;0;0;8;0;0;3;4;1;0
16103.0;2022;15;STRASBOURG;MASCULIN;INDIVIDUEL;BAC PROFESSIONNEL;BAC PRO PROD;BAC PRO 22004 PROC. CHIMIE EAU PAPIERS-CARTONS;1;0;0;0;0;0;0;0;0;0;0;0;0;0
16106.0;2022;15;STRASBOURG;MASCULIN;INDIVIDUEL;BAC PROFESSIONNEL;BAC PRO PROD;BAC PRO 23004 TECHN. ETUDES BAT.A ETUDES & ECO.;1;1;0;1;0;0;0;0;0;0;0;0;0;1
16115.0;2022;15;STRASBOURG;MASCULIN;INDIVIDUEL;BAC PROFESSIONNEL;BAC PRO PROD;BAC PRO 25510 METIERS ELECT. ENVIRON. CONNECTES;5;5;2;2;1;1;0;3;0;0;0;0;3;2
16118.0;2022;15;STRASBOURG;MASCULIN;INDIVIDUEL;BAC PROFESSIONNEL;BAC PRO PROD;BAC PRO AG 21211 COND GEST ENTR HIPPIQUE;1;0;0;0;0;0;0;0;0;0;0;0;0;0
16123.0;2022;15;STRASBOURG;MASCULIN;INDIVIDUEL;BAC PROFESSIONNEL;BAC PRO SERV;BAC PRO 33403 COMMERC. SERVICES EN RESTAURATION;1;1;1;0;0;0;0;1;0;0;0;0;1;0
16131.0;2022;15;STRASBOURG;MASCULIN;INDIVIDUEL;BAC TECHNOLOGIQUE;BAC STMG;BAC STMG RESSOURCES HUMAINES ET COMMUNICATION;3;2;1;1;0;0;0;1;0;0;0;0;1;1
16133.0;2022;15;STRASBOURG;MASCULIN;SCOLAIRE;BAC GENERAL;BAC GENERAL;BAC GENE 10019 BAC GENERAL;4121;4121;3841;65;215;136;79;3977;88;526;1044;1286;1033;144
16137.0;2022;15;STRASBOURG;MASCULIN;SCOLAIRE;BAC PROFESSIONNEL;BAC PRO PROD;BAC PRO 22106 CUISINE;62;62;45;10;7;4;3;49;0;1;10;19;19;13
16139.0;2022;15;STRASBOURG;MASCULIN;SCOLAIRE;BAC PROFESSIONNEL;BAC PRO PROD;BAC PRO 22703 TECHN.INSTALL.SYST.ENERG.CLIMATI;29;29;11;16;2;2;0;13;0;0;2;1;10;16
16143.0;2022;15;STRASBOURG;MASCULIN;SCOLAIRE;BAC PROFESSIONNEL;BAC PRO PROD;BAC PRO 23102 TRAVAUX PUBLICS;7;7;4;3;0;0;0;4;0;0;0;1;3;3
16149.0;2022;15;STRASBOURG;MASCULIN;SCOLAIRE;BAC PROFESSIONNEL;BAC PRO PROD;BAC PRO 23407 TECHNIC.FAB.BOIS ET MATERX ASSOC;11;11;8;3;0;0;0;8;0;2;1;2;3;3
16151.0;2022;15;STRASBOURG;MASCULIN;SCOLAIRE;BAC PROFESSIONNEL;BAC PRO PROD;BAC PRO 25006 MICROTECHNIQUES;18;18;16;0;2;2;0;18;0;0;2;7;9;0
16160.0;2022;15;STRASBOURG;MASCULIN;SCOLAIRE;BAC PROFESSIONNEL;BAC PRO PROD;BAC PRO 25406 OUVRAGES DU BATIMENT METALLERIE;19;19;11;7;1;0;1;11;0;1;3;1;6;8
16173.0;2022;15;STRASBOURG;MASCULIN;SCOLAIRE;BAC PROFESSIONNEL;BAC PRO PROD;BAC PRO AG 21405 AMENAGEMENTS PAYSAGERS;18;18;16;2;0;0;0;16;0;0;2;3;11;2
16174.0;2022;15;STRASBOURG;MASCULIN;SCOLAIRE;BAC PROFESSIONNEL;BAC PRO PROD;BAC PRO AG 22105 LABORATOIRE CONTROLE QUALITE;9;9;9;0;0;0;0;9;0;0;4;0;5;0
16175.0;2022;15;STRASBOURG;MASCULIN;SCOLAIRE;BAC PROFESSIONNEL;BAC PRO PROD;BAC PRO AG 22107 TEC CONS VTE ALIMENTATION P.ALIM;2;2;2;0;0;0;0;2;0;0;0;0;2;0
16180.0;2022;15;STRASBOURG;MASCULIN;SCOLAIRE;BAC PROFESSIONNEL;BAC PRO SERV;BAC PRO 31109 TRANSPORT FLUVIAL;17;17;15;2;0;0;0;15;0;4;4;5;2;2
16184.0;2022;15;STRASBOURG;MASCULIN;SCOLAIRE;BAC PROFESSIONNEL;BAC PRO SERV;BAC PRO 32207 REAL.PR.IMPR.PLURI.OPTA.PR.GRAPH.;14;14;14;0;0;0;0;14;0;0;4;8;2;0
16186.0;2022;15;STRASBOURG;MASCULIN;SCOLAIRE;BAC PROFESSIONNEL;BAC PRO SERV;BAC PRO 32303 ART.& MET.ART:COM.VIS.VIS.PLURI-M;11;11;10;1;0;0;0;10;0;0;6;2;2;1
16192.0;2022;15;STRASBOURG;MASCULIN;SCOLAIRE;BAC PROFESSIONNEL;BAC PRO SERV;BAC PRO 33603 ESTHETIQUE COSMETIQUE PARFUMERIE;1;1;0;1;0;0;0;0;0;0;0;0;0;1
16193.0;2022;15;STRASBOURG;MASCULIN;SCOLAIRE;BAC PROFESSIONNEL;BAC PRO SERV;BAC PRO 34304 HYGIENE PROPRETE STERILISATION;3;3;2;0;1;1;0;3;0;0;0;1;2;0
16194.0;2022;15;STRASBOURG;MASCULIN;SCOLAIRE;BAC PROFESSIONNEL;BAC PRO SERV;BAC PRO 34403 METIERS DE LA SECURITE;27;27;26;1;0;0;0;26;0;4;5;8;9;1
16197.0;2022;15;STRASBOURG;MASCULIN;SCOLAIRE;BAC TECHNOLOGIQUE;BAC STAV;BAC STAV AGRONOMIE ALIM ENV TERRITOI;43;43;43;0;0;0;0;43;0;1;7;17;18;0
16200.0;2022;15;STRASBOURG;MASCULIN;SCOLAIRE;BAC TECHNOLOGIQUE;BAC STI2D;BAC STI2D ARCHITECTURE ET CONSTRUCTION;177;177;149;5;23;10;13;159;0;6;16;63;74;18
16204.0;2022;15;STRASBOURG;MASCULIN;SCOLAIRE;BAC TECHNOLOGIQUE;BAC STL;BAC STL BIOCHIM.-BIOLOGIE-BIOTECHNOL.;78;78;59;10;9;4;5;63;0;2;13;19;29;15
16205.0;2022;15;STRASBOURG;MASCULIN;SCOLAIRE;BAC TECHNOLOGIQUE;BAC STL;BAC STL SCIENCES PHYSIQUES CHIMIQUES  EN LABORAT.;39;39;26;4;9;7;2;33;0;2;3;12;16;6
16206.0;2022;15;STRASBOURG;MASCULIN;SCOLAIRE;BAC TECHNOLOGIQUE;BAC STMG;BAC STMG GESTION ET FINANCE;243;243;204;12;27;17;10;221;0;8;32;79;102;22
16210.0;2022;16;TOULOUSE;FEMININ;APPRENTISSAGE;BAC PROFESSIONNEL;BAC PRO PROD;BAC PRO 22003 BIO-INDUSTRIES DE TRANSFORMATION;1;1;1;0;0;0;0;1;0;0;0;1;0;0
16216.0;2022;16;TOULOUSE;FEMININ;APPRENTISSAGE;BAC PROFESSIONNEL;BAC PRO PROD;BAC PRO 24202 ARTIS.& MET.ART : TAPIS.D'AMEUBL;1;1;1;0;0;0;0;1;0;0;0;1;0;0
16223.0;2022;16;TOULOUSE;FEMININ;APPRENTISSAGE;BAC PROFESSIONNEL;BAC PRO PROD;BAC PRO 25219 MAINT.MATERIELS OPT.A AGRICOLES;1;1;0;1;0;0;0;0;0;0;0;0;0;1
16252.0;2022;16;TOULOUSE;FEMININ;ENSEIGNEMENT A DISTANCE;BAC PROFESSIONNEL;BAC PRO SERV;BAC PRO 31213 MET.COM.VEN.OP.A ANI.GES.ESP.COM.;1;1;0;1;0;0;0;0;0;0;0;0;0;1
16254.0;2022;16;TOULOUSE;FEMININ;ENSEIGNEMENT A DISTANCE;BAC PROFESSIONNEL;BAC PRO SERV;BAC PRO 33004 ACC.SOINS-S.PERS. OPT.EN STRUCTUR;3;2;2;0;0;0;0;2;0;0;0;0;2;0
16265.0;2022;16;TOULOUSE;FEMININ;INDIVIDUEL;BAC PROFESSIONNEL;BAC PRO PROD;BAC PRO 22106 CUISINE;3;2;0;2;0;0;0;0;0;0;0;0;0;2
16271.0;2022;16;TOULOUSE;FEMININ;INDIVIDUEL;BAC PROFESSIONNEL;BAC PRO PROD;BAC PRO AG 21211 COND GEST ENTR HIPPIQUE;7;5;4;1;0;0;0;4;0;0;1;2;1;1
16280.0;2022;16;TOULOUSE;FEMININ;INDIVIDUEL;BAC TECHNOLOGIQUE;BAC ST2S;BAC ST2S SCIENCES & TECHNO. SANTE & SOCIAL;7;5;0;4;1;1;0;1;0;0;0;0;1;4
16282.0;2022;16;TOULOUSE;FEMININ;INDIVIDUEL;BAC TECHNOLOGIQUE;BAC STHR;BAC STHR SC.&TEC. HOTELLERIE-RESTAURATION;1;1;0;1;0;0;0;0;0;0;0;0;0;1
16285.0;2022;16;TOULOUSE;FEMININ;INDIVIDUEL;BAC TECHNOLOGIQUE;BAC STMG;BAC STMG RESSOURCES HUMAINES ET COMMUNICATION;3;1;1;0;0;0;0;1;0;0;0;0;1;0
16288.0;2022;16;TOULOUSE;FEMININ;SCOLAIRE;BAC PROFESSIONNEL;BAC PRO PROD;BAC PRO 22003 BIO-INDUSTRIES DE TRANSFORMATION;18;17;13;3;1;0;1;13;0;1;2;4;6;4
16295.0;2022;16;TOULOUSE;FEMININ;SCOLAIRE;BAC PROFESSIONNEL;BAC PRO PROD;BAC PRO 23003 ARTIS. & M.ART:MARCHANDISAGE VIS.;22;22;17;5;0;0;0;17;0;2;5;8;2;5
16298.0;2022;16;TOULOUSE;FEMININ;SCOLAIRE;BAC PROFESSIONNEL;BAC PRO PROD;BAC PRO 23304 AMENAGEMENT FINITION BATIMENT;9;9;7;2;0;0;0;7;0;1;0;3;3;2
16299.0;2022;16;TOULOUSE;FEMININ;SCOLAIRE;BAC PROFESSIONNEL;BAC PRO PROD;BAC PRO 23405 TECHNICIEN MENUISIER AGENCEUR;4;4;3;1;0;0;0;3;0;1;2;0;0;1
16300.0;2022;16;TOULOUSE;FEMININ;SCOLAIRE;BAC PROFESSIONNEL;BAC PRO PROD;BAC PRO 23407 TECHNIC.FAB.BOIS ET MATERX ASSOC;4;4;2;2;0;0;0;2;0;0;1;1;0;2
16301.0;2022;16;TOULOUSE;FEMININ;SCOLAIRE;BAC PROFESSIONNEL;BAC PRO PROD;BAC PRO 23408 Etude et réalisation d'agencement;10;10;9;1;0;0;0;9;0;0;4;4;1;1
16310.0;2022;16;TOULOUSE;FEMININ;SCOLAIRE;BAC PROFESSIONNEL;BAC PRO PROD;BAC PRO 25303 AERONAUTIQUE OPTION SYSTEMES;2;2;2;0;0;0;0;2;0;1;1;0;0;0
16314.0;2022;16;TOULOUSE;FEMININ;SCOLAIRE;BAC PROFESSIONNEL;BAC PRO PROD;BAC PRO 25513 SYST.NUM.OPT.A SURETE SECURITE;2;2;2;0;0;0;0;2;0;1;0;0;1;0
16317.0;2022;16;TOULOUSE;FEMININ;SCOLAIRE;BAC PROFESSIONNEL;BAC PRO PROD;BAC PRO AG 21004 CGEA;95;91;77;14;0;0;0;77;0;1;4;32;40;14
16320.0;2022;16;TOULOUSE;FEMININ;SCOLAIRE;BAC PROFESSIONNEL;BAC PRO PROD;BAC PRO AG 21203 TECHN CONSEIL DE VENTE ANIMAL;60;59;43;16;0;0;0;43;0;1;5;10;27;16
16328.0;2022;16;TOULOUSE;FEMININ;SCOLAIRE;BAC PROFESSIONNEL;BAC PRO PROD;BAC PRO AG 22107 TEC CONS VTE ALIMENTATION P.ALIM;14;14;10;4;0;0;0;10;0;0;0;2;8;4
16333.0;2022;16;TOULOUSE;FEMININ;SCOLAIRE;BAC PROFESSIONNEL;BAC PRO SERV;BAC PRO 31212 METIERS DE L'ACCUEIL;245;244;205;28;11;7;4;212;0;10;56;74;72;32
16335.0;2022;16;TOULOUSE;FEMININ;SCOLAIRE;BAC PROFESSIONNEL;BAC PRO SERV;BAC PRO 31214 MET.COM.VEN.OP.B PR.CL.VA.OF.COM.;131;131;105;20;6;4;2;109;0;7;20;39;43;22
16336.0;2022;16;TOULOUSE;FEMININ;SCOLAIRE;BAC PROFESSIONNEL;BAC PRO SERV;BAC PRO 32207 REAL.PR.IMPR.PLURI.OPTA.PR.GRAPH.;3;3;3;0;0;0;0;3;0;0;0;2;1;0
16344.0;2022;16;TOULOUSE;FEMININ;SCOLAIRE;BAC PROFESSIONNEL;BAC PRO SERV;BAC PRO 33102 PROTHESE DENTAIRE;22;21;20;1;0;0;0;20;0;4;4;8;4;1
16349.0;2022;16;TOULOUSE;FEMININ;SCOLAIRE;BAC PROFESSIONNEL;BAC PRO SERV;BAC PRO 34304 HYGIENE PROPRETE STERILISATION;7;7;3;1;3;3;0;6;0;1;0;0;5;1
16351.0;2022;16;TOULOUSE;FEMININ;SCOLAIRE;BAC PROFESSIONNEL;BAC PRO SERV;BAC PRO AG 33002 SERV PERS TERRIT;351;342;317;25;0;0;0;317;0;3;52;131;131;25
16352.0;2022;16;TOULOUSE;FEMININ;SCOLAIRE;BAC TECHNOLOGIQUE;BAC S2TMD;BAC S2TMD DANSE;8;8;8;0;0;0;0;8;3;1;2;1;1;0
16353.0;2022;16;TOULOUSE;FEMININ;SCOLAIRE;BAC TECHNOLOGIQUE;BAC S2TMD;BAC S2TMD MUSIQUE;6;6;6;0;0;0;0;6;2;1;3;0;0;0
16365.0;2022;16;TOULOUSE;FEMININ;SCOLAIRE;BAC TECHNOLOGIQUE;BAC STMG;BAC STMG GESTION ET FINANCE;265;265;242;3;20;15;5;257;0;9;34;115;99;8
16370.0;2022;16;TOULOUSE;MASCULIN;APPRENTISSAGE;BAC PROFESSIONNEL;BAC PRO PROD;BAC PRO 22004 PROC. CHIMIE EAU PAPIERS-CARTONS;2;2;2;0;0;0;0;2;0;1;1;0;0;0
16376.0;2022;16;TOULOUSE;MASCULIN;APPRENTISSAGE;BAC PROFESSIONNEL;BAC PRO PROD;BAC PRO 22705 TECHNICIEN GAZ;7;7;7;0;0;0;0;7;0;5;0;2;0;0
16381.0;2022;16;TOULOUSE;MASCULIN;APPRENTISSAGE;BAC PROFESSIONNEL;BAC PRO PROD;BAC PRO 23203 TECHNICIEN BAT. : ORG.REAL.GROS O;4;4;3;1;0;0;0;3;0;0;1;0;2;1
16382.0;2022;16;TOULOUSE;MASCULIN;APPRENTISSAGE;BAC PROFESSIONNEL;BAC PRO PROD;BAC PRO 23205 INTERV. SUR PATRIMOINE BATI OPT.A;4;4;3;1;0;0;0;3;0;0;1;0;2;1
16386.0;2022;16;TOULOUSE;MASCULIN;APPRENTISSAGE;BAC PROFESSIONNEL;BAC PRO PROD;BAC PRO 23404 TECHNICIEN CONSTRUCTEUR BOIS;3;3;3;0;0;0;0;3;0;1;2;0;0;0
16394.0;2022;16;TOULOUSE;MASCULIN;APPRENTISSAGE;BAC PROFESSIONNEL;BAC PRO PROD;BAC PRO 25216 MAINT.VEHIC.OPTC MOTOCYCLES;13;13;9;4;0;0;0;9;0;1;1;6;1;4
16395.0;2022;16;TOULOUSE;MASCULIN;APPRENTISSAGE;BAC PROFESSIONNEL;BAC PRO PROD;BAC PRO 25219 MAINT.MATERIELS OPT.A AGRICOLES;37;37;26;7;4;2;2;28;0;1;2;15;10;9
16407.0;2022;16;TOULOUSE;MASCULIN;APPRENTISSAGE;BAC PROFESSIONNEL;BAC PRO PROD;BAC PRO AG 21004 CGEA;35;34;30;4;0;0;0;30;0;0;2;13;15;4
16408.0;2022;16;TOULOUSE;MASCULIN;APPRENTISSAGE;BAC PROFESSIONNEL;BAC PRO PROD;BAC PRO AG 21405 AMENAGEMENTS PAYSAGERS;33;29;26;3;0;0;0;26;0;0;3;10;13;3
16418.0;2022;16;TOULOUSE;MASCULIN;APPRENTISSAGE;BAC PROFESSIONNEL;BAC PRO SERV;BAC PRO 33403 COMMERC. SERVICES EN RESTAURATION;5;5;5;0;0;0;0;5;0;0;2;3;0;0
16435.0;2022;16;TOULOUSE;MASCULIN;FORMATION CONTINUE;BAC PROFESSIONNEL;BAC PRO PROD;BAC PRO 25303 AERONAUTIQUE OPTION SYSTEMES;1;1;1;0;0;0;0;1;0;0;0;1;0;0
16438.0;2022;16;TOULOUSE;MASCULIN;FORMATION CONTINUE;BAC PROFESSIONNEL;BAC PRO PROD;BAC PRO AG 21004 CGEA;4;4;4;0;0;0;0;4;0;0;0;3;1;0
16443.0;2022;16;TOULOUSE;MASCULIN;INDIVIDUEL;BAC PROFESSIONNEL;BAC PRO PROD;BAC PRO 22105 BOULANGER-PÂTISSIER;1;1;1;0;0;0;0;1;0;0;1;0;0;0
16448.0;2022;16;TOULOUSE;MASCULIN;INDIVIDUEL;BAC PROFESSIONNEL;BAC PRO PROD;BAC PRO 25106 TECHNICIEN D'USINAGE;1;0;0;0;0;0;0;0;0;0;0;0;0;0
16455.0;2022;16;TOULOUSE;MASCULIN;INDIVIDUEL;BAC PROFESSIONNEL;BAC PRO PROD;BAC PRO AG 21113 CGEVV;2;1;1;0;0;0;0;1;0;0;0;0;1;0
16458.0;2022;16;TOULOUSE;MASCULIN;INDIVIDUEL;BAC PROFESSIONNEL;BAC PRO PROD;BAC PRO AG 21302 GEST MILIEUX NATURELS FAUNE;1;1;1;0;0;0;0;1;0;0;0;0;1;0
16461.0;2022;16;TOULOUSE;MASCULIN;INDIVIDUEL;BAC PROFESSIONNEL;BAC PRO SERV;BAC PRO 31212 METIERS DE L'ACCUEIL;2;1;0;1;0;0;0;0;0;0;0;0;0;1
16463.0;2022;16;TOULOUSE;MASCULIN;INDIVIDUEL;BAC PROFESSIONNEL;BAC PRO SERV;BAC PRO 31214 MET.COM.VEN.OP.B PR.CL.VA.OF.COM.;2;2;1;1;0;0;0;1;0;0;0;0;1;1
16465.0;2022;16;TOULOUSE;MASCULIN;INDIVIDUEL;BAC TECHNOLOGIQUE;BAC ST2S;BAC ST2S SCIENCES & TECHNO. SANTE & SOCIAL;4;4;1;2;1;0;1;1;0;0;0;1;0;3
16483.0;2022;16;TOULOUSE;MASCULIN;SCOLAIRE;BAC PROFESSIONNEL;BAC PRO PROD;BAC PRO 22704 TECHN. MAINT. SYST.ENERG.CLIMATI;32;32;22;7;3;3;0;25;0;0;3;8;14;7
16484.0;2022;16;TOULOUSE;MASCULIN;SCOLAIRE;BAC PROFESSIONNEL;BAC PRO PROD;BAC PRO 22705 TECHNICIEN GAZ;1;1;0;1;0;0;0;0;0;0;0;0;0;1
16492.0;2022;16;TOULOUSE;MASCULIN;SCOLAIRE;BAC PROFESSIONNEL;BAC PRO PROD;BAC PRO 23303 MENUISERIE ALUMINIUM-VERRE;9;9;6;3;0;0;0;6;0;0;2;2;2;3
16494.0;2022;16;TOULOUSE;MASCULIN;SCOLAIRE;BAC PROFESSIONNEL;BAC PRO PROD;BAC PRO 23404 TECHNICIEN CONSTRUCTEUR BOIS;34;34;25;7;2;2;0;27;0;1;3;11;12;7
16495.0;2022;16;TOULOUSE;MASCULIN;SCOLAIRE;BAC PROFESSIONNEL;BAC PRO PROD;BAC PRO 23405 TECHNICIEN MENUISIER AGENCEUR;43;43;36;5;2;1;1;37;0;2;10;14;11;6
16502.0;2022;16;TOULOUSE;MASCULIN;SCOLAIRE;BAC PROFESSIONNEL;BAC PRO PROD;BAC PRO 25006 MICROTECHNIQUES;15;15;14;0;1;1;0;15;0;3;2;7;3;0
16507.0;2022;16;TOULOUSE;MASCULIN;SCOLAIRE;BAC PROFESSIONNEL;BAC PRO PROD;BAC PRO 25214 MAINT.VEHIC.OPTA VOIT.PARTICUL.;227;227;155;57;15;9;6;164;0;7;21;54;82;63
16519.0;2022;16;TOULOUSE;MASCULIN;SCOLAIRE;BAC PROFESSIONNEL;BAC PRO PROD;BAC PRO 25509 TECHNIC. FROID CONDITIONNEMT AIR;15;15;11;4;0;0;0;11;0;2;5;0;4;4
16534.0;2022;16;TOULOUSE;MASCULIN;SCOLAIRE;BAC PROFESSIONNEL;BAC PRO PROD;BAC PRO AG 21407 TEC CONS VTE UNIVERS JARDINERIE;4;3;0;3;0;0;0;0;0;0;0;0;0;3
16546.0;2022;16;TOULOUSE;MASCULIN;SCOLAIRE;BAC PROFESSIONNEL;BAC PRO SERV;BAC PRO 32303 ART.& MET.ART:COM.VIS.VIS.PLURI-M;44;44;38;6;0;0;0;38;0;1;12;18;7;6
16549.0;2022;16;TOULOUSE;MASCULIN;SCOLAIRE;BAC PROFESSIONNEL;BAC PRO SERV;BAC PRO 33003 ACC.SOINS-S.PERS. OPT.A DOMICILE;6;6;4;1;1;1;0;5;0;0;0;2;3;1
16561.0;2022;16;TOULOUSE;MASCULIN;SCOLAIRE;BAC TECHNOLOGIQUE;BAC S2TMD;BAC S2TMD THEATRE;2;2;2;0;0;0;0;2;0;1;1;0;0;0
16562.0;2022;16;TOULOUSE;MASCULIN;SCOLAIRE;BAC TECHNOLOGIQUE;BAC ST2S;BAC ST2S SCIENCES & TECHNO. SANTE & SOCIAL;182;182;146;11;25;18;7;164;0;4;14;38;108;18
16564.0;2022;16;TOULOUSE;MASCULIN;SCOLAIRE;BAC TECHNOLOGIQUE;BAC STD2A;BAC STD2A SCIENCES & TECHNO. DESIGN-ARTS APPLIQUES;27;27;27;0;0;0;0;27;0;0;10;11;6;0
16565.0;2022;16;TOULOUSE;MASCULIN;SCOLAIRE;BAC TECHNOLOGIQUE;BAC STHR;BAC STHR SC.&TEC. HOTELLERIE-RESTAURATION;55;55;51;0;4;2;2;53;0;2;15;24;12;2
16568.0;2022;16;TOULOUSE;MASCULIN;SCOLAIRE;BAC TECHNOLOGIQUE;BAC STI2D;BAC STI2D INNOVATION TECHNO.  ET ECO CONCEPTION;398;398;336;16;46;33;13;369;0;4;46;136;183;29
16569.0;2022;16;TOULOUSE;MASCULIN;SCOLAIRE;BAC TECHNOLOGIQUE;BAC STI2D;BAC STI2D SYSTÈME D'INFORMATION  ET NUMERIQUE;411;411;352;13;46;28;18;380;0;13;63;136;168;31
16571.0;2022;16;TOULOUSE;MASCULIN;SCOLAIRE;BAC TECHNOLOGIQUE;BAC STL;BAC STL SCIENCES PHYSIQUES CHIMIQUES  EN LABORAT.;75;75;67;1;7;6;1;73;0;3;10;29;31;2
16575.0;2022;16;TOULOUSE;MASCULIN;SCOLAIRE;BAC TECHNOLOGIQUE;BAC STMG;BAC STMG SYSTEMES D'INFORMATION DE GESTION;27;27;22;2;3;3;0;25;0;0;2;3;20;2
16581.0;2022;25;VERSAILLES;FEMININ;APPRENTISSAGE;BAC PROFESSIONNEL;BAC PRO PROD;BAC PRO 25106 TECHNICIEN D'USINAGE;1;1;1;0;0;0;0;1;0;0;1;0;0;0
16590.0;2022;25;VERSAILLES;FEMININ;APPRENTISSAGE;BAC PROFESSIONNEL;BAC PRO PROD;BAC PRO AG 21211 COND GEST ENTR HIPPIQUE;35;35;28;7;0;0;0;28;0;0;3;9;16;7
16593.0;2022;25;VERSAILLES;FEMININ;APPRENTISSAGE;BAC PROFESSIONNEL;BAC PRO SERV;BAC PRO 31106 LOGISTIQUE;2;2;2;0;0;0;0;2;0;0;0;1;1;0
16595.0;2022;25;VERSAILLES;FEMININ;APPRENTISSAGE;BAC PROFESSIONNEL;BAC PRO SERV;BAC PRO 31213 MET.COM.VEN.OP.A ANI.GES.ESP.COM.;102;98;79;11;8;5;3;84;0;6;18;27;33;14
16603.0;2022;25;VERSAILLES;FEMININ;APPRENTISSAGE;BAC PROFESSIONNEL;BAC PRO SERV;BAC PRO AG 33002 SERV PERS TERRIT;1;1;0;1;0;0;0;0;0;0;0;0;0;1
16619.0;2022;25;VERSAILLES;FEMININ;FORMATION CONTINUE;BAC PROFESSIONNEL;BAC PRO PROD;BAC PRO 25007 MAINTENANCE EQUIPEMENTS INDUST.;1;1;1;0;0;0;0;1;0;0;1;0;0;0
16626.0;2022;25;VERSAILLES;FEMININ;FORMATION CONTINUE;BAC PROFESSIONNEL;BAC PRO SERV;BAC PRO 34403 METIERS DE LA SECURITE;5;5;2;2;1;1;0;3;0;0;0;2;1;2
16629.0;2022;25;VERSAILLES;FEMININ;INDIVIDUEL;BAC PROFESSIONNEL;BAC PRO PROD;BAC PRO 24203 METIERS DE LA MODE - VÊTEMENT;2;2;2;0;0;0;0;2;0;0;0;1;1;0
16635.0;2022;25;VERSAILLES;FEMININ;INDIVIDUEL;BAC PROFESSIONNEL;BAC PRO SERV;BAC PRO 31212 METIERS DE L'ACCUEIL;14;11;1;6;4;3;1;4;0;0;0;0;4;7
16640.0;2022;25;VERSAILLES;FEMININ;INDIVIDUEL;BAC PROFESSIONNEL;BAC PRO SERV;BAC PRO 33003 ACC.SOINS-S.PERS. OPT.A DOMICILE;4;3;1;0;2;2;0;3;0;0;0;1;2;0
16643.0;2022;25;VERSAILLES;FEMININ;INDIVIDUEL;BAC PROFESSIONNEL;BAC PRO SERV;BAC PRO 33403 COMMERC. SERVICES EN RESTAURATION;1;1;1;0;0;0;0;1;0;0;0;0;1;0
16650.0;2022;25;VERSAILLES;FEMININ;INDIVIDUEL;BAC TECHNOLOGIQUE;BAC STMG;BAC STMG RESSOURCES HUMAINES ET COMMUNICATION;24;14;2;4;8;4;4;6;0;0;0;0;6;8
16651.0;2022;25;VERSAILLES;FEMININ;INDIVIDUEL;BAC TECHNOLOGIQUE;BAC STMG;BAC STMG SYSTEMES D'INFORMATION DE GESTION;1;1;1;0;0;0;0;1;0;0;0;0;1;0
16661.0;2022;25;VERSAILLES;FEMININ;SCOLAIRE;BAC PROFESSIONNEL;BAC PRO PROD;BAC PRO 23304 AMENAGEMENT FINITION BATIMENT;2;2;2;0;0;0;0;2;0;0;2;0;0;0
16663.0;2022;25;VERSAILLES;FEMININ;SCOLAIRE;BAC PROFESSIONNEL;BAC PRO PROD;BAC PRO 23408 Etude et réalisation d'agencement;36;36;28;7;1;1;0;29;0;3;5;11;10;7
16673.0;2022;25;VERSAILLES;FEMININ;SCOLAIRE;BAC PROFESSIONNEL;BAC PRO PROD;BAC PRO 25221 MAINT.MATERIELS OPT.C ESP. VERTS;1;1;0;1;0;0;0;0;0;0;0;0;0;1
16678.0;2022;25;VERSAILLES;FEMININ;SCOLAIRE;BAC PROFESSIONNEL;BAC PRO PROD;BAC PRO 25411 TECH.CHAUDRONNERIE INDUSTRIELLE;1;1;1;0;0;0;0;1;0;0;0;0;1;0
16680.0;2022;25;VERSAILLES;FEMININ;SCOLAIRE;BAC PROFESSIONNEL;BAC PRO PROD;BAC PRO 25513 SYST.NUM.OPT.A SURETE SECURITE;3;3;3;0;0;0;0;3;0;0;1;1;1;0
16681.0;2022;25;VERSAILLES;FEMININ;SCOLAIRE;BAC PROFESSIONNEL;BAC PRO PROD;BAC PRO 25514 SYST.NUM.OPT.B AUD.RES.EQUIP.DOM.;4;4;4;0;0;0;0;4;0;1;2;0;1;0
16688.0;2022;25;VERSAILLES;FEMININ;SCOLAIRE;BAC PROFESSIONNEL;BAC PRO SERV;BAC PRO 30001 GESTION-ADMINISTRATION;1394;1394;1085;242;67;44;23;1129;0;30;198;394;507;265
16689.0;2022;25;VERSAILLES;FEMININ;SCOLAIRE;BAC PROFESSIONNEL;BAC PRO SERV;BAC PRO 31106 LOGISTIQUE;16;14;9;3;2;1;1;10;0;2;3;1;4;4
16691.0;2022;25;VERSAILLES;FEMININ;SCOLAIRE;BAC PROFESSIONNEL;BAC PRO SERV;BAC PRO 31108 TRANSPORT;11;11;6;5;0;0;0;6;0;0;1;1;4;5
16694.0;2022;25;VERSAILLES;FEMININ;SCOLAIRE;BAC PROFESSIONNEL;BAC PRO SERV;BAC PRO 31214 MET.COM.VEN.OP.B PR.CL.VA.OF.COM.;342;341;305;25;11;7;4;312;0;18;94;133;67;29
16696.0;2022;25;VERSAILLES;FEMININ;SCOLAIRE;BAC PROFESSIONNEL;BAC PRO SERV;BAC PRO 32207 REAL.PR.IMPR.PLURI.OPTA.PR.GRAPH.;14;14;13;1;0;0;0;13;0;1;3;5;4;1
16708.0;2022;25;VERSAILLES;FEMININ;SCOLAIRE;BAC PROFESSIONNEL;BAC PRO SERV;BAC PRO AG 33002 SERV PERS TERRIT;42;40;31;9;0;0;0;31;0;0;2;12;17;9
16711.0;2022;25;VERSAILLES;FEMININ;SCOLAIRE;BAC TECHNOLOGIQUE;BAC ST2S;BAC ST2S SCIENCES & TECHNO. SANTE & SOCIAL;1455;1455;1210;55;190;94;96;1304;1;47;205;450;601;151
16717.0;2022;25;VERSAILLES;FEMININ;SCOLAIRE;BAC TECHNOLOGIQUE;BAC STI2D;BAC STI2D INNOVATION TECHNO.  ET ECO CONCEPTION;55;55;50;0;5;2;3;52;0;2;8;15;27;3
16724.0;2022;25;VERSAILLES;FEMININ;SCOLAIRE;BAC TECHNOLOGIQUE;BAC STMG;BAC STMG SYSTEMES D'INFORMATION DE GESTION;138;138;93;17;28;23;5;116;0;0;7;32;77;22
16725.0;2022;25;VERSAILLES;MASCULIN;APPRENTISSAGE;BAC PROFESSIONNEL;BAC PRO PROD;BAC PRO 22105 BOULANGER-PÂTISSIER;37;37;30;5;2;0;2;30;0;0;5;16;9;7
16730.0;2022;25;VERSAILLES;MASCULIN;APPRENTISSAGE;BAC PROFESSIONNEL;BAC PRO PROD;BAC PRO 23102 TRAVAUX PUBLICS;30;29;27;2;0;0;0;27;0;5;3;8;11;2
16742.0;2022;25;VERSAILLES;MASCULIN;APPRENTISSAGE;BAC PROFESSIONNEL;BAC PRO PROD;BAC PRO 25221 MAINT.MATERIELS OPT.C ESP. VERTS;2;2;1;1;0;0;0;1;0;0;0;0;1;1
16744.0;2022;25;VERSAILLES;MASCULIN;APPRENTISSAGE;BAC PROFESSIONNEL;BAC PRO PROD;BAC PRO 25303 AERONAUTIQUE OPTION SYSTEMES;58;58;55;3;0;0;0;55;0;20;19;12;4;3
16747.0;2022;25;VERSAILLES;MASCULIN;APPRENTISSAGE;BAC PROFESSIONNEL;BAC PRO PROD;BAC PRO 25411 TECH.CHAUDRONNERIE INDUSTRIELLE;22;22;20;1;1;1;0;21;0;2;8;7;4;1
16748.0;2022;25;VERSAILLES;MASCULIN;APPRENTISSAGE;BAC PROFESSIONNEL;BAC PRO PROD;BAC PRO 25509 TECHNIC. FROID CONDITIONNEMT AIR;4;4;3;1;0;0;0;3;0;0;1;1;1;1
16752.0;2022;25;VERSAILLES;MASCULIN;APPRENTISSAGE;BAC PROFESSIONNEL;BAC PRO PROD;BAC PRO 25515 SYST.NUM.OPT.C RES.INF.SYST.COMM.;11;11;8;2;1;1;0;9;0;0;2;5;2;2
16754.0;2022;25;VERSAILLES;MASCULIN;APPRENTISSAGE;BAC PROFESSIONNEL;BAC PRO PROD;BAC PRO AG 21211 COND GEST ENTR HIPPIQUE;8;7;5;2;0;0;0;5;0;0;0;2;3;2
16758.0;2022;25;VERSAILLES;MASCULIN;APPRENTISSAGE;BAC PROFESSIONNEL;BAC PRO SERV;BAC PRO 31107 CONDUCT. TRANSP.ROUT.MARCHANDISES;9;9;8;0;1;1;0;9;0;0;5;3;1;0
16763.0;2022;25;VERSAILLES;MASCULIN;APPRENTISSAGE;BAC PROFESSIONNEL;BAC PRO SERV;BAC PRO 33004 ACC.SOINS-S.PERS. OPT.EN STRUCTUR;3;3;3;0;0;0;0;3;0;0;1;1;1;0
16770.0;2022;25;VERSAILLES;MASCULIN;ENSEIGNEMENT A DISTANCE;BAC PROFESSIONNEL;BAC PRO SERV;BAC PRO 30001 GESTION-ADMINISTRATION;7;5;4;1;0;0;0;4;0;0;0;2;2;1
16771.0;2022;25;VERSAILLES;MASCULIN;ENSEIGNEMENT A DISTANCE;BAC PROFESSIONNEL;BAC PRO SERV;BAC PRO 31213 MET.COM.VEN.OP.A ANI.GES.ESP.COM.;11;7;5;2;0;0;0;5;0;1;0;2;2;2
16783.0;2022;25;VERSAILLES;MASCULIN;FORMATION CONTINUE;BAC PROFESSIONNEL;BAC PRO PROD;BAC PRO 25007 MAINTENANCE EQUIPEMENTS INDUST.;8;6;6;0;0;0;0;6;0;1;1;2;2;0
16791.0;2022;25;VERSAILLES;MASCULIN;FORMATION CONTINUE;BAC PROFESSIONNEL;BAC PRO SERV;BAC PRO 34403 METIERS DE LA SECURITE;15;14;5;4;5;2;3;7;0;0;0;4;3;7
16798.0;2022;25;VERSAILLES;MASCULIN;INDIVIDUEL;BAC PROFESSIONNEL;BAC PRO PROD;BAC PRO 23304 AMENAGEMENT FINITION BATIMENT;1;1;1;0;0;0;0;1;0;1;0;0;0;0
16809.0;2022;25;VERSAILLES;MASCULIN;INDIVIDUEL;BAC PROFESSIONNEL;BAC PRO PROD;BAC PRO 25515 SYST.NUM.OPT.C RES.INF.SYST.COMM.;1;1;0;1;0;0;0;0;0;0;0;0;0;1
16810.0;2022;25;VERSAILLES;MASCULIN;INDIVIDUEL;BAC PROFESSIONNEL;BAC PRO PROD;BAC PRO AG 21004 CGEA;7;7;5;2;0;0;0;5;0;0;0;0;5;2
16814.0;2022;25;VERSAILLES;MASCULIN;INDIVIDUEL;BAC PROFESSIONNEL;BAC PRO PROD;BAC PRO AG 21302 GEST MILIEUX NATURELS FAUNE;1;1;1;0;0;0;0;1;0;0;0;0;1;0
16824.0;2022;25;VERSAILLES;MASCULIN;INDIVIDUEL;BAC PROFESSIONNEL;BAC PRO SERV;BAC PRO 32304 PHOTOGRAPHIE;1;1;0;1;0;0;0;0;0;0;0;0;0;1
16825.0;2022;25;VERSAILLES;MASCULIN;INDIVIDUEL;BAC PROFESSIONNEL;BAC PRO SERV;BAC PRO 33002 SERVICES DE PROXIMITE  VIE LOCAL;1;1;1;0;0;0;0;1;0;0;0;0;1;0
16829.0;2022;25;VERSAILLES;MASCULIN;INDIVIDUEL;BAC TECHNOLOGIQUE;BAC ST2S;BAC ST2S SCIENCES & TECHNO. SANTE & SOCIAL;9;4;0;3;1;0;1;0;0;0;0;0;0;4
16834.0;2022;25;VERSAILLES;MASCULIN;INDIVIDUEL;BAC TECHNOLOGIQUE;BAC STI2D;BAC STI2D INNOVATION TECHNO.  ET ECO CONCEPTION;3;1;0;1;0;0;0;0;0;0;0;0;0;1
16843.0;2022;25;VERSAILLES;MASCULIN;SCOLAIRE;BAC PROFESSIONNEL;BAC PRO PROD;BACPRO 20002 ETUD.DEFINITION PRDTS INDUSTRIEL;46;46;28;16;2;2;0;30;0;0;7;5;18;16
16848.0;2022;25;VERSAILLES;MASCULIN;SCOLAIRE;BAC PROFESSIONNEL;BAC PRO PROD;BAC PRO 22503 PLASTIQUES ET COMPOSITES;7;7;6;1;0;0;0;6;0;1;0;2;3;1
16849.0;2022;25;VERSAILLES;MASCULIN;SCOLAIRE;BAC PROFESSIONNEL;BAC PRO PROD;BAC PRO 22703 TECHN.INSTALL.SYST.ENERG.CLIMATI;131;131;82;35;14;10;4;92;0;1;7;24;60;39
16850.0;2022;25;VERSAILLES;MASCULIN;SCOLAIRE;BAC PROFESSIONNEL;BAC PRO PROD;BAC PRO 22704 TECHN. MAINT. SYST.ENERG.CLIMATI;90;90;53;34;3;3;0;56;0;1;5;21;29;34
16851.0;2022;25;VERSAILLES;MASCULIN;SCOLAIRE;BAC PROFESSIONNEL;BAC PRO PROD;BAC PRO 23003 ARTIS. & M.ART:MARCHANDISAGE VIS.;20;18;15;3;0;0;0;15;0;1;2;7;5;3
16859.0;2022;25;VERSAILLES;MASCULIN;SCOLAIRE;BAC PROFESSIONNEL;BAC PRO PROD;BAC PRO 23404 TECHNICIEN CONSTRUCTEUR BOIS;7;7;3;4;0;0;0;3;0;0;0;0;3;4
16864.0;2022;25;VERSAILLES;MASCULIN;SCOLAIRE;BAC PROFESSIONNEL;BAC PRO PROD;BAC PRO 24302 METIERS DU CUIR : MAROQUINERIE;1;1;1;0;0;0;0;1;0;0;1;0;0;0
16867.0;2022;25;VERSAILLES;MASCULIN;SCOLAIRE;BAC PROFESSIONNEL;BAC PRO PROD;BAC PRO 25009 MAINTENANCE NAUTIQUE;19;19;15;4;0;0;0;15;0;0;5;3;7;4
16870.0;2022;25;VERSAILLES;MASCULIN;SCOLAIRE;BAC PROFESSIONNEL;BAC PRO PROD;BAC PRO 25214 MAINT.VEHIC.OPTA VOIT.PARTICUL.;324;324;247;59;18;11;7;258;0;16;52;98;92;66
16871.0;2022;25;VERSAILLES;MASCULIN;SCOLAIRE;BAC PROFESSIONNEL;BAC PRO PROD;BAC PRO 25215 MAINT.VEHIC.OPTB VEHIC.TRANS.ROUT;20;20;15;4;1;1;0;16;0;1;5;1;9;4
16872.0;2022;25;VERSAILLES;MASCULIN;SCOLAIRE;BAC PROFESSIONNEL;BAC PRO PROD;BAC PRO 25216 MAINT.VEHIC.OPTC MOTOCYCLES;38;38;32;4;2;1;1;33;0;3;11;11;8;5
16874.0;2022;25;VERSAILLES;MASCULIN;SCOLAIRE;BAC PROFESSIONNEL;BAC PRO PROD;BAC PRO 25220 MAINT.MATERIELS OPT.B TP MANUT.;19;19;16;2;1;0;1;16;0;0;1;9;6;3
16876.0;2022;25;VERSAILLES;MASCULIN;SCOLAIRE;BAC PROFESSIONNEL;BAC PRO PROD;BAC PRO 25302 AERONAUTIQUE OPTION AVIONIQUE;11;11;9;2;0;0;0;9;0;2;3;2;2;2
16879.0;2022;25;VERSAILLES;MASCULIN;SCOLAIRE;BAC PROFESSIONNEL;BAC PRO PROD;BAC PRO 25406 OUVRAGES DU BATIMENT METALLERIE;8;8;5;2;1;1;0;6;0;0;0;2;4;2
16880.0;2022;25;VERSAILLES;MASCULIN;SCOLAIRE;BAC PROFESSIONNEL;BAC PRO PROD;BAC PRO 25408 REPARATION DES CARROSSERIES;62;62;39;17;6;4;2;43;0;0;5;16;22;19
16889.0;2022;25;VERSAILLES;MASCULIN;SCOLAIRE;BAC PROFESSIONNEL;BAC PRO PROD;BAC PRO AG 21114 CONDUITE PRODUCTIONS HORTICOLES;10;10;8;2;0;0;0;8;0;0;2;2;4;2
16891.0;2022;25;VERSAILLES;MASCULIN;SCOLAIRE;BAC PROFESSIONNEL;BAC PRO PROD;BAC PRO AG 21302 GEST MILIEUX NATURELS FAUNE;27;27;27;0;0;0;0;27;0;1;5;13;8;0
16895.0;2022;25;VERSAILLES;MASCULIN;SCOLAIRE;BAC PROFESSIONNEL;BAC PRO SERV;BAC PRO 31106 LOGISTIQUE;116;115;78;26;11;6;5;84;0;1;11;17;55;31
16898.0;2022;25;VERSAILLES;MASCULIN;SCOLAIRE;BAC PROFESSIONNEL;BAC PRO SERV;BAC PRO 31212 METIERS DE L'ACCUEIL;205;202;136;47;19;18;1;154;0;3;17;55;79;48
16908.0;2022;25;VERSAILLES;MASCULIN;SCOLAIRE;BAC PROFESSIONNEL;BAC PRO SERV;BAC PRO 33004 ACC.SOINS-S.PERS. OPT.EN STRUCTUR;62;61;50;10;1;0;1;50;0;2;6;19;23;11
16909.0;2022;25;VERSAILLES;MASCULIN;SCOLAIRE;BAC PROFESSIONNEL;BAC PRO SERV;BAC PRO 33101 OPTIQUE LUNETTERIE;28;28;21;6;1;1;0;22;0;3;2;4;13;6
16914.0;2022;25;VERSAILLES;MASCULIN;SCOLAIRE;BAC PROFESSIONNEL;BAC PRO SERV;BAC PRO AG 33002 SERV PERS TERRIT;20;20;14;6;0;0;0;14;0;0;1;5;8;6
16919.0;2022;25;VERSAILLES;MASCULIN;SCOLAIRE;BAC TECHNOLOGIQUE;BAC STHR;BAC STHR SC.&TEC. HOTELLERIE-RESTAURATION;49;49;47;0;2;2;0;49;0;1;7;20;21;0
16925.0;2022;25;VERSAILLES;MASCULIN;SCOLAIRE;BAC TECHNOLOGIQUE;BAC STL;BAC STL SCIENCES PHYSIQUES CHIMIQUES  EN LABORAT.;67;67;53;3;11;6;5;59;0;4;18;15;22;8
16943.0;2023;02;AIX-MARSEILLE;FEMININ;APPRENTISSAGE;BAC PROFESSIONNEL;BAC PRO PROD;BAC PRO AG 21203 TECHN CONSEIL DE VENTE ANIMAL;6;6;5;1;0;0;0;5;0;0;0;3;2;1
16948.0;2023;02;AIX-MARSEILLE;FEMININ;APPRENTISSAGE;BAC PROFESSIONNEL;BAC PRO SERV;BAC PRO 30004 ASSISTANC.GEST.ORGANIS.ACTIVITES;11;9;5;4;0;0;0;5;0;1;2;2;0;4
16959.0;2023;02;AIX-MARSEILLE;FEMININ;APPRENTISSAGE;BAC PROFESSIONNEL;BAC PRO SERV;BAC PRO 34304 HYGIENE PROPRETE STERILISATION;2;2;1;1;0;0;0;1;0;0;1;0;0;1
16965.0;2023;02;AIX-MARSEILLE;FEMININ;ENSEIGNEMENT A DISTANCE;BAC PROFESSIONNEL;BAC PRO SERV;BAC PRO 33004 ACC.SOINS-S.PERS. OPT.EN STRUCTUR;4;1;1;0;0;0;0;1;0;0;0;0;1;0
16970.0;2023;02;AIX-MARSEILLE;FEMININ;ENSEIGNEMENT A DISTANCE;BAC TECHNOLOGIQUE;BAC STMG;BAC STMG MERCATIQUE (MARKETING);4;4;2;1;1;1;0;3;0;0;1;0;2;1
16972.0;2023;02;AIX-MARSEILLE;FEMININ;FORMATION CONTINUE;BAC PROFESSIONNEL;BAC PRO PROD;BAC PRO 22106 CUISINE;1;1;0;1;0;0;0;0;0;0;0;0;0;1
16990.0;2023;02;AIX-MARSEILLE;FEMININ;INDIVIDUEL;BAC PROFESSIONNEL;BAC PRO PROD;BAC PRO AG 21114 CONDUITE PRODUCTIONS HORTICOLES;1;1;1;0;0;0;0;1;0;0;0;0;1;0
16992.0;2023;02;AIX-MARSEILLE;FEMININ;INDIVIDUEL;BAC PROFESSIONNEL;BAC PRO SERV;BAC PRO 30004 ASSISTANC.GEST.ORGANIS.ACTIVITES;12;7;3;4;0;0;0;3;0;0;0;0;3;4
16998.0;2023;02;AIX-MARSEILLE;FEMININ;INDIVIDUEL;BAC PROFESSIONNEL;BAC PRO SERV;BAC PRO 33006 ANIMAT. ENFANCE& PERSONNES AGEES;1;0;0;0;0;0;0;0;0;0;0;0;0;0
17005.0;2023;02;AIX-MARSEILLE;FEMININ;INDIVIDUEL;BAC TECHNOLOGIQUE;BAC STL;BAC STL BIOCHIM.-BIOLOGIE-BIOTECHNOL.;2;2;0;1;1;0;1;0;0;0;0;0;0;2
17006.0;2023;02;AIX-MARSEILLE;FEMININ;INDIVIDUEL;BAC TECHNOLOGIQUE;BAC STL;BAC STL SCIENCES PHYSIQUES CHIMIQUES  EN LABORAT.;1;1;0;0;1;0;1;0;0;0;0;0;0;1
17012.0;2023;02;AIX-MARSEILLE;FEMININ;SCOLAIRE;BAC PROFESSIONNEL;BAC PRO PROD;BAC PRO 22003 BIO-INDUSTRIES DE TRANSFORMATION;14;14;9;5;0;0;0;9;0;0;1;6;2;5
17013.0;2023;02;AIX-MARSEILLE;FEMININ;SCOLAIRE;BAC PROFESSIONNEL;BAC PRO PROD;BAC PRO 22004 PROC. CHIMIE EAU PAPIERS-CARTONS;7;7;5;2;0;0;0;5;0;1;2;2;0;2
17014.0;2023;02;AIX-MARSEILLE;FEMININ;SCOLAIRE;BAC PROFESSIONNEL;BAC PRO PROD;BAC PRO 22105 BOULANGER-PÂTISSIER;11;11;9;2;0;0;0;9;0;0;1;4;4;2
17016.0;2023;02;AIX-MARSEILLE;FEMININ;SCOLAIRE;BAC PROFESSIONNEL;BAC PRO PROD;BAC PRO 22503 PLASTIQUES ET COMPOSITES;1;1;1;0;0;0;0;1;0;0;0;0;1;0
17021.0;2023;02;AIX-MARSEILLE;FEMININ;SCOLAIRE;BAC PROFESSIONNEL;BAC PRO PROD;BACPRO 23103 TECHNICIEN GEOMETRE-TOPOGRAPHE;2;2;1;1;0;0;0;1;0;0;0;0;1;1
17030.0;2023;02;AIX-MARSEILLE;FEMININ;SCOLAIRE;BAC PROFESSIONNEL;BAC PRO PROD;BAC PRO 25215 MAINT.VEHIC.OPTB VEHIC.TRANS.ROUT;2;2;0;2;0;0;0;0;0;0;0;0;0;2
17032.0;2023;02;AIX-MARSEILLE;FEMININ;SCOLAIRE;BAC PROFESSIONNEL;BAC PRO PROD;BAC PRO 25303 AERONAUTIQUE OPTION SYSTEMES;3;3;3;0;0;0;0;3;0;0;1;1;1;0
17033.0;2023;02;AIX-MARSEILLE;FEMININ;SCOLAIRE;BAC PROFESSIONNEL;BAC PRO PROD;BAC PRO 25304 AERONAUTIQUE OPTION STRUCTURE;1;1;1;0;0;0;0;1;0;0;0;0;1;0
17036.0;2023;02;AIX-MARSEILLE;FEMININ;SCOLAIRE;BAC PROFESSIONNEL;BAC PRO PROD;BAC PRO 25513 SYST.NUM.OPT.A SURETE SECURITE;2;2;2;0;0;0;0;2;0;0;1;1;0;0
17040.0;2023;02;AIX-MARSEILLE;FEMININ;SCOLAIRE;BAC PROFESSIONNEL;BAC PRO PROD;BAC PRO AG 21113 CGEVV;6;6;5;1;0;0;0;5;0;0;0;2;3;1
17060.0;2023;02;AIX-MARSEILLE;FEMININ;SCOLAIRE;BAC PROFESSIONNEL;BAC PRO SERV;BAC PRO 32304 PHOTOGRAPHIE;18;18;12;6;0;0;0;12;0;0;4;2;6;6
17068.0;2023;02;AIX-MARSEILLE;FEMININ;SCOLAIRE;BAC PROFESSIONNEL;BAC PRO SERV;BAC PRO 33603 ESTHETIQUE COSMETIQUE PARFUMERIE;156;153;111;31;11;4;7;115;0;2;21;46;46;38
17077.0;2023;02;AIX-MARSEILLE;FEMININ;SCOLAIRE;BAC TECHNOLOGIQUE;BAC STI2D;BAC STI2D ARCHITECTURE ET CONSTRUCTION;25;25;20;1;4;2;2;22;0;1;1;7;13;3
17082.0;2023;02;AIX-MARSEILLE;FEMININ;SCOLAIRE;BAC TECHNOLOGIQUE;BAC STL;BAC STL SCIENCES PHYSIQUES CHIMIQUES  EN LABORAT.;105;105;86;4;15;12;3;98;0;7;17;30;44;7
17088.0;2023;02;AIX-MARSEILLE;MASCULIN;APPRENTISSAGE;BAC PROFESSIONNEL;BAC PRO PROD;BAC PRO 22004 PROC. CHIMIE EAU PAPIERS-CARTONS;2;2;2;0;0;0;0;2;0;0;1;0;1;0
17091.0;2023;02;AIX-MARSEILLE;MASCULIN;APPRENTISSAGE;BAC PROFESSIONNEL;BAC PRO PROD;BAC PRO 22503 PLASTIQUES ET COMPOSITES;2;2;0;2;0;0;0;0;0;0;0;0;0;2
17095.0;2023;02;AIX-MARSEILLE;MASCULIN;APPRENTISSAGE;BAC PROFESSIONNEL;BAC PRO PROD;BAC PRO 23102 TRAVAUX PUBLICS;13;13;11;2;0;0;0;11;0;0;1;4;6;2
17100.0;2023;02;AIX-MARSEILLE;MASCULIN;APPRENTISSAGE;BAC PROFESSIONNEL;BAC PRO PROD;BAC PRO 24203 METIERS DE LA MODE - VÊTEMENT;1;1;1;0;0;0;0;1;0;0;0;0;1;0
17108.0;2023;02;AIX-MARSEILLE;MASCULIN;APPRENTISSAGE;BAC PROFESSIONNEL;BAC PRO PROD;BAC PRO 25303 AERONAUTIQUE OPTION SYSTEMES;13;13;11;2;0;0;0;11;0;3;2;3;3;2
17111.0;2023;02;AIX-MARSEILLE;MASCULIN;APPRENTISSAGE;BAC PROFESSIONNEL;BAC PRO PROD;BAC PRO 25411 TECH.CHAUDRONNERIE INDUSTRIELLE;15;15;14;1;0;0;0;14;0;1;4;7;2;1
17118.0;2023;02;AIX-MARSEILLE;MASCULIN;APPRENTISSAGE;BAC PROFESSIONNEL;BAC PRO PROD;BAC PRO AG 21114 CONDUITE PRODUCTIONS HORTICOLES;3;3;3;0;0;0;0;3;0;0;0;2;1;0
17121.0;2023;02;AIX-MARSEILLE;MASCULIN;APPRENTISSAGE;BAC PROFESSIONNEL;BAC PRO PROD;BAC PRO AG 21303 FORET;8;8;7;1;0;0;0;7;0;0;0;3;4;1
17122.0;2023;02;AIX-MARSEILLE;MASCULIN;APPRENTISSAGE;BAC PROFESSIONNEL;BAC PRO PROD;BAC PRO AG 21405 AMENAGEMENTS PAYSAGERS;57;53;43;10;0;0;0;43;0;0;2;11;30;10
17123.0;2023;02;AIX-MARSEILLE;MASCULIN;APPRENTISSAGE;BAC PROFESSIONNEL;BAC PRO PROD;BAC PRO AG 22105 LABORATOIRE CONTROLE QUALITE;1;1;1;0;0;0;0;1;0;0;0;0;1;0
17124.0;2023;02;AIX-MARSEILLE;MASCULIN;APPRENTISSAGE;BAC PROFESSIONNEL;BAC PRO PROD;BAC PRO AG 22108 TEC CONS VTE ALIMENTATION (PAB);1;1;1;0;0;0;0;1;0;0;0;1;0;0
17131.0;2023;02;AIX-MARSEILLE;MASCULIN;APPRENTISSAGE;BAC PROFESSIONNEL;BAC PRO SERV;BAC PRO 32303 ART.& MET.ART:COM.VIS.VIS.PLURI-M;3;2;0;2;0;0;0;0;0;0;0;0;0;2
17132.0;2023;02;AIX-MARSEILLE;MASCULIN;APPRENTISSAGE;BAC PROFESSIONNEL;BAC PRO SERV;BAC PRO 33101 OPTIQUE LUNETTERIE;4;4;2;2;0;0;0;2;0;0;0;1;1;2
17138.0;2023;02;AIX-MARSEILLE;MASCULIN;ENSEIGNEMENT A DISTANCE;BAC PROFESSIONNEL;BAC PRO SERV;BAC PRO 30004 ASSISTANC.GEST.ORGANIS.ACTIVITES;1;1;0;1;0;0;0;0;0;0;0;0;0;1
17140.0;2023;02;AIX-MARSEILLE;MASCULIN;ENSEIGNEMENT A DISTANCE;BAC PROFESSIONNEL;BAC PRO SERV;BAC PRO 31214 MET.COM.VEN.OP.B PR.CL.VA.OF.COM.;1;1;1;0;0;0;0;1;0;0;0;1;0;0
17146.0;2023;02;AIX-MARSEILLE;MASCULIN;ENSEIGNEMENT A DISTANCE;BAC TECHNOLOGIQUE;BAC STMG;BAC STMG MERCATIQUE (MARKETING);3;3;3;0;0;0;0;3;0;0;1;2;0;0
17147.0;2023;02;AIX-MARSEILLE;MASCULIN;ENSEIGNEMENT A DISTANCE;BAC TECHNOLOGIQUE;BAC STMG;BAC STMG RESSOURCES HUMAINES ET COMMUNICATION;1;1;0;0;1;1;0;1;0;0;0;0;1;0
17151.0;2023;02;AIX-MARSEILLE;MASCULIN;FORMATION CONTINUE;BAC PROFESSIONNEL;BAC PRO PROD;BAC PRO 22704 TECHN. MAINT. SYST.ENERG.CLIMATI;4;3;1;2;0;0;0;1;0;1;0;0;0;2
17152.0;2023;02;AIX-MARSEILLE;MASCULIN;FORMATION CONTINUE;BAC PROFESSIONNEL;BAC PRO PROD;BAC PRO 22705 TECHNICIEN GAZ;1;1;1;0;0;0;0;1;0;0;0;1;0;0
17154.0;2023;02;AIX-MARSEILLE;MASCULIN;FORMATION CONTINUE;BAC PROFESSIONNEL;BAC PRO PROD;BAC PRO 25510 METIERS ELECT. ENVIRON. CONNECTES;14;14;11;1;2;1;1;12;0;1;2;3;6;2
17159.0;2023;02;AIX-MARSEILLE;MASCULIN;FORMATION CONTINUE;BAC PROFESSIONNEL;BAC PRO SERV;BAC PRO 32304 PHOTOGRAPHIE;2;1;1;0;0;0;0;1;0;0;0;1;0;0
17168.0;2023;02;AIX-MARSEILLE;MASCULIN;INDIVIDUEL;BAC PROFESSIONNEL;BAC PRO PROD;BAC PRO 25009 MAINTENANCE NAUTIQUE;1;0;0;0;0;0;0;0;0;0;0;0;0;0
17169.0;2023;02;AIX-MARSEILLE;MASCULIN;INDIVIDUEL;BAC PROFESSIONNEL;BAC PRO PROD;BAC PRO 25106 TECHNICIEN D'USINAGE;1;0;0;0;0;0;0;0;0;0;0;0;0;0
17171.0;2023;02;AIX-MARSEILLE;MASCULIN;INDIVIDUEL;BAC PROFESSIONNEL;BAC PRO PROD;BAC PRO 25216 MAINT.VEHIC.OPTC MOTOCYCLES;1;1;0;1;0;0;0;0;0;0;0;0;0;1
17173.0;2023;02;AIX-MARSEILLE;MASCULIN;INDIVIDUEL;BAC PROFESSIONNEL;BAC PRO PROD;BAC PRO 25408 REPARATION DES CARROSSERIES;1;0;0;0;0;0;0;0;0;0;0;0;0;0
17175.0;2023;02;AIX-MARSEILLE;MASCULIN;INDIVIDUEL;BAC PROFESSIONNEL;BAC PRO PROD;BAC PRO 25510 METIERS ELECT. ENVIRON. CONNECTES;4;4;2;1;1;1;0;3;0;0;0;0;3;1
17182.0;2023;02;AIX-MARSEILLE;MASCULIN;INDIVIDUEL;BAC PROFESSIONNEL;BAC PRO PROD;BAC PRO AG 21405 AMENAGEMENTS PAYSAGERS;2;1;1;0;0;0;0;1;0;0;0;0;1;0
17185.0;2023;02;AIX-MARSEILLE;MASCULIN;INDIVIDUEL;BAC PROFESSIONNEL;BAC PRO SERV;BAC PRO 31114 ORGANIS. TRANSPORT MARCHANDISES;1;1;0;1;0;0;0;0;0;0;0;0;0;1
17188.0;2023;02;AIX-MARSEILLE;MASCULIN;INDIVIDUEL;BAC PROFESSIONNEL;BAC PRO SERV;BAC PRO 33403 COMMERC. SERVICES EN RESTAURATION;1;0;0;0;0;0;0;0;0;0;0;0;0;0
17191.0;2023;02;AIX-MARSEILLE;MASCULIN;INDIVIDUEL;BAC TECHNOLOGIQUE;BAC STI2D;BAC STI2D ARCHITECTURE ET CONSTRUCTION;1;1;0;1;0;0;0;0;0;0;0;0;0;1
17198.0;2023;02;AIX-MARSEILLE;MASCULIN;INDIVIDUEL;BAC TECHNOLOGIQUE;BAC STMG;BAC STMG RESSOURCES HUMAINES ET COMMUNICATION;18;18;11;6;1;1;0;12;0;0;0;6;6;6
17206.0;2023;02;AIX-MARSEILLE;MASCULIN;SCOLAIRE;BAC PROFESSIONNEL;BAC PRO PROD;BAC PRO 22106 CUISINE;79;79;60;14;5;3;2;63;0;1;11;27;24;16
17210.0;2023;02;AIX-MARSEILLE;MASCULIN;SCOLAIRE;BAC PROFESSIONNEL;BAC PRO PROD;BAC PRO 22704 TECHN. MAINT. SYST.ENERG.CLIMATI;47;47;26;18;3;3;0;29;0;1;2;8;18;18
17217.0;2023;02;AIX-MARSEILLE;MASCULIN;SCOLAIRE;BAC PROFESSIONNEL;BAC PRO PROD;BAC PRO 23303 MENUISERIE ALUMINIUM-VERRE;5;5;2;0;3;1;2;3;0;0;0;1;2;2
17219.0;2023;02;AIX-MARSEILLE;MASCULIN;SCOLAIRE;BAC PROFESSIONNEL;BAC PRO PROD;BAC PRO 23404 TECHNICIEN CONSTRUCTEUR BOIS;21;20;13;6;1;1;0;14;0;1;2;3;8;6
17224.0;2023;02;AIX-MARSEILLE;MASCULIN;SCOLAIRE;BAC PROFESSIONNEL;BAC PRO PROD;BAC PRO 25007 MAINTENANCE EQUIPEMENTS INDUST.;260;258;173;67;18;13;5;186;0;2;18;76;90;72
17231.0;2023;02;AIX-MARSEILLE;MASCULIN;SCOLAIRE;BAC PROFESSIONNEL;BAC PRO PROD;BAC PRO 25219 MAINT.MATERIELS OPT.A AGRICOLES;17;17;16;1;0;0;0;16;0;2;3;7;4;1
17239.0;2023;02;AIX-MARSEILLE;MASCULIN;SCOLAIRE;BAC PROFESSIONNEL;BAC PRO PROD;BAC PRO 25411 TECH.CHAUDRONNERIE INDUSTRIELLE;71;70;52;12;6;3;3;55;0;0;13;22;20;15
17242.0;2023;02;AIX-MARSEILLE;MASCULIN;SCOLAIRE;BAC PROFESSIONNEL;BAC PRO PROD;BAC PRO 25513 SYST.NUM.OPT.A SURETE SECURITE;69;69;55;8;6;6;0;61;0;2;6;29;24;8
17243.0;2023;02;AIX-MARSEILLE;MASCULIN;SCOLAIRE;BAC PROFESSIONNEL;BAC PRO PROD;BAC PRO 25514 SYST.NUM.OPT.B AUD.RES.EQUIP.DOM.;105;105;81;19;5;4;1;85;0;4;14;29;38;20
17255.0;2023;02;AIX-MARSEILLE;MASCULIN;SCOLAIRE;BAC PROFESSIONNEL;BAC PRO PROD;BAC PRO AG 22105 LABORATOIRE CONTROLE QUALITE;7;7;7;0;0;0;0;7;0;0;2;4;1;0
17258.0;2023;02;AIX-MARSEILLE;MASCULIN;SCOLAIRE;BAC PROFESSIONNEL;BAC PRO SERV;BAC PRO 31106 LOGISTIQUE;53;53;38;11;4;3;1;41;0;3;5;11;22;12
17265.0;2023;02;AIX-MARSEILLE;MASCULIN;SCOLAIRE;BAC PROFESSIONNEL;BAC PRO SERV;BAC PRO 32208 REAL.PR.IMPR.PLURI.OPTB.PR.IMPR.;11;11;10;0;1;0;1;10;0;0;1;6;3;1
17268.0;2023;02;AIX-MARSEILLE;MASCULIN;SCOLAIRE;BAC PROFESSIONNEL;BAC PRO SERV;BAC PRO 33003 ACC.SOINS-S.PERS. OPT.A DOMICILE;4;4;2;2;0;0;0;2;0;0;0;0;2;2
17271.0;2023;02;AIX-MARSEILLE;MASCULIN;SCOLAIRE;BAC PROFESSIONNEL;BAC PRO SERV;BAC PRO 33101 OPTIQUE LUNETTERIE;8;8;6;2;0;0;0;6;0;0;1;5;0;2
17273.0;2023;02;AIX-MARSEILLE;MASCULIN;SCOLAIRE;BAC PROFESSIONNEL;BAC PRO SERV;BAC PRO 33104 TECHNICIEN EN PROTHESE DENTAIRE;4;4;4;0;0;0;0;4;0;0;0;1;3;0
17279.0;2023;02;AIX-MARSEILLE;MASCULIN;SCOLAIRE;BAC TECHNOLOGIQUE;BAC S2TMD;BAC S2TMD MUSIQUE;1;1;0;1;0;0;0;0;0;0;0;0;0;1
17282.0;2023;02;AIX-MARSEILLE;MASCULIN;SCOLAIRE;BAC TECHNOLOGIQUE;BAC STD2A;BAC STD2A SCIENCES & TECHNO. DESIGN-ARTS APPLIQUES;32;32;28;1;3;2;1;30;0;2;7;8;13;2
17287.0;2023;02;AIX-MARSEILLE;MASCULIN;SCOLAIRE;BAC TECHNOLOGIQUE;BAC STI2D;BAC STI2D SYSTÈME D'INFORMATION  ET NUMERIQUE;346;346;309;7;30;18;12;327;1;12;67;130;117;19
17289.0;2023;02;AIX-MARSEILLE;MASCULIN;SCOLAIRE;BAC TECHNOLOGIQUE;BAC STL;BAC STL SCIENCES PHYSIQUES CHIMIQUES  EN LABORAT.;68;68;61;2;5;3;2;64;0;3;11;29;21;4
17292.0;2023;02;AIX-MARSEILLE;MASCULIN;SCOLAIRE;BAC TECHNOLOGIQUE;BAC STMG;BAC STMG RESSOURCES HUMAINES ET COMMUNICATION;285;285;189;24;72;51;21;240;0;2;13;48;177;45
17301.0;2023;20;AMIENS;FEMININ;APPRENTISSAGE;BAC PROFESSIONNEL;BAC PRO PROD;BAC PRO 25216 MAINT.VEHIC.OPTC MOTOCYCLES;1;1;1;0;0;0;0;1;0;0;0;1;0;0
17305.0;2023;20;AMIENS;FEMININ;APPRENTISSAGE;BAC PROFESSIONNEL;BAC PRO PROD;BAC PRO AG 21211 COND GEST ENTR HIPPIQUE;21;20;19;1;0;0;0;19;0;1;4;9;5;1
17307.0;2023;20;AMIENS;FEMININ;APPRENTISSAGE;BAC PROFESSIONNEL;BAC PRO PROD;BAC PRO AG 22108 TEC CONS VTE ALIMENTATION (PAB);9;9;8;1;0;0;0;8;0;0;1;1;6;1
17311.0;2023;20;AMIENS;FEMININ;APPRENTISSAGE;BAC PROFESSIONNEL;BAC PRO SERV;BAC PRO 31213 MET.COM.VEN.OP.A ANI.GES.ESP.COM.;60;57;41;12;4;2;2;43;0;2;10;14;17;14
17312.0;2023;20;AMIENS;FEMININ;APPRENTISSAGE;BAC PROFESSIONNEL;BAC PRO SERV;BAC PRO 33403 COMMERC. SERVICES EN RESTAURATION;6;6;3;2;1;1;0;4;0;0;1;1;2;2
17313.0;2023;20;AMIENS;FEMININ;APPRENTISSAGE;BAC PROFESSIONNEL;BAC PRO SERV;BAC PRO AG 33002 SERV PERS TERRIT;22;22;19;3;0;0;0;19;0;0;1;7;11;3
17318.0;2023;20;AMIENS;FEMININ;ENSEIGNEMENT A DISTANCE;BAC TECHNOLOGIQUE;BAC STMG;BAC STMG RESSOURCES HUMAINES ET COMMUNICATION;1;1;1;0;0;0;0;1;0;0;0;0;1;0
17320.0;2023;20;AMIENS;FEMININ;FORMATION CONTINUE;BAC PROFESSIONNEL;BAC PRO PROD;BAC PRO 23102 TRAVAUX PUBLICS;1;1;1;0;0;0;0;1;0;0;0;0;1;0
17321.0;2023;20;AMIENS;FEMININ;FORMATION CONTINUE;BAC PROFESSIONNEL;BAC PRO PROD;BAC PRO 23203 TECHNICIEN BAT. : ORG.REAL.GROS O;1;1;1;0;0;0;0;1;0;0;0;1;0;0
17323.0;2023;20;AMIENS;FEMININ;FORMATION CONTINUE;BAC PROFESSIONNEL;BAC PRO SERV;BAC PRO 31213 MET.COM.VEN.OP.A ANI.GES.ESP.COM.;1;1;1;0;0;0;0;1;0;0;0;1;0;0
17327.0;2023;20;AMIENS;FEMININ;INDIVIDUEL;BAC PROFESSIONNEL;BAC PRO PROD;BAC PRO AG 21004 CGEA;9;9;5;4;0;0;0;5;0;0;0;0;5;4
17328.0;2023;20;AMIENS;FEMININ;INDIVIDUEL;BAC PROFESSIONNEL;BAC PRO PROD;BAC PRO AG 21114 CONDUITE PRODUCTIONS HORTICOLES;1;1;1;0;0;0;0;1;0;0;0;0;1;0
17331.0;2023;20;AMIENS;FEMININ;INDIVIDUEL;BAC PROFESSIONNEL;BAC PRO SERV;BAC PRO 31106 LOGISTIQUE;1;1;1;0;0;0;0;1;0;0;0;0;1;0
17332.0;2023;20;AMIENS;FEMININ;INDIVIDUEL;BAC PROFESSIONNEL;BAC PRO SERV;BAC PRO 31114 ORGANIS. TRANSPORT MARCHANDISES;1;0;0;0;0;0;0;0;0;0;0;0;0;0
17344.0;2023;20;AMIENS;FEMININ;INDIVIDUEL;BAC TECHNOLOGIQUE;BAC STMG;BAC STMG MERCATIQUE (MARKETING);6;6;0;4;2;1;1;1;0;0;0;0;1;5
17354.0;2023;20;AMIENS;FEMININ;SCOLAIRE;BAC PROFESSIONNEL;BAC PRO PROD;BAC PRO 22503 PLASTIQUES ET COMPOSITES;1;1;1;0;0;0;0;1;0;0;0;1;0;0
17369.0;2023;20;AMIENS;FEMININ;SCOLAIRE;BAC PROFESSIONNEL;BAC PRO PROD;BAC PRO 25220 MAINT.MATERIELS OPT.B TP MANUT.;1;1;1;0;0;0;0;1;0;0;0;0;1;0
17374.0;2023;20;AMIENS;FEMININ;SCOLAIRE;BAC PROFESSIONNEL;BAC PRO PROD;BAC PRO 25513 SYST.NUM.OPT.A SURETE SECURITE;1;1;1;0;0;0;0;1;0;0;1;0;0;0
17378.0;2023;20;AMIENS;FEMININ;SCOLAIRE;BAC PROFESSIONNEL;BAC PRO PROD;BAC PRO AG 21113 CGEVV;1;1;0;1;0;0;0;0;0;0;0;0;0;1
17380.0;2023;20;AMIENS;FEMININ;SCOLAIRE;BAC PROFESSIONNEL;BAC PRO PROD;BAC PRO AG 21203 TECHN CONSEIL DE VENTE ANIMAL;25;25;23;2;0;0;0;23;0;1;0;7;15;2
17387.0;2023;20;AMIENS;FEMININ;SCOLAIRE;BAC PROFESSIONNEL;BAC PRO SERV;BAC PRO 31106 LOGISTIQUE;21;21;10;10;1;1;0;11;0;0;1;5;5;10
17402.0;2023;20;AMIENS;FEMININ;SCOLAIRE;BAC PROFESSIONNEL;BAC PRO SERV;BAC PRO 34304 HYGIENE PROPRETE STERILISATION;28;28;19;6;3;2;1;21;0;3;4;6;8;7
17405.0;2023;20;AMIENS;FEMININ;SCOLAIRE;BAC TECHNOLOGIQUE;BAC ST2S;BAC ST2S SCIENCES & TECHNO. SANTE & SOCIAL;654;654;533;26;95;51;44;584;1;23;87;176;297;70
17409.0;2023;20;AMIENS;FEMININ;SCOLAIRE;BAC TECHNOLOGIQUE;BAC STI2D;BAC STI2D ARCHITECTURE ET CONSTRUCTION;21;21;19;1;1;0;1;19;0;2;1;4;12;2
17410.0;2023;20;AMIENS;FEMININ;SCOLAIRE;BAC TECHNOLOGIQUE;BAC STI2D;BAC STI2D ENERGIES  ET ENVIRONNEMENT;13;13;7;3;3;3;0;10;0;0;2;2;6;3
17421.0;2023;20;AMIENS;MASCULIN;APPRENTISSAGE;BAC PROFESSIONNEL;BAC PRO PROD;BAC PRO 22703 TECHN.INSTALL.SYST.ENERG.CLIMATI;4;4;4;0;0;0;0;4;0;0;1;2;1;0
17429.0;2023;20;AMIENS;MASCULIN;APPRENTISSAGE;BAC PROFESSIONNEL;BAC PRO PROD;BAC PRO 23405 TECHNICIEN MENUISIER AGENCEUR;4;4;3;0;1;0;1;3;0;0;1;0;2;1
17433.0;2023;20;AMIENS;MASCULIN;APPRENTISSAGE;BAC PROFESSIONNEL;BAC PRO PROD;BAC PRO 25106 TECHNICIEN D'USINAGE;22;22;17;4;1;1;0;18;0;1;5;7;5;4
17450.0;2023;20;AMIENS;MASCULIN;APPRENTISSAGE;BAC PROFESSIONNEL;BAC PRO PROD;BAC PRO AG 21211 COND GEST ENTR HIPPIQUE;10;10;9;1;0;0;0;9;0;0;1;4;4;1
17453.0;2023;20;AMIENS;MASCULIN;APPRENTISSAGE;BAC PROFESSIONNEL;BAC PRO SERV;BAC PRO 30004 ASSISTANC.GEST.ORGANIS.ACTIVITES;3;3;1;1;1;1;0;2;0;0;1;0;1;1
17457.0;2023;20;AMIENS;MASCULIN;APPRENTISSAGE;BAC PROFESSIONNEL;BAC PRO SERV;BAC PRO 33403 COMMERC. SERVICES EN RESTAURATION;11;11;7;4;0;0;0;7;0;1;0;1;5;4
17459.0;2023;20;AMIENS;MASCULIN;ENSEIGNEMENT A DISTANCE;BAC GENERAL;BAC GENERAL;BAC GENE 10019 BAC GENERAL;7;7;3;3;1;1;0;4;0;0;1;1;2;3
17460.0;2023;20;AMIENS;MASCULIN;ENSEIGNEMENT A DISTANCE;BAC TECHNOLOGIQUE;BAC STMG;BAC STMG GESTION ET FINANCE;1;1;0;1;0;0;0;0;0;0;0;0;0;1
17463.0;2023;20;AMIENS;MASCULIN;FORMATION CONTINUE;BAC PROFESSIONNEL;BAC PRO PROD;BAC PRO 22704 TECHN. MAINT. SYST.ENERG.CLIMATI;1;1;1;0;0;0;0;1;0;0;1;0;0;0
17468.0;2023;20;AMIENS;MASCULIN;INDIVIDUEL;BAC GENERAL;BAC GENERAL;BAC GENE 10019 BAC GENERAL;41;40;7;30;3;1;2;8;0;0;1;2;5;32
17469.0;2023;20;AMIENS;MASCULIN;INDIVIDUEL;BAC PROFESSIONNEL;BAC PRO PROD;BAC PRO 22703 TECHN.INSTALL.SYST.ENERG.CLIMATI;1;0;0;0;0;0;0;0;0;0;0;0;0;0
17473.0;2023;20;AMIENS;MASCULIN;INDIVIDUEL;BAC PROFESSIONNEL;BAC PRO PROD;BAC PRO AG 21004 CGEA;4;4;2;2;0;0;0;2;0;0;0;0;2;2
17480.0;2023;20;AMIENS;MASCULIN;INDIVIDUEL;BAC PROFESSIONNEL;BAC PRO SERV;BAC PRO 33004 ACC.SOINS-S.PERS. OPT.EN STRUCTUR;1;1;0;1;0;0;0;0;0;0;0;0;0;1
17485.0;2023;20;AMIENS;MASCULIN;INDIVIDUEL;BAC TECHNOLOGIQUE;BAC STL;BAC STL SCIENCES PHYSIQUES CHIMIQUES  EN LABORAT.;1;1;0;1;0;0;0;0;0;0;0;0;0;1
17489.0;2023;20;AMIENS;MASCULIN;INDIVIDUEL;BAC TECHNOLOGIQUE;BAC STMG;BAC STMG SYSTEMES D'INFORMATION DE GESTION;1;1;0;1;0;0;0;0;0;0;0;0;0;1
17497.0;2023;20;AMIENS;MASCULIN;SCOLAIRE;BAC PROFESSIONNEL;BAC PRO PROD;BAC PRO 22303 FONDERIE;4;4;3;1;0;0;0;3;0;1;1;1;0;1
17501.0;2023;20;AMIENS;MASCULIN;SCOLAIRE;BAC PROFESSIONNEL;BAC PRO PROD;BAC PRO 23004 TECHN. ETUDES BAT.A ETUDES & ECO.;10;10;7;3;0;0;0;7;0;1;1;3;2;3
17506.0;2023;20;AMIENS;MASCULIN;SCOLAIRE;BAC PROFESSIONNEL;BAC PRO PROD;BAC PRO 23208 METIERS ET ARTS DE LA PIERRE;2;2;2;0;0;0;0;2;0;0;0;0;2;0
17512.0;2023;20;AMIENS;MASCULIN;SCOLAIRE;BAC PROFESSIONNEL;BAC PRO PROD;BAC PRO 24203 METIERS DE LA MODE - VÊTEMENT;9;9;7;2;0;0;0;7;0;2;3;2;0;2
17520.0;2023;20;AMIENS;MASCULIN;SCOLAIRE;BAC PROFESSIONNEL;BAC PRO PROD;BAC PRO 25215 MAINT.VEHIC.OPTB VEHIC.TRANS.ROUT;23;23;19;2;2;2;0;21;0;4;4;7;6;2
17521.0;2023;20;AMIENS;MASCULIN;SCOLAIRE;BAC PROFESSIONNEL;BAC PRO PROD;BAC PRO 25216 MAINT.VEHIC.OPTC MOTOCYCLES;14;14;13;1;0;0;0;13;0;1;3;9;0;1
17523.0;2023;20;AMIENS;MASCULIN;SCOLAIRE;BAC PROFESSIONNEL;BAC PRO PROD;BAC PRO 25220 MAINT.MATERIELS OPT.B TP MANUT.;16;16;12;2;2;2;0;14;0;0;3;6;5;2
17527.0;2023;20;AMIENS;MASCULIN;SCOLAIRE;BAC PROFESSIONNEL;BAC PRO PROD;BAC PRO 25408 REPARATION DES CARROSSERIES;29;28;18;9;1;1;0;19;0;0;2;7;10;9
17535.0;2023;20;AMIENS;MASCULIN;SCOLAIRE;BAC PROFESSIONNEL;BAC PRO PROD;BAC PRO AG 21004 CGEA;77;76;59;17;0;0;0;59;0;1;8;21;29;17
17538.0;2023;20;AMIENS;MASCULIN;SCOLAIRE;BAC PROFESSIONNEL;BAC PRO PROD;BAC PRO AG 21204 PROD-AQUACOLES;8;8;6;2;0;0;0;6;0;0;1;2;3;2
17539.0;2023;20;AMIENS;MASCULIN;SCOLAIRE;BAC PROFESSIONNEL;BAC PRO PROD;BAC PRO AG 21211 COND GEST ENTR HIPPIQUE;3;3;1;2;0;0;0;1;0;0;0;0;1;2
17546.0;2023;20;AMIENS;MASCULIN;SCOLAIRE;BAC PROFESSIONNEL;BAC PRO SERV;BAC PRO 31107 CONDUCT. TRANSP.ROUT.MARCHANDISES;22;22;17;5;0;0;0;17;0;0;5;9;3;5
17547.0;2023;20;AMIENS;MASCULIN;SCOLAIRE;BAC PROFESSIONNEL;BAC PRO SERV;BAC PRO 31114 ORGANIS. TRANSPORT MARCHANDISES;19;19;9;10;0;0;0;9;0;3;1;0;5;10
17555.0;2023;20;AMIENS;MASCULIN;SCOLAIRE;BAC PROFESSIONNEL;BAC PRO SERV;BAC PRO 33006 ANIMAT. ENFANCE& PERSONNES AGEES;22;22;21;1;0;0;0;21;0;2;7;6;6;1
17556.0;2023;20;AMIENS;MASCULIN;SCOLAIRE;BAC PROFESSIONNEL;BAC PRO SERV;BAC PRO 33101 OPTIQUE LUNETTERIE;7;7;3;4;0;0;0;3;0;0;0;2;1;4
17563.0;2023;20;AMIENS;MASCULIN;SCOLAIRE;BAC TECHNOLOGIQUE;BAC STAV;BAC STAV AGRONOMIE ALIM ENV TERRITOI;77;77;74;3;0;0;0;74;0;0;5;21;48;3
17568.0;2023;20;AMIENS;MASCULIN;SCOLAIRE;BAC TECHNOLOGIQUE;BAC STI2D;BAC STI2D INNOVATION TECHNO.  ET ECO CONCEPTION;213;213;169;9;35;20;15;189;0;2;29;57;101;24
17575.0;2023;20;AMIENS;MASCULIN;SCOLAIRE;BAC TECHNOLOGIQUE;BAC STMG;BAC STMG SYSTEMES D'INFORMATION DE GESTION;28;28;18;3;7;7;0;25;0;0;1;2;22;3
17579.0;2023;03;BESANCON;FEMININ;APPRENTISSAGE;BAC PROFESSIONNEL;BAC PRO PROD;BAC PRO 25007 MAINTENANCE EQUIPEMENTS INDUST.;2;2;1;1;0;0;0;1;0;0;0;1;0;1
17583.0;2023;03;BESANCON;FEMININ;APPRENTISSAGE;BAC PROFESSIONNEL;BAC PRO PROD;BAC PRO 25513 SYST.NUM.OPT.A SURETE SECURITE;1;1;1;0;0;0;0;1;0;0;0;0;1;0
17597.0;2023;03;BESANCON;FEMININ;APPRENTISSAGE;BAC PROFESSIONNEL;BAC PRO SERV;BAC PRO 31214 MET.COM.VEN.OP.B PR.CL.VA.OF.COM.;5;5;4;1;0;0;0;4;0;0;2;0;2;1
17605.0;2023;03;BESANCON;FEMININ;ENSEIGNEMENT A DISTANCE;BAC GENERAL;BAC GENERAL;BAC GENE 10019 BAC GENERAL;25;23;15;7;1;1;0;16;1;2;1;8;4;7
17606.0;2023;03;BESANCON;FEMININ;ENSEIGNEMENT A DISTANCE;BAC PROFESSIONNEL;BAC PRO SERV;BAC PRO 30004 ASSISTANC.GEST.ORGANIS.ACTIVITES;1;1;1;0;0;0;0;1;0;0;0;1;0;0
17613.0;2023;03;BESANCON;FEMININ;ENSEIGNEMENT A DISTANCE;BAC TECHNOLOGIQUE;BAC STMG;BAC STMG RESSOURCES HUMAINES ET COMMUNICATION;1;1;1;0;0;0;0;1;0;0;0;1;0;0
17614.0;2023;03;BESANCON;FEMININ;FORMATION CONTINUE;BAC PROFESSIONNEL;BAC PRO SERV;BAC PRO 33101 OPTIQUE LUNETTERIE;1;1;1;0;0;0;0;1;0;0;0;0;1;0
17619.0;2023;03;BESANCON;FEMININ;INDIVIDUEL;BAC TECHNOLOGIQUE;BAC STMG;BAC STMG GESTION ET FINANCE;1;1;0;1;0;0;0;0;0;0;0;0;0;1
17621.0;2023;03;BESANCON;FEMININ;SCOLAIRE;BAC GENERAL;BAC GENERAL;BAC GENE 10019 BAC GENERAL;3378;3378;3121;41;216;154;62;3275;46;374;809;1092;954;103
17625.0;2023;03;BESANCON;FEMININ;SCOLAIRE;BAC PROFESSIONNEL;BAC PRO PROD;BAC PRO 23005 TECHN. ETUDES BAT B ASSIST.ARCHI.;5;5;5;0;0;0;0;5;0;0;0;4;1;0
17629.0;2023;03;BESANCON;FEMININ;SCOLAIRE;BAC PROFESSIONNEL;BAC PRO PROD;BAC PRO 23407 TECHNIC.FAB.BOIS ET MATERX ASSOC;1;1;1;0;0;0;0;1;0;0;0;0;1;0
17632.0;2023;03;BESANCON;FEMININ;SCOLAIRE;BAC PROFESSIONNEL;BAC PRO PROD;BAC PRO 24203 METIERS DE LA MODE - VÊTEMENT;39;39;36;2;1;1;0;37;0;2;11;13;11;2
17637.0;2023;03;BESANCON;FEMININ;SCOLAIRE;BAC PROFESSIONNEL;BAC PRO PROD;BAC PRO 25216 MAINT.VEHIC.OPTC MOTOCYCLES;1;1;1;0;0;0;0;1;0;0;0;0;1;0
17643.0;2023;03;BESANCON;FEMININ;SCOLAIRE;BAC PROFESSIONNEL;BAC PRO PROD;BAC PRO 25515 SYST.NUM.OPT.C RES.INF.SYST.COMM.;2;2;2;0;0;0;0;2;0;0;1;1;0;0
17665.0;2023;03;BESANCON;FEMININ;SCOLAIRE;BAC PROFESSIONNEL;BAC PRO SERV;BAC PRO 33604 METIERS DE LA COIFFURE;2;2;2;0;0;0;0;2;0;0;0;0;2;0
17666.0;2023;03;BESANCON;FEMININ;SCOLAIRE;BAC PROFESSIONNEL;BAC PRO SERV;BAC PRO 34304 HYGIENE PROPRETE STERILISATION;11;11;4;6;1;1;0;5;0;0;0;2;3;6
17680.0;2023;03;BESANCON;FEMININ;SCOLAIRE;BAC TECHNOLOGIQUE;BAC STL;BAC STL SCIENCES PHYSIQUES CHIMIQUES  EN LABORAT.;38;38;37;0;1;1;0;38;0;1;15;12;10;0
17684.0;2023;03;BESANCON;MASCULIN;APPRENTISSAGE;BAC PROFESSIONNEL;BAC PRO PROD;BAC PRO 22003 BIO-INDUSTRIES DE TRANSFORMATION;13;13;11;2;0;0;0;11;0;0;3;5;3;2
17686.0;2023;03;BESANCON;MASCULIN;APPRENTISSAGE;BAC PROFESSIONNEL;BAC PRO PROD;BAC PRO 22106 CUISINE;7;7;5;2;0;0;0;5;0;0;2;2;1;2
17687.0;2023;03;BESANCON;MASCULIN;APPRENTISSAGE;BAC PROFESSIONNEL;BAC PRO PROD;BAC PRO 22503 PLASTIQUES ET COMPOSITES;1;1;1;0;0;0;0;1;0;0;0;0;1;0
17689.0;2023;03;BESANCON;MASCULIN;APPRENTISSAGE;BAC PROFESSIONNEL;BAC PRO PROD;BAC PRO 22704 TECHN. MAINT. SYST.ENERG.CLIMATI;9;9;7;0;2;2;0;9;0;0;1;4;4;0
17691.0;2023;03;BESANCON;MASCULIN;APPRENTISSAGE;BAC PROFESSIONNEL;BAC PRO PROD;BAC PRO 23005 TECHN. ETUDES BAT B ASSIST.ARCHI.;1;1;1;0;0;0;0;1;0;0;0;1;0;0
17692.0;2023;03;BESANCON;MASCULIN;APPRENTISSAGE;BAC PROFESSIONNEL;BAC PRO PROD;BAC PRO 23102 TRAVAUX PUBLICS;17;17;11;6;0;0;0;11;0;2;3;3;3;6
17698.0;2023;03;BESANCON;MASCULIN;APPRENTISSAGE;BAC PROFESSIONNEL;BAC PRO PROD;BAC PRO 23405 TECHNICIEN MENUISIER AGENCEUR;20;20;18;2;0;0;0;18;0;1;8;5;4;2
17700.0;2023;03;BESANCON;MASCULIN;APPRENTISSAGE;BAC PROFESSIONNEL;BAC PRO PROD;BAC PRO 25005 PRODUCTIQ.MECA. OPT.DECOLLETAGE;2;2;1;0;1;1;0;2;0;0;0;1;1;0
17703.0;2023;03;BESANCON;MASCULIN;APPRENTISSAGE;BAC PROFESSIONNEL;BAC PRO PROD;BAC PRO 25106 TECHNICIEN D'USINAGE;24;24;18;2;4;3;1;21;0;1;3;6;11;3
17705.0;2023;03;BESANCON;MASCULIN;APPRENTISSAGE;BAC PROFESSIONNEL;BAC PRO PROD;BAC PRO 25214 MAINT.VEHIC.OPTA VOIT.PARTICUL.;62;62;54;7;1;0;1;54;0;6;18;19;11;8
17717.0;2023;03;BESANCON;MASCULIN;APPRENTISSAGE;BAC PROFESSIONNEL;BAC PRO PROD;BAC PRO 25515 SYST.NUM.OPT.C RES.INF.SYST.COMM.;5;5;5;0;0;0;0;5;0;1;3;1;0;0
17719.0;2023;03;BESANCON;MASCULIN;APPRENTISSAGE;BAC PROFESSIONNEL;BAC PRO PROD;BAC PRO AG 21004 CGEA;56;55;46;9;0;0;0;46;0;0;6;12;28;9
17721.0;2023;03;BESANCON;MASCULIN;APPRENTISSAGE;BAC PROFESSIONNEL;BAC PRO PROD;BAC PRO AG 21203 TECHN CONSEIL DE VENTE ANIMAL;1;1;1;0;0;0;0;1;0;0;0;1;0;0
17722.0;2023;03;BESANCON;MASCULIN;APPRENTISSAGE;BAC PROFESSIONNEL;BAC PRO PROD;BAC PRO AG 21211 COND GEST ENTR HIPPIQUE;5;5;3;2;0;0;0;3;0;0;0;1;2;2
17723.0;2023;03;BESANCON;MASCULIN;APPRENTISSAGE;BAC PROFESSIONNEL;BAC PRO PROD;BAC PRO AG 21302 GEST MILIEUX NATURELS FAUNE;7;7;6;1;0;0;0;6;0;0;2;3;1;1
17727.0;2023;03;BESANCON;MASCULIN;APPRENTISSAGE;BAC PROFESSIONNEL;BAC PRO PROD;BAC PRO AG 22108 TEC CONS VTE ALIMENTATION (PAB);4;4;4;0;0;0;0;4;0;0;0;2;2;0
17736.0;2023;03;BESANCON;MASCULIN;APPRENTISSAGE;BAC PROFESSIONNEL;BAC PRO SERV;BAC PRO 34403 METIERS DE LA SECURITE;2;2;2;0;0;0;0;2;0;0;1;1;0;0
17737.0;2023;03;BESANCON;MASCULIN;APPRENTISSAGE;BAC PROFESSIONNEL;BAC PRO SERV;BAC PRO AG 33002 SERV PERS TERRIT;2;2;2;0;0;0;0;2;0;0;0;0;2;0
17738.0;2023;03;BESANCON;MASCULIN;ENSEIGNEMENT A DISTANCE;BAC GENERAL;BAC GENERAL;BAC GENE 10019 BAC GENERAL;9;9;5;1;3;2;1;7;0;1;0;1;5;2
17744.0;2023;03;BESANCON;MASCULIN;INDIVIDUEL;BAC GENERAL;BAC GENERAL;BAC GENE 10019 BAC GENERAL;18;18;8;8;2;0;2;8;0;0;0;4;4;10
17746.0;2023;03;BESANCON;MASCULIN;INDIVIDUEL;BAC PROFESSIONNEL;BAC PRO PROD;BAC PRO 23405 TECHNICIEN MENUISIER AGENCEUR;1;0;0;0;0;0;0;0;0;0;0;0;0;0
17747.0;2023;03;BESANCON;MASCULIN;INDIVIDUEL;BAC PROFESSIONNEL;BAC PRO PROD;BAC PRO 25007 MAINTENANCE EQUIPEMENTS INDUST.;2;1;0;1;0;0;0;0;0;0;0;0;0;1
17751.0;2023;03;BESANCON;MASCULIN;INDIVIDUEL;BAC PROFESSIONNEL;BAC PRO PROD;BAC PRO 25510 METIERS ELECT. ENVIRON. CONNECTES;2;1;0;1;0;0;0;0;0;0;0;0;0;1
17753.0;2023;03;BESANCON;MASCULIN;INDIVIDUEL;BAC PROFESSIONNEL;BAC PRO SERV;BAC PRO 30004 ASSISTANC.GEST.ORGANIS.ACTIVITES;1;0;0;0;0;0;0;0;0;0;0;0;0;0
17762.0;2023;03;BESANCON;MASCULIN;INDIVIDUEL;BAC TECHNOLOGIQUE;BAC STMG;BAC STMG MERCATIQUE (MARKETING);6;6;4;2;0;0;0;4;0;0;0;0;4;2
17765.0;2023;03;BESANCON;MASCULIN;SCOLAIRE;BAC PROFESSIONNEL;BAC PRO PROD;BAC PRO 22004 PROC. CHIMIE EAU PAPIERS-CARTONS;11;11;11;0;0;0;0;11;0;1;1;6;3;0
17776.0;2023;03;BESANCON;MASCULIN;SCOLAIRE;BAC PROFESSIONNEL;BAC PRO PROD;BAC PRO 23304 AMENAGEMENT FINITION BATIMENT;9;9;5;2;2;2;0;7;0;0;1;2;4;2
17777.0;2023;03;BESANCON;MASCULIN;SCOLAIRE;BAC PROFESSIONNEL;BAC PRO PROD;BAC PRO 23404 TECHNICIEN CONSTRUCTEUR BOIS;37;37;33;2;2;2;0;35;0;4;5;12;14;2
17779.0;2023;03;BESANCON;MASCULIN;SCOLAIRE;BAC PROFESSIONNEL;BAC PRO PROD;BAC PRO 23407 TECHNIC.FAB.BOIS ET MATERX ASSOC;24;24;23;1;0;0;0;23;0;5;7;6;5;1
17783.0;2023;03;BESANCON;MASCULIN;SCOLAIRE;BAC PROFESSIONNEL;BAC PRO PROD;BAC PRO 25005 PRODUCTIQ.MECA. OPT.DECOLLETAGE;4;4;1;3;0;0;0;1;0;0;0;0;1;3
17797.0;2023;03;BESANCON;MASCULIN;SCOLAIRE;BAC PROFESSIONNEL;BAC PRO PROD;BAC PRO 25514 SYST.NUM.OPT.B AUD.RES.EQUIP.DOM.;56;56;48;5;3;3;0;51;0;2;14;18;17;5
17800.0;2023;03;BESANCON;MASCULIN;SCOLAIRE;BAC PROFESSIONNEL;BAC PRO PROD;BAC PRO AG 21004 CGEA;74;74;65;9;0;0;0;65;0;2;11;22;30;9
17805.0;2023;03;BESANCON;MASCULIN;SCOLAIRE;BAC PROFESSIONNEL;BAC PRO PROD;BAC PRO AG 21405 AMENAGEMENTS PAYSAGERS;20;20;20;0;0;0;0;20;0;0;6;7;7;0
17813.0;2023;03;BESANCON;MASCULIN;SCOLAIRE;BAC PROFESSIONNEL;BAC PRO SERV;BAC PRO 31214 MET.COM.VEN.OP.B PR.CL.VA.OF.COM.;79;79;62;9;8;5;3;67;0;3;12;25;27;12
17815.0;2023;03;BESANCON;MASCULIN;SCOLAIRE;BAC PROFESSIONNEL;BAC PRO SERV;BAC PRO 33004 ACC.SOINS-S.PERS. OPT.EN STRUCTUR;16;16;15;0;1;1;0;16;0;0;3;6;7;0
17824.0;2023;03;BESANCON;MASCULIN;SCOLAIRE;BAC TECHNOLOGIQUE;BAC ST2S;BAC ST2S SCIENCES & TECHNO. SANTE & SOCIAL;42;42;35;1;6;6;0;41;0;0;4;11;26;1
17827.0;2023;03;BESANCON;MASCULIN;SCOLAIRE;BAC TECHNOLOGIQUE;BAC STHR;BAC STHR SC.&TEC. HOTELLERIE-RESTAURATION;20;20;20;0;0;0;0;20;0;1;2;12;5;0
17829.0;2023;03;BESANCON;MASCULIN;SCOLAIRE;BAC TECHNOLOGIQUE;BAC STI2D;BAC STI2D ENERGIES  ET ENVIRONNEMENT;83;83;54;3;26;17;9;71;0;2;8;18;43;12
17836.0;2023;03;BESANCON;MASCULIN;SCOLAIRE;BAC TECHNOLOGIQUE;BAC STMG;BAC STMG RESSOURCES HUMAINES ET COMMUNICATION;135;135;72;19;44;27;17;99;0;0;0;15;84;36
17844.0;2023;04;BORDEAUX;FEMININ;APPRENTISSAGE;BAC PROFESSIONNEL;BAC PRO PROD;BAC PRO 24303 MET. DU CUIR: SELLERIE GARNISSAGE;2;2;2;0;0;0;0;2;0;1;1;0;0;0
17846.0;2023;04;BORDEAUX;FEMININ;APPRENTISSAGE;BAC PROFESSIONNEL;BAC PRO PROD;BAC PRO 25106 TECHNICIEN D'USINAGE;5;5;4;1;0;0;0;4;0;1;3;0;0;1
17855.0;2023;04;BORDEAUX;FEMININ;APPRENTISSAGE;BAC PROFESSIONNEL;BAC PRO PROD;BAC PRO AG 21114 CONDUITE PRODUCTIONS HORTICOLES;6;5;5;0;0;0;0;5;0;0;1;1;3;0
17862.0;2023;04;BORDEAUX;FEMININ;APPRENTISSAGE;BAC PROFESSIONNEL;BAC PRO SERV;BAC PRO 31209 POISSONIER ECAILLER TRAITEUR;1;1;0;1;0;0;0;0;0;0;0;0;0;1
17878.0;2023;04;BORDEAUX;FEMININ;ENSEIGNEMENT A DISTANCE;BAC PROFESSIONNEL;BAC PRO SERV;BAC PRO 31213 MET.COM.VEN.OP.A ANI.GES.ESP.COM.;6;6;3;3;0;0;0;3;0;0;0;1;2;3
17879.0;2023;04;BORDEAUX;FEMININ;ENSEIGNEMENT A DISTANCE;BAC PROFESSIONNEL;BAC PRO SERV;BAC PRO 31214 MET.COM.VEN.OP.B PR.CL.VA.OF.COM.;3;2;0;1;1;1;0;1;0;0;0;0;1;1
17886.0;2023;04;BORDEAUX;FEMININ;ENSEIGNEMENT A DISTANCE;BAC TECHNOLOGIQUE;BAC STMG;BAC STMG MERCATIQUE (MARKETING);4;4;0;1;3;1;2;1;0;0;0;0;1;3
17889.0;2023;04;BORDEAUX;FEMININ;FORMATION CONTINUE;BAC PROFESSIONNEL;BAC PRO PROD;BAC PRO 23303 MENUISERIE ALUMINIUM-VERRE;1;1;1;0;0;0;0;1;0;0;1;0;0;0
17895.0;2023;04;BORDEAUX;FEMININ;FORMATION CONTINUE;BAC PROFESSIONNEL;BAC PRO SERV;BAC PRO 33104 TECHNICIEN EN PROTHESE DENTAIRE;1;1;1;0;0;0;0;1;0;0;0;1;0;0
17896.0;2023;04;BORDEAUX;FEMININ;INDIVIDUEL;BAC GENERAL;BAC GENERAL;BAC GENE 10019 BAC GENERAL;124;123;62;44;17;10;7;72;0;6;11;15;40;51
17903.0;2023;04;BORDEAUX;FEMININ;INDIVIDUEL;BAC PROFESSIONNEL;BAC PRO SERV;BAC PRO 30004 ASSISTANC.GEST.ORGANIS.ACTIVITES;14;8;2;6;0;0;0;2;0;0;0;0;2;6
17905.0;2023;04;BORDEAUX;FEMININ;INDIVIDUEL;BAC PROFESSIONNEL;BAC PRO SERV;BAC PRO 31213 MET.COM.VEN.OP.A ANI.GES.ESP.COM.;3;2;2;0;0;0;0;2;0;0;0;0;2;0
17906.0;2023;04;BORDEAUX;FEMININ;INDIVIDUEL;BAC PROFESSIONNEL;BAC PRO SERV;BAC PRO 32304 PHOTOGRAPHIE;1;0;0;0;0;0;0;0;0;0;0;0;0;0
17915.0;2023;04;BORDEAUX;FEMININ;INDIVIDUEL;BAC TECHNOLOGIQUE;BAC STMG;BAC STMG GESTION ET FINANCE;2;2;1;1;0;0;0;1;0;0;0;0;1;1
17920.0;2023;04;BORDEAUX;FEMININ;SCOLAIRE;BAC PROFESSIONNEL;BAC PRO PROD;BAC PRO 20102 PILOTE DE LIGNE DE PRODUCTION;1;1;1;0;0;0;0;1;0;0;0;0;1;0
17926.0;2023;04;BORDEAUX;FEMININ;SCOLAIRE;BAC PROFESSIONNEL;BAC PRO PROD;BAC PRO 22403 ARTS.& MET.ART:MET.ENSEIGN SIGNA;2;2;2;0;0;0;0;2;0;0;1;1;0;0
17930.0;2023;04;BORDEAUX;FEMININ;SCOLAIRE;BAC PROFESSIONNEL;BAC PRO PROD;BAC PRO 23005 TECHN. ETUDES BAT B ASSIST.ARCHI.;10;10;10;0;0;0;0;10;0;1;3;4;2;0
17934.0;2023;04;BORDEAUX;FEMININ;SCOLAIRE;BAC PROFESSIONNEL;BAC PRO PROD;BAC PRO 23405 TECHNICIEN MENUISIER AGENCEUR;12;12;10;2;0;0;0;10;0;0;3;4;3;2
17935.0;2023;04;BORDEAUX;FEMININ;SCOLAIRE;BAC PROFESSIONNEL;BAC PRO PROD;BAC PRO 23408 Etude et réalisation d'agencement;21;21;20;1;0;0;0;20;0;1;7;9;3;1
17937.0;2023;04;BORDEAUX;FEMININ;SCOLAIRE;BAC PROFESSIONNEL;BAC PRO PROD;BAC PRO 24203 METIERS DE LA MODE - VÊTEMENT;112;112;100;11;1;0;1;100;0;7;32;31;30;12
17938.0;2023;04;BORDEAUX;FEMININ;SCOLAIRE;BAC PROFESSIONNEL;BAC PRO PROD;BAC PRO 25007 MAINTENANCE EQUIPEMENTS INDUST.;3;3;3;0;0;0;0;3;0;0;0;3;0;0
17945.0;2023;04;BORDEAUX;FEMININ;SCOLAIRE;BAC PROFESSIONNEL;BAC PRO PROD;BAC PRO 25219 MAINT.MATERIELS OPT.A AGRICOLES;1;1;1;0;0;0;0;1;0;1;0;0;0;0
17949.0;2023;04;BORDEAUX;FEMININ;SCOLAIRE;BAC PROFESSIONNEL;BAC PRO PROD;BAC PRO 25408 REPARATION DES CARROSSERIES;1;1;0;1;0;0;0;0;0;0;0;0;0;1
17950.0;2023;04;BORDEAUX;FEMININ;SCOLAIRE;BAC PROFESSIONNEL;BAC PRO PROD;BAC PRO 25411 TECH.CHAUDRONNERIE INDUSTRIELLE;2;2;1;1;0;0;0;1;0;0;1;0;0;1
17961.0;2023;04;BORDEAUX;FEMININ;SCOLAIRE;BAC PROFESSIONNEL;BAC PRO PROD;BAC PRO AG 21211 COND GEST ENTR HIPPIQUE;60;57;50;7;0;0;0;50;0;1;8;12;29;7
17963.0;2023;04;BORDEAUX;FEMININ;SCOLAIRE;BAC PROFESSIONNEL;BAC PRO PROD;BAC PRO AG 21405 AMENAGEMENTS PAYSAGERS;8;8;6;2;0;0;0;6;0;0;2;1;3;2
17965.0;2023;04;BORDEAUX;FEMININ;SCOLAIRE;BAC PROFESSIONNEL;BAC PRO PROD;BAC PRO AG 22105 LABORATOIRE CONTROLE QUALITE;13;13;13;0;0;0;0;13;0;0;2;3;8;0
17981.0;2023;04;BORDEAUX;FEMININ;SCOLAIRE;BAC PROFESSIONNEL;BAC PRO SERV;BAC PRO 33101 OPTIQUE LUNETTERIE;13;13;10;3;0;0;0;10;0;0;0;6;4;3
17998.0;2023;04;BORDEAUX;FEMININ;SCOLAIRE;BAC TECHNOLOGIQUE;BAC STI2D;BAC STI2D SYSTÈME D'INFORMATION  ET NUMERIQUE;13;13;12;0;1;1;0;13;0;1;1;6;5;0
18000.0;2023;04;BORDEAUX;FEMININ;SCOLAIRE;BAC TECHNOLOGIQUE;BAC STL;BAC STL SCIENCES PHYSIQUES CHIMIQUES  EN LABORAT.;76;76;65;1;10;4;6;69;0;4;17;19;29;7
18004.0;2023;04;BORDEAUX;FEMININ;SCOLAIRE;BAC TECHNOLOGIQUE;BAC STMG;BAC STMG SYSTEMES D'INFORMATION DE GESTION;15;15;12;0;3;2;1;14;0;0;2;3;9;1
18007.0;2023;04;BORDEAUX;MASCULIN;APPRENTISSAGE;BAC PROFESSIONNEL;BAC PRO PROD;BAC PRO 22105 BOULANGER-PÂTISSIER;3;3;3;0;0;0;0;3;0;0;2;0;1;0
18013.0;2023;04;BORDEAUX;MASCULIN;APPRENTISSAGE;BAC PROFESSIONNEL;BAC PRO PROD;BAC PRO 23203 TECHNICIEN BAT. : ORG.REAL.GROS O;5;5;3;2;0;0;0;3;0;0;0;2;1;2
18014.0;2023;04;BORDEAUX;MASCULIN;APPRENTISSAGE;BAC PROFESSIONNEL;BAC PRO PROD;BAC PRO 23205 INTERV. SUR PATRIMOINE BATI OPT.A;4;4;2;2;0;0;0;2;0;0;0;1;1;2
18022.0;2023;04;BORDEAUX;MASCULIN;APPRENTISSAGE;BAC PROFESSIONNEL;BAC PRO PROD;BAC PRO 25009 MAINTENANCE NAUTIQUE;8;8;7;0;1;1;0;8;0;0;2;2;4;0
18025.0;2023;04;BORDEAUX;MASCULIN;APPRENTISSAGE;BAC PROFESSIONNEL;BAC PRO PROD;BAC PRO 25215 MAINT.VEHIC.OPTB VEHIC.TRANS.ROUT;21;21;15;4;2;1;1;16;0;2;1;8;5;5
18029.0;2023;04;BORDEAUX;MASCULIN;APPRENTISSAGE;BAC PROFESSIONNEL;BAC PRO PROD;BAC PRO 25302 AERONAUTIQUE OPTION AVIONIQUE;7;7;7;0;0;0;0;7;0;4;1;2;0;0
18034.0;2023;04;BORDEAUX;MASCULIN;APPRENTISSAGE;BAC PROFESSIONNEL;BAC PRO PROD;BAC PRO 25509 TECHNIC. FROID CONDITIONNEMT AIR;21;21;16;5;0;0;0;16;0;2;2;5;7;5
18041.0;2023;04;BORDEAUX;MASCULIN;APPRENTISSAGE;BAC PROFESSIONNEL;BAC PRO PROD;BAC PRO AG 21113 CGEVV;24;23;17;6;0;0;0;17;0;1;3;3;10;6
18051.0;2023;04;BORDEAUX;MASCULIN;APPRENTISSAGE;BAC PROFESSIONNEL;BAC PRO SERV;BAC PRO 31212 METIERS DE L'ACCUEIL;1;1;1;0;0;0;0;1;0;0;0;1;0;0
18056.0;2023;04;BORDEAUX;MASCULIN;APPRENTISSAGE;BAC PROFESSIONNEL;BAC PRO SERV;BAC PRO 33006 ANIMAT. ENFANCE& PERSONNES AGEES;2;2;2;0;0;0;0;2;0;0;0;0;2;0
18060.0;2023;04;BORDEAUX;MASCULIN;APPRENTISSAGE;BAC PROFESSIONNEL;BAC PRO SERV;BAC PRO 34303 GEST. POLLUTIONS PROTEC. ENVIRON.;2;2;2;0;0;0;0;2;0;0;0;2;0;0
18065.0;2023;04;BORDEAUX;MASCULIN;ENSEIGNEMENT A DISTANCE;BAC PROFESSIONNEL;BAC PRO SERV;BAC PRO 30004 ASSISTANC.GEST.ORGANIS.ACTIVITES;1;1;0;1;0;0;0;0;0;0;0;0;0;1
18066.0;2023;04;BORDEAUX;MASCULIN;ENSEIGNEMENT A DISTANCE;BAC PROFESSIONNEL;BAC PRO SERV;BAC PRO 31213 MET.COM.VEN.OP.A ANI.GES.ESP.COM.;2;2;0;2;0;0;0;0;0;0;0;0;0;2
18077.0;2023;04;BORDEAUX;MASCULIN;FORMATION CONTINUE;BAC PROFESSIONNEL;BAC PRO PROD;BAC PRO AG 21405 AMENAGEMENTS PAYSAGERS;7;7;7;0;0;0;0;7;0;1;1;0;5;0
18078.0;2023;04;BORDEAUX;MASCULIN;FORMATION CONTINUE;BAC PROFESSIONNEL;BAC PRO SERV;BAC PRO 31213 MET.COM.VEN.OP.A ANI.GES.ESP.COM.;7;7;4;3;0;0;0;4;0;0;0;3;1;3
18084.0;2023;04;BORDEAUX;MASCULIN;INDIVIDUEL;BAC PROFESSIONNEL;BAC PRO PROD;BAC PRO 25007 MAINTENANCE EQUIPEMENTS INDUST.;1;0;0;0;0;0;0;0;0;0;0;0;0;0
18086.0;2023;04;BORDEAUX;MASCULIN;INDIVIDUEL;BAC PROFESSIONNEL;BAC PRO PROD;BAC PRO 25510 METIERS ELECT. ENVIRON. CONNECTES;1;1;1;0;0;0;0;1;0;0;0;0;1;0
18087.0;2023;04;BORDEAUX;MASCULIN;INDIVIDUEL;BAC PROFESSIONNEL;BAC PRO PROD;BAC PRO AG 21001 AGRO-EQUIPEMENT;1;0;0;0;0;0;0;0;0;0;0;0;0;0
18092.0;2023;04;BORDEAUX;MASCULIN;INDIVIDUEL;BAC PROFESSIONNEL;BAC PRO SERV;BAC PRO 30004 ASSISTANC.GEST.ORGANIS.ACTIVITES;5;3;1;2;0;0;0;1;0;0;0;0;1;2
18100.0;2023;04;BORDEAUX;MASCULIN;INDIVIDUEL;BAC TECHNOLOGIQUE;BAC STI2D;BAC STI2D INNOVATION TECHNO.  ET ECO CONCEPTION;2;2;0;1;1;1;0;1;0;0;0;0;1;1
18106.0;2023;04;BORDEAUX;MASCULIN;INDIVIDUEL;BAC TECHNOLOGIQUE;BAC STMG;BAC STMG SYSTEMES D'INFORMATION DE GESTION;2;2;0;2;0;0;0;0;0;0;0;0;0;2
18108.0;2023;04;BORDEAUX;MASCULIN;SCOLAIRE;BAC PROFESSIONNEL;BAC PRO PROD;BACPRO 20002 ETUD.DEFINITION PRDTS INDUSTRIEL;30;30;21;8;1;1;0;22;0;0;4;9;9;8
18111.0;2023;04;BORDEAUX;MASCULIN;SCOLAIRE;BAC PROFESSIONNEL;BAC PRO PROD;BAC PRO 22004 PROC. CHIMIE EAU PAPIERS-CARTONS;27;27;20;6;1;1;0;21;0;2;3;9;7;6
18118.0;2023;04;BORDEAUX;MASCULIN;SCOLAIRE;BAC PROFESSIONNEL;BAC PRO PROD;BAC PRO 22704 TECHN. MAINT. SYST.ENERG.CLIMATI;17;17;10;5;2;2;0;12;0;1;3;2;6;5
18126.0;2023;04;BORDEAUX;MASCULIN;SCOLAIRE;BAC PROFESSIONNEL;BAC PRO PROD;BAC PRO 23303 MENUISERIE ALUMINIUM-VERRE;3;3;2;1;0;0;0;2;0;0;0;1;1;1
18136.0;2023;04;BORDEAUX;MASCULIN;SCOLAIRE;BAC PROFESSIONNEL;BAC PRO PROD;BAC PRO 25106 TECHNICIEN D'USINAGE;98;98;80;15;3;2;1;82;0;7;14;32;29;16
18141.0;2023;04;BORDEAUX;MASCULIN;SCOLAIRE;BAC PROFESSIONNEL;BAC PRO PROD;BAC PRO 25219 MAINT.MATERIELS OPT.A AGRICOLES;41;41;35;5;1;1;0;36;0;0;9;10;17;5
18142.0;2023;04;BORDEAUX;MASCULIN;SCOLAIRE;BAC PROFESSIONNEL;BAC PRO PROD;BAC PRO 25220 MAINT.MATERIELS OPT.B TP MANUT.;24;24;20;2;2;2;0;22;0;2;5;7;8;2
18145.0;2023;04;BORDEAUX;MASCULIN;SCOLAIRE;BAC PROFESSIONNEL;BAC PRO PROD;BAC PRO 25303 AERONAUTIQUE OPTION SYSTEMES;50;50;48;1;1;1;0;49;0;6;21;17;5;1
18147.0;2023;04;BORDEAUX;MASCULIN;SCOLAIRE;BAC PROFESSIONNEL;BAC PRO PROD;BAC PRO 25406 OUVRAGES DU BATIMENT METALLERIE;7;7;4;2;1;1;0;5;0;0;0;2;3;2
18159.0;2023;04;BORDEAUX;MASCULIN;SCOLAIRE;BAC PROFESSIONNEL;BAC PRO PROD;BAC PRO AG 21203 TECHN CONSEIL DE VENTE ANIMAL;14;14;11;3;0;0;0;11;0;0;3;3;5;3
18160.0;2023;04;BORDEAUX;MASCULIN;SCOLAIRE;BAC PROFESSIONNEL;BAC PRO PROD;BAC PRO AG 21204 PROD-AQUACOLES;18;18;15;3;0;0;0;15;0;0;0;6;9;3
18161.0;2023;04;BORDEAUX;MASCULIN;SCOLAIRE;BAC PROFESSIONNEL;BAC PRO PROD;BAC PRO AG 21210 COND GEST ENTR CANIN ET FELIN;7;7;7;0;0;0;0;7;0;0;0;1;6;0
18168.0;2023;04;BORDEAUX;MASCULIN;SCOLAIRE;BAC PROFESSIONNEL;BAC PRO PROD;BAC PRO AG 22108 TEC CONS VTE ALIMENTATION (PAB);18;17;16;1;0;0;0;16;0;0;3;5;8;1
18172.0;2023;04;BORDEAUX;MASCULIN;SCOLAIRE;BAC PROFESSIONNEL;BAC PRO SERV;BAC PRO 31114 ORGANIS. TRANSPORT MARCHANDISES;56;56;38;18;0;0;0;38;0;2;6;13;17;18
18176.0;2023;04;BORDEAUX;MASCULIN;SCOLAIRE;BAC PROFESSIONNEL;BAC PRO SERV;BAC PRO 32207 REAL.PR.IMPR.PLURI.OPTA.PR.GRAPH.;34;34;26;5;3;2;1;28;0;1;5;10;12;6
18177.0;2023;04;BORDEAUX;MASCULIN;SCOLAIRE;BAC PROFESSIONNEL;BAC PRO SERV;BAC PRO 32208 REAL.PR.IMPR.PLURI.OPTB.PR.IMPR.;14;14;12;2;0;0;0;12;0;1;1;7;3;2
18183.0;2023;04;BORDEAUX;MASCULIN;SCOLAIRE;BAC PROFESSIONNEL;BAC PRO SERV;BAC PRO 33101 OPTIQUE LUNETTERIE;10;10;9;1;0;0;0;9;0;0;0;5;4;1
18205.0;2023;04;BORDEAUX;MASCULIN;SCOLAIRE;BAC TECHNOLOGIQUE;BAC STMG;BAC STMG MERCATIQUE (MARKETING);817;817;573;60;184;136;48;709;0;4;43;183;479;108
18211.0;2023;06;CLERMONT-FERRAND;FEMININ;APPRENTISSAGE;BAC PROFESSIONNEL;BAC PRO PROD;BAC PRO 24302 METIERS DU CUIR : MAROQUINERIE;3;3;3;0;0;0;0;3;0;1;1;1;0;0
18215.0;2023;06;CLERMONT-FERRAND;FEMININ;APPRENTISSAGE;BAC PROFESSIONNEL;BAC PRO PROD;BAC PRO 25510 METIERS ELECT. ENVIRON. CONNECTES;1;1;1;0;0;0;0;1;0;0;1;0;0;0
18222.0;2023;06;CLERMONT-FERRAND;FEMININ;APPRENTISSAGE;BAC PROFESSIONNEL;BAC PRO SERV;BAC PRO 30004 ASSISTANC.GEST.ORGANIS.ACTIVITES;7;7;7;0;0;0;0;7;0;2;2;3;0;0
18225.0;2023;06;CLERMONT-FERRAND;FEMININ;APPRENTISSAGE;BAC PROFESSIONNEL;BAC PRO SERV;BAC PRO 31213 MET.COM.VEN.OP.A ANI.GES.ESP.COM.;45;44;35;5;4;4;0;39;0;3;8;13;15;5
18243.0;2023;06;CLERMONT-FERRAND;FEMININ;FORMATION CONTINUE;BAC PROFESSIONNEL;BAC PRO SERV;BAC PRO 32304 PHOTOGRAPHIE;1;1;0;1;0;0;0;0;0;0;0;0;0;1
18247.0;2023;06;CLERMONT-FERRAND;FEMININ;INDIVIDUEL;BAC PROFESSIONNEL;BAC PRO PROD;BAC PRO 22106 CUISINE;1;1;0;1;0;0;0;0;0;0;0;0;0;1
18253.0;2023;06;CLERMONT-FERRAND;FEMININ;INDIVIDUEL;BAC PROFESSIONNEL;BAC PRO SERV;BAC PRO 31214 MET.COM.VEN.OP.B PR.CL.VA.OF.COM.;1;1;0;1;0;0;0;0;0;0;0;0;0;1
18254.0;2023;06;CLERMONT-FERRAND;FEMININ;INDIVIDUEL;BAC PROFESSIONNEL;BAC PRO SERV;BAC PRO 33002 SERVICES DE PROXIMITE  VIE LOCAL;2;2;2;0;0;0;0;2;0;0;0;0;2;0
18258.0;2023;06;CLERMONT-FERRAND;FEMININ;INDIVIDUEL;BAC TECHNOLOGIQUE;BAC STMG;BAC STMG MERCATIQUE (MARKETING);7;6;1;4;1;0;1;1;0;0;1;0;0;5
18264.0;2023;06;CLERMONT-FERRAND;FEMININ;SCOLAIRE;BAC PROFESSIONNEL;BAC PRO PROD;BAC PRO 22403 ARTS.& MET.ART:MET.ENSEIGN SIGNA;3;3;3;0;0;0;0;3;0;0;2;0;1;0
18267.0;2023;06;CLERMONT-FERRAND;FEMININ;SCOLAIRE;BAC PROFESSIONNEL;BAC PRO PROD;BAC PRO 23005 TECHN. ETUDES BAT B ASSIST.ARCHI.;8;8;5;3;0;0;0;5;0;1;0;3;1;3
18273.0;2023;06;CLERMONT-FERRAND;FEMININ;SCOLAIRE;BAC PROFESSIONNEL;BAC PRO PROD;BAC PRO 24302 METIERS DU CUIR : MAROQUINERIE;16;16;11;3;2;1;1;12;0;0;3;5;4;4
18282.0;2023;06;CLERMONT-FERRAND;FEMININ;SCOLAIRE;BAC PROFESSIONNEL;BAC PRO PROD;BAC PRO 25515 SYST.NUM.OPT.C RES.INF.SYST.COMM.;1;1;0;1;0;0;0;0;0;0;0;0;0;1
18289.0;2023;06;CLERMONT-FERRAND;FEMININ;SCOLAIRE;BAC PROFESSIONNEL;BAC PRO PROD;BAC PRO AG 21211 COND GEST ENTR HIPPIQUE;28;28;26;2;0;0;0;26;0;0;3;12;11;2
18290.0;2023;06;CLERMONT-FERRAND;FEMININ;SCOLAIRE;BAC PROFESSIONNEL;BAC PRO PROD;BAC PRO AG 21302 GEST MILIEUX NATURELS FAUNE;9;9;9;0;0;0;0;9;0;1;0;6;2;0
18306.0;2023;06;CLERMONT-FERRAND;FEMININ;SCOLAIRE;BAC PROFESSIONNEL;BAC PRO SERV;BAC PRO 32304 PHOTOGRAPHIE;11;11;11;0;0;0;0;11;0;1;5;4;1;0
18308.0;2023;06;CLERMONT-FERRAND;FEMININ;SCOLAIRE;BAC PROFESSIONNEL;BAC PRO SERV;BAC PRO 33004 ACC.SOINS-S.PERS. OPT.EN STRUCTUR;231;231;186;34;11;5;6;191;0;2;31;72;86;40
18309.0;2023;06;CLERMONT-FERRAND;FEMININ;SCOLAIRE;BAC PROFESSIONNEL;BAC PRO SERV;BAC PRO 33006 ANIMAT. ENFANCE& PERSONNES AGEES;20;20;17;3;0;0;0;17;0;2;2;9;4;3
18311.0;2023;06;CLERMONT-FERRAND;FEMININ;SCOLAIRE;BAC PROFESSIONNEL;BAC PRO SERV;BAC PRO 33104 TECHNICIEN EN PROTHESE DENTAIRE;10;10;9;1;0;0;0;9;0;0;1;1;7;1
18313.0;2023;06;CLERMONT-FERRAND;FEMININ;SCOLAIRE;BAC PROFESSIONNEL;BAC PRO SERV;BAC PRO 33603 ESTHETIQUE COSMETIQUE PARFUMERIE;71;70;64;3;3;3;0;67;0;5;10;22;30;3
18318.0;2023;06;CLERMONT-FERRAND;FEMININ;SCOLAIRE;BAC TECHNOLOGIQUE;BAC ST2S;BAC ST2S SCIENCES & TECHNO. SANTE & SOCIAL;375;375;317;4;54;38;16;355;0;4;37;140;174;20
18327.0;2023;06;CLERMONT-FERRAND;FEMININ;SCOLAIRE;BAC TECHNOLOGIQUE;BAC STL;BAC STL SCIENCES PHYSIQUES CHIMIQUES  EN LABORAT.;19;19;18;1;0;0;0;18;1;1;2;8;6;1
18339.0;2023;06;CLERMONT-FERRAND;MASCULIN;APPRENTISSAGE;BAC PROFESSIONNEL;BAC PRO PROD;BAC PRO 23203 TECHNICIEN BAT. : ORG.REAL.GROS O;15;15;14;0;1;1;0;15;0;5;1;4;5;0
18343.0;2023;06;CLERMONT-FERRAND;MASCULIN;APPRENTISSAGE;BAC PROFESSIONNEL;BAC PRO PROD;BAC PRO 25007 MAINTENANCE EQUIPEMENTS INDUST.;52;52;39;11;2;2;0;41;0;2;11;14;14;11
18345.0;2023;06;CLERMONT-FERRAND;MASCULIN;APPRENTISSAGE;BAC PROFESSIONNEL;BAC PRO PROD;BAC PRO 25214 MAINT.VEHIC.OPTA VOIT.PARTICUL.;71;70;55;8;7;2;5;57;0;6;11;22;18;13
18359.0;2023;06;CLERMONT-FERRAND;MASCULIN;APPRENTISSAGE;BAC PROFESSIONNEL;BAC PRO PROD;BAC PRO 25514 SYST.NUM.OPT.B AUD.RES.EQUIP.DOM.;1;1;1;0;0;0;0;1;0;0;1;0;0;0
18361.0;2023;06;CLERMONT-FERRAND;MASCULIN;APPRENTISSAGE;BAC PROFESSIONNEL;BAC PRO PROD;BAC PRO AG 21001 AGRO-EQUIPEMENT;14;14;11;3;0;0;0;11;0;0;0;5;6;3
18365.0;2023;06;CLERMONT-FERRAND;MASCULIN;APPRENTISSAGE;BAC PROFESSIONNEL;BAC PRO PROD;BAC PRO AG 21303 FORET;6;6;6;0;0;0;0;6;0;0;0;0;6;0
18371.0;2023;06;CLERMONT-FERRAND;MASCULIN;APPRENTISSAGE;BAC PROFESSIONNEL;BAC PRO SERV;BAC PRO 31213 MET.COM.VEN.OP.A ANI.GES.ESP.COM.;40;40;28;7;5;4;1;32;0;1;3;13;15;8
18372.0;2023;06;CLERMONT-FERRAND;MASCULIN;APPRENTISSAGE;BAC PROFESSIONNEL;BAC PRO SERV;BAC PRO 31214 MET.COM.VEN.OP.B PR.CL.VA.OF.COM.;1;1;1;0;0;0;0;1;0;0;0;1;0;0
18373.0;2023;06;CLERMONT-FERRAND;MASCULIN;APPRENTISSAGE;BAC PROFESSIONNEL;BAC PRO SERV;BAC PRO 33403 COMMERC. SERVICES EN RESTAURATION;2;1;1;0;0;0;0;1;0;0;0;0;1;0
18382.0;2023;06;CLERMONT-FERRAND;MASCULIN;FORMATION CONTINUE;BAC PROFESSIONNEL;BAC PRO PROD;BAC PRO AG 21113 CGEVV;28;24;22;2;0;0;0;22;0;0;0;0;22;2
18385.0;2023;06;CLERMONT-FERRAND;MASCULIN;INDIVIDUEL;BAC GENERAL;BAC GENERAL;BAC GENE 10019 BAC GENERAL;31;29;6;19;4;2;2;8;0;0;1;0;7;21
18395.0;2023;06;CLERMONT-FERRAND;MASCULIN;INDIVIDUEL;BAC PROFESSIONNEL;BAC PRO SERV;BAC PRO 30004 ASSISTANC.GEST.ORGANIS.ACTIVITES;1;1;0;1;0;0;0;0;0;0;0;0;0;1
18397.0;2023;06;CLERMONT-FERRAND;MASCULIN;INDIVIDUEL;BAC PROFESSIONNEL;BAC PRO SERV;BAC PRO 31213 MET.COM.VEN.OP.A ANI.GES.ESP.COM.;1;1;1;0;0;0;0;1;0;0;0;0;1;0
18398.0;2023;06;CLERMONT-FERRAND;MASCULIN;INDIVIDUEL;BAC PROFESSIONNEL;BAC PRO SERV;BAC PRO 31214 MET.COM.VEN.OP.B PR.CL.VA.OF.COM.;1;0;0;0;0;0;0;0;0;0;0;0;0;0
18414.0;2023;06;CLERMONT-FERRAND;MASCULIN;SCOLAIRE;BAC PROFESSIONNEL;BAC PRO PROD;BAC PRO 22503 PLASTIQUES ET COMPOSITES;4;4;4;0;0;0;0;4;0;0;0;2;2;0
18418.0;2023;06;CLERMONT-FERRAND;MASCULIN;SCOLAIRE;BAC PROFESSIONNEL;BAC PRO PROD;BAC PRO 23004 TECHN. ETUDES BAT.A ETUDES & ECO.;10;10;9;1;0;0;0;9;0;0;2;3;4;1
18431.0;2023;06;CLERMONT-FERRAND;MASCULIN;SCOLAIRE;BAC PROFESSIONNEL;BAC PRO PROD;BAC PRO 25215 MAINT.VEHIC.OPTB VEHIC.TRANS.ROUT;10;10;5;5;0;0;0;5;0;0;2;2;1;5
18436.0;2023;06;CLERMONT-FERRAND;MASCULIN;SCOLAIRE;BAC PROFESSIONNEL;BAC PRO PROD;BAC PRO 25303 AERONAUTIQUE OPTION SYSTEMES;10;10;9;0;1;1;0;10;0;0;3;3;4;0
18441.0;2023;06;CLERMONT-FERRAND;MASCULIN;SCOLAIRE;BAC PROFESSIONNEL;BAC PRO PROD;BAC PRO 25509 TECHNIC. FROID CONDITIONNEMT AIR;14;14;12;2;0;0;0;12;0;0;5;2;5;2
18444.0;2023;06;CLERMONT-FERRAND;MASCULIN;SCOLAIRE;BAC PROFESSIONNEL;BAC PRO PROD;BAC PRO 25514 SYST.NUM.OPT.B AUD.RES.EQUIP.DOM.;18;18;15;2;1;1;0;16;0;0;5;5;6;2
18456.0;2023;06;CLERMONT-FERRAND;MASCULIN;SCOLAIRE;BAC PROFESSIONNEL;BAC PRO PROD;BAC PRO AG 22105 LABORATOIRE CONTROLE QUALITE;1;1;1;0;0;0;0;1;0;0;0;1;0;0
18457.0;2023;06;CLERMONT-FERRAND;MASCULIN;SCOLAIRE;BAC PROFESSIONNEL;BAC PRO SERV;BAC PRO 30004 ASSISTANC.GEST.ORGANIS.ACTIVITES;96;96;71;20;5;4;1;75;0;2;10;28;35;21
18460.0;2023;06;CLERMONT-FERRAND;MASCULIN;SCOLAIRE;BAC PROFESSIONNEL;BAC PRO SERV;BAC PRO 31114 ORGANIS. TRANSPORT MARCHANDISES;17;17;13;3;1;1;0;14;0;0;1;5;8;3
18463.0;2023;06;CLERMONT-FERRAND;MASCULIN;SCOLAIRE;BAC PROFESSIONNEL;BAC PRO SERV;BAC PRO 31214 MET.COM.VEN.OP.B PR.CL.VA.OF.COM.;80;80;60;15;5;4;1;64;0;1;15;27;21;16
18466.0;2023;06;CLERMONT-FERRAND;MASCULIN;SCOLAIRE;BAC PROFESSIONNEL;BAC PRO SERV;BAC PRO 32303 ART.& MET.ART:COM.VIS.VIS.PLURI-M;28;28;25;3;0;0;0;25;0;1;4;14;6;3
18470.0;2023;06;CLERMONT-FERRAND;MASCULIN;SCOLAIRE;BAC PROFESSIONNEL;BAC PRO SERV;BAC PRO 33006 ANIMAT. ENFANCE& PERSONNES AGEES;13;13;12;0;1;1;0;13;0;0;3;6;4;0
18481.0;2023;06;CLERMONT-FERRAND;MASCULIN;SCOLAIRE;BAC TECHNOLOGIQUE;BAC STHR;BAC STHR SC.&TEC. HOTELLERIE-RESTAURATION;27;27;21;0;6;6;0;27;0;0;4;7;16;0
18484.0;2023;06;CLERMONT-FERRAND;MASCULIN;SCOLAIRE;BAC TECHNOLOGIQUE;BAC STI2D;BAC STI2D INNOVATION TECHNO.  ET ECO CONCEPTION;128;128;118;0;10;4;6;122;0;5;21;45;51;6
18503.0;2023;27;CORSE;FEMININ;INDIVIDUEL;BAC PROFESSIONNEL;BAC PRO PROD;BAC PRO AG 21004 CGEA;4;3;3;0;0;0;0;3;0;0;0;0;3;0
18508.0;2023;27;CORSE;FEMININ;SCOLAIRE;BAC GENERAL;BAC GENERAL;BAC GENE 10019 BAC GENERAL;879;879;825;6;48;42;6;867;33;135;226;254;219;12
18509.0;2023;27;CORSE;FEMININ;SCOLAIRE;BAC PROFESSIONNEL;BAC PRO PROD;BAC PRO 22106 CUISINE;11;11;10;1;0;0;0;10;0;1;5;3;1;1
18510.0;2023;27;CORSE;FEMININ;SCOLAIRE;BAC PROFESSIONNEL;BAC PRO PROD;BAC PRO 23004 TECHN. ETUDES BAT.A ETUDES & ECO.;3;3;2;1;0;0;0;2;0;0;1;0;1;1
18512.0;2023;27;CORSE;FEMININ;SCOLAIRE;BAC PROFESSIONNEL;BAC PRO PROD;BAC PRO 24203 METIERS DE LA MODE - VÊTEMENT;10;10;9;1;0;0;0;9;0;1;4;2;2;1
18523.0;2023;27;CORSE;FEMININ;SCOLAIRE;BAC PROFESSIONNEL;BAC PRO SERV;BAC PRO 31212 METIERS DE L'ACCUEIL;8;8;6;1;1;0;1;6;0;0;1;2;3;2
18530.0;2023;27;CORSE;FEMININ;SCOLAIRE;BAC PROFESSIONNEL;BAC PRO SERV;BAC PRO 34403 METIERS DE LA SECURITE;3;3;3;0;0;0;0;3;0;1;1;1;0;0
18531.0;2023;27;CORSE;FEMININ;SCOLAIRE;BAC PROFESSIONNEL;BAC PRO SERV;BAC PRO AG 33002 SERV PERS TERRIT;9;9;6;3;0;0;0;6;0;0;0;2;4;3
18539.0;2023;27;CORSE;FEMININ;SCOLAIRE;BAC TECHNOLOGIQUE;BAC STMG;BAC STMG MERCATIQUE (MARKETING);68;68;59;1;8;7;1;66;0;0;9;21;36;2
18557.0;2023;27;CORSE;MASCULIN;ENSEIGNEMENT A DISTANCE;BAC TECHNOLOGIQUE;BAC ST2S;BAC ST2S SCIENCES & TECHNO. SANTE & SOCIAL;1;1;0;0;1;1;0;1;0;0;0;0;1;0
18558.0;2023;27;CORSE;MASCULIN;ENSEIGNEMENT A DISTANCE;BAC TECHNOLOGIQUE;BAC STMG;BAC STMG MERCATIQUE (MARKETING);1;1;1;0;0;0;0;1;0;0;0;0;1;0
18562.0;2023;27;CORSE;MASCULIN;INDIVIDUEL;BAC PROFESSIONNEL;BAC PRO PROD;BAC PRO AG 21113 CGEVV;2;2;2;0;0;0;0;2;0;0;0;0;2;0
18563.0;2023;27;CORSE;MASCULIN;INDIVIDUEL;BAC PROFESSIONNEL;BAC PRO PROD;BAC PRO AG 21114 CONDUITE PRODUCTIONS HORTICOLES;11;11;8;3;0;0;0;8;0;0;0;0;8;3
18564.0;2023;27;CORSE;MASCULIN;INDIVIDUEL;BAC PROFESSIONNEL;BAC PRO PROD;BAC PRO AG 21405 AMENAGEMENTS PAYSAGERS;1;1;1;0;0;0;0;1;0;0;0;0;1;0
18568.0;2023;27;CORSE;MASCULIN;SCOLAIRE;BAC PROFESSIONNEL;BAC PRO PROD;BAC PRO 23004 TECHN. ETUDES BAT.A ETUDES & ECO.;6;6;4;2;0;0;0;4;0;0;0;1;3;2
18577.0;2023;27;CORSE;MASCULIN;SCOLAIRE;BAC PROFESSIONNEL;BAC PRO PROD;BAC PRO 25514 SYST.NUM.OPT.B AUD.RES.EQUIP.DOM.;9;9;9;0;0;0;0;9;0;1;2;2;4;0
18582.0;2023;27;CORSE;MASCULIN;SCOLAIRE;BAC PROFESSIONNEL;BAC PRO PROD;BAC PRO AG 21303 FORET;6;6;4;2;0;0;0;4;0;0;0;0;4;2
18588.0;2023;27;CORSE;MASCULIN;SCOLAIRE;BAC PROFESSIONNEL;BAC PRO SERV;BAC PRO 31213 MET.COM.VEN.OP.A ANI.GES.ESP.COM.;22;22;19;3;0;0;0;19;0;2;5;6;6;3
18593.0;2023;27;CORSE;MASCULIN;SCOLAIRE;BAC PROFESSIONNEL;BAC PRO SERV;BAC PRO 34403 METIERS DE LA SECURITE;10;10;10;0;0;0;0;10;0;0;1;9;0;0
18608.0;2023;24;CRETEIL;FEMININ;APPRENTISSAGE;BAC PROFESSIONNEL;BAC PRO PROD;BAC PRO 23203 TECHNICIEN BAT. : ORG.REAL.GROS O;1;1;1;0;0;0;0;1;0;0;0;0;1;0
18616.0;2023;24;CRETEIL;FEMININ;APPRENTISSAGE;BAC PROFESSIONNEL;BAC PRO PROD;BAC PRO 25219 MAINT.MATERIELS OPT.A AGRICOLES;1;1;1;0;0;0;0;1;0;0;0;1;0;0
18620.0;2023;24;CRETEIL;FEMININ;APPRENTISSAGE;BAC PROFESSIONNEL;BAC PRO PROD;BAC PRO AG 21405 AMENAGEMENTS PAYSAGERS;5;5;2;3;0;0;0;2;0;0;0;0;2;3
18627.0;2023;24;CRETEIL;FEMININ;APPRENTISSAGE;BAC PROFESSIONNEL;BAC PRO SERV;BAC PRO 33403 COMMERC. SERVICES EN RESTAURATION;13;13;10;2;1;0;1;10;0;1;1;3;5;3
18632.0;2023;24;CRETEIL;FEMININ;ENSEIGNEMENT A DISTANCE;BAC PROFESSIONNEL;BAC PRO PROD;BAC PRO 24203 METIERS DE LA MODE - VÊTEMENT;1;1;0;1;0;0;0;0;0;0;0;0;0;1
18644.0;2023;24;CRETEIL;FEMININ;FORMATION CONTINUE;BAC PROFESSIONNEL;BAC PRO PROD;BAC PRO 24302 METIERS DU CUIR : MAROQUINERIE;15;15;13;2;0;0;0;13;0;1;6;5;1;2
18654.0;2023;24;CRETEIL;FEMININ;INDIVIDUEL;BAC GENERAL;BAC GENERAL;BAC GENE 10019 BAC GENERAL;274;271;94;144;33;23;10;117;0;4;25;22;66;154
18656.0;2023;24;CRETEIL;FEMININ;INDIVIDUEL;BAC PROFESSIONNEL;BAC PRO PROD;BAC PRO 23203 TECHNICIEN BAT. : ORG.REAL.GROS O;1;1;0;0;1;1;0;1;0;0;0;0;1;0
18663.0;2023;24;CRETEIL;FEMININ;INDIVIDUEL;BAC PROFESSIONNEL;BAC PRO SERV;BAC PRO 31213 MET.COM.VEN.OP.A ANI.GES.ESP.COM.;9;7;4;3;0;0;0;4;0;0;0;0;4;3
18667.0;2023;24;CRETEIL;FEMININ;INDIVIDUEL;BAC PROFESSIONNEL;BAC PRO SERV;BAC PRO 33004 ACC.SOINS-S.PERS. OPT.EN STRUCTUR;8;7;4;2;1;0;1;4;0;0;1;0;3;3
18668.0;2023;24;CRETEIL;FEMININ;INDIVIDUEL;BAC PROFESSIONNEL;BAC PRO SERV;BAC PRO 33403 COMMERC. SERVICES EN RESTAURATION;1;1;1;0;0;0;0;1;0;0;0;0;1;0
18671.0;2023;24;CRETEIL;FEMININ;INDIVIDUEL;BAC TECHNOLOGIQUE;BAC ST2S;BAC ST2S SCIENCES & TECHNO. SANTE & SOCIAL;32;32;3;25;4;2;2;5;0;0;0;0;5;27
18675.0;2023;24;CRETEIL;FEMININ;INDIVIDUEL;BAC TECHNOLOGIQUE;BAC STI2D;BAC STI2D SYSTÈME D'INFORMATION  ET NUMERIQUE;1;1;0;1;0;0;0;0;0;0;0;0;0;1
18680.0;2023;24;CRETEIL;FEMININ;INDIVIDUEL;BAC TECHNOLOGIQUE;BAC STMG;BAC STMG SYSTEMES D'INFORMATION DE GESTION;2;2;1;1;0;0;0;1;0;0;0;0;1;1
18681.0;2023;24;CRETEIL;FEMININ;SCOLAIRE;BAC GENERAL;BAC GENERAL;BAC GENE 10019 BAC GENERAL;15143;15143;13353;431;1359;964;395;14317;196;1520;3305;4485;4811;826
18688.0;2023;24;CRETEIL;FEMININ;SCOLAIRE;BAC PROFESSIONNEL;BAC PRO PROD;BAC PRO 23005 TECHN. ETUDES BAT B ASSIST.ARCHI.;21;21;21;0;0;0;0;21;0;4;3;9;5;0
18690.0;2023;24;CRETEIL;FEMININ;SCOLAIRE;BAC PROFESSIONNEL;BAC PRO PROD;BACPRO 23103 TECHNICIEN GEOMETRE-TOPOGRAPHE;1;1;1;0;0;0;0;1;0;0;0;1;0;0
18700.0;2023;24;CRETEIL;FEMININ;SCOLAIRE;BAC PROFESSIONNEL;BAC PRO PROD;BAC PRO 25007 MAINTENANCE EQUIPEMENTS INDUST.;4;4;3;1;0;0;0;3;0;1;1;1;0;1
18707.0;2023;24;CRETEIL;FEMININ;SCOLAIRE;BAC PROFESSIONNEL;BAC PRO PROD;BAC PRO 25510 METIERS ELECT. ENVIRON. CONNECTES;6;6;4;2;0;0;0;4;0;0;1;0;3;2
18712.0;2023;24;CRETEIL;FEMININ;SCOLAIRE;BAC PROFESSIONNEL;BAC PRO PROD;BAC PRO AG 21405 AMENAGEMENTS PAYSAGERS;2;2;2;0;0;0;0;2;0;0;0;2;0;0
18717.0;2023;24;CRETEIL;FEMININ;SCOLAIRE;BAC PROFESSIONNEL;BAC PRO SERV;BAC PRO 31106 LOGISTIQUE;14;14;13;0;1;0;1;13;0;1;2;3;7;1
18718.0;2023;24;CRETEIL;FEMININ;SCOLAIRE;BAC PROFESSIONNEL;BAC PRO SERV;BAC PRO 31107 CONDUCT. TRANSP.ROUT.MARCHANDISES;1;1;1;0;0;0;0;1;0;1;0;0;0;0
18725.0;2023;24;CRETEIL;FEMININ;SCOLAIRE;BAC PROFESSIONNEL;BAC PRO SERV;BAC PRO 32208 REAL.PR.IMPR.PLURI.OPTB.PR.IMPR.;6;6;6;0;0;0;0;6;0;0;2;3;1;0
18736.0;2023;24;CRETEIL;FEMININ;SCOLAIRE;BAC PROFESSIONNEL;BAC PRO SERV;BAC PRO 34304 HYGIENE PROPRETE STERILISATION;18;18;16;1;1;1;0;17;0;0;6;7;4;1
18738.0;2023;24;CRETEIL;FEMININ;SCOLAIRE;BAC PROFESSIONNEL;BAC PRO SERV;BAC PRO AG 33002 SERV PERS TERRIT;24;21;15;6;0;0;0;15;0;0;2;4;9;6
18743.0;2023;24;CRETEIL;FEMININ;SCOLAIRE;BAC TECHNOLOGIQUE;BAC STI2D;BAC STI2D ARCHITECTURE ET CONSTRUCTION;46;46;34;2;10;7;3;41;0;0;6;12;23;5
18749.0;2023;24;CRETEIL;FEMININ;SCOLAIRE;BAC TECHNOLOGIQUE;BAC STMG;BAC STMG GESTION ET FINANCE;883;883;673;60;150;122;28;795;0;14;123;243;415;88
18765.0;2023;24;CRETEIL;MASCULIN;APPRENTISSAGE;BAC PROFESSIONNEL;BAC PRO PROD;BAC PRO 25216 MAINT.VEHIC.OPTC MOTOCYCLES;45;45;37;6;2;1;1;38;0;1;9;11;17;7
18769.0;2023;24;CRETEIL;MASCULIN;APPRENTISSAGE;BAC PROFESSIONNEL;BAC PRO PROD;BAC PRO 25408 REPARATION DES CARROSSERIES;44;44;37;3;4;1;3;38;0;7;9;10;12;6
18770.0;2023;24;CRETEIL;MASCULIN;APPRENTISSAGE;BAC PROFESSIONNEL;BAC PRO PROD;BAC PRO 25410 CONSTRUCTION DES CARROSSERIES;2;2;2;0;0;0;0;2;0;0;0;1;1;0
18775.0;2023;24;CRETEIL;MASCULIN;APPRENTISSAGE;BAC PROFESSIONNEL;BAC PRO PROD;BAC PRO 25515 SYST.NUM.OPT.C RES.INF.SYST.COMM.;17;17;15;2;0;0;0;15;0;5;5;3;2;2
18779.0;2023;24;CRETEIL;MASCULIN;APPRENTISSAGE;BAC PROFESSIONNEL;BAC PRO SERV;BAC PRO 30004 ASSISTANC.GEST.ORGANIS.ACTIVITES;1;1;1;0;0;0;0;1;0;0;0;1;0;0
18784.0;2023;24;CRETEIL;MASCULIN;APPRENTISSAGE;BAC PROFESSIONNEL;BAC PRO SERV;BAC PRO 32208 REAL.PR.IMPR.PLURI.OPTB.PR.IMPR.;3;3;2;1;0;0;0;2;0;0;0;2;0;1
18785.0;2023;24;CRETEIL;MASCULIN;APPRENTISSAGE;BAC PROFESSIONNEL;BAC PRO SERV;BAC PRO 32303 ART.& MET.ART:COM.VIS.VIS.PLURI-M;8;8;7;1;0;0;0;7;0;1;0;3;3;1
18786.0;2023;24;CRETEIL;MASCULIN;APPRENTISSAGE;BAC PROFESSIONNEL;BAC PRO SERV;BAC PRO 33104 TECHNICIEN EN PROTHESE DENTAIRE;7;7;7;0;0;0;0;7;0;0;5;1;1;0
18787.0;2023;24;CRETEIL;MASCULIN;APPRENTISSAGE;BAC PROFESSIONNEL;BAC PRO SERV;BAC PRO 33403 COMMERC. SERVICES EN RESTAURATION;18;18;16;1;1;1;0;17;0;1;3;9;4;1
18793.0;2023;24;CRETEIL;MASCULIN;ENSEIGNEMENT A DISTANCE;BAC PROFESSIONNEL;BAC PRO SERV;BAC PRO 33004 ACC.SOINS-S.PERS. OPT.EN STRUCTUR;1;1;0;1;0;0;0;0;0;0;0;0;0;1
18794.0;2023;24;CRETEIL;MASCULIN;ENSEIGNEMENT A DISTANCE;BAC PROFESSIONNEL;BAC PRO SERV;BAC PRO 34403 METIERS DE LA SECURITE;1;0;0;0;0;0;0;0;0;0;0;0;0;0
18795.0;2023;24;CRETEIL;MASCULIN;ENSEIGNEMENT A DISTANCE;BAC TECHNOLOGIQUE;BAC ST2S;BAC ST2S SCIENCES & TECHNO. SANTE & SOCIAL;1;1;1;0;0;0;0;1;0;0;0;0;1;0
18799.0;2023;24;CRETEIL;MASCULIN;ENSEIGNEMENT A DISTANCE;BAC TECHNOLOGIQUE;BAC STMG;BAC STMG SYSTEMES D'INFORMATION DE GESTION;1;1;1;0;0;0;0;1;0;0;0;0;1;0
18803.0;2023;24;CRETEIL;MASCULIN;FORMATION CONTINUE;BAC PROFESSIONNEL;BAC PRO PROD;BAC PRO 25106 TECHNICIEN D'USINAGE;10;9;7;2;0;0;0;7;0;4;1;2;0;2
18804.0;2023;24;CRETEIL;MASCULIN;FORMATION CONTINUE;BAC PROFESSIONNEL;BAC PRO PROD;BAC PRO 25214 MAINT.VEHIC.OPTA VOIT.PARTICUL.;12;12;12;0;0;0;0;12;0;2;3;6;1;0
18809.0;2023;24;CRETEIL;MASCULIN;FORMATION CONTINUE;BAC PROFESSIONNEL;BAC PRO SERV;BAC PRO 31214 MET.COM.VEN.OP.B PR.CL.VA.OF.COM.;1;1;0;1;0;0;0;0;0;0;0;0;0;1
18813.0;2023;24;CRETEIL;MASCULIN;INDIVIDUEL;BAC PROFESSIONNEL;BAC PRO PROD;BAC PRO 22105 BOULANGER-PÂTISSIER;1;1;1;0;0;0;0;1;0;0;0;0;1;0
18814.0;2023;24;CRETEIL;MASCULIN;INDIVIDUEL;BAC PROFESSIONNEL;BAC PRO PROD;BAC PRO 22106 CUISINE;1;0;0;0;0;0;0;0;0;0;0;0;0;0
18820.0;2023;24;CRETEIL;MASCULIN;INDIVIDUEL;BAC PROFESSIONNEL;BAC PRO PROD;BAC PRO 25007 MAINTENANCE EQUIPEMENTS INDUST.;8;6;2;3;1;1;0;3;0;0;0;0;3;3
18827.0;2023;24;CRETEIL;MASCULIN;INDIVIDUEL;BAC PROFESSIONNEL;BAC PRO PROD;BAC PRO 25510 METIERS ELECT. ENVIRON. CONNECTES;12;10;6;4;0;0;0;6;0;0;0;2;4;4
18828.0;2023;24;CRETEIL;MASCULIN;INDIVIDUEL;BAC PROFESSIONNEL;BAC PRO PROD;BAC PRO 25513 SYST.NUM.OPT.A SURETE SECURITE;1;0;0;0;0;0;0;0;0;0;0;0;0;0
18829.0;2023;24;CRETEIL;MASCULIN;INDIVIDUEL;BAC PROFESSIONNEL;BAC PRO PROD;BAC PRO 25515 SYST.NUM.OPT.C RES.INF.SYST.COMM.;1;1;0;1;0;0;0;0;0;0;0;0;0;1
18837.0;2023;24;CRETEIL;MASCULIN;INDIVIDUEL;BAC PROFESSIONNEL;BAC PRO SERV;BAC PRO 31214 MET.COM.VEN.OP.B PR.CL.VA.OF.COM.;7;3;1;2;0;0;0;1;0;0;0;0;1;2
18840.0;2023;24;CRETEIL;MASCULIN;INDIVIDUEL;BAC PROFESSIONNEL;BAC PRO SERV;BAC PRO 34403 METIERS DE LA SECURITE;1;1;0;0;1;1;0;1;0;0;0;0;1;0
18843.0;2023;24;CRETEIL;MASCULIN;INDIVIDUEL;BAC TECHNOLOGIQUE;BAC STAV;BAC STAV AGRONOMIE ALIM ENV TERRITOI;1;1;1;0;0;0;0;1;0;0;0;0;1;0
18850.0;2023;24;CRETEIL;MASCULIN;INDIVIDUEL;BAC TECHNOLOGIQUE;BAC STL;BAC STL BIOCHIM.-BIOLOGIE-BIOTECHNOL.;1;1;0;1;0;0;0;0;0;0;0;0;0;1
18857.0;2023;24;CRETEIL;MASCULIN;SCOLAIRE;BAC PROFESSIONNEL;BAC PRO PROD;BACPRO 20002 ETUD.DEFINITION PRDTS INDUSTRIEL;41;41;31;9;1;1;0;32;0;3;7;13;9;9
18863.0;2023;24;CRETEIL;MASCULIN;SCOLAIRE;BAC PROFESSIONNEL;BAC PRO PROD;BAC PRO 23003 ARTIS. & M.ART:MARCHANDISAGE VIS.;8;8;8;0;0;0;0;8;0;0;0;4;4;0
18867.0;2023;24;CRETEIL;MASCULIN;SCOLAIRE;BAC PROFESSIONNEL;BAC PRO PROD;BACPRO 23103 TECHNICIEN GEOMETRE-TOPOGRAPHE;14;14;8;6;0;0;0;8;0;0;2;2;4;6
18873.0;2023;24;CRETEIL;MASCULIN;SCOLAIRE;BAC PROFESSIONNEL;BAC PRO PROD;BAC PRO 23407 TECHNIC.FAB.BOIS ET MATERX ASSOC;11;11;9;2;0;0;0;9;0;1;1;3;4;2
18877.0;2023;24;CRETEIL;MASCULIN;SCOLAIRE;BAC PROFESSIONNEL;BAC PRO PROD;BAC PRO 24302 METIERS DU CUIR : MAROQUINERIE;1;1;1;0;0;0;0;1;0;0;0;0;1;0
18880.0;2023;24;CRETEIL;MASCULIN;SCOLAIRE;BAC PROFESSIONNEL;BAC PRO PROD;BAC PRO 25106 TECHNICIEN D'USINAGE;123;123;84;36;3;2;1;86;0;7;15;27;37;37
18886.0;2023;24;CRETEIL;MASCULIN;SCOLAIRE;BAC PROFESSIONNEL;BAC PRO PROD;BAC PRO 25220 MAINT.MATERIELS OPT.B TP MANUT.;17;17;7;8;2;0;2;7;0;0;2;3;2;10
18890.0;2023;24;CRETEIL;MASCULIN;SCOLAIRE;BAC PROFESSIONNEL;BAC PRO PROD;BAC PRO 25304 AERONAUTIQUE OPTION STRUCTURE;16;16;13;3;0;0;0;13;0;2;5;5;1;3
18891.0;2023;24;CRETEIL;MASCULIN;SCOLAIRE;BAC PROFESSIONNEL;BAC PRO PROD;BAC PRO 25406 OUVRAGES DU BATIMENT METALLERIE;23;23;12;11;0;0;0;12;0;0;3;4;5;11
18898.0;2023;24;CRETEIL;MASCULIN;SCOLAIRE;BAC PROFESSIONNEL;BAC PRO PROD;BAC PRO 25514 SYST.NUM.OPT.B AUD.RES.EQUIP.DOM.;95;94;88;4;2;2;0;90;0;5;13;44;28;4
18903.0;2023;24;CRETEIL;MASCULIN;SCOLAIRE;BAC PROFESSIONNEL;BAC PRO PROD;BAC PRO AG 21407 TEC CONS VTE UNIVERS JARDINERIE;2;2;1;1;0;0;0;1;0;0;0;0;1;1
18904.0;2023;24;CRETEIL;MASCULIN;SCOLAIRE;BAC PROFESSIONNEL;BAC PRO PROD;BAC PRO AG 22105 LABORATOIRE CONTROLE QUALITE;6;6;4;2;0;0;0;4;0;0;1;0;3;2
18905.0;2023;24;CRETEIL;MASCULIN;SCOLAIRE;BAC PROFESSIONNEL;BAC PRO PROD;BAC PRO AG 22108 TEC CONS VTE ALIMENTATION (PAB);12;12;8;4;0;0;0;8;0;1;1;3;3;4
18906.0;2023;24;CRETEIL;MASCULIN;SCOLAIRE;BAC PROFESSIONNEL;BAC PRO SERV;BAC PRO 30004 ASSISTANC.GEST.ORGANIS.ACTIVITES;991;990;636;308;46;32;14;668;0;6;67;231;364;322
18907.0;2023;24;CRETEIL;MASCULIN;SCOLAIRE;BAC PROFESSIONNEL;BAC PRO SERV;BAC PRO 31106 LOGISTIQUE;130;130;91;34;5;4;1;95;0;5;15;32;43;35
18909.0;2023;24;CRETEIL;MASCULIN;SCOLAIRE;BAC PROFESSIONNEL;BAC PRO SERV;BAC PRO 31114 ORGANIS. TRANSPORT MARCHANDISES;38;38;24;13;1;0;1;24;0;1;3;5;15;14
18912.0;2023;24;CRETEIL;MASCULIN;SCOLAIRE;BAC PROFESSIONNEL;BAC PRO SERV;BAC PRO 31214 MET.COM.VEN.OP.B PR.CL.VA.OF.COM.;594;594;444;110;40;29;11;473;0;15;81;161;216;121
18922.0;2023;24;CRETEIL;MASCULIN;SCOLAIRE;BAC PROFESSIONNEL;BAC PRO SERV;BAC PRO 33104 TECHNICIEN EN PROTHESE DENTAIRE;1;1;1;0;0;0;0;1;0;0;1;0;0;0
18923.0;2023;24;CRETEIL;MASCULIN;SCOLAIRE;BAC PROFESSIONNEL;BAC PRO SERV;BAC PRO 33403 COMMERC. SERVICES EN RESTAURATION;65;65;48;13;4;3;1;51;0;1;10;12;28;14
18928.0;2023;24;CRETEIL;MASCULIN;SCOLAIRE;BAC PROFESSIONNEL;BAC PRO SERV;BAC PRO AG 33002 SERV PERS TERRIT;2;2;1;1;0;0;0;1;0;0;0;1;0;1
18933.0;2023;24;CRETEIL;MASCULIN;SCOLAIRE;BAC TECHNOLOGIQUE;BAC STI2D;BAC STI2D ARCHITECTURE ET CONSTRUCTION;206;206;147;18;41;27;14;174;0;4;14;52;104;32
18938.0;2023;24;CRETEIL;MASCULIN;SCOLAIRE;BAC TECHNOLOGIQUE;BAC STL;BAC STL SCIENCES PHYSIQUES CHIMIQUES  EN LABORAT.;89;89;57;10;22;10;12;67;0;2;8;24;33;22
18947.0;2023;07;DIJON;FEMININ;APPRENTISSAGE;BAC PROFESSIONNEL;BAC PRO PROD;BAC PRO 23304 AMENAGEMENT FINITION BATIMENT;1;1;1;0;0;0;0;1;0;0;1;0;0;0
18951.0;2023;07;DIJON;FEMININ;APPRENTISSAGE;BAC PROFESSIONNEL;BAC PRO PROD;BAC PRO 25219 MAINT.MATERIELS OPT.A AGRICOLES;1;1;1;0;0;0;0;1;0;1;0;0;0;0
18952.0;2023;07;DIJON;FEMININ;APPRENTISSAGE;BAC PROFESSIONNEL;BAC PRO PROD;BAC PRO 25408 REPARATION DES CARROSSERIES;3;3;3;0;0;0;0;3;0;1;2;0;0;0
18953.0;2023;07;DIJON;FEMININ;APPRENTISSAGE;BAC PROFESSIONNEL;BAC PRO PROD;BAC PRO 25411 TECH.CHAUDRONNERIE INDUSTRIELLE;2;2;2;0;0;0;0;2;0;2;0;0;0;0
18955.0;2023;07;DIJON;FEMININ;APPRENTISSAGE;BAC PROFESSIONNEL;BAC PRO PROD;BAC PRO AG 21113 CGEVV;3;3;3;0;0;0;0;3;0;0;0;1;2;0
18956.0;2023;07;DIJON;FEMININ;APPRENTISSAGE;BAC PROFESSIONNEL;BAC PRO PROD;BAC PRO AG 21210 COND GEST ENTR CANIN ET FELIN;15;15;14;1;0;0;0;14;0;0;2;4;8;1
18960.0;2023;07;DIJON;FEMININ;APPRENTISSAGE;BAC PROFESSIONNEL;BAC PRO SERV;BAC PRO 30004 ASSISTANC.GEST.ORGANIS.ACTIVITES;2;2;2;0;0;0;0;2;0;0;2;0;0;0
18964.0;2023;07;DIJON;FEMININ;APPRENTISSAGE;BAC PROFESSIONNEL;BAC PRO SERV;BAC PRO 33006 ANIMAT. ENFANCE& PERSONNES AGEES;1;1;1;0;0;0;0;1;0;0;0;0;1;0
18972.0;2023;07;DIJON;FEMININ;ENSEIGNEMENT A DISTANCE;BAC PROFESSIONNEL;BAC PRO SERV;BAC PRO 33603 ESTHETIQUE COSMETIQUE PARFUMERIE;1;0;0;0;0;0;0;0;0;0;0;0;0;0
18974.0;2023;07;DIJON;FEMININ;ENSEIGNEMENT A DISTANCE;BAC TECHNOLOGIQUE;BAC STMG;BAC STMG GESTION ET FINANCE;1;1;1;0;0;0;0;1;0;0;1;0;0;0
18979.0;2023;07;DIJON;FEMININ;FORMATION CONTINUE;BAC PROFESSIONNEL;BAC PRO SERV;BAC PRO 31213 MET.COM.VEN.OP.A ANI.GES.ESP.COM.;1;1;1;0;0;0;0;1;0;0;1;0;0;0
18992.0;2023;07;DIJON;FEMININ;INDIVIDUEL;BAC TECHNOLOGIQUE;BAC STHR;BAC STHR SC.&TEC. HOTELLERIE-RESTAURATION;1;1;0;0;1;1;0;1;0;0;0;0;1;0
18996.0;2023;07;DIJON;FEMININ;SCOLAIRE;BAC PROFESSIONNEL;BAC PRO PROD;BACPRO 20002 ETUD.DEFINITION PRDTS INDUSTRIEL;1;1;1;0;0;0;0;1;0;0;0;0;1;0
19002.0;2023;07;DIJON;FEMININ;SCOLAIRE;BAC PROFESSIONNEL;BAC PRO PROD;BAC PRO 23005 TECHN. ETUDES BAT B ASSIST.ARCHI.;5;5;3;2;0;0;0;3;0;0;0;0;3;2
19005.0;2023;07;DIJON;FEMININ;SCOLAIRE;BAC PROFESSIONNEL;BAC PRO PROD;BAC PRO 23304 AMENAGEMENT FINITION BATIMENT;3;3;3;0;0;0;0;3;0;0;1;2;0;0
19015.0;2023;07;DIJON;FEMININ;SCOLAIRE;BAC PROFESSIONNEL;BAC PRO PROD;BAC PRO 25406 OUVRAGES DU BATIMENT METALLERIE;1;1;1;0;0;0;0;1;0;0;1;0;0;0
19021.0;2023;07;DIJON;FEMININ;SCOLAIRE;BAC PROFESSIONNEL;BAC PRO PROD;BAC PRO 25515 SYST.NUM.OPT.C RES.INF.SYST.COMM.;8;8;8;0;0;0;0;8;0;0;4;1;3;0
19029.0;2023;07;DIJON;FEMININ;SCOLAIRE;BAC PROFESSIONNEL;BAC PRO PROD;BAC PRO AG 22108 TEC CONS VTE ALIMENTATION (PAB);49;47;39;8;0;0;0;39;0;0;2;9;28;8
19030.0;2023;07;DIJON;FEMININ;SCOLAIRE;BAC PROFESSIONNEL;BAC PRO SERV;BAC PRO 30004 ASSISTANC.GEST.ORGANIS.ACTIVITES;248;248;197;36;15;10;5;207;0;10;34;74;89;41
19031.0;2023;07;DIJON;FEMININ;SCOLAIRE;BAC PROFESSIONNEL;BAC PRO SERV;BAC PRO 31106 LOGISTIQUE;9;9;7;1;1;1;0;8;0;0;3;4;1;1
19036.0;2023;07;DIJON;FEMININ;SCOLAIRE;BAC PROFESSIONNEL;BAC PRO SERV;BAC PRO 32207 REAL.PR.IMPR.PLURI.OPTA.PR.GRAPH.;3;3;3;0;0;0;0;3;0;1;1;0;1;0
19038.0;2023;07;DIJON;FEMININ;SCOLAIRE;BAC PROFESSIONNEL;BAC PRO SERV;BAC PRO 33004 ACC.SOINS-S.PERS. OPT.EN STRUCTUR;260;258;228;20;10;7;3;235;0;15;45;104;71;23
19039.0;2023;07;DIJON;FEMININ;SCOLAIRE;BAC PROFESSIONNEL;BAC PRO SERV;BAC PRO 33006 ANIMAT. ENFANCE& PERSONNES AGEES;50;50;44;6;0;0;0;44;0;4;8;25;7;6
19042.0;2023;07;DIJON;FEMININ;SCOLAIRE;BAC PROFESSIONNEL;BAC PRO SERV;BAC PRO 33104 TECHNICIEN EN PROTHESE DENTAIRE;5;5;2;3;0;0;0;2;0;0;0;1;1;3
19045.0;2023;07;DIJON;FEMININ;SCOLAIRE;BAC PROFESSIONNEL;BAC PRO SERV;BAC PRO 33604 METIERS DE LA COIFFURE;7;7;5;2;0;0;0;5;0;0;0;2;3;2
19046.0;2023;07;DIJON;FEMININ;SCOLAIRE;BAC PROFESSIONNEL;BAC PRO SERV;BAC PRO 34304 HYGIENE PROPRETE STERILISATION;18;18;11;6;1;0;1;11;0;0;4;4;3;7
19051.0;2023;07;DIJON;FEMININ;SCOLAIRE;BAC TECHNOLOGIQUE;BAC S2TMD;BAC S2TMD MUSIQUE;3;3;2;0;1;1;0;3;0;1;1;0;1;0
19054.0;2023;07;DIJON;FEMININ;SCOLAIRE;BAC TECHNOLOGIQUE;BAC STD2A;BAC STD2A SCIENCES & TECHNO. DESIGN-ARTS APPLIQUES;48;48;48;0;0;0;0;48;0;2;19;17;10;0
19056.0;2023;07;DIJON;FEMININ;SCOLAIRE;BAC TECHNOLOGIQUE;BAC STI2D;BAC STI2D ARCHITECTURE ET CONSTRUCTION;20;20;17;0;3;2;1;19;0;1;2;6;10;1
19059.0;2023;07;DIJON;FEMININ;SCOLAIRE;BAC TECHNOLOGIQUE;BAC STI2D;BAC STI2D SYSTÈME D'INFORMATION  ET NUMERIQUE;9;9;9;0;0;0;0;9;0;0;4;0;5;0
19060.0;2023;07;DIJON;FEMININ;SCOLAIRE;BAC TECHNOLOGIQUE;BAC STL;BAC STL BIOCHIM.-BIOLOGIE-BIOTECHNOL.;50;50;46;2;2;0;2;46;0;3;6;10;27;4
19066.0;2023;07;DIJON;MASCULIN;APPRENTISSAGE;BAC PROFESSIONNEL;BAC PRO PROD;BAC PRO 20102 PILOTE DE LIGNE DE PRODUCTION;2;2;2;0;0;0;0;2;0;0;0;2;0;0
19068.0;2023;07;DIJON;MASCULIN;APPRENTISSAGE;BAC PROFESSIONNEL;BAC PRO PROD;BAC PRO 22503 PLASTIQUES ET COMPOSITES;2;2;2;0;0;0;0;2;0;0;0;1;1;0
19089.0;2023;07;DIJON;MASCULIN;APPRENTISSAGE;BAC PROFESSIONNEL;BAC PRO PROD;BAC PRO 25514 SYST.NUM.OPT.B AUD.RES.EQUIP.DOM.;2;2;2;0;0;0;0;2;0;0;1;1;0;0
19090.0;2023;07;DIJON;MASCULIN;APPRENTISSAGE;BAC PROFESSIONNEL;BAC PRO PROD;BAC PRO 25515 SYST.NUM.OPT.C RES.INF.SYST.COMM.;1;1;1;0;0;0;0;1;0;0;1;0;0;0
19100.0;2023;07;DIJON;MASCULIN;APPRENTISSAGE;BAC PROFESSIONNEL;BAC PRO SERV;BAC PRO 31214 MET.COM.VEN.OP.B PR.CL.VA.OF.COM.;2;1;0;0;1;1;0;1;0;0;0;0;1;0
19102.0;2023;07;DIJON;MASCULIN;APPRENTISSAGE;BAC PROFESSIONNEL;BAC PRO SERV;BAC PRO 34304 HYGIENE PROPRETE STERILISATION;1;1;1;0;0;0;0;1;0;0;1;0;0;0
19104.0;2023;07;DIJON;MASCULIN;ENSEIGNEMENT A DISTANCE;BAC GENERAL;BAC GENERAL;BAC GENE 10019 BAC GENERAL;20;20;13;6;1;0;1;13;0;0;1;6;6;7
19110.0;2023;07;DIJON;MASCULIN;FORMATION CONTINUE;BAC PROFESSIONNEL;BAC PRO PROD;BAC PRO 23004 TECHN. ETUDES BAT.A ETUDES & ECO.;1;1;1;0;0;0;0;1;0;0;0;0;1;0
19111.0;2023;07;DIJON;MASCULIN;FORMATION CONTINUE;BAC PROFESSIONNEL;BAC PRO SERV;BAC PRO 30004 ASSISTANC.GEST.ORGANIS.ACTIVITES;1;1;0;1;0;0;0;0;0;0;0;0;0;1
19115.0;2023;07;DIJON;MASCULIN;INDIVIDUEL;BAC PROFESSIONNEL;BAC PRO PROD;BAC PRO 22503 PLASTIQUES ET COMPOSITES;1;0;0;0;0;0;0;0;0;0;0;0;0;0
19119.0;2023;07;DIJON;MASCULIN;INDIVIDUEL;BAC PROFESSIONNEL;BAC PRO PROD;BAC PRO 25513 SYST.NUM.OPT.A SURETE SECURITE;1;0;0;0;0;0;0;0;0;0;0;0;0;0
19124.0;2023;07;DIJON;MASCULIN;INDIVIDUEL;BAC PROFESSIONNEL;BAC PRO SERV;BAC PRO 31106 LOGISTIQUE;1;1;1;0;0;0;0;1;0;0;0;1;0;0
19125.0;2023;07;DIJON;MASCULIN;INDIVIDUEL;BAC PROFESSIONNEL;BAC PRO SERV;BAC PRO 31213 MET.COM.VEN.OP.A ANI.GES.ESP.COM.;1;1;1;0;0;0;0;1;0;0;0;0;1;0
19129.0;2023;07;DIJON;MASCULIN;INDIVIDUEL;BAC TECHNOLOGIQUE;BAC STI2D;BAC STI2D ENERGIES  ET ENVIRONNEMENT;1;1;1;0;0;0;0;1;0;0;0;0;1;0
19130.0;2023;07;DIJON;MASCULIN;INDIVIDUEL;BAC TECHNOLOGIQUE;BAC STI2D;BAC STI2D SYSTÈME D'INFORMATION  ET NUMERIQUE;1;1;0;0;1;1;0;1;0;0;0;0;1;0
19147.0;2023;07;DIJON;MASCULIN;SCOLAIRE;BAC PROFESSIONNEL;BAC PRO PROD;BAC PRO 23203 TECHNICIEN BAT. : ORG.REAL.GROS O;9;9;5;3;1;0;1;5;0;0;0;0;5;4
19158.0;2023;07;DIJON;MASCULIN;SCOLAIRE;BAC PROFESSIONNEL;BAC PRO PROD;BAC PRO 25107 TECHNICIEN OUTILLEUR;9;9;4;5;0;0;0;4;0;0;0;2;2;5
19166.0;2023;07;DIJON;MASCULIN;SCOLAIRE;BAC PROFESSIONNEL;BAC PRO PROD;BAC PRO 25305 AVIATION GENERALE;6;6;4;2;0;0;0;4;0;2;0;2;0;2
19170.0;2023;07;DIJON;MASCULIN;SCOLAIRE;BAC PROFESSIONNEL;BAC PRO PROD;BAC PRO 25509 TECHNIC. FROID CONDITIONNEMT AIR;19;18;11;6;1;1;0;12;0;1;1;4;6;6
19171.0;2023;07;DIJON;MASCULIN;SCOLAIRE;BAC PROFESSIONNEL;BAC PRO PROD;BAC PRO 25510 METIERS ELECT. ENVIRON. CONNECTES;199;199;146;42;11;9;2;155;0;8;26;57;64;44
19174.0;2023;07;DIJON;MASCULIN;SCOLAIRE;BAC PROFESSIONNEL;BAC PRO PROD;BAC PRO 25515 SYST.NUM.OPT.C RES.INF.SYST.COMM.;80;80;74;5;1;0;1;74;0;8;26;28;12;6
19180.0;2023;07;DIJON;MASCULIN;SCOLAIRE;BAC PROFESSIONNEL;BAC PRO PROD;BAC PRO AG 21204 PROD-AQUACOLES;23;23;20;3;0;0;0;20;0;0;2;4;14;3
19183.0;2023;07;DIJON;MASCULIN;SCOLAIRE;BAC PROFESSIONNEL;BAC PRO PROD;BAC PRO AG 21302 GEST MILIEUX NATURELS FAUNE;10;10;10;0;0;0;0;10;0;0;1;3;6;0
19188.0;2023;07;DIJON;MASCULIN;SCOLAIRE;BAC PROFESSIONNEL;BAC PRO SERV;BAC PRO 31106 LOGISTIQUE;42;42;23;12;7;3;4;26;0;0;3;6;17;16
19195.0;2023;07;DIJON;MASCULIN;SCOLAIRE;BAC PROFESSIONNEL;BAC PRO SERV;BAC PRO 32208 REAL.PR.IMPR.PLURI.OPTB.PR.IMPR.;5;5;5;0;0;0;0;5;0;0;2;2;1;0
19202.0;2023;07;DIJON;MASCULIN;SCOLAIRE;BAC PROFESSIONNEL;BAC PRO SERV;BAC PRO 33104 TECHNICIEN EN PROTHESE DENTAIRE;5;5;3;2;0;0;0;3;0;0;0;3;0;2
19203.0;2023;07;DIJON;MASCULIN;SCOLAIRE;BAC PROFESSIONNEL;BAC PRO SERV;BAC PRO 33403 COMMERC. SERVICES EN RESTAURATION;50;50;40;6;4;4;0;44;0;5;10;12;17;6
19204.0;2023;07;DIJON;MASCULIN;SCOLAIRE;BAC PROFESSIONNEL;BAC PRO SERV;BAC PRO 33603 ESTHETIQUE COSMETIQUE PARFUMERIE;1;1;1;0;0;0;0;1;0;0;1;0;0;0
19211.0;2023;07;DIJON;MASCULIN;SCOLAIRE;BAC TECHNOLOGIQUE;BAC S2TMD;BAC S2TMD MUSIQUE;3;3;3;0;0;0;0;3;0;0;1;1;1;0
19212.0;2023;07;DIJON;MASCULIN;SCOLAIRE;BAC TECHNOLOGIQUE;BAC ST2S;BAC ST2S SCIENCES & TECHNO. SANTE & SOCIAL;69;69;50;1;18;9;9;59;0;0;8;16;35;10
19224.0;2023;07;DIJON;MASCULIN;SCOLAIRE;BAC TECHNOLOGIQUE;BAC STMG;BAC STMG RESSOURCES HUMAINES ET COMMUNICATION;165;165;108;13;44;27;17;135;0;0;9;27;99;30
19229.0;2023;08;GRENOBLE;FEMININ;APPRENTISSAGE;BAC PROFESSIONNEL;BAC PRO PROD;BAC PRO 22106 CUISINE;2;2;2;0;0;0;0;2;0;0;2;0;0;0
19235.0;2023;08;GRENOBLE;FEMININ;APPRENTISSAGE;BAC PROFESSIONNEL;BAC PRO PROD;BAC PRO 23404 TECHNICIEN CONSTRUCTEUR BOIS;1;1;0;1;0;0;0;0;0;0;0;0;0;1
19238.0;2023;08;GRENOBLE;FEMININ;APPRENTISSAGE;BAC PROFESSIONNEL;BAC PRO PROD;BAC PRO 25007 MAINTENANCE EQUIPEMENTS INDUST.;6;5;4;1;0;0;0;4;0;2;0;1;1;1
19240.0;2023;08;GRENOBLE;FEMININ;APPRENTISSAGE;BAC PROFESSIONNEL;BAC PRO PROD;BAC PRO 25214 MAINT.VEHIC.OPTA VOIT.PARTICUL.;3;3;3;0;0;0;0;3;0;3;0;0;0;0
19246.0;2023;08;GRENOBLE;FEMININ;APPRENTISSAGE;BAC PROFESSIONNEL;BAC PRO PROD;BAC PRO 25510 METIERS ELECT. ENVIRON. CONNECTES;6;6;6;0;0;0;0;6;0;3;0;2;1;0
19266.0;2023;08;GRENOBLE;FEMININ;ENSEIGNEMENT A DISTANCE;BAC PROFESSIONNEL;BAC PRO SERV;BAC PRO 31214 MET.COM.VEN.OP.B PR.CL.VA.OF.COM.;3;2;2;0;0;0;0;2;0;0;0;0;2;0
19269.0;2023;08;GRENOBLE;FEMININ;ENSEIGNEMENT A DISTANCE;BAC TECHNOLOGIQUE;BAC ST2S;BAC ST2S SCIENCES & TECHNO. SANTE & SOCIAL;11;11;4;0;7;3;4;7;0;0;0;1;6;4
19272.0;2023;08;GRENOBLE;FEMININ;ENSEIGNEMENT A DISTANCE;BAC TECHNOLOGIQUE;BAC STMG;BAC STMG SYSTEMES D'INFORMATION DE GESTION;2;2;2;0;0;0;0;2;0;0;0;0;2;0
19274.0;2023;08;GRENOBLE;FEMININ;INDIVIDUEL;BAC PROFESSIONNEL;BAC PRO PROD;BAC PRO AG 21004 CGEA;4;4;3;1;0;0;0;3;0;0;0;0;3;1
19276.0;2023;08;GRENOBLE;FEMININ;INDIVIDUEL;BAC PROFESSIONNEL;BAC PRO PROD;BAC PRO AG 21211 COND GEST ENTR HIPPIQUE;10;10;6;4;0;0;0;6;0;0;1;2;3;4
19279.0;2023;08;GRENOBLE;FEMININ;INDIVIDUEL;BAC PROFESSIONNEL;BAC PRO SERV;BAC PRO 31212 METIERS DE L'ACCUEIL;1;1;1;0;0;0;0;1;0;0;0;1;0;0
19282.0;2023;08;GRENOBLE;FEMININ;INDIVIDUEL;BAC PROFESSIONNEL;BAC PRO SERV;BAC PRO 33002 SERVICES DE PROXIMITE  VIE LOCAL;1;1;1;0;0;0;0;1;0;0;0;0;1;0
19286.0;2023;08;GRENOBLE;FEMININ;INDIVIDUEL;BAC PROFESSIONNEL;BAC PRO SERV;BAC PRO 33603 ESTHETIQUE COSMETIQUE PARFUMERIE;2;2;1;1;0;0;0;1;0;0;0;0;1;1
19287.0;2023;08;GRENOBLE;FEMININ;INDIVIDUEL;BAC PROFESSIONNEL;BAC PRO SERV;BAC PRO 34304 HYGIENE PROPRETE STERILISATION;2;2;2;0;0;0;0;2;0;0;0;0;2;0
19301.0;2023;08;GRENOBLE;FEMININ;SCOLAIRE;BAC PROFESSIONNEL;BAC PRO PROD;BAC PRO 22105 BOULANGER-PÂTISSIER;31;31;31;0;0;0;0;31;0;3;10;16;2;0
19306.0;2023;08;GRENOBLE;FEMININ;SCOLAIRE;BAC PROFESSIONNEL;BAC PRO PROD;BAC PRO 23005 TECHN. ETUDES BAT B ASSIST.ARCHI.;19;19;19;0;0;0;0;19;0;2;6;7;4;0
19312.0;2023;08;GRENOBLE;FEMININ;SCOLAIRE;BAC PROFESSIONNEL;BAC PRO PROD;BAC PRO 23407 TECHNIC.FAB.BOIS ET MATERX ASSOC;1;1;1;0;0;0;0;1;0;0;0;0;1;0
19313.0;2023;08;GRENOBLE;FEMININ;SCOLAIRE;BAC PROFESSIONNEL;BAC PRO PROD;BAC PRO 24202 ARTIS.& MET.ART : TAPIS.D'AMEUBL;5;5;5;0;0;0;0;5;0;1;0;1;3;0
19318.0;2023;08;GRENOBLE;FEMININ;SCOLAIRE;BAC PROFESSIONNEL;BAC PRO PROD;BAC PRO 25006 MICROTECHNIQUES;4;4;3;1;0;0;0;3;0;0;2;0;1;1
19325.0;2023;08;GRENOBLE;FEMININ;SCOLAIRE;BAC PROFESSIONNEL;BAC PRO PROD;BAC PRO 25514 SYST.NUM.OPT.B AUD.RES.EQUIP.DOM.;3;3;3;0;0;0;0;3;0;1;0;2;0;0
19328.0;2023;08;GRENOBLE;FEMININ;SCOLAIRE;BAC PROFESSIONNEL;BAC PRO PROD;BAC PRO AG 21203 TECHN CONSEIL DE VENTE ANIMAL;42;42;40;2;0;0;0;40;0;2;8;14;16;2
19330.0;2023;08;GRENOBLE;FEMININ;SCOLAIRE;BAC PROFESSIONNEL;BAC PRO PROD;BAC PRO AG 21210 COND GEST ENTR CANIN ET FELIN;26;26;25;1;0;0;0;25;0;2;6;8;9;1
19333.0;2023;08;GRENOBLE;FEMININ;SCOLAIRE;BAC PROFESSIONNEL;BAC PRO PROD;BAC PRO AG 21405 AMENAGEMENTS PAYSAGERS;11;11;11;0;0;0;0;11;0;0;5;2;4;0
19337.0;2023;08;GRENOBLE;FEMININ;SCOLAIRE;BAC PROFESSIONNEL;BAC PRO SERV;BAC PRO 30004 ASSISTANC.GEST.ORGANIS.ACTIVITES;608;607;465;120;22;18;4;483;0;18;79;168;218;124
19340.0;2023;08;GRENOBLE;FEMININ;SCOLAIRE;BAC PROFESSIONNEL;BAC PRO SERV;BAC PRO 31109 TRANSPORT FLUVIAL;1;1;1;0;0;0;0;1;0;0;1;0;0;0
19345.0;2023;08;GRENOBLE;FEMININ;SCOLAIRE;BAC PROFESSIONNEL;BAC PRO SERV;BAC PRO 32207 REAL.PR.IMPR.PLURI.OPTA.PR.GRAPH.;3;3;3;0;0;0;0;3;0;1;1;1;0;0
19352.0;2023;08;GRENOBLE;FEMININ;SCOLAIRE;BAC PROFESSIONNEL;BAC PRO SERV;BAC PRO 33403 COMMERC. SERVICES EN RESTAURATION;70;69;55;10;4;4;0;59;0;4;12;16;27;10
19354.0;2023;08;GRENOBLE;FEMININ;SCOLAIRE;BAC PROFESSIONNEL;BAC PRO SERV;BAC PRO 34304 HYGIENE PROPRETE STERILISATION;7;7;4;3;0;0;0;4;0;0;0;2;2;3
19359.0;2023;08;GRENOBLE;FEMININ;SCOLAIRE;BAC TECHNOLOGIQUE;BAC S2TMD;BAC S2TMD MUSIQUE;12;12;10;0;2;1;1;11;1;1;3;4;2;1
19361.0;2023;08;GRENOBLE;FEMININ;SCOLAIRE;BAC TECHNOLOGIQUE;BAC STAV;BAC STAV AGRONOMIE ALIM ENV TERRITOI;158;158;155;3;0;0;0;155;0;2;34;63;56;3
19364.0;2023;08;GRENOBLE;FEMININ;SCOLAIRE;BAC TECHNOLOGIQUE;BAC STI2D;BAC STI2D ARCHITECTURE ET CONSTRUCTION;53;53;48;2;3;1;2;49;0;7;9;17;16;4
19366.0;2023;08;GRENOBLE;FEMININ;SCOLAIRE;BAC TECHNOLOGIQUE;BAC STI2D;BAC STI2D INNOVATION TECHNO.  ET ECO CONCEPTION;30;30;26;3;1;1;0;27;0;4;1;11;11;3
19381.0;2023;08;GRENOBLE;MASCULIN;APPRENTISSAGE;BAC PROFESSIONNEL;BAC PRO PROD;BAC PRO 23004 TECHN. ETUDES BAT.A ETUDES & ECO.;1;1;0;1;0;0;0;0;0;0;0;0;0;1
19382.0;2023;08;GRENOBLE;MASCULIN;APPRENTISSAGE;BAC PROFESSIONNEL;BAC PRO PROD;BAC PRO 23102 TRAVAUX PUBLICS;51;51;45;5;1;1;0;46;0;1;14;19;12;5
19383.0;2023;08;GRENOBLE;MASCULIN;APPRENTISSAGE;BAC PROFESSIONNEL;BAC PRO PROD;BAC PRO 23203 TECHNICIEN BAT. : ORG.REAL.GROS O;18;18;16;1;1;0;1;16;0;0;6;8;2;2
19390.0;2023;08;GRENOBLE;MASCULIN;APPRENTISSAGE;BAC PROFESSIONNEL;BAC PRO PROD;BAC PRO 25005 PRODUCTIQ.MECA. OPT.DECOLLETAGE;1;1;1;0;0;0;0;1;0;0;0;1;0;0
19392.0;2023;08;GRENOBLE;MASCULIN;APPRENTISSAGE;BAC PROFESSIONNEL;BAC PRO PROD;BAC PRO 25007 MAINTENANCE EQUIPEMENTS INDUST.;80;80;69;7;4;4;0;73;0;4;21;27;21;7
19400.0;2023;08;GRENOBLE;MASCULIN;APPRENTISSAGE;BAC PROFESSIONNEL;BAC PRO PROD;BAC PRO 25221 MAINT.MATERIELS OPT.C ESP. VERTS;11;11;9;1;1;0;1;9;0;0;0;3;6;2
19420.0;2023;08;GRENOBLE;MASCULIN;APPRENTISSAGE;BAC PROFESSIONNEL;BAC PRO SERV;BAC PRO 31212 METIERS DE L'ACCUEIL;10;10;7;2;1;0;1;7;0;0;1;3;3;3
19422.0;2023;08;GRENOBLE;MASCULIN;APPRENTISSAGE;BAC PROFESSIONNEL;BAC PRO SERV;BAC PRO 31214 MET.COM.VEN.OP.B PR.CL.VA.OF.COM.;6;6;5;0;1;0;1;5;0;0;0;4;1;1
19440.0;2023;08;GRENOBLE;MASCULIN;FORMATION CONTINUE;BAC PROFESSIONNEL;BAC PRO PROD;BAC PRO AG 21302 GEST MILIEUX NATURELS FAUNE;1;1;1;0;0;0;0;1;0;0;0;0;1;0
19456.0;2023;08;GRENOBLE;MASCULIN;INDIVIDUEL;BAC PROFESSIONNEL;BAC PRO PROD;BAC PRO 25510 METIERS ELECT. ENVIRON. CONNECTES;6;4;2;1;1;1;0;3;0;0;0;1;2;1
19458.0;2023;08;GRENOBLE;MASCULIN;INDIVIDUEL;BAC PROFESSIONNEL;BAC PRO PROD;BAC PRO AG 21004 CGEA;2;2;2;0;0;0;0;2;0;0;0;0;2;0
19464.0;2023;08;GRENOBLE;MASCULIN;INDIVIDUEL;BAC PROFESSIONNEL;BAC PRO SERV;BAC PRO 31213 MET.COM.VEN.OP.A ANI.GES.ESP.COM.;3;0;0;0;0;0;0;0;0;0;0;0;0;0
19468.0;2023;08;GRENOBLE;MASCULIN;INDIVIDUEL;BAC PROFESSIONNEL;BAC PRO SERV;BAC PRO AG 33002 SERV PERS TERRIT;1;1;0;1;0;0;0;0;0;0;0;0;0;1
19472.0;2023;08;GRENOBLE;MASCULIN;INDIVIDUEL;BAC TECHNOLOGIQUE;BAC STI2D;BAC STI2D SYSTÈME D'INFORMATION  ET NUMERIQUE;5;5;2;1;2;0;2;2;0;1;0;1;0;3
19477.0;2023;08;GRENOBLE;MASCULIN;SCOLAIRE;BAC GENERAL;BAC GENERAL;BAC GENE 10019 BAC GENERAL;8407;8407;7675;134;598;437;161;8112;134;1011;1924;2607;2436;295
19483.0;2023;08;GRENOBLE;MASCULIN;SCOLAIRE;BAC PROFESSIONNEL;BAC PRO PROD;BAC PRO 22106 CUISINE;161;161;154;5;2;2;0;156;0;16;39;66;35;5
19487.0;2023;08;GRENOBLE;MASCULIN;SCOLAIRE;BAC PROFESSIONNEL;BAC PRO PROD;BAC PRO 23003 ARTIS. & M.ART:MARCHANDISAGE VIS.;8;8;8;0;0;0;0;8;0;2;2;3;1;0
19489.0;2023;08;GRENOBLE;MASCULIN;SCOLAIRE;BAC PROFESSIONNEL;BAC PRO PROD;BAC PRO 23005 TECHN. ETUDES BAT B ASSIST.ARCHI.;20;20;18;2;0;0;0;18;0;1;7;6;4;2
19490.0;2023;08;GRENOBLE;MASCULIN;SCOLAIRE;BAC PROFESSIONNEL;BAC PRO PROD;BACPRO 23103 TECHNICIEN GEOMETRE-TOPOGRAPHE;19;19;18;1;0;0;0;18;0;0;4;7;7;1
19492.0;2023;08;GRENOBLE;MASCULIN;SCOLAIRE;BAC PROFESSIONNEL;BAC PRO PROD;BAC PRO 23303 MENUISERIE ALUMINIUM-VERRE;12;11;7;3;1;0;1;7;0;0;0;3;4;4
19495.0;2023;08;GRENOBLE;MASCULIN;SCOLAIRE;BAC PROFESSIONNEL;BAC PRO PROD;BAC PRO 23405 TECHNICIEN MENUISIER AGENCEUR;94;94;73;17;4;4;0;77;0;5;16;27;29;17
19498.0;2023;08;GRENOBLE;MASCULIN;SCOLAIRE;BAC PROFESSIONNEL;BAC PRO PROD;BAC PRO 24203 METIERS DE LA MODE - VÊTEMENT;10;10;9;0;1;0;1;9;0;2;3;2;2;1
19508.0;2023;08;GRENOBLE;MASCULIN;SCOLAIRE;BAC PROFESSIONNEL;BAC PRO PROD;BAC PRO 25216 MAINT.VEHIC.OPTC MOTOCYCLES;18;18;14;4;0;0;0;14;0;2;3;7;2;4
19520.0;2023;08;GRENOBLE;MASCULIN;SCOLAIRE;BAC PROFESSIONNEL;BAC PRO PROD;BAC PRO AG 21114 CONDUITE PRODUCTIONS HORTICOLES;18;18;13;5;0;0;0;13;0;0;1;2;10;5
19521.0;2023;08;GRENOBLE;MASCULIN;SCOLAIRE;BAC PROFESSIONNEL;BAC PRO PROD;BAC PRO AG 21203 TECHN CONSEIL DE VENTE ANIMAL;16;16;15;1;0;0;0;15;0;0;0;7;8;1
19526.0;2023;08;GRENOBLE;MASCULIN;SCOLAIRE;BAC PROFESSIONNEL;BAC PRO PROD;BAC PRO AG 21303 FORET;35;35;29;6;0;0;0;29;0;0;1;8;20;6
19530.0;2023;08;GRENOBLE;MASCULIN;SCOLAIRE;BAC PROFESSIONNEL;BAC PRO PROD;BAC PRO AG 22108 TEC CONS VTE ALIMENTATION (PAB);40;40;37;3;0;0;0;37;0;0;0;11;26;3
19531.0;2023;08;GRENOBLE;MASCULIN;SCOLAIRE;BAC PROFESSIONNEL;BAC PRO SERV;BAC PRO 30004 ASSISTANC.GEST.ORGANIS.ACTIVITES;240;240;175;57;8;7;1;182;0;2;27;73;80;58
19532.0;2023;08;GRENOBLE;MASCULIN;SCOLAIRE;BAC PROFESSIONNEL;BAC PRO SERV;BAC PRO 31106 LOGISTIQUE;82;82;67;9;6;5;1;72;0;0;16;30;26;10
19539.0;2023;08;GRENOBLE;MASCULIN;SCOLAIRE;BAC PROFESSIONNEL;BAC PRO SERV;BAC PRO 32207 REAL.PR.IMPR.PLURI.OPTA.PR.GRAPH.;7;7;6;1;0;0;0;6;0;0;2;3;1;1
19541.0;2023;08;GRENOBLE;MASCULIN;SCOLAIRE;BAC PROFESSIONNEL;BAC PRO SERV;BAC PRO 32303 ART.& MET.ART:COM.VIS.VIS.PLURI-M;31;31;30;0;1;1;0;31;0;5;11;8;7;0
19542.0;2023;08;GRENOBLE;MASCULIN;SCOLAIRE;BAC PROFESSIONNEL;BAC PRO SERV;BAC PRO 33003 ACC.SOINS-S.PERS. OPT.A DOMICILE;7;7;7;0;0;0;0;7;0;0;1;2;4;0
19545.0;2023;08;GRENOBLE;MASCULIN;SCOLAIRE;BAC PROFESSIONNEL;BAC PRO SERV;BAC PRO 33101 OPTIQUE LUNETTERIE;9;9;6;3;0;0;0;6;0;0;2;3;1;3
19546.0;2023;08;GRENOBLE;MASCULIN;SCOLAIRE;BAC PROFESSIONNEL;BAC PRO SERV;BAC PRO 33403 COMMERC. SERVICES EN RESTAURATION;100;100;83;17;0;0;0;83;0;9;13;31;30;17
19547.0;2023;08;GRENOBLE;MASCULIN;SCOLAIRE;BAC PROFESSIONNEL;BAC PRO SERV;BAC PRO 34304 HYGIENE PROPRETE STERILISATION;6;6;5;0;1;1;0;6;0;0;0;0;6;0
19550.0;2023;08;GRENOBLE;MASCULIN;SCOLAIRE;BAC PROFESSIONNEL;BAC PRO SERV;BAC PRO AG 33002 SERV PERS TERRIT;58;58;53;5;0;0;0;53;0;3;5;20;25;5
19561.0;2023;08;GRENOBLE;MASCULIN;SCOLAIRE;BAC TECHNOLOGIQUE;BAC STL;BAC STL BIOCHIM.-BIOLOGIE-BIOTECHNOL.;56;56;46;2;8;2;6;48;0;0;10;12;26;8
19563.0;2023;08;GRENOBLE;MASCULIN;SCOLAIRE;BAC TECHNOLOGIQUE;BAC STMG;BAC STMG GESTION ET FINANCE;564;564;441;36;87;62;25;503;0;5;41;153;304;61
19571.0;2023;32;GUADELOUPE;FEMININ;APPRENTISSAGE;BAC PROFESSIONNEL;BAC PRO SERV;BAC PRO 33603 ESTHETIQUE COSMETIQUE PARFUMERIE;3;2;0;1;1;1;0;1;0;0;0;0;1;1
19579.0;2023;32;GUADELOUPE;FEMININ;ENSEIGNEMENT A DISTANCE;BAC TECHNOLOGIQUE;BAC STMG;BAC STMG MERCATIQUE (MARKETING);1;1;1;0;0;0;0;1;0;0;0;1;0;0
19590.0;2023;32;GUADELOUPE;FEMININ;INDIVIDUEL;BAC PROFESSIONNEL;BAC PRO SERV;BAC PRO 31214 MET.COM.VEN.OP.B PR.CL.VA.OF.COM.;1;1;0;1;0;0;0;0;0;0;0;0;0;1
19592.0;2023;32;GUADELOUPE;FEMININ;INDIVIDUEL;BAC PROFESSIONNEL;BAC PRO SERV;BAC PRO 33003 ACC.SOINS-S.PERS. OPT.A DOMICILE;4;3;1;1;1;1;0;2;0;0;0;0;2;1
19600.0;2023;32;GUADELOUPE;FEMININ;INDIVIDUEL;BAC TECHNOLOGIQUE;BAC STMG;BAC STMG GESTION ET FINANCE;3;3;2;1;0;0;0;2;0;0;1;0;1;1
19608.0;2023;32;GUADELOUPE;FEMININ;SCOLAIRE;BAC PROFESSIONNEL;BAC PRO PROD;BAC PRO 23005 TECHN. ETUDES BAT B ASSIST.ARCHI.;4;4;3;0;1;1;0;4;0;0;0;0;4;0
19613.0;2023;32;GUADELOUPE;FEMININ;SCOLAIRE;BAC PROFESSIONNEL;BAC PRO PROD;BAC PRO 24203 METIERS DE LA MODE - VÊTEMENT;28;28;18;5;5;5;0;23;0;2;4;6;11;5
19620.0;2023;32;GUADELOUPE;FEMININ;SCOLAIRE;BAC PROFESSIONNEL;BAC PRO PROD;BAC PRO 25411 TECH.CHAUDRONNERIE INDUSTRIELLE;1;0;0;0;0;0;0;0;0;0;0;0;0;0
19623.0;2023;32;GUADELOUPE;FEMININ;SCOLAIRE;BAC PROFESSIONNEL;BAC PRO PROD;BAC PRO 25515 SYST.NUM.OPT.C RES.INF.SYST.COMM.;11;9;7;0;2;1;1;8;0;1;2;3;2;1
19624.0;2023;32;GUADELOUPE;FEMININ;SCOLAIRE;BAC PROFESSIONNEL;BAC PRO PROD;BAC PRO AG 21004 CGEA;9;9;7;2;0;0;0;7;0;0;1;5;1;2
19632.0;2023;32;GUADELOUPE;FEMININ;SCOLAIRE;BAC PROFESSIONNEL;BAC PRO SERV;BAC PRO 31213 MET.COM.VEN.OP.A ANI.GES.ESP.COM.;62;59;44;6;9;9;0;53;0;1;4;20;28;6
19635.0;2023;32;GUADELOUPE;FEMININ;SCOLAIRE;BAC PROFESSIONNEL;BAC PRO SERV;BAC PRO 33002 SERVICES DE PROXIMITE  VIE LOCAL;4;4;2;2;0;0;0;2;0;0;0;1;1;2
19637.0;2023;32;GUADELOUPE;FEMININ;SCOLAIRE;BAC PROFESSIONNEL;BAC PRO SERV;BAC PRO 33004 ACC.SOINS-S.PERS. OPT.EN STRUCTUR;78;76;42;28;6;5;1;47;0;1;5;13;28;29
19639.0;2023;32;GUADELOUPE;FEMININ;SCOLAIRE;BAC PROFESSIONNEL;BAC PRO SERV;BAC PRO 33403 COMMERC. SERVICES EN RESTAURATION;23;23;19;4;0;0;0;19;0;2;5;5;7;4
19640.0;2023;32;GUADELOUPE;FEMININ;SCOLAIRE;BAC PROFESSIONNEL;BAC PRO SERV;BAC PRO 33603 ESTHETIQUE COSMETIQUE PARFUMERIE;30;30;23;7;0;0;0;23;0;3;3;7;10;7
19646.0;2023;32;GUADELOUPE;FEMININ;SCOLAIRE;BAC TECHNOLOGIQUE;BAC S2TMD;BAC S2TMD THEATRE;5;5;5;0;0;0;0;5;1;2;0;1;1;0
19650.0;2023;32;GUADELOUPE;FEMININ;SCOLAIRE;BAC TECHNOLOGIQUE;BAC STHR;BAC STHR SC.&TEC. HOTELLERIE-RESTAURATION;12;12;12;0;0;0;0;12;0;1;2;3;6;0
19653.0;2023;32;GUADELOUPE;FEMININ;SCOLAIRE;BAC TECHNOLOGIQUE;BAC STI2D;BAC STI2D INNOVATION TECHNO.  ET ECO CONCEPTION;13;13;7;1;5;4;1;11;0;0;2;1;8;2
19655.0;2023;32;GUADELOUPE;FEMININ;SCOLAIRE;BAC TECHNOLOGIQUE;BAC STL;BAC STL BIOCHIM.-BIOLOGIE-BIOTECHNOL.;24;24;19;0;5;3;2;22;0;0;2;5;15;2
19660.0;2023;32;GUADELOUPE;FEMININ;SCOLAIRE;BAC TECHNOLOGIQUE;BAC STMG;BAC STMG SYSTEMES D'INFORMATION DE GESTION;2;2;0;0;2;2;0;2;0;0;0;0;2;0
19680.0;2023;32;GUADELOUPE;MASCULIN;INDIVIDUEL;BAC PROFESSIONNEL;BAC PRO PROD;BAC PRO AG 21114 CONDUITE PRODUCTIONS HORTICOLES;2;2;2;0;0;0;0;2;0;0;0;0;2;0
19683.0;2023;32;GUADELOUPE;MASCULIN;INDIVIDUEL;BAC TECHNOLOGIQUE;BAC ST2S;BAC ST2S SCIENCES & TECHNO. SANTE & SOCIAL;1;1;0;1;0;0;0;0;0;0;0;0;0;1
19684.0;2023;32;GUADELOUPE;MASCULIN;INDIVIDUEL;BAC TECHNOLOGIQUE;BAC STI2D;BAC STI2D ENERGIES  ET ENVIRONNEMENT;1;1;0;1;0;0;0;0;0;0;0;0;0;1
19687.0;2023;32;GUADELOUPE;MASCULIN;INDIVIDUEL;BAC TECHNOLOGIQUE;BAC STMG;BAC STMG RESSOURCES HUMAINES ET COMMUNICATION;3;3;1;2;0;0;0;1;0;0;1;0;0;2
19691.0;2023;32;GUADELOUPE;MASCULIN;SCOLAIRE;BAC PROFESSIONNEL;BAC PRO PROD;BAC PRO 22106 CUISINE;29;29;26;3;0;0;0;26;0;2;4;13;7;3
19692.0;2023;32;GUADELOUPE;MASCULIN;SCOLAIRE;BAC PROFESSIONNEL;BAC PRO PROD;BAC PRO 22704 TECHN. MAINT. SYST.ENERG.CLIMATI;13;13;7;1;5;4;1;11;0;1;0;2;8;2
19695.0;2023;32;GUADELOUPE;MASCULIN;SCOLAIRE;BAC PROFESSIONNEL;BAC PRO PROD;BAC PRO 23005 TECHN. ETUDES BAT B ASSIST.ARCHI.;9;9;6;1;2;2;0;8;0;0;0;1;7;1
19706.0;2023;32;GUADELOUPE;MASCULIN;SCOLAIRE;BAC PROFESSIONNEL;BAC PRO PROD;BAC PRO 25215 MAINT.VEHIC.OPTB VEHIC.TRANS.ROUT;9;9;6;2;1;1;0;7;0;0;0;3;4;2
19717.0;2023;32;GUADELOUPE;MASCULIN;SCOLAIRE;BAC PROFESSIONNEL;BAC PRO PROD;BAC PRO 25514 SYST.NUM.OPT.B AUD.RES.EQUIP.DOM.;22;22;14;4;4;3;1;17;0;1;2;5;9;5
19720.0;2023;32;GUADELOUPE;MASCULIN;SCOLAIRE;BAC PROFESSIONNEL;BAC PRO PROD;BAC PRO AG 21114 CONDUITE PRODUCTIONS HORTICOLES;2;2;2;0;0;0;0;2;0;0;0;1;1;0
19721.0;2023;32;GUADELOUPE;MASCULIN;SCOLAIRE;BAC PROFESSIONNEL;BAC PRO PROD;BAC PRO AG 21405 AMENAGEMENTS PAYSAGERS;23;20;18;2;0;0;0;18;0;0;0;4;14;2
19723.0;2023;32;GUADELOUPE;MASCULIN;SCOLAIRE;BAC PROFESSIONNEL;BAC PRO SERV;BAC PRO 30004 ASSISTANC.GEST.ORGANIS.ACTIVITES;64;64;54;7;3;3;0;57;0;1;10;23;23;7
19730.0;2023;32;GUADELOUPE;MASCULIN;SCOLAIRE;BAC PROFESSIONNEL;BAC PRO SERV;BAC PRO 33003 ACC.SOINS-S.PERS. OPT.A DOMICILE;12;12;8;4;0;0;0;8;0;0;0;5;3;4
19737.0;2023;32;GUADELOUPE;MASCULIN;SCOLAIRE;BAC PROFESSIONNEL;BAC PRO SERV;BAC PRO AG 33002 SERV PERS TERRIT;11;11;10;1;0;0;0;10;0;0;1;3;6;1
19741.0;2023;32;GUADELOUPE;MASCULIN;SCOLAIRE;BAC TECHNOLOGIQUE;BAC ST2S;BAC ST2S SCIENCES & TECHNO. SANTE & SOCIAL;28;28;23;1;4;4;0;27;0;0;1;9;17;1
19751.0;2023;32;GUADELOUPE;MASCULIN;SCOLAIRE;BAC TECHNOLOGIQUE;BAC STMG;BAC STMG GESTION ET FINANCE;63;63;54;1;8;7;1;61;0;2;4;19;36;2
19752.0;2023;32;GUADELOUPE;MASCULIN;SCOLAIRE;BAC TECHNOLOGIQUE;BAC STMG;BAC STMG MERCATIQUE (MARKETING);93;93;64;4;25;23;2;87;0;2;6;24;55;6
19758.0;2023;33;GUYANE;FEMININ;ENSEIGNEMENT A DISTANCE;BAC GENERAL;BAC GENERAL;BAC GENE 10019 BAC GENERAL;3;3;3;0;0;0;0;3;0;0;1;1;1;0
19759.0;2023;33;GUYANE;FEMININ;FORMATION CONTINUE;BAC PROFESSIONNEL;BAC PRO SERV;BAC PRO 30004 ASSISTANC.GEST.ORGANIS.ACTIVITES;1;0;0;0;0;0;0;0;0;0;0;0;0;0
19760.0;2023;33;GUYANE;FEMININ;FORMATION CONTINUE;BAC PROFESSIONNEL;BAC PRO SERV;BAC PRO 31213 MET.COM.VEN.OP.A ANI.GES.ESP.COM.;12;10;5;4;1;1;0;6;0;0;3;0;3;4
19763.0;2023;33;GUYANE;FEMININ;INDIVIDUEL;BAC PROFESSIONNEL;BAC PRO PROD;BAC PRO 22106 CUISINE;1;0;0;0;0;0;0;0;0;0;0;0;0;0
19764.0;2023;33;GUYANE;FEMININ;INDIVIDUEL;BAC PROFESSIONNEL;BAC PRO PROD;BAC PRO 23203 TECHNICIEN BAT. : ORG.REAL.GROS O;1;0;0;0;0;0;0;0;0;0;0;0;0;0
19767.0;2023;33;GUYANE;FEMININ;INDIVIDUEL;BAC PROFESSIONNEL;BAC PRO PROD;BAC PRO AG 21114 CONDUITE PRODUCTIONS HORTICOLES;1;1;1;0;0;0;0;1;0;0;0;0;1;0
19771.0;2023;33;GUYANE;FEMININ;INDIVIDUEL;BAC PROFESSIONNEL;BAC PRO SERV;BAC PRO 31213 MET.COM.VEN.OP.A ANI.GES.ESP.COM.;5;1;0;1;0;0;0;0;0;0;0;0;0;1
19774.0;2023;33;GUYANE;FEMININ;INDIVIDUEL;BAC PROFESSIONNEL;BAC PRO SERV;BAC PRO 33003 ACC.SOINS-S.PERS. OPT.A DOMICILE;1;1;0;1;0;0;0;0;0;0;0;0;0;1
19780.0;2023;33;GUYANE;FEMININ;SCOLAIRE;BAC PROFESSIONNEL;BAC PRO PROD;BAC PRO 22104 BOUCHER CHARCUTIER TRAITEUR;6;6;3;1;2;2;0;5;0;0;0;1;4;1
19783.0;2023;33;GUYANE;FEMININ;SCOLAIRE;BAC PROFESSIONNEL;BAC PRO PROD;BAC PRO 23004 TECHN. ETUDES BAT.A ETUDES & ECO.;13;13;2;11;0;0;0;2;0;0;0;1;1;11
19785.0;2023;33;GUYANE;FEMININ;SCOLAIRE;BAC PROFESSIONNEL;BAC PRO PROD;BACPRO 23103 TECHNICIEN GEOMETRE-TOPOGRAPHE;3;3;1;2;0;0;0;1;0;0;0;1;0;2
19788.0;2023;33;GUYANE;FEMININ;SCOLAIRE;BAC PROFESSIONNEL;BAC PRO PROD;BAC PRO 23304 AMENAGEMENT FINITION BATIMENT;4;4;2;2;0;0;0;2;0;0;0;0;2;2
19792.0;2023;33;GUYANE;FEMININ;SCOLAIRE;BAC PROFESSIONNEL;BAC PRO PROD;BAC PRO 25007 MAINTENANCE EQUIPEMENTS INDUST.;1;1;1;0;0;0;0;1;0;0;0;1;0;0
19796.0;2023;33;GUYANE;FEMININ;SCOLAIRE;BAC PROFESSIONNEL;BAC PRO PROD;BAC PRO 25510 METIERS ELECT. ENVIRON. CONNECTES;2;2;0;0;2;2;0;2;0;0;0;0;2;0
19797.0;2023;33;GUYANE;FEMININ;SCOLAIRE;BAC PROFESSIONNEL;BAC PRO PROD;BAC PRO 25513 SYST.NUM.OPT.A SURETE SECURITE;2;2;1;1;0;0;0;1;0;0;0;0;1;1
19804.0;2023;33;GUYANE;FEMININ;SCOLAIRE;BAC PROFESSIONNEL;BAC PRO SERV;BAC PRO 31209 POISSONIER ECAILLER TRAITEUR;2;2;0;0;2;1;1;1;0;0;0;0;1;1
19809.0;2023;33;GUYANE;FEMININ;SCOLAIRE;BAC PROFESSIONNEL;BAC PRO SERV;BAC PRO 33002 SERVICES DE PROXIMITE  VIE LOCAL;3;3;1;2;0;0;0;1;0;0;0;0;1;2
19816.0;2023;33;GUYANE;FEMININ;SCOLAIRE;BAC PROFESSIONNEL;BAC PRO SERV;BAC PRO 34403 METIERS DE LA SECURITE;10;10;6;2;2;2;0;8;0;0;2;1;5;2
19819.0;2023;33;GUYANE;FEMININ;SCOLAIRE;BAC TECHNOLOGIQUE;BAC STAV;BAC STAV AGRONOMIE ALIM ENV TERRITOI;5;5;5;0;0;0;0;5;0;0;1;1;3;0
19823.0;2023;33;GUYANE;FEMININ;SCOLAIRE;BAC TECHNOLOGIQUE;BAC STI2D;BAC STI2D INNOVATION TECHNO.  ET ECO CONCEPTION;2;2;1;0;1;0;1;1;0;0;0;0;1;1
19824.0;2023;33;GUYANE;FEMININ;SCOLAIRE;BAC TECHNOLOGIQUE;BAC STI2D;BAC STI2D SYSTÈME D'INFORMATION  ET NUMERIQUE;1;1;1;0;0;0;0;1;0;0;0;1;0;0
19830.0;2023;33;GUYANE;FEMININ;SCOLAIRE;BAC TECHNOLOGIQUE;BAC STMG;BAC STMG SYSTEMES D'INFORMATION DE GESTION;9;9;4;1;4;4;0;8;0;0;0;0;8;1
19831.0;2023;33;GUYANE;MASCULIN;APPRENTISSAGE;BAC PROFESSIONNEL;BAC PRO PROD;BAC PRO 22704 TECHN. MAINT. SYST.ENERG.CLIMATI;1;1;1;0;0;0;0;1;0;0;0;0;1;0
19833.0;2023;33;GUYANE;MASCULIN;APPRENTISSAGE;BAC PROFESSIONNEL;BAC PRO PROD;BAC PRO 25509 TECHNIC. FROID CONDITIONNEMT AIR;1;1;0;1;0;0;0;0;0;0;0;0;0;1
19844.0;2023;33;GUYANE;MASCULIN;INDIVIDUEL;BAC PROFESSIONNEL;BAC PRO PROD;BAC PRO 25515 SYST.NUM.OPT.C RES.INF.SYST.COMM.;2;1;0;1;0;0;0;0;0;0;0;0;0;1
19847.0;2023;33;GUYANE;MASCULIN;INDIVIDUEL;BAC PROFESSIONNEL;BAC PRO SERV;BAC PRO 31213 MET.COM.VEN.OP.A ANI.GES.ESP.COM.;7;4;2;1;1;1;0;3;0;0;0;0;3;1
19849.0;2023;33;GUYANE;MASCULIN;INDIVIDUEL;BAC PROFESSIONNEL;BAC PRO SERV;BAC PRO 32303 ART.& MET.ART:COM.VIS.VIS.PLURI-M;1;1;1;0;0;0;0;1;0;0;0;0;1;0
19850.0;2023;33;GUYANE;MASCULIN;INDIVIDUEL;BAC PROFESSIONNEL;BAC PRO SERV;BAC PRO 34303 GEST. POLLUTIONS PROTEC. ENVIRON.;1;1;0;1;0;0;0;0;0;0;0;0;0;1
19856.0;2023;33;GUYANE;MASCULIN;SCOLAIRE;BAC PROFESSIONNEL;BAC PRO PROD;BAC PRO 22104 BOUCHER CHARCUTIER TRAITEUR;7;7;6;0;1;1;0;7;0;0;0;2;5;0
19858.0;2023;33;GUYANE;MASCULIN;SCOLAIRE;BAC PROFESSIONNEL;BAC PRO PROD;BAC PRO 22704 TECHN. MAINT. SYST.ENERG.CLIMATI;16;16;6;6;4;4;0;10;0;0;0;3;7;6
19865.0;2023;33;GUYANE;MASCULIN;SCOLAIRE;BAC PROFESSIONNEL;BAC PRO PROD;BAC PRO 23303 MENUISERIE ALUMINIUM-VERRE;10;10;8;2;0;0;0;8;0;0;0;2;6;2
19871.0;2023;33;GUYANE;MASCULIN;SCOLAIRE;BAC PROFESSIONNEL;BAC PRO PROD;BAC PRO 25214 MAINT.VEHIC.OPTA VOIT.PARTICUL.;50;49;22;20;7;6;1;28;0;0;2;9;17;21
19874.0;2023;33;GUYANE;MASCULIN;SCOLAIRE;BAC PROFESSIONNEL;BAC PRO PROD;BAC PRO 25509 TECHNIC. FROID CONDITIONNEMT AIR;35;35;17;10;8;6;2;23;0;0;0;7;16;12
19877.0;2023;33;GUYANE;MASCULIN;SCOLAIRE;BAC PROFESSIONNEL;BAC PRO PROD;BAC PRO 25515 SYST.NUM.OPT.C RES.INF.SYST.COMM.;12;12;12;0;0;0;0;12;0;2;2;5;3;0
19881.0;2023;33;GUYANE;MASCULIN;SCOLAIRE;BAC PROFESSIONNEL;BAC PRO PROD;BAC PRO AG 22108 TEC CONS VTE ALIMENTATION (PAB);7;7;7;0;0;0;0;7;0;0;0;1;6;0
19882.0;2023;33;GUYANE;MASCULIN;SCOLAIRE;BAC PROFESSIONNEL;BAC PRO SERV;BAC PRO 30004 ASSISTANC.GEST.ORGANIS.ACTIVITES;51;51;31;10;10;10;0;41;0;1;2;12;26;10
19884.0;2023;33;GUYANE;MASCULIN;SCOLAIRE;BAC PROFESSIONNEL;BAC PRO SERV;BAC PRO 31209 POISSONIER ECAILLER TRAITEUR;8;8;4;3;1;0;1;4;0;0;0;0;4;4
19892.0;2023;33;GUYANE;MASCULIN;SCOLAIRE;BAC PROFESSIONNEL;BAC PRO SERV;BAC PRO 33006 ANIMAT. ENFANCE& PERSONNES AGEES;6;6;2;4;0;0;0;2;0;0;2;0;0;4
19893.0;2023;33;GUYANE;MASCULIN;SCOLAIRE;BAC PROFESSIONNEL;BAC PRO SERV;BAC PRO 33403 COMMERC. SERVICES EN RESTAURATION;5;5;2;3;0;0;0;2;0;0;0;2;0;3
19906.0;2023;33;GUYANE;MASCULIN;SCOLAIRE;BAC TECHNOLOGIQUE;BAC STL;BAC STL SCIENCES PHYSIQUES CHIMIQUES  EN LABORAT.;17;17;11;2;4;1;3;12;1;0;1;5;5;5
19907.0;2023;33;GUYANE;MASCULIN;SCOLAIRE;BAC TECHNOLOGIQUE;BAC STMG;BAC STMG GESTION ET FINANCE;39;39;32;4;3;2;1;34;0;1;5;13;15;5
19911.0;2023;28;LA REUNION;FEMININ;APPRENTISSAGE;BAC PROFESSIONNEL;BAC PRO PROD;BAC PRO 22106 CUISINE;2;2;2;0;0;0;0;2;0;0;0;2;0;0
19918.0;2023;28;LA REUNION;FEMININ;ENSEIGNEMENT A DISTANCE;BAC TECHNOLOGIQUE;BAC ST2S;BAC ST2S SCIENCES & TECHNO. SANTE & SOCIAL;1;1;1;0;0;0;0;1;0;0;0;0;1;0
19924.0;2023;28;LA REUNION;FEMININ;INDIVIDUEL;BAC PROFESSIONNEL;BAC PRO SERV;BAC PRO 31213 MET.COM.VEN.OP.A ANI.GES.ESP.COM.;1;0;0;0;0;0;0;0;0;0;0;0;0;0
19925.0;2023;28;LA REUNION;FEMININ;INDIVIDUEL;BAC PROFESSIONNEL;BAC PRO SERV;BAC PRO 31214 MET.COM.VEN.OP.B PR.CL.VA.OF.COM.;1;0;0;0;0;0;0;0;0;0;0;0;0;0
19927.0;2023;28;LA REUNION;FEMININ;INDIVIDUEL;BAC PROFESSIONNEL;BAC PRO SERV;BAC PRO 33002 SERVICES DE PROXIMITE  VIE LOCAL;1;1;0;1;0;0;0;0;0;0;0;0;0;1
19928.0;2023;28;LA REUNION;FEMININ;INDIVIDUEL;BAC PROFESSIONNEL;BAC PRO SERV;BAC PRO 33004 ACC.SOINS-S.PERS. OPT.EN STRUCTUR;1;1;0;1;0;0;0;0;0;0;0;0;0;1
19931.0;2023;28;LA REUNION;FEMININ;INDIVIDUEL;BAC TECHNOLOGIQUE;BAC STL;BAC STL BIOCHIM.-BIOLOGIE-BIOTECHNOL.;1;1;1;0;0;0;0;1;0;0;0;0;1;0
19932.0;2023;28;LA REUNION;FEMININ;INDIVIDUEL;BAC TECHNOLOGIQUE;BAC STMG;BAC STMG GESTION ET FINANCE;2;2;2;0;0;0;0;2;0;0;0;1;1;0
19933.0;2023;28;LA REUNION;FEMININ;INDIVIDUEL;BAC TECHNOLOGIQUE;BAC STMG;BAC STMG RESSOURCES HUMAINES ET COMMUNICATION;3;3;0;2;1;1;0;1;0;0;0;0;1;2
19934.0;2023;28;LA REUNION;FEMININ;SCOLAIRE;BAC GENERAL;BAC GENERAL;BAC GENE 10019 BAC GENERAL;3151;3151;2859;54;238;172;66;3031;70;408;737;919;897;120
19939.0;2023;28;LA REUNION;FEMININ;SCOLAIRE;BAC PROFESSIONNEL;BAC PRO PROD;BAC PRO 22105 BOULANGER-PÂTISSIER;7;7;7;0;0;0;0;7;0;0;2;4;1;0
19940.0;2023;28;LA REUNION;FEMININ;SCOLAIRE;BAC PROFESSIONNEL;BAC PRO PROD;BAC PRO 22106 CUISINE;10;10;10;0;0;0;0;10;0;1;1;4;4;0
19941.0;2023;28;LA REUNION;FEMININ;SCOLAIRE;BAC PROFESSIONNEL;BAC PRO PROD;BAC PRO 22503 PLASTIQUES ET COMPOSITES;1;1;0;1;0;0;0;0;0;0;0;0;0;1
19942.0;2023;28;LA REUNION;FEMININ;SCOLAIRE;BAC PROFESSIONNEL;BAC PRO PROD;BAC PRO 22704 TECHN. MAINT. SYST.ENERG.CLIMATI;1;1;1;0;0;0;0;1;0;0;0;1;0;0
19950.0;2023;28;LA REUNION;FEMININ;SCOLAIRE;BAC PROFESSIONNEL;BAC PRO PROD;BAC PRO 23303 MENUISERIE ALUMINIUM-VERRE;2;2;2;0;0;0;0;2;0;0;2;0;0;0
19955.0;2023;28;LA REUNION;FEMININ;SCOLAIRE;BAC PROFESSIONNEL;BAC PRO PROD;BAC PRO 25007 MAINTENANCE EQUIPEMENTS INDUST.;5;5;3;2;0;0;0;3;0;0;0;1;2;2
19962.0;2023;28;LA REUNION;FEMININ;SCOLAIRE;BAC PROFESSIONNEL;BAC PRO PROD;BAC PRO 25514 SYST.NUM.OPT.B AUD.RES.EQUIP.DOM.;2;2;2;0;0;0;0;2;0;0;1;0;1;0
19968.0;2023;28;LA REUNION;FEMININ;SCOLAIRE;BAC PROFESSIONNEL;BAC PRO PROD;BAC PRO AG 21407 TEC CONS VTE UNIVERS JARDINERIE;1;1;0;1;0;0;0;0;0;0;0;0;0;1
19972.0;2023;28;LA REUNION;FEMININ;SCOLAIRE;BAC PROFESSIONNEL;BAC PRO SERV;BAC PRO 31114 ORGANIS. TRANSPORT MARCHANDISES;15;15;11;3;1;1;0;12;0;2;0;7;3;3
19980.0;2023;28;LA REUNION;FEMININ;SCOLAIRE;BAC PROFESSIONNEL;BAC PRO SERV;BAC PRO 33004 ACC.SOINS-S.PERS. OPT.EN STRUCTUR;143;143;120;14;9;9;0;129;0;5;25;63;36;14
19990.0;2023;28;LA REUNION;FEMININ;SCOLAIRE;BAC TECHNOLOGIQUE;BAC STAV;BAC STAV AGRONOMIE ALIM ENV TERRITOI;14;13;12;1;0;0;0;12;0;0;1;3;8;1
19998.0;2023;28;LA REUNION;FEMININ;SCOLAIRE;BAC TECHNOLOGIQUE;BAC STL;BAC STL SCIENCES PHYSIQUES CHIMIQUES  EN LABORAT.;20;20;14;2;4;3;1;17;1;2;2;4;8;3
9.0;2021;02;AIX-MARSEILLE;FEMININ;APPRENTISSAGE;BAC PROFESSIONNEL;BAC PRO PROD;BAC PRO AG 21203 TECHN CONSEIL DE VENTE ANIMAL;4;4;4;0;0;0;0;4;0;0;1;0;3;0
12.0;2021;02;AIX-MARSEILLE;FEMININ;APPRENTISSAGE;BAC PROFESSIONNEL;BAC PRO PROD;BAC PRO AG 22105 LABORATOIRE CONTROLE QUALITE;1;1;1;0;0;0;0;1;0;0;1;0;0;0
13.0;2021;02;AIX-MARSEILLE;FEMININ;APPRENTISSAGE;BAC PROFESSIONNEL;BAC PRO PROD;BAC PRO AG 22107 TEC CONS VTE ALIMENTATION P.ALIM;1;1;1;0;0;0;0;1;0;0;0;1;0;0
20.0;2021;02;AIX-MARSEILLE;FEMININ;APPRENTISSAGE;BAC PROFESSIONNEL;BAC PRO SERV;BAC PRO 33101 OPTIQUE LUNETTERIE;1;1;1;0;0;0;0;1;0;0;0;1;0;0
37.0;2021;02;AIX-MARSEILLE;FEMININ;ENSEIGNEMENT A DISTANCE;BAC TECHNOLOGIQUE;BAC STMG;BAC STMG SYSTEMES D'INFORMATION DE GESTION;1;1;1;0;0;0;0;1;0;0;0;0;1;0
43.0;2021;02;AIX-MARSEILLE;FEMININ;FORMATION CONTINUE;BAC PROFESSIONNEL;BAC PRO SERV;BAC PRO 32304 PHOTOGRAPHIE;5;4;2;2;0;0;0;2;0;1;0;0;1;2
44.0;2021;02;AIX-MARSEILLE;FEMININ;FORMATION CONTINUE;BAC PROFESSIONNEL;BAC PRO SERV;BAC PRO 33102 PROTHESE DENTAIRE;3;3;3;0;0;0;0;3;0;0;0;2;1;0
50.0;2021;02;AIX-MARSEILLE;FEMININ;INDIVIDUEL;BAC PROFESSIONNEL;BAC PRO PROD;BAC PRO 25215 MAINT.VEHIC.OPTB VEHIC.TRANS.ROUT;1;0;0;0;0;0;0;0;0;0;0;0;0;0
52.0;2021;02;AIX-MARSEILLE;FEMININ;INDIVIDUEL;BAC PROFESSIONNEL;BAC PRO PROD;BAC PRO AG 21113 CGEVV;1;0;0;0;0;0;0;0;0;0;0;0;0;0
54.0;2021;02;AIX-MARSEILLE;FEMININ;INDIVIDUEL;BAC PROFESSIONNEL;BAC PRO PROD;BAC PRO AG 21211 COND GEST ENTR HIPPIQUE;3;3;2;1;0;0;0;2;0;0;0;0;2;1
60.0;2021;02;AIX-MARSEILLE;FEMININ;INDIVIDUEL;BAC PROFESSIONNEL;BAC PRO SERV;BAC PRO 33002 SERVICES DE PROXIMITE  VIE LOCAL;1;0;0;0;0;0;0;0;0;0;0;0;0;0
62.0;2021;02;AIX-MARSEILLE;FEMININ;INDIVIDUEL;BAC PROFESSIONNEL;BAC PRO SERV;BAC PRO 33004 ACC.SOINS-S.PERS. OPT.EN STRUCTUR;10;7;2;2;3;1;2;3;0;0;0;0;3;4
68.0;2021;02;AIX-MARSEILLE;FEMININ;INDIVIDUEL;BAC TECHNOLOGIQUE;BAC STD2A;BAC STD2A SCIENCES & TECHNO. DESIGN-ARTS APPLIQUES;2;1;1;0;0;0;0;1;0;0;1;0;0;0
70.0;2021;02;AIX-MARSEILLE;FEMININ;INDIVIDUEL;BAC TECHNOLOGIQUE;BAC STL;BAC STL SCIENCES PHYSIQUES CHIMIQUES  EN LABORAT.;1;0;0;0;0;0;0;0;0;0;0;0;0;0
82.0;2021;02;AIX-MARSEILLE;FEMININ;SCOLAIRE;BAC PROFESSIONNEL;BAC PRO PROD;BAC PRO 23004 TECHN. ETUDES BAT.A ETUDES & ECO.;3;3;2;0;1;1;0;3;0;0;1;0;2;0
86.0;2021;02;AIX-MARSEILLE;FEMININ;SCOLAIRE;BAC PROFESSIONNEL;BAC PRO PROD;BAC PRO 23408 Etude et réalisation d'agencement;4;4;4;0;0;0;0;4;0;0;0;2;2;0
89.0;2021;02;AIX-MARSEILLE;FEMININ;SCOLAIRE;BAC PROFESSIONNEL;BAC PRO PROD;BAC PRO 25007 MAINTENANCE EQUIPEMENTS INDUST.;2;2;2;0;0;0;0;2;0;0;0;0;2;0
96.0;2021;02;AIX-MARSEILLE;FEMININ;SCOLAIRE;BAC PROFESSIONNEL;BAC PRO PROD;BAC PRO 25406 OUVRAGES DU BATIMENT METALLERIE;1;1;1;0;0;0;0;1;0;0;0;0;1;0
101.0;2021;02;AIX-MARSEILLE;FEMININ;SCOLAIRE;BAC PROFESSIONNEL;BAC PRO PROD;BAC PRO 25515 SYST.NUM.OPT.C RES.INF.SYST.COMM.;12;12;8;2;2;1;1;9;0;0;2;5;2;3
103.0;2021;02;AIX-MARSEILLE;FEMININ;SCOLAIRE;BAC PROFESSIONNEL;BAC PRO PROD;BAC PRO AG 21113 CGEVV;3;2;2;0;0;0;0;2;0;0;0;1;1;0
111.0;2021;02;AIX-MARSEILLE;FEMININ;SCOLAIRE;BAC PROFESSIONNEL;BAC PRO PROD;BAC PRO AG 22107 TEC CONS VTE ALIMENTATION P.ALIM;24;22;20;2;0;0;0;20;0;1;0;7;12;2
112.0;2021;02;AIX-MARSEILLE;FEMININ;SCOLAIRE;BAC PROFESSIONNEL;BAC PRO SERV;BAC PRO 30001 GESTION-ADMINISTRATION;844;842;688;120;34;19;15;707;0;14;155;243;295;135
116.0;2021;02;AIX-MARSEILLE;FEMININ;SCOLAIRE;BAC PROFESSIONNEL;BAC PRO SERV;BAC PRO 31202 COMMERCE;330;330;276;23;31;21;10;297;0;14;64;118;101;33
123.0;2021;02;AIX-MARSEILLE;FEMININ;SCOLAIRE;BAC PROFESSIONNEL;BAC PRO SERV;BAC PRO 33002 SERVICES DE PROXIMITE  VIE LOCAL;79;79;64;8;7;4;3;68;0;1;10;27;30;11
124.0;2021;02;AIX-MARSEILLE;FEMININ;SCOLAIRE;BAC PROFESSIONNEL;BAC PRO SERV;BAC PRO 33003 ACC.SOINS-S.PERS. OPT.A DOMICILE;118;117;95;16;6;5;1;100;0;4;23;47;26;17
125.0;2021;02;AIX-MARSEILLE;FEMININ;SCOLAIRE;BAC PROFESSIONNEL;BAC PRO SERV;BAC PRO 33004 ACC.SOINS-S.PERS. OPT.EN STRUCTUR;615;614;532;48;34;20;14;552;0;34;141;209;168;62
127.0;2021;02;AIX-MARSEILLE;FEMININ;SCOLAIRE;BAC PROFESSIONNEL;BAC PRO SERV;BAC PRO 33102 PROTHESE DENTAIRE;9;9;6;3;0;0;0;6;0;0;0;3;3;3
133.0;2021;02;AIX-MARSEILLE;FEMININ;SCOLAIRE;BAC PROFESSIONNEL;BAC PRO SERV;BAC PRO AG 33002 SERV PERS TERRIT;216;212;201;11;0;0;0;201;0;8;23;95;75;11
141.0;2021;02;AIX-MARSEILLE;FEMININ;SCOLAIRE;BAC TECHNOLOGIQUE;BAC STI2D;BAC STI2D SYSTÈME D'INFORMATION  ET NUMERIQUE;21;21;19;0;2;2;0;21;0;5;2;7;7;0
142.0;2021;02;AIX-MARSEILLE;FEMININ;SCOLAIRE;BAC TECHNOLOGIQUE;BAC STL;BAC STL BIOCHIM.-BIOLOGIE-BIOTECHNOL.;125;125;120;0;5;3;2;123;0;2;25;44;52;2
146.0;2021;02;AIX-MARSEILLE;FEMININ;SCOLAIRE;BAC TECHNOLOGIQUE;BAC STMG;BAC STMG RESSOURCES HUMAINES ET COMMUNICATION;618;618;557;10;51;21;30;578;0;4;86;236;252;40
150.0;2021;02;AIX-MARSEILLE;MASCULIN;APPRENTISSAGE;BAC PROFESSIONNEL;BAC PRO PROD;BAC PRO 22703 TECHN.INSTALL.SYST.ENERG.CLIMATI;22;20;15;3;2;1;1;16;0;0;1;7;8;4
156.0;2021;02;AIX-MARSEILLE;MASCULIN;APPRENTISSAGE;BAC PROFESSIONNEL;BAC PRO PROD;BAC PRO 25007 MAINTENANCE EQUIPEMENTS INDUST.;19;19;17;1;1;1;0;18;0;2;3;8;5;1
161.0;2021;02;AIX-MARSEILLE;MASCULIN;APPRENTISSAGE;BAC PROFESSIONNEL;BAC PRO PROD;BAC PRO 25216 MAINT.VEHIC.OPTC MOTOCYCLES;14;13;11;1;1;0;1;11;0;1;5;2;3;2
173.0;2021;02;AIX-MARSEILLE;MASCULIN;APPRENTISSAGE;BAC PROFESSIONNEL;BAC PRO PROD;BAC PRO AG 21203 TECHN CONSEIL DE VENTE ANIMAL;2;2;2;0;0;0;0;2;0;0;0;0;2;0
174.0;2021;02;AIX-MARSEILLE;MASCULIN;APPRENTISSAGE;BAC PROFESSIONNEL;BAC PRO PROD;BAC PRO AG 21211 COND GEST ENTR HIPPIQUE;7;7;6;1;0;0;0;6;0;0;1;3;2;1
187.0;2021;02;AIX-MARSEILLE;MASCULIN;APPRENTISSAGE;BAC PROFESSIONNEL;BAC PRO SERV;BAC PRO 33101 OPTIQUE LUNETTERIE;1;1;1;0;0;0;0;1;0;0;1;0;0;0
188.0;2021;02;AIX-MARSEILLE;MASCULIN;APPRENTISSAGE;BAC PROFESSIONNEL;BAC PRO SERV;BAC PRO 33102 PROTHESE DENTAIRE;11;11;9;1;1;1;0;10;0;0;2;5;3;1
189.0;2021;02;AIX-MARSEILLE;MASCULIN;APPRENTISSAGE;BAC PROFESSIONNEL;BAC PRO SERV;BAC PRO 33403 COMMERC. SERVICES EN RESTAURATION;18;18;15;3;0;0;0;15;0;0;3;7;5;3
193.0;2021;02;AIX-MARSEILLE;MASCULIN;ENSEIGNEMENT A DISTANCE;BAC PROFESSIONNEL;BAC PRO SERV;BAC PRO 31107 CONDUCT. TRANSP.ROUT.MARCHANDISES;1;0;0;0;0;0;0;0;0;0;0;0;0;0
198.0;2021;02;AIX-MARSEILLE;MASCULIN;ENSEIGNEMENT A DISTANCE;BAC TECHNOLOGIQUE;BAC STMG;BAC STMG RESSOURCES HUMAINES ET COMMUNICATION;6;5;5;0;0;0;0;5;0;0;1;3;1;0
207.0;2021;02;AIX-MARSEILLE;MASCULIN;FORMATION CONTINUE;BAC PROFESSIONNEL;BAC PRO PROD;BAC PRO 25513 SYST.NUM.OPT.A SURETE SECURITE;10;7;6;1;0;0;0;6;0;0;0;1;5;1
208.0;2021;02;AIX-MARSEILLE;MASCULIN;FORMATION CONTINUE;BAC PROFESSIONNEL;BAC PRO SERV;BAC PRO 30001 GESTION-ADMINISTRATION;6;4;4;0;0;0;0;4;0;1;1;1;1;0
209.0;2021;02;AIX-MARSEILLE;MASCULIN;FORMATION CONTINUE;BAC PROFESSIONNEL;BAC PRO SERV;BAC PRO 31202 COMMERCE;2;2;1;0;1;1;0;2;0;0;0;1;1;0
211.0;2021;02;AIX-MARSEILLE;MASCULIN;FORMATION CONTINUE;BAC PROFESSIONNEL;BAC PRO SERV;BAC PRO 31210 ACCUEIL -RELATION CLIENTS USAGERS;5;5;4;0;1;1;0;5;0;0;3;1;1;0
213.0;2021;02;AIX-MARSEILLE;MASCULIN;FORMATION CONTINUE;BAC PROFESSIONNEL;BAC PRO SERV;BAC PRO 33403 COMMERC. SERVICES EN RESTAURATION;1;1;0;1;0;0;0;0;0;0;0;0;0;1
214.0;2021;02;AIX-MARSEILLE;MASCULIN;INDIVIDUEL;BAC GENERAL;BAC GENERAL;BAC GENE 10019 BAC GENERAL;143;95;54;28;13;12;1;66;0;5;11;8;42;29
216.0;2021;02;AIX-MARSEILLE;MASCULIN;INDIVIDUEL;BAC PROFESSIONNEL;BAC PRO PROD;BAC PRO 22004 PROC. CHIMIE EAU PAPIERS-CARTONS;1;0;0;0;0;0;0;0;0;0;0;0;0;0
224.0;2021;02;AIX-MARSEILLE;MASCULIN;INDIVIDUEL;BAC PROFESSIONNEL;BAC PRO PROD;BAC PRO 25514 SYST.NUM.OPT.B AUD.RES.EQUIP.DOM.;1;0;0;0;0;0;0;0;0;0;0;0;0;0
225.0;2021;02;AIX-MARSEILLE;MASCULIN;INDIVIDUEL;BAC PROFESSIONNEL;BAC PRO PROD;BAC PRO 25515 SYST.NUM.OPT.C RES.INF.SYST.COMM.;1;0;0;0;0;0;0;0;0;0;0;0;0;0
232.0;2021;02;AIX-MARSEILLE;MASCULIN;INDIVIDUEL;BAC PROFESSIONNEL;BAC PRO SERV;BAC PRO 30001 GESTION-ADMINISTRATION;10;6;2;4;0;0;0;2;0;0;0;1;1;4
237.0;2021;02;AIX-MARSEILLE;MASCULIN;INDIVIDUEL;BAC PROFESSIONNEL;BAC PRO SERV;BAC PRO 32207 REAL.PR.IMPR.PLURI.OPTA.PR.GRAPH.;1;1;1;0;0;0;0;1;0;0;0;0;1;0
238.0;2021;02;AIX-MARSEILLE;MASCULIN;INDIVIDUEL;BAC PROFESSIONNEL;BAC PRO SERV;BAC PRO 32303 ART.& MET.ART:COM.VIS.VIS.PLURI-M;1;0;0;0;0;0;0;0;0;0;0;0;0;0
242.0;2021;02;AIX-MARSEILLE;MASCULIN;INDIVIDUEL;BAC TECHNOLOGIQUE;BAC STAV;BAC STAV AGRONOMIE ALIM ENV TERRITOI;2;2;2;0;0;0;0;2;0;0;0;0;2;0
243.0;2021;02;AIX-MARSEILLE;MASCULIN;INDIVIDUEL;BAC TECHNOLOGIQUE;BAC STHR;BAC STHR SC.&TEC. HOTELLERIE-RESTAURATION;4;4;4;0;0;0;0;4;0;0;0;4;0;0
244.0;2021;02;AIX-MARSEILLE;MASCULIN;INDIVIDUEL;BAC TECHNOLOGIQUE;BAC STI2D;BAC STI2D ARCHITECTURE ET CONSTRUCTION;1;0;0;0;0;0;0;0;0;0;0;0;0;0
251.0;2021;02;AIX-MARSEILLE;MASCULIN;INDIVIDUEL;BAC TECHNOLOGIQUE;BAC STMG;BAC STMG RESSOURCES HUMAINES ET COMMUNICATION;16;12;10;2;0;0;0;10;0;0;1;9;0;2
258.0;2021;02;AIX-MARSEILLE;MASCULIN;SCOLAIRE;BAC PROFESSIONNEL;BAC PRO PROD;BAC PRO 22105 BOULANGER-PÂTISSIER;8;8;8;0;0;0;0;8;0;0;0;7;1;0
259.0;2021;02;AIX-MARSEILLE;MASCULIN;SCOLAIRE;BAC PROFESSIONNEL;BAC PRO PROD;BAC PRO 22106 CUISINE;72;72;65;5;2;0;2;65;0;4;11;28;22;7
264.0;2021;02;AIX-MARSEILLE;MASCULIN;SCOLAIRE;BAC PROFESSIONNEL;BAC PRO PROD;BAC PRO 23004 TECHN. ETUDES BAT.A ETUDES & ECO.;49;49;37;9;3;3;0;40;0;3;9;9;19;9
265.0;2021;02;AIX-MARSEILLE;MASCULIN;SCOLAIRE;BAC PROFESSIONNEL;BAC PRO PROD;BAC PRO 23005 TECHN. ETUDES BAT B ASSIST.ARCHI.;37;37;32;5;0;0;0;32;0;2;6;15;9;5
266.0;2021;02;AIX-MARSEILLE;MASCULIN;SCOLAIRE;BAC PROFESSIONNEL;BAC PRO PROD;BAC PRO 23102 TRAVAUX PUBLICS;35;35;28;3;4;2;2;30;0;2;6;8;14;5
274.0;2021;02;AIX-MARSEILLE;MASCULIN;SCOLAIRE;BAC PROFESSIONNEL;BAC PRO PROD;BAC PRO 23408 Etude et réalisation d'agencement;5;5;3;1;1;1;0;4;0;0;0;1;3;1
276.0;2021;02;AIX-MARSEILLE;MASCULIN;SCOLAIRE;BAC PROFESSIONNEL;BAC PRO PROD;BAC PRO 25006 MICROTECHNIQUES;22;22;19;3;0;0;0;19;0;2;4;8;5;3
277.0;2021;02;AIX-MARSEILLE;MASCULIN;SCOLAIRE;BAC PROFESSIONNEL;BAC PRO PROD;BAC PRO 25007 MAINTENANCE EQUIPEMENTS INDUST.;258;256;193;43;20;14;6;207;0;11;43;78;75;49
297.0;2021;02;AIX-MARSEILLE;MASCULIN;SCOLAIRE;BAC PROFESSIONNEL;BAC PRO PROD;BAC PRO 25515 SYST.NUM.OPT.C RES.INF.SYST.COMM.;259;259;221;24;14;11;3;232;0;15;51;81;85;27
312.0;2021;02;AIX-MARSEILLE;MASCULIN;SCOLAIRE;BAC PROFESSIONNEL;BAC PRO SERV;BAC PRO 31107 CONDUCT. TRANSP.ROUT.MARCHANDISES;85;85;66;16;3;3;0;69;0;2;9;32;26;16
333.0;2021;02;AIX-MARSEILLE;MASCULIN;SCOLAIRE;BAC TECHNOLOGIQUE;BAC STD2A;BAC STD2A SCIENCES & TECHNO. DESIGN-ARTS APPLIQUES;43;43;41;0;2;2;0;43;0;7;9;19;8;0
335.0;2021;02;AIX-MARSEILLE;MASCULIN;SCOLAIRE;BAC TECHNOLOGIQUE;BAC STI2D;BAC STI2D ARCHITECTURE ET CONSTRUCTION;125;125;110;1;14;7;7;117;0;0;15;47;55;8
339.0;2021;02;AIX-MARSEILLE;MASCULIN;SCOLAIRE;BAC TECHNOLOGIQUE;BAC STL;BAC STL BIOCHIM.-BIOLOGIE-BIOTECHNOL.;89;89;81;2;6;4;2;85;0;2;11;27;45;4
343.0;2021;02;AIX-MARSEILLE;MASCULIN;SCOLAIRE;BAC TECHNOLOGIQUE;BAC STMG;BAC STMG RESSOURCES HUMAINES ET COMMUNICATION;311;311;261;17;33;15;18;276;0;2;24;94;156;35
344.0;2021;02;AIX-MARSEILLE;MASCULIN;SCOLAIRE;BAC TECHNOLOGIQUE;BAC STMG;BAC STMG SYSTEMES D'INFORMATION DE GESTION;60;60;50;4;6;6;0;56;0;0;6;21;29;4
347.0;2021;20;AMIENS;FEMININ;APPRENTISSAGE;BAC PROFESSIONNEL;BAC PRO PROD;BAC PRO 23102 TRAVAUX PUBLICS;1;1;1;0;0;0;0;1;0;0;0;1;0;0
349.0;2021;20;AMIENS;FEMININ;APPRENTISSAGE;BAC PROFESSIONNEL;BAC PRO PROD;BAC PRO 25214 MAINT.VEHIC.OPTA VOIT.PARTICUL.;1;1;0;1;0;0;0;0;0;0;0;0;0;1
354.0;2021;20;AMIENS;FEMININ;APPRENTISSAGE;BAC PROFESSIONNEL;BAC PRO PROD;BAC PRO AG 21405 AMENAGEMENTS PAYSAGERS;5;5;5;0;0;0;0;5;0;0;0;3;2;0
357.0;2021;20;AMIENS;FEMININ;APPRENTISSAGE;BAC PROFESSIONNEL;BAC PRO SERV;BAC PRO 31106 LOGISTIQUE;7;7;6;0;1;1;0;7;0;0;4;1;2;0
362.0;2021;20;AMIENS;FEMININ;ENSEIGNEMENT A DISTANCE;BAC GENERAL;BAC GENERAL;BAC GENE 10019 BAC GENERAL;33;33;30;2;1;0;1;30;0;3;13;6;8;3
365.0;2021;20;AMIENS;FEMININ;ENSEIGNEMENT A DISTANCE;BAC TECHNOLOGIQUE;BAC STMG;BAC STMG MERCATIQUE (MARKETING);2;2;2;0;0;0;0;2;0;0;0;1;1;0
372.0;2021;20;AMIENS;FEMININ;INDIVIDUEL;BAC PROFESSIONNEL;BAC PRO PROD;BAC PRO 23005 TECHN. ETUDES BAT B ASSIST.ARCHI.;1;0;0;0;0;0;0;0;0;0;0;0;0;0
373.0;2021;20;AMIENS;FEMININ;INDIVIDUEL;BAC PROFESSIONNEL;BAC PRO PROD;BAC PRO 25214 MAINT.VEHIC.OPTA VOIT.PARTICUL.;1;1;1;0;0;0;0;1;0;1;0;0;0;0
377.0;2021;20;AMIENS;FEMININ;INDIVIDUEL;BAC PROFESSIONNEL;BAC PRO PROD;BAC PRO AG 21211 COND GEST ENTR HIPPIQUE;8;6;6;0;0;0;0;6;0;0;0;1;5;0
378.0;2021;20;AMIENS;FEMININ;INDIVIDUEL;BAC PROFESSIONNEL;BAC PRO PROD;BAC PRO AG 21302 GEST MILIEUX NATURELS FAUNE;1;0;0;0;0;0;0;0;0;0;0;0;0;0
381.0;2021;20;AMIENS;FEMININ;INDIVIDUEL;BAC PROFESSIONNEL;BAC PRO SERV;BAC PRO 31202 COMMERCE;7;6;4;2;0;0;0;4;0;0;0;2;2;2
383.0;2021;20;AMIENS;FEMININ;INDIVIDUEL;BAC PROFESSIONNEL;BAC PRO SERV;BAC PRO 31210 ACCUEIL -RELATION CLIENTS USAGERS;4;4;1;3;0;0;0;1;0;0;0;0;1;3
384.0;2021;20;AMIENS;FEMININ;INDIVIDUEL;BAC PROFESSIONNEL;BAC PRO SERV;BAC PRO 32304 PHOTOGRAPHIE;1;0;0;0;0;0;0;0;0;0;0;0;0;0
394.0;2021;20;AMIENS;FEMININ;INDIVIDUEL;BAC TECHNOLOGIQUE;BAC STMG;BAC STMG RESSOURCES HUMAINES ET COMMUNICATION;4;3;0;3;0;0;0;0;0;0;0;0;0;3
395.0;2021;20;AMIENS;FEMININ;SCOLAIRE;BAC GENERAL;BAC GENERAL;BAC GENE 10019 BAC GENERAL;5641;5641;5429;36;176;110;66;5539;163;796;1622;1816;1142;102
397.0;2021;20;AMIENS;FEMININ;SCOLAIRE;BAC PROFESSIONNEL;BAC PRO PROD;BAC PRO 22003 BIO-INDUSTRIES DE TRANSFORMATION;11;11;9;1;1;1;0;10;0;0;2;4;4;1
399.0;2021;20;AMIENS;FEMININ;SCOLAIRE;BAC PROFESSIONNEL;BAC PRO PROD;BAC PRO 22104 BOUCHER CHARCUTIER TRAITEUR;2;2;2;0;0;0;0;2;0;0;1;1;0;0
400.0;2021;20;AMIENS;FEMININ;SCOLAIRE;BAC PROFESSIONNEL;BAC PRO PROD;BAC PRO 22105 BOULANGER-PÂTISSIER;7;7;7;0;0;0;0;7;0;0;6;1;0;0
404.0;2021;20;AMIENS;FEMININ;SCOLAIRE;BAC PROFESSIONNEL;BAC PRO PROD;BAC PRO 23005 TECHN. ETUDES BAT B ASSIST.ARCHI.;10;9;9;0;0;0;0;9;0;0;5;2;2;0
409.0;2021;20;AMIENS;FEMININ;SCOLAIRE;BAC PROFESSIONNEL;BAC PRO PROD;BAC PRO 24203 METIERS DE LA MODE - VÊTEMENT;89;87;68;19;0;0;0;68;0;4;24;19;21;19
413.0;2021;20;AMIENS;FEMININ;SCOLAIRE;BAC PROFESSIONNEL;BAC PRO PROD;BAC PRO 25214 MAINT.VEHIC.OPTA VOIT.PARTICUL.;11;11;11;0;0;0;0;11;0;1;3;6;1;0
419.0;2021;20;AMIENS;FEMININ;SCOLAIRE;BAC PROFESSIONNEL;BAC PRO PROD;BAC PRO 25514 SYST.NUM.OPT.B AUD.RES.EQUIP.DOM.;4;4;3;1;0;0;0;3;0;0;2;1;0;1
420.0;2021;20;AMIENS;FEMININ;SCOLAIRE;BAC PROFESSIONNEL;BAC PRO PROD;BAC PRO 25515 SYST.NUM.OPT.C RES.INF.SYST.COMM.;2;2;2;0;0;0;0;2;0;0;0;1;1;0
425.0;2021;20;AMIENS;FEMININ;SCOLAIRE;BAC PROFESSIONNEL;BAC PRO PROD;BAC PRO AG 21302 GEST MILIEUX NATURELS FAUNE;7;7;7;0;0;0;0;7;0;0;2;0;5;0
426.0;2021;20;AMIENS;FEMININ;SCOLAIRE;BAC PROFESSIONNEL;BAC PRO PROD;BAC PRO AG 21405 AMENAGEMENTS PAYSAGERS;5;5;5;0;0;0;0;5;0;0;2;2;1;0
438.0;2021;20;AMIENS;FEMININ;SCOLAIRE;BAC PROFESSIONNEL;BAC PRO SERV;BAC PRO 33003 ACC.SOINS-S.PERS. OPT.A DOMICILE;158;156;138;13;5;1;4;139;0;4;37;61;37;17
441.0;2021;20;AMIENS;FEMININ;SCOLAIRE;BAC PROFESSIONNEL;BAC PRO SERV;BAC PRO 33403 COMMERC. SERVICES EN RESTAURATION;47;47;32;11;4;4;0;36;0;2;6;17;11;11
443.0;2021;20;AMIENS;FEMININ;SCOLAIRE;BAC PROFESSIONNEL;BAC PRO SERV;BAC PRO 34304 HYGIENE PROPRETE STERILISATION;30;30;26;1;3;1;2;27;0;1;7;9;10;3
446.0;2021;20;AMIENS;FEMININ;SCOLAIRE;BAC TECHNOLOGIQUE;BAC ST2S;BAC ST2S SCIENCES & TECHNO. SANTE & SOCIAL;706;706;623;17;66;26;40;649;0;20;102;232;295;57
451.0;2021;20;AMIENS;FEMININ;SCOLAIRE;BAC TECHNOLOGIQUE;BAC STI2D;BAC STI2D ENERGIES  ET ENVIRONNEMENT;12;12;11;0;1;1;0;12;0;1;4;2;5;0
458.0;2021;20;AMIENS;FEMININ;SCOLAIRE;BAC TECHNOLOGIQUE;BAC STMG;BAC STMG RESSOURCES HUMAINES ET COMMUNICATION;444;444;397;11;36;17;19;414;0;11;55;176;172;30
463.0;2021;20;AMIENS;MASCULIN;APPRENTISSAGE;BAC PROFESSIONNEL;BAC PRO PROD;BAC PRO 22503 PLASTIQUES ET COMPOSITES;1;1;1;0;0;0;0;1;0;0;0;1;0;0
470.0;2021;20;AMIENS;MASCULIN;APPRENTISSAGE;BAC PROFESSIONNEL;BAC PRO PROD;BAC PRO 25219 MAINT.MATERIELS OPT.A AGRICOLES;2;2;2;0;0;0;0;2;0;0;1;0;1;0
472.0;2021;20;AMIENS;MASCULIN;APPRENTISSAGE;BAC PROFESSIONNEL;BAC PRO PROD;BAC PRO 25221 MAINT.MATERIELS OPT.C ESP. VERTS;3;3;2;0;1;0;1;2;0;0;1;1;0;1
479.0;2021;20;AMIENS;MASCULIN;APPRENTISSAGE;BAC PROFESSIONNEL;BAC PRO PROD;BAC PRO AG 21001 AGRO-EQUIPEMENT;16;16;15;1;0;0;0;15;0;0;1;9;5;1
480.0;2021;20;AMIENS;MASCULIN;APPRENTISSAGE;BAC PROFESSIONNEL;BAC PRO PROD;BAC PRO AG 21004 CGEA;5;4;4;0;0;0;0;4;0;0;0;2;2;0
483.0;2021;20;AMIENS;MASCULIN;APPRENTISSAGE;BAC PROFESSIONNEL;BAC PRO PROD;BAC PRO AG 22107 TEC CONS VTE ALIMENTATION P.ALIM;6;6;5;1;0;0;0;5;0;0;0;4;1;1
493.0;2021;20;AMIENS;MASCULIN;FORMATION CONTINUE;BAC PROFESSIONNEL;BAC PRO PROD;BAC PRO 20102 PILOTE DE LIGNE DE PRODUCTION;6;6;6;0;0;0;0;6;0;4;2;0;0;0
499.0;2021;20;AMIENS;MASCULIN;FORMATION CONTINUE;BAC PROFESSIONNEL;BAC PRO PROD;BAC PRO 25509 TECHNIC. FROID CONDITIONNEMT AIR;8;8;7;1;0;0;0;7;0;3;1;0;3;1
501.0;2021;20;AMIENS;MASCULIN;FORMATION CONTINUE;BAC PROFESSIONNEL;BAC PRO SERV;BAC PRO 31202 COMMERCE;1;1;1;0;0;0;0;1;0;0;0;0;1;0
511.0;2021;20;AMIENS;MASCULIN;INDIVIDUEL;BAC PROFESSIONNEL;BAC PRO PROD;BAC PRO 25510 METIERS ELECT. ENVIRON. CONNECTES;2;0;0;0;0;0;0;0;0;0;0;0;0;0
521.0;2021;20;AMIENS;MASCULIN;INDIVIDUEL;BAC PROFESSIONNEL;BAC PRO SERV;BAC PRO 33004 ACC.SOINS-S.PERS. OPT.EN STRUCTUR;1;0;0;0;0;0;0;0;0;0;0;0;0;0
534.0;2021;20;AMIENS;MASCULIN;SCOLAIRE;BAC PROFESSIONNEL;BAC PRO PROD;BACPRO 20002 ETUD.DEFINITION PRDTS INDUSTRIEL;26;26;21;3;2;1;1;22;0;1;5;6;10;4
546.0;2021;20;AMIENS;MASCULIN;SCOLAIRE;BAC PROFESSIONNEL;BAC PRO PROD;BAC PRO 23102 TRAVAUX PUBLICS;3;3;2;1;0;0;0;2;0;0;0;2;0;1
549.0;2021;20;AMIENS;MASCULIN;SCOLAIRE;BAC PROFESSIONNEL;BAC PRO PROD;BAC PRO 23208 METIERS ET ARTS DE LA PIERRE;1;1;1;0;0;0;0;1;0;0;0;1;0;0
552.0;2021;20;AMIENS;MASCULIN;SCOLAIRE;BAC PROFESSIONNEL;BAC PRO PROD;BAC PRO 23404 TECHNICIEN CONSTRUCTEUR BOIS;13;13;10;3;0;0;0;10;0;0;1;3;6;3
559.0;2021;20;AMIENS;MASCULIN;SCOLAIRE;BAC PROFESSIONNEL;BAC PRO PROD;BAC PRO 25007 MAINTENANCE EQUIPEMENTS INDUST.;228;225;163;47;15;9;6;172;0;4;34;68;66;53
563.0;2021;20;AMIENS;MASCULIN;SCOLAIRE;BAC PROFESSIONNEL;BAC PRO PROD;BAC PRO 25214 MAINT.VEHIC.OPTA VOIT.PARTICUL.;186;186;148;30;8;3;5;151;0;11;44;57;39;35
565.0;2021;20;AMIENS;MASCULIN;SCOLAIRE;BAC PROFESSIONNEL;BAC PRO PROD;BAC PRO 25216 MAINT.VEHIC.OPTC MOTOCYCLES;13;13;11;2;0;0;0;11;0;0;4;3;4;2
566.0;2021;20;AMIENS;MASCULIN;SCOLAIRE;BAC PROFESSIONNEL;BAC PRO PROD;BAC PRO 25219 MAINT.MATERIELS OPT.A AGRICOLES;14;14;13;1;0;0;0;13;0;1;1;6;5;1
569.0;2021;20;AMIENS;MASCULIN;SCOLAIRE;BAC PROFESSIONNEL;BAC PRO PROD;BAC PRO 25303 AERONAUTIQUE OPTION SYSTEMES;14;14;14;0;0;0;0;14;0;1;5;5;3;0
570.0;2021;20;AMIENS;MASCULIN;SCOLAIRE;BAC PROFESSIONNEL;BAC PRO PROD;BAC PRO 25406 OUVRAGES DU BATIMENT METALLERIE;14;14;10;2;2;1;1;11;0;0;2;3;6;3
572.0;2021;20;AMIENS;MASCULIN;SCOLAIRE;BAC PROFESSIONNEL;BAC PRO PROD;BAC PRO 25411 TECH.CHAUDRONNERIE INDUSTRIELLE;29;29;25;3;1;1;0;26;0;1;5;13;7;3
576.0;2021;20;AMIENS;MASCULIN;SCOLAIRE;BAC PROFESSIONNEL;BAC PRO PROD;BAC PRO 25514 SYST.NUM.OPT.B AUD.RES.EQUIP.DOM.;88;88;77;10;1;1;0;78;0;5;18;40;15;10
577.0;2021;20;AMIENS;MASCULIN;SCOLAIRE;BAC PROFESSIONNEL;BAC PRO PROD;BAC PRO 25515 SYST.NUM.OPT.C RES.INF.SYST.COMM.;77;76;69;5;2;2;0;71;0;9;19;25;18;5
579.0;2021;20;AMIENS;MASCULIN;SCOLAIRE;BAC PROFESSIONNEL;BAC PRO PROD;BAC PRO AG 21004 CGEA;81;79;69;10;0;0;0;69;0;1;14;23;31;10
583.0;2021;20;AMIENS;MASCULIN;SCOLAIRE;BAC PROFESSIONNEL;BAC PRO PROD;BAC PRO AG 21204 PROD-AQUACOLES;8;8;8;0;0;0;0;8;0;0;0;4;4;0
597.0;2021;20;AMIENS;MASCULIN;SCOLAIRE;BAC PROFESSIONNEL;BAC PRO SERV;BAC PRO 32303 ART.& MET.ART:COM.VIS.VIS.PLURI-M;35;35;28;6;1;1;0;29;0;1;7;14;7;6
604.0;2021;20;AMIENS;MASCULIN;SCOLAIRE;BAC PROFESSIONNEL;BAC PRO SERV;BAC PRO 34403 METIERS DE LA SECURITE;72;72;61;10;1;1;0;62;0;3;24;20;15;10
615.0;2021;20;AMIENS;MASCULIN;SCOLAIRE;BAC TECHNOLOGIQUE;BAC STL;BAC STL SCIENCES PHYSIQUES CHIMIQUES  EN LABORAT.;65;65;58;2;5;4;1;62;0;2;13;21;26;3
642.0;2021;03;BESANCON;FEMININ;ENSEIGNEMENT A DISTANCE;BAC PROFESSIONNEL;BAC PRO SERV;BAC PRO 31202 COMMERCE;3;3;2;1;0;0;0;2;0;0;1;1;0;1
645.0;2021;03;BESANCON;FEMININ;ENSEIGNEMENT A DISTANCE;BAC TECHNOLOGIQUE;BAC STMG;BAC STMG MERCATIQUE (MARKETING);1;1;1;0;0;0;0;1;0;0;1;0;0;0
647.0;2021;03;BESANCON;FEMININ;FORMATION CONTINUE;BAC PROFESSIONNEL;BAC PRO SERV;BAC PRO 33101 OPTIQUE LUNETTERIE;3;3;3;0;0;0;0;3;0;2;1;0;0;0
648.0;2021;03;BESANCON;FEMININ;INDIVIDUEL;BAC GENERAL;BAC GENERAL;BAC GENE 10019 BAC GENERAL;42;31;23;4;4;2;2;25;0;3;7;7;8;6
693.0;2021;03;BESANCON;FEMININ;SCOLAIRE;BAC PROFESSIONNEL;BAC PRO SERV;BAC PRO 31106 LOGISTIQUE;5;5;2;3;0;0;0;2;0;0;1;1;0;3
694.0;2021;03;BESANCON;FEMININ;SCOLAIRE;BAC PROFESSIONNEL;BAC PRO SERV;BAC PRO 31107 CONDUCT. TRANSP.ROUT.MARCHANDISES;7;7;5;2;0;0;0;5;0;0;0;1;4;2
695.0;2021;03;BESANCON;FEMININ;SCOLAIRE;BAC PROFESSIONNEL;BAC PRO SERV;BAC PRO 31202 COMMERCE;170;170;149;8;13;7;6;156;0;7;41;66;42;14
698.0;2021;03;BESANCON;FEMININ;SCOLAIRE;BAC PROFESSIONNEL;BAC PRO SERV;BAC PRO 33002 SERVICES DE PROXIMITE  VIE LOCAL;25;25;21;2;2;2;0;23;0;1;5;13;4;2
699.0;2021;03;BESANCON;FEMININ;SCOLAIRE;BAC PROFESSIONNEL;BAC PRO SERV;BAC PRO 33003 ACC.SOINS-S.PERS. OPT.A DOMICILE;49;49;45;2;2;2;0;47;0;4;12;15;16;2
703.0;2021;03;BESANCON;FEMININ;SCOLAIRE;BAC PROFESSIONNEL;BAC PRO SERV;BAC PRO 33603 ESTHETIQUE COSMETIQUE PARFUMERIE;28;28;25;3;0;0;0;25;0;0;4;12;9;3
706.0;2021;03;BESANCON;FEMININ;SCOLAIRE;BAC PROFESSIONNEL;BAC PRO SERV;BAC PRO AG 33002 SERV PERS TERRIT;239;231;219;12;0;0;0;219;0;4;42;92;81;12
709.0;2021;03;BESANCON;FEMININ;SCOLAIRE;BAC TECHNOLOGIQUE;BAC ST2S;BAC ST2S SCIENCES & TECHNO. SANTE & SOCIAL;288;288;274;2;12;7;5;281;0;8;66;111;96;7
714.0;2021;03;BESANCON;FEMININ;SCOLAIRE;BAC TECHNOLOGIQUE;BAC STI2D;BAC STI2D ENERGIES  ET ENVIRONNEMENT;2;2;1;0;1;0;1;1;0;0;0;1;0;1
724.0;2021;03;BESANCON;MASCULIN;APPRENTISSAGE;BAC PROFESSIONNEL;BAC PRO PROD;BAC PRO 22703 TECHN.INSTALL.SYST.ENERG.CLIMATI;10;10;8;2;0;0;0;8;0;0;3;3;2;2
735.0;2021;03;BESANCON;MASCULIN;APPRENTISSAGE;BAC PROFESSIONNEL;BAC PRO PROD;BAC PRO 25007 MAINTENANCE EQUIPEMENTS INDUST.;24;24;20;2;2;0;2;20;0;3;8;4;5;4
743.0;2021;03;BESANCON;MASCULIN;APPRENTISSAGE;BAC PROFESSIONNEL;BAC PRO PROD;BAC PRO 25221 MAINT.MATERIELS OPT.C ESP. VERTS;6;5;3;2;0;0;0;3;0;0;0;1;2;2
744.0;2021;03;BESANCON;MASCULIN;APPRENTISSAGE;BAC PROFESSIONNEL;BAC PRO PROD;BAC PRO 25406 OUVRAGES DU BATIMENT METALLERIE;6;6;6;0;0;0;0;6;0;0;3;3;0;0
753.0;2021;03;BESANCON;MASCULIN;APPRENTISSAGE;BAC PROFESSIONNEL;BAC PRO PROD;BAC PRO AG 21211 COND GEST ENTR HIPPIQUE;1;1;1;0;0;0;0;1;0;0;0;0;1;0
755.0;2021;03;BESANCON;MASCULIN;APPRENTISSAGE;BAC PROFESSIONNEL;BAC PRO PROD;BAC PRO AG 21303 FORET;20;19;19;0;0;0;0;19;0;0;3;11;5;0
757.0;2021;03;BESANCON;MASCULIN;APPRENTISSAGE;BAC PROFESSIONNEL;BAC PRO PROD;BAC PRO AG 22107 TEC CONS VTE ALIMENTATION P.ALIM;5;5;5;0;0;0;0;5;0;0;0;3;2;0
765.0;2021;03;BESANCON;MASCULIN;APPRENTISSAGE;BAC PROFESSIONNEL;BAC PRO SERV;BAC PRO 34403 METIERS DE LA SECURITE;3;3;3;0;0;0;0;3;0;0;0;3;0;0
782.0;2021;03;BESANCON;MASCULIN;INDIVIDUEL;BAC PROFESSIONNEL;BAC PRO PROD;BAC PRO AG 21211 COND GEST ENTR HIPPIQUE;2;2;2;0;0;0;0;2;0;0;0;1;1;0
786.0;2021;03;BESANCON;MASCULIN;INDIVIDUEL;BAC TECHNOLOGIQUE;BAC ST2S;BAC ST2S SCIENCES & TECHNO. SANTE & SOCIAL;1;0;0;0;0;0;0;0;0;0;0;0;0;0
795.0;2021;03;BESANCON;MASCULIN;SCOLAIRE;BAC PROFESSIONNEL;BAC PRO PROD;BAC PRO 22503 PLASTIQUES ET COMPOSITES;5;5;4;1;0;0;0;4;0;0;0;1;3;1
796.0;2021;03;BESANCON;MASCULIN;SCOLAIRE;BAC PROFESSIONNEL;BAC PRO PROD;BAC PRO 22703 TECHN.INSTALL.SYST.ENERG.CLIMATI;17;17;15;1;1;1;0;16;0;0;1;6;9;1
798.0;2021;03;BESANCON;MASCULIN;SCOLAIRE;BAC PROFESSIONNEL;BAC PRO PROD;BAC PRO 23004 TECHN. ETUDES BAT.A ETUDES & ECO.;8;8;6;1;1;0;1;6;0;0;1;2;3;2
799.0;2021;03;BESANCON;MASCULIN;SCOLAIRE;BAC PROFESSIONNEL;BAC PRO PROD;BAC PRO 23005 TECHN. ETUDES BAT B ASSIST.ARCHI.;17;17;17;0;0;0;0;17;0;1;5;6;5;0
804.0;2021;03;BESANCON;MASCULIN;SCOLAIRE;BAC PROFESSIONNEL;BAC PRO PROD;BAC PRO 23304 AMENAGEMENT FINITION BATIMENT;7;7;3;0;4;0;4;3;0;0;1;1;1;4
807.0;2021;03;BESANCON;MASCULIN;SCOLAIRE;BAC PROFESSIONNEL;BAC PRO PROD;BAC PRO 23407 TECHNIC.FAB.BOIS ET MATERX ASSOC;24;23;21;2;0;0;0;21;0;3;5;11;2;2
808.0;2021;03;BESANCON;MASCULIN;SCOLAIRE;BAC PROFESSIONNEL;BAC PRO PROD;BAC PRO 23408 Etude et réalisation d'agencement;10;10;10;0;0;0;0;10;0;1;2;6;1;0
811.0;2021;03;BESANCON;MASCULIN;SCOLAIRE;BAC PROFESSIONNEL;BAC PRO PROD;BAC PRO 25006 MICROTECHNIQUES;73;73;60;7;6;4;2;64;0;2;14;26;22;9
814.0;2021;03;BESANCON;MASCULIN;SCOLAIRE;BAC PROFESSIONNEL;BAC PRO PROD;BAC PRO 25107 TECHNICIEN OUTILLEUR;4;4;3;0;1;1;0;4;0;0;0;1;3;0
820.0;2021;03;BESANCON;MASCULIN;SCOLAIRE;BAC PROFESSIONNEL;BAC PRO PROD;BAC PRO 25411 TECH.CHAUDRONNERIE INDUSTRIELLE;46;44;32;11;1;0;1;32;0;3;5;11;13;12
835.0;2021;03;BESANCON;MASCULIN;SCOLAIRE;BAC PROFESSIONNEL;BAC PRO PROD;BAC PRO AG 22107 TEC CONS VTE ALIMENTATION P.ALIM;17;17;16;1;0;0;0;16;0;0;1;8;7;1
839.0;2021;03;BESANCON;MASCULIN;SCOLAIRE;BAC PROFESSIONNEL;BAC PRO SERV;BAC PRO 31202 COMMERCE;147;147;123;12;12;10;2;133;0;5;26;45;57;14
844.0;2021;03;BESANCON;MASCULIN;SCOLAIRE;BAC PROFESSIONNEL;BAC PRO SERV;BAC PRO 33004 ACC.SOINS-S.PERS. OPT.EN STRUCTUR;19;19;18;0;1;0;1;18;0;0;3;10;5;1
849.0;2021;03;BESANCON;MASCULIN;SCOLAIRE;BAC TECHNOLOGIQUE;BAC S2TMD;BAC S2TMD MUSIQUE;4;4;4;0;0;0;0;4;0;0;1;1;2;0
856.0;2021;03;BESANCON;MASCULIN;SCOLAIRE;BAC TECHNOLOGIQUE;BAC STI2D;BAC STI2D INNOVATION TECHNO.  ET ECO CONCEPTION;210;210;189;5;16;11;5;200;0;4;28;78;90;10
869.0;2021;04;BORDEAUX;FEMININ;APPRENTISSAGE;BAC PROFESSIONNEL;BAC PRO PROD;BAC PRO 25214 MAINT.VEHIC.OPTA VOIT.PARTICUL.;11;11;8;3;0;0;0;8;0;0;4;2;2;3
871.0;2021;04;BORDEAUX;FEMININ;APPRENTISSAGE;BAC PROFESSIONNEL;BAC PRO PROD;BAC PRO 25302 AERONAUTIQUE OPTION AVIONIQUE;5;5;5;0;0;0;0;5;0;3;1;1;0;0
873.0;2021;04;BORDEAUX;FEMININ;APPRENTISSAGE;BAC PROFESSIONNEL;BAC PRO PROD;BAC PRO 25304 AERONAUTIQUE OPTION STRUCTURE;2;2;1;1;0;0;0;1;0;0;0;0;1;1
897.0;2021;04;BORDEAUX;FEMININ;ENSEIGNEMENT A DISTANCE;BAC PROFESSIONNEL;BAC PRO SERV;BAC PRO 30001 GESTION-ADMINISTRATION;7;3;3;0;0;0;0;3;0;0;1;1;1;0
899.0;2021;04;BORDEAUX;FEMININ;ENSEIGNEMENT A DISTANCE;BAC PROFESSIONNEL;BAC PRO SERV;BAC PRO 31206 VENTE (PROSPECT.NEGO.SUIV.CLIENT;1;1;1;0;0;0;0;1;0;0;1;0;0;0
902.0;2021;04;BORDEAUX;FEMININ;ENSEIGNEMENT A DISTANCE;BAC PROFESSIONNEL;BAC PRO SERV;BAC PRO 33004 ACC.SOINS-S.PERS. OPT.EN STRUCTUR;6;1;1;0;0;0;0;1;0;0;1;0;0;0
907.0;2021;04;BORDEAUX;FEMININ;FORMATION CONTINUE;BAC PROFESSIONNEL;BAC PRO PROD;BAC PRO 22004 PROC. CHIMIE EAU PAPIERS-CARTONS;1;1;1;0;0;0;0;1;0;1;0;0;0;0
913.0;2021;04;BORDEAUX;FEMININ;FORMATION CONTINUE;BAC PROFESSIONNEL;BAC PRO SERV;BAC PRO 31206 VENTE (PROSPECT.NEGO.SUIV.CLIENT;1;1;1;0;0;0;0;1;0;0;0;0;1;0
915.0;2021;04;BORDEAUX;FEMININ;FORMATION CONTINUE;BAC PROFESSIONNEL;BAC PRO SERV;BAC PRO 33102 PROTHESE DENTAIRE;1;1;1;0;0;0;0;1;0;0;1;0;0;0
919.0;2021;04;BORDEAUX;FEMININ;INDIVIDUEL;BAC PROFESSIONNEL;BAC PRO PROD;BAC PRO AG 21114 CONDUITE PRODUCTIONS HORTICOLES;5;4;4;0;0;0;0;4;0;0;0;0;4;0
922.0;2021;04;BORDEAUX;FEMININ;INDIVIDUEL;BAC PROFESSIONNEL;BAC PRO PROD;BAC PRO AG 21405 AMENAGEMENTS PAYSAGERS;1;1;0;1;0;0;0;0;0;0;0;0;0;1
933.0;2021;04;BORDEAUX;FEMININ;INDIVIDUEL;BAC PROFESSIONNEL;BAC PRO SERV;BAC PRO AG 33002 SERV PERS TERRIT;2;1;1;0;0;0;0;1;0;0;0;0;1;0
940.0;2021;04;BORDEAUX;FEMININ;INDIVIDUEL;BAC TECHNOLOGIQUE;BAC STMG;BAC STMG SYSTEMES D'INFORMATION DE GESTION;1;1;1;0;0;0;0;1;0;0;0;0;1;0
947.0;2021;04;BORDEAUX;FEMININ;SCOLAIRE;BAC PROFESSIONNEL;BAC PRO PROD;BAC PRO 22105 BOULANGER-PÂTISSIER;32;31;31;0;0;0;0;31;0;5;11;12;3;0
948.0;2021;04;BORDEAUX;FEMININ;SCOLAIRE;BAC PROFESSIONNEL;BAC PRO PROD;BAC PRO 22106 CUISINE;88;88;83;3;2;1;1;84;0;9;20;33;22;4
953.0;2021;04;BORDEAUX;FEMININ;SCOLAIRE;BAC PROFESSIONNEL;BAC PRO PROD;BAC PRO 23005 TECHN. ETUDES BAT B ASSIST.ARCHI.;11;11;9;2;0;0;0;9;0;0;3;4;2;2
956.0;2021;04;BORDEAUX;FEMININ;SCOLAIRE;BAC PROFESSIONNEL;BAC PRO PROD;BAC PRO 23304 AMENAGEMENT FINITION BATIMENT;13;13;12;0;1;0;1;12;0;1;2;4;5;1
959.0;2021;04;BORDEAUX;FEMININ;SCOLAIRE;BAC PROFESSIONNEL;BAC PRO PROD;BAC PRO 23408 Etude et réalisation d'agencement;22;22;22;0;0;0;0;22;0;1;5;13;3;0
962.0;2021;04;BORDEAUX;FEMININ;SCOLAIRE;BAC PROFESSIONNEL;BAC PRO PROD;BAC PRO 25007 MAINTENANCE EQUIPEMENTS INDUST.;9;9;9;0;0;0;0;9;0;0;3;3;3;0
965.0;2021;04;BORDEAUX;FEMININ;SCOLAIRE;BAC PROFESSIONNEL;BAC PRO PROD;BAC PRO 25214 MAINT.VEHIC.OPTA VOIT.PARTICUL.;11;11;7;4;0;0;0;7;0;0;2;3;2;4
973.0;2021;04;BORDEAUX;FEMININ;SCOLAIRE;BAC PROFESSIONNEL;BAC PRO PROD;BAC PRO 25510 METIERS ELECT. ENVIRON. CONNECTES;5;5;5;0;0;0;0;5;0;0;1;3;1;0
988.0;2021;04;BORDEAUX;FEMININ;SCOLAIRE;BAC PROFESSIONNEL;BAC PRO PROD;BAC PRO AG 22106 TEC CONS VTE ALIMENTATION VINS SP;14;14;12;2;0;0;0;12;0;0;1;5;6;2
995.0;2021;04;BORDEAUX;FEMININ;SCOLAIRE;BAC PROFESSIONNEL;BAC PRO SERV;BAC PRO 31206 VENTE (PROSPECT.NEGO.SUIV.CLIENT;138;138;116;10;12;10;2;126;0;3;19;59;45;12
997.0;2021;04;BORDEAUX;FEMININ;SCOLAIRE;BAC PROFESSIONNEL;BAC PRO SERV;BAC PRO 32207 REAL.PR.IMPR.PLURI.OPTA.PR.GRAPH.;12;12;11;1;0;0;0;11;0;1;4;2;4;1
1001.0;2021;04;BORDEAUX;FEMININ;SCOLAIRE;BAC PROFESSIONNEL;BAC PRO SERV;BAC PRO 33002 SERVICES DE PROXIMITE  VIE LOCAL;157;157;148;5;4;3;1;151;0;5;46;49;51;6
1012.0;2021;04;BORDEAUX;FEMININ;SCOLAIRE;BAC TECHNOLOGIQUE;BAC S2TMD;BAC S2TMD MUSIQUE;3;3;3;0;0;0;0;3;0;2;0;0;1;0
1023.0;2021;04;BORDEAUX;FEMININ;SCOLAIRE;BAC TECHNOLOGIQUE;BAC STMG;BAC STMG GESTION ET FINANCE;228;228;216;1;11;9;2;225;0;11;43;89;82;3
1030.0;2021;04;BORDEAUX;MASCULIN;APPRENTISSAGE;BAC PROFESSIONNEL;BAC PRO PROD;BAC PRO 22703 TECHN.INSTALL.SYST.ENERG.CLIMATI;8;8;5;0;3;2;1;7;0;0;3;2;2;1
1042.0;2021;04;BORDEAUX;MASCULIN;APPRENTISSAGE;BAC PROFESSIONNEL;BAC PRO PROD;BAC PRO 25007 MAINTENANCE EQUIPEMENTS INDUST.;69;66;58;4;4;3;1;61;0;7;19;20;15;5
1043.0;2021;04;BORDEAUX;MASCULIN;APPRENTISSAGE;BAC PROFESSIONNEL;BAC PRO PROD;BAC PRO 25009 MAINTENANCE NAUTIQUE;4;4;4;0;0;0;0;4;0;0;2;2;0;0
1044.0;2021;04;BORDEAUX;MASCULIN;APPRENTISSAGE;BAC PROFESSIONNEL;BAC PRO PROD;BAC PRO 25106 TECHNICIEN D'USINAGE;36;36;32;2;2;1;1;33;0;2;8;16;7;3
1050.0;2021;04;BORDEAUX;MASCULIN;APPRENTISSAGE;BAC PROFESSIONNEL;BAC PRO PROD;BAC PRO 25302 AERONAUTIQUE OPTION AVIONIQUE;6;6;6;0;0;0;0;6;0;2;1;3;0;0
1053.0;2021;04;BORDEAUX;MASCULIN;APPRENTISSAGE;BAC PROFESSIONNEL;BAC PRO PROD;BAC PRO 25411 TECH.CHAUDRONNERIE INDUSTRIELLE;75;75;69;4;2;1;1;70;0;4;26;27;13;5
1057.0;2021;04;BORDEAUX;MASCULIN;APPRENTISSAGE;BAC PROFESSIONNEL;BAC PRO PROD;BAC PRO 25514 SYST.NUM.OPT.B AUD.RES.EQUIP.DOM.;1;1;1;0;0;0;0;1;0;0;0;1;0;0
1068.0;2021;04;BORDEAUX;MASCULIN;APPRENTISSAGE;BAC PROFESSIONNEL;BAC PRO SERV;BAC PRO 31106 LOGISTIQUE;20;20;13;3;4;4;0;17;0;0;2;5;10;3
1069.0;2021;04;BORDEAUX;MASCULIN;APPRENTISSAGE;BAC PROFESSIONNEL;BAC PRO SERV;BAC PRO 31202 COMMERCE;112;111;84;15;12;10;2;94;0;4;23;32;35;17
1070.0;2021;04;BORDEAUX;MASCULIN;APPRENTISSAGE;BAC PROFESSIONNEL;BAC PRO SERV;BAC PRO 31206 VENTE (PROSPECT.NEGO.SUIV.CLIENT;1;1;1;0;0;0;0;1;0;1;0;0;0;0
1071.0;2021;04;BORDEAUX;MASCULIN;APPRENTISSAGE;BAC PROFESSIONNEL;BAC PRO SERV;BAC PRO 31209 POISSONIER ECAILLER TRAITEUR;5;5;4;1;0;0;0;4;0;0;0;1;3;1
1080.0;2021;04;BORDEAUX;MASCULIN;APPRENTISSAGE;BAC PROFESSIONNEL;BAC PRO SERV;BAC PRO AG 33002 SERV PERS TERRIT;1;1;1;0;0;0;0;1;0;0;0;1;0;0
1087.0;2021;04;BORDEAUX;MASCULIN;ENSEIGNEMENT A DISTANCE;BAC TECHNOLOGIQUE;BAC ST2S;BAC ST2S SCIENCES & TECHNO. SANTE & SOCIAL;3;3;3;0;0;0;0;3;0;0;0;2;1;0
1088.0;2021;04;BORDEAUX;MASCULIN;ENSEIGNEMENT A DISTANCE;BAC TECHNOLOGIQUE;BAC STMG;BAC STMG GESTION ET FINANCE;5;4;3;0;1;0;1;3;0;0;0;1;2;1
1091.0;2021;04;BORDEAUX;MASCULIN;ENSEIGNEMENT A DISTANCE;BAC TECHNOLOGIQUE;BAC STMG;BAC STMG SYSTEMES D'INFORMATION DE GESTION;1;1;0;1;0;0;0;0;0;0;0;0;0;1
1099.0;2021;04;BORDEAUX;MASCULIN;FORMATION CONTINUE;BAC PROFESSIONNEL;BAC PRO SERV;BAC PRO 30001 GESTION-ADMINISTRATION;1;1;1;0;0;0;0;1;0;0;0;0;1;0
1101.0;2021;04;BORDEAUX;MASCULIN;FORMATION CONTINUE;BAC PROFESSIONNEL;BAC PRO SERV;BAC PRO 31202 COMMERCE;31;26;22;4;0;0;0;22;0;1;3;10;8;4
1105.0;2021;04;BORDEAUX;MASCULIN;INDIVIDUEL;BAC PROFESSIONNEL;BAC PRO PROD;BAC PRO 22106 CUISINE;1;1;1;0;0;0;0;1;0;0;0;1;0;0
1113.0;2021;04;BORDEAUX;MASCULIN;INDIVIDUEL;BAC PROFESSIONNEL;BAC PRO PROD;BAC PRO 25514 SYST.NUM.OPT.B AUD.RES.EQUIP.DOM.;1;0;0;0;0;0;0;0;0;0;0;0;0;0
1114.0;2021;04;BORDEAUX;MASCULIN;INDIVIDUEL;BAC PROFESSIONNEL;BAC PRO PROD;BAC PRO 25515 SYST.NUM.OPT.C RES.INF.SYST.COMM.;3;1;0;1;0;0;0;0;0;0;0;0;0;1
1115.0;2021;04;BORDEAUX;MASCULIN;INDIVIDUEL;BAC PROFESSIONNEL;BAC PRO PROD;BAC PRO AG 21004 CGEA;7;5;5;0;0;0;0;5;0;0;0;0;5;0
1121.0;2021;04;BORDEAUX;MASCULIN;INDIVIDUEL;BAC PROFESSIONNEL;BAC PRO SERV;BAC PRO 31202 COMMERCE;5;2;1;1;0;0;0;1;0;1;0;0;0;1
1123.0;2021;04;BORDEAUX;MASCULIN;INDIVIDUEL;BAC PROFESSIONNEL;BAC PRO SERV;BAC PRO 31210 ACCUEIL -RELATION CLIENTS USAGERS;1;1;1;0;0;0;0;1;0;0;0;0;1;0
1134.0;2021;04;BORDEAUX;MASCULIN;INDIVIDUEL;BAC TECHNOLOGIQUE;BAC STMG;BAC STMG SYSTEMES D'INFORMATION DE GESTION;3;2;1;0;1;1;0;2;0;0;0;0;2;0
1136.0;2021;04;BORDEAUX;MASCULIN;SCOLAIRE;BAC PROFESSIONNEL;BAC PRO PROD;BACPRO 20002 ETUD.DEFINITION PRDTS INDUSTRIEL;26;26;24;0;2;2;0;26;0;1;3;8;14;0
1141.0;2021;04;BORDEAUX;MASCULIN;SCOLAIRE;BAC PROFESSIONNEL;BAC PRO PROD;BAC PRO 22105 BOULANGER-PÂTISSIER;41;41;39;1;1;1;0;40;0;2;18;11;9;1
1148.0;2021;04;BORDEAUX;MASCULIN;SCOLAIRE;BAC PROFESSIONNEL;BAC PRO PROD;BAC PRO 23102 TRAVAUX PUBLICS;31;31;28;1;2;2;0;30;0;1;12;11;6;1
1152.0;2021;04;BORDEAUX;MASCULIN;SCOLAIRE;BAC PROFESSIONNEL;BAC PRO PROD;BAC PRO 23303 MENUISERIE ALUMINIUM-VERRE;3;3;3;0;0;0;0;3;0;0;0;0;3;0
1153.0;2021;04;BORDEAUX;MASCULIN;SCOLAIRE;BAC PROFESSIONNEL;BAC PRO PROD;BAC PRO 23304 AMENAGEMENT FINITION BATIMENT;35;35;24;4;7;2;5;26;0;0;1;7;18;9
1157.0;2021;04;BORDEAUX;MASCULIN;SCOLAIRE;BAC PROFESSIONNEL;BAC PRO PROD;BAC PRO 23408 Etude et réalisation d'agencement;8;8;6;1;1;1;0;7;0;0;1;2;4;1
1160.0;2021;04;BORDEAUX;MASCULIN;SCOLAIRE;BAC PROFESSIONNEL;BAC PRO PROD;BAC PRO 25007 MAINTENANCE EQUIPEMENTS INDUST.;228;227;183;27;17;14;3;197;0;6;41;69;81;30
1172.0;2021;04;BORDEAUX;MASCULIN;SCOLAIRE;BAC PROFESSIONNEL;BAC PRO PROD;BAC PRO 25304 AERONAUTIQUE OPTION STRUCTURE;21;21;19;2;0;0;0;19;0;0;1;8;10;2
1185.0;2021;04;BORDEAUX;MASCULIN;SCOLAIRE;BAC PROFESSIONNEL;BAC PRO PROD;BAC PRO AG 21203 TECHN CONSEIL DE VENTE ANIMAL;11;11;10;1;0;0;0;10;0;1;2;3;4;1
1186.0;2021;04;BORDEAUX;MASCULIN;SCOLAIRE;BAC PROFESSIONNEL;BAC PRO PROD;BAC PRO AG 21204 PROD-AQUACOLES;12;12;10;2;0;0;0;10;0;0;2;3;5;2
1188.0;2021;04;BORDEAUX;MASCULIN;SCOLAIRE;BAC PROFESSIONNEL;BAC PRO PROD;BAC PRO AG 21211 COND GEST ENTR HIPPIQUE;8;8;8;0;0;0;0;8;0;1;2;3;2;0
1189.0;2021;04;BORDEAUX;MASCULIN;SCOLAIRE;BAC PROFESSIONNEL;BAC PRO PROD;BAC PRO AG 21302 GEST MILIEUX NATURELS FAUNE;70;70;69;1;0;0;0;69;0;2;20;29;18;1
1198.0;2021;04;BORDEAUX;MASCULIN;SCOLAIRE;BAC PROFESSIONNEL;BAC PRO SERV;BAC PRO 31107 CONDUCT. TRANSP.ROUT.MARCHANDISES;62;62;56;4;2;2;0;58;0;5;22;25;6;4
1202.0;2021;04;BORDEAUX;MASCULIN;SCOLAIRE;BAC PROFESSIONNEL;BAC PRO SERV;BAC PRO 31210 ACCUEIL -RELATION CLIENTS USAGERS;80;79;60;14;5;5;0;65;0;4;12;20;29;14
1203.0;2021;04;BORDEAUX;MASCULIN;SCOLAIRE;BAC PROFESSIONNEL;BAC PRO SERV;BAC PRO 32207 REAL.PR.IMPR.PLURI.OPTA.PR.GRAPH.;40;40;34;3;3;2;1;36;0;2;4;17;13;4
1211.0;2021;04;BORDEAUX;MASCULIN;SCOLAIRE;BAC PROFESSIONNEL;BAC PRO SERV;BAC PRO 33102 PROTHESE DENTAIRE;8;8;8;0;0;0;0;8;0;0;1;1;6;0
1213.0;2021;04;BORDEAUX;MASCULIN;SCOLAIRE;BAC PROFESSIONNEL;BAC PRO SERV;BAC PRO 34304 HYGIENE PROPRETE STERILISATION;5;5;3;1;1;1;0;4;0;0;1;1;2;1
1215.0;2021;04;BORDEAUX;MASCULIN;SCOLAIRE;BAC PROFESSIONNEL;BAC PRO SERV;BAC PRO 34403 METIERS DE LA SECURITE;64;64;58;3;3;3;0;61;0;0;17;26;18;3
1219.0;2021;04;BORDEAUX;MASCULIN;SCOLAIRE;BAC TECHNOLOGIQUE;BAC STAV;BAC STAV AGRONOMIE ALIM ENV TERRITOI;149;148;147;1;0;0;0;147;0;3;20;68;56;1
1221.0;2021;04;BORDEAUX;MASCULIN;SCOLAIRE;BAC TECHNOLOGIQUE;BAC STHR;BAC STHR SC.&TEC. HOTELLERIE-RESTAURATION;50;50;44;1;5;4;1;48;0;2;7;17;22;2
1222.0;2021;04;BORDEAUX;MASCULIN;SCOLAIRE;BAC TECHNOLOGIQUE;BAC STI2D;BAC STI2D ARCHITECTURE ET CONSTRUCTION;224;224;205;3;16;13;3;218;1;2;41;91;83;6
1227.0;2021;04;BORDEAUX;MASCULIN;SCOLAIRE;BAC TECHNOLOGIQUE;BAC STL;BAC STL SCIENCES PHYSIQUES CHIMIQUES  EN LABORAT.;87;87;81;3;3;2;1;83;0;2;13;29;39;4
1229.0;2021;04;BORDEAUX;MASCULIN;SCOLAIRE;BAC TECHNOLOGIQUE;BAC STMG;BAC STMG MERCATIQUE (MARKETING);891;891;765;31;95;52;43;817;0;8;72;318;419;74
1234.0;2021;06;CLERMONT-FERRAND;FEMININ;APPRENTISSAGE;BAC PROFESSIONNEL;BAC PRO PROD;BAC PRO 22503 PLASTIQUES ET COMPOSITES;2;2;2;0;0;0;0;2;0;0;2;0;0;0
1246.0;2021;06;CLERMONT-FERRAND;FEMININ;APPRENTISSAGE;BAC PROFESSIONNEL;BAC PRO PROD;BAC PRO AG 21004 CGEA;4;4;3;1;0;0;0;3;0;0;0;1;2;1
1257.0;2021;06;CLERMONT-FERRAND;FEMININ;ENSEIGNEMENT A DISTANCE;BAC PROFESSIONNEL;BAC PRO SERV;BAC PRO 31210 ACCUEIL -RELATION CLIENTS USAGERS;1;1;1;0;0;0;0;1;0;0;0;0;1;0
1261.0;2021;06;CLERMONT-FERRAND;FEMININ;ENSEIGNEMENT A DISTANCE;BAC TECHNOLOGIQUE;BAC STMG;BAC STMG MERCATIQUE (MARKETING);1;1;0;1;0;0;0;0;0;0;0;0;0;1
1262.0;2021;06;CLERMONT-FERRAND;FEMININ;ENSEIGNEMENT A DISTANCE;BAC TECHNOLOGIQUE;BAC STMG;BAC STMG RESSOURCES HUMAINES ET COMMUNICATION;2;2;1;1;0;0;0;1;0;0;0;0;1;1
1271.0;2021;06;CLERMONT-FERRAND;FEMININ;INDIVIDUEL;BAC PROFESSIONNEL;BAC PRO PROD;BAC PRO AG 21113 CGEVV;1;1;1;0;0;0;0;1;0;0;0;0;1;0
1274.0;2021;06;CLERMONT-FERRAND;FEMININ;INDIVIDUEL;BAC PROFESSIONNEL;BAC PRO PROD;BAC PRO AG 21302 GEST MILIEUX NATURELS FAUNE;1;1;1;0;0;0;0;1;0;0;0;0;1;0
1277.0;2021;06;CLERMONT-FERRAND;FEMININ;INDIVIDUEL;BAC PROFESSIONNEL;BAC PRO SERV;BAC PRO 31210 ACCUEIL -RELATION CLIENTS USAGERS;1;1;1;0;0;0;0;1;0;0;0;0;1;0
1283.0;2021;06;CLERMONT-FERRAND;FEMININ;INDIVIDUEL;BAC TECHNOLOGIQUE;BAC STMG;BAC STMG MERCATIQUE (MARKETING);1;1;0;1;0;0;0;0;0;0;0;0;0;1
1288.0;2021;06;CLERMONT-FERRAND;FEMININ;SCOLAIRE;BAC PROFESSIONNEL;BAC PRO PROD;BAC PRO 22106 CUISINE;52;52;47;3;2;0;2;47;0;6;13;16;12;5
1291.0;2021;06;CLERMONT-FERRAND;FEMININ;SCOLAIRE;BAC PROFESSIONNEL;BAC PRO PROD;BAC PRO 23003 ARTIS. & M.ART:MARCHANDISAGE VIS.;11;11;11;0;0;0;0;11;0;0;6;4;1;0
1295.0;2021;06;CLERMONT-FERRAND;FEMININ;SCOLAIRE;BAC PROFESSIONNEL;BAC PRO PROD;BAC PRO 23405 TECHNICIEN MENUISIER AGENCEUR;2;2;2;0;0;0;0;2;0;1;1;0;0;0
1296.0;2021;06;CLERMONT-FERRAND;FEMININ;SCOLAIRE;BAC PROFESSIONNEL;BAC PRO PROD;BAC PRO 24202 ARTIS.& MET.ART : TAPIS.D'AMEUBL;7;7;7;0;0;0;0;7;0;0;3;1;3;0
1303.0;2021;06;CLERMONT-FERRAND;FEMININ;SCOLAIRE;BAC PROFESSIONNEL;BAC PRO PROD;BAC PRO 25411 TECH.CHAUDRONNERIE INDUSTRIELLE;2;2;2;0;0;0;0;2;0;0;1;1;0;0
1307.0;2021;06;CLERMONT-FERRAND;FEMININ;SCOLAIRE;BAC PROFESSIONNEL;BAC PRO PROD;BAC PRO AG 21001 AGRO-EQUIPEMENT;1;1;1;0;0;0;0;1;0;0;0;0;1;0
1310.0;2021;06;CLERMONT-FERRAND;FEMININ;SCOLAIRE;BAC PROFESSIONNEL;BAC PRO PROD;BAC PRO AG 21114 CONDUITE PRODUCTIONS HORTICOLES;5;5;5;0;0;0;0;5;0;1;0;1;3;0
1312.0;2021;06;CLERMONT-FERRAND;FEMININ;SCOLAIRE;BAC PROFESSIONNEL;BAC PRO PROD;BAC PRO AG 21210 COND GEST ENTR CANIN ET FELIN;23;23;22;1;0;0;0;22;0;1;5;11;5;1
1319.0;2021;06;CLERMONT-FERRAND;FEMININ;SCOLAIRE;BAC PROFESSIONNEL;BAC PRO PROD;BAC PRO AG 22107 TEC CONS VTE ALIMENTATION P.ALIM;5;5;5;0;0;0;0;5;0;0;2;0;3;0
1323.0;2021;06;CLERMONT-FERRAND;FEMININ;SCOLAIRE;BAC PROFESSIONNEL;BAC PRO SERV;BAC PRO 31202 COMMERCE;158;158;131;10;17;7;10;138;0;10;42;50;36;20
1326.0;2021;06;CLERMONT-FERRAND;FEMININ;SCOLAIRE;BAC PROFESSIONNEL;BAC PRO SERV;BAC PRO 32207 REAL.PR.IMPR.PLURI.OPTA.PR.GRAPH.;2;2;1;1;0;0;0;1;0;0;0;0;1;1
1328.0;2021;06;CLERMONT-FERRAND;FEMININ;SCOLAIRE;BAC PROFESSIONNEL;BAC PRO SERV;BAC PRO 32303 ART.& MET.ART:COM.VIS.VIS.PLURI-M;32;32;31;1;0;0;0;31;0;4;12;11;4;1
1332.0;2021;06;CLERMONT-FERRAND;FEMININ;SCOLAIRE;BAC PROFESSIONNEL;BAC PRO SERV;BAC PRO 33004 ACC.SOINS-S.PERS. OPT.EN STRUCTUR;303;303;277;12;14;8;6;285;0;7;78;118;82;18
1334.0;2021;06;CLERMONT-FERRAND;FEMININ;SCOLAIRE;BAC PROFESSIONNEL;BAC PRO SERV;BAC PRO 33102 PROTHESE DENTAIRE;6;6;5;1;0;0;0;5;0;0;1;1;3;1
1343.0;2021;06;CLERMONT-FERRAND;FEMININ;SCOLAIRE;BAC TECHNOLOGIQUE;BAC STHR;BAC STHR SC.&TEC. HOTELLERIE-RESTAURATION;41;41;37;1;3;1;2;38;0;2;9;16;11;3
1359.0;2021;06;CLERMONT-FERRAND;MASCULIN;APPRENTISSAGE;BAC PROFESSIONNEL;BAC PRO PROD;BAC PRO 22704 TECHN. MAINT. SYST.ENERG.CLIMATI;1;1;0;1;0;0;0;0;0;0;0;0;0;1
1361.0;2021;06;CLERMONT-FERRAND;MASCULIN;APPRENTISSAGE;BAC PROFESSIONNEL;BAC PRO PROD;BAC PRO 23203 TECHNICIEN BAT. : ORG.REAL.GROS O;5;5;5;0;0;0;0;5;0;0;1;1;3;0
1389.0;2021;06;CLERMONT-FERRAND;MASCULIN;APPRENTISSAGE;BAC PROFESSIONNEL;BAC PRO SERV;BAC PRO 31108 TRANSPORT;1;1;1;0;0;0;0;1;0;0;1;0;0;0
1396.0;2021;06;CLERMONT-FERRAND;MASCULIN;ENSEIGNEMENT A DISTANCE;BAC PROFESSIONNEL;BAC PRO PROD;BAC PRO AG 21004 CGEA;63;46;35;11;0;0;0;35;0;0;0;0;35;11
1411.0;2021;06;CLERMONT-FERRAND;MASCULIN;INDIVIDUEL;BAC PROFESSIONNEL;BAC PRO PROD;BAC PRO AG 21004 CGEA;4;2;2;0;0;0;0;2;0;0;0;0;2;0
1420.0;2021;06;CLERMONT-FERRAND;MASCULIN;INDIVIDUEL;BAC TECHNOLOGIQUE;BAC STMG;BAC STMG MERCATIQUE (MARKETING);5;5;1;3;1;0;1;1;0;0;0;0;1;4
1422.0;2021;06;CLERMONT-FERRAND;MASCULIN;SCOLAIRE;BAC GENERAL;BAC GENERAL;BAC GENE 10019 BAC GENERAL;2783;2783;2628;27;128;70;58;2698;40;259;558;959;882;85
1429.0;2021;06;CLERMONT-FERRAND;MASCULIN;SCOLAIRE;BAC PROFESSIONNEL;BAC PRO PROD;BAC PRO 22703 TECHN.INSTALL.SYST.ENERG.CLIMATI;19;19;12;7;0;0;0;12;0;0;0;8;4;7
1430.0;2021;06;CLERMONT-FERRAND;MASCULIN;SCOLAIRE;BAC PROFESSIONNEL;BAC PRO PROD;BAC PRO 22704 TECHN. MAINT. SYST.ENERG.CLIMATI;9;9;2;6;1;0;1;2;0;0;0;0;2;7
1438.0;2021;06;CLERMONT-FERRAND;MASCULIN;SCOLAIRE;BAC PROFESSIONNEL;BAC PRO PROD;BAC PRO 23404 TECHNICIEN CONSTRUCTEUR BOIS;19;19;15;4;0;0;0;15;0;0;2;10;3;4
1439.0;2021;06;CLERMONT-FERRAND;MASCULIN;SCOLAIRE;BAC PROFESSIONNEL;BAC PRO PROD;BAC PRO 23405 TECHNICIEN MENUISIER AGENCEUR;31;31;25;4;2;2;0;27;0;0;6;9;12;4
1440.0;2021;06;CLERMONT-FERRAND;MASCULIN;SCOLAIRE;BAC PROFESSIONNEL;BAC PRO PROD;BAC PRO 24202 ARTIS.& MET.ART : TAPIS.D'AMEUBL;1;1;1;0;0;0;0;1;0;0;0;0;1;0
1444.0;2021;06;CLERMONT-FERRAND;MASCULIN;SCOLAIRE;BAC PROFESSIONNEL;BAC PRO PROD;BAC PRO 25106 TECHNICIEN D'USINAGE;38;38;27;10;1;1;0;28;0;0;4;16;8;10
1447.0;2021;06;CLERMONT-FERRAND;MASCULIN;SCOLAIRE;BAC PROFESSIONNEL;BAC PRO PROD;BAC PRO 25219 MAINT.MATERIELS OPT.A AGRICOLES;10;10;7;3;0;0;0;7;0;1;2;2;2;3
1450.0;2021;06;CLERMONT-FERRAND;MASCULIN;SCOLAIRE;BAC PROFESSIONNEL;BAC PRO PROD;BAC PRO 25302 AERONAUTIQUE OPTION AVIONIQUE;6;6;6;0;0;0;0;6;0;0;2;3;1;0
1451.0;2021;06;CLERMONT-FERRAND;MASCULIN;SCOLAIRE;BAC PROFESSIONNEL;BAC PRO PROD;BAC PRO 25303 AERONAUTIQUE OPTION SYSTEMES;12;12;12;0;0;0;0;12;0;2;4;5;1;0
1466.0;2021;06;CLERMONT-FERRAND;MASCULIN;SCOLAIRE;BAC PROFESSIONNEL;BAC PRO PROD;BAC PRO AG 21210 COND GEST ENTR CANIN ET FELIN;7;7;6;1;0;0;0;6;0;0;0;3;3;1
1468.0;2021;06;CLERMONT-FERRAND;MASCULIN;SCOLAIRE;BAC PROFESSIONNEL;BAC PRO PROD;BAC PRO AG 21302 GEST MILIEUX NATURELS FAUNE;29;29;27;2;0;0;0;27;0;3;6;9;9;2
1473.0;2021;06;CLERMONT-FERRAND;MASCULIN;SCOLAIRE;BAC PROFESSIONNEL;BAC PRO PROD;BAC PRO AG 22107 TEC CONS VTE ALIMENTATION P.ALIM;5;4;4;0;0;0;0;4;0;0;1;1;2;0
1480.0;2021;06;CLERMONT-FERRAND;MASCULIN;SCOLAIRE;BAC PROFESSIONNEL;BAC PRO SERV;BAC PRO 31210 ACCUEIL -RELATION CLIENTS USAGERS;21;21;17;4;0;0;0;17;0;0;1;6;10;4
1481.0;2021;06;CLERMONT-FERRAND;MASCULIN;SCOLAIRE;BAC PROFESSIONNEL;BAC PRO SERV;BAC PRO 32207 REAL.PR.IMPR.PLURI.OPTA.PR.GRAPH.;15;15;13;2;0;0;0;13;0;1;0;5;7;2
1485.0;2021;06;CLERMONT-FERRAND;MASCULIN;SCOLAIRE;BAC PROFESSIONNEL;BAC PRO SERV;BAC PRO 33002 SERVICES DE PROXIMITE  VIE LOCAL;13;13;11;0;2;1;1;12;0;0;2;4;6;1
1494.0;2021;06;CLERMONT-FERRAND;MASCULIN;SCOLAIRE;BAC TECHNOLOGIQUE;BAC ST2S;BAC ST2S SCIENCES & TECHNO. SANTE & SOCIAL;42;42;39;0;3;2;1;41;0;0;4;10;27;1
1495.0;2021;06;CLERMONT-FERRAND;MASCULIN;SCOLAIRE;BAC TECHNOLOGIQUE;BAC STAV;BAC STAV AGRONOMIE ALIM ENV TERRITOI;110;110;108;2;0;0;0;108;0;4;8;63;33;2
1496.0;2021;06;CLERMONT-FERRAND;MASCULIN;SCOLAIRE;BAC TECHNOLOGIQUE;BAC STD2A;BAC STD2A SCIENCES & TECHNO. DESIGN-ARTS APPLIQUES;24;24;24;0;0;0;0;24;0;5;10;8;1;0
1498.0;2021;06;CLERMONT-FERRAND;MASCULIN;SCOLAIRE;BAC TECHNOLOGIQUE;BAC STI2D;BAC STI2D ARCHITECTURE ET CONSTRUCTION;86;86;81;0;5;5;0;86;0;0;10;41;35;0
1502.0;2021;06;CLERMONT-FERRAND;MASCULIN;SCOLAIRE;BAC TECHNOLOGIQUE;BAC STL;BAC STL BIOCHIM.-BIOLOGIE-BIOTECHNOL.;36;36;32;2;2;1;1;33;0;1;5;13;14;3
1507.0;2021;06;CLERMONT-FERRAND;MASCULIN;SCOLAIRE;BAC TECHNOLOGIQUE;BAC STMG;BAC STMG SYSTEMES D'INFORMATION DE GESTION;7;7;4;0;3;1;2;5;0;0;0;0;5;2
1513.0;2021;27;CORSE;FEMININ;ENSEIGNEMENT A DISTANCE;BAC GENERAL;BAC GENERAL;BAC GENE 10019 BAC GENERAL;10;10;10;0;0;0;0;10;0;3;4;2;1;0
1516.0;2021;27;CORSE;FEMININ;ENSEIGNEMENT A DISTANCE;BAC PROFESSIONNEL;BAC PRO SERV;BAC PRO 33004 ACC.SOINS-S.PERS. OPT.EN STRUCTUR;1;1;1;0;0;0;0;1;0;0;1;0;0;0
1518.0;2021;27;CORSE;FEMININ;ENSEIGNEMENT A DISTANCE;BAC TECHNOLOGIQUE;BAC STMG;BAC STMG MERCATIQUE (MARKETING);1;1;1;0;0;0;0;1;0;0;1;0;0;0
1523.0;2021;27;CORSE;FEMININ;INDIVIDUEL;BAC PROFESSIONNEL;BAC PRO PROD;BAC PRO AG 21113 CGEVV;2;2;1;1;0;0;0;1;0;0;0;0;1;1
1525.0;2021;27;CORSE;FEMININ;INDIVIDUEL;BAC PROFESSIONNEL;BAC PRO PROD;BAC PRO AG 21211 COND GEST ENTR HIPPIQUE;2;2;2;0;0;0;0;2;0;0;0;0;2;0
1526.0;2021;27;CORSE;FEMININ;INDIVIDUEL;BAC TECHNOLOGIQUE;BAC STMG;BAC STMG GESTION ET FINANCE;1;0;0;0;0;0;0;0;0;0;0;0;0;0
1531.0;2021;27;CORSE;FEMININ;SCOLAIRE;BAC PROFESSIONNEL;BAC PRO PROD;BAC PRO 23005 TECHN. ETUDES BAT B ASSIST.ARCHI.;3;3;2;1;0;0;0;2;0;1;0;1;0;1
1539.0;2021;27;CORSE;FEMININ;SCOLAIRE;BAC PROFESSIONNEL;BAC PRO PROD;BAC PRO AG 21405 AMENAGEMENTS PAYSAGERS;1;1;1;0;0;0;0;1;0;0;0;0;1;0
1540.0;2021;27;CORSE;FEMININ;SCOLAIRE;BAC PROFESSIONNEL;BAC PRO SERV;BAC PRO 30001 GESTION-ADMINISTRATION;49;49;38;10;1;1;0;39;0;2;6;11;20;10
1542.0;2021;27;CORSE;FEMININ;SCOLAIRE;BAC PROFESSIONNEL;BAC PRO SERV;BAC PRO 31206 VENTE (PROSPECT.NEGO.SUIV.CLIENT;2;2;2;0;0;0;0;2;0;0;0;1;1;0
1544.0;2021;27;CORSE;FEMININ;SCOLAIRE;BAC PROFESSIONNEL;BAC PRO SERV;BAC PRO 33002 SERVICES DE PROXIMITE  VIE LOCAL;6;6;6;0;0;0;0;6;0;0;1;0;5;0
1549.0;2021;27;CORSE;FEMININ;SCOLAIRE;BAC TECHNOLOGIQUE;BAC ST2S;BAC ST2S SCIENCES & TECHNO. SANTE & SOCIAL;86;86;76;0;10;6;4;82;0;2;11;30;39;4
1551.0;2021;27;CORSE;FEMININ;SCOLAIRE;BAC TECHNOLOGIQUE;BAC STHR;BAC STHR SC.&TEC. HOTELLERIE-RESTAURATION;6;6;6;0;0;0;0;6;0;0;0;1;5;0
1555.0;2021;27;CORSE;FEMININ;SCOLAIRE;BAC TECHNOLOGIQUE;BAC STMG;BAC STMG GESTION ET FINANCE;41;41;40;0;1;1;0;41;0;0;9;14;18;0
1561.0;2021;27;CORSE;MASCULIN;APPRENTISSAGE;BAC PROFESSIONNEL;BAC PRO PROD;BAC PRO 25510 METIERS ELECT. ENVIRON. CONNECTES;13;11;11;0;0;0;0;11;0;5;5;1;0;0
1566.0;2021;27;CORSE;MASCULIN;APPRENTISSAGE;BAC PROFESSIONNEL;BAC PRO SERV;BAC PRO 33403 COMMERC. SERVICES EN RESTAURATION;3;3;1;2;0;0;0;1;0;0;1;0;0;2
1569.0;2021;27;CORSE;MASCULIN;INDIVIDUEL;BAC GENERAL;BAC GENERAL;BAC GENE 10019 BAC GENERAL;2;2;1;1;0;0;0;1;0;0;0;0;1;1
1572.0;2021;27;CORSE;MASCULIN;INDIVIDUEL;BAC PROFESSIONNEL;BAC PRO PROD;BAC PRO AG 21004 CGEA;8;5;3;2;0;0;0;3;0;0;0;0;3;2
1576.0;2021;27;CORSE;MASCULIN;INDIVIDUEL;BAC PROFESSIONNEL;BAC PRO PROD;BAC PRO AG 21303 FORET;1;0;0;0;0;0;0;0;0;0;0;0;0;0
1580.0;2021;27;CORSE;MASCULIN;INDIVIDUEL;BAC TECHNOLOGIQUE;BAC STAV;BAC STAV AGRONOMIE ALIM ENV TERRITOI;1;1;1;0;0;0;0;1;0;0;0;0;1;0
1581.0;2021;27;CORSE;MASCULIN;INDIVIDUEL;BAC TECHNOLOGIQUE;BAC STI2D;BAC STI2D ARCHITECTURE ET CONSTRUCTION;1;1;1;0;0;0;0;1;0;0;0;0;1;0
1589.0;2021;27;CORSE;MASCULIN;SCOLAIRE;BAC PROFESSIONNEL;BAC PRO PROD;BAC PRO 24203 METIERS DE LA MODE - VÊTEMENT;1;1;1;0;0;0;0;1;0;0;1;0;0;0
1592.0;2021;27;CORSE;MASCULIN;SCOLAIRE;BAC PROFESSIONNEL;BAC PRO PROD;BAC PRO 25214 MAINT.VEHIC.OPTA VOIT.PARTICUL.;16;16;15;1;0;0;0;15;0;0;4;5;6;1
1600.0;2021;27;CORSE;MASCULIN;SCOLAIRE;BAC PROFESSIONNEL;BAC PRO PROD;BAC PRO AG 21302 GEST MILIEUX NATURELS FAUNE;4;4;4;0;0;0;0;4;0;0;1;2;1;0
1607.0;2021;27;CORSE;MASCULIN;SCOLAIRE;BAC PROFESSIONNEL;BAC PRO SERV;BAC PRO 31206 VENTE (PROSPECT.NEGO.SUIV.CLIENT;9;9;7;2;0;0;0;7;0;0;0;3;4;2
1609.0;2021;27;CORSE;MASCULIN;SCOLAIRE;BAC PROFESSIONNEL;BAC PRO SERV;BAC PRO 33002 SERVICES DE PROXIMITE  VIE LOCAL;1;1;1;0;0;0;0;1;0;0;0;0;1;0
1610.0;2021;27;CORSE;MASCULIN;SCOLAIRE;BAC PROFESSIONNEL;BAC PRO SERV;BAC PRO 33004 ACC.SOINS-S.PERS. OPT.EN STRUCTUR;6;6;6;0;0;0;0;6;0;0;2;2;2;0
1612.0;2021;27;CORSE;MASCULIN;SCOLAIRE;BAC PROFESSIONNEL;BAC PRO SERV;BAC PRO 34403 METIERS DE LA SECURITE;12;12;12;0;0;0;0;12;0;2;4;4;2;0
1619.0;2021;27;CORSE;MASCULIN;SCOLAIRE;BAC TECHNOLOGIQUE;BAC STI2D;BAC STI2D SYSTÈME D'INFORMATION  ET NUMERIQUE;34;34;32;0;2;1;1;33;0;1;8;13;11;1
1622.0;2021;27;CORSE;MASCULIN;SCOLAIRE;BAC TECHNOLOGIQUE;BAC STMG;BAC STMG MERCATIQUE (MARKETING);91;91;84;3;4;2;2;86;0;0;9;38;39;5
1623.0;2021;27;CORSE;MASCULIN;SCOLAIRE;BAC TECHNOLOGIQUE;BAC STMG;BAC STMG RESSOURCES HUMAINES ET COMMUNICATION;34;34;32;0;2;2;0;34;0;0;3;13;18;0
1626.0;2021;24;CRETEIL;FEMININ;APPRENTISSAGE;BAC PROFESSIONNEL;BAC PRO PROD;BAC PRO 23304 AMENAGEMENT FINITION BATIMENT;1;1;1;0;0;0;0;1;0;0;0;0;1;0
1635.0;2021;24;CRETEIL;FEMININ;APPRENTISSAGE;BAC PROFESSIONNEL;BAC PRO PROD;BAC PRO AG 22107 TEC CONS VTE ALIMENTATION P.ALIM;4;4;2;2;0;0;0;2;0;0;0;1;1;2
1639.0;2021;24;CRETEIL;FEMININ;APPRENTISSAGE;BAC PROFESSIONNEL;BAC PRO SERV;BAC PRO 31210 ACCUEIL -RELATION CLIENTS USAGERS;6;6;6;0;0;0;0;6;0;1;2;2;1;0
1649.0;2021;24;CRETEIL;FEMININ;ENSEIGNEMENT A DISTANCE;BAC PROFESSIONNEL;BAC PRO SERV;BAC PRO 31210 ACCUEIL -RELATION CLIENTS USAGERS;5;3;3;0;0;0;0;3;0;0;0;3;0;0
1650.0;2021;24;CRETEIL;FEMININ;ENSEIGNEMENT A DISTANCE;BAC PROFESSIONNEL;BAC PRO SERV;BAC PRO 33004 ACC.SOINS-S.PERS. OPT.EN STRUCTUR;8;6;3;3;0;0;0;3;0;0;1;1;1;3
1651.0;2021;24;CRETEIL;FEMININ;ENSEIGNEMENT A DISTANCE;BAC TECHNOLOGIQUE;BAC ST2S;BAC ST2S SCIENCES & TECHNO. SANTE & SOCIAL;9;9;6;1;2;0;2;6;0;0;5;1;0;3
1652.0;2021;24;CRETEIL;FEMININ;ENSEIGNEMENT A DISTANCE;BAC TECHNOLOGIQUE;BAC STMG;BAC STMG GESTION ET FINANCE;5;5;3;1;1;0;1;3;0;0;2;1;0;2
1654.0;2021;24;CRETEIL;FEMININ;ENSEIGNEMENT A DISTANCE;BAC TECHNOLOGIQUE;BAC STMG;BAC STMG RESSOURCES HUMAINES ET COMMUNICATION;7;7;7;0;0;0;0;7;0;1;3;2;1;0
1661.0;2021;24;CRETEIL;FEMININ;FORMATION CONTINUE;BAC PROFESSIONNEL;BAC PRO SERV;BAC PRO 33102 PROTHESE DENTAIRE;2;1;0;1;0;0;0;0;0;0;0;0;0;1
1664.0;2021;24;CRETEIL;FEMININ;INDIVIDUEL;BAC PROFESSIONNEL;BAC PRO PROD;BAC PRO 22106 CUISINE;1;1;1;0;0;0;0;1;0;0;0;0;1;0
1666.0;2021;24;CRETEIL;FEMININ;INDIVIDUEL;BAC PROFESSIONNEL;BAC PRO PROD;BAC PRO 24302 METIERS DU CUIR : MAROQUINERIE;1;0;0;0;0;0;0;0;0;0;0;0;0;0
1668.0;2021;24;CRETEIL;FEMININ;INDIVIDUEL;BAC PROFESSIONNEL;BAC PRO PROD;BAC PRO AG 21114 CONDUITE PRODUCTIONS HORTICOLES;4;3;3;0;0;0;0;3;0;0;0;0;3;0
1674.0;2021;24;CRETEIL;FEMININ;INDIVIDUEL;BAC PROFESSIONNEL;BAC PRO SERV;BAC PRO 31202 COMMERCE;15;14;7;6;1;0;1;7;0;0;1;2;4;7
1699.0;2021;24;CRETEIL;FEMININ;SCOLAIRE;BAC PROFESSIONNEL;BAC PRO PROD;BAC PRO 23005 TECHN. ETUDES BAT B ASSIST.ARCHI.;21;21;18;1;2;0;2;18;0;2;5;5;6;3
1703.0;2021;24;CRETEIL;FEMININ;SCOLAIRE;BAC PROFESSIONNEL;BAC PRO PROD;BAC PRO 23408 Etude et réalisation d'agencement;4;4;2;2;0;0;0;2;0;0;1;1;0;2
1704.0;2021;24;CRETEIL;FEMININ;SCOLAIRE;BAC PROFESSIONNEL;BAC PRO PROD;BAC PRO 24202 ARTIS.& MET.ART : TAPIS.D'AMEUBL;5;5;5;0;0;0;0;5;0;2;0;2;1;0
1705.0;2021;24;CRETEIL;FEMININ;SCOLAIRE;BAC PROFESSIONNEL;BAC PRO PROD;BAC PRO 24203 METIERS DE LA MODE - VÊTEMENT;188;186;143;37;6;5;1;148;0;21;35;42;50;38
1714.0;2021;24;CRETEIL;FEMININ;SCOLAIRE;BAC PROFESSIONNEL;BAC PRO PROD;BAC PRO 25411 TECH.CHAUDRONNERIE INDUSTRIELLE;1;1;1;0;0;0;0;1;0;0;0;0;1;0
1715.0;2021;24;CRETEIL;FEMININ;SCOLAIRE;BAC PROFESSIONNEL;BAC PRO PROD;BAC PRO 25510 METIERS ELECT. ENVIRON. CONNECTES;5;5;3;1;1;1;0;4;0;1;0;2;1;1
1718.0;2021;24;CRETEIL;FEMININ;SCOLAIRE;BAC PROFESSIONNEL;BAC PRO PROD;BAC PRO 25515 SYST.NUM.OPT.C RES.INF.SYST.COMM.;8;8;6;1;1;0;1;6;0;0;1;2;3;2
1719.0;2021;24;CRETEIL;FEMININ;SCOLAIRE;BAC PROFESSIONNEL;BAC PRO PROD;BAC PRO AG 21004 CGEA;22;21;17;4;0;0;0;17;0;1;0;4;12;4
1731.0;2021;24;CRETEIL;FEMININ;SCOLAIRE;BAC PROFESSIONNEL;BAC PRO SERV;BAC PRO 31210 ACCUEIL -RELATION CLIENTS USAGERS;475;471;382;57;32;27;5;409;0;15;75;151;168;62
1736.0;2021;24;CRETEIL;FEMININ;SCOLAIRE;BAC PROFESSIONNEL;BAC PRO SERV;BAC PRO 32304 PHOTOGRAPHIE;26;26;20;6;0;0;0;20;0;0;2;10;8;6
1740.0;2021;24;CRETEIL;FEMININ;SCOLAIRE;BAC PROFESSIONNEL;BAC PRO SERV;BAC PRO 33102 PROTHESE DENTAIRE;10;10;10;0;0;0;0;10;0;1;2;4;3;0
1741.0;2021;24;CRETEIL;FEMININ;SCOLAIRE;BAC PROFESSIONNEL;BAC PRO SERV;BAC PRO 33403 COMMERC. SERVICES EN RESTAURATION;44;44;34;8;2;0;2;34;0;1;8;13;12;10
1743.0;2021;24;CRETEIL;FEMININ;SCOLAIRE;BAC PROFESSIONNEL;BAC PRO SERV;BAC PRO 34303 GEST. POLLUTIONS PROTEC. ENVIRON.;2;2;2;0;0;0;0;2;0;2;0;0;0;0
1744.0;2021;24;CRETEIL;FEMININ;SCOLAIRE;BAC PROFESSIONNEL;BAC PRO SERV;BAC PRO 34304 HYGIENE PROPRETE STERILISATION;9;9;5;2;2;2;0;7;0;0;0;3;4;2
1745.0;2021;24;CRETEIL;FEMININ;SCOLAIRE;BAC PROFESSIONNEL;BAC PRO SERV;BAC PRO 34403 METIERS DE LA SECURITE;45;45;38;3;4;0;4;38;0;3;12;15;8;7
1747.0;2021;24;CRETEIL;FEMININ;SCOLAIRE;BAC TECHNOLOGIQUE;BAC ST2S;BAC ST2S SCIENCES & TECHNO. SANTE & SOCIAL;1426;1424;1326;26;72;34;38;1360;4;44;219;532;561;64
1761.0;2021;24;CRETEIL;MASCULIN;APPRENTISSAGE;BAC PROFESSIONNEL;BAC PRO PROD;BAC PRO 22105 BOULANGER-PÂTISSIER;7;7;6;1;0;0;0;6;0;1;1;3;1;1
1769.0;2021;24;CRETEIL;MASCULIN;APPRENTISSAGE;BAC PROFESSIONNEL;BAC PRO PROD;BAC PRO 25007 MAINTENANCE EQUIPEMENTS INDUST.;36;36;26;8;2;2;0;28;0;3;12;8;5;8
1773.0;2021;24;CRETEIL;MASCULIN;APPRENTISSAGE;BAC PROFESSIONNEL;BAC PRO PROD;BAC PRO 25216 MAINT.VEHIC.OPTC MOTOCYCLES;49;46;38;5;3;2;1;40;0;4;8;12;16;6
1780.0;2021;24;CRETEIL;MASCULIN;APPRENTISSAGE;BAC PROFESSIONNEL;BAC PRO PROD;BAC PRO 25515 SYST.NUM.OPT.C RES.INF.SYST.COMM.;20;20;16;2;2;2;0;18;0;1;5;4;8;2
1788.0;2021;24;CRETEIL;MASCULIN;APPRENTISSAGE;BAC PROFESSIONNEL;BAC PRO SERV;BAC PRO 31210 ACCUEIL -RELATION CLIENTS USAGERS;7;6;4;1;1;1;0;5;0;1;2;1;1;1
1789.0;2021;24;CRETEIL;MASCULIN;APPRENTISSAGE;BAC PROFESSIONNEL;BAC PRO SERV;BAC PRO 32303 ART.& MET.ART:COM.VIS.VIS.PLURI-M;8;7;6;1;0;0;0;6;0;0;0;1;5;1
1792.0;2021;24;CRETEIL;MASCULIN;APPRENTISSAGE;BAC PROFESSIONNEL;BAC PRO SERV;BAC PRO 34304 HYGIENE PROPRETE STERILISATION;21;20;14;4;2;1;1;15;0;0;3;5;7;5
1793.0;2021;24;CRETEIL;MASCULIN;ENSEIGNEMENT A DISTANCE;BAC GENERAL;BAC GENERAL;BAC GENE 10019 BAC GENERAL;43;37;35;1;1;0;1;35;1;5;13;5;11;2
1796.0;2021;24;CRETEIL;MASCULIN;ENSEIGNEMENT A DISTANCE;BAC PROFESSIONNEL;BAC PRO SERV;BAC PRO 31202 COMMERCE;3;3;1;2;0;0;0;1;0;0;0;0;1;2
1799.0;2021;24;CRETEIL;MASCULIN;ENSEIGNEMENT A DISTANCE;BAC PROFESSIONNEL;BAC PRO SERV;BAC PRO 33004 ACC.SOINS-S.PERS. OPT.EN STRUCTUR;1;1;1;0;0;0;0;1;0;0;0;1;0;0
1804.0;2021;24;CRETEIL;MASCULIN;FORMATION CONTINUE;BAC PROFESSIONNEL;BAC PRO PROD;BAC PRO 22704 TECHN. MAINT. SYST.ENERG.CLIMATI;13;13;13;0;0;0;0;13;0;3;3;6;1;0
1807.0;2021;24;CRETEIL;MASCULIN;FORMATION CONTINUE;BAC PROFESSIONNEL;BAC PRO PROD;BAC PRO 25106 TECHNICIEN D'USINAGE;1;1;1;0;0;0;0;1;0;0;1;0;0;0
1810.0;2021;24;CRETEIL;MASCULIN;FORMATION CONTINUE;BAC PROFESSIONNEL;BAC PRO PROD;BAC PRO 25510 METIERS ELECT. ENVIRON. CONNECTES;62;61;59;2;0;0;0;59;0;15;16;20;8;2
1811.0;2021;24;CRETEIL;MASCULIN;FORMATION CONTINUE;BAC PROFESSIONNEL;BAC PRO PROD;BAC PRO 25515 SYST.NUM.OPT.C RES.INF.SYST.COMM.;12;12;8;4;0;0;0;8;0;1;2;2;3;4
1817.0;2021;24;CRETEIL;MASCULIN;INDIVIDUEL;BAC PROFESSIONNEL;BAC PRO PROD;BAC PRO 22704 TECHN. MAINT. SYST.ENERG.CLIMATI;1;0;0;0;0;0;0;0;0;0;0;0;0;0
1832.0;2021;24;CRETEIL;MASCULIN;INDIVIDUEL;BAC PROFESSIONNEL;BAC PRO PROD;BAC PRO AG 21113 CGEVV;1;0;0;0;0;0;0;0;0;0;0;0;0;0
1841.0;2021;24;CRETEIL;MASCULIN;INDIVIDUEL;BAC PROFESSIONNEL;BAC PRO SERV;BAC PRO 32303 ART.& MET.ART:COM.VIS.VIS.PLURI-M;1;0;0;0;0;0;0;0;0;0;0;0;0;0
1843.0;2021;24;CRETEIL;MASCULIN;INDIVIDUEL;BAC PROFESSIONNEL;BAC PRO SERV;BAC PRO 33004 ACC.SOINS-S.PERS. OPT.EN STRUCTUR;1;0;0;0;0;0;0;0;0;0;0;0;0;0
1847.0;2021;24;CRETEIL;MASCULIN;INDIVIDUEL;BAC PROFESSIONNEL;BAC PRO SERV;BAC PRO 34403 METIERS DE LA SECURITE;2;1;1;0;0;0;0;1;0;0;0;0;1;0
1854.0;2021;24;CRETEIL;MASCULIN;INDIVIDUEL;BAC TECHNOLOGIQUE;BAC STMG;BAC STMG GESTION ET FINANCE;15;11;5;3;3;3;0;8;0;1;0;0;7;3
1872.0;2021;24;CRETEIL;MASCULIN;SCOLAIRE;BAC PROFESSIONNEL;BAC PRO PROD;BAC PRO 23304 AMENAGEMENT FINITION BATIMENT;30;30;25;3;2;2;0;27;0;1;9;8;9;3
1875.0;2021;24;CRETEIL;MASCULIN;SCOLAIRE;BAC PROFESSIONNEL;BAC PRO PROD;BAC PRO 23407 TECHNIC.FAB.BOIS ET MATERX ASSOC;13;13;9;4;0;0;0;9;0;0;1;2;6;4
1876.0;2021;24;CRETEIL;MASCULIN;SCOLAIRE;BAC PROFESSIONNEL;BAC PRO PROD;BAC PRO 23408 Etude et réalisation d'agencement;6;6;5;0;1;0;1;5;0;0;0;2;3;1
1878.0;2021;24;CRETEIL;MASCULIN;SCOLAIRE;BAC PROFESSIONNEL;BAC PRO PROD;BAC PRO 24302 METIERS DU CUIR : MAROQUINERIE;4;4;3;1;0;0;0;3;0;0;2;0;1;1
1890.0;2021;24;CRETEIL;MASCULIN;SCOLAIRE;BAC PROFESSIONNEL;BAC PRO PROD;BAC PRO 25304 AERONAUTIQUE OPTION STRUCTURE;18;18;14;1;3;0;3;14;0;0;3;5;6;4
1892.0;2021;24;CRETEIL;MASCULIN;SCOLAIRE;BAC PROFESSIONNEL;BAC PRO PROD;BAC PRO 25408 REPARATION DES CARROSSERIES;56;56;43;10;3;2;1;45;0;0;9;19;17;11
1895.0;2021;24;CRETEIL;MASCULIN;SCOLAIRE;BAC PROFESSIONNEL;BAC PRO PROD;BAC PRO 25509 TECHNIC. FROID CONDITIONNEMT AIR;90;90;57;27;6;6;0;63;0;5;15;15;28;27
1896.0;2021;24;CRETEIL;MASCULIN;SCOLAIRE;BAC PROFESSIONNEL;BAC PRO PROD;BAC PRO 25510 METIERS ELECT. ENVIRON. CONNECTES;1213;1206;973;193;40;19;21;992;0;47;235;404;306;214
1898.0;2021;24;CRETEIL;MASCULIN;SCOLAIRE;BAC PROFESSIONNEL;BAC PRO PROD;BAC PRO 25514 SYST.NUM.OPT.B AUD.RES.EQUIP.DOM.;92;92;85;5;2;1;1;86;0;1;17;44;24;6
1900.0;2021;24;CRETEIL;MASCULIN;SCOLAIRE;BAC PROFESSIONNEL;BAC PRO PROD;BAC PRO AG 21004 CGEA;17;17;13;4;0;0;0;13;0;0;1;5;7;4
1907.0;2021;24;CRETEIL;MASCULIN;SCOLAIRE;BAC PROFESSIONNEL;BAC PRO SERV;BAC PRO 31106 LOGISTIQUE;141;141;99;19;23;20;3;119;0;3;15;37;64;22
1908.0;2021;24;CRETEIL;MASCULIN;SCOLAIRE;BAC PROFESSIONNEL;BAC PRO SERV;BAC PRO 31107 CONDUCT. TRANSP.ROUT.MARCHANDISES;40;39;30;8;1;0;1;30;0;4;5;12;9;9
1910.0;2021;24;CRETEIL;MASCULIN;SCOLAIRE;BAC PROFESSIONNEL;BAC PRO SERV;BAC PRO 31202 COMMERCE;1124;1115;803;201;111;79;32;882;0;22;105;287;468;233
1913.0;2021;24;CRETEIL;MASCULIN;SCOLAIRE;BAC PROFESSIONNEL;BAC PRO SERV;BAC PRO 32206 FACONNAGE PRODTS IMPRIMES ROUTAGE;11;11;6;4;1;1;0;7;0;0;2;3;2;4
1920.0;2021;24;CRETEIL;MASCULIN;SCOLAIRE;BAC PROFESSIONNEL;BAC PRO SERV;BAC PRO 33101 OPTIQUE LUNETTERIE;32;30;26;3;1;0;1;26;0;0;5;7;14;4
1928.0;2021;24;CRETEIL;MASCULIN;SCOLAIRE;BAC TECHNOLOGIQUE;BAC STAV;BAC STAV AGRONOMIE ALIM ENV TERRITOI;25;25;25;0;0;0;0;25;0;1;1;12;11;0
1932.0;2021;24;CRETEIL;MASCULIN;SCOLAIRE;BAC TECHNOLOGIQUE;BAC STI2D;BAC STI2D ENERGIES  ET ENVIRONNEMENT;343;343;311;7;25;16;9;327;0;5;53;115;154;16
1933.0;2021;24;CRETEIL;MASCULIN;SCOLAIRE;BAC TECHNOLOGIQUE;BAC STI2D;BAC STI2D INNOVATION TECHNO.  ET ECO CONCEPTION;465;465;410;11;44;32;12;442;2;6;48;160;226;23
1935.0;2021;24;CRETEIL;MASCULIN;SCOLAIRE;BAC TECHNOLOGIQUE;BAC STL;BAC STL BIOCHIM.-BIOLOGIE-BIOTECHNOL.;96;96;74;5;17;10;7;84;1;1;8;31;43;12
1940.0;2021;24;CRETEIL;MASCULIN;SCOLAIRE;BAC TECHNOLOGIQUE;BAC STMG;BAC STMG SYSTEMES D'INFORMATION DE GESTION;203;201;187;7;7;4;3;191;0;2;18;70;101;10
1945.0;2021;07;DIJON;FEMININ;APPRENTISSAGE;BAC PROFESSIONNEL;BAC PRO PROD;BAC PRO 24302 METIERS DU CUIR : MAROQUINERIE;2;2;2;0;0;0;0;2;0;0;2;0;0;0
1954.0;2021;07;DIJON;FEMININ;APPRENTISSAGE;BAC PROFESSIONNEL;BAC PRO PROD;BAC PRO AG 21114 CONDUITE PRODUCTIONS HORTICOLES;2;2;2;0;0;0;0;2;0;0;1;0;1;0
1964.0;2021;07;DIJON;FEMININ;APPRENTISSAGE;BAC PROFESSIONNEL;BAC PRO SERV;BAC PRO 33002 SERVICES DE PROXIMITE  VIE LOCAL;5;5;5;0;0;0;0;5;0;0;2;2;1;0
1969.0;2021;07;DIJON;FEMININ;ENSEIGNEMENT A DISTANCE;BAC PROFESSIONNEL;BAC PRO SERV;BAC PRO 31202 COMMERCE;3;3;3;0;0;0;0;3;0;0;0;2;1;0
1975.0;2021;07;DIJON;FEMININ;FORMATION CONTINUE;BAC PROFESSIONNEL;BAC PRO PROD;BAC PRO 23304 AMENAGEMENT FINITION BATIMENT;1;1;1;0;0;0;0;1;0;0;0;1;0;0
1979.0;2021;07;DIJON;FEMININ;FORMATION CONTINUE;BAC PROFESSIONNEL;BAC PRO SERV;BAC PRO 33102 PROTHESE DENTAIRE;7;7;7;0;0;0;0;7;0;0;4;3;0;0
1980.0;2021;07;DIJON;FEMININ;INDIVIDUEL;BAC GENERAL;BAC GENERAL;BAC GENE 10019 BAC GENERAL;39;30;19;11;0;0;0;19;0;0;8;7;4;11
1981.0;2021;07;DIJON;FEMININ;INDIVIDUEL;BAC PROFESSIONNEL;BAC PRO PROD;BAC PRO AG 21004 CGEA;2;2;2;0;0;0;0;2;0;0;0;0;2;0
1989.0;2021;07;DIJON;FEMININ;INDIVIDUEL;BAC PROFESSIONNEL;BAC PRO SERV;BAC PRO 33003 ACC.SOINS-S.PERS. OPT.A DOMICILE;2;2;1;1;0;0;0;1;0;0;0;0;1;1
1992.0;2021;07;DIJON;FEMININ;INDIVIDUEL;BAC TECHNOLOGIQUE;BAC ST2S;BAC ST2S SCIENCES & TECHNO. SANTE & SOCIAL;7;5;2;2;1;1;0;3;0;0;1;0;2;2
1995.0;2021;07;DIJON;FEMININ;INDIVIDUEL;BAC TECHNOLOGIQUE;BAC STMG;BAC STMG RESSOURCES HUMAINES ET COMMUNICATION;1;1;1;0;0;0;0;1;0;0;0;0;1;0
2004.0;2021;07;DIJON;FEMININ;SCOLAIRE;BAC PROFESSIONNEL;BAC PRO PROD;BAC PRO 22703 TECHN.INSTALL.SYST.ENERG.CLIMATI;1;1;0;0;1;0;1;0;0;0;0;0;0;1
2007.0;2021;07;DIJON;FEMININ;SCOLAIRE;BAC PROFESSIONNEL;BAC PRO PROD;BACPRO 23103 TECHNICIEN GEOMETRE-TOPOGRAPHE;2;2;2;0;0;0;0;2;0;0;1;1;0;0
2008.0;2021;07;DIJON;FEMININ;SCOLAIRE;BAC PROFESSIONNEL;BAC PRO PROD;BAC PRO 23304 AMENAGEMENT FINITION BATIMENT;5;5;5;0;0;0;0;5;0;0;1;1;3;0
2010.0;2021;07;DIJON;FEMININ;SCOLAIRE;BAC PROFESSIONNEL;BAC PRO PROD;BAC PRO 23408 Etude et réalisation d'agencement;8;8;5;2;1;0;1;5;0;1;1;2;1;3
2015.0;2021;07;DIJON;FEMININ;SCOLAIRE;BAC PROFESSIONNEL;BAC PRO PROD;BAC PRO 25106 TECHNICIEN D'USINAGE;3;3;3;0;0;0;0;3;0;0;0;2;1;0
2016.0;2021;07;DIJON;FEMININ;SCOLAIRE;BAC PROFESSIONNEL;BAC PRO PROD;BAC PRO 25108 TECHNICIEN MODELEUR;8;8;7;0;1;1;0;8;0;0;2;2;4;0
2018.0;2021;07;DIJON;FEMININ;SCOLAIRE;BAC PROFESSIONNEL;BAC PRO PROD;BAC PRO 25215 MAINT.VEHIC.OPTB VEHIC.TRANS.ROUT;1;1;1;0;0;0;0;1;0;0;1;0;0;0
2020.0;2021;07;DIJON;FEMININ;SCOLAIRE;BAC PROFESSIONNEL;BAC PRO PROD;BAC PRO 25305 AVIATION GENERALE;1;1;0;0;1;1;0;1;0;0;0;0;1;0
2021.0;2021;07;DIJON;FEMININ;SCOLAIRE;BAC PROFESSIONNEL;BAC PRO PROD;BAC PRO 25406 OUVRAGES DU BATIMENT METALLERIE;1;1;1;0;0;0;0;1;0;0;1;0;0;0
2023.0;2021;07;DIJON;FEMININ;SCOLAIRE;BAC PROFESSIONNEL;BAC PRO PROD;BAC PRO 25411 TECH.CHAUDRONNERIE INDUSTRIELLE;2;2;2;0;0;0;0;2;0;1;0;1;0;0
2031.0;2021;07;DIJON;FEMININ;SCOLAIRE;BAC PROFESSIONNEL;BAC PRO PROD;BAC PRO AG 21203 TECHN CONSEIL DE VENTE ANIMAL;8;8;8;0;0;0;0;8;0;0;1;2;5;0
2038.0;2021;07;DIJON;FEMININ;SCOLAIRE;BAC PROFESSIONNEL;BAC PRO PROD;BAC PRO AG 22107 TEC CONS VTE ALIMENTATION P.ALIM;37;36;33;3;0;0;0;33;0;0;4;10;19;3
2041.0;2021;07;DIJON;FEMININ;SCOLAIRE;BAC PROFESSIONNEL;BAC PRO SERV;BAC PRO 31107 CONDUCT. TRANSP.ROUT.MARCHANDISES;2;2;2;0;0;0;0;2;0;0;0;2;0;0
2049.0;2021;07;DIJON;FEMININ;SCOLAIRE;BAC PROFESSIONNEL;BAC PRO SERV;BAC PRO 33003 ACC.SOINS-S.PERS. OPT.A DOMICILE;114;113;105;3;5;4;1;109;0;7;26;36;40;4
2052.0;2021;07;DIJON;FEMININ;SCOLAIRE;BAC PROFESSIONNEL;BAC PRO SERV;BAC PRO 33102 PROTHESE DENTAIRE;10;10;8;2;0;0;0;8;0;0;2;4;2;2
2055.0;2021;07;DIJON;FEMININ;SCOLAIRE;BAC PROFESSIONNEL;BAC PRO SERV;BAC PRO 33603 ESTHETIQUE COSMETIQUE PARFUMERIE;66;66;62;3;1;1;0;63;0;0;19;26;18;3
2071.0;2021;07;DIJON;FEMININ;SCOLAIRE;BAC TECHNOLOGIQUE;BAC STMG;BAC STMG GESTION ET FINANCE;107;107;98;1;8;5;3;103;0;4;23;40;36;4
2082.0;2021;07;DIJON;MASCULIN;APPRENTISSAGE;BAC PROFESSIONNEL;BAC PRO PROD;BAC PRO 23303 MENUISERIE ALUMINIUM-VERRE;9;9;9;0;0;0;0;9;0;0;3;3;3;0
2084.0;2021;07;DIJON;MASCULIN;APPRENTISSAGE;BAC PROFESSIONNEL;BAC PRO PROD;BAC PRO 25007 MAINTENANCE EQUIPEMENTS INDUST.;33;33;30;1;2;0;2;30;0;2;11;10;7;3
2090.0;2021;07;DIJON;MASCULIN;APPRENTISSAGE;BAC PROFESSIONNEL;BAC PRO PROD;BAC PRO 25215 MAINT.VEHIC.OPTB VEHIC.TRANS.ROUT;31;31;19;10;2;1;1;20;0;0;2;9;9;11
2096.0;2021;07;DIJON;MASCULIN;APPRENTISSAGE;BAC PROFESSIONNEL;BAC PRO PROD;BAC PRO 25510 METIERS ELECT. ENVIRON. CONNECTES;22;22;20;1;1;0;1;20;0;1;6;9;4;2
2097.0;2021;07;DIJON;MASCULIN;APPRENTISSAGE;BAC PROFESSIONNEL;BAC PRO PROD;BAC PRO 25514 SYST.NUM.OPT.B AUD.RES.EQUIP.DOM.;3;3;3;0;0;0;0;3;0;0;1;1;1;0
2105.0;2021;07;DIJON;MASCULIN;APPRENTISSAGE;BAC PROFESSIONNEL;BAC PRO PROD;BAC PRO AG 22106 TEC CONS VTE ALIMENTATION VINS SP;1;1;1;0;0;0;0;1;0;0;0;0;1;0
2108.0;2021;07;DIJON;MASCULIN;APPRENTISSAGE;BAC PROFESSIONNEL;BAC PRO SERV;BAC PRO 31202 COMMERCE;28;26;23;2;1;0;1;23;0;1;8;8;6;3
2109.0;2021;07;DIJON;MASCULIN;APPRENTISSAGE;BAC PROFESSIONNEL;BAC PRO SERV;BAC PRO 31206 VENTE (PROSPECT.NEGO.SUIV.CLIENT;1;1;0;0;1;1;0;1;0;0;0;0;1;0
2116.0;2021;07;DIJON;MASCULIN;FORMATION CONTINUE;BAC PROFESSIONNEL;BAC PRO PROD;BAC PRO 22106 CUISINE;2;2;1;1;0;0;0;1;0;0;0;1;0;1
2124.0;2021;07;DIJON;MASCULIN;FORMATION CONTINUE;BAC PROFESSIONNEL;BAC PRO SERV;BAC PRO AG 33002 SERV PERS TERRIT;1;1;1;0;0;0;0;1;0;0;0;0;1;0
2128.0;2021;07;DIJON;MASCULIN;INDIVIDUEL;BAC PROFESSIONNEL;BAC PRO PROD;BAC PRO 25214 MAINT.VEHIC.OPTA VOIT.PARTICUL.;1;1;1;0;0;0;0;1;0;0;0;1;0;0
2131.0;2021;07;DIJON;MASCULIN;INDIVIDUEL;BAC PROFESSIONNEL;BAC PRO PROD;BAC PRO AG 21203 TECHN CONSEIL DE VENTE ANIMAL;1;0;0;0;0;0;0;0;0;0;0;0;0;0
2133.0;2021;07;DIJON;MASCULIN;INDIVIDUEL;BAC PROFESSIONNEL;BAC PRO SERV;BAC PRO 30001 GESTION-ADMINISTRATION;2;1;1;0;0;0;0;1;0;0;0;0;1;0
2140.0;2021;07;DIJON;MASCULIN;INDIVIDUEL;BAC TECHNOLOGIQUE;BAC STI2D;BAC STI2D INNOVATION TECHNO.  ET ECO CONCEPTION;2;2;0;0;2;1;1;1;0;0;0;0;1;1
2141.0;2021;07;DIJON;MASCULIN;INDIVIDUEL;BAC TECHNOLOGIQUE;BAC STI2D;BAC STI2D SYSTÈME D'INFORMATION  ET NUMERIQUE;1;1;1;0;0;0;0;1;0;0;0;0;1;0
2144.0;2021;07;DIJON;MASCULIN;INDIVIDUEL;BAC TECHNOLOGIQUE;BAC STMG;BAC STMG RESSOURCES HUMAINES ET COMMUNICATION;3;3;0;3;0;0;0;0;0;0;0;0;0;3
2152.0;2021;07;DIJON;MASCULIN;SCOLAIRE;BAC PROFESSIONNEL;BAC PRO PROD;BAC PRO 22503 PLASTIQUES ET COMPOSITES;17;17;14;2;1;0;1;14;0;0;0;7;7;3
2160.0;2021;07;DIJON;MASCULIN;SCOLAIRE;BAC PROFESSIONNEL;BAC PRO PROD;BAC PRO 23205 INTERV. SUR PATRIMOINE BATI OPT.A;1;1;1;0;0;0;0;1;0;0;1;0;0;0
2162.0;2021;07;DIJON;MASCULIN;SCOLAIRE;BAC PROFESSIONNEL;BAC PRO PROD;BAC PRO 23303 MENUISERIE ALUMINIUM-VERRE;5;5;4;0;1;1;0;5;0;0;2;1;2;0
2166.0;2021;07;DIJON;MASCULIN;SCOLAIRE;BAC PROFESSIONNEL;BAC PRO PROD;BAC PRO 23408 Etude et réalisation d'agencement;5;5;4;1;0;0;0;4;0;0;0;2;2;1
2167.0;2021;07;DIJON;MASCULIN;SCOLAIRE;BAC PROFESSIONNEL;BAC PRO PROD;BAC PRO 24202 ARTIS.& MET.ART : TAPIS.D'AMEUBL;1;1;1;0;0;0;0;1;0;0;1;0;0;0
2169.0;2021;07;DIJON;MASCULIN;SCOLAIRE;BAC PROFESSIONNEL;BAC PRO PROD;BAC PRO 24302 METIERS DU CUIR : MAROQUINERIE;3;3;3;0;0;0;0;3;0;0;0;1;2;0
2172.0;2021;07;DIJON;MASCULIN;SCOLAIRE;BAC PROFESSIONNEL;BAC PRO PROD;BAC PRO 25107 TECHNICIEN OUTILLEUR;10;10;8;2;0;0;0;8;0;0;0;5;3;2
2173.0;2021;07;DIJON;MASCULIN;SCOLAIRE;BAC PROFESSIONNEL;BAC PRO PROD;BAC PRO 25108 TECHNICIEN MODELEUR;3;3;3;0;0;0;0;3;0;1;1;1;0;0
2174.0;2021;07;DIJON;MASCULIN;SCOLAIRE;BAC PROFESSIONNEL;BAC PRO PROD;BAC PRO 25214 MAINT.VEHIC.OPTA VOIT.PARTICUL.;131;131;106;13;12;9;3;115;0;12;22;35;46;16
2177.0;2021;07;DIJON;MASCULIN;SCOLAIRE;BAC PROFESSIONNEL;BAC PRO PROD;BAC PRO 25220 MAINT.MATERIELS OPT.B TP MANUT.;10;10;8;2;0;0;0;8;0;0;1;0;7;2
2186.0;2021;07;DIJON;MASCULIN;SCOLAIRE;BAC PROFESSIONNEL;BAC PRO PROD;BAC PRO 25513 SYST.NUM.OPT.A SURETE SECURITE;19;19;15;2;2;2;0;17;0;2;3;6;6;2
2187.0;2021;07;DIJON;MASCULIN;SCOLAIRE;BAC PROFESSIONNEL;BAC PRO PROD;BAC PRO 25514 SYST.NUM.OPT.B AUD.RES.EQUIP.DOM.;42;42;40;2;0;0;0;40;0;7;10;16;7;2
2189.0;2021;07;DIJON;MASCULIN;SCOLAIRE;BAC PROFESSIONNEL;BAC PRO PROD;BAC PRO AG 21004 CGEA;79;76;67;9;0;0;0;67;0;1;11;36;19;9
2191.0;2021;07;DIJON;MASCULIN;SCOLAIRE;BAC PROFESSIONNEL;BAC PRO PROD;BAC PRO AG 21114 CONDUITE PRODUCTIONS HORTICOLES;8;8;8;0;0;0;0;8;0;0;0;4;4;0
2196.0;2021;07;DIJON;MASCULIN;SCOLAIRE;BAC PROFESSIONNEL;BAC PRO PROD;BAC PRO AG 21302 GEST MILIEUX NATURELS FAUNE;15;15;14;1;0;0;0;14;0;0;1;7;6;1
2199.0;2021;07;DIJON;MASCULIN;SCOLAIRE;BAC PROFESSIONNEL;BAC PRO PROD;BAC PRO AG 22106 TEC CONS VTE ALIMENTATION VINS SP;12;11;11;0;0;0;0;11;0;1;1;5;4;0
2214.0;2021;07;DIJON;MASCULIN;SCOLAIRE;BAC PROFESSIONNEL;BAC PRO SERV;BAC PRO 33102 PROTHESE DENTAIRE;6;6;3;3;0;0;0;3;0;0;2;0;1;3
2217.0;2021;07;DIJON;MASCULIN;SCOLAIRE;BAC PROFESSIONNEL;BAC PRO SERV;BAC PRO 34304 HYGIENE PROPRETE STERILISATION;1;1;1;0;0;0;0;1;0;0;0;1;0;0
2218.0;2021;07;DIJON;MASCULIN;SCOLAIRE;BAC PROFESSIONNEL;BAC PRO SERV;BAC PRO 34305 TECHN.D'INTERV.SUR INSTALL. NUCL.;7;7;5;1;1;0;1;5;0;0;1;3;1;2
2219.0;2021;07;DIJON;MASCULIN;SCOLAIRE;BAC PROFESSIONNEL;BAC PRO SERV;BAC PRO 34403 METIERS DE LA SECURITE;54;54;54;0;0;0;0;54;0;6;24;17;7;0
2221.0;2021;07;DIJON;MASCULIN;SCOLAIRE;BAC TECHNOLOGIQUE;BAC S2TMD;BAC S2TMD MUSIQUE;5;5;5;0;0;0;0;5;0;0;2;3;0;0
2227.0;2021;07;DIJON;MASCULIN;SCOLAIRE;BAC TECHNOLOGIQUE;BAC STI2D;BAC STI2D ENERGIES  ET ENVIRONNEMENT;97;97;86;1;10;6;4;92;0;0;9;39;44;5
2228.0;2021;07;DIJON;MASCULIN;SCOLAIRE;BAC TECHNOLOGIQUE;BAC STI2D;BAC STI2D INNOVATION TECHNO.  ET ECO CONCEPTION;255;255;243;3;9;4;5;247;0;5;41;105;96;8
2233.0;2021;07;DIJON;MASCULIN;SCOLAIRE;BAC TECHNOLOGIQUE;BAC STMG;BAC STMG MERCATIQUE (MARKETING);351;351;290;18;43;25;18;315;0;2;12;116;185;36
2235.0;2021;07;DIJON;MASCULIN;SCOLAIRE;BAC TECHNOLOGIQUE;BAC STMG;BAC STMG SYSTEMES D'INFORMATION DE GESTION;9;9;8;0;1;1;0;9;0;0;2;4;3;0
2236.0;2021;08;GRENOBLE;FEMININ;APPRENTISSAGE;BAC PROFESSIONNEL;BAC PRO PROD;BACPRO 20002 ETUD.DEFINITION PRDTS INDUSTRIEL;2;2;2;0;0;0;0;2;0;0;0;2;0;0
2238.0;2021;08;GRENOBLE;FEMININ;APPRENTISSAGE;BAC PROFESSIONNEL;BAC PRO PROD;BAC PRO 22003 BIO-INDUSTRIES DE TRANSFORMATION;2;2;2;0;0;0;0;2;0;1;0;0;1;0
2240.0;2021;08;GRENOBLE;FEMININ;APPRENTISSAGE;BAC PROFESSIONNEL;BAC PRO PROD;BAC PRO 22106 CUISINE;2;2;1;0;1;1;0;2;0;0;1;0;1;0
2242.0;2021;08;GRENOBLE;FEMININ;APPRENTISSAGE;BAC PROFESSIONNEL;BAC PRO PROD;BAC PRO 23208 METIERS ET ARTS DE LA PIERRE;2;1;1;0;0;0;0;1;0;0;1;0;0;0
2248.0;2021;08;GRENOBLE;FEMININ;APPRENTISSAGE;BAC PROFESSIONNEL;BAC PRO PROD;BAC PRO 25214 MAINT.VEHIC.OPTA VOIT.PARTICUL.;7;7;7;0;0;0;0;7;0;1;2;2;2;0
2250.0;2021;08;GRENOBLE;FEMININ;APPRENTISSAGE;BAC PROFESSIONNEL;BAC PRO PROD;BAC PRO 25408 REPARATION DES CARROSSERIES;1;1;1;0;0;0;0;1;0;0;0;1;0;0
2268.0;2021;08;GRENOBLE;FEMININ;ENSEIGNEMENT A DISTANCE;BAC PROFESSIONNEL;BAC PRO SERV;BAC PRO 33004 ACC.SOINS-S.PERS. OPT.EN STRUCTUR;8;4;2;2;0;0;0;2;0;0;1;0;1;2
2269.0;2021;08;GRENOBLE;FEMININ;ENSEIGNEMENT A DISTANCE;BAC TECHNOLOGIQUE;BAC ST2S;BAC ST2S SCIENCES & TECHNO. SANTE & SOCIAL;4;4;3;0;1;0;1;3;0;1;1;1;0;1
2270.0;2021;08;GRENOBLE;FEMININ;ENSEIGNEMENT A DISTANCE;BAC TECHNOLOGIQUE;BAC STMG;BAC STMG GESTION ET FINANCE;3;3;3;0;0;0;0;3;1;0;1;1;0;0
2272.0;2021;08;GRENOBLE;FEMININ;ENSEIGNEMENT A DISTANCE;BAC TECHNOLOGIQUE;BAC STMG;BAC STMG RESSOURCES HUMAINES ET COMMUNICATION;8;8;7;1;0;0;0;7;0;0;1;3;3;1
2280.0;2021;08;GRENOBLE;FEMININ;INDIVIDUEL;BAC PROFESSIONNEL;BAC PRO PROD;BAC PRO 24203 METIERS DE LA MODE - VÊTEMENT;1;0;0;0;0;0;0;0;0;0;0;0;0;0
2282.0;2021;08;GRENOBLE;FEMININ;INDIVIDUEL;BAC PROFESSIONNEL;BAC PRO PROD;BAC PRO AG 21113 CGEVV;1;1;1;0;0;0;0;1;0;0;0;0;1;0
2286.0;2021;08;GRENOBLE;FEMININ;INDIVIDUEL;BAC PROFESSIONNEL;BAC PRO PROD;BAC PRO AG 21302 GEST MILIEUX NATURELS FAUNE;2;2;2;0;0;0;0;2;0;0;1;1;0;0
2290.0;2021;08;GRENOBLE;FEMININ;INDIVIDUEL;BAC PROFESSIONNEL;BAC PRO SERV;BAC PRO 33003 ACC.SOINS-S.PERS. OPT.A DOMICILE;2;2;2;0;0;0;0;2;0;0;1;0;1;0
2293.0;2021;08;GRENOBLE;FEMININ;INDIVIDUEL;BAC PROFESSIONNEL;BAC PRO SERV;BAC PRO AG 33002 SERV PERS TERRIT;1;0;0;0;0;0;0;0;0;0;0;0;0;0
2297.0;2021;08;GRENOBLE;FEMININ;INDIVIDUEL;BAC TECHNOLOGIQUE;BAC STI2D;BAC STI2D ENERGIES  ET ENVIRONNEMENT;1;1;1;0;0;0;0;1;0;0;0;1;0;0
2298.0;2021;08;GRENOBLE;FEMININ;INDIVIDUEL;BAC TECHNOLOGIQUE;BAC STMG;BAC STMG GESTION ET FINANCE;10;6;2;2;2;1;1;3;0;0;0;0;3;3
2307.0;2021;08;GRENOBLE;FEMININ;SCOLAIRE;BAC PROFESSIONNEL;BAC PRO PROD;BAC PRO 22106 CUISINE;73;73;67;4;2;2;0;69;0;13;17;23;16;4
2310.0;2021;08;GRENOBLE;FEMININ;SCOLAIRE;BAC PROFESSIONNEL;BAC PRO PROD;BAC PRO 23005 TECHN. ETUDES BAT B ASSIST.ARCHI.;12;12;10;2;0;0;0;10;0;0;3;4;3;2
2312.0;2021;08;GRENOBLE;FEMININ;SCOLAIRE;BAC PROFESSIONNEL;BAC PRO PROD;BAC PRO 23203 TECHNICIEN BAT. : ORG.REAL.GROS O;1;1;1;0;0;0;0;1;0;0;0;0;1;0
2319.0;2021;08;GRENOBLE;FEMININ;SCOLAIRE;BAC PROFESSIONNEL;BAC PRO PROD;BAC PRO 24301 METIERS DU CUIR : CHAUSSURES;8;8;8;0;0;0;0;8;0;1;0;5;2;0
2328.0;2021;08;GRENOBLE;FEMININ;SCOLAIRE;BAC PROFESSIONNEL;BAC PRO PROD;BAC PRO 25408 REPARATION DES CARROSSERIES;3;3;0;3;0;0;0;0;0;0;0;0;0;3
2329.0;2021;08;GRENOBLE;FEMININ;SCOLAIRE;BAC PROFESSIONNEL;BAC PRO PROD;BAC PRO 25411 TECH.CHAUDRONNERIE INDUSTRIELLE;4;4;4;0;0;0;0;4;0;1;1;1;1;0
2330.0;2021;08;GRENOBLE;FEMININ;SCOLAIRE;BAC PROFESSIONNEL;BAC PRO PROD;BAC PRO 25510 METIERS ELECT. ENVIRON. CONNECTES;5;5;4;0;1;0;1;4;0;0;1;1;2;1
2350.0;2021;08;GRENOBLE;FEMININ;SCOLAIRE;BAC PROFESSIONNEL;BAC PRO SERV;BAC PRO 31206 VENTE (PROSPECT.NEGO.SUIV.CLIENT;164;163;142;15;6;5;1;147;0;9;32;57;49;16
2351.0;2021;08;GRENOBLE;FEMININ;SCOLAIRE;BAC PROFESSIONNEL;BAC PRO SERV;BAC PRO 31210 ACCUEIL -RELATION CLIENTS USAGERS;236;236;204;16;16;9;7;213;0;7;34;74;98;23
2354.0;2021;08;GRENOBLE;FEMININ;SCOLAIRE;BAC PROFESSIONNEL;BAC PRO SERV;BAC PRO 33002 SERVICES DE PROXIMITE  VIE LOCAL;42;42;36;4;2;0;2;36;0;0;6;18;12;6
2356.0;2021;08;GRENOBLE;FEMININ;SCOLAIRE;BAC PROFESSIONNEL;BAC PRO SERV;BAC PRO 33004 ACC.SOINS-S.PERS. OPT.EN STRUCTUR;550;550;503;22;25;15;10;518;0;26;99;236;157;32
2360.0;2021;08;GRENOBLE;FEMININ;SCOLAIRE;BAC PROFESSIONNEL;BAC PRO SERV;BAC PRO 34304 HYGIENE PROPRETE STERILISATION;4;4;2;1;1;1;0;3;0;0;2;0;1;1
2363.0;2021;08;GRENOBLE;FEMININ;SCOLAIRE;BAC TECHNOLOGIQUE;BAC S2TMD;BAC S2TMD DANSE;4;4;4;0;0;0;0;4;0;1;2;1;0;0
2370.0;2021;08;GRENOBLE;FEMININ;SCOLAIRE;BAC TECHNOLOGIQUE;BAC STI2D;BAC STI2D ENERGIES  ET ENVIRONNEMENT;27;27;26;1;0;0;0;26;0;1;10;7;8;1
2377.0;2021;08;GRENOBLE;FEMININ;SCOLAIRE;BAC TECHNOLOGIQUE;BAC STMG;BAC STMG RESSOURCES HUMAINES ET COMMUNICATION;754;753;683;6;64;33;31;716;0;4;107;289;316;37
2381.0;2021;08;GRENOBLE;MASCULIN;APPRENTISSAGE;BAC PROFESSIONNEL;BAC PRO PROD;BAC PRO 22003 BIO-INDUSTRIES DE TRANSFORMATION;4;4;4;0;0;0;0;4;0;0;1;1;2;0
2382.0;2021;08;GRENOBLE;MASCULIN;APPRENTISSAGE;BAC PROFESSIONNEL;BAC PRO PROD;BAC PRO 22004 PROC. CHIMIE EAU PAPIERS-CARTONS;19;19;19;0;0;0;0;19;0;8;7;3;1;0
2384.0;2021;08;GRENOBLE;MASCULIN;APPRENTISSAGE;BAC PROFESSIONNEL;BAC PRO PROD;BAC PRO 22503 PLASTIQUES ET COMPOSITES;1;1;0;0;1;1;0;1;0;0;0;0;1;0
2391.0;2021;08;GRENOBLE;MASCULIN;APPRENTISSAGE;BAC PROFESSIONNEL;BAC PRO PROD;BAC PRO 23205 INTERV. SUR PATRIMOINE BATI OPT.A;8;8;8;0;0;0;0;8;0;0;1;4;3;0
2393.0;2021;08;GRENOBLE;MASCULIN;APPRENTISSAGE;BAC PROFESSIONNEL;BAC PRO PROD;BAC PRO 23303 MENUISERIE ALUMINIUM-VERRE;1;1;1;0;0;0;0;1;0;0;0;1;0;0
2401.0;2021;08;GRENOBLE;MASCULIN;APPRENTISSAGE;BAC PROFESSIONNEL;BAC PRO PROD;BAC PRO 25214 MAINT.VEHIC.OPTA VOIT.PARTICUL.;215;212;193;14;5;4;1;197;0;14;53;69;61;15
2402.0;2021;08;GRENOBLE;MASCULIN;APPRENTISSAGE;BAC PROFESSIONNEL;BAC PRO PROD;BAC PRO 25215 MAINT.VEHIC.OPTB VEHIC.TRANS.ROUT;34;34;32;0;2;2;0;34;0;1;5;12;16;0
2403.0;2021;08;GRENOBLE;MASCULIN;APPRENTISSAGE;BAC PROFESSIONNEL;BAC PRO PROD;BAC PRO 25216 MAINT.VEHIC.OPTC MOTOCYCLES;24;24;20;4;0;0;0;20;0;0;9;6;5;4
2411.0;2021;08;GRENOBLE;MASCULIN;APPRENTISSAGE;BAC PROFESSIONNEL;BAC PRO PROD;BAC PRO 25411 TECH.CHAUDRONNERIE INDUSTRIELLE;59;59;51;5;3;3;0;54;0;5;15;16;18;5
2415.0;2021;08;GRENOBLE;MASCULIN;APPRENTISSAGE;BAC PROFESSIONNEL;BAC PRO PROD;BAC PRO AG 21004 CGEA;16;16;14;2;0;0;0;14;0;0;3;6;5;2
2426.0;2021;08;GRENOBLE;MASCULIN;APPRENTISSAGE;BAC PROFESSIONNEL;BAC PRO SERV;BAC PRO 33403 COMMERC. SERVICES EN RESTAURATION;4;4;3;1;0;0;0;3;0;0;0;2;1;1
2428.0;2021;08;GRENOBLE;MASCULIN;ENSEIGNEMENT A DISTANCE;BAC GENERAL;BAC GENERAL;BAC GENE 10019 BAC GENERAL;40;39;35;3;1;0;1;35;0;6;9;15;5;4
2437.0;2021;08;GRENOBLE;MASCULIN;FORMATION CONTINUE;BAC PROFESSIONNEL;BAC PRO PROD;BAC PRO 22703 TECHN.INSTALL.SYST.ENERG.CLIMATI;3;3;3;0;0;0;0;3;0;1;0;1;1;0
2440.0;2021;08;GRENOBLE;MASCULIN;FORMATION CONTINUE;BAC PROFESSIONNEL;BAC PRO PROD;BAC PRO 25411 TECH.CHAUDRONNERIE INDUSTRIELLE;3;3;3;0;0;0;0;3;0;0;2;1;0;0
2441.0;2021;08;GRENOBLE;MASCULIN;FORMATION CONTINUE;BAC PROFESSIONNEL;BAC PRO PROD;BAC PRO 25510 METIERS ELECT. ENVIRON. CONNECTES;6;6;6;0;0;0;0;6;0;2;2;2;0;0
2446.0;2021;08;GRENOBLE;MASCULIN;INDIVIDUEL;BAC PROFESSIONNEL;BAC PRO PROD;BAC PRO 23004 TECHN. ETUDES BAT.A ETUDES & ECO.;1;1;0;1;0;0;0;0;0;0;0;0;0;1
2449.0;2021;08;GRENOBLE;MASCULIN;INDIVIDUEL;BAC PROFESSIONNEL;BAC PRO PROD;BAC PRO 25214 MAINT.VEHIC.OPTA VOIT.PARTICUL.;5;5;3;2;0;0;0;3;0;0;2;0;1;2
2454.0;2021;08;GRENOBLE;MASCULIN;INDIVIDUEL;BAC PROFESSIONNEL;BAC PRO PROD;BAC PRO 25510 METIERS ELECT. ENVIRON. CONNECTES;8;8;5;2;1;1;0;6;0;0;1;1;4;2
2457.0;2021;08;GRENOBLE;MASCULIN;INDIVIDUEL;BAC PROFESSIONNEL;BAC PRO PROD;BAC PRO AG 21001 AGRO-EQUIPEMENT;1;0;0;0;0;0;0;0;0;0;0;0;0;0
2460.0;2021;08;GRENOBLE;MASCULIN;INDIVIDUEL;BAC PROFESSIONNEL;BAC PRO PROD;BAC PRO AG 21211 COND GEST ENTR HIPPIQUE;1;1;1;0;0;0;0;1;0;0;0;0;1;0
2464.0;2021;08;GRENOBLE;MASCULIN;INDIVIDUEL;BAC PROFESSIONNEL;BAC PRO SERV;BAC PRO 31106 LOGISTIQUE;1;1;1;0;0;0;0;1;0;0;0;0;1;0
2471.0;2021;08;GRENOBLE;MASCULIN;INDIVIDUEL;BAC TECHNOLOGIQUE;BAC ST2S;BAC ST2S SCIENCES & TECHNO. SANTE & SOCIAL;4;4;1;3;0;0;0;1;0;0;0;1;0;3
2478.0;2021;08;GRENOBLE;MASCULIN;INDIVIDUEL;BAC TECHNOLOGIQUE;BAC STMG;BAC STMG GESTION ET FINANCE;10;9;2;4;3;2;1;4;0;0;0;0;4;5
2487.0;2021;08;GRENOBLE;MASCULIN;SCOLAIRE;BAC PROFESSIONNEL;BAC PRO PROD;BAC PRO 22105 BOULANGER-PÂTISSIER;25;25;23;1;1;1;0;24;0;3;5;9;7;1
2489.0;2021;08;GRENOBLE;MASCULIN;SCOLAIRE;BAC PROFESSIONNEL;BAC PRO PROD;BAC PRO 22503 PLASTIQUES ET COMPOSITES;3;3;2;0;1;1;0;3;0;0;0;1;2;0
2499.0;2021;08;GRENOBLE;MASCULIN;SCOLAIRE;BAC PROFESSIONNEL;BAC PRO PROD;BAC PRO 23303 MENUISERIE ALUMINIUM-VERRE;11;11;7;1;3;0;3;7;0;1;1;2;3;4
2512.0;2021;08;GRENOBLE;MASCULIN;SCOLAIRE;BAC PROFESSIONNEL;BAC PRO PROD;BAC PRO 25107 TECHNICIEN OUTILLEUR;3;3;1;2;0;0;0;1;0;0;0;1;0;2
2517.0;2021;08;GRENOBLE;MASCULIN;SCOLAIRE;BAC PROFESSIONNEL;BAC PRO PROD;BAC PRO 25303 AERONAUTIQUE OPTION SYSTEMES;12;12;11;0;1;1;0;12;0;2;4;5;1;0
2520.0;2021;08;GRENOBLE;MASCULIN;SCOLAIRE;BAC PROFESSIONNEL;BAC PRO PROD;BAC PRO 25411 TECH.CHAUDRONNERIE INDUSTRIELLE;67;67;59;4;4;2;2;61;0;4;11;20;26;6
2522.0;2021;08;GRENOBLE;MASCULIN;SCOLAIRE;BAC PROFESSIONNEL;BAC PRO PROD;BAC PRO 25510 METIERS ELECT. ENVIRON. CONNECTES;602;602;482;89;31;19;12;501;0;34;93;169;205;101
2523.0;2021;08;GRENOBLE;MASCULIN;SCOLAIRE;BAC PROFESSIONNEL;BAC PRO PROD;BAC PRO 25513 SYST.NUM.OPT.A SURETE SECURITE;45;45;34;9;2;1;1;35;0;2;5;17;11;10
2528.0;2021;08;GRENOBLE;MASCULIN;SCOLAIRE;BAC PROFESSIONNEL;BAC PRO PROD;BAC PRO AG 21114 CONDUITE PRODUCTIONS HORTICOLES;22;21;19;2;0;0;0;19;0;1;2;5;11;2
2531.0;2021;08;GRENOBLE;MASCULIN;SCOLAIRE;BAC PROFESSIONNEL;BAC PRO PROD;BAC PRO AG 21210 COND GEST ENTR CANIN ET FELIN;15;15;11;4;0;0;0;11;0;1;3;5;2;4
2535.0;2021;08;GRENOBLE;MASCULIN;SCOLAIRE;BAC PROFESSIONNEL;BAC PRO PROD;BAC PRO AG 21405 AMENAGEMENTS PAYSAGERS;144;140;139;1;0;0;0;139;0;2;29;70;38;1
2553.0;2021;08;GRENOBLE;MASCULIN;SCOLAIRE;BAC PROFESSIONNEL;BAC PRO SERV;BAC PRO 33101 OPTIQUE LUNETTERIE;9;9;6;2;1;1;0;7;0;1;1;2;3;2
2565.0;2021;08;GRENOBLE;MASCULIN;SCOLAIRE;BAC TECHNOLOGIQUE;BAC STI2D;BAC STI2D ENERGIES  ET ENVIRONNEMENT;325;325;305;3;17;12;5;317;0;7;56;149;105;8
2586.0;2021;32;GUADELOUPE;FEMININ;INDIVIDUEL;BAC GENERAL;BAC GENERAL;BAC GENE 10019 BAC GENERAL;11;9;7;0;2;1;1;8;0;2;1;4;1;1
2589.0;2021;32;GUADELOUPE;FEMININ;INDIVIDUEL;BAC PROFESSIONNEL;BAC PRO SERV;BAC PRO 30001 GESTION-ADMINISTRATION;4;3;2;1;0;0;0;2;0;0;0;1;1;1
2594.0;2021;32;GUADELOUPE;FEMININ;INDIVIDUEL;BAC TECHNOLOGIQUE;BAC ST2S;BAC ST2S SCIENCES & TECHNO. SANTE & SOCIAL;1;1;0;0;1;1;0;1;0;0;0;0;1;0
2596.0;2021;32;GUADELOUPE;FEMININ;INDIVIDUEL;BAC TECHNOLOGIQUE;BAC STI2D;BAC STI2D ENERGIES  ET ENVIRONNEMENT;1;1;0;1;0;0;0;0;0;0;0;0;0;1
2598.0;2021;32;GUADELOUPE;FEMININ;INDIVIDUEL;BAC TECHNOLOGIQUE;BAC STMG;BAC STMG RESSOURCES HUMAINES ET COMMUNICATION;4;3;0;2;1;1;0;1;0;0;0;0;1;2
2602.0;2021;32;GUADELOUPE;FEMININ;SCOLAIRE;BAC PROFESSIONNEL;BAC PRO PROD;BAC PRO 22106 CUISINE;15;15;15;0;0;0;0;15;0;0;4;8;3;0
2608.0;2021;32;GUADELOUPE;FEMININ;SCOLAIRE;BAC PROFESSIONNEL;BAC PRO PROD;BAC PRO 23404 TECHNICIEN CONSTRUCTEUR BOIS;1;1;1;0;0;0;0;1;0;0;0;1;0;0
2609.0;2021;32;GUADELOUPE;FEMININ;SCOLAIRE;BAC PROFESSIONNEL;BAC PRO PROD;BAC PRO 23405 TECHNICIEN MENUISIER AGENCEUR;1;1;1;0;0;0;0;1;0;0;0;1;0;0
2614.0;2021;32;GUADELOUPE;FEMININ;SCOLAIRE;BAC PROFESSIONNEL;BAC PRO PROD;BAC PRO 25406 OUVRAGES DU BATIMENT METALLERIE;4;4;3;0;1;1;0;4;0;0;0;0;4;0
2615.0;2021;32;GUADELOUPE;FEMININ;SCOLAIRE;BAC PROFESSIONNEL;BAC PRO PROD;BAC PRO 25509 TECHNIC. FROID CONDITIONNEMT AIR;3;3;2;1;0;0;0;2;0;0;1;1;0;1
2619.0;2021;32;GUADELOUPE;FEMININ;SCOLAIRE;BAC PROFESSIONNEL;BAC PRO PROD;BAC PRO AG 21004 CGEA;5;4;4;0;0;0;0;4;0;0;0;1;3;0
2627.0;2021;32;GUADELOUPE;FEMININ;SCOLAIRE;BAC PROFESSIONNEL;BAC PRO SERV;BAC PRO 31210 ACCUEIL -RELATION CLIENTS USAGERS;72;71;58;6;7;7;0;65;0;2;11;22;30;6
2631.0;2021;32;GUADELOUPE;FEMININ;SCOLAIRE;BAC PROFESSIONNEL;BAC PRO SERV;BAC PRO 33004 ACC.SOINS-S.PERS. OPT.EN STRUCTUR;71;70;44;15;11;11;0;55;0;1;8;17;29;15
2636.0;2021;32;GUADELOUPE;FEMININ;SCOLAIRE;BAC PROFESSIONNEL;BAC PRO SERV;BAC PRO 34403 METIERS DE LA SECURITE;8;8;8;0;0;0;0;8;0;1;1;5;1;0
2649.0;2021;32;GUADELOUPE;FEMININ;SCOLAIRE;BAC TECHNOLOGIQUE;BAC STL;BAC STL SCIENCES PHYSIQUES CHIMIQUES  EN LABORAT.;16;16;12;0;4;3;1;15;0;0;1;3;11;1
2655.0;2021;32;GUADELOUPE;MASCULIN;APPRENTISSAGE;BAC PROFESSIONNEL;BAC PRO PROD;BAC PRO 25510 METIERS ELECT. ENVIRON. CONNECTES;2;2;1;0;1;0;1;1;0;0;0;0;1;1
2660.0;2021;32;GUADELOUPE;MASCULIN;ENSEIGNEMENT A DISTANCE;BAC TECHNOLOGIQUE;BAC STMG;BAC STMG MERCATIQUE (MARKETING);1;1;1;0;0;0;0;1;0;0;0;0;1;0
2661.0;2021;32;GUADELOUPE;MASCULIN;FORMATION CONTINUE;BAC PROFESSIONNEL;BAC PRO PROD;BAC PRO 22106 CUISINE;1;1;1;0;0;0;0;1;0;1;0;0;0;0
2665.0;2021;32;GUADELOUPE;MASCULIN;FORMATION CONTINUE;BAC PROFESSIONNEL;BAC PRO SERV;BAC PRO 33004 ACC.SOINS-S.PERS. OPT.EN STRUCTUR;2;2;0;2;0;0;0;0;0;0;0;0;0;2
2666.0;2021;32;GUADELOUPE;MASCULIN;INDIVIDUEL;BAC GENERAL;BAC GENERAL;BAC GENE 10019 BAC GENERAL;10;8;5;2;1;1;0;6;0;1;3;0;2;2
2669.0;2021;32;GUADELOUPE;MASCULIN;INDIVIDUEL;BAC PROFESSIONNEL;BAC PRO PROD;BAC PRO 25009 MAINTENANCE NAUTIQUE;2;1;0;1;0;0;0;0;0;0;0;0;0;1
2679.0;2021;32;GUADELOUPE;MASCULIN;INDIVIDUEL;BAC TECHNOLOGIQUE;BAC STMG;BAC STMG GESTION ET FINANCE;11;8;0;4;4;3;1;3;0;0;0;0;3;5
2680.0;2021;32;GUADELOUPE;MASCULIN;INDIVIDUEL;BAC TECHNOLOGIQUE;BAC STMG;BAC STMG MERCATIQUE (MARKETING);5;5;3;2;0;0;0;3;0;0;1;2;0;2
2683.0;2021;32;GUADELOUPE;MASCULIN;SCOLAIRE;BAC PROFESSIONNEL;BAC PRO PROD;BAC PRO 22104 BOUCHER CHARCUTIER TRAITEUR;8;8;7;0;1;1;0;8;0;0;1;3;4;0
2686.0;2021;32;GUADELOUPE;MASCULIN;SCOLAIRE;BAC PROFESSIONNEL;BAC PRO PROD;BAC PRO 22704 TECHN. MAINT. SYST.ENERG.CLIMATI;14;14;13;0;1;1;0;14;0;0;0;0;14;0
2691.0;2021;32;GUADELOUPE;MASCULIN;SCOLAIRE;BAC PROFESSIONNEL;BAC PRO PROD;BAC PRO 23303 MENUISERIE ALUMINIUM-VERRE;22;22;18;2;2;2;0;20;0;0;2;4;14;2
2692.0;2021;32;GUADELOUPE;MASCULIN;SCOLAIRE;BAC PROFESSIONNEL;BAC PRO PROD;BAC PRO 23304 AMENAGEMENT FINITION BATIMENT;26;26;14;7;5;1;4;15;0;0;1;5;9;11
2693.0;2021;32;GUADELOUPE;MASCULIN;SCOLAIRE;BAC PROFESSIONNEL;BAC PRO PROD;BAC PRO 23404 TECHNICIEN CONSTRUCTEUR BOIS;11;10;7;2;1;1;0;8;0;0;1;3;4;2
2696.0;2021;32;GUADELOUPE;MASCULIN;SCOLAIRE;BAC PROFESSIONNEL;BAC PRO PROD;BAC PRO 24203 METIERS DE LA MODE - VÊTEMENT;1;1;1;0;0;0;0;1;0;0;0;0;1;0
2703.0;2021;32;GUADELOUPE;MASCULIN;SCOLAIRE;BAC PROFESSIONNEL;BAC PRO PROD;BAC PRO 25220 MAINT.MATERIELS OPT.B TP MANUT.;9;9;8;1;0;0;0;8;0;0;2;4;2;1
2704.0;2021;32;GUADELOUPE;MASCULIN;SCOLAIRE;BAC PROFESSIONNEL;BAC PRO PROD;BAC PRO 25303 AERONAUTIQUE OPTION SYSTEMES;12;11;10;1;0;0;0;10;0;0;1;5;4;1
2705.0;2021;32;GUADELOUPE;MASCULIN;SCOLAIRE;BAC PROFESSIONNEL;BAC PRO PROD;BAC PRO 25406 OUVRAGES DU BATIMENT METALLERIE;8;8;5;1;2;2;0;7;0;0;0;1;6;1
2709.0;2021;32;GUADELOUPE;MASCULIN;SCOLAIRE;BAC PROFESSIONNEL;BAC PRO PROD;BAC PRO 25510 METIERS ELECT. ENVIRON. CONNECTES;161;161;133;21;7;3;4;136;0;10;18;49;59;25
2712.0;2021;32;GUADELOUPE;MASCULIN;SCOLAIRE;BAC PROFESSIONNEL;BAC PRO PROD;BAC PRO 25515 SYST.NUM.OPT.C RES.INF.SYST.COMM.;48;48;43;4;1;1;0;44;0;2;8;26;8;4
2723.0;2021;32;GUADELOUPE;MASCULIN;SCOLAIRE;BAC PROFESSIONNEL;BAC PRO SERV;BAC PRO 33002 SERVICES DE PROXIMITE  VIE LOCAL;5;5;3;2;0;0;0;3;0;0;0;2;1;2
2724.0;2021;32;GUADELOUPE;MASCULIN;SCOLAIRE;BAC PROFESSIONNEL;BAC PRO SERV;BAC PRO 33003 ACC.SOINS-S.PERS. OPT.A DOMICILE;6;6;5;0;1;1;0;6;0;0;0;4;2;0
2730.0;2021;32;GUADELOUPE;MASCULIN;SCOLAIRE;BAC PROFESSIONNEL;BAC PRO SERV;BAC PRO AG 33002 SERV PERS TERRIT;18;18;17;1;0;0;0;17;0;0;1;7;9;1
2733.0;2021;32;GUADELOUPE;MASCULIN;SCOLAIRE;BAC TECHNOLOGIQUE;BAC ST2S;BAC ST2S SCIENCES & TECHNO. SANTE & SOCIAL;34;34;32;0;2;2;0;34;0;0;4;14;16;0
2737.0;2021;32;GUADELOUPE;MASCULIN;SCOLAIRE;BAC TECHNOLOGIQUE;BAC STI2D;BAC STI2D ARCHITECTURE ET CONSTRUCTION;45;45;38;0;7;3;4;41;0;0;6;16;19;4
2738.0;2021;32;GUADELOUPE;MASCULIN;SCOLAIRE;BAC TECHNOLOGIQUE;BAC STI2D;BAC STI2D ENERGIES  ET ENVIRONNEMENT;27;27;24;0;3;3;0;27;0;1;4;9;13;0
2742.0;2021;32;GUADELOUPE;MASCULIN;SCOLAIRE;BAC TECHNOLOGIQUE;BAC STMG;BAC STMG GESTION ET FINANCE;81;81;76;2;3;2;1;78;0;1;6;30;41;3
2744.0;2021;32;GUADELOUPE;MASCULIN;SCOLAIRE;BAC TECHNOLOGIQUE;BAC STMG;BAC STMG RESSOURCES HUMAINES ET COMMUNICATION;55;55;44;1;10;7;3;51;0;0;3;9;39;4
2750.0;2021;33;GUYANE;FEMININ;FORMATION CONTINUE;BAC PROFESSIONNEL;BAC PRO SERV;BAC PRO 31202 COMMERCE;28;25;12;10;3;2;1;14;0;0;3;4;7;11
2756.0;2021;33;GUYANE;FEMININ;INDIVIDUEL;BAC PROFESSIONNEL;BAC PRO SERV;BAC PRO 31202 COMMERCE;4;4;0;2;2;0;2;0;0;0;0;0;0;4
2760.0;2021;33;GUYANE;FEMININ;INDIVIDUEL;BAC TECHNOLOGIQUE;BAC ST2S;BAC ST2S SCIENCES & TECHNO. SANTE & SOCIAL;4;3;1;1;1;0;1;1;0;0;0;0;1;2
2764.0;2021;33;GUYANE;FEMININ;SCOLAIRE;BAC PROFESSIONNEL;BAC PRO PROD;BAC PRO 22004 PROC. CHIMIE EAU PAPIERS-CARTONS;3;3;3;0;0;0;0;3;0;0;1;1;1;0
2776.0;2021;33;GUYANE;FEMININ;SCOLAIRE;BAC PROFESSIONNEL;BAC PRO PROD;BAC PRO 23405 TECHNICIEN MENUISIER AGENCEUR;3;3;2;0;1;1;0;3;0;0;0;0;3;0
2777.0;2021;33;GUYANE;FEMININ;SCOLAIRE;BAC PROFESSIONNEL;BAC PRO PROD;BAC PRO 24203 METIERS DE LA MODE - VÊTEMENT;39;39;27;8;4;4;0;31;0;1;2;9;19;8
2780.0;2021;33;GUYANE;FEMININ;SCOLAIRE;BAC PROFESSIONNEL;BAC PRO PROD;BAC PRO 25509 TECHNIC. FROID CONDITIONNEMT AIR;2;2;0;2;0;0;0;0;0;0;0;0;0;2
2781.0;2021;33;GUYANE;FEMININ;SCOLAIRE;BAC PROFESSIONNEL;BAC PRO PROD;BAC PRO 25510 METIERS ELECT. ENVIRON. CONNECTES;1;1;0;1;0;0;0;0;0;0;0;0;0;1
2783.0;2021;33;GUYANE;FEMININ;SCOLAIRE;BAC PROFESSIONNEL;BAC PRO PROD;BAC PRO AG 21114 CONDUITE PRODUCTIONS HORTICOLES;8;5;5;0;0;0;0;5;0;0;0;1;4;0
2792.0;2021;33;GUYANE;FEMININ;SCOLAIRE;BAC PROFESSIONNEL;BAC PRO SERV;BAC PRO 33002 SERVICES DE PROXIMITE  VIE LOCAL;54;53;33;14;6;5;1;38;0;0;1;11;26;15
2807.0;2021;33;GUYANE;FEMININ;SCOLAIRE;BAC TECHNOLOGIQUE;BAC STL;BAC STL SCIENCES PHYSIQUES CHIMIQUES  EN LABORAT.;20;20;13;3;4;3;1;16;0;1;5;4;6;4
2808.0;2021;33;GUYANE;FEMININ;SCOLAIRE;BAC TECHNOLOGIQUE;BAC STMG;BAC STMG GESTION ET FINANCE;60;60;56;1;3;3;0;59;0;3;11;26;19;1
2811.0;2021;33;GUYANE;FEMININ;SCOLAIRE;BAC TECHNOLOGIQUE;BAC STMG;BAC STMG SYSTEMES D'INFORMATION DE GESTION;13;13;11;0;2;2;0;13;0;0;0;3;10;0
2817.0;2021;33;GUYANE;MASCULIN;FORMATION CONTINUE;BAC PROFESSIONNEL;BAC PRO PROD;BAC PRO AG 21114 CONDUITE PRODUCTIONS HORTICOLES;1;1;1;0;0;0;0;1;0;0;0;0;1;0
2819.0;2021;33;GUYANE;MASCULIN;INDIVIDUEL;BAC GENERAL;BAC GENERAL;BAC GENE 10019 BAC GENERAL;10;8;0;5;3;3;0;3;0;0;0;0;3;5
2822.0;2021;33;GUYANE;MASCULIN;INDIVIDUEL;BAC PROFESSIONNEL;BAC PRO PROD;BAC PRO 25510 METIERS ELECT. ENVIRON. CONNECTES;1;1;0;1;0;0;0;0;0;0;0;0;0;1
2828.0;2021;33;GUYANE;MASCULIN;INDIVIDUEL;BAC TECHNOLOGIQUE;BAC STI2D;BAC STI2D INNOVATION TECHNO.  ET ECO CONCEPTION;1;0;0;0;0;0;0;0;0;0;0;0;0;0
2829.0;2021;33;GUYANE;MASCULIN;INDIVIDUEL;BAC TECHNOLOGIQUE;BAC STMG;BAC STMG GESTION ET FINANCE;1;1;0;0;1;1;0;1;0;0;0;0;1;0
2837.0;2021;33;GUYANE;MASCULIN;SCOLAIRE;BAC PROFESSIONNEL;BAC PRO PROD;BACPRO 23103 TECHNICIEN GEOMETRE-TOPOGRAPHE;8;8;3;5;0;0;0;3;0;0;0;1;2;5
2841.0;2021;33;GUYANE;MASCULIN;SCOLAIRE;BAC PROFESSIONNEL;BAC PRO PROD;BAC PRO 23304 AMENAGEMENT FINITION BATIMENT;19;19;10;6;3;3;0;13;0;1;1;3;8;6
2842.0;2021;33;GUYANE;MASCULIN;SCOLAIRE;BAC PROFESSIONNEL;BAC PRO PROD;BAC PRO 23404 TECHNICIEN CONSTRUCTEUR BOIS;22;22;12;7;3;3;0;15;0;0;0;1;14;7
2849.0;2021;33;GUYANE;MASCULIN;SCOLAIRE;BAC PROFESSIONNEL;BAC PRO PROD;BAC PRO 25509 TECHNIC. FROID CONDITIONNEMT AIR;11;11;7;3;1;1;0;8;0;0;0;1;7;3
2855.0;2021;33;GUYANE;MASCULIN;SCOLAIRE;BAC PROFESSIONNEL;BAC PRO PROD;BAC PRO AG 22107 TEC CONS VTE ALIMENTATION P.ALIM;8;7;7;0;0;0;0;7;0;1;1;2;3;0
2857.0;2021;33;GUYANE;MASCULIN;SCOLAIRE;BAC PROFESSIONNEL;BAC PRO SERV;BAC PRO 31106 LOGISTIQUE;24;24;12;7;5;5;0;17;0;0;1;5;11;7
2859.0;2021;33;GUYANE;MASCULIN;SCOLAIRE;BAC PROFESSIONNEL;BAC PRO SERV;BAC PRO 31206 VENTE (PROSPECT.NEGO.SUIV.CLIENT;29;29;26;2;1;0;1;26;0;2;5;10;9;3
2873.0;2021;33;GUYANE;MASCULIN;SCOLAIRE;BAC TECHNOLOGIQUE;BAC STI2D;BAC STI2D ARCHITECTURE ET CONSTRUCTION;25;25;22;1;2;2;0;24;0;0;4;16;4;1
2876.0;2021;33;GUYANE;MASCULIN;SCOLAIRE;BAC TECHNOLOGIQUE;BAC STI2D;BAC STI2D SYSTÈME D'INFORMATION  ET NUMERIQUE;23;23;15;1;7;5;2;20;0;0;2;2;16;3
2880.0;2021;33;GUYANE;MASCULIN;SCOLAIRE;BAC TECHNOLOGIQUE;BAC STMG;BAC STMG MERCATIQUE (MARKETING);28;28;23;2;3;1;2;24;0;0;0;6;18;4
2881.0;2021;33;GUYANE;MASCULIN;SCOLAIRE;BAC TECHNOLOGIQUE;BAC STMG;BAC STMG RESSOURCES HUMAINES ET COMMUNICATION;32;32;22;2;8;8;0;30;0;0;2;7;21;2
2884.0;2021;28;LA REUNION;FEMININ;APPRENTISSAGE;BAC PROFESSIONNEL;BAC PRO PROD;BAC PRO AG 22107 TEC CONS VTE ALIMENTATION P.ALIM;5;4;3;1;0;0;0;3;0;0;1;0;2;1
2885.0;2021;28;LA REUNION;FEMININ;ENSEIGNEMENT A DISTANCE;BAC GENERAL;BAC GENERAL;BAC GENE 10019 BAC GENERAL;17;16;16;0;0;0;0;16;0;5;6;3;2;0
2888.0;2021;28;LA REUNION;FEMININ;FORMATION CONTINUE;BAC PROFESSIONNEL;BAC PRO SERV;BAC PRO 30001 GESTION-ADMINISTRATION;2;2;2;0;0;0;0;2;0;0;1;1;0;0
2899.0;2021;28;LA REUNION;FEMININ;INDIVIDUEL;BAC TECHNOLOGIQUE;BAC STMG;BAC STMG MERCATIQUE (MARKETING);1;1;0;1;0;0;0;0;0;0;0;0;0;1
2905.0;2021;28;LA REUNION;FEMININ;SCOLAIRE;BAC PROFESSIONNEL;BAC PRO PROD;BAC PRO 22106 CUISINE;7;7;7;0;0;0;0;7;0;0;2;3;2;0
2910.0;2021;28;LA REUNION;FEMININ;SCOLAIRE;BAC PROFESSIONNEL;BAC PRO PROD;BACPRO 23103 TECHNICIEN GEOMETRE-TOPOGRAPHE;2;2;2;0;0;0;0;2;0;0;1;0;1;0
2913.0;2021;28;LA REUNION;FEMININ;SCOLAIRE;BAC PROFESSIONNEL;BAC PRO PROD;BAC PRO 23407 TECHNIC.FAB.BOIS ET MATERX ASSOC;4;4;4;0;0;0;0;4;0;0;0;2;2;0
2918.0;2021;28;LA REUNION;FEMININ;SCOLAIRE;BAC PROFESSIONNEL;BAC PRO PROD;BAC PRO 25214 MAINT.VEHIC.OPTA VOIT.PARTICUL.;3;3;2;1;0;0;0;2;0;0;2;0;0;1
2920.0;2021;28;LA REUNION;FEMININ;SCOLAIRE;BAC PROFESSIONNEL;BAC PRO PROD;BAC PRO 25510 METIERS ELECT. ENVIRON. CONNECTES;5;5;5;0;0;0;0;5;0;0;1;2;2;0
2923.0;2021;28;LA REUNION;FEMININ;SCOLAIRE;BAC PROFESSIONNEL;BAC PRO PROD;BAC PRO AG 21001 AGRO-EQUIPEMENT;1;1;1;0;0;0;0;1;0;0;0;0;1;0
2928.0;2021;28;LA REUNION;FEMININ;SCOLAIRE;BAC PROFESSIONNEL;BAC PRO PROD;BAC PRO AG 21406 TEC CONS VTE PROD DES JARDINS;3;3;3;0;0;0;0;3;0;0;0;2;1;0
2935.0;2021;28;LA REUNION;FEMININ;SCOLAIRE;BAC PROFESSIONNEL;BAC PRO SERV;BAC PRO 31210 ACCUEIL -RELATION CLIENTS USAGERS;183;183;155;19;9;5;4;160;0;10;33;55;62;23
2936.0;2021;28;LA REUNION;FEMININ;SCOLAIRE;BAC PROFESSIONNEL;BAC PRO SERV;BAC PRO 32207 REAL.PR.IMPR.PLURI.OPTA.PR.GRAPH.;3;3;3;0;0;0;0;3;0;0;0;2;1;0
2954.0;2021;28;LA REUNION;FEMININ;SCOLAIRE;BAC TECHNOLOGIQUE;BAC STI2D;BAC STI2D ENERGIES  ET ENVIRONNEMENT;17;17;15;1;1;1;0;16;0;0;3;7;6;1
2957.0;2021;28;LA REUNION;FEMININ;SCOLAIRE;BAC TECHNOLOGIQUE;BAC STL;BAC STL BIOCHIM.-BIOLOGIE-BIOTECHNOL.;59;59;54;1;4;1;3;55;0;2;10;18;25;4
2960.0;2021;28;LA REUNION;FEMININ;SCOLAIRE;BAC TECHNOLOGIQUE;BAC STMG;BAC STMG MERCATIQUE (MARKETING);257;257;229;3;25;18;7;247;0;8;38;97;104;10
2961.0;2021;28;LA REUNION;FEMININ;SCOLAIRE;BAC TECHNOLOGIQUE;BAC STMG;BAC STMG RESSOURCES HUMAINES ET COMMUNICATION;373;373;279;20;74;51;23;330;0;1;28;111;190;43
2967.0;2021;28;LA REUNION;MASCULIN;APPRENTISSAGE;BAC PROFESSIONNEL;BAC PRO PROD;BAC PRO 25215 MAINT.VEHIC.OPTB VEHIC.TRANS.ROUT;5;5;3;1;1;1;0;4;0;0;0;1;3;1
2968.0;2021;28;LA REUNION;MASCULIN;APPRENTISSAGE;BAC PROFESSIONNEL;BAC PRO PROD;BAC PRO 25406 OUVRAGES DU BATIMENT METALLERIE;3;3;1;2;0;0;0;1;0;0;1;0;0;2
2973.0;2021;28;LA REUNION;MASCULIN;APPRENTISSAGE;BAC PROFESSIONNEL;BAC PRO SERV;BAC PRO 31106 LOGISTIQUE;13;10;6;0;4;4;0;10;0;0;1;3;6;0
2978.0;2021;28;LA REUNION;MASCULIN;FORMATION CONTINUE;BAC PROFESSIONNEL;BAC PRO SERV;BAC PRO 31202 COMMERCE;11;4;1;3;0;0;0;1;0;0;0;0;1;3
2981.0;2021;28;LA REUNION;MASCULIN;INDIVIDUEL;BAC PROFESSIONNEL;BAC PRO PROD;BAC PRO AG 21004 CGEA;10;4;3;1;0;0;0;3;0;0;0;0;3;1
2991.0;2021;28;LA REUNION;MASCULIN;INDIVIDUEL;BAC TECHNOLOGIQUE;BAC STMG;BAC STMG MERCATIQUE (MARKETING);4;2;1;1;0;0;0;1;0;0;0;0;1;1
2992.0;2021;28;LA REUNION;MASCULIN;INDIVIDUEL;BAC TECHNOLOGIQUE;BAC STMG;BAC STMG RESSOURCES HUMAINES ET COMMUNICATION;3;3;0;0;3;3;0;3;0;0;0;0;3;0
2997.0;2021;28;LA REUNION;MASCULIN;SCOLAIRE;BAC PROFESSIONNEL;BAC PRO PROD;BAC PRO 22004 PROC. CHIMIE EAU PAPIERS-CARTONS;15;15;14;1;0;0;0;14;0;0;1;6;7;1
3000.0;2021;28;LA REUNION;MASCULIN;SCOLAIRE;BAC PROFESSIONNEL;BAC PRO PROD;BAC PRO 22503 PLASTIQUES ET COMPOSITES;4;4;3;1;0;0;0;3;0;0;0;2;1;1
3001.0;2021;28;LA REUNION;MASCULIN;SCOLAIRE;BAC PROFESSIONNEL;BAC PRO PROD;BAC PRO 22703 TECHN.INSTALL.SYST.ENERG.CLIMATI;24;24;13;8;3;2;1;15;0;0;2;6;7;9
3009.0;2021;28;LA REUNION;MASCULIN;SCOLAIRE;BAC PROFESSIONNEL;BAC PRO PROD;BAC PRO 23205 INTERV. SUR PATRIMOINE BATI OPT.A;1;1;1;0;0;0;0;1;0;0;0;1;0;0
3015.0;2021;28;LA REUNION;MASCULIN;SCOLAIRE;BAC PROFESSIONNEL;BAC PRO PROD;BAC PRO 23405 TECHNICIEN MENUISIER AGENCEUR;54;54;38;11;5;5;0;43;0;1;3;8;31;11
3022.0;2021;28;LA REUNION;MASCULIN;SCOLAIRE;BAC PROFESSIONNEL;BAC PRO PROD;BAC PRO 25216 MAINT.VEHIC.OPTC MOTOCYCLES;17;17;8;8;1;1;0;9;0;0;1;4;4;8
3031.0;2021;28;LA REUNION;MASCULIN;SCOLAIRE;BAC PROFESSIONNEL;BAC PRO PROD;BAC PRO 25510 METIERS ELECT. ENVIRON. CONNECTES;227;226;180;30;16;7;9;187;0;9;34;71;73;39
3036.0;2021;28;LA REUNION;MASCULIN;SCOLAIRE;BAC PROFESSIONNEL;BAC PRO PROD;BAC PRO AG 21004 CGEA;29;27;20;7;0;0;0;20;0;0;0;5;15;7
3037.0;2021;28;LA REUNION;MASCULIN;SCOLAIRE;BAC PROFESSIONNEL;BAC PRO PROD;BAC PRO AG 21114 CONDUITE PRODUCTIONS HORTICOLES;13;13;13;0;0;0;0;13;0;0;0;6;7;0
3050.0;2021;28;LA REUNION;MASCULIN;SCOLAIRE;BAC PROFESSIONNEL;BAC PRO SERV;BAC PRO 32303 ART.& MET.ART:COM.VIS.VIS.PLURI-M;15;15;13;1;1;1;0;14;0;2;4;4;4;1
3052.0;2021;28;LA REUNION;MASCULIN;SCOLAIRE;BAC PROFESSIONNEL;BAC PRO SERV;BAC PRO 33003 ACC.SOINS-S.PERS. OPT.A DOMICILE;2;2;1;1;0;0;0;1;0;0;0;0;1;1
3053.0;2021;28;LA REUNION;MASCULIN;SCOLAIRE;BAC PROFESSIONNEL;BAC PRO SERV;BAC PRO 33004 ACC.SOINS-S.PERS. OPT.EN STRUCTUR;13;12;12;0;0;0;0;12;0;0;2;4;6;0
3062.0;2021;28;LA REUNION;MASCULIN;SCOLAIRE;BAC TECHNOLOGIQUE;BAC STD2A;BAC STD2A SCIENCES & TECHNO. DESIGN-ARTS APPLIQUES;8;8;8;0;0;0;0;8;0;0;4;2;2;0
3063.0;2021;28;LA REUNION;MASCULIN;SCOLAIRE;BAC TECHNOLOGIQUE;BAC STHR;BAC STHR SC.&TEC. HOTELLERIE-RESTAURATION;9;9;8;0;1;1;0;9;0;0;2;2;5;0
3065.0;2021;28;LA REUNION;MASCULIN;SCOLAIRE;BAC TECHNOLOGIQUE;BAC STI2D;BAC STI2D ENERGIES  ET ENVIRONNEMENT;122;122;105;3;14;9;5;114;0;4;9;34;67;8
3066.0;2021;28;LA REUNION;MASCULIN;SCOLAIRE;BAC TECHNOLOGIQUE;BAC STI2D;BAC STI2D INNOVATION TECHNO.  ET ECO CONCEPTION;130;130;109;0;21;14;7;123;0;6;19;41;57;7
3074.0;2021;09;LILLE;FEMININ;APPRENTISSAGE;BAC PROFESSIONNEL;BAC PRO PROD;BAC PRO 20102 PILOTE DE LIGNE DE PRODUCTION;3;3;3;0;0;0;0;3;0;0;0;3;0;0
3078.0;2021;09;LILLE;FEMININ;APPRENTISSAGE;BAC PROFESSIONNEL;BAC PRO PROD;BAC PRO 23004 TECHN. ETUDES BAT.A ETUDES & ECO.;1;1;1;0;0;0;0;1;0;0;0;0;1;0
3083.0;2021;09;LILLE;FEMININ;APPRENTISSAGE;BAC PROFESSIONNEL;BAC PRO PROD;BAC PRO 25007 MAINTENANCE EQUIPEMENTS INDUST.;1;1;1;0;0;0;0;1;0;0;1;0;0;0
3084.0;2021;09;LILLE;FEMININ;APPRENTISSAGE;BAC PROFESSIONNEL;BAC PRO PROD;BAC PRO 25106 TECHNICIEN D'USINAGE;2;1;1;0;0;0;0;1;0;0;0;1;0;0
3090.0;2021;09;LILLE;FEMININ;APPRENTISSAGE;BAC PROFESSIONNEL;BAC PRO PROD;BAC PRO AG 21004 CGEA;8;8;6;2;0;0;0;6;0;0;0;4;2;2
3095.0;2021;09;LILLE;FEMININ;APPRENTISSAGE;BAC PROFESSIONNEL;BAC PRO SERV;BAC PRO 30001 GESTION-ADMINISTRATION;21;20;20;0;0;0;0;20;0;5;7;6;2;0
3100.0;2021;09;LILLE;FEMININ;APPRENTISSAGE;BAC PROFESSIONNEL;BAC PRO SERV;BAC PRO 32303 ART.& MET.ART:COM.VIS.VIS.PLURI-M;1;1;1;0;0;0;0;1;0;0;1;0;0;0
3114.0;2021;09;LILLE;FEMININ;FORMATION CONTINUE;BAC PROFESSIONNEL;BAC PRO PROD;BAC PRO 22106 CUISINE;1;1;1;0;0;0;0;1;0;0;0;1;0;0
3115.0;2021;09;LILLE;FEMININ;FORMATION CONTINUE;BAC PROFESSIONNEL;BAC PRO PROD;BAC PRO 22703 TECHN.INSTALL.SYST.ENERG.CLIMATI;1;1;1;0;0;0;0;1;0;0;0;1;0;0
3118.0;2021;09;LILLE;FEMININ;FORMATION CONTINUE;BAC PROFESSIONNEL;BAC PRO PROD;BAC PRO 25214 MAINT.VEHIC.OPTA VOIT.PARTICUL.;1;1;1;0;0;0;0;1;0;1;0;0;0;0
3120.0;2021;09;LILLE;FEMININ;FORMATION CONTINUE;BAC PROFESSIONNEL;BAC PRO SERV;BAC PRO 30001 GESTION-ADMINISTRATION;20;20;18;2;0;0;0;18;0;1;8;9;0;2
3123.0;2021;09;LILLE;FEMININ;FORMATION CONTINUE;BAC PROFESSIONNEL;BAC PRO SERV;BAC PRO 31202 COMMERCE;24;21;16;3;2;0;2;16;0;2;2;3;9;5
3126.0;2021;09;LILLE;FEMININ;INDIVIDUEL;BAC GENERAL;BAC GENERAL;BAC GENE 10019 BAC GENERAL;89;50;27;13;10;6;4;33;0;2;8;4;19;17
3134.0;2021;09;LILLE;FEMININ;INDIVIDUEL;BAC PROFESSIONNEL;BAC PRO SERV;BAC PRO 31202 COMMERCE;7;4;2;1;1;0;1;2;0;0;0;0;2;2
3137.0;2021;09;LILLE;FEMININ;INDIVIDUEL;BAC PROFESSIONNEL;BAC PRO SERV;BAC PRO 32304 PHOTOGRAPHIE;3;3;1;2;0;0;0;1;0;0;0;1;0;2
3153.0;2021;09;LILLE;FEMININ;SCOLAIRE;BAC PROFESSIONNEL;BAC PRO PROD;BAC PRO 23004 TECHN. ETUDES BAT.A ETUDES & ECO.;16;16;15;1;0;0;0;15;0;1;3;6;5;1
3155.0;2021;09;LILLE;FEMININ;SCOLAIRE;BAC PROFESSIONNEL;BAC PRO PROD;BACPRO 23103 TECHNICIEN GEOMETRE-TOPOGRAPHE;2;2;1;0;1;1;0;2;0;0;0;1;1;0
3169.0;2021;09;LILLE;FEMININ;SCOLAIRE;BAC PROFESSIONNEL;BAC PRO PROD;BAC PRO 25406 OUVRAGES DU BATIMENT METALLERIE;2;2;2;0;0;0;0;2;0;0;0;1;1;0
3172.0;2021;09;LILLE;FEMININ;SCOLAIRE;BAC PROFESSIONNEL;BAC PRO PROD;BAC PRO 25411 TECH.CHAUDRONNERIE INDUSTRIELLE;5;5;5;0;0;0;0;5;0;1;1;3;0;0
3173.0;2021;09;LILLE;FEMININ;SCOLAIRE;BAC PROFESSIONNEL;BAC PRO PROD;BAC PRO 25510 METIERS ELECT. ENVIRON. CONNECTES;14;14;12;2;0;0;0;12;0;1;4;4;3;2
3174.0;2021;09;LILLE;FEMININ;SCOLAIRE;BAC PROFESSIONNEL;BAC PRO PROD;BAC PRO 25513 SYST.NUM.OPT.A SURETE SECURITE;2;2;1;1;0;0;0;1;0;0;0;1;0;1
3176.0;2021;09;LILLE;FEMININ;SCOLAIRE;BAC PROFESSIONNEL;BAC PRO PROD;BAC PRO 25515 SYST.NUM.OPT.C RES.INF.SYST.COMM.;9;9;7;2;0;0;0;7;0;0;3;3;1;2
3187.0;2021;09;LILLE;FEMININ;SCOLAIRE;BAC PROFESSIONNEL;BAC PRO PROD;BAC PRO AG 22105 LABORATOIRE CONTROLE QUALITE;19;19;19;0;0;0;0;19;0;0;2;5;12;0
3191.0;2021;09;LILLE;FEMININ;SCOLAIRE;BAC PROFESSIONNEL;BAC PRO SERV;BAC PRO 31107 CONDUCT. TRANSP.ROUT.MARCHANDISES;7;7;6;1;0;0;0;6;0;1;2;2;1;1
3193.0;2021;09;LILLE;FEMININ;SCOLAIRE;BAC PROFESSIONNEL;BAC PRO SERV;BAC PRO 31202 COMMERCE;1306;1301;1034;170;97;56;41;1090;0;45;227;394;424;211
3196.0;2021;09;LILLE;FEMININ;SCOLAIRE;BAC PROFESSIONNEL;BAC PRO SERV;BAC PRO 32207 REAL.PR.IMPR.PLURI.OPTA.PR.GRAPH.;3;3;1;2;0;0;0;1;0;0;0;1;0;2
3198.0;2021;09;LILLE;FEMININ;SCOLAIRE;BAC PROFESSIONNEL;BAC PRO SERV;BAC PRO 32303 ART.& MET.ART:COM.VIS.VIS.PLURI-M;55;54;51;3;0;0;0;51;0;4;24;15;8;3
3202.0;2021;09;LILLE;FEMININ;SCOLAIRE;BAC PROFESSIONNEL;BAC PRO SERV;BAC PRO 33004 ACC.SOINS-S.PERS. OPT.EN STRUCTUR;1409;1406;1274;70;62;44;18;1318;0;40;277;592;409;88
3206.0;2021;09;LILLE;FEMININ;SCOLAIRE;BAC PROFESSIONNEL;BAC PRO SERV;BAC PRO 33403 COMMERC. SERVICES EN RESTAURATION;95;95;77;13;5;3;2;80;0;6;23;27;24;15
3209.0;2021;09;LILLE;FEMININ;SCOLAIRE;BAC PROFESSIONNEL;BAC PRO SERV;BAC PRO 34304 HYGIENE PROPRETE STERILISATION;65;65;48;8;9;5;4;53;0;1;8;21;23;12
3212.0;2021;09;LILLE;FEMININ;SCOLAIRE;BAC TECHNOLOGIQUE;BAC S2TMD;BAC S2TMD DANSE;2;2;2;0;0;0;0;2;0;1;1;0;0;0
3215.0;2021;09;LILLE;FEMININ;SCOLAIRE;BAC TECHNOLOGIQUE;BAC STAV;BAC STAV AGRONOMIE ALIM ENV TERRITOI;143;143;143;0;0;0;0;143;0;11;35;58;39;0
3216.0;2021;09;LILLE;FEMININ;SCOLAIRE;BAC TECHNOLOGIQUE;BAC STD2A;BAC STD2A SCIENCES & TECHNO. DESIGN-ARTS APPLIQUES;139;139;134;1;4;3;1;137;0;22;41;46;28;2
3236.0;2021;09;LILLE;MASCULIN;APPRENTISSAGE;BAC PROFESSIONNEL;BAC PRO PROD;BAC PRO 23102 TRAVAUX PUBLICS;70;69;51;11;7;4;3;55;0;2;13;26;14;14
3239.0;2021;09;LILLE;MASCULIN;APPRENTISSAGE;BAC PROFESSIONNEL;BAC PRO PROD;BAC PRO 23304 AMENAGEMENT FINITION BATIMENT;8;8;7;0;1;1;0;8;0;0;1;5;2;0
3248.0;2021;09;LILLE;MASCULIN;APPRENTISSAGE;BAC PROFESSIONNEL;BAC PRO PROD;BAC PRO 25221 MAINT.MATERIELS OPT.C ESP. VERTS;1;1;1;0;0;0;0;1;0;0;0;1;0;0
3252.0;2021;09;LILLE;MASCULIN;APPRENTISSAGE;BAC PROFESSIONNEL;BAC PRO PROD;BAC PRO 25411 TECH.CHAUDRONNERIE INDUSTRIELLE;72;72;59;8;5;3;2;62;0;6;19;15;22;10
3256.0;2021;09;LILLE;MASCULIN;APPRENTISSAGE;BAC PROFESSIONNEL;BAC PRO PROD;BAC PRO AG 21004 CGEA;37;37;24;13;0;0;0;24;0;0;4;3;17;13
3270.0;2021;09;LILLE;MASCULIN;ENSEIGNEMENT A DISTANCE;BAC GENERAL;BAC GENERAL;BAC GENE 10019 BAC GENERAL;26;24;22;2;0;0;0;22;1;2;7;7;5;2
3273.0;2021;09;LILLE;MASCULIN;ENSEIGNEMENT A DISTANCE;BAC PROFESSIONNEL;BAC PRO SERV;BAC PRO 31210 ACCUEIL -RELATION CLIENTS USAGERS;1;0;0;0;0;0;0;0;0;0;0;0;0;0
3278.0;2021;09;LILLE;MASCULIN;ENSEIGNEMENT A DISTANCE;BAC TECHNOLOGIQUE;BAC STMG;BAC STMG RESSOURCES HUMAINES ET COMMUNICATION;3;3;2;0;1;1;0;3;0;0;0;1;2;0
3279.0;2021;09;LILLE;MASCULIN;ENSEIGNEMENT A DISTANCE;BAC TECHNOLOGIQUE;BAC STMG;BAC STMG SYSTEMES D'INFORMATION DE GESTION;1;1;1;0;0;0;0;1;0;0;0;0;1;0
3287.0;2021;09;LILLE;MASCULIN;FORMATION CONTINUE;BAC PROFESSIONNEL;BAC PRO PROD;BAC PRO 25007 MAINTENANCE EQUIPEMENTS INDUST.;10;10;10;0;0;0;0;10;0;3;4;1;2;0
3289.0;2021;09;LILLE;MASCULIN;FORMATION CONTINUE;BAC PROFESSIONNEL;BAC PRO PROD;BAC PRO 25214 MAINT.VEHIC.OPTA VOIT.PARTICUL.;22;21;17;4;0;0;0;17;0;2;5;7;3;4
3290.0;2021;09;LILLE;MASCULIN;FORMATION CONTINUE;BAC PROFESSIONNEL;BAC PRO PROD;BAC PRO 25220 MAINT.MATERIELS OPT.B TP MANUT.;9;9;9;0;0;0;0;9;0;0;2;6;1;0
3294.0;2021;09;LILLE;MASCULIN;FORMATION CONTINUE;BAC PROFESSIONNEL;BAC PRO SERV;BAC PRO 30001 GESTION-ADMINISTRATION;13;13;13;0;0;0;0;13;0;2;2;4;5;0
3298.0;2021;09;LILLE;MASCULIN;INDIVIDUEL;BAC GENERAL;BAC GENERAL;BAC GENE 10019 BAC GENERAL;114;63;46;11;6;4;2;50;0;3;7;19;21;13
3304.0;2021;09;LILLE;MASCULIN;INDIVIDUEL;BAC PROFESSIONNEL;BAC PRO PROD;BAC PRO 25411 TECH.CHAUDRONNERIE INDUSTRIELLE;1;1;1;0;0;0;0;1;0;0;0;1;0;0
3305.0;2021;09;LILLE;MASCULIN;INDIVIDUEL;BAC PROFESSIONNEL;BAC PRO PROD;BAC PRO 25510 METIERS ELECT. ENVIRON. CONNECTES;1;1;1;0;0;0;0;1;0;0;0;0;1;0
3318.0;2021;09;LILLE;MASCULIN;INDIVIDUEL;BAC TECHNOLOGIQUE;BAC STI2D;BAC STI2D INNOVATION TECHNO.  ET ECO CONCEPTION;2;1;1;0;0;0;0;1;0;0;0;0;1;0
3332.0;2021;09;LILLE;MASCULIN;SCOLAIRE;BAC PROFESSIONNEL;BAC PRO PROD;BAC PRO 22703 TECHN.INSTALL.SYST.ENERG.CLIMATI;115;115;64;32;19;13;6;77;0;1;5;19;52;38
3334.0;2021;09;LILLE;MASCULIN;SCOLAIRE;BAC PROFESSIONNEL;BAC PRO PROD;BAC PRO 23003 ARTIS. & M.ART:MARCHANDISAGE VIS.;3;3;2;1;0;0;0;2;0;0;0;2;0;1
3337.0;2021;09;LILLE;MASCULIN;SCOLAIRE;BAC PROFESSIONNEL;BAC PRO PROD;BAC PRO 23102 TRAVAUX PUBLICS;39;39;35;1;3;3;0;38;0;2;10;16;10;1
3340.0;2021;09;LILLE;MASCULIN;SCOLAIRE;BAC PROFESSIONNEL;BAC PRO PROD;BAC PRO 23205 INTERV. SUR PATRIMOINE BATI OPT.A;2;2;2;0;0;0;0;2;0;0;0;2;0;0
3342.0;2021;09;LILLE;MASCULIN;SCOLAIRE;BAC PROFESSIONNEL;BAC PRO PROD;BAC PRO 23304 AMENAGEMENT FINITION BATIMENT;116;116;81;25;10;3;7;84;0;5;16;26;37;32
3345.0;2021;09;LILLE;MASCULIN;SCOLAIRE;BAC PROFESSIONNEL;BAC PRO PROD;BAC PRO 23407 TECHNIC.FAB.BOIS ET MATERX ASSOC;68;67;58;6;3;2;1;60;0;2;9;24;25;7
3352.0;2021;09;LILLE;MASCULIN;SCOLAIRE;BAC PROFESSIONNEL;BAC PRO PROD;BAC PRO 25216 MAINT.VEHIC.OPTC MOTOCYCLES;30;30;25;5;0;0;0;25;0;4;10;7;4;5
3356.0;2021;09;LILLE;MASCULIN;SCOLAIRE;BAC PROFESSIONNEL;BAC PRO PROD;BAC PRO 25303 AERONAUTIQUE OPTION SYSTEMES;19;19;17;1;1;1;0;18;0;2;3;8;5;1
3364.0;2021;09;LILLE;MASCULIN;SCOLAIRE;BAC PROFESSIONNEL;BAC PRO PROD;BAC PRO 25514 SYST.NUM.OPT.B AUD.RES.EQUIP.DOM.;118;118;102;13;3;3;0;105;0;5;16;50;34;13
3366.0;2021;09;LILLE;MASCULIN;SCOLAIRE;BAC PROFESSIONNEL;BAC PRO PROD;BAC PRO AG 21001 AGRO-EQUIPEMENT;41;41;35;6;0;0;0;35;0;0;6;14;15;6
3368.0;2021;09;LILLE;MASCULIN;SCOLAIRE;BAC PROFESSIONNEL;BAC PRO PROD;BAC PRO AG 21114 CONDUITE PRODUCTIONS HORTICOLES;10;10;10;0;0;0;0;10;0;1;0;4;5;0
3369.0;2021;09;LILLE;MASCULIN;SCOLAIRE;BAC PROFESSIONNEL;BAC PRO PROD;BAC PRO AG 21203 TECHN CONSEIL DE VENTE ANIMAL;34;34;32;2;0;0;0;32;0;2;7;7;16;2
3374.0;2021;09;LILLE;MASCULIN;SCOLAIRE;BAC PROFESSIONNEL;BAC PRO PROD;BAC PRO AG 21303 FORET;12;12;12;0;0;0;0;12;0;0;3;4;5;0
3385.0;2021;09;LILLE;MASCULIN;SCOLAIRE;BAC PROFESSIONNEL;BAC PRO SERV;BAC PRO 31210 ACCUEIL -RELATION CLIENTS USAGERS;109;109;77;27;5;5;0;82;0;2;13;33;34;27
3395.0;2021;09;LILLE;MASCULIN;SCOLAIRE;BAC PROFESSIONNEL;BAC PRO SERV;BAC PRO 33103 TECHNICIEN APPAREIL. ORTHOPEDIQUE;8;8;7;1;0;0;0;7;0;2;0;2;3;1
3403.0;2021;09;LILLE;MASCULIN;SCOLAIRE;BAC TECHNOLOGIQUE;BAC STAV;BAC STAV AGRONOMIE ALIM ENV TERRITOI;196;194;193;1;0;0;0;193;0;3;48;94;48;1
3406.0;2021;09;LILLE;MASCULIN;SCOLAIRE;BAC TECHNOLOGIQUE;BAC STI2D;BAC STI2D ARCHITECTURE ET CONSTRUCTION;329;328;290;9;29;16;13;306;0;8;60;123;115;22
3407.0;2021;09;LILLE;MASCULIN;SCOLAIRE;BAC TECHNOLOGIQUE;BAC STI2D;BAC STI2D ENERGIES  ET ENVIRONNEMENT;212;212;182;10;20;11;9;193;0;9;28;72;84;19
3410.0;2021;09;LILLE;MASCULIN;SCOLAIRE;BAC TECHNOLOGIQUE;BAC STL;BAC STL BIOCHIM.-BIOLOGIE-BIOTECHNOL.;124;124;109;6;9;2;7;111;0;3;16;43;49;13
3413.0;2021;09;LILLE;MASCULIN;SCOLAIRE;BAC TECHNOLOGIQUE;BAC STMG;BAC STMG MERCATIQUE (MARKETING);971;969;831;41;97;59;38;890;0;14;95;323;458;79
3419.0;2021;22;LIMOGES;FEMININ;APPRENTISSAGE;BAC PROFESSIONNEL;BAC PRO PROD;BAC PRO 25214 MAINT.VEHIC.OPTA VOIT.PARTICUL.;1;1;1;0;0;0;0;1;0;1;0;0;0;0
3423.0;2021;22;LIMOGES;FEMININ;APPRENTISSAGE;BAC PROFESSIONNEL;BAC PRO SERV;BAC PRO 31202 COMMERCE;19;18;14;1;3;2;1;16;0;0;3;6;7;2
3425.0;2021;22;LIMOGES;FEMININ;APPRENTISSAGE;BAC PROFESSIONNEL;BAC PRO SERV;BAC PRO 33101 OPTIQUE LUNETTERIE;1;1;1;0;0;0;0;1;0;0;1;0;0;0
3427.0;2021;22;LIMOGES;FEMININ;ENSEIGNEMENT A DISTANCE;BAC GENERAL;BAC GENERAL;BAC GENE 10019 BAC GENERAL;13;13;12;1;0;0;0;12;0;1;6;4;1;1
3430.0;2021;22;LIMOGES;FEMININ;ENSEIGNEMENT A DISTANCE;BAC TECHNOLOGIQUE;BAC ST2S;BAC ST2S SCIENCES & TECHNO. SANTE & SOCIAL;1;1;1;0;0;0;0;1;0;0;1;0;0;0
3437.0;2021;22;LIMOGES;FEMININ;INDIVIDUEL;BAC PROFESSIONNEL;BAC PRO PROD;BAC PRO AG 21114 CONDUITE PRODUCTIONS HORTICOLES;3;1;1;0;0;0;0;1;0;0;0;0;1;0
3439.0;2021;22;LIMOGES;FEMININ;INDIVIDUEL;BAC PROFESSIONNEL;BAC PRO SERV;BAC PRO 30001 GESTION-ADMINISTRATION;1;0;0;0;0;0;0;0;0;0;0;0;0;0
3441.0;2021;22;LIMOGES;FEMININ;INDIVIDUEL;BAC PROFESSIONNEL;BAC PRO SERV;BAC PRO 31206 VENTE (PROSPECT.NEGO.SUIV.CLIENT;1;0;0;0;0;0;0;0;0;0;0;0;0;0
3443.0;2021;22;LIMOGES;FEMININ;INDIVIDUEL;BAC PROFESSIONNEL;BAC PRO SERV;BAC PRO 33002 SERVICES DE PROXIMITE  VIE LOCAL;1;1;0;1;0;0;0;0;0;0;0;0;0;1
3444.0;2021;22;LIMOGES;FEMININ;INDIVIDUEL;BAC PROFESSIONNEL;BAC PRO SERV;BAC PRO 33004 ACC.SOINS-S.PERS. OPT.EN STRUCTUR;3;1;0;1;0;0;0;0;0;0;0;0;0;1
3445.0;2021;22;LIMOGES;FEMININ;INDIVIDUEL;BAC TECHNOLOGIQUE;BAC ST2S;BAC ST2S SCIENCES & TECHNO. SANTE & SOCIAL;1;1;0;0;1;1;0;1;0;0;0;0;1;0
3449.0;2021;22;LIMOGES;FEMININ;SCOLAIRE;BAC GENERAL;BAC GENERAL;BAC GENE 10019 BAC GENERAL;1954;1952;1875;9;68;45;23;1920;31;224;500;683;482;32
3452.0;2021;22;LIMOGES;FEMININ;SCOLAIRE;BAC PROFESSIONNEL;BAC PRO PROD;BAC PRO 22106 CUISINE;24;24;22;1;1;0;1;22;0;1;8;10;3;2
3469.0;2021;22;LIMOGES;FEMININ;SCOLAIRE;BAC PROFESSIONNEL;BAC PRO PROD;BAC PRO 25514 SYST.NUM.OPT.B AUD.RES.EQUIP.DOM.;2;2;1;0;1;0;1;1;0;0;1;0;0;1
3470.0;2021;22;LIMOGES;FEMININ;SCOLAIRE;BAC PROFESSIONNEL;BAC PRO PROD;BAC PRO AG 21004 CGEA;14;14;13;1;0;0;0;13;0;0;1;3;9;1
3505.0;2021;22;LIMOGES;FEMININ;SCOLAIRE;BAC TECHNOLOGIQUE;BAC STMG;BAC STMG GESTION ET FINANCE;32;32;29;0;3;0;3;29;0;1;5;11;12;3
3507.0;2021;22;LIMOGES;FEMININ;SCOLAIRE;BAC TECHNOLOGIQUE;BAC STMG;BAC STMG RESSOURCES HUMAINES ET COMMUNICATION;113;113;103;3;7;4;3;107;0;2;6;43;56;6
3508.0;2021;22;LIMOGES;FEMININ;SCOLAIRE;BAC TECHNOLOGIQUE;BAC STMG;BAC STMG SYSTEMES D'INFORMATION DE GESTION;2;2;1;0;1;1;0;2;0;0;0;0;2;0
3511.0;2021;22;LIMOGES;MASCULIN;APPRENTISSAGE;BAC PROFESSIONNEL;BAC PRO PROD;BAC PRO 23102 TRAVAUX PUBLICS;15;15;15;0;0;0;0;15;0;2;4;9;0;0
3513.0;2021;22;LIMOGES;MASCULIN;APPRENTISSAGE;BAC PROFESSIONNEL;BAC PRO PROD;BAC PRO 23205 INTERV. SUR PATRIMOINE BATI OPT.A;2;2;2;0;0;0;0;2;0;0;1;1;0;0
3527.0;2021;22;LIMOGES;MASCULIN;APPRENTISSAGE;BAC PROFESSIONNEL;BAC PRO PROD;BAC PRO 25410 CONSTRUCTION DES CARROSSERIES;1;1;1;0;0;0;0;1;0;0;0;0;1;0
3531.0;2021;22;LIMOGES;MASCULIN;APPRENTISSAGE;BAC PROFESSIONNEL;BAC PRO PROD;BAC PRO AG 21004 CGEA;20;19;19;0;0;0;0;19;0;0;2;2;15;0
3532.0;2021;22;LIMOGES;MASCULIN;APPRENTISSAGE;BAC PROFESSIONNEL;BAC PRO PROD;BAC PRO AG 21405 AMENAGEMENTS PAYSAGERS;24;24;21;3;0;0;0;21;0;0;2;6;13;3
3542.0;2021;22;LIMOGES;MASCULIN;FORMATION CONTINUE;BAC PROFESSIONNEL;BAC PRO SERV;BAC PRO 30001 GESTION-ADMINISTRATION;5;5;5;0;0;0;0;5;0;0;0;4;1;0
3544.0;2021;22;LIMOGES;MASCULIN;INDIVIDUEL;BAC PROFESSIONNEL;BAC PRO PROD;BAC PRO 23404 TECHNICIEN CONSTRUCTEUR BOIS;1;1;1;0;0;0;0;1;0;0;0;0;1;0
3545.0;2021;22;LIMOGES;MASCULIN;INDIVIDUEL;BAC PROFESSIONNEL;BAC PRO PROD;BAC PRO 25216 MAINT.VEHIC.OPTC MOTOCYCLES;1;1;1;0;0;0;0;1;0;0;0;1;0;0
3556.0;2021;22;LIMOGES;MASCULIN;SCOLAIRE;BAC GENERAL;BAC GENERAL;BAC GENE 10019 BAC GENERAL;1442;1441;1339;20;82;55;27;1394;16;124;261;477;516;47
3561.0;2021;22;LIMOGES;MASCULIN;SCOLAIRE;BAC PROFESSIONNEL;BAC PRO PROD;BAC PRO 22106 CUISINE;23;23;22;0;1;1;0;23;0;1;5;12;5;0
3563.0;2021;22;LIMOGES;MASCULIN;SCOLAIRE;BAC PROFESSIONNEL;BAC PRO PROD;BAC PRO 23004 TECHN. ETUDES BAT.A ETUDES & ECO.;7;7;4;1;2;2;0;6;0;0;0;1;5;1
3573.0;2021;22;LIMOGES;MASCULIN;SCOLAIRE;BAC PROFESSIONNEL;BAC PRO PROD;BAC PRO 25007 MAINTENANCE EQUIPEMENTS INDUST.;44;44;34;8;2;2;0;36;0;0;3;18;15;8
3575.0;2021;22;LIMOGES;MASCULIN;SCOLAIRE;BAC PROFESSIONNEL;BAC PRO PROD;BAC PRO 25107 TECHNICIEN OUTILLEUR;9;9;3;4;2;1;1;4;0;0;1;1;2;5
3579.0;2021;22;LIMOGES;MASCULIN;SCOLAIRE;BAC PROFESSIONNEL;BAC PRO PROD;BAC PRO 25216 MAINT.VEHIC.OPTC MOTOCYCLES;7;7;7;0;0;0;0;7;0;0;2;3;2;0
3581.0;2021;22;LIMOGES;MASCULIN;SCOLAIRE;BAC PROFESSIONNEL;BAC PRO PROD;BAC PRO 25220 MAINT.MATERIELS OPT.B TP MANUT.;24;24;24;0;0;0;0;24;0;2;11;9;2;0
3589.0;2021;22;LIMOGES;MASCULIN;SCOLAIRE;BAC PROFESSIONNEL;BAC PRO PROD;BAC PRO 25515 SYST.NUM.OPT.C RES.INF.SYST.COMM.;35;35;32;2;1;1;0;33;0;2;9;13;9;2
3593.0;2021;22;LIMOGES;MASCULIN;SCOLAIRE;BAC PROFESSIONNEL;BAC PRO PROD;BAC PRO AG 21203 TECHN CONSEIL DE VENTE ANIMAL;8;8;7;1;0;0;0;7;0;0;2;2;3;1
3596.0;2021;22;LIMOGES;MASCULIN;SCOLAIRE;BAC PROFESSIONNEL;BAC PRO PROD;BAC PRO AG 21302 GEST MILIEUX NATURELS FAUNE;26;26;24;2;0;0;0;24;0;1;0;13;10;2
3600.0;2021;22;LIMOGES;MASCULIN;SCOLAIRE;BAC PROFESSIONNEL;BAC PRO PROD;BAC PRO AG 22105 LABORATOIRE CONTROLE QUALITE;4;4;4;0;0;0;0;4;0;0;2;1;1;0
3602.0;2021;22;LIMOGES;MASCULIN;SCOLAIRE;BAC PROFESSIONNEL;BAC PRO SERV;BAC PRO 31106 LOGISTIQUE;10;10;7;3;0;0;0;7;0;1;0;1;5;3
3604.0;2021;22;LIMOGES;MASCULIN;SCOLAIRE;BAC PROFESSIONNEL;BAC PRO SERV;BAC PRO 31108 TRANSPORT;6;6;3;2;1;0;1;3;0;0;2;0;1;3
3614.0;2021;22;LIMOGES;MASCULIN;SCOLAIRE;BAC PROFESSIONNEL;BAC PRO SERV;BAC PRO 33101 OPTIQUE LUNETTERIE;6;6;5;1;0;0;0;5;0;1;3;1;0;1
3641.0;2021;10;LYON;FEMININ;APPRENTISSAGE;BAC PROFESSIONNEL;BAC PRO PROD;BAC PRO 23405 TECHNICIEN MENUISIER AGENCEUR;3;3;3;0;0;0;0;3;0;1;1;1;0;0
3661.0;2021;10;LYON;FEMININ;APPRENTISSAGE;BAC PROFESSIONNEL;BAC PRO SERV;BAC PRO 31106 LOGISTIQUE;1;1;1;0;0;0;0;1;0;0;0;1;0;0
3667.0;2021;10;LYON;FEMININ;APPRENTISSAGE;BAC PROFESSIONNEL;BAC PRO SERV;BAC PRO 33102 PROTHESE DENTAIRE;6;5;4;1;0;0;0;4;0;0;1;0;3;1
3674.0;2021;10;LYON;FEMININ;ENSEIGNEMENT A DISTANCE;BAC TECHNOLOGIQUE;BAC STMG;BAC STMG MERCATIQUE (MARKETING);5;5;5;0;0;0;0;5;0;0;3;2;0;0
3675.0;2021;10;LYON;FEMININ;ENSEIGNEMENT A DISTANCE;BAC TECHNOLOGIQUE;BAC STMG;BAC STMG RESSOURCES HUMAINES ET COMMUNICATION;1;1;1;0;0;0;0;1;0;0;0;1;0;0
3688.0;2021;10;LYON;FEMININ;INDIVIDUEL;BAC PROFESSIONNEL;BAC PRO SERV;BAC PRO 30001 GESTION-ADMINISTRATION;17;9;4;4;1;1;0;5;0;0;1;0;4;4
3693.0;2021;10;LYON;FEMININ;INDIVIDUEL;BAC PROFESSIONNEL;BAC PRO SERV;BAC PRO 33003 ACC.SOINS-S.PERS. OPT.A DOMICILE;1;1;1;0;0;0;0;1;0;0;0;0;1;0
3694.0;2021;10;LYON;FEMININ;INDIVIDUEL;BAC PROFESSIONNEL;BAC PRO SERV;BAC PRO 33004 ACC.SOINS-S.PERS. OPT.EN STRUCTUR;13;7;4;2;1;0;1;4;0;0;0;3;1;3
3707.0;2021;10;LYON;FEMININ;SCOLAIRE;BAC GENERAL;BAC GENERAL;BAC GENE 10019 BAC GENERAL;10300;10298;9926;72;300;180;120;10106;158;1260;2804;3665;2219;192
3710.0;2021;10;LYON;FEMININ;SCOLAIRE;BAC PROFESSIONNEL;BAC PRO PROD;BAC PRO 22105 BOULANGER-PÂTISSIER;20;20;19;1;0;0;0;19;0;3;8;5;3;1
3712.0;2021;10;LYON;FEMININ;SCOLAIRE;BAC PROFESSIONNEL;BAC PRO PROD;BAC PRO 22503 PLASTIQUES ET COMPOSITES;2;2;2;0;0;0;0;2;0;0;0;1;1;0
3717.0;2021;10;LYON;FEMININ;SCOLAIRE;BAC PROFESSIONNEL;BAC PRO PROD;BAC PRO 23304 AMENAGEMENT FINITION BATIMENT;3;3;2;1;0;0;0;2;0;0;0;0;2;1
3718.0;2021;10;LYON;FEMININ;SCOLAIRE;BAC PROFESSIONNEL;BAC PRO PROD;BAC PRO 23405 TECHNICIEN MENUISIER AGENCEUR;11;11;9;0;2;2;0;11;0;0;3;4;4;0
3723.0;2021;10;LYON;FEMININ;SCOLAIRE;BAC PROFESSIONNEL;BAC PRO PROD;BAC PRO 24302 METIERS DU CUIR : MAROQUINERIE;11;11;10;1;0;0;0;10;0;1;1;6;2;1
3726.0;2021;10;LYON;FEMININ;SCOLAIRE;BAC PROFESSIONNEL;BAC PRO PROD;BAC PRO 25007 MAINTENANCE EQUIPEMENTS INDUST.;1;1;0;1;0;0;0;0;0;0;0;0;0;1
3729.0;2021;10;LYON;FEMININ;SCOLAIRE;BAC PROFESSIONNEL;BAC PRO PROD;BAC PRO 25216 MAINT.VEHIC.OPTC MOTOCYCLES;3;3;3;0;0;0;0;3;0;0;1;1;1;0
3731.0;2021;10;LYON;FEMININ;SCOLAIRE;BAC PROFESSIONNEL;BAC PRO PROD;BAC PRO 25220 MAINT.MATERIELS OPT.B TP MANUT.;1;1;1;0;0;0;0;1;0;0;0;1;0;0
3740.0;2021;10;LYON;FEMININ;SCOLAIRE;BAC PROFESSIONNEL;BAC PRO PROD;BAC PRO AG 21203 TECHN CONSEIL DE VENTE ANIMAL;36;36;34;2;0;0;0;34;0;1;2;17;14;2
3747.0;2021;10;LYON;FEMININ;SCOLAIRE;BAC PROFESSIONNEL;BAC PRO PROD;BAC PRO AG 21406 TEC CONS VTE PROD DES JARDINS;6;6;4;2;0;0;0;4;0;0;1;3;0;2
3751.0;2021;10;LYON;FEMININ;SCOLAIRE;BAC PROFESSIONNEL;BAC PRO SERV;BAC PRO 31106 LOGISTIQUE;11;11;7;2;2;2;0;9;0;0;1;2;6;2
3762.0;2021;10;LYON;FEMININ;SCOLAIRE;BAC PROFESSIONNEL;BAC PRO SERV;BAC PRO 33003 ACC.SOINS-S.PERS. OPT.A DOMICILE;62;62;53;6;3;2;1;55;0;1;12;22;20;7
3763.0;2021;10;LYON;FEMININ;SCOLAIRE;BAC PROFESSIONNEL;BAC PRO SERV;BAC PRO 33004 ACC.SOINS-S.PERS. OPT.EN STRUCTUR;611;611;553;34;24;19;5;572;0;34;148;243;147;39
3765.0;2021;10;LYON;FEMININ;SCOLAIRE;BAC PROFESSIONNEL;BAC PRO SERV;BAC PRO 33102 PROTHESE DENTAIRE;24;23;18;4;1;1;0;19;0;1;2;6;10;4
3770.0;2021;10;LYON;FEMININ;SCOLAIRE;BAC PROFESSIONNEL;BAC PRO SERV;BAC PRO 34403 METIERS DE LA SECURITE;31;31;31;0;0;0;0;31;0;4;13;11;3;0
3771.0;2021;10;LYON;FEMININ;SCOLAIRE;BAC PROFESSIONNEL;BAC PRO SERV;BAC PRO AG 33002 SERV PERS TERRIT;342;339;323;16;0;0;0;323;0;6;46;143;128;16
3773.0;2021;10;LYON;FEMININ;SCOLAIRE;BAC TECHNOLOGIQUE;BAC S2TMD;BAC S2TMD MUSIQUE;4;4;4;0;0;0;0;4;0;1;3;0;0;0
3777.0;2021;10;LYON;FEMININ;SCOLAIRE;BAC TECHNOLOGIQUE;BAC STHR;BAC STHR SC.&TEC. HOTELLERIE-RESTAURATION;55;55;55;0;0;0;0;55;1;1;11;24;18;0
3778.0;2021;10;LYON;FEMININ;SCOLAIRE;BAC TECHNOLOGIQUE;BAC STI2D;BAC STI2D ARCHITECTURE ET CONSTRUCTION;55;55;54;0;1;1;0;55;0;4;16;21;14;0
3786.0;2021;10;LYON;FEMININ;SCOLAIRE;BAC TECHNOLOGIQUE;BAC STMG;BAC STMG RESSOURCES HUMAINES ET COMMUNICATION;616;616;532;18;66;29;37;561;0;7;51;247;256;55
3788.0;2021;10;LYON;MASCULIN;APPRENTISSAGE;BAC PROFESSIONNEL;BAC PRO PROD;BAC PRO 20102 PILOTE DE LIGNE DE PRODUCTION;5;5;4;1;0;0;0;4;0;0;1;1;2;1
3790.0;2021;10;LYON;MASCULIN;APPRENTISSAGE;BAC PROFESSIONNEL;BAC PRO PROD;BAC PRO 22004 PROC. CHIMIE EAU PAPIERS-CARTONS;8;8;8;0;0;0;0;8;0;1;5;2;0;0
3816.0;2021;10;LYON;MASCULIN;APPRENTISSAGE;BAC PROFESSIONNEL;BAC PRO PROD;BAC PRO 25406 OUVRAGES DU BATIMENT METALLERIE;11;11;11;0;0;0;0;11;0;3;3;3;2;0
3829.0;2021;10;LYON;MASCULIN;APPRENTISSAGE;BAC PROFESSIONNEL;BAC PRO PROD;BAC PRO AG 21211 COND GEST ENTR HIPPIQUE;2;2;2;0;0;0;0;2;0;0;0;0;2;0
3832.0;2021;10;LYON;MASCULIN;APPRENTISSAGE;BAC PROFESSIONNEL;BAC PRO SERV;BAC PRO 30001 GESTION-ADMINISTRATION;4;2;2;0;0;0;0;2;0;0;0;2;0;0
3834.0;2021;10;LYON;MASCULIN;APPRENTISSAGE;BAC PROFESSIONNEL;BAC PRO SERV;BAC PRO 31202 COMMERCE;100;92;74;9;9;3;6;77;0;4;16;24;33;15
3848.0;2021;10;LYON;MASCULIN;ENSEIGNEMENT A DISTANCE;BAC TECHNOLOGIQUE;BAC STMG;BAC STMG SYSTEMES D'INFORMATION DE GESTION;2;2;2;0;0;0;0;2;0;0;0;1;1;0
3856.0;2021;10;LYON;MASCULIN;FORMATION CONTINUE;BAC PROFESSIONNEL;BAC PRO PROD;BAC PRO 25510 METIERS ELECT. ENVIRON. CONNECTES;5;5;5;0;0;0;0;5;0;4;1;0;0;0
3858.0;2021;10;LYON;MASCULIN;FORMATION CONTINUE;BAC PROFESSIONNEL;BAC PRO SERV;BAC PRO 31202 COMMERCE;23;22;19;3;0;0;0;19;0;1;5;10;3;3
3868.0;2021;10;LYON;MASCULIN;INDIVIDUEL;BAC PROFESSIONNEL;BAC PRO PROD;BAC PRO 25107 TECHNICIEN OUTILLEUR;2;2;1;1;0;0;0;1;0;0;0;1;0;1
3872.0;2021;10;LYON;MASCULIN;INDIVIDUEL;BAC PROFESSIONNEL;BAC PRO PROD;BAC PRO 25510 METIERS ELECT. ENVIRON. CONNECTES;5;1;1;0;0;0;0;1;0;0;0;0;1;0
3875.0;2021;10;LYON;MASCULIN;INDIVIDUEL;BAC PROFESSIONNEL;BAC PRO PROD;BAC PRO AG 21114 CONDUITE PRODUCTIONS HORTICOLES;4;3;2;1;0;0;0;2;0;0;0;0;2;1
3878.0;2021;10;LYON;MASCULIN;INDIVIDUEL;BAC PROFESSIONNEL;BAC PRO PROD;BAC PRO AG 21405 AMENAGEMENTS PAYSAGERS;1;0;0;0;0;0;0;0;0;0;0;0;0;0
3882.0;2021;10;LYON;MASCULIN;INDIVIDUEL;BAC PROFESSIONNEL;BAC PRO SERV;BAC PRO 31107 CONDUCT. TRANSP.ROUT.MARCHANDISES;1;1;0;1;0;0;0;0;0;0;0;0;0;1
3888.0;2021;10;LYON;MASCULIN;INDIVIDUEL;BAC PROFESSIONNEL;BAC PRO SERV;BAC PRO 33002 SERVICES DE PROXIMITE  VIE LOCAL;1;1;1;0;0;0;0;1;0;0;0;0;1;0
3891.0;2021;10;LYON;MASCULIN;INDIVIDUEL;BAC TECHNOLOGIQUE;BAC S2TMD;BAC S2TMD MUSIQUE;1;1;1;0;0;0;0;1;0;1;0;0;0;0
3894.0;2021;10;LYON;MASCULIN;INDIVIDUEL;BAC TECHNOLOGIQUE;BAC STD2A;BAC STD2A SCIENCES & TECHNO. DESIGN-ARTS APPLIQUES;6;6;4;0;2;2;0;6;0;0;0;3;3;0
3895.0;2021;10;LYON;MASCULIN;INDIVIDUEL;BAC TECHNOLOGIQUE;BAC STI2D;BAC STI2D ARCHITECTURE ET CONSTRUCTION;2;0;0;0;0;0;0;0;0;0;0;0;0;0
3901.0;2021;10;LYON;MASCULIN;INDIVIDUEL;BAC TECHNOLOGIQUE;BAC STMG;BAC STMG GESTION ET FINANCE;12;8;4;2;2;1;1;5;0;0;0;0;5;3
3903.0;2021;10;LYON;MASCULIN;INDIVIDUEL;BAC TECHNOLOGIQUE;BAC STMG;BAC STMG RESSOURCES HUMAINES ET COMMUNICATION;9;3;1;1;1;0;1;1;0;0;0;0;1;2
3909.0;2021;10;LYON;MASCULIN;SCOLAIRE;BAC PROFESSIONNEL;BAC PRO PROD;BAC PRO 22004 PROC. CHIMIE EAU PAPIERS-CARTONS;21;21;14;6;1;1;0;15;0;0;2;9;4;6
3914.0;2021;10;LYON;MASCULIN;SCOLAIRE;BAC PROFESSIONNEL;BAC PRO PROD;BAC PRO 22503 PLASTIQUES ET COMPOSITES;15;15;13;0;2;0;2;13;0;0;3;5;5;2
3918.0;2021;10;LYON;MASCULIN;SCOLAIRE;BAC PROFESSIONNEL;BAC PRO PROD;BAC PRO 23004 TECHN. ETUDES BAT.A ETUDES & ECO.;38;38;30;8;0;0;0;30;0;3;4;15;8;8
3919.0;2021;10;LYON;MASCULIN;SCOLAIRE;BAC PROFESSIONNEL;BAC PRO PROD;BAC PRO 23005 TECHN. ETUDES BAT B ASSIST.ARCHI.;25;25;21;4;0;0;0;21;0;1;6;8;6;4
3920.0;2021;10;LYON;MASCULIN;SCOLAIRE;BAC PROFESSIONNEL;BAC PRO PROD;BAC PRO 23102 TRAVAUX PUBLICS;7;7;7;0;0;0;0;7;0;1;3;1;2;0
3937.0;2021;10;LYON;MASCULIN;SCOLAIRE;BAC PROFESSIONNEL;BAC PRO PROD;BAC PRO 25107 TECHNICIEN OUTILLEUR;19;19;15;3;1;0;1;15;0;0;1;6;8;4
3946.0;2021;10;LYON;MASCULIN;SCOLAIRE;BAC PROFESSIONNEL;BAC PRO PROD;BAC PRO 25410 CONSTRUCTION DES CARROSSERIES;3;3;2;0;1;1;0;3;0;0;0;2;1;0
3948.0;2021;10;LYON;MASCULIN;SCOLAIRE;BAC PROFESSIONNEL;BAC PRO PROD;BAC PRO 25509 TECHNIC. FROID CONDITIONNEMT AIR;35;35;19;12;4;1;3;20;0;0;2;9;9;15
3953.0;2021;10;LYON;MASCULIN;SCOLAIRE;BAC PROFESSIONNEL;BAC PRO PROD;BAC PRO AG 21001 AGRO-EQUIPEMENT;25;24;16;8;0;0;0;16;0;0;0;6;10;8
3955.0;2021;10;LYON;MASCULIN;SCOLAIRE;BAC PROFESSIONNEL;BAC PRO PROD;BAC PRO AG 21113 CGEVV;7;7;6;1;0;0;0;6;0;0;0;3;3;1
3961.0;2021;10;LYON;MASCULIN;SCOLAIRE;BAC PROFESSIONNEL;BAC PRO PROD;BAC PRO AG 21212 TECH EXPE ANIMALE;10;10;9;1;0;0;0;9;0;0;0;4;5;1
3968.0;2021;10;LYON;MASCULIN;SCOLAIRE;BAC PROFESSIONNEL;BAC PRO SERV;BAC PRO 30001 GESTION-ADMINISTRATION;294;293;228;55;10;5;5;233;0;6;31;94;102;60
3969.0;2021;10;LYON;MASCULIN;SCOLAIRE;BAC PROFESSIONNEL;BAC PRO SERV;BAC PRO 31106 LOGISTIQUE;84;84;65;11;8;6;2;71;0;0;15;22;34;13
3972.0;2021;10;LYON;MASCULIN;SCOLAIRE;BAC PROFESSIONNEL;BAC PRO SERV;BAC PRO 31202 COMMERCE;425;425;358;34;33;22;11;380;0;19;83;141;137;45
3976.0;2021;10;LYON;MASCULIN;SCOLAIRE;BAC PROFESSIONNEL;BAC PRO SERV;BAC PRO 32208 REAL.PR.IMPR.PLURI.OPTB.PR.IMPR.;27;27;24;2;1;1;0;25;0;1;2;8;14;2
3982.0;2021;10;LYON;MASCULIN;SCOLAIRE;BAC PROFESSIONNEL;BAC PRO SERV;BAC PRO 33101 OPTIQUE LUNETTERIE;10;10;9;1;0;0;0;9;0;0;6;2;1;1
3984.0;2021;10;LYON;MASCULIN;SCOLAIRE;BAC PROFESSIONNEL;BAC PRO SERV;BAC PRO 33403 COMMERC. SERVICES EN RESTAURATION;65;65;56;7;2;2;0;58;0;0;10;29;19;7
3995.0;2021;10;LYON;MASCULIN;SCOLAIRE;BAC TECHNOLOGIQUE;BAC STHR;BAC STHR SC.&TEC. HOTELLERIE-RESTAURATION;44;44;44;0;0;0;0;44;0;3;15;20;6;0
4005.0;2021;10;LYON;MASCULIN;SCOLAIRE;BAC TECHNOLOGIQUE;BAC STMG;BAC STMG SYSTEMES D'INFORMATION DE GESTION;53;53;42;6;5;2;3;44;0;0;2;16;26;9
4009.0;2021;31;MARTINIQUE;FEMININ;APPRENTISSAGE;BAC PROFESSIONNEL;BAC PRO SERV;BAC PRO 31106 LOGISTIQUE;1;1;1;0;0;0;0;1;0;0;0;0;1;0
4013.0;2021;31;MARTINIQUE;FEMININ;ENSEIGNEMENT A DISTANCE;BAC GENERAL;BAC GENERAL;BAC GENE 10019 BAC GENERAL;3;3;3;0;0;0;0;3;0;0;1;1;1;0
4018.0;2021;31;MARTINIQUE;FEMININ;INDIVIDUEL;BAC PROFESSIONNEL;BAC PRO SERV;BAC PRO 31210 ACCUEIL -RELATION CLIENTS USAGERS;1;1;0;0;1;1;0;1;0;0;0;0;1;0
4027.0;2021;31;MARTINIQUE;FEMININ;SCOLAIRE;BAC PROFESSIONNEL;BAC PRO PROD;BAC PRO 22106 CUISINE;22;22;22;0;0;0;0;22;0;2;5;10;5;0
4029.0;2021;31;MARTINIQUE;FEMININ;SCOLAIRE;BAC PROFESSIONNEL;BAC PRO PROD;BAC PRO 23004 TECHN. ETUDES BAT.A ETUDES & ECO.;1;1;1;0;0;0;0;1;0;0;0;1;0;0
4031.0;2021;31;MARTINIQUE;FEMININ;SCOLAIRE;BAC PROFESSIONNEL;BAC PRO PROD;BACPRO 23103 TECHNICIEN GEOMETRE-TOPOGRAPHE;1;1;1;0;0;0;0;1;0;0;0;0;1;0
4033.0;2021;31;MARTINIQUE;FEMININ;SCOLAIRE;BAC PROFESSIONNEL;BAC PRO PROD;BAC PRO 23304 AMENAGEMENT FINITION BATIMENT;1;1;1;0;0;0;0;1;0;0;0;0;1;0
4036.0;2021;31;MARTINIQUE;FEMININ;SCOLAIRE;BAC PROFESSIONNEL;BAC PRO PROD;BAC PRO 24203 METIERS DE LA MODE - VÊTEMENT;15;15;13;2;0;0;0;13;0;0;3;4;6;2
4039.0;2021;31;MARTINIQUE;FEMININ;SCOLAIRE;BAC PROFESSIONNEL;BAC PRO PROD;BAC PRO 25214 MAINT.VEHIC.OPTA VOIT.PARTICUL.;5;5;4;1;0;0;0;4;0;0;0;3;1;1
4044.0;2021;31;MARTINIQUE;FEMININ;SCOLAIRE;BAC PROFESSIONNEL;BAC PRO PROD;BAC PRO AG 21004 CGEA;5;5;5;0;0;0;0;5;0;1;3;1;0;0
4054.0;2021;31;MARTINIQUE;FEMININ;SCOLAIRE;BAC PROFESSIONNEL;BAC PRO SERV;BAC PRO 32303 ART.& MET.ART:COM.VIS.VIS.PLURI-M;5;5;5;0;0;0;0;5;0;1;3;0;1;0
4056.0;2021;31;MARTINIQUE;FEMININ;SCOLAIRE;BAC PROFESSIONNEL;BAC PRO SERV;BAC PRO 33003 ACC.SOINS-S.PERS. OPT.A DOMICILE;68;68;51;10;7;1;6;52;0;1;4;24;23;16
4063.0;2021;31;MARTINIQUE;FEMININ;SCOLAIRE;BAC TECHNOLOGIQUE;BAC ST2S;BAC ST2S SCIENCES & TECHNO. SANTE & SOCIAL;161;161;143;1;17;12;5;155;0;2;15;54;84;6
4069.0;2021;31;MARTINIQUE;FEMININ;SCOLAIRE;BAC TECHNOLOGIQUE;BAC STI2D;BAC STI2D INNOVATION TECHNO.  ET ECO CONCEPTION;1;1;1;0;0;0;0;1;0;0;0;1;0;0
4070.0;2021;31;MARTINIQUE;FEMININ;SCOLAIRE;BAC TECHNOLOGIQUE;BAC STI2D;BAC STI2D SYSTÈME D'INFORMATION  ET NUMERIQUE;5;5;5;0;0;0;0;5;0;0;1;3;1;0
4073.0;2021;31;MARTINIQUE;FEMININ;SCOLAIRE;BAC TECHNOLOGIQUE;BAC STMG;BAC STMG MERCATIQUE (MARKETING);63;63;55;0;8;6;2;61;0;1;6;20;34;2
4088.0;2021;31;MARTINIQUE;MASCULIN;APPRENTISSAGE;BAC PROFESSIONNEL;BAC PRO SERV;BAC PRO 31202 COMMERCE;4;4;2;0;2;2;0;4;0;0;0;1;3;0
4093.0;2021;31;MARTINIQUE;MASCULIN;ENSEIGNEMENT A DISTANCE;BAC TECHNOLOGIQUE;BAC STMG;BAC STMG GESTION ET FINANCE;1;1;1;0;0;0;0;1;0;0;0;1;0;0
4124.0;2021;31;MARTINIQUE;MASCULIN;SCOLAIRE;BAC PROFESSIONNEL;BAC PRO PROD;BAC PRO 23405 TECHNICIEN MENUISIER AGENCEUR;3;3;1;1;1;1;0;2;0;0;0;0;2;1
4127.0;2021;31;MARTINIQUE;MASCULIN;SCOLAIRE;BAC PROFESSIONNEL;BAC PRO PROD;BAC PRO 25007 MAINTENANCE EQUIPEMENTS INDUST.;17;17;9;7;1;1;0;10;0;0;1;3;6;7
4145.0;2021;31;MARTINIQUE;MASCULIN;SCOLAIRE;BAC PROFESSIONNEL;BAC PRO PROD;BAC PRO AG 22107 TEC CONS VTE ALIMENTATION P.ALIM;7;6;5;1;0;0;0;5;0;0;0;0;5;1
4156.0;2021;31;MARTINIQUE;MASCULIN;SCOLAIRE;BAC PROFESSIONNEL;BAC PRO SERV;BAC PRO 33403 COMMERC. SERVICES EN RESTAURATION;17;17;15;2;0;0;0;15;0;0;2;9;4;2
4157.0;2021;31;MARTINIQUE;MASCULIN;SCOLAIRE;BAC PROFESSIONNEL;BAC PRO SERV;BAC PRO 34303 GEST. POLLUTIONS PROTEC. ENVIRON.;7;7;1;4;2;2;0;3;0;0;0;0;3;4
4160.0;2021;31;MARTINIQUE;MASCULIN;SCOLAIRE;BAC TECHNOLOGIQUE;BAC ST2S;BAC ST2S SCIENCES & TECHNO. SANTE & SOCIAL;28;28;22;0;6;6;0;28;0;0;3;6;19;0
4163.0;2021;31;MARTINIQUE;MASCULIN;SCOLAIRE;BAC TECHNOLOGIQUE;BAC STHR;BAC STHR SC.&TEC. HOTELLERIE-RESTAURATION;8;8;5;0;3;1;2;6;0;0;1;2;3;2
4171.0;2021;31;MARTINIQUE;MASCULIN;SCOLAIRE;BAC TECHNOLOGIQUE;BAC STMG;BAC STMG RESSOURCES HUMAINES ET COMMUNICATION;49;49;44;0;5;5;0;49;0;0;1;15;33;0
4177.0;2021;43;MAYOTTE;FEMININ;INDIVIDUEL;BAC PROFESSIONNEL;BAC PRO PROD;BAC PRO 22106 CUISINE;1;1;0;1;0;0;0;0;0;0;0;0;0;1
4181.0;2021;43;MAYOTTE;FEMININ;INDIVIDUEL;BAC PROFESSIONNEL;BAC PRO SERV;BAC PRO 33002 SERVICES DE PROXIMITE  VIE LOCAL;1;1;0;1;0;0;0;0;0;0;0;0;0;1
4185.0;2021;43;MAYOTTE;FEMININ;INDIVIDUEL;BAC TECHNOLOGIQUE;BAC STMG;BAC STMG GESTION ET FINANCE;2;2;0;2;0;0;0;0;0;0;0;0;0;2
4189.0;2021;43;MAYOTTE;FEMININ;SCOLAIRE;BAC PROFESSIONNEL;BAC PRO PROD;BAC PRO 22003 BIO-INDUSTRIES DE TRANSFORMATION;4;4;2;1;1;1;0;3;0;0;0;0;3;1
4190.0;2021;43;MAYOTTE;FEMININ;SCOLAIRE;BAC PROFESSIONNEL;BAC PRO PROD;BAC PRO 22106 CUISINE;18;18;9;2;7;5;2;14;0;0;0;1;13;4
4192.0;2021;43;MAYOTTE;FEMININ;SCOLAIRE;BAC PROFESSIONNEL;BAC PRO PROD;BAC PRO 23408 Etude et réalisation d'agencement;6;6;2;3;1;0;1;2;0;0;0;1;1;4
4193.0;2021;43;MAYOTTE;FEMININ;SCOLAIRE;BAC PROFESSIONNEL;BAC PRO PROD;BAC PRO 25214 MAINT.VEHIC.OPTA VOIT.PARTICUL.;2;2;1;1;0;0;0;1;0;0;0;1;0;1
4197.0;2021;43;MAYOTTE;FEMININ;SCOLAIRE;BAC PROFESSIONNEL;BAC PRO PROD;BAC PRO AG 21114 CONDUITE PRODUCTIONS HORTICOLES;4;4;4;0;0;0;0;4;0;1;1;0;2;0
4209.0;2021;43;MAYOTTE;FEMININ;SCOLAIRE;BAC PROFESSIONNEL;BAC PRO SERV;BAC PRO 34403 METIERS DE LA SECURITE;10;10;9;0;1;0;1;9;0;0;2;3;4;1
4213.0;2021;43;MAYOTTE;FEMININ;SCOLAIRE;BAC TECHNOLOGIQUE;BAC STHR;BAC STHR SC.&TEC. HOTELLERIE-RESTAURATION;16;16;7;3;6;3;3;10;0;0;1;1;8;6
4218.0;2021;43;MAYOTTE;FEMININ;SCOLAIRE;BAC TECHNOLOGIQUE;BAC STL;BAC STL SCIENCES PHYSIQUES CHIMIQUES  EN LABORAT.;66;66;49;1;16;13;3;62;0;0;4;12;46;4
4221.0;2021;43;MAYOTTE;FEMININ;SCOLAIRE;BAC TECHNOLOGIQUE;BAC STMG;BAC STMG RESSOURCES HUMAINES ET COMMUNICATION;263;263;119;28;116;63;53;182;0;1;3;30;148;81
4223.0;2021;43;MAYOTTE;MASCULIN;APPRENTISSAGE;BAC PROFESSIONNEL;BAC PRO PROD;BAC PRO 25215 MAINT.VEHIC.OPTB VEHIC.TRANS.ROUT;7;7;1;6;0;0;0;1;0;1;0;0;0;6
4230.0;2021;43;MAYOTTE;MASCULIN;INDIVIDUEL;BAC PROFESSIONNEL;BAC PRO SERV;BAC PRO 31202 COMMERCE;2;2;0;2;0;0;0;0;0;0;0;0;0;2
4238.0;2021;43;MAYOTTE;MASCULIN;INDIVIDUEL;BAC TECHNOLOGIQUE;BAC STMG;BAC STMG RESSOURCES HUMAINES ET COMMUNICATION;8;5;0;3;2;1;1;1;0;0;0;0;1;4
4240.0;2021;43;MAYOTTE;MASCULIN;SCOLAIRE;BAC PROFESSIONNEL;BAC PRO PROD;BAC PRO 22003 BIO-INDUSTRIES DE TRANSFORMATION;10;10;3;6;1;1;0;4;0;0;0;2;2;6
4246.0;2021;43;MAYOTTE;MASCULIN;SCOLAIRE;BAC PROFESSIONNEL;BAC PRO PROD;BAC PRO 23203 TECHNICIEN BAT. : ORG.REAL.GROS O;29;29;11;10;8;7;1;18;0;0;0;4;14;11
4252.0;2021;43;MAYOTTE;MASCULIN;SCOLAIRE;BAC PROFESSIONNEL;BAC PRO PROD;BAC PRO 25009 MAINTENANCE NAUTIQUE;20;20;3;15;2;1;1;4;0;0;0;0;4;16
4258.0;2021;43;MAYOTTE;MASCULIN;SCOLAIRE;BAC PROFESSIONNEL;BAC PRO PROD;BAC PRO 25513 SYST.NUM.OPT.A SURETE SECURITE;15;15;9;0;6;5;1;14;0;0;0;3;11;1
4261.0;2021;43;MAYOTTE;MASCULIN;SCOLAIRE;BAC PROFESSIONNEL;BAC PRO PROD;BAC PRO AG 21004 CGEA;13;13;11;2;0;0;0;11;0;0;1;2;8;2
4271.0;2021;43;MAYOTTE;MASCULIN;SCOLAIRE;BAC PROFESSIONNEL;BAC PRO SERV;BAC PRO 33003 ACC.SOINS-S.PERS. OPT.A DOMICILE;3;3;1;1;1;1;0;2;0;0;0;1;1;1
4272.0;2021;43;MAYOTTE;MASCULIN;SCOLAIRE;BAC PROFESSIONNEL;BAC PRO SERV;BAC PRO 33004 ACC.SOINS-S.PERS. OPT.EN STRUCTUR;3;3;3;0;0;0;0;3;0;0;0;3;0;0
4282.0;2021;43;MAYOTTE;MASCULIN;SCOLAIRE;BAC TECHNOLOGIQUE;BAC STI2D;BAC STI2D SYSTÈME D'INFORMATION  ET NUMERIQUE;62;62;54;3;5;4;1;58;0;1;1;17;39;4
4300.0;2021;11;MONTPELLIER;FEMININ;APPRENTISSAGE;BAC PROFESSIONNEL;BAC PRO SERV;BAC PRO 31106 LOGISTIQUE;4;3;3;0;0;0;0;3;0;1;1;1;0;0
4309.0;2021;11;MONTPELLIER;FEMININ;ENSEIGNEMENT A DISTANCE;BAC PROFESSIONNEL;BAC PRO SERV;BAC PRO 31202 COMMERCE;8;5;2;3;0;0;0;2;0;0;0;0;2;3
4310.0;2021;11;MONTPELLIER;FEMININ;ENSEIGNEMENT A DISTANCE;BAC PROFESSIONNEL;BAC PRO SERV;BAC PRO 31210 ACCUEIL -RELATION CLIENTS USAGERS;2;1;1;0;0;0;0;1;0;1;0;0;0;0
4314.0;2021;11;MONTPELLIER;FEMININ;ENSEIGNEMENT A DISTANCE;BAC TECHNOLOGIQUE;BAC STMG;BAC STMG GESTION ET FINANCE;1;1;1;0;0;0;0;1;0;0;0;1;0;0
4319.0;2021;11;MONTPELLIER;FEMININ;FORMATION CONTINUE;BAC PROFESSIONNEL;BAC PRO PROD;BAC PRO AG 21114 CONDUITE PRODUCTIONS HORTICOLES;1;1;1;0;0;0;0;1;0;0;0;0;1;0
4328.0;2021;11;MONTPELLIER;FEMININ;INDIVIDUEL;BAC PROFESSIONNEL;BAC PRO PROD;BAC PRO AG 21113 CGEVV;2;2;2;0;0;0;0;2;0;0;0;0;2;0
4331.0;2021;11;MONTPELLIER;FEMININ;INDIVIDUEL;BAC PROFESSIONNEL;BAC PRO PROD;BAC PRO AG 21302 GEST MILIEUX NATURELS FAUNE;1;0;0;0;0;0;0;0;0;0;0;0;0;0
4335.0;2021;11;MONTPELLIER;FEMININ;INDIVIDUEL;BAC PROFESSIONNEL;BAC PRO SERV;BAC PRO 33003 ACC.SOINS-S.PERS. OPT.A DOMICILE;3;2;2;0;0;0;0;2;0;0;1;1;0;0
4338.0;2021;11;MONTPELLIER;FEMININ;INDIVIDUEL;BAC PROFESSIONNEL;BAC PRO SERV;BAC PRO 33603 ESTHETIQUE COSMETIQUE PARFUMERIE;2;1;1;0;0;0;0;1;0;0;0;0;1;0
4345.0;2021;11;MONTPELLIER;FEMININ;INDIVIDUEL;BAC TECHNOLOGIQUE;BAC STMG;BAC STMG RESSOURCES HUMAINES ET COMMUNICATION;8;3;0;2;1;1;0;1;0;0;0;0;1;2
4358.0;2021;11;MONTPELLIER;FEMININ;SCOLAIRE;BAC PROFESSIONNEL;BAC PRO PROD;BAC PRO 23304 AMENAGEMENT FINITION BATIMENT;4;4;3;1;0;0;0;3;0;0;2;0;1;1
4360.0;2021;11;MONTPELLIER;FEMININ;SCOLAIRE;BAC PROFESSIONNEL;BAC PRO PROD;BAC PRO 23405 TECHNICIEN MENUISIER AGENCEUR;1;1;1;0;0;0;0;1;0;0;1;0;0;0
4375.0;2021;11;MONTPELLIER;FEMININ;SCOLAIRE;BAC PROFESSIONNEL;BAC PRO PROD;BAC PRO 25406 OUVRAGES DU BATIMENT METALLERIE;1;1;1;0;0;0;0;1;0;1;0;0;0;0
4377.0;2021;11;MONTPELLIER;FEMININ;SCOLAIRE;BAC PROFESSIONNEL;BAC PRO PROD;BAC PRO 25510 METIERS ELECT. ENVIRON. CONNECTES;3;3;3;0;0;0;0;3;0;0;1;0;2;0
4384.0;2021;11;MONTPELLIER;FEMININ;SCOLAIRE;BAC PROFESSIONNEL;BAC PRO PROD;BAC PRO AG 21204 PROD-AQUACOLES;1;1;1;0;0;0;0;1;0;0;1;0;0;0
4386.0;2021;11;MONTPELLIER;FEMININ;SCOLAIRE;BAC PROFESSIONNEL;BAC PRO PROD;BAC PRO AG 21211 COND GEST ENTR HIPPIQUE;47;47;43;4;0;0;0;43;0;2;8;14;19;4
4389.0;2021;11;MONTPELLIER;FEMININ;SCOLAIRE;BAC PROFESSIONNEL;BAC PRO PROD;BAC PRO AG 22105 LABORATOIRE CONTROLE QUALITE;16;15;15;0;0;0;0;15;0;0;0;7;8;0
4394.0;2021;11;MONTPELLIER;FEMININ;SCOLAIRE;BAC PROFESSIONNEL;BAC PRO SERV;BAC PRO 31108 TRANSPORT;3;3;2;0;1;1;0;3;0;1;1;0;1;0
4401.0;2021;11;MONTPELLIER;FEMININ;SCOLAIRE;BAC PROFESSIONNEL;BAC PRO SERV;BAC PRO 32304 PHOTOGRAPHIE;8;8;7;0;1;1;0;8;0;0;2;1;5;0
4402.0;2021;11;MONTPELLIER;FEMININ;SCOLAIRE;BAC PROFESSIONNEL;BAC PRO SERV;BAC PRO 33002 SERVICES DE PROXIMITE  VIE LOCAL;74;74;69;1;4;0;4;69;0;1;14;39;15;5
4407.0;2021;11;MONTPELLIER;FEMININ;SCOLAIRE;BAC PROFESSIONNEL;BAC PRO SERV;BAC PRO 33403 COMMERC. SERVICES EN RESTAURATION;77;76;64;7;5;3;2;67;0;1;10;19;37;9
4409.0;2021;11;MONTPELLIER;FEMININ;SCOLAIRE;BAC PROFESSIONNEL;BAC PRO SERV;BAC PRO 34304 HYGIENE PROPRETE STERILISATION;6;6;2;3;1;1;0;3;0;0;0;0;3;3
4413.0;2021;11;MONTPELLIER;FEMININ;SCOLAIRE;BAC TECHNOLOGIQUE;BAC S2TMD;BAC S2TMD MUSIQUE;3;3;2;1;0;0;0;2;0;2;0;0;0;1
4414.0;2021;11;MONTPELLIER;FEMININ;SCOLAIRE;BAC TECHNOLOGIQUE;BAC ST2S;BAC ST2S SCIENCES & TECHNO. SANTE & SOCIAL;800;800;742;17;41;26;15;768;1;17;173;314;263;32
4415.0;2021;11;MONTPELLIER;FEMININ;SCOLAIRE;BAC TECHNOLOGIQUE;BAC STAV;BAC STAV AGRONOMIE ALIM ENV TERRITOI;100;100;100;0;0;0;0;100;0;3;19;49;29;0
4417.0;2021;11;MONTPELLIER;FEMININ;SCOLAIRE;BAC TECHNOLOGIQUE;BAC STHR;BAC STHR SC.&TEC. HOTELLERIE-RESTAURATION;43;43;40;1;2;2;0;42;0;1;12;19;10;1
4423.0;2021;11;MONTPELLIER;FEMININ;SCOLAIRE;BAC TECHNOLOGIQUE;BAC STL;BAC STL SCIENCES PHYSIQUES CHIMIQUES  EN LABORAT.;53;53;49;0;4;2;2;51;0;2;11;18;20;2
4429.0;2021;11;MONTPELLIER;MASCULIN;APPRENTISSAGE;BAC PROFESSIONNEL;BAC PRO PROD;BAC PRO 22004 PROC. CHIMIE EAU PAPIERS-CARTONS;8;8;8;0;0;0;0;8;0;2;4;2;0;0
4430.0;2021;11;MONTPELLIER;MASCULIN;APPRENTISSAGE;BAC PROFESSIONNEL;BAC PRO PROD;BAC PRO 22106 CUISINE;6;6;4;2;0;0;0;4;0;0;0;2;2;2
4431.0;2021;11;MONTPELLIER;MASCULIN;APPRENTISSAGE;BAC PROFESSIONNEL;BAC PRO PROD;BAC PRO 22703 TECHN.INSTALL.SYST.ENERG.CLIMATI;15;15;14;1;0;0;0;14;0;1;4;7;2;1
4435.0;2021;11;MONTPELLIER;MASCULIN;APPRENTISSAGE;BAC PROFESSIONNEL;BAC PRO PROD;BAC PRO 23405 TECHNICIEN MENUISIER AGENCEUR;5;5;4;1;0;0;0;4;0;0;2;1;1;1
4438.0;2021;11;MONTPELLIER;MASCULIN;APPRENTISSAGE;BAC PROFESSIONNEL;BAC PRO PROD;BAC PRO 25106 TECHNICIEN D'USINAGE;6;6;6;0;0;0;0;6;0;0;3;2;1;0
4440.0;2021;11;MONTPELLIER;MASCULIN;APPRENTISSAGE;BAC PROFESSIONNEL;BAC PRO PROD;BAC PRO 25215 MAINT.VEHIC.OPTB VEHIC.TRANS.ROUT;11;10;9;1;0;0;0;9;0;0;3;5;1;1
4447.0;2021;11;MONTPELLIER;MASCULIN;APPRENTISSAGE;BAC PROFESSIONNEL;BAC PRO PROD;BAC PRO 25411 TECH.CHAUDRONNERIE INDUSTRIELLE;24;24;23;1;0;0;0;23;0;1;4;11;7;1
4461.0;2021;11;MONTPELLIER;MASCULIN;APPRENTISSAGE;BAC PROFESSIONNEL;BAC PRO SERV;BAC PRO 31210 ACCUEIL -RELATION CLIENTS USAGERS;1;1;1;0;0;0;0;1;0;0;0;1;0;0
4462.0;2021;11;MONTPELLIER;MASCULIN;APPRENTISSAGE;BAC PROFESSIONNEL;BAC PRO SERV;BAC PRO 33101 OPTIQUE LUNETTERIE;6;6;6;0;0;0;0;6;0;1;2;3;0;0
4465.0;2021;11;MONTPELLIER;MASCULIN;ENSEIGNEMENT A DISTANCE;BAC GENERAL;BAC GENERAL;BAC GENE 10019 BAC GENERAL;41;39;37;1;1;0;1;37;0;5;19;9;4;2
4466.0;2021;11;MONTPELLIER;MASCULIN;ENSEIGNEMENT A DISTANCE;BAC PROFESSIONNEL;BAC PRO SERV;BAC PRO 30001 GESTION-ADMINISTRATION;1;1;1;0;0;0;0;1;0;0;1;0;0;0
4467.0;2021;11;MONTPELLIER;MASCULIN;ENSEIGNEMENT A DISTANCE;BAC PROFESSIONNEL;BAC PRO SERV;BAC PRO 31202 COMMERCE;1;1;1;0;0;0;0;1;0;0;0;1;0;0
4468.0;2021;11;MONTPELLIER;MASCULIN;ENSEIGNEMENT A DISTANCE;BAC PROFESSIONNEL;BAC PRO SERV;BAC PRO 31206 VENTE (PROSPECT.NEGO.SUIV.CLIENT;2;1;1;0;0;0;0;1;0;0;0;1;0;0
4471.0;2021;11;MONTPELLIER;MASCULIN;ENSEIGNEMENT A DISTANCE;BAC TECHNOLOGIQUE;BAC STMG;BAC STMG GESTION ET FINANCE;4;4;4;0;0;0;0;4;0;0;2;0;2;0
4474.0;2021;11;MONTPELLIER;MASCULIN;FORMATION CONTINUE;BAC PROFESSIONNEL;BAC PRO PROD;BAC PRO 20102 PILOTE DE LIGNE DE PRODUCTION;3;3;3;0;0;0;0;3;0;1;1;1;0;0
4477.0;2021;11;MONTPELLIER;MASCULIN;FORMATION CONTINUE;BAC PROFESSIONNEL;BAC PRO PROD;BAC PRO 23303 MENUISERIE ALUMINIUM-VERRE;1;1;1;0;0;0;0;1;0;0;0;0;1;0
4481.0;2021;11;MONTPELLIER;MASCULIN;FORMATION CONTINUE;BAC PROFESSIONNEL;BAC PRO PROD;BAC PRO 25216 MAINT.VEHIC.OPTC MOTOCYCLES;1;1;1;0;0;0;0;1;0;0;1;0;0;0
4484.0;2021;11;MONTPELLIER;MASCULIN;FORMATION CONTINUE;BAC PROFESSIONNEL;BAC PRO PROD;BAC PRO AG 21114 CONDUITE PRODUCTIONS HORTICOLES;3;2;2;0;0;0;0;2;0;1;0;1;0;0
4492.0;2021;11;MONTPELLIER;MASCULIN;INDIVIDUEL;BAC PROFESSIONNEL;BAC PRO PROD;BAC PRO 25007 MAINTENANCE EQUIPEMENTS INDUST.;1;0;0;0;0;0;0;0;0;0;0;0;0;0
4505.0;2021;11;MONTPELLIER;MASCULIN;INDIVIDUEL;BAC PROFESSIONNEL;BAC PRO SERV;BAC PRO 33004 ACC.SOINS-S.PERS. OPT.EN STRUCTUR;1;0;0;0;0;0;0;0;0;0;0;0;0;0
4515.0;2021;11;MONTPELLIER;MASCULIN;INDIVIDUEL;BAC TECHNOLOGIQUE;BAC STI2D;BAC STI2D SYSTÈME D'INFORMATION  ET NUMERIQUE;3;1;1;0;0;0;0;1;0;0;0;0;1;0
4518.0;2021;11;MONTPELLIER;MASCULIN;INDIVIDUEL;BAC TECHNOLOGIQUE;BAC STMG;BAC STMG RESSOURCES HUMAINES ET COMMUNICATION;7;3;1;1;1;0;1;1;0;0;0;0;1;2
4519.0;2021;11;MONTPELLIER;MASCULIN;INDIVIDUEL;BAC TECHNOLOGIQUE;BAC STMG;BAC STMG SYSTEMES D'INFORMATION DE GESTION;2;0;0;0;0;0;0;0;0;0;0;0;0;0
4521.0;2021;11;MONTPELLIER;MASCULIN;SCOLAIRE;BAC PROFESSIONNEL;BAC PRO PROD;BACPRO 20002 ETUD.DEFINITION PRDTS INDUSTRIEL;23;23;19;4;0;0;0;19;0;0;3;5;11;4
4527.0;2021;11;MONTPELLIER;MASCULIN;SCOLAIRE;BAC PROFESSIONNEL;BAC PRO PROD;BAC PRO 22403 ARTS.& MET.ART:MET.ENSEIGN SIGNA;9;9;9;0;0;0;0;9;0;0;3;4;2;0
4530.0;2021;11;MONTPELLIER;MASCULIN;SCOLAIRE;BAC PROFESSIONNEL;BAC PRO PROD;BAC PRO 22704 TECHN. MAINT. SYST.ENERG.CLIMATI;56;56;36;13;7;4;3;40;0;2;4;13;21;16
4536.0;2021;11;MONTPELLIER;MASCULIN;SCOLAIRE;BAC PROFESSIONNEL;BAC PRO PROD;BAC PRO 23203 TECHNICIEN BAT. : ORG.REAL.GROS O;14;13;11;2;0;0;0;11;0;0;0;5;6;2
4546.0;2021;11;MONTPELLIER;MASCULIN;SCOLAIRE;BAC PROFESSIONNEL;BAC PRO PROD;BAC PRO 24302 METIERS DU CUIR : MAROQUINERIE;1;1;1;0;0;0;0;1;0;0;1;0;0;0
4548.0;2021;11;MONTPELLIER;MASCULIN;SCOLAIRE;BAC PROFESSIONNEL;BAC PRO PROD;BAC PRO 25006 MICROTECHNIQUES;14;13;7;6;0;0;0;7;0;0;0;4;3;6
4554.0;2021;11;MONTPELLIER;MASCULIN;SCOLAIRE;BAC PROFESSIONNEL;BAC PRO PROD;BAC PRO 25216 MAINT.VEHIC.OPTC MOTOCYCLES;50;50;44;5;1;1;0;45;0;4;9;18;14;5
4557.0;2021;11;MONTPELLIER;MASCULIN;SCOLAIRE;BAC PROFESSIONNEL;BAC PRO PROD;BAC PRO 25302 AERONAUTIQUE OPTION AVIONIQUE;12;12;12;0;0;0;0;12;0;1;5;6;0;0
4561.0;2021;11;MONTPELLIER;MASCULIN;SCOLAIRE;BAC PROFESSIONNEL;BAC PRO PROD;BAC PRO 25411 TECH.CHAUDRONNERIE INDUSTRIELLE;60;60;44;13;3;3;0;47;0;6;6;17;18;13
4570.0;2021;11;MONTPELLIER;MASCULIN;SCOLAIRE;BAC PROFESSIONNEL;BAC PRO PROD;BAC PRO AG 21114 CONDUITE PRODUCTIONS HORTICOLES;31;30;27;3;0;0;0;27;0;0;2;10;15;3
4571.0;2021;11;MONTPELLIER;MASCULIN;SCOLAIRE;BAC PROFESSIONNEL;BAC PRO PROD;BAC PRO AG 21203 TECHN CONSEIL DE VENTE ANIMAL;12;12;12;0;0;0;0;12;0;0;2;6;4;0
4572.0;2021;11;MONTPELLIER;MASCULIN;SCOLAIRE;BAC PROFESSIONNEL;BAC PRO PROD;BAC PRO AG 21204 PROD-AQUACOLES;10;10;6;4;0;0;0;6;0;0;1;1;4;4
4573.0;2021;11;MONTPELLIER;MASCULIN;SCOLAIRE;BAC PROFESSIONNEL;BAC PRO PROD;BAC PRO AG 21210 COND GEST ENTR CANIN ET FELIN;9;8;8;0;0;0;0;8;0;0;0;5;3;0
4589.0;2021;11;MONTPELLIER;MASCULIN;SCOLAIRE;BAC PROFESSIONNEL;BAC PRO SERV;BAC PRO 32208 REAL.PR.IMPR.PLURI.OPTB.PR.IMPR.;7;7;7;0;0;0;0;7;0;0;2;2;3;0
4594.0;2021;11;MONTPELLIER;MASCULIN;SCOLAIRE;BAC PROFESSIONNEL;BAC PRO SERV;BAC PRO 33004 ACC.SOINS-S.PERS. OPT.EN STRUCTUR;54;54;47;5;2;1;1;48;0;1;11;23;13;6
4598.0;2021;11;MONTPELLIER;MASCULIN;SCOLAIRE;BAC PROFESSIONNEL;BAC PRO SERV;BAC PRO 34304 HYGIENE PROPRETE STERILISATION;4;4;4;0;0;0;0;4;0;0;0;1;3;0
4604.0;2021;11;MONTPELLIER;MASCULIN;SCOLAIRE;BAC TECHNOLOGIQUE;BAC STD2A;BAC STD2A SCIENCES & TECHNO. DESIGN-ARTS APPLIQUES;29;29;29;0;0;0;0;29;0;3;4;18;4;0
4609.0;2021;11;MONTPELLIER;MASCULIN;SCOLAIRE;BAC TECHNOLOGIQUE;BAC STI2D;BAC STI2D SYSTÈME D'INFORMATION  ET NUMERIQUE;333;333;299;10;24;16;8;315;0;10;43;129;133;18
4613.0;2021;11;MONTPELLIER;MASCULIN;SCOLAIRE;BAC TECHNOLOGIQUE;BAC STMG;BAC STMG MERCATIQUE (MARKETING);734;733;639;26;68;47;21;686;0;11;59;272;344;47
4614.0;2021;11;MONTPELLIER;MASCULIN;SCOLAIRE;BAC TECHNOLOGIQUE;BAC STMG;BAC STMG RESSOURCES HUMAINES ET COMMUNICATION;265;265;218;10;37;24;13;242;0;1;18;66;157;23
4622.0;2021;12;NANCY-METZ;FEMININ;APPRENTISSAGE;BAC PROFESSIONNEL;BAC PRO PROD;BAC PRO 25302 AERONAUTIQUE OPTION AVIONIQUE;1;1;1;0;0;0;0;1;0;0;0;1;0;0
4624.0;2021;12;NANCY-METZ;FEMININ;APPRENTISSAGE;BAC PROFESSIONNEL;BAC PRO PROD;BAC PRO 25408 REPARATION DES CARROSSERIES;1;1;1;0;0;0;0;1;0;0;0;1;0;0
4646.0;2021;12;NANCY-METZ;FEMININ;FORMATION CONTINUE;BAC PROFESSIONNEL;BAC PRO PROD;BAC PRO 24203 METIERS DE LA MODE - VÊTEMENT;1;1;1;0;0;0;0;1;0;1;0;0;0;0
4652.0;2021;12;NANCY-METZ;FEMININ;FORMATION CONTINUE;BAC PROFESSIONNEL;BAC PRO SERV;BAC PRO 31106 LOGISTIQUE;3;3;3;0;0;0;0;3;0;1;1;1;0;0
4653.0;2021;12;NANCY-METZ;FEMININ;FORMATION CONTINUE;BAC PROFESSIONNEL;BAC PRO SERV;BAC PRO 31202 COMMERCE;13;12;11;0;1;1;0;12;0;4;1;5;2;0
4661.0;2021;12;NANCY-METZ;FEMININ;INDIVIDUEL;BAC PROFESSIONNEL;BAC PRO PROD;BAC PRO 23005 TECHN. ETUDES BAT B ASSIST.ARCHI.;1;1;1;0;0;0;0;1;0;0;0;0;1;0
4663.0;2021;12;NANCY-METZ;FEMININ;INDIVIDUEL;BAC PROFESSIONNEL;BAC PRO PROD;BAC PRO AG 21004 CGEA;2;2;1;1;0;0;0;1;0;0;0;0;1;1
4666.0;2021;12;NANCY-METZ;FEMININ;INDIVIDUEL;BAC PROFESSIONNEL;BAC PRO SERV;BAC PRO 31202 COMMERCE;8;1;0;1;0;0;0;0;0;0;0;0;0;1
4668.0;2021;12;NANCY-METZ;FEMININ;INDIVIDUEL;BAC PROFESSIONNEL;BAC PRO SERV;BAC PRO 31210 ACCUEIL -RELATION CLIENTS USAGERS;1;1;0;1;0;0;0;0;0;0;0;0;0;1
4671.0;2021;12;NANCY-METZ;FEMININ;INDIVIDUEL;BAC PROFESSIONNEL;BAC PRO SERV;BAC PRO 33603 ESTHETIQUE COSMETIQUE PARFUMERIE;1;1;0;1;0;0;0;0;0;0;0;0;0;1
4675.0;2021;12;NANCY-METZ;FEMININ;INDIVIDUEL;BAC TECHNOLOGIQUE;BAC STMG;BAC STMG GESTION ET FINANCE;1;1;0;1;0;0;0;0;0;0;0;0;0;1
4677.0;2021;12;NANCY-METZ;FEMININ;INDIVIDUEL;BAC TECHNOLOGIQUE;BAC STMG;BAC STMG RESSOURCES HUMAINES ET COMMUNICATION;5;4;2;2;0;0;0;2;0;0;0;0;2;2
4678.0;2021;12;NANCY-METZ;FEMININ;INDIVIDUEL;BAC TECHNOLOGIQUE;BAC STMG;BAC STMG SYSTEMES D'INFORMATION DE GESTION;2;1;0;0;1;1;0;1;0;0;0;0;1;0
4688.0;2021;12;NANCY-METZ;FEMININ;SCOLAIRE;BAC PROFESSIONNEL;BAC PRO PROD;BAC PRO 23005 TECHN. ETUDES BAT B ASSIST.ARCHI.;14;14;10;3;1;1;0;11;0;0;3;7;1;3
4695.0;2021;12;NANCY-METZ;FEMININ;SCOLAIRE;BAC PROFESSIONNEL;BAC PRO PROD;BAC PRO 24203 METIERS DE LA MODE - VÊTEMENT;63;63;54;7;2;2;0;56;0;4;18;18;16;7
4700.0;2021;12;NANCY-METZ;FEMININ;SCOLAIRE;BAC PROFESSIONNEL;BAC PRO PROD;BAC PRO 25302 AERONAUTIQUE OPTION AVIONIQUE;1;1;1;0;0;0;0;1;0;0;1;0;0;0
4716.0;2021;12;NANCY-METZ;FEMININ;SCOLAIRE;BAC PROFESSIONNEL;BAC PRO PROD;BAC PRO AG 22107 TEC CONS VTE ALIMENTATION P.ALIM;3;3;3;0;0;0;0;3;0;0;1;0;2;0
4717.0;2021;12;NANCY-METZ;FEMININ;SCOLAIRE;BAC PROFESSIONNEL;BAC PRO SERV;BAC PRO 30001 GESTION-ADMINISTRATION;520;516;407;69;40;25;15;432;0;21;85;169;157;84
4739.0;2021;12;NANCY-METZ;FEMININ;SCOLAIRE;BAC TECHNOLOGIQUE;BAC S2TMD;BAC S2TMD MUSIQUE;10;10;10;0;0;0;0;10;0;2;6;2;0;0
4742.0;2021;12;NANCY-METZ;FEMININ;SCOLAIRE;BAC TECHNOLOGIQUE;BAC STD2A;BAC STD2A SCIENCES & TECHNO. DESIGN-ARTS APPLIQUES;87;87;87;0;0;0;0;87;1;16;32;32;6;0
4750.0;2021;12;NANCY-METZ;FEMININ;SCOLAIRE;BAC TECHNOLOGIQUE;BAC STMG;BAC STMG GESTION ET FINANCE;264;264;251;4;9;5;4;256;1;13;46;110;86;8
4768.0;2021;12;NANCY-METZ;MASCULIN;APPRENTISSAGE;BAC PROFESSIONNEL;BAC PRO PROD;BAC PRO 25106 TECHNICIEN D'USINAGE;21;20;17;1;2;2;0;19;0;2;3;8;6;1
4771.0;2021;12;NANCY-METZ;MASCULIN;APPRENTISSAGE;BAC PROFESSIONNEL;BAC PRO PROD;BAC PRO 25215 MAINT.VEHIC.OPTB VEHIC.TRANS.ROUT;14;14;11;3;0;0;0;11;0;0;1;4;6;3
4775.0;2021;12;NANCY-METZ;MASCULIN;APPRENTISSAGE;BAC PROFESSIONNEL;BAC PRO PROD;BAC PRO 25221 MAINT.MATERIELS OPT.C ESP. VERTS;3;3;3;0;0;0;0;3;0;0;1;1;1;0
4777.0;2021;12;NANCY-METZ;MASCULIN;APPRENTISSAGE;BAC PROFESSIONNEL;BAC PRO PROD;BAC PRO 25303 AERONAUTIQUE OPTION SYSTEMES;7;7;7;0;0;0;0;7;0;3;2;1;1;0
4782.0;2021;12;NANCY-METZ;MASCULIN;APPRENTISSAGE;BAC PROFESSIONNEL;BAC PRO PROD;BAC PRO 25510 METIERS ELECT. ENVIRON. CONNECTES;70;69;58;8;3;0;3;58;0;6;16;20;16;11
4784.0;2021;12;NANCY-METZ;MASCULIN;APPRENTISSAGE;BAC PROFESSIONNEL;BAC PRO PROD;BAC PRO AG 21004 CGEA;42;41;35;6;0;0;0;35;0;1;3;13;18;6
4785.0;2021;12;NANCY-METZ;MASCULIN;APPRENTISSAGE;BAC PROFESSIONNEL;BAC PRO PROD;BAC PRO AG 21203 TECHN CONSEIL DE VENTE ANIMAL;1;1;1;0;0;0;0;1;0;0;0;0;1;0
4790.0;2021;12;NANCY-METZ;MASCULIN;APPRENTISSAGE;BAC PROFESSIONNEL;BAC PRO SERV;BAC PRO 30001 GESTION-ADMINISTRATION;5;5;5;0;0;0;0;5;0;2;1;2;0;0
4793.0;2021;12;NANCY-METZ;MASCULIN;APPRENTISSAGE;BAC PROFESSIONNEL;BAC PRO SERV;BAC PRO 31206 VENTE (PROSPECT.NEGO.SUIV.CLIENT;2;2;1;1;0;0;0;1;0;0;0;0;1;1
4795.0;2021;12;NANCY-METZ;MASCULIN;APPRENTISSAGE;BAC PROFESSIONNEL;BAC PRO SERV;BAC PRO 32207 REAL.PR.IMPR.PLURI.OPTA.PR.GRAPH.;1;1;1;0;0;0;0;1;0;0;1;0;0;0
4799.0;2021;12;NANCY-METZ;MASCULIN;ENSEIGNEMENT A DISTANCE;BAC TECHNOLOGIQUE;BAC STMG;BAC STMG MERCATIQUE (MARKETING);2;2;2;0;0;0;0;2;0;0;1;1;0;0
4803.0;2021;12;NANCY-METZ;MASCULIN;FORMATION CONTINUE;BAC PROFESSIONNEL;BAC PRO PROD;BAC PRO 22704 TECHN. MAINT. SYST.ENERG.CLIMATI;11;11;11;0;0;0;0;11;0;4;6;0;1;0
4804.0;2021;12;NANCY-METZ;MASCULIN;FORMATION CONTINUE;BAC PROFESSIONNEL;BAC PRO PROD;BAC PRO 23004 TECHN. ETUDES BAT.A ETUDES & ECO.;5;5;4;0;1;1;0;5;0;0;2;1;2;0
4810.0;2021;12;NANCY-METZ;MASCULIN;FORMATION CONTINUE;BAC PROFESSIONNEL;BAC PRO PROD;BAC PRO 25408 REPARATION DES CARROSSERIES;4;3;3;0;0;0;0;3;0;2;1;0;0;0
4812.0;2021;12;NANCY-METZ;MASCULIN;FORMATION CONTINUE;BAC PROFESSIONNEL;BAC PRO PROD;BAC PRO 25510 METIERS ELECT. ENVIRON. CONNECTES;1;0;0;0;0;0;0;0;0;0;0;0;0;0
4813.0;2021;12;NANCY-METZ;MASCULIN;FORMATION CONTINUE;BAC PROFESSIONNEL;BAC PRO PROD;BAC PRO 25515 SYST.NUM.OPT.C RES.INF.SYST.COMM.;12;12;9;2;1;1;0;10;0;2;1;5;2;2
4826.0;2021;12;NANCY-METZ;MASCULIN;INDIVIDUEL;BAC PROFESSIONNEL;BAC PRO PROD;BAC PRO 23005 TECHN. ETUDES BAT B ASSIST.ARCHI.;1;1;1;0;0;0;0;1;0;0;0;0;1;0
4830.0;2021;12;NANCY-METZ;MASCULIN;INDIVIDUEL;BAC PROFESSIONNEL;BAC PRO PROD;BAC PRO 25513 SYST.NUM.OPT.A SURETE SECURITE;1;1;0;0;1;1;0;1;0;0;0;0;1;0
4833.0;2021;12;NANCY-METZ;MASCULIN;INDIVIDUEL;BAC PROFESSIONNEL;BAC PRO SERV;BAC PRO 30001 GESTION-ADMINISTRATION;3;2;0;2;0;0;0;0;0;0;0;0;0;2
4840.0;2021;12;NANCY-METZ;MASCULIN;INDIVIDUEL;BAC TECHNOLOGIQUE;BAC ST2S;BAC ST2S SCIENCES & TECHNO. SANTE & SOCIAL;2;2;0;0;2;2;0;2;0;0;0;0;2;0
4842.0;2021;12;NANCY-METZ;MASCULIN;INDIVIDUEL;BAC TECHNOLOGIQUE;BAC STI2D;BAC STI2D ENERGIES  ET ENVIRONNEMENT;2;2;2;0;0;0;0;2;0;0;0;2;0;0
4853.0;2021;12;NANCY-METZ;MASCULIN;SCOLAIRE;BAC PROFESSIONNEL;BAC PRO PROD;BAC PRO 22106 CUISINE;143;143;124;14;5;3;2;127;0;6;37;53;31;16
4855.0;2021;12;NANCY-METZ;MASCULIN;SCOLAIRE;BAC PROFESSIONNEL;BAC PRO PROD;BAC PRO 22403 ARTS.& MET.ART:MET.ENSEIGN SIGNA;8;8;7;1;0;0;0;7;0;0;2;2;3;1
4857.0;2021;12;NANCY-METZ;MASCULIN;SCOLAIRE;BAC PROFESSIONNEL;BAC PRO PROD;BAC PRO 22703 TECHN.INSTALL.SYST.ENERG.CLIMATI;35;32;22;6;4;3;1;25;0;0;2;8;15;7
4869.0;2021;12;NANCY-METZ;MASCULIN;SCOLAIRE;BAC PROFESSIONNEL;BAC PRO PROD;BAC PRO 23406 TECHNICIEN DE SCIERIE;2;2;2;0;0;0;0;2;0;0;2;0;0;0
4873.0;2021;12;NANCY-METZ;MASCULIN;SCOLAIRE;BAC PROFESSIONNEL;BAC PRO PROD;BAC PRO 25007 MAINTENANCE EQUIPEMENTS INDUST.;217;216;171;31;14;7;7;178;0;9;35;69;65;38
4874.0;2021;12;NANCY-METZ;MASCULIN;SCOLAIRE;BAC PROFESSIONNEL;BAC PRO PROD;BAC PRO 25106 TECHNICIEN D'USINAGE;81;79;60;14;5;3;2;63;0;1;9;21;32;16
4876.0;2021;12;NANCY-METZ;MASCULIN;SCOLAIRE;BAC PROFESSIONNEL;BAC PRO PROD;BAC PRO 25214 MAINT.VEHIC.OPTA VOIT.PARTICUL.;231;231;183;39;9;4;5;187;0;12;41;68;66;44
4877.0;2021;12;NANCY-METZ;MASCULIN;SCOLAIRE;BAC PROFESSIONNEL;BAC PRO PROD;BAC PRO 25215 MAINT.VEHIC.OPTB VEHIC.TRANS.ROUT;21;20;18;2;0;0;0;18;0;0;3;8;7;2
4878.0;2021;12;NANCY-METZ;MASCULIN;SCOLAIRE;BAC PROFESSIONNEL;BAC PRO PROD;BAC PRO 25216 MAINT.VEHIC.OPTC MOTOCYCLES;28;27;23;3;1;0;1;23;0;5;9;5;4;4
4887.0;2021;12;NANCY-METZ;MASCULIN;SCOLAIRE;BAC PROFESSIONNEL;BAC PRO PROD;BAC PRO 25411 TECH.CHAUDRONNERIE INDUSTRIELLE;79;78;58;10;10;8;2;66;0;5;9;23;29;12
4891.0;2021;12;NANCY-METZ;MASCULIN;SCOLAIRE;BAC PROFESSIONNEL;BAC PRO PROD;BAC PRO 25514 SYST.NUM.OPT.B AUD.RES.EQUIP.DOM.;66;66;57;8;1;1;0;58;0;2;11;27;18;8
4905.0;2021;12;NANCY-METZ;MASCULIN;SCOLAIRE;BAC PROFESSIONNEL;BAC PRO SERV;BAC PRO 31108 TRANSPORT;30;30;27;2;1;1;0;28;0;3;8;5;12;2
4908.0;2021;12;NANCY-METZ;MASCULIN;SCOLAIRE;BAC PROFESSIONNEL;BAC PRO SERV;BAC PRO 31210 ACCUEIL -RELATION CLIENTS USAGERS;34;34;31;2;1;0;1;31;0;1;8;14;8;3
4909.0;2021;12;NANCY-METZ;MASCULIN;SCOLAIRE;BAC PROFESSIONNEL;BAC PRO SERV;BAC PRO 32207 REAL.PR.IMPR.PLURI.OPTA.PR.GRAPH.;18;18;16;1;1;1;0;17;0;0;2;6;9;1
4910.0;2021;12;NANCY-METZ;MASCULIN;SCOLAIRE;BAC PROFESSIONNEL;BAC PRO SERV;BAC PRO 32208 REAL.PR.IMPR.PLURI.OPTB.PR.IMPR.;6;6;5;0;1;1;0;6;0;0;0;2;4;0
4912.0;2021;12;NANCY-METZ;MASCULIN;SCOLAIRE;BAC PROFESSIONNEL;BAC PRO SERV;BAC PRO 32304 PHOTOGRAPHIE;3;3;3;0;0;0;0;3;0;0;1;2;0;0
4914.0;2021;12;NANCY-METZ;MASCULIN;SCOLAIRE;BAC PROFESSIONNEL;BAC PRO SERV;BAC PRO 33003 ACC.SOINS-S.PERS. OPT.A DOMICILE;11;11;10;1;0;0;0;10;0;0;5;1;4;1
4917.0;2021;12;NANCY-METZ;MASCULIN;SCOLAIRE;BAC PROFESSIONNEL;BAC PRO SERV;BAC PRO 33102 PROTHESE DENTAIRE;7;7;7;0;0;0;0;7;0;0;2;2;3;0
4929.0;2021;12;NANCY-METZ;MASCULIN;SCOLAIRE;BAC TECHNOLOGIQUE;BAC STI2D;BAC STI2D ENERGIES  ET ENVIRONNEMENT;198;198;179;3;16;13;3;192;0;7;21;77;87;6
4934.0;2021;12;NANCY-METZ;MASCULIN;SCOLAIRE;BAC TECHNOLOGIQUE;BAC STMG;BAC STMG GESTION ET FINANCE;327;327;286;13;28;11;17;297;0;4;37;117;139;30
4936.0;2021;12;NANCY-METZ;MASCULIN;SCOLAIRE;BAC TECHNOLOGIQUE;BAC STMG;BAC STMG RESSOURCES HUMAINES ET COMMUNICATION;185;185;147;9;29;19;10;166;0;0;10;61;95;19
4948.0;2021;17;NANTES;FEMININ;APPRENTISSAGE;BAC PROFESSIONNEL;BAC PRO PROD;BAC PRO 25214 MAINT.VEHIC.OPTA VOIT.PARTICUL.;10;10;10;0;0;0;0;10;0;5;2;3;0;0
4950.0;2021;17;NANTES;FEMININ;APPRENTISSAGE;BAC PROFESSIONNEL;BAC PRO PROD;BAC PRO 25219 MAINT.MATERIELS OPT.A AGRICOLES;1;1;0;1;0;0;0;0;0;0;0;0;0;1
4955.0;2021;17;NANTES;FEMININ;APPRENTISSAGE;BAC PROFESSIONNEL;BAC PRO PROD;BAC PRO 25411 TECH.CHAUDRONNERIE INDUSTRIELLE;5;5;5;0;0;0;0;5;0;0;1;2;2;0
4957.0;2021;17;NANTES;FEMININ;APPRENTISSAGE;BAC PROFESSIONNEL;BAC PRO PROD;BAC PRO 25515 SYST.NUM.OPT.C RES.INF.SYST.COMM.;1;1;1;0;0;0;0;1;0;0;0;0;1;0
4965.0;2021;17;NANTES;FEMININ;APPRENTISSAGE;BAC PROFESSIONNEL;BAC PRO PROD;BAC PRO AG 22107 TEC CONS VTE ALIMENTATION P.ALIM;2;2;2;0;0;0;0;2;0;0;0;0;2;0
4971.0;2021;17;NANTES;FEMININ;APPRENTISSAGE;BAC PROFESSIONNEL;BAC PRO SERV;BAC PRO 32207 REAL.PR.IMPR.PLURI.OPTA.PR.GRAPH.;6;6;5;1;0;0;0;5;0;2;1;0;2;1
4977.0;2021;17;NANTES;FEMININ;ENSEIGNEMENT A DISTANCE;BAC GENERAL;BAC GENERAL;BAC GENE 10019 BAC GENERAL;59;56;53;1;2;1;1;54;1;6;21;15;11;2
4981.0;2021;17;NANTES;FEMININ;ENSEIGNEMENT A DISTANCE;BAC TECHNOLOGIQUE;BAC STMG;BAC STMG MERCATIQUE (MARKETING);4;4;4;0;0;0;0;4;0;0;3;1;0;0
4984.0;2021;17;NANTES;FEMININ;FORMATION CONTINUE;BAC PROFESSIONNEL;BAC PRO PROD;BAC PRO 22003 BIO-INDUSTRIES DE TRANSFORMATION;1;1;1;0;0;0;0;1;0;0;1;0;0;0
4987.0;2021;17;NANTES;FEMININ;FORMATION CONTINUE;BAC PROFESSIONNEL;BAC PRO PROD;BAC PRO 24302 METIERS DU CUIR : MAROQUINERIE;1;1;1;0;0;0;0;1;0;0;0;0;1;0
4995.0;2021;17;NANTES;FEMININ;INDIVIDUEL;BAC GENERAL;BAC GENERAL;BAC GENE 10019 BAC GENERAL;114;93;60;24;9;4;5;64;0;4;5;20;35;29
4999.0;2021;17;NANTES;FEMININ;INDIVIDUEL;BAC PROFESSIONNEL;BAC PRO PROD;BAC PRO AG 21113 CGEVV;1;0;0;0;0;0;0;0;0;0;0;0;0;0
5011.0;2021;17;NANTES;FEMININ;INDIVIDUEL;BAC TECHNOLOGIQUE;BAC ST2S;BAC ST2S SCIENCES & TECHNO. SANTE & SOCIAL;5;3;0;2;1;1;0;1;0;0;0;0;1;2
5017.0;2021;17;NANTES;FEMININ;SCOLAIRE;BAC PROFESSIONNEL;BAC PRO PROD;BACPRO 20002 ETUD.DEFINITION PRDTS INDUSTRIEL;2;2;2;0;0;0;0;2;0;0;0;1;1;0
5020.0;2021;17;NANTES;FEMININ;SCOLAIRE;BAC PROFESSIONNEL;BAC PRO PROD;BAC PRO 22106 CUISINE;70;70;64;2;4;3;1;67;0;7;14;30;16;3
5029.0;2021;17;NANTES;FEMININ;SCOLAIRE;BAC PROFESSIONNEL;BAC PRO PROD;BAC PRO 23304 AMENAGEMENT FINITION BATIMENT;18;18;14;1;3;1;2;15;0;0;3;8;4;3
5030.0;2021;17;NANTES;FEMININ;SCOLAIRE;BAC PROFESSIONNEL;BAC PRO PROD;BAC PRO 23405 TECHNICIEN MENUISIER AGENCEUR;8;8;7;0;1;0;1;7;0;1;1;4;1;1
5031.0;2021;17;NANTES;FEMININ;SCOLAIRE;BAC PROFESSIONNEL;BAC PRO PROD;BAC PRO 23407 TECHNIC.FAB.BOIS ET MATERX ASSOC;1;1;1;0;0;0;0;1;0;0;0;1;0;0
5037.0;2021;17;NANTES;FEMININ;SCOLAIRE;BAC PROFESSIONNEL;BAC PRO PROD;BAC PRO 25007 MAINTENANCE EQUIPEMENTS INDUST.;11;11;10;1;0;0;0;10;0;1;4;2;3;1
5045.0;2021;17;NANTES;FEMININ;SCOLAIRE;BAC PROFESSIONNEL;BAC PRO PROD;BAC PRO 25510 METIERS ELECT. ENVIRON. CONNECTES;9;9;8;1;0;0;0;8;0;0;4;2;2;1
5052.0;2021;17;NANTES;FEMININ;SCOLAIRE;BAC PROFESSIONNEL;BAC PRO PROD;BAC PRO AG 21203 TECHN CONSEIL DE VENTE ANIMAL;84;84;76;8;0;0;0;76;0;1;9;21;45;8
5053.0;2021;17;NANTES;FEMININ;SCOLAIRE;BAC PROFESSIONNEL;BAC PRO PROD;BAC PRO AG 21210 COND GEST ENTR CANIN ET FELIN;34;33;32;1;0;0;0;32;0;0;5;19;8;1
5054.0;2021;17;NANTES;FEMININ;SCOLAIRE;BAC PROFESSIONNEL;BAC PRO PROD;BAC PRO AG 21211 COND GEST ENTR HIPPIQUE;90;88;83;5;0;0;0;83;0;1;11;26;45;5
5065.0;2021;17;NANTES;FEMININ;SCOLAIRE;BAC PROFESSIONNEL;BAC PRO SERV;BAC PRO 31206 VENTE (PROSPECT.NEGO.SUIV.CLIENT;126;126;110;9;7;5;2;115;0;5;28;40;42;11
5069.0;2021;17;NANTES;FEMININ;SCOLAIRE;BAC PROFESSIONNEL;BAC PRO SERV;BAC PRO 32303 ART.& MET.ART:COM.VIS.VIS.PLURI-M;42;42;41;0;1;1;0;42;0;5;10;21;6;0
5071.0;2021;17;NANTES;FEMININ;SCOLAIRE;BAC PROFESSIONNEL;BAC PRO SERV;BAC PRO 33002 SERVICES DE PROXIMITE  VIE LOCAL;68;68;63;2;3;2;1;65;0;3;17;29;16;3
5078.0;2021;17;NANTES;FEMININ;SCOLAIRE;BAC PROFESSIONNEL;BAC PRO SERV;BAC PRO 33603 ESTHETIQUE COSMETIQUE PARFUMERIE;194;194;186;5;3;1;2;187;0;6;40;88;53;7
5085.0;2021;17;NANTES;FEMININ;SCOLAIRE;BAC TECHNOLOGIQUE;BAC STAV;BAC STAV AGRONOMIE ALIM ENV TERRITOI;132;132;130;2;0;0;0;130;0;2;20;53;55;2
5086.0;2021;17;NANTES;FEMININ;SCOLAIRE;BAC TECHNOLOGIQUE;BAC STD2A;BAC STD2A SCIENCES & TECHNO. DESIGN-ARTS APPLIQUES;172;172;172;0;0;0;0;172;0;28;80;54;10;0
5092.0;2021;17;NANTES;FEMININ;SCOLAIRE;BAC TECHNOLOGIQUE;BAC STL;BAC STL BIOCHIM.-BIOLOGIE-BIOTECHNOL.;104;104;95;0;9;3;6;98;0;9;16;40;33;6
5094.0;2021;17;NANTES;FEMININ;SCOLAIRE;BAC TECHNOLOGIQUE;BAC STMG;BAC STMG GESTION ET FINANCE;333;333;310;4;19;13;6;323;0;9;81;136;97;10
5098.0;2021;17;NANTES;MASCULIN;APPRENTISSAGE;BAC PROFESSIONNEL;BAC PRO PROD;BAC PRO 20102 PILOTE DE LIGNE DE PRODUCTION;16;16;13;1;2;0;2;13;0;0;3;3;7;3
5104.0;2021;17;NANTES;MASCULIN;APPRENTISSAGE;BAC PROFESSIONNEL;BAC PRO PROD;BAC PRO 22704 TECHN. MAINT. SYST.ENERG.CLIMATI;13;13;11;2;0;0;0;11;0;1;4;2;4;2
5111.0;2021;17;NANTES;MASCULIN;APPRENTISSAGE;BAC PROFESSIONNEL;BAC PRO PROD;BAC PRO 23404 TECHNICIEN CONSTRUCTEUR BOIS;8;8;8;0;0;0;0;8;0;0;1;4;3;0
5117.0;2021;17;NANTES;MASCULIN;APPRENTISSAGE;BAC PROFESSIONNEL;BAC PRO PROD;BAC PRO 25107 TECHNICIEN OUTILLEUR;11;11;8;0;3;2;1;10;0;0;2;3;5;1
5129.0;2021;17;NANTES;MASCULIN;APPRENTISSAGE;BAC PROFESSIONNEL;BAC PRO PROD;BAC PRO 25410 CONSTRUCTION DES CARROSSERIES;1;1;1;0;0;0;0;1;0;0;0;0;1;0
5135.0;2021;17;NANTES;MASCULIN;APPRENTISSAGE;BAC PROFESSIONNEL;BAC PRO PROD;BAC PRO AG 21001 AGRO-EQUIPEMENT;62;61;51;10;0;0;0;51;0;0;7;15;29;10
5136.0;2021;17;NANTES;MASCULIN;APPRENTISSAGE;BAC PROFESSIONNEL;BAC PRO PROD;BAC PRO AG 21004 CGEA;103;101;91;10;0;0;0;91;0;1;10;25;55;10
5157.0;2021;17;NANTES;MASCULIN;ENSEIGNEMENT A DISTANCE;BAC PROFESSIONNEL;BAC PRO PROD;BAC PRO AG 21004 CGEA;7;6;6;0;0;0;0;6;0;0;0;0;6;0
5164.0;2021;17;NANTES;MASCULIN;FORMATION CONTINUE;BAC PROFESSIONNEL;BAC PRO PROD;BAC PRO 22003 BIO-INDUSTRIES DE TRANSFORMATION;1;1;0;1;0;0;0;0;0;0;0;0;0;1
5167.0;2021;17;NANTES;MASCULIN;FORMATION CONTINUE;BAC PROFESSIONNEL;BAC PRO PROD;BAC PRO 23004 TECHN. ETUDES BAT.A ETUDES & ECO.;19;19;16;3;0;0;0;16;0;2;2;5;7;3
5168.0;2021;17;NANTES;MASCULIN;FORMATION CONTINUE;BAC PROFESSIONNEL;BAC PRO PROD;BAC PRO 23404 TECHNICIEN CONSTRUCTEUR BOIS;2;2;2;0;0;0;0;2;0;2;0;0;0;0
5174.0;2021;17;NANTES;MASCULIN;FORMATION CONTINUE;BAC PROFESSIONNEL;BAC PRO PROD;BAC PRO 25411 TECH.CHAUDRONNERIE INDUSTRIELLE;1;1;1;0;0;0;0;1;0;0;0;1;0;0
5176.0;2021;17;NANTES;MASCULIN;FORMATION CONTINUE;BAC PROFESSIONNEL;BAC PRO PROD;BAC PRO 25510 METIERS ELECT. ENVIRON. CONNECTES;22;22;20;1;1;1;0;21;0;9;6;2;4;1
5182.0;2021;17;NANTES;MASCULIN;FORMATION CONTINUE;BAC PROFESSIONNEL;BAC PRO SERV;BAC PRO 33102 PROTHESE DENTAIRE;5;5;5;0;0;0;0;5;0;0;1;3;1;0
5186.0;2021;17;NANTES;MASCULIN;INDIVIDUEL;BAC PROFESSIONNEL;BAC PRO PROD;BAC PRO 23004 TECHN. ETUDES BAT.A ETUDES & ECO.;1;0;0;0;0;0;0;0;0;0;0;0;0;0
5201.0;2021;17;NANTES;MASCULIN;INDIVIDUEL;BAC PROFESSIONNEL;BAC PRO SERV;BAC PRO 32208 REAL.PR.IMPR.PLURI.OPTB.PR.IMPR.;1;1;1;0;0;0;0;1;0;0;0;0;1;0
5211.0;2021;17;NANTES;MASCULIN;INDIVIDUEL;BAC TECHNOLOGIQUE;BAC STMG;BAC STMG GESTION ET FINANCE;9;6;3;1;2;2;0;5;0;0;1;2;2;1
5214.0;2021;17;NANTES;MASCULIN;INDIVIDUEL;BAC TECHNOLOGIQUE;BAC STMG;BAC STMG SYSTEMES D'INFORMATION DE GESTION;2;1;0;0;1;0;1;0;0;0;0;0;0;1
5219.0;2021;17;NANTES;MASCULIN;SCOLAIRE;BAC PROFESSIONNEL;BAC PRO PROD;BAC PRO 22105 BOULANGER-PÂTISSIER;42;42;35;0;7;4;3;39;0;0;6;17;16;3
5220.0;2021;17;NANTES;MASCULIN;SCOLAIRE;BAC PROFESSIONNEL;BAC PRO PROD;BAC PRO 22106 CUISINE;183;183;164;9;10;3;7;167;0;7;34;71;55;16
5224.0;2021;17;NANTES;MASCULIN;SCOLAIRE;BAC PROFESSIONNEL;BAC PRO PROD;BAC PRO 22704 TECHN. MAINT. SYST.ENERG.CLIMATI;7;7;4;2;1;0;1;4;0;0;0;0;4;3
5228.0;2021;17;NANTES;MASCULIN;SCOLAIRE;BAC PROFESSIONNEL;BAC PRO PROD;BAC PRO 23102 TRAVAUX PUBLICS;4;4;4;0;0;0;0;4;0;0;3;1;0;0
5239.0;2021;17;NANTES;MASCULIN;SCOLAIRE;BAC PROFESSIONNEL;BAC PRO PROD;BAC PRO 24203 METIERS DE LA MODE - VÊTEMENT;10;10;9;1;0;0;0;9;0;1;2;3;3;1
5240.0;2021;17;NANTES;MASCULIN;SCOLAIRE;BAC PROFESSIONNEL;BAC PRO PROD;BAC PRO 24302 METIERS DU CUIR : MAROQUINERIE;1;1;1;0;0;0;0;1;0;0;0;1;0;0
5246.0;2021;17;NANTES;MASCULIN;SCOLAIRE;BAC PROFESSIONNEL;BAC PRO PROD;BAC PRO 25214 MAINT.VEHIC.OPTA VOIT.PARTICUL.;228;228;193;32;3;2;1;195;0;16;51;71;57;33
5258.0;2021;17;NANTES;MASCULIN;SCOLAIRE;BAC PROFESSIONNEL;BAC PRO PROD;BAC PRO 25513 SYST.NUM.OPT.A SURETE SECURITE;85;85;78;4;3;2;1;80;0;3;22;26;29;5
5261.0;2021;17;NANTES;MASCULIN;SCOLAIRE;BAC PROFESSIONNEL;BAC PRO PROD;BAC PRO AG 21001 AGRO-EQUIPEMENT;109;109;102;7;0;0;0;102;0;2;13;33;54;7
5273.0;2021;17;NANTES;MASCULIN;SCOLAIRE;BAC PROFESSIONNEL;BAC PRO PROD;BAC PRO AG 22105 LABORATOIRE CONTROLE QUALITE;13;13;13;0;0;0;0;13;0;0;0;8;5;0
5274.0;2021;17;NANTES;MASCULIN;SCOLAIRE;BAC PROFESSIONNEL;BAC PRO PROD;BAC PRO AG 22107 TEC CONS VTE ALIMENTATION P.ALIM;104;100;85;15;0;0;0;85;0;2;5;33;45;15
5277.0;2021;17;NANTES;MASCULIN;SCOLAIRE;BAC PROFESSIONNEL;BAC PRO SERV;BAC PRO 31107 CONDUCT. TRANSP.ROUT.MARCHANDISES;92;92;84;8;0;0;0;84;0;4;23;39;18;8
5281.0;2021;17;NANTES;MASCULIN;SCOLAIRE;BAC PROFESSIONNEL;BAC PRO SERV;BAC PRO 31210 ACCUEIL -RELATION CLIENTS USAGERS;85;85;65;16;4;4;0;69;0;1;14;25;29;16
5286.0;2021;17;NANTES;MASCULIN;SCOLAIRE;BAC PROFESSIONNEL;BAC PRO SERV;BAC PRO 33002 SERVICES DE PROXIMITE  VIE LOCAL;48;48;46;1;1;1;0;47;0;1;3;22;21;1
5294.0;2021;17;NANTES;MASCULIN;SCOLAIRE;BAC PROFESSIONNEL;BAC PRO SERV;BAC PRO 34303 GEST. POLLUTIONS PROTEC. ENVIRON.;6;6;5;1;0;0;0;5;0;0;0;2;3;1
5304.0;2021;17;NANTES;MASCULIN;SCOLAIRE;BAC TECHNOLOGIQUE;BAC STI2D;BAC STI2D ARCHITECTURE ET CONSTRUCTION;251;251;234;3;14;10;4;244;0;5;37;108;94;7
5308.0;2021;17;NANTES;MASCULIN;SCOLAIRE;BAC TECHNOLOGIQUE;BAC STL;BAC STL BIOCHIM.-BIOLOGIE-BIOTECHNOL.;62;62;53;0;9;6;3;59;0;0;6;27;26;3
5310.0;2021;17;NANTES;MASCULIN;SCOLAIRE;BAC TECHNOLOGIQUE;BAC STMG;BAC STMG GESTION ET FINANCE;388;388;349;5;34;21;13;370;0;4;40;150;176;18
5320.0;2021;23;NICE;FEMININ;APPRENTISSAGE;BAC PROFESSIONNEL;BAC PRO PROD;BAC PRO AG 21405 AMENAGEMENTS PAYSAGERS;1;1;1;0;0;0;0;1;0;0;1;0;0;0
5322.0;2021;23;NICE;FEMININ;APPRENTISSAGE;BAC PROFESSIONNEL;BAC PRO SERV;BAC PRO 31202 COMMERCE;58;55;47;4;4;3;1;50;0;1;15;17;17;5
5325.0;2021;23;NICE;FEMININ;APPRENTISSAGE;BAC PROFESSIONNEL;BAC PRO SERV;BAC PRO 33004 ACC.SOINS-S.PERS. OPT.EN STRUCTUR;9;9;9;0;0;0;0;9;0;2;1;4;2;0
5337.0;2021;23;NICE;FEMININ;ENSEIGNEMENT A DISTANCE;BAC TECHNOLOGIQUE;BAC STMG;BAC STMG MERCATIQUE (MARKETING);3;3;2;1;0;0;0;2;0;0;1;1;0;1
5342.0;2021;23;NICE;FEMININ;FORMATION CONTINUE;BAC PROFESSIONNEL;BAC PRO SERV;BAC PRO 31202 COMMERCE;4;3;3;0;0;0;0;3;0;0;0;0;3;0
5343.0;2021;23;NICE;FEMININ;FORMATION CONTINUE;BAC PROFESSIONNEL;BAC PRO SERV;BAC PRO 31210 ACCUEIL -RELATION CLIENTS USAGERS;15;15;15;0;0;0;0;15;0;2;2;6;5;0
5359.0;2021;23;NICE;FEMININ;INDIVIDUEL;BAC TECHNOLOGIQUE;BAC STL;BAC STL SCIENCES PHYSIQUES CHIMIQUES  EN LABORAT.;1;1;1;0;0;0;0;1;0;0;0;0;1;0
5361.0;2021;23;NICE;FEMININ;INDIVIDUEL;BAC TECHNOLOGIQUE;BAC STMG;BAC STMG MERCATIQUE (MARKETING);17;14;7;5;2;1;1;8;0;0;1;3;4;6
5366.0;2021;23;NICE;FEMININ;SCOLAIRE;BAC PROFESSIONNEL;BAC PRO PROD;BAC PRO 22704 TECHN. MAINT. SYST.ENERG.CLIMATI;1;0;0;0;0;0;0;0;0;0;0;0;0;0
5368.0;2021;23;NICE;FEMININ;SCOLAIRE;BAC PROFESSIONNEL;BAC PRO PROD;BAC PRO 23004 TECHN. ETUDES BAT.A ETUDES & ECO.;7;7;6;0;1;1;0;7;0;0;2;4;1;0
5371.0;2021;23;NICE;FEMININ;SCOLAIRE;BAC PROFESSIONNEL;BAC PRO PROD;BACPRO 23103 TECHNICIEN GEOMETRE-TOPOGRAPHE;3;3;3;0;0;0;0;3;0;0;0;1;2;0
5372.0;2021;23;NICE;FEMININ;SCOLAIRE;BAC PROFESSIONNEL;BAC PRO PROD;BAC PRO 23303 MENUISERIE ALUMINIUM-VERRE;2;2;2;0;0;0;0;2;0;0;2;0;0;0
5380.0;2021;23;NICE;FEMININ;SCOLAIRE;BAC PROFESSIONNEL;BAC PRO PROD;BAC PRO 25007 MAINTENANCE EQUIPEMENTS INDUST.;6;6;6;0;0;0;0;6;0;0;1;2;3;0
5383.0;2021;23;NICE;FEMININ;SCOLAIRE;BAC PROFESSIONNEL;BAC PRO PROD;BAC PRO 25215 MAINT.VEHIC.OPTB VEHIC.TRANS.ROUT;1;1;1;0;0;0;0;1;0;0;0;1;0;0
5386.0;2021;23;NICE;FEMININ;SCOLAIRE;BAC PROFESSIONNEL;BAC PRO PROD;BAC PRO 25411 TECH.CHAUDRONNERIE INDUSTRIELLE;1;1;0;0;1;1;0;1;0;0;0;0;1;0
5398.0;2021;23;NICE;FEMININ;SCOLAIRE;BAC PROFESSIONNEL;BAC PRO SERV;BAC PRO 31106 LOGISTIQUE;2;2;2;0;0;0;0;2;0;0;0;0;2;0
5400.0;2021;23;NICE;FEMININ;SCOLAIRE;BAC PROFESSIONNEL;BAC PRO SERV;BAC PRO 31108 TRANSPORT;3;3;3;0;0;0;0;3;0;0;0;2;1;0
5408.0;2021;23;NICE;FEMININ;SCOLAIRE;BAC PROFESSIONNEL;BAC PRO SERV;BAC PRO 33003 ACC.SOINS-S.PERS. OPT.A DOMICILE;53;53;46;3;4;2;2;48;0;2;6;25;15;5
5409.0;2021;23;NICE;FEMININ;SCOLAIRE;BAC PROFESSIONNEL;BAC PRO SERV;BAC PRO 33004 ACC.SOINS-S.PERS. OPT.EN STRUCTUR;290;289;271;11;7;6;1;277;0;26;75;115;61;12
5413.0;2021;23;NICE;FEMININ;SCOLAIRE;BAC PROFESSIONNEL;BAC PRO SERV;BAC PRO 34304 HYGIENE PROPRETE STERILISATION;19;19;17;2;0;0;0;17;0;2;3;6;6;2
5414.0;2021;23;NICE;FEMININ;SCOLAIRE;BAC PROFESSIONNEL;BAC PRO SERV;BAC PRO 34403 METIERS DE LA SECURITE;17;17;17;0;0;0;0;17;0;0;4;10;3;0
5424.0;2021;23;NICE;FEMININ;SCOLAIRE;BAC TECHNOLOGIQUE;BAC STI2D;BAC STI2D INNOVATION TECHNO.  ET ECO CONCEPTION;10;10;10;0;0;0;0;10;0;0;3;5;2;0
5425.0;2021;23;NICE;FEMININ;SCOLAIRE;BAC TECHNOLOGIQUE;BAC STI2D;BAC STI2D SYSTÈME D'INFORMATION  ET NUMERIQUE;12;12;11;1;0;0;0;11;0;0;3;6;2;1
5426.0;2021;23;NICE;FEMININ;SCOLAIRE;BAC TECHNOLOGIQUE;BAC STL;BAC STL BIOCHIM.-BIOLOGIE-BIOTECHNOL.;75;75;70;0;5;5;0;75;2;4;19;28;22;0
5430.0;2021;23;NICE;FEMININ;SCOLAIRE;BAC TECHNOLOGIQUE;BAC STMG;BAC STMG RESSOURCES HUMAINES ET COMMUNICATION;421;421;378;7;36;16;20;394;0;8;52;166;168;27
5435.0;2021;23;NICE;MASCULIN;APPRENTISSAGE;BAC PROFESSIONNEL;BAC PRO PROD;BAC PRO 22704 TECHN. MAINT. SYST.ENERG.CLIMATI;2;2;2;0;0;0;0;2;0;0;1;1;0;0
5440.0;2021;23;NICE;MASCULIN;APPRENTISSAGE;BAC PROFESSIONNEL;BAC PRO PROD;BAC PRO 25007 MAINTENANCE EQUIPEMENTS INDUST.;10;10;9;1;0;0;0;9;0;1;1;3;4;1
5447.0;2021;23;NICE;MASCULIN;APPRENTISSAGE;BAC PROFESSIONNEL;BAC PRO PROD;BAC PRO 25509 TECHNIC. FROID CONDITIONNEMT AIR;11;9;6;1;2;1;1;7;0;0;1;1;5;2
5451.0;2021;23;NICE;MASCULIN;APPRENTISSAGE;BAC PROFESSIONNEL;BAC PRO PROD;BAC PRO AG 21302 GEST MILIEUX NATURELS FAUNE;9;8;6;2;0;0;0;6;0;0;1;2;3;2
5452.0;2021;23;NICE;MASCULIN;APPRENTISSAGE;BAC PROFESSIONNEL;BAC PRO PROD;BAC PRO AG 21405 AMENAGEMENTS PAYSAGERS;18;17;17;0;0;0;0;17;0;0;4;9;4;0
5454.0;2021;23;NICE;MASCULIN;APPRENTISSAGE;BAC PROFESSIONNEL;BAC PRO SERV;BAC PRO 31106 LOGISTIQUE;6;6;6;0;0;0;0;6;0;1;2;3;0;0
5456.0;2021;23;NICE;MASCULIN;APPRENTISSAGE;BAC PROFESSIONNEL;BAC PRO SERV;BAC PRO 31206 VENTE (PROSPECT.NEGO.SUIV.CLIENT;2;2;2;0;0;0;0;2;0;0;0;1;1;0
5460.0;2021;23;NICE;MASCULIN;ENSEIGNEMENT A DISTANCE;BAC GENERAL;BAC GENERAL;BAC GENE 10019 BAC GENERAL;37;34;33;1;0;0;0;33;0;3;16;7;7;1
5464.0;2021;23;NICE;MASCULIN;ENSEIGNEMENT A DISTANCE;BAC PROFESSIONNEL;BAC PRO SERV;BAC PRO 33004 ACC.SOINS-S.PERS. OPT.EN STRUCTUR;1;1;1;0;0;0;0;1;0;0;0;0;1;0
5465.0;2021;23;NICE;MASCULIN;ENSEIGNEMENT A DISTANCE;BAC TECHNOLOGIQUE;BAC STMG;BAC STMG GESTION ET FINANCE;2;2;2;0;0;0;0;2;0;0;1;0;1;0
5466.0;2021;23;NICE;MASCULIN;ENSEIGNEMENT A DISTANCE;BAC TECHNOLOGIQUE;BAC STMG;BAC STMG MERCATIQUE (MARKETING);4;4;4;0;0;0;0;4;0;1;2;1;0;0
5468.0;2021;23;NICE;MASCULIN;ENSEIGNEMENT A DISTANCE;BAC TECHNOLOGIQUE;BAC STMG;BAC STMG SYSTEMES D'INFORMATION DE GESTION;1;1;1;0;0;0;0;1;0;0;0;1;0;0
5483.0;2021;23;NICE;MASCULIN;INDIVIDUEL;BAC PROFESSIONNEL;BAC PRO PROD;BAC PRO 25107 TECHNICIEN OUTILLEUR;1;1;0;0;1;1;0;1;0;0;0;0;1;0
5488.0;2021;23;NICE;MASCULIN;INDIVIDUEL;BAC PROFESSIONNEL;BAC PRO PROD;BAC PRO AG 21004 CGEA;2;1;1;0;0;0;0;1;0;0;0;0;1;0
5493.0;2021;23;NICE;MASCULIN;INDIVIDUEL;BAC PROFESSIONNEL;BAC PRO SERV;BAC PRO 31206 VENTE (PROSPECT.NEGO.SUIV.CLIENT;2;1;0;1;0;0;0;0;0;0;0;0;0;1
5497.0;2021;23;NICE;MASCULIN;INDIVIDUEL;BAC TECHNOLOGIQUE;BAC ST2S;BAC ST2S SCIENCES & TECHNO. SANTE & SOCIAL;2;0;0;0;0;0;0;0;0;0;0;0;0;0
5502.0;2021;23;NICE;MASCULIN;INDIVIDUEL;BAC TECHNOLOGIQUE;BAC STMG;BAC STMG GESTION ET FINANCE;5;4;1;3;0;0;0;1;0;0;0;0;1;3
5512.0;2021;23;NICE;MASCULIN;SCOLAIRE;BAC PROFESSIONNEL;BAC PRO PROD;BAC PRO 22703 TECHN.INSTALL.SYST.ENERG.CLIMATI;46;46;31;10;5;2;3;33;0;0;5;14;14;13
5514.0;2021;23;NICE;MASCULIN;SCOLAIRE;BAC PROFESSIONNEL;BAC PRO PROD;BAC PRO 23003 ARTIS. & M.ART:MARCHANDISAGE VIS.;4;4;4;0;0;0;0;4;0;0;0;1;3;0
5517.0;2021;23;NICE;MASCULIN;SCOLAIRE;BAC PROFESSIONNEL;BAC PRO PROD;BAC PRO 23102 TRAVAUX PUBLICS;16;16;15;1;0;0;0;15;0;1;5;5;4;1
5522.0;2021;23;NICE;MASCULIN;SCOLAIRE;BAC PROFESSIONNEL;BAC PRO PROD;BAC PRO 23404 TECHNICIEN CONSTRUCTEUR BOIS;7;7;6;0;1;1;0;7;0;0;0;2;5;0
5542.0;2021;23;NICE;MASCULIN;SCOLAIRE;BAC PROFESSIONNEL;BAC PRO PROD;BAC PRO 25513 SYST.NUM.OPT.A SURETE SECURITE;34;33;28;4;1;1;0;29;0;1;8;14;6;4
5546.0;2021;23;NICE;MASCULIN;SCOLAIRE;BAC PROFESSIONNEL;BAC PRO PROD;BAC PRO AG 21113 CGEVV;24;24;19;5;0;0;0;19;0;0;0;9;10;5
5549.0;2021;23;NICE;MASCULIN;SCOLAIRE;BAC PROFESSIONNEL;BAC PRO PROD;BAC PRO AG 21405 AMENAGEMENTS PAYSAGERS;48;46;42;4;0;0;0;42;0;0;5;22;15;4
5551.0;2021;23;NICE;MASCULIN;SCOLAIRE;BAC PROFESSIONNEL;BAC PRO SERV;BAC PRO 30001 GESTION-ADMINISTRATION;208;208;159;40;9;8;1;167;0;5;20;72;70;41
5555.0;2021;23;NICE;MASCULIN;SCOLAIRE;BAC PROFESSIONNEL;BAC PRO SERV;BAC PRO 31202 COMMERCE;286;285;207;37;41;28;13;235;0;9;41;69;116;50
5557.0;2021;23;NICE;MASCULIN;SCOLAIRE;BAC PROFESSIONNEL;BAC PRO SERV;BAC PRO 31210 ACCUEIL -RELATION CLIENTS USAGERS;60;60;39;14;7;5;2;44;0;1;5;19;19;16
5560.0;2021;23;NICE;MASCULIN;SCOLAIRE;BAC PROFESSIONNEL;BAC PRO SERV;BAC PRO 32303 ART.& MET.ART:COM.VIS.VIS.PLURI-M;6;6;6;0;0;0;0;6;0;0;0;4;2;0
5567.0;2021;23;NICE;MASCULIN;SCOLAIRE;BAC PROFESSIONNEL;BAC PRO SERV;BAC PRO 34403 METIERS DE LA SECURITE;43;43;40;2;1;1;0;41;0;1;12;18;10;2
5578.0;2021;23;NICE;MASCULIN;SCOLAIRE;BAC TECHNOLOGIQUE;BAC STI2D;BAC STI2D SYSTÈME D'INFORMATION  ET NUMERIQUE;253;252;234;8;10;8;2;242;0;6;44;104;88;10
5580.0;2021;23;NICE;MASCULIN;SCOLAIRE;BAC TECHNOLOGIQUE;BAC STL;BAC STL SCIENCES PHYSIQUES CHIMIQUES  EN LABORAT.;40;40;36;2;2;2;0;38;0;0;10;13;15;2
5583.0;2021;23;NICE;MASCULIN;SCOLAIRE;BAC TECHNOLOGIQUE;BAC STMG;BAC STMG RESSOURCES HUMAINES ET COMMUNICATION;171;170;144;10;16;7;9;151;0;1;9;49;92;19
5588.0;2021;70;NORMANDIE;FEMININ;APPRENTISSAGE;BAC PROFESSIONNEL;BAC PRO PROD;BAC PRO 22105 BOULANGER-PÂTISSIER;1;1;0;1;0;0;0;0;0;0;0;0;0;1
5594.0;2021;70;NORMANDIE;FEMININ;APPRENTISSAGE;BAC PROFESSIONNEL;BAC PRO PROD;BAC PRO 25215 MAINT.VEHIC.OPTB VEHIC.TRANS.ROUT;1;1;1;0;0;0;0;1;0;0;1;0;0;0
5596.0;2021;70;NORMANDIE;FEMININ;APPRENTISSAGE;BAC PROFESSIONNEL;BAC PRO PROD;BAC PRO 25408 REPARATION DES CARROSSERIES;1;1;1;0;0;0;0;1;0;0;0;0;1;0
5599.0;2021;70;NORMANDIE;FEMININ;APPRENTISSAGE;BAC PROFESSIONNEL;BAC PRO PROD;BAC PRO AG 21004 CGEA;19;18;16;2;0;0;0;16;0;0;1;7;8;2
5602.0;2021;70;NORMANDIE;FEMININ;APPRENTISSAGE;BAC PROFESSIONNEL;BAC PRO PROD;BAC PRO AG 21211 COND GEST ENTR HIPPIQUE;51;51;48;3;0;0;0;48;0;0;4;19;25;3
5606.0;2021;70;NORMANDIE;FEMININ;APPRENTISSAGE;BAC PROFESSIONNEL;BAC PRO SERV;BAC PRO 30001 GESTION-ADMINISTRATION;23;23;22;1;0;0;0;22;0;3;7;8;4;1
5609.0;2021;70;NORMANDIE;FEMININ;APPRENTISSAGE;BAC PROFESSIONNEL;BAC PRO SERV;BAC PRO 31210 ACCUEIL -RELATION CLIENTS USAGERS;1;1;0;1;0;0;0;0;0;0;0;0;0;1
5610.0;2021;70;NORMANDIE;FEMININ;APPRENTISSAGE;BAC PROFESSIONNEL;BAC PRO SERV;BAC PRO 32208 REAL.PR.IMPR.PLURI.OPTB.PR.IMPR.;2;2;2;0;0;0;0;2;0;0;0;0;2;0
5615.0;2021;70;NORMANDIE;FEMININ;APPRENTISSAGE;BAC PROFESSIONNEL;BAC PRO SERV;BAC PRO AG 33002 SERV PERS TERRIT;2;2;2;0;0;0;0;2;0;0;0;0;2;0
5616.0;2021;70;NORMANDIE;FEMININ;ENSEIGNEMENT A DISTANCE;BAC GENERAL;BAC GENERAL;BAC GENE 10019 BAC GENERAL;50;48;43;4;1;0;1;43;1;9;8;14;11;5
5636.0;2021;70;NORMANDIE;FEMININ;FORMATION CONTINUE;BAC PROFESSIONNEL;BAC PRO SERV;BAC PRO 34303 GEST. POLLUTIONS PROTEC. ENVIRON.;2;2;2;0;0;0;0;2;0;0;2;0;0;0
5638.0;2021;70;NORMANDIE;FEMININ;INDIVIDUEL;BAC GENERAL;BAC GENERAL;BAC GENE 10019 BAC GENERAL;74;56;32;13;11;6;5;38;0;2;7;11;18;18
5639.0;2021;70;NORMANDIE;FEMININ;INDIVIDUEL;BAC PROFESSIONNEL;BAC PRO PROD;BAC PRO AG 21004 CGEA;6;5;5;0;0;0;0;5;0;0;0;0;5;0
5645.0;2021;70;NORMANDIE;FEMININ;INDIVIDUEL;BAC PROFESSIONNEL;BAC PRO SERV;BAC PRO 33003 ACC.SOINS-S.PERS. OPT.A DOMICILE;1;0;0;0;0;0;0;0;0;0;0;0;0;0
5646.0;2021;70;NORMANDIE;FEMININ;INDIVIDUEL;BAC PROFESSIONNEL;BAC PRO SERV;BAC PRO 33004 ACC.SOINS-S.PERS. OPT.EN STRUCTUR;2;2;2;0;0;0;0;2;0;0;0;1;1;0
5649.0;2021;70;NORMANDIE;FEMININ;INDIVIDUEL;BAC PROFESSIONNEL;BAC PRO SERV;BAC PRO AG 33002 SERV PERS TERRIT;2;1;0;1;0;0;0;0;0;0;0;0;0;1
5651.0;2021;70;NORMANDIE;FEMININ;INDIVIDUEL;BAC TECHNOLOGIQUE;BAC STD2A;BAC STD2A SCIENCES & TECHNO. DESIGN-ARTS APPLIQUES;1;0;0;0;0;0;0;0;0;0;0;0;0;0
5658.0;2021;70;NORMANDIE;FEMININ;SCOLAIRE;BAC PROFESSIONNEL;BAC PRO PROD;BAC PRO 22003 BIO-INDUSTRIES DE TRANSFORMATION;15;13;10;2;1;1;0;11;0;0;0;6;5;2
5660.0;2021;70;NORMANDIE;FEMININ;SCOLAIRE;BAC PROFESSIONNEL;BAC PRO PROD;BAC PRO 22105 BOULANGER-PÂTISSIER;27;27;24;1;2;1;1;25;0;4;7;12;2;2
5661.0;2021;70;NORMANDIE;FEMININ;SCOLAIRE;BAC PROFESSIONNEL;BAC PRO PROD;BAC PRO 22106 CUISINE;70;70;63;6;1;1;0;64;0;7;14;18;25;6
5671.0;2021;70;NORMANDIE;FEMININ;SCOLAIRE;BAC PROFESSIONNEL;BAC PRO PROD;BAC PRO 23404 TECHNICIEN CONSTRUCTEUR BOIS;2;2;1;0;1;1;0;2;0;0;0;1;1;0
5688.0;2021;70;NORMANDIE;FEMININ;SCOLAIRE;BAC PROFESSIONNEL;BAC PRO PROD;BAC PRO 25515 SYST.NUM.OPT.C RES.INF.SYST.COMM.;6;6;6;0;0;0;0;6;0;1;4;1;0;0
5694.0;2021;70;NORMANDIE;FEMININ;SCOLAIRE;BAC PROFESSIONNEL;BAC PRO PROD;BAC PRO AG 21211 COND GEST ENTR HIPPIQUE;31;31;29;2;0;0;0;29;0;0;2;9;18;2
5695.0;2021;70;NORMANDIE;FEMININ;SCOLAIRE;BAC PROFESSIONNEL;BAC PRO PROD;BAC PRO AG 21302 GEST MILIEUX NATURELS FAUNE;13;12;12;0;0;0;0;12;0;0;0;6;6;0
5696.0;2021;70;NORMANDIE;FEMININ;SCOLAIRE;BAC PROFESSIONNEL;BAC PRO PROD;BAC PRO AG 21303 FORET;1;1;1;0;0;0;0;1;0;0;0;1;0;0
5698.0;2021;70;NORMANDIE;FEMININ;SCOLAIRE;BAC PROFESSIONNEL;BAC PRO PROD;BAC PRO AG 21406 TEC CONS VTE PROD DES JARDINS;16;16;16;0;0;0;0;16;0;0;2;7;7;0
5700.0;2021;70;NORMANDIE;FEMININ;SCOLAIRE;BAC PROFESSIONNEL;BAC PRO PROD;BAC PRO AG 22107 TEC CONS VTE ALIMENTATION P.ALIM;18;17;15;2;0;0;0;15;0;1;2;3;9;2
5701.0;2021;70;NORMANDIE;FEMININ;SCOLAIRE;BAC PROFESSIONNEL;BAC PRO SERV;BAC PRO 30001 GESTION-ADMINISTRATION;866;865;680;123;62;39;23;719;0;21;115;278;305;146
5708.0;2021;70;NORMANDIE;FEMININ;SCOLAIRE;BAC PROFESSIONNEL;BAC PRO SERV;BAC PRO 32207 REAL.PR.IMPR.PLURI.OPTA.PR.GRAPH.;13;13;12;1;0;0;0;12;0;1;8;3;0;1
5719.0;2021;70;NORMANDIE;FEMININ;SCOLAIRE;BAC PROFESSIONNEL;BAC PRO SERV;BAC PRO 33603 ESTHETIQUE COSMETIQUE PARFUMERIE;130;130;126;4;0;0;0;126;0;6;39;51;30;4
5726.0;2021;70;NORMANDIE;FEMININ;SCOLAIRE;BAC TECHNOLOGIQUE;BAC ST2S;BAC ST2S SCIENCES & TECHNO. SANTE & SOCIAL;908;908;830;11;67;40;27;870;0;29;133;314;394;38
5731.0;2021;70;NORMANDIE;FEMININ;SCOLAIRE;BAC TECHNOLOGIQUE;BAC STI2D;BAC STI2D ENERGIES  ET ENVIRONNEMENT;16;16;15;0;1;0;1;15;0;1;2;4;8;1
5736.0;2021;70;NORMANDIE;FEMININ;SCOLAIRE;BAC TECHNOLOGIQUE;BAC STMG;BAC STMG GESTION ET FINANCE;311;311;284;7;20;14;6;298;0;10;55;130;103;13
5737.0;2021;70;NORMANDIE;FEMININ;SCOLAIRE;BAC TECHNOLOGIQUE;BAC STMG;BAC STMG MERCATIQUE (MARKETING);777;777;707;11;59;30;29;737;0;10;109;285;333;40
5739.0;2021;70;NORMANDIE;FEMININ;SCOLAIRE;BAC TECHNOLOGIQUE;BAC STMG;BAC STMG SYSTEMES D'INFORMATION DE GESTION;5;5;5;0;0;0;0;5;0;0;0;2;3;0
5740.0;2021;70;NORMANDIE;MASCULIN;APPRENTISSAGE;BAC PROFESSIONNEL;BAC PRO PROD;BAC PRO 20102 PILOTE DE LIGNE DE PRODUCTION;11;11;11;0;0;0;0;11;0;2;5;3;1;0
5742.0;2021;70;NORMANDIE;MASCULIN;APPRENTISSAGE;BAC PROFESSIONNEL;BAC PRO PROD;BAC PRO 22004 PROC. CHIMIE EAU PAPIERS-CARTONS;11;11;10;1;0;0;0;10;0;6;2;2;0;1
5748.0;2021;70;NORMANDIE;MASCULIN;APPRENTISSAGE;BAC PROFESSIONNEL;BAC PRO PROD;BAC PRO 22704 TECHN. MAINT. SYST.ENERG.CLIMATI;6;6;5;1;0;0;0;5;0;1;2;2;0;1
5750.0;2021;70;NORMANDIE;MASCULIN;APPRENTISSAGE;BAC PROFESSIONNEL;BAC PRO PROD;BAC PRO 23102 TRAVAUX PUBLICS;25;24;19;5;0;0;0;19;0;0;5;10;4;5
5751.0;2021;70;NORMANDIE;MASCULIN;APPRENTISSAGE;BAC PROFESSIONNEL;BAC PRO PROD;BAC PRO 23203 TECHNICIEN BAT. : ORG.REAL.GROS O;14;13;9;1;3;1;2;10;0;0;0;5;5;3
5757.0;2021;70;NORMANDIE;MASCULIN;APPRENTISSAGE;BAC PROFESSIONNEL;BAC PRO PROD;BAC PRO 25106 TECHNICIEN D'USINAGE;28;28;22;4;2;1;1;23;0;1;6;8;8;5
5763.0;2021;70;NORMANDIE;MASCULIN;APPRENTISSAGE;BAC PROFESSIONNEL;BAC PRO PROD;BAC PRO 25303 AERONAUTIQUE OPTION SYSTEMES;7;7;7;0;0;0;0;7;0;2;4;1;0;0
5765.0;2021;70;NORMANDIE;MASCULIN;APPRENTISSAGE;BAC PROFESSIONNEL;BAC PRO PROD;BAC PRO 25411 TECH.CHAUDRONNERIE INDUSTRIELLE;109;107;98;5;4;3;1;101;0;3;28;40;30;6
5771.0;2021;70;NORMANDIE;MASCULIN;APPRENTISSAGE;BAC PROFESSIONNEL;BAC PRO PROD;BAC PRO AG 21001 AGRO-EQUIPEMENT;25;25;23;2;0;0;0;23;0;0;0;7;16;2
5779.0;2021;70;NORMANDIE;MASCULIN;APPRENTISSAGE;BAC PROFESSIONNEL;BAC PRO PROD;BAC PRO AG 21406 TEC CONS VTE PROD DES JARDINS;1;1;1;0;0;0;0;1;0;0;1;0;0;0
5783.0;2021;70;NORMANDIE;MASCULIN;APPRENTISSAGE;BAC PROFESSIONNEL;BAC PRO SERV;BAC PRO 31202 COMMERCE;74;72;60;4;8;5;3;65;0;0;15;27;23;7
5787.0;2021;70;NORMANDIE;MASCULIN;APPRENTISSAGE;BAC PROFESSIONNEL;BAC PRO SERV;BAC PRO 32208 REAL.PR.IMPR.PLURI.OPTB.PR.IMPR.;4;4;4;0;0;0;0;4;0;0;0;2;2;0
5789.0;2021;70;NORMANDIE;MASCULIN;APPRENTISSAGE;BAC PROFESSIONNEL;BAC PRO SERV;BAC PRO 34305 TECHN.D'INTERV.SUR INSTALL. NUCL.;11;11;11;0;0;0;0;11;0;3;5;2;1;0
5794.0;2021;70;NORMANDIE;MASCULIN;ENSEIGNEMENT A DISTANCE;BAC TECHNOLOGIQUE;BAC STMG;BAC STMG GESTION ET FINANCE;3;3;3;0;0;0;0;3;0;0;0;2;1;0
5796.0;2021;70;NORMANDIE;MASCULIN;ENSEIGNEMENT A DISTANCE;BAC TECHNOLOGIQUE;BAC STMG;BAC STMG RESSOURCES HUMAINES ET COMMUNICATION;3;3;3;0;0;0;0;3;0;0;2;1;0;0
5800.0;2021;70;NORMANDIE;MASCULIN;FORMATION CONTINUE;BAC PROFESSIONNEL;BAC PRO PROD;BAC PRO 22703 TECHN.INSTALL.SYST.ENERG.CLIMATI;7;7;6;1;0;0;0;6;0;1;3;2;0;1
5804.0;2021;70;NORMANDIE;MASCULIN;FORMATION CONTINUE;BAC PROFESSIONNEL;BAC PRO PROD;BAC PRO 23405 TECHNICIEN MENUISIER AGENCEUR;2;2;2;0;0;0;0;2;0;2;0;0;0;0
5806.0;2021;70;NORMANDIE;MASCULIN;FORMATION CONTINUE;BAC PROFESSIONNEL;BAC PRO PROD;BAC PRO 25106 TECHNICIEN D'USINAGE;10;10;8;2;0;0;0;8;0;1;3;3;1;2
5815.0;2021;70;NORMANDIE;MASCULIN;FORMATION CONTINUE;BAC PROFESSIONNEL;BAC PRO SERV;BAC PRO 31202 COMMERCE;16;12;9;1;2;1;1;10;0;0;1;6;3;2
5820.0;2021;70;NORMANDIE;MASCULIN;INDIVIDUEL;BAC GENERAL;BAC GENERAL;BAC GENE 10019 BAC GENERAL;94;77;49;23;5;2;3;51;1;2;7;20;21;26
5826.0;2021;70;NORMANDIE;MASCULIN;INDIVIDUEL;BAC PROFESSIONNEL;BAC PRO PROD;BAC PRO 25215 MAINT.VEHIC.OPTB VEHIC.TRANS.ROUT;1;0;0;0;0;0;0;0;0;0;0;0;0;0
5834.0;2021;70;NORMANDIE;MASCULIN;INDIVIDUEL;BAC PROFESSIONNEL;BAC PRO PROD;BAC PRO AG 21211 COND GEST ENTR HIPPIQUE;3;1;1;0;0;0;0;1;0;0;0;0;1;0
5838.0;2021;70;NORMANDIE;MASCULIN;INDIVIDUEL;BAC PROFESSIONNEL;BAC PRO SERV;BAC PRO 31202 COMMERCE;1;1;0;1;0;0;0;0;0;0;0;0;0;1
5840.0;2021;70;NORMANDIE;MASCULIN;INDIVIDUEL;BAC TECHNOLOGIQUE;BAC ST2S;BAC ST2S SCIENCES & TECHNO. SANTE & SOCIAL;2;1;1;0;0;0;0;1;0;0;0;0;1;0
5852.0;2021;70;NORMANDIE;MASCULIN;SCOLAIRE;BAC PROFESSIONNEL;BAC PRO PROD;BAC PRO 22003 BIO-INDUSTRIES DE TRANSFORMATION;7;7;5;2;0;0;0;5;0;0;3;2;0;2
5861.0;2021;70;NORMANDIE;MASCULIN;SCOLAIRE;BAC PROFESSIONNEL;BAC PRO PROD;BAC PRO 23004 TECHN. ETUDES BAT.A ETUDES & ECO.;82;80;63;13;4;1;3;64;0;3;13;27;21;16
5865.0;2021;70;NORMANDIE;MASCULIN;SCOLAIRE;BAC PROFESSIONNEL;BAC PRO PROD;BAC PRO 23203 TECHNICIEN BAT. : ORG.REAL.GROS O;43;40;30;9;1;1;0;31;0;4;5;11;11;9
5870.0;2021;70;NORMANDIE;MASCULIN;SCOLAIRE;BAC PROFESSIONNEL;BAC PRO PROD;BAC PRO 23405 TECHNICIEN MENUISIER AGENCEUR;83;83;68;9;6;5;1;73;0;2;18;26;27;10
5871.0;2021;70;NORMANDIE;MASCULIN;SCOLAIRE;BAC PROFESSIONNEL;BAC PRO PROD;BAC PRO 23406 TECHNICIEN DE SCIERIE;7;7;3;4;0;0;0;3;0;0;1;1;1;4
5876.0;2021;70;NORMANDIE;MASCULIN;SCOLAIRE;BAC PROFESSIONNEL;BAC PRO PROD;BAC PRO 25006 MICROTECHNIQUES;39;39;34;4;1;1;0;35;0;3;12;15;5;4
5879.0;2021;70;NORMANDIE;MASCULIN;SCOLAIRE;BAC PROFESSIONNEL;BAC PRO PROD;BAC PRO 25106 TECHNICIEN D'USINAGE;143;143;110;24;9;5;4;115;0;8;31;37;39;28
5888.0;2021;70;NORMANDIE;MASCULIN;SCOLAIRE;BAC PROFESSIONNEL;BAC PRO PROD;BAC PRO 25408 REPARATION DES CARROSSERIES;58;57;43;12;2;1;1;44;0;1;7;14;22;13
5891.0;2021;70;NORMANDIE;MASCULIN;SCOLAIRE;BAC PROFESSIONNEL;BAC PRO PROD;BAC PRO 25510 METIERS ELECT. ENVIRON. CONNECTES;576;575;476;82;17;7;10;483;0;30;94;191;168;92
5897.0;2021;70;NORMANDIE;MASCULIN;SCOLAIRE;BAC PROFESSIONNEL;BAC PRO PROD;BAC PRO AG 21114 CONDUITE PRODUCTIONS HORTICOLES;18;18;17;1;0;0;0;17;0;0;2;2;13;1
5898.0;2021;70;NORMANDIE;MASCULIN;SCOLAIRE;BAC PROFESSIONNEL;BAC PRO PROD;BAC PRO AG 21203 TECHN CONSEIL DE VENTE ANIMAL;8;8;8;0;0;0;0;8;0;0;1;3;4;0
5900.0;2021;70;NORMANDIE;MASCULIN;SCOLAIRE;BAC PROFESSIONNEL;BAC PRO PROD;BAC PRO AG 21210 COND GEST ENTR CANIN ET FELIN;23;23;21;2;0;0;0;21;0;0;0;4;17;2
5901.0;2021;70;NORMANDIE;MASCULIN;SCOLAIRE;BAC PROFESSIONNEL;BAC PRO PROD;BAC PRO AG 21211 COND GEST ENTR HIPPIQUE;3;3;3;0;0;0;0;3;0;0;0;2;1;0
5905.0;2021;70;NORMANDIE;MASCULIN;SCOLAIRE;BAC PROFESSIONNEL;BAC PRO PROD;BAC PRO AG 21406 TEC CONS VTE PROD DES JARDINS;7;7;5;2;0;0;0;5;0;0;1;1;3;2
5910.0;2021;70;NORMANDIE;MASCULIN;SCOLAIRE;BAC PROFESSIONNEL;BAC PRO SERV;BAC PRO 31107 CONDUCT. TRANSP.ROUT.MARCHANDISES;129;129;101;24;4;3;1;104;0;6;35;37;26;25
5916.0;2021;70;NORMANDIE;MASCULIN;SCOLAIRE;BAC PROFESSIONNEL;BAC PRO SERV;BAC PRO 32208 REAL.PR.IMPR.PLURI.OPTB.PR.IMPR.;12;12;12;0;0;0;0;12;0;0;1;5;6;0
5919.0;2021;70;NORMANDIE;MASCULIN;SCOLAIRE;BAC PROFESSIONNEL;BAC PRO SERV;BAC PRO 33002 SERVICES DE PROXIMITE  VIE LOCAL;30;30;26;3;1;1;0;27;0;0;3;15;9;3
5924.0;2021;70;NORMANDIE;MASCULIN;SCOLAIRE;BAC PROFESSIONNEL;BAC PRO SERV;BAC PRO 33403 COMMERC. SERVICES EN RESTAURATION;96;96;88;8;0;0;0;88;0;7;23;31;27;8
5929.0;2021;70;NORMANDIE;MASCULIN;SCOLAIRE;BAC PROFESSIONNEL;BAC PRO SERV;BAC PRO AG 33002 SERV PERS TERRIT;37;35;30;5;0;0;0;30;0;0;3;9;18;5
5931.0;2021;70;NORMANDIE;MASCULIN;SCOLAIRE;BAC TECHNOLOGIQUE;BAC S2TMD;BAC S2TMD MUSIQUE;11;11;9;0;2;1;1;10;1;0;3;4;2;1
5932.0;2021;70;NORMANDIE;MASCULIN;SCOLAIRE;BAC TECHNOLOGIQUE;BAC ST2S;BAC ST2S SCIENCES & TECHNO. SANTE & SOCIAL;118;118;99;4;15;7;8;106;0;0;10;36;60;12
5934.0;2021;70;NORMANDIE;MASCULIN;SCOLAIRE;BAC TECHNOLOGIQUE;BAC STD2A;BAC STD2A SCIENCES & TECHNO. DESIGN-ARTS APPLIQUES;15;15;15;0;0;0;0;15;0;3;4;7;1;0
5941.0;2021;70;NORMANDIE;MASCULIN;SCOLAIRE;BAC TECHNOLOGIQUE;BAC STL;BAC STL SCIENCES PHYSIQUES CHIMIQUES  EN LABORAT.;54;54;45;3;6;6;0;51;0;3;9;17;22;3
5942.0;2021;70;NORMANDIE;MASCULIN;SCOLAIRE;BAC TECHNOLOGIQUE;BAC STMG;BAC STMG GESTION ET FINANCE;419;418;342;22;54;43;11;385;0;2;49;137;197;33
5951.0;2021;18;ORLEANS-TOURS;FEMININ;APPRENTISSAGE;BAC PROFESSIONNEL;BAC PRO PROD;BAC PRO 25214 MAINT.VEHIC.OPTA VOIT.PARTICUL.;6;6;5;1;0;0;0;5;0;1;1;1;2;1
5952.0;2021;18;ORLEANS-TOURS;FEMININ;APPRENTISSAGE;BAC PROFESSIONNEL;BAC PRO PROD;BAC PRO 25408 REPARATION DES CARROSSERIES;1;1;1;0;0;0;0;1;0;0;0;1;0;0
5956.0;2021;18;ORLEANS-TOURS;FEMININ;APPRENTISSAGE;BAC PROFESSIONNEL;BAC PRO PROD;BAC PRO 25514 SYST.NUM.OPT.B AUD.RES.EQUIP.DOM.;1;1;1;0;0;0;0;1;0;0;0;1;0;0
5957.0;2021;18;ORLEANS-TOURS;FEMININ;APPRENTISSAGE;BAC PROFESSIONNEL;BAC PRO PROD;BAC PRO AG 21004 CGEA;6;6;5;1;0;0;0;5;0;0;0;2;3;1
5965.0;2021;18;ORLEANS-TOURS;FEMININ;APPRENTISSAGE;BAC PROFESSIONNEL;BAC PRO SERV;BAC PRO 31202 COMMERCE;93;92;79;9;4;2;2;81;0;2;21;26;32;11
5973.0;2021;18;ORLEANS-TOURS;FEMININ;ENSEIGNEMENT A DISTANCE;BAC PROFESSIONNEL;BAC PRO SERV;BAC PRO 31210 ACCUEIL -RELATION CLIENTS USAGERS;1;1;1;0;0;0;0;1;0;0;0;0;1;0
5978.0;2021;18;ORLEANS-TOURS;FEMININ;FORMATION CONTINUE;BAC PROFESSIONNEL;BAC PRO PROD;BAC PRO 25106 TECHNICIEN D'USINAGE;2;2;2;0;0;0;0;2;0;1;0;1;0;0
5986.0;2021;18;ORLEANS-TOURS;FEMININ;INDIVIDUEL;BAC PROFESSIONNEL;BAC PRO PROD;BAC PRO AG 21004 CGEA;10;8;7;1;0;0;0;7;0;0;0;0;7;1
5989.0;2021;18;ORLEANS-TOURS;FEMININ;INDIVIDUEL;BAC PROFESSIONNEL;BAC PRO PROD;BAC PRO AG 21302 GEST MILIEUX NATURELS FAUNE;1;1;1;0;0;0;0;1;0;0;0;0;1;0
5994.0;2021;18;ORLEANS-TOURS;FEMININ;INDIVIDUEL;BAC PROFESSIONNEL;BAC PRO SERV;BAC PRO 33002 SERVICES DE PROXIMITE  VIE LOCAL;2;0;0;0;0;0;0;0;0;0;0;0;0;0
5995.0;2021;18;ORLEANS-TOURS;FEMININ;INDIVIDUEL;BAC PROFESSIONNEL;BAC PRO SERV;BAC PRO 33004 ACC.SOINS-S.PERS. OPT.EN STRUCTUR;4;3;3;0;0;0;0;3;0;0;1;1;1;0
6001.0;2021;18;ORLEANS-TOURS;FEMININ;INDIVIDUEL;BAC TECHNOLOGIQUE;BAC STL;BAC STL BIOCHIM.-BIOLOGIE-BIOTECHNOL.;1;1;1;0;0;0;0;1;0;0;0;0;1;0
6005.0;2021;18;ORLEANS-TOURS;FEMININ;INDIVIDUEL;BAC TECHNOLOGIQUE;BAC STMG;BAC STMG SYSTEMES D'INFORMATION DE GESTION;1;1;0;0;1;0;1;0;0;0;0;0;0;1
6008.0;2021;18;ORLEANS-TOURS;FEMININ;SCOLAIRE;BAC PROFESSIONNEL;BAC PRO PROD;BAC PRO 22003 BIO-INDUSTRIES DE TRANSFORMATION;8;8;8;0;0;0;0;8;0;0;3;3;2;0
6015.0;2021;18;ORLEANS-TOURS;FEMININ;SCOLAIRE;BAC PROFESSIONNEL;BAC PRO PROD;BAC PRO 23005 TECHN. ETUDES BAT B ASSIST.ARCHI.;14;14;13;1;0;0;0;13;0;0;3;4;6;1
6017.0;2021;18;ORLEANS-TOURS;FEMININ;SCOLAIRE;BAC PROFESSIONNEL;BAC PRO PROD;BAC PRO 23304 AMENAGEMENT FINITION BATIMENT;8;8;8;0;0;0;0;8;0;0;2;3;3;0
6038.0;2021;18;ORLEANS-TOURS;FEMININ;SCOLAIRE;BAC PROFESSIONNEL;BAC PRO PROD;BAC PRO AG 21114 CONDUITE PRODUCTIONS HORTICOLES;15;15;14;1;0;0;0;14;0;0;4;4;6;1
6042.0;2021;18;ORLEANS-TOURS;FEMININ;SCOLAIRE;BAC PROFESSIONNEL;BAC PRO PROD;BAC PRO AG 21302 GEST MILIEUX NATURELS FAUNE;7;6;6;0;0;0;0;6;0;0;0;4;2;0
6045.0;2021;18;ORLEANS-TOURS;FEMININ;SCOLAIRE;BAC PROFESSIONNEL;BAC PRO PROD;BAC PRO AG 22105 LABORATOIRE CONTROLE QUALITE;5;5;5;0;0;0;0;5;0;0;1;2;2;0
6046.0;2021;18;ORLEANS-TOURS;FEMININ;SCOLAIRE;BAC PROFESSIONNEL;BAC PRO PROD;BAC PRO AG 22106 TEC CONS VTE ALIMENTATION VINS SP;4;3;2;1;0;0;0;2;0;0;0;1;1;1
6050.0;2021;18;ORLEANS-TOURS;FEMININ;SCOLAIRE;BAC PROFESSIONNEL;BAC PRO SERV;BAC PRO 31107 CONDUCT. TRANSP.ROUT.MARCHANDISES;6;6;4;2;0;0;0;4;0;0;2;1;1;2
6052.0;2021;18;ORLEANS-TOURS;FEMININ;SCOLAIRE;BAC PROFESSIONNEL;BAC PRO SERV;BAC PRO 31202 COMMERCE;373;373;324;19;30;22;8;346;0;21;81;128;116;27
6053.0;2021;18;ORLEANS-TOURS;FEMININ;SCOLAIRE;BAC PROFESSIONNEL;BAC PRO SERV;BAC PRO 31206 VENTE (PROSPECT.NEGO.SUIV.CLIENT;112;112;103;6;3;3;0;106;0;4;25;35;42;6
6055.0;2021;18;ORLEANS-TOURS;FEMININ;SCOLAIRE;BAC PROFESSIONNEL;BAC PRO SERV;BAC PRO 32207 REAL.PR.IMPR.PLURI.OPTA.PR.GRAPH.;9;9;8;1;0;0;0;8;0;1;3;4;0;1
6056.0;2021;18;ORLEANS-TOURS;FEMININ;SCOLAIRE;BAC PROFESSIONNEL;BAC PRO SERV;BAC PRO 32208 REAL.PR.IMPR.PLURI.OPTB.PR.IMPR.;10;10;7;3;0;0;0;7;0;0;1;3;3;3
6080.0;2021;18;ORLEANS-TOURS;FEMININ;SCOLAIRE;BAC TECHNOLOGIQUE;BAC STL;BAC STL SCIENCES PHYSIQUES CHIMIQUES  EN LABORAT.;52;52;46;1;5;1;4;47;0;3;8;19;17;5
6086.0;2021;18;ORLEANS-TOURS;MASCULIN;APPRENTISSAGE;BAC PROFESSIONNEL;BAC PRO PROD;BAC PRO 22106 CUISINE;5;5;4;1;0;0;0;4;0;0;0;2;2;1
6092.0;2021;18;ORLEANS-TOURS;MASCULIN;APPRENTISSAGE;BAC PROFESSIONNEL;BAC PRO PROD;BAC PRO 23303 MENUISERIE ALUMINIUM-VERRE;3;3;3;0;0;0;0;3;0;0;0;0;3;0
6096.0;2021;18;ORLEANS-TOURS;MASCULIN;APPRENTISSAGE;BAC PROFESSIONNEL;BAC PRO PROD;BAC PRO 25106 TECHNICIEN D'USINAGE;33;33;25;2;6;3;3;28;0;1;5;9;13;5
6123.0;2021;18;ORLEANS-TOURS;MASCULIN;APPRENTISSAGE;BAC PROFESSIONNEL;BAC PRO SERV;BAC PRO 32207 REAL.PR.IMPR.PLURI.OPTA.PR.GRAPH.;3;3;3;0;0;0;0;3;0;0;1;2;0;0
6125.0;2021;18;ORLEANS-TOURS;MASCULIN;APPRENTISSAGE;BAC PROFESSIONNEL;BAC PRO SERV;BAC PRO 33002 SERVICES DE PROXIMITE  VIE LOCAL;1;1;1;0;0;0;0;1;0;0;0;1;0;0
6127.0;2021;18;ORLEANS-TOURS;MASCULIN;APPRENTISSAGE;BAC PROFESSIONNEL;BAC PRO SERV;BAC PRO 34304 HYGIENE PROPRETE STERILISATION;8;8;6;1;1;0;1;6;0;0;1;2;3;2
6128.0;2021;18;ORLEANS-TOURS;MASCULIN;ENSEIGNEMENT A DISTANCE;BAC GENERAL;BAC GENERAL;BAC GENE 10019 BAC GENERAL;26;25;22;2;1;1;0;23;2;6;8;2;5;2
6132.0;2021;18;ORLEANS-TOURS;MASCULIN;FORMATION CONTINUE;BAC PROFESSIONNEL;BAC PRO PROD;BAC PRO 22106 CUISINE;2;2;2;0;0;0;0;2;0;0;2;0;0;0
6135.0;2021;18;ORLEANS-TOURS;MASCULIN;FORMATION CONTINUE;BAC PROFESSIONNEL;BAC PRO PROD;BAC PRO 22704 TECHN. MAINT. SYST.ENERG.CLIMATI;3;3;2;0;1;1;0;3;0;1;0;1;1;0
6139.0;2021;18;ORLEANS-TOURS;MASCULIN;FORMATION CONTINUE;BAC PROFESSIONNEL;BAC PRO PROD;BAC PRO 25007 MAINTENANCE EQUIPEMENTS INDUST.;12;12;12;0;0;0;0;12;0;2;2;6;2;0
6141.0;2021;18;ORLEANS-TOURS;MASCULIN;FORMATION CONTINUE;BAC PROFESSIONNEL;BAC PRO PROD;BAC PRO 25216 MAINT.VEHIC.OPTC MOTOCYCLES;1;1;1;0;0;0;0;1;0;1;0;0;0;0
6143.0;2021;18;ORLEANS-TOURS;MASCULIN;FORMATION CONTINUE;BAC PROFESSIONNEL;BAC PRO PROD;BAC PRO 25302 AERONAUTIQUE OPTION AVIONIQUE;13;13;11;2;0;0;0;11;0;3;4;4;0;2
6160.0;2021;18;ORLEANS-TOURS;MASCULIN;INDIVIDUEL;BAC PROFESSIONNEL;BAC PRO PROD;BAC PRO 25215 MAINT.VEHIC.OPTB VEHIC.TRANS.ROUT;1;1;1;0;0;0;0;1;0;0;0;0;1;0
6165.0;2021;18;ORLEANS-TOURS;MASCULIN;INDIVIDUEL;BAC PROFESSIONNEL;BAC PRO PROD;BAC PRO AG 21004 CGEA;15;11;11;0;0;0;0;11;0;0;0;0;11;0
6173.0;2021;18;ORLEANS-TOURS;MASCULIN;INDIVIDUEL;BAC PROFESSIONNEL;BAC PRO SERV;BAC PRO 31206 VENTE (PROSPECT.NEGO.SUIV.CLIENT;4;2;0;2;0;0;0;0;0;0;0;0;0;2
6180.0;2021;18;ORLEANS-TOURS;MASCULIN;INDIVIDUEL;BAC TECHNOLOGIQUE;BAC STI2D;BAC STI2D INNOVATION TECHNO.  ET ECO CONCEPTION;2;1;0;0;1;1;0;1;0;0;0;0;1;0
6184.0;2021;18;ORLEANS-TOURS;MASCULIN;INDIVIDUEL;BAC TECHNOLOGIQUE;BAC STMG;BAC STMG MERCATIQUE (MARKETING);15;10;3;6;1;0;1;3;0;0;0;0;3;7
6192.0;2021;18;ORLEANS-TOURS;MASCULIN;SCOLAIRE;BAC PROFESSIONNEL;BAC PRO PROD;BAC PRO 22303 FONDERIE;5;5;5;0;0;0;0;5;0;0;2;2;1;0
6200.0;2021;18;ORLEANS-TOURS;MASCULIN;SCOLAIRE;BAC PROFESSIONNEL;BAC PRO PROD;BAC PRO 23102 TRAVAUX PUBLICS;18;17;15;1;1;0;1;15;0;1;4;6;4;2
6201.0;2021;18;ORLEANS-TOURS;MASCULIN;SCOLAIRE;BAC PROFESSIONNEL;BAC PRO PROD;BACPRO 23103 TECHNICIEN GEOMETRE-TOPOGRAPHE;14;14;7;6;1;1;0;8;0;0;2;4;2;6
6202.0;2021;18;ORLEANS-TOURS;MASCULIN;SCOLAIRE;BAC PROFESSIONNEL;BAC PRO PROD;BAC PRO 23203 TECHNICIEN BAT. : ORG.REAL.GROS O;16;16;13;2;1;1;0;14;0;1;1;3;9;2
6216.0;2021;18;ORLEANS-TOURS;MASCULIN;SCOLAIRE;BAC PROFESSIONNEL;BAC PRO PROD;BAC PRO 25106 TECHNICIEN D'USINAGE;77;77;54;19;4;2;2;56;0;4;7;28;17;21
6217.0;2021;18;ORLEANS-TOURS;MASCULIN;SCOLAIRE;BAC PROFESSIONNEL;BAC PRO PROD;BAC PRO 25107 TECHNICIEN OUTILLEUR;12;12;10;0;2;2;0;12;0;0;4;3;5;0
6219.0;2021;18;ORLEANS-TOURS;MASCULIN;SCOLAIRE;BAC PROFESSIONNEL;BAC PRO PROD;BAC PRO 25214 MAINT.VEHIC.OPTA VOIT.PARTICUL.;191;191;148;34;9;2;7;150;0;12;39;51;48;41
6221.0;2021;18;ORLEANS-TOURS;MASCULIN;SCOLAIRE;BAC PROFESSIONNEL;BAC PRO PROD;BAC PRO 25216 MAINT.VEHIC.OPTC MOTOCYCLES;20;20;18;2;0;0;0;18;0;0;9;8;1;2
6227.0;2021;18;ORLEANS-TOURS;MASCULIN;SCOLAIRE;BAC PROFESSIONNEL;BAC PRO PROD;BAC PRO 25410 CONSTRUCTION DES CARROSSERIES;7;7;5;2;0;0;0;5;0;0;0;2;3;2
6229.0;2021;18;ORLEANS-TOURS;MASCULIN;SCOLAIRE;BAC PROFESSIONNEL;BAC PRO PROD;BAC PRO 25509 TECHNIC. FROID CONDITIONNEMT AIR;36;36;25;8;3;2;1;27;0;2;2;11;12;9
6239.0;2021;18;ORLEANS-TOURS;MASCULIN;SCOLAIRE;BAC PROFESSIONNEL;BAC PRO PROD;BAC PRO AG 21211 COND GEST ENTR HIPPIQUE;9;9;7;2;0;0;0;7;0;0;1;3;3;2
6244.0;2021;18;ORLEANS-TOURS;MASCULIN;SCOLAIRE;BAC PROFESSIONNEL;BAC PRO PROD;BAC PRO AG 21406 TEC CONS VTE PROD DES JARDINS;14;13;9;4;0;0;0;9;0;0;0;1;8;4
6247.0;2021;18;ORLEANS-TOURS;MASCULIN;SCOLAIRE;BAC PROFESSIONNEL;BAC PRO PROD;BAC PRO AG 22107 TEC CONS VTE ALIMENTATION P.ALIM;18;15;12;3;0;0;0;12;0;0;1;5;6;3
6250.0;2021;18;ORLEANS-TOURS;MASCULIN;SCOLAIRE;BAC PROFESSIONNEL;BAC PRO SERV;BAC PRO 31107 CONDUCT. TRANSP.ROUT.MARCHANDISES;53;53;48;3;2;2;0;50;0;8;13;19;10;3
6252.0;2021;18;ORLEANS-TOURS;MASCULIN;SCOLAIRE;BAC PROFESSIONNEL;BAC PRO SERV;BAC PRO 31202 COMMERCE;365;364;291;29;44;25;19;316;0;12;64;127;113;48
6265.0;2021;18;ORLEANS-TOURS;MASCULIN;SCOLAIRE;BAC PROFESSIONNEL;BAC PRO SERV;BAC PRO 34305 TECHN.D'INTERV.SUR INSTALL. NUCL.;11;11;11;0;0;0;0;11;0;0;1;3;7;0
6270.0;2021;18;ORLEANS-TOURS;MASCULIN;SCOLAIRE;BAC TECHNOLOGIQUE;BAC STAV;BAC STAV AGRONOMIE ALIM ENV TERRITOI;101;101;99;2;0;0;0;99;0;1;15;46;37;2
6272.0;2021;18;ORLEANS-TOURS;MASCULIN;SCOLAIRE;BAC TECHNOLOGIQUE;BAC STHR;BAC STHR SC.&TEC. HOTELLERIE-RESTAURATION;52;52;51;0;1;1;0;52;0;1;10;25;16;0
6280.0;2021;18;ORLEANS-TOURS;MASCULIN;SCOLAIRE;BAC TECHNOLOGIQUE;BAC STMG;BAC STMG MERCATIQUE (MARKETING);694;694;602;26;66;45;21;647;0;2;60;240;345;47
6290.0;2021;01;PARIS;FEMININ;APPRENTISSAGE;BAC PROFESSIONNEL;BAC PRO PROD;BAC PRO 25007 MAINTENANCE EQUIPEMENTS INDUST.;1;1;1;0;0;0;0;1;0;0;0;0;1;0
6296.0;2021;01;PARIS;FEMININ;APPRENTISSAGE;BAC PROFESSIONNEL;BAC PRO SERV;BAC PRO 31210 ACCUEIL -RELATION CLIENTS USAGERS;27;27;26;0;1;1;0;27;0;3;7;7;10;0
6305.0;2021;01;PARIS;FEMININ;ENSEIGNEMENT A DISTANCE;BAC GENERAL;BAC GENERAL;BAC GENE 10019 BAC GENERAL;55;55;55;0;0;0;0;55;2;15;16;14;8;0
6307.0;2021;01;PARIS;FEMININ;ENSEIGNEMENT A DISTANCE;BAC TECHNOLOGIQUE;BAC ST2S;BAC ST2S SCIENCES & TECHNO. SANTE & SOCIAL;1;1;1;0;0;0;0;1;0;0;0;1;0;0
6308.0;2021;01;PARIS;FEMININ;ENSEIGNEMENT A DISTANCE;BAC TECHNOLOGIQUE;BAC STMG;BAC STMG GESTION ET FINANCE;2;2;2;0;0;0;0;2;0;1;0;1;0;0
6310.0;2021;01;PARIS;FEMININ;ENSEIGNEMENT A DISTANCE;BAC TECHNOLOGIQUE;BAC STMG;BAC STMG RESSOURCES HUMAINES ET COMMUNICATION;1;1;1;0;0;0;0;1;0;1;0;0;0;0
6313.0;2021;01;PARIS;FEMININ;FORMATION CONTINUE;BAC PROFESSIONNEL;BAC PRO PROD;BAC PRO 25515 SYST.NUM.OPT.C RES.INF.SYST.COMM.;1;1;1;0;0;0;0;1;0;0;0;1;0;0
6317.0;2021;01;PARIS;FEMININ;FORMATION CONTINUE;BAC PROFESSIONNEL;BAC PRO SERV;BAC PRO 33102 PROTHESE DENTAIRE;5;5;2;2;1;1;0;3;0;0;0;2;1;2
6323.0;2021;01;PARIS;FEMININ;INDIVIDUEL;BAC PROFESSIONNEL;BAC PRO PROD;BAC PRO AG 21114 CONDUITE PRODUCTIONS HORTICOLES;7;7;7;0;0;0;0;7;0;0;0;0;7;0
6326.0;2021;01;PARIS;FEMININ;INDIVIDUEL;BAC PROFESSIONNEL;BAC PRO SERV;BAC PRO 31202 COMMERCE;4;4;2;1;1;0;1;2;0;0;0;0;2;2
6330.0;2021;01;PARIS;FEMININ;INDIVIDUEL;BAC PROFESSIONNEL;BAC PRO SERV;BAC PRO 32304 PHOTOGRAPHIE;1;0;0;0;0;0;0;0;0;0;0;0;0;0
6331.0;2021;01;PARIS;FEMININ;INDIVIDUEL;BAC PROFESSIONNEL;BAC PRO SERV;BAC PRO 33002 SERVICES DE PROXIMITE  VIE LOCAL;1;1;1;0;0;0;0;1;0;0;0;0;1;0
6332.0;2021;01;PARIS;FEMININ;INDIVIDUEL;BAC PROFESSIONNEL;BAC PRO SERV;BAC PRO 33004 ACC.SOINS-S.PERS. OPT.EN STRUCTUR;3;2;0;2;0;0;0;0;0;0;0;0;0;2
6335.0;2021;01;PARIS;FEMININ;INDIVIDUEL;BAC TECHNOLOGIQUE;BAC STAV;BAC STAV AGRONOMIE ALIM ENV TERRITOI;4;3;3;0;0;0;0;3;0;0;0;0;3;0
6346.0;2021;01;PARIS;FEMININ;SCOLAIRE;BAC PROFESSIONNEL;BAC PRO PROD;BAC PRO 23004 TECHN. ETUDES BAT.A ETUDES & ECO.;2;2;1;0;1;1;0;2;0;0;1;0;1;0
6348.0;2021;01;PARIS;FEMININ;SCOLAIRE;BAC PROFESSIONNEL;BAC PRO PROD;BAC PRO 23304 AMENAGEMENT FINITION BATIMENT;1;1;1;0;0;0;0;1;0;1;0;0;0;0
6349.0;2021;01;PARIS;FEMININ;SCOLAIRE;BAC PROFESSIONNEL;BAC PRO PROD;BAC PRO 23405 TECHNICIEN MENUISIER AGENCEUR;2;2;2;0;0;0;0;2;0;1;0;0;1;0
6350.0;2021;01;PARIS;FEMININ;SCOLAIRE;BAC PROFESSIONNEL;BAC PRO PROD;BAC PRO 23408 Etude et réalisation d'agencement;7;7;6;1;0;0;0;6;0;0;2;3;1;1
6356.0;2021;01;PARIS;FEMININ;SCOLAIRE;BAC PROFESSIONNEL;BAC PRO PROD;BAC PRO 25513 SYST.NUM.OPT.A SURETE SECURITE;2;2;2;0;0;0;0;2;0;0;1;1;0;0
6376.0;2021;01;PARIS;FEMININ;SCOLAIRE;BAC PROFESSIONNEL;BAC PRO SERV;BAC PRO 33103 TECHNICIEN APPAREIL. ORTHOPEDIQUE;7;7;4;1;2;2;0;6;0;0;0;1;5;1
6378.0;2021;01;PARIS;FEMININ;SCOLAIRE;BAC PROFESSIONNEL;BAC PRO SERV;BAC PRO 33602 PERRUQUIER POSTICHEUR;8;8;8;0;0;0;0;8;0;1;5;1;1;0
6379.0;2021;01;PARIS;FEMININ;SCOLAIRE;BAC PROFESSIONNEL;BAC PRO SERV;BAC PRO 33603 ESTHETIQUE COSMETIQUE PARFUMERIE;79;75;62;8;5;5;0;67;0;3;9;27;28;8
6380.0;2021;01;PARIS;FEMININ;SCOLAIRE;BAC PROFESSIONNEL;BAC PRO SERV;BAC PRO 34304 HYGIENE PROPRETE STERILISATION;4;4;4;0;0;0;0;4;0;0;0;0;4;0
6388.0;2021;01;PARIS;FEMININ;SCOLAIRE;BAC TECHNOLOGIQUE;BAC STI2D;BAC STI2D ENERGIES  ET ENVIRONNEMENT;8;8;8;0;0;0;0;8;0;1;0;2;5;0
6390.0;2021;01;PARIS;FEMININ;SCOLAIRE;BAC TECHNOLOGIQUE;BAC STI2D;BAC STI2D SYSTÈME D'INFORMATION  ET NUMERIQUE;17;17;16;1;0;0;0;16;0;1;6;7;2;1
6391.0;2021;01;PARIS;FEMININ;SCOLAIRE;BAC TECHNOLOGIQUE;BAC STL;BAC STL BIOCHIM.-BIOLOGIE-BIOTECHNOL.;70;70;66;0;4;2;2;68;0;3;12;34;19;2
6394.0;2021;01;PARIS;FEMININ;SCOLAIRE;BAC TECHNOLOGIQUE;BAC STMG;BAC STMG MERCATIQUE (MARKETING);399;398;382;2;14;7;7;389;0;9;79;175;126;9
6397.0;2021;01;PARIS;MASCULIN;APPRENTISSAGE;BAC PROFESSIONNEL;BAC PRO PROD;BAC PRO 22004 PROC. CHIMIE EAU PAPIERS-CARTONS;9;9;8;0;1;1;0;9;0;2;2;2;3;0
6406.0;2021;01;PARIS;MASCULIN;APPRENTISSAGE;BAC PROFESSIONNEL;BAC PRO PROD;BAC PRO 25411 TECH.CHAUDRONNERIE INDUSTRIELLE;16;16;12;3;1;0;1;12;0;0;1;7;4;4
6408.0;2021;01;PARIS;MASCULIN;APPRENTISSAGE;BAC PROFESSIONNEL;BAC PRO PROD;BAC PRO 25510 METIERS ELECT. ENVIRON. CONNECTES;143;141;123;12;6;5;1;128;0;7;34;58;29;13
6412.0;2021;01;PARIS;MASCULIN;APPRENTISSAGE;BAC PROFESSIONNEL;BAC PRO SERV;BAC PRO 31209 POISSONIER ECAILLER TRAITEUR;5;4;4;0;0;0;0;4;0;0;0;4;0;0
6415.0;2021;01;PARIS;MASCULIN;APPRENTISSAGE;BAC PROFESSIONNEL;BAC PRO SERV;BAC PRO 32208 REAL.PR.IMPR.PLURI.OPTB.PR.IMPR.;6;6;5;1;0;0;0;5;0;0;2;3;0;1
6418.0;2021;01;PARIS;MASCULIN;APPRENTISSAGE;BAC PROFESSIONNEL;BAC PRO SERV;BAC PRO 33403 COMMERC. SERVICES EN RESTAURATION;45;45;39;4;2;0;2;39;0;1;11;13;14;6
6422.0;2021;01;PARIS;MASCULIN;ENSEIGNEMENT A DISTANCE;BAC PROFESSIONNEL;BAC PRO SERV;BAC PRO 31202 COMMERCE;2;2;1;1;0;0;0;1;0;1;0;0;0;1
6424.0;2021;01;PARIS;MASCULIN;ENSEIGNEMENT A DISTANCE;BAC TECHNOLOGIQUE;BAC STMG;BAC STMG GESTION ET FINANCE;2;2;2;0;0;0;0;2;0;0;1;0;1;0
6425.0;2021;01;PARIS;MASCULIN;ENSEIGNEMENT A DISTANCE;BAC TECHNOLOGIQUE;BAC STMG;BAC STMG MERCATIQUE (MARKETING);2;1;1;0;0;0;0;1;0;0;0;0;1;0
6431.0;2021;01;PARIS;MASCULIN;FORMATION CONTINUE;BAC PROFESSIONNEL;BAC PRO PROD;BAC PRO 25214 MAINT.VEHIC.OPTA VOIT.PARTICUL.;9;9;9;0;0;0;0;9;0;2;3;2;2;0
6432.0;2021;01;PARIS;MASCULIN;FORMATION CONTINUE;BAC PROFESSIONNEL;BAC PRO PROD;BAC PRO 25509 TECHNIC. FROID CONDITIONNEMT AIR;7;7;7;0;0;0;0;7;0;1;4;0;2;0
6437.0;2021;01;PARIS;MASCULIN;FORMATION CONTINUE;BAC PROFESSIONNEL;BAC PRO SERV;BAC PRO 30001 GESTION-ADMINISTRATION;6;6;4;2;0;0;0;4;0;1;0;1;2;2
6439.0;2021;01;PARIS;MASCULIN;FORMATION CONTINUE;BAC PROFESSIONNEL;BAC PRO SERV;BAC PRO 33102 PROTHESE DENTAIRE;1;1;0;1;0;0;0;0;0;0;0;0;0;1
6440.0;2021;01;PARIS;MASCULIN;INDIVIDUEL;BAC GENERAL;BAC GENERAL;BAC GENE 10019 BAC GENERAL;535;482;364;51;67;55;12;419;2;19;56;129;213;63
6442.0;2021;01;PARIS;MASCULIN;INDIVIDUEL;BAC PROFESSIONNEL;BAC PRO PROD;BAC PRO 22703 TECHN.INSTALL.SYST.ENERG.CLIMATI;1;1;0;1;0;0;0;0;0;0;0;0;0;1
6447.0;2021;01;PARIS;MASCULIN;INDIVIDUEL;BAC PROFESSIONNEL;BAC PRO PROD;BAC PRO 25510 METIERS ELECT. ENVIRON. CONNECTES;19;13;11;0;2;2;0;13;0;2;1;2;8;0
6449.0;2021;01;PARIS;MASCULIN;INDIVIDUEL;BAC PROFESSIONNEL;BAC PRO PROD;BAC PRO AG 21004 CGEA;23;14;14;0;0;0;0;14;0;0;0;1;13;0
6456.0;2021;01;PARIS;MASCULIN;INDIVIDUEL;BAC PROFESSIONNEL;BAC PRO SERV;BAC PRO 31202 COMMERCE;11;5;2;2;1;0;1;2;0;0;0;0;2;3
6462.0;2021;01;PARIS;MASCULIN;INDIVIDUEL;BAC TECHNOLOGIQUE;BAC ST2S;BAC ST2S SCIENCES & TECHNO. SANTE & SOCIAL;2;1;0;1;0;0;0;0;0;0;0;0;0;1
6465.0;2021;01;PARIS;MASCULIN;INDIVIDUEL;BAC TECHNOLOGIQUE;BAC STI2D;BAC STI2D ENERGIES  ET ENVIRONNEMENT;2;2;0;2;0;0;0;0;0;0;0;0;0;2
6466.0;2021;01;PARIS;MASCULIN;INDIVIDUEL;BAC TECHNOLOGIQUE;BAC STI2D;BAC STI2D SYSTÈME D'INFORMATION  ET NUMERIQUE;2;1;0;1;0;0;0;0;0;0;0;0;0;1
6472.0;2021;01;PARIS;MASCULIN;SCOLAIRE;BAC PROFESSIONNEL;BAC PRO PROD;BACPRO 20002 ETUD.DEFINITION PRDTS INDUSTRIEL;10;10;5;3;2;2;0;7;0;0;1;0;6;3
6480.0;2021;01;PARIS;MASCULIN;SCOLAIRE;BAC PROFESSIONNEL;BAC PRO PROD;BAC PRO 22704 TECHN. MAINT. SYST.ENERG.CLIMATI;14;14;8;4;2;0;2;8;0;0;1;6;1;6
6481.0;2021;01;PARIS;MASCULIN;SCOLAIRE;BAC PROFESSIONNEL;BAC PRO PROD;BAC PRO 23003 ARTIS. & M.ART:MARCHANDISAGE VIS.;8;8;7;1;0;0;0;7;0;0;1;4;2;1
6482.0;2021;01;PARIS;MASCULIN;SCOLAIRE;BAC PROFESSIONNEL;BAC PRO PROD;BAC PRO 23004 TECHN. ETUDES BAT.A ETUDES & ECO.;14;14;10;2;2;2;0;12;0;0;2;1;9;2
6503.0;2021;01;PARIS;MASCULIN;SCOLAIRE;BAC PROFESSIONNEL;BAC PRO PROD;BAC PRO 25509 TECHNIC. FROID CONDITIONNEMT AIR;21;21;11;8;2;1;1;12;0;1;0;5;6;9
6504.0;2021;01;PARIS;MASCULIN;SCOLAIRE;BAC PROFESSIONNEL;BAC PRO PROD;BAC PRO 25510 METIERS ELECT. ENVIRON. CONNECTES;257;256;219;22;15;8;7;227;0;21;45;84;77;29
6506.0;2021;01;PARIS;MASCULIN;SCOLAIRE;BAC PROFESSIONNEL;BAC PRO PROD;BAC PRO 25514 SYST.NUM.OPT.B AUD.RES.EQUIP.DOM.;72;72;65;4;3;3;0;68;0;1;22;23;22;4
6507.0;2021;01;PARIS;MASCULIN;SCOLAIRE;BAC PROFESSIONNEL;BAC PRO PROD;BAC PRO 25515 SYST.NUM.OPT.C RES.INF.SYST.COMM.;180;180;162;8;10;7;3;169;0;11;35;55;68;11
6512.0;2021;01;PARIS;MASCULIN;SCOLAIRE;BAC PROFESSIONNEL;BAC PRO SERV;BAC PRO 31108 TRANSPORT;27;27;19;7;1;1;0;20;0;0;5;7;8;7
6517.0;2021;01;PARIS;MASCULIN;SCOLAIRE;BAC PROFESSIONNEL;BAC PRO SERV;BAC PRO 32207 REAL.PR.IMPR.PLURI.OPTA.PR.GRAPH.;16;16;13;2;1;1;0;14;0;0;0;11;3;2
6523.0;2021;01;PARIS;MASCULIN;SCOLAIRE;BAC PROFESSIONNEL;BAC PRO SERV;BAC PRO 33004 ACC.SOINS-S.PERS. OPT.EN STRUCTUR;13;13;12;1;0;0;0;12;0;0;5;3;4;1
6526.0;2021;01;PARIS;MASCULIN;SCOLAIRE;BAC PROFESSIONNEL;BAC PRO SERV;BAC PRO 33103 TECHNICIEN APPAREIL. ORTHOPEDIQUE;9;9;8;1;0;0;0;8;0;0;0;2;6;1
6533.0;2021;01;PARIS;MASCULIN;SCOLAIRE;BAC TECHNOLOGIQUE;BAC STD2A;BAC STD2A SCIENCES & TECHNO. DESIGN-ARTS APPLIQUES;62;62;60;0;2;2;0;62;0;5;16;28;13;0
6537.0;2021;01;PARIS;MASCULIN;SCOLAIRE;BAC TECHNOLOGIQUE;BAC STI2D;BAC STI2D INNOVATION TECHNO.  ET ECO CONCEPTION;186;186;165;6;15;11;4;176;0;5;28;69;74;10
6540.0;2021;01;PARIS;MASCULIN;SCOLAIRE;BAC TECHNOLOGIQUE;BAC STL;BAC STL SCIENCES PHYSIQUES CHIMIQUES  EN LABORAT.;35;35;25;4;6;1;5;26;0;0;6;5;15;9
6545.0;2021;13;POITIERS;FEMININ;APPRENTISSAGE;BAC PROFESSIONNEL;BAC PRO PROD;BAC PRO 20102 PILOTE DE LIGNE DE PRODUCTION;3;3;3;0;0;0;0;3;0;1;1;0;1;0
6552.0;2021;13;POITIERS;FEMININ;APPRENTISSAGE;BAC PROFESSIONNEL;BAC PRO PROD;BAC PRO 25304 AERONAUTIQUE OPTION STRUCTURE;2;2;2;0;0;0;0;2;0;0;1;1;0;0
6553.0;2021;13;POITIERS;FEMININ;APPRENTISSAGE;BAC PROFESSIONNEL;BAC PRO PROD;BAC PRO 25510 METIERS ELECT. ENVIRON. CONNECTES;1;1;1;0;0;0;0;1;0;0;0;0;1;0
6556.0;2021;13;POITIERS;FEMININ;APPRENTISSAGE;BAC PROFESSIONNEL;BAC PRO PROD;BAC PRO AG 21210 COND GEST ENTR CANIN ET FELIN;3;3;2;1;0;0;0;2;0;0;1;0;1;1
6560.0;2021;13;POITIERS;FEMININ;APPRENTISSAGE;BAC PROFESSIONNEL;BAC PRO SERV;BAC PRO 31202 COMMERCE;90;86;73;8;5;4;1;77;0;0;16;27;34;9
6563.0;2021;13;POITIERS;FEMININ;APPRENTISSAGE;BAC PROFESSIONNEL;BAC PRO SERV;BAC PRO 32208 REAL.PR.IMPR.PLURI.OPTB.PR.IMPR.;1;1;1;0;0;0;0;1;0;0;1;0;0;0
6564.0;2021;13;POITIERS;FEMININ;APPRENTISSAGE;BAC PROFESSIONNEL;BAC PRO SERV;BAC PRO 33004 ACC.SOINS-S.PERS. OPT.EN STRUCTUR;3;3;2;1;0;0;0;2;0;0;0;2;0;1
6568.0;2021;13;POITIERS;FEMININ;APPRENTISSAGE;BAC PROFESSIONNEL;BAC PRO SERV;BAC PRO 34303 GEST. POLLUTIONS PROTEC. ENVIRON.;1;1;1;0;0;0;0;1;0;0;0;1;0;0
6583.0;2021;13;POITIERS;FEMININ;INDIVIDUEL;BAC PROFESSIONNEL;BAC PRO PROD;BAC PRO AG 21004 CGEA;2;1;1;0;0;0;0;1;0;0;0;0;1;0
6606.0;2021;13;POITIERS;FEMININ;SCOLAIRE;BAC PROFESSIONNEL;BAC PRO PROD;BAC PRO 23004 TECHN. ETUDES BAT.A ETUDES & ECO.;9;9;5;3;1;1;0;6;0;0;1;2;3;3
6607.0;2021;13;POITIERS;FEMININ;SCOLAIRE;BAC PROFESSIONNEL;BAC PRO PROD;BAC PRO 23005 TECHN. ETUDES BAT B ASSIST.ARCHI.;25;25;21;2;2;1;1;22;0;2;2;11;7;3
6616.0;2021;13;POITIERS;FEMININ;SCOLAIRE;BAC PROFESSIONNEL;BAC PRO PROD;BAC PRO 25215 MAINT.VEHIC.OPTB VEHIC.TRANS.ROUT;1;1;1;0;0;0;0;1;0;0;0;1;0;0
6627.0;2021;13;POITIERS;FEMININ;SCOLAIRE;BAC PROFESSIONNEL;BAC PRO PROD;BAC PRO AG 21113 CGEVV;2;2;2;0;0;0;0;2;0;0;1;0;1;0
6630.0;2021;13;POITIERS;FEMININ;SCOLAIRE;BAC PROFESSIONNEL;BAC PRO PROD;BAC PRO AG 21204 PROD-AQUACOLES;1;1;0;1;0;0;0;0;0;0;0;0;0;1
6641.0;2021;13;POITIERS;FEMININ;SCOLAIRE;BAC PROFESSIONNEL;BAC PRO SERV;BAC PRO 31106 LOGISTIQUE;9;9;6;2;1;1;0;7;0;0;1;3;3;2
6642.0;2021;13;POITIERS;FEMININ;SCOLAIRE;BAC PROFESSIONNEL;BAC PRO SERV;BAC PRO 31107 CONDUCT. TRANSP.ROUT.MARCHANDISES;8;8;7;0;1;1;0;8;0;0;2;1;5;0
6652.0;2021;13;POITIERS;FEMININ;SCOLAIRE;BAC PROFESSIONNEL;BAC PRO SERV;BAC PRO 33004 ACC.SOINS-S.PERS. OPT.EN STRUCTUR;301;301;281;8;12;7;5;288;0;24;86;89;89;13
6659.0;2021;13;POITIERS;FEMININ;SCOLAIRE;BAC TECHNOLOGIQUE;BAC ST2S;BAC ST2S SCIENCES & TECHNO. SANTE & SOCIAL;415;415;390;2;23;8;15;398;0;12;78;167;141;17
6663.0;2021;13;POITIERS;FEMININ;SCOLAIRE;BAC TECHNOLOGIQUE;BAC STI2D;BAC STI2D ARCHITECTURE ET CONSTRUCTION;17;17;17;0;0;0;0;17;0;0;7;9;1;0
6664.0;2021;13;POITIERS;FEMININ;SCOLAIRE;BAC TECHNOLOGIQUE;BAC STI2D;BAC STI2D ENERGIES  ET ENVIRONNEMENT;5;5;4;1;0;0;0;4;0;0;0;1;3;1
6665.0;2021;13;POITIERS;FEMININ;SCOLAIRE;BAC TECHNOLOGIQUE;BAC STI2D;BAC STI2D INNOVATION TECHNO.  ET ECO CONCEPTION;11;11;11;0;0;0;0;11;0;0;4;7;0;0
6671.0;2021;13;POITIERS;FEMININ;SCOLAIRE;BAC TECHNOLOGIQUE;BAC STMG;BAC STMG RESSOURCES HUMAINES ET COMMUNICATION;299;299;271;4;24;14;10;285;0;1;34;97;153;14
6672.0;2021;13;POITIERS;FEMININ;SCOLAIRE;BAC TECHNOLOGIQUE;BAC STMG;BAC STMG SYSTEMES D'INFORMATION DE GESTION;2;2;2;0;0;0;0;2;0;1;0;0;1;0
6673.0;2021;13;POITIERS;MASCULIN;APPRENTISSAGE;BAC PROFESSIONNEL;BAC PRO PROD;BAC PRO 20102 PILOTE DE LIGNE DE PRODUCTION;4;2;2;0;0;0;0;2;0;1;0;0;1;0
6674.0;2021;13;POITIERS;MASCULIN;APPRENTISSAGE;BAC PROFESSIONNEL;BAC PRO PROD;BAC PRO 22004 PROC. CHIMIE EAU PAPIERS-CARTONS;7;7;7;0;0;0;0;7;0;0;2;2;3;0
6677.0;2021;13;POITIERS;MASCULIN;APPRENTISSAGE;BAC PROFESSIONNEL;BAC PRO PROD;BAC PRO 22704 TECHN. MAINT. SYST.ENERG.CLIMATI;13;13;11;2;0;0;0;11;0;0;5;3;3;2
6678.0;2021;13;POITIERS;MASCULIN;APPRENTISSAGE;BAC PROFESSIONNEL;BAC PRO PROD;BAC PRO 23102 TRAVAUX PUBLICS;14;14;13;0;1;0;1;13;0;1;5;4;3;1
6681.0;2021;13;POITIERS;MASCULIN;APPRENTISSAGE;BAC PROFESSIONNEL;BAC PRO PROD;BAC PRO 23404 TECHNICIEN CONSTRUCTEUR BOIS;6;6;3;1;2;1;1;4;0;0;2;1;1;2
6684.0;2021;13;POITIERS;MASCULIN;APPRENTISSAGE;BAC PROFESSIONNEL;BAC PRO PROD;BAC PRO 25007 MAINTENANCE EQUIPEMENTS INDUST.;10;10;8;2;0;0;0;8;0;0;3;4;1;2
6714.0;2021;13;POITIERS;MASCULIN;APPRENTISSAGE;BAC PROFESSIONNEL;BAC PRO SERV;BAC PRO 34303 GEST. POLLUTIONS PROTEC. ENVIRON.;4;4;4;0;0;0;0;4;0;1;0;1;2;0
6716.0;2021;13;POITIERS;MASCULIN;ENSEIGNEMENT A DISTANCE;BAC PROFESSIONNEL;BAC PRO SERV;BAC PRO 30001 GESTION-ADMINISTRATION;1;1;1;0;0;0;0;1;0;0;0;0;1;0
6719.0;2021;13;POITIERS;MASCULIN;ENSEIGNEMENT A DISTANCE;BAC TECHNOLOGIQUE;BAC STMG;BAC STMG MERCATIQUE (MARKETING);6;6;6;0;0;0;0;6;0;0;2;4;0;0
6721.0;2021;13;POITIERS;MASCULIN;FORMATION CONTINUE;BAC PROFESSIONNEL;BAC PRO PROD;BAC PRO 25411 TECH.CHAUDRONNERIE INDUSTRIELLE;1;1;1;0;0;0;0;1;0;0;0;1;0;0
6729.0;2021;13;POITIERS;MASCULIN;INDIVIDUEL;BAC PROFESSIONNEL;BAC PRO PROD;BAC PRO AG 21004 CGEA;2;1;1;0;0;0;0;1;0;0;0;0;1;0
6735.0;2021;13;POITIERS;MASCULIN;INDIVIDUEL;BAC TECHNOLOGIQUE;BAC STI2D;BAC STI2D SYSTÈME D'INFORMATION  ET NUMERIQUE;1;1;1;0;0;0;0;1;0;0;0;0;1;0
6741.0;2021;13;POITIERS;MASCULIN;SCOLAIRE;BAC PROFESSIONNEL;BAC PRO PROD;BACPRO 20002 ETUD.DEFINITION PRDTS INDUSTRIEL;9;9;6;2;1;1;0;7;0;0;0;5;2;2
6742.0;2021;13;POITIERS;MASCULIN;SCOLAIRE;BAC PROFESSIONNEL;BAC PRO PROD;BAC PRO 20102 PILOTE DE LIGNE DE PRODUCTION;22;21;19;2;0;0;0;19;0;0;8;8;3;2
6750.0;2021;13;POITIERS;MASCULIN;SCOLAIRE;BAC PROFESSIONNEL;BAC PRO PROD;BAC PRO 23004 TECHN. ETUDES BAT.A ETUDES & ECO.;24;24;19;2;3;3;0;22;0;0;2;7;13;2
6763.0;2021;13;POITIERS;MASCULIN;SCOLAIRE;BAC PROFESSIONNEL;BAC PRO PROD;BAC PRO 25006 MICROTECHNIQUES;14;14;12;2;0;0;0;12;0;0;1;3;8;2
6772.0;2021;13;POITIERS;MASCULIN;SCOLAIRE;BAC PROFESSIONNEL;BAC PRO PROD;BAC PRO 25220 MAINT.MATERIELS OPT.B TP MANUT.;18;18;8;8;2;1;1;9;0;0;1;3;5;9
6774.0;2021;13;POITIERS;MASCULIN;SCOLAIRE;BAC PROFESSIONNEL;BAC PRO PROD;BAC PRO 25302 AERONAUTIQUE OPTION AVIONIQUE;18;18;18;0;0;0;0;18;0;2;8;7;1;0
6775.0;2021;13;POITIERS;MASCULIN;SCOLAIRE;BAC PROFESSIONNEL;BAC PRO PROD;BAC PRO 25303 AERONAUTIQUE OPTION SYSTEMES;33;33;32;1;0;0;0;32;0;3;14;15;0;1
6777.0;2021;13;POITIERS;MASCULIN;SCOLAIRE;BAC PROFESSIONNEL;BAC PRO PROD;BAC PRO 25408 REPARATION DES CARROSSERIES;12;12;9;2;1;1;0;10;0;1;2;3;4;2
6786.0;2021;13;POITIERS;MASCULIN;SCOLAIRE;BAC PROFESSIONNEL;BAC PRO PROD;BAC PRO AG 21113 CGEVV;28;28;25;3;0;0;0;25;0;0;3;10;12;3
6787.0;2021;13;POITIERS;MASCULIN;SCOLAIRE;BAC PROFESSIONNEL;BAC PRO PROD;BAC PRO AG 21114 CONDUITE PRODUCTIONS HORTICOLES;20;20;16;4;0;0;0;16;0;1;2;2;11;4
6788.0;2021;13;POITIERS;MASCULIN;SCOLAIRE;BAC PROFESSIONNEL;BAC PRO PROD;BAC PRO AG 21203 TECHN CONSEIL DE VENTE ANIMAL;19;19;19;0;0;0;0;19;0;1;1;2;15;0
6803.0;2021;13;POITIERS;MASCULIN;SCOLAIRE;BAC PROFESSIONNEL;BAC PRO SERV;BAC PRO 31202 COMMERCE;199;199;174;10;15;8;7;182;0;9;36;82;55;17
6804.0;2021;13;POITIERS;MASCULIN;SCOLAIRE;BAC PROFESSIONNEL;BAC PRO SERV;BAC PRO 31206 VENTE (PROSPECT.NEGO.SUIV.CLIENT;99;98;81;14;3;3;0;84;0;2;11;34;37;14
6807.0;2021;13;POITIERS;MASCULIN;SCOLAIRE;BAC PROFESSIONNEL;BAC PRO SERV;BAC PRO 32208 REAL.PR.IMPR.PLURI.OPTB.PR.IMPR.;6;6;5;1;0;0;0;5;0;0;2;0;3;1
6808.0;2021;13;POITIERS;MASCULIN;SCOLAIRE;BAC PROFESSIONNEL;BAC PRO SERV;BAC PRO 32303 ART.& MET.ART:COM.VIS.VIS.PLURI-M;20;20;15;4;1;1;0;16;0;0;5;6;5;4
6812.0;2021;13;POITIERS;MASCULIN;SCOLAIRE;BAC PROFESSIONNEL;BAC PRO SERV;BAC PRO 33403 COMMERC. SERVICES EN RESTAURATION;35;35;29;2;4;3;1;32;0;0;8;8;16;3
6824.0;2021;13;POITIERS;MASCULIN;SCOLAIRE;BAC TECHNOLOGIQUE;BAC STL;BAC STL BIOCHIM.-BIOLOGIE-BIOTECHNOL.;51;51;45;1;5;3;2;48;0;4;3;19;22;3
6827.0;2021;13;POITIERS;MASCULIN;SCOLAIRE;BAC TECHNOLOGIQUE;BAC STMG;BAC STMG MERCATIQUE (MARKETING);496;496;432;12;52;31;21;463;0;6;57;186;214;33
6828.0;2021;13;POITIERS;MASCULIN;SCOLAIRE;BAC TECHNOLOGIQUE;BAC STMG;BAC STMG RESSOURCES HUMAINES ET COMMUNICATION;134;133;111;6;16;11;5;122;0;2;8;43;69;11
6832.0;2021;19;REIMS;FEMININ;APPRENTISSAGE;BAC PROFESSIONNEL;BAC PRO PROD;BAC PRO 23004 TECHN. ETUDES BAT.A ETUDES & ECO.;1;1;0;1;0;0;0;0;0;0;0;0;0;1
6834.0;2021;19;REIMS;FEMININ;APPRENTISSAGE;BAC PROFESSIONNEL;BAC PRO PROD;BAC PRO 25215 MAINT.VEHIC.OPTB VEHIC.TRANS.ROUT;1;1;1;0;0;0;0;1;0;0;0;1;0;0
6835.0;2021;19;REIMS;FEMININ;APPRENTISSAGE;BAC PROFESSIONNEL;BAC PRO PROD;BAC PRO 25411 TECH.CHAUDRONNERIE INDUSTRIELLE;2;2;0;1;1;1;0;1;0;0;0;0;1;1
6838.0;2021;19;REIMS;FEMININ;APPRENTISSAGE;BAC PROFESSIONNEL;BAC PRO PROD;BAC PRO AG 21211 COND GEST ENTR HIPPIQUE;8;8;5;3;0;0;0;5;0;0;1;2;2;3
6839.0;2021;19;REIMS;FEMININ;APPRENTISSAGE;BAC PROFESSIONNEL;BAC PRO SERV;BAC PRO 30001 GESTION-ADMINISTRATION;2;2;2;0;0;0;0;2;0;0;1;0;1;0
6842.0;2021;19;REIMS;FEMININ;APPRENTISSAGE;BAC PROFESSIONNEL;BAC PRO SERV;BAC PRO 31210 ACCUEIL -RELATION CLIENTS USAGERS;1;1;1;0;0;0;0;1;0;0;1;0;0;0
6844.0;2021;19;REIMS;FEMININ;APPRENTISSAGE;BAC PROFESSIONNEL;BAC PRO SERV;BAC PRO 33603 ESTHETIQUE COSMETIQUE PARFUMERIE;2;2;2;0;0;0;0;2;0;0;1;1;0;0
6852.0;2021;19;REIMS;FEMININ;ENSEIGNEMENT A DISTANCE;BAC TECHNOLOGIQUE;BAC STMG;BAC STMG GESTION ET FINANCE;2;2;2;0;0;0;0;2;0;0;0;1;1;0
6853.0;2021;19;REIMS;FEMININ;ENSEIGNEMENT A DISTANCE;BAC TECHNOLOGIQUE;BAC STMG;BAC STMG MERCATIQUE (MARKETING);3;3;3;0;0;0;0;3;0;0;1;1;1;0
6854.0;2021;19;REIMS;FEMININ;FORMATION CONTINUE;BAC PROFESSIONNEL;BAC PRO PROD;BAC PRO 23004 TECHN. ETUDES BAT.A ETUDES & ECO.;1;1;1;0;0;0;0;1;0;0;1;0;0;0
6858.0;2021;19;REIMS;FEMININ;FORMATION CONTINUE;BAC PROFESSIONNEL;BAC PRO PROD;BAC PRO 24302 METIERS DU CUIR : MAROQUINERIE;2;1;1;0;0;0;0;1;0;0;0;1;0;0
6859.0;2021;19;REIMS;FEMININ;FORMATION CONTINUE;BAC PROFESSIONNEL;BAC PRO PROD;BAC PRO 25007 MAINTENANCE EQUIPEMENTS INDUST.;1;1;1;0;0;0;0;1;0;0;0;0;1;0
6883.0;2021;19;REIMS;FEMININ;SCOLAIRE;BAC PROFESSIONNEL;BAC PRO PROD;BAC PRO 22003 BIO-INDUSTRIES DE TRANSFORMATION;9;9;9;0;0;0;0;9;0;0;3;1;5;0
6885.0;2021;19;REIMS;FEMININ;SCOLAIRE;BAC PROFESSIONNEL;BAC PRO PROD;BAC PRO 22106 CUISINE;46;46;44;0;2;2;0;46;0;4;9;16;17;0
6889.0;2021;19;REIMS;FEMININ;SCOLAIRE;BAC PROFESSIONNEL;BAC PRO PROD;BAC PRO 23304 AMENAGEMENT FINITION BATIMENT;4;4;4;0;0;0;0;4;0;0;1;3;0;0
6890.0;2021;19;REIMS;FEMININ;SCOLAIRE;BAC PROFESSIONNEL;BAC PRO PROD;BAC PRO 23404 TECHNICIEN CONSTRUCTEUR BOIS;1;1;1;0;0;0;0;1;0;0;0;1;0;0
6902.0;2021;19;REIMS;FEMININ;SCOLAIRE;BAC PROFESSIONNEL;BAC PRO PROD;BAC PRO 25510 METIERS ELECT. ENVIRON. CONNECTES;5;5;5;0;0;0;0;5;0;0;0;3;2;0
6904.0;2021;19;REIMS;FEMININ;SCOLAIRE;BAC PROFESSIONNEL;BAC PRO PROD;BAC PRO 25514 SYST.NUM.OPT.B AUD.RES.EQUIP.DOM.;2;2;2;0;0;0;0;2;0;0;0;1;1;0
6913.0;2021;19;REIMS;FEMININ;SCOLAIRE;BAC PROFESSIONNEL;BAC PRO PROD;BAC PRO AG 21405 AMENAGEMENTS PAYSAGERS;7;6;5;1;0;0;0;5;0;0;1;3;1;1
6915.0;2021;19;REIMS;FEMININ;SCOLAIRE;BAC PROFESSIONNEL;BAC PRO PROD;BAC PRO AG 22106 TEC CONS VTE ALIMENTATION VINS SP;5;5;5;0;0;0;0;5;0;0;3;2;0;0
6917.0;2021;19;REIMS;FEMININ;SCOLAIRE;BAC PROFESSIONNEL;BAC PRO SERV;BAC PRO 30001 GESTION-ADMINISTRATION;263;263;194;37;32;22;10;216;0;5;29;67;115;47
6919.0;2021;19;REIMS;FEMININ;SCOLAIRE;BAC PROFESSIONNEL;BAC PRO SERV;BAC PRO 31107 CONDUCT. TRANSP.ROUT.MARCHANDISES;7;7;7;0;0;0;0;7;0;0;2;3;2;0
6920.0;2021;19;REIMS;FEMININ;SCOLAIRE;BAC PROFESSIONNEL;BAC PRO SERV;BAC PRO 31108 TRANSPORT;6;6;4;0;2;2;0;6;0;1;0;2;3;0
6931.0;2021;19;REIMS;FEMININ;SCOLAIRE;BAC PROFESSIONNEL;BAC PRO SERV;BAC PRO 33102 PROTHESE DENTAIRE;3;3;3;0;0;0;0;3;0;0;0;1;2;0
6940.0;2021;19;REIMS;FEMININ;SCOLAIRE;BAC TECHNOLOGIQUE;BAC ST2S;BAC ST2S SCIENCES & TECHNO. SANTE & SOCIAL;337;337;310;1;26;11;15;321;0;9;41;150;121;16
6950.0;2021;19;REIMS;FEMININ;SCOLAIRE;BAC TECHNOLOGIQUE;BAC STMG;BAC STMG GESTION ET FINANCE;125;125;119;1;5;4;1;123;0;2;22;50;49;2
6952.0;2021;19;REIMS;FEMININ;SCOLAIRE;BAC TECHNOLOGIQUE;BAC STMG;BAC STMG RESSOURCES HUMAINES ET COMMUNICATION;325;325;274;13;38;26;12;300;0;6;37;117;140;25
6961.0;2021;19;REIMS;MASCULIN;APPRENTISSAGE;BAC PROFESSIONNEL;BAC PRO PROD;BAC PRO 23303 MENUISERIE ALUMINIUM-VERRE;4;4;2;1;1;0;1;2;0;0;0;1;1;2
6962.0;2021;19;REIMS;MASCULIN;APPRENTISSAGE;BAC PROFESSIONNEL;BAC PRO PROD;BAC PRO 23304 AMENAGEMENT FINITION BATIMENT;1;1;1;0;0;0;0;1;0;0;0;1;0;0
6966.0;2021;19;REIMS;MASCULIN;APPRENTISSAGE;BAC PROFESSIONNEL;BAC PRO PROD;BAC PRO 25106 TECHNICIEN D'USINAGE;16;16;13;2;1;0;1;13;0;0;4;6;3;3
6968.0;2021;19;REIMS;MASCULIN;APPRENTISSAGE;BAC PROFESSIONNEL;BAC PRO PROD;BAC PRO 25214 MAINT.VEHIC.OPTA VOIT.PARTICUL.;50;50;41;6;3;2;1;43;0;3;6;18;16;7
6972.0;2021;19;REIMS;MASCULIN;APPRENTISSAGE;BAC PROFESSIONNEL;BAC PRO PROD;BAC PRO 25220 MAINT.MATERIELS OPT.B TP MANUT.;15;14;8;6;0;0;0;8;0;0;1;2;5;6
6974.0;2021;19;REIMS;MASCULIN;APPRENTISSAGE;BAC PROFESSIONNEL;BAC PRO PROD;BAC PRO 25408 REPARATION DES CARROSSERIES;7;7;6;1;0;0;0;6;0;0;0;3;3;1
6993.0;2021;19;REIMS;MASCULIN;FORMATION CONTINUE;BAC PROFESSIONNEL;BAC PRO PROD;BAC PRO 22303 FONDERIE;1;1;1;0;0;0;0;1;0;0;1;0;0;0
6997.0;2021;19;REIMS;MASCULIN;FORMATION CONTINUE;BAC PROFESSIONNEL;BAC PRO PROD;BAC PRO 25510 METIERS ELECT. ENVIRON. CONNECTES;2;2;2;0;0;0;0;2;0;0;1;0;1;0
7002.0;2021;19;REIMS;MASCULIN;INDIVIDUEL;BAC GENERAL;BAC GENERAL;BAC GENE 10019 BAC GENERAL;22;21;5;12;4;1;3;6;0;0;0;2;4;15
7012.0;2021;19;REIMS;MASCULIN;INDIVIDUEL;BAC TECHNOLOGIQUE;BAC STMG;BAC STMG GESTION ET FINANCE;2;2;0;2;0;0;0;0;0;0;0;0;0;2
7015.0;2021;19;REIMS;MASCULIN;SCOLAIRE;BAC GENERAL;BAC GENERAL;BAC GENE 10019 BAC GENERAL;2832;2832;2596;46;190;110;80;2706;34;221;599;950;902;126
7018.0;2021;19;REIMS;MASCULIN;SCOLAIRE;BAC PROFESSIONNEL;BAC PRO PROD;BAC PRO 22003 BIO-INDUSTRIES DE TRANSFORMATION;9;9;6;1;2;2;0;8;0;0;2;1;5;1
7020.0;2021;19;REIMS;MASCULIN;SCOLAIRE;BAC PROFESSIONNEL;BAC PRO PROD;BAC PRO 22106 CUISINE;60;60;52;3;5;4;1;56;0;1;13;27;15;4
7024.0;2021;19;REIMS;MASCULIN;SCOLAIRE;BAC PROFESSIONNEL;BAC PRO PROD;BAC PRO 22703 TECHN.INSTALL.SYST.ENERG.CLIMATI;19;18;9;6;3;2;1;11;0;1;0;4;6;7
7027.0;2021;19;REIMS;MASCULIN;SCOLAIRE;BAC PROFESSIONNEL;BAC PRO PROD;BAC PRO 23005 TECHN. ETUDES BAT B ASSIST.ARCHI.;23;23;17;5;1;1;0;18;0;1;5;9;3;5
7030.0;2021;19;REIMS;MASCULIN;SCOLAIRE;BAC PROFESSIONNEL;BAC PRO PROD;BAC PRO 23203 TECHNICIEN BAT. : ORG.REAL.GROS O;9;9;5;3;1;0;1;5;0;1;0;2;2;4
7031.0;2021;19;REIMS;MASCULIN;SCOLAIRE;BAC PROFESSIONNEL;BAC PRO PROD;BAC PRO 23303 MENUISERIE ALUMINIUM-VERRE;7;7;1;4;2;1;1;2;0;0;0;0;2;5
7035.0;2021;19;REIMS;MASCULIN;SCOLAIRE;BAC PROFESSIONNEL;BAC PRO PROD;BAC PRO 24202 ARTIS.& MET.ART : TAPIS.D'AMEUBL;1;1;1;0;0;0;0;1;0;1;0;0;0;0
7046.0;2021;19;REIMS;MASCULIN;SCOLAIRE;BAC PROFESSIONNEL;BAC PRO PROD;BAC PRO 25411 TECH.CHAUDRONNERIE INDUSTRIELLE;34;33;27;4;2;1;1;28;0;3;4;8;13;5
7047.0;2021;19;REIMS;MASCULIN;SCOLAIRE;BAC PROFESSIONNEL;BAC PRO PROD;BAC PRO 25509 TECHNIC. FROID CONDITIONNEMT AIR;18;18;12;6;0;0;0;12;0;0;3;4;5;6
7048.0;2021;19;REIMS;MASCULIN;SCOLAIRE;BAC PROFESSIONNEL;BAC PRO PROD;BAC PRO 25510 METIERS ELECT. ENVIRON. CONNECTES;227;227;165;54;8;8;0;173;0;8;36;62;67;54
7051.0;2021;19;REIMS;MASCULIN;SCOLAIRE;BAC PROFESSIONNEL;BAC PRO PROD;BAC PRO 25515 SYST.NUM.OPT.C RES.INF.SYST.COMM.;87;87;78;8;1;0;1;78;0;3;28;25;22;9
7057.0;2021;19;REIMS;MASCULIN;SCOLAIRE;BAC PROFESSIONNEL;BAC PRO PROD;BAC PRO AG 21210 COND GEST ENTR CANIN ET FELIN;8;8;8;0;0;0;0;8;0;0;2;3;3;0
7074.0;2021;19;REIMS;MASCULIN;SCOLAIRE;BAC PROFESSIONNEL;BAC PRO SERV;BAC PRO 33002 SERVICES DE PROXIMITE  VIE LOCAL;5;5;4;0;1;1;0;5;0;0;2;0;3;0
7081.0;2021;19;REIMS;MASCULIN;SCOLAIRE;BAC PROFESSIONNEL;BAC PRO SERV;BAC PRO 34305 TECHN.D'INTERV.SUR INSTALL. NUCL.;10;10;10;0;0;0;0;10;0;0;2;2;6;0
7085.0;2021;19;REIMS;MASCULIN;SCOLAIRE;BAC TECHNOLOGIQUE;BAC ST2S;BAC ST2S SCIENCES & TECHNO. SANTE & SOCIAL;58;58;49;1;8;3;5;52;0;2;3;13;34;6
7087.0;2021;19;REIMS;MASCULIN;SCOLAIRE;BAC TECHNOLOGIQUE;BAC STD2A;BAC STD2A SCIENCES & TECHNO. DESIGN-ARTS APPLIQUES;19;19;19;0;0;0;0;19;0;1;3;10;5;0
7088.0;2021;19;REIMS;MASCULIN;SCOLAIRE;BAC TECHNOLOGIQUE;BAC STHR;BAC STHR SC.&TEC. HOTELLERIE-RESTAURATION;15;15;14;1;0;0;0;14;0;0;4;4;6;1
7091.0;2021;19;REIMS;MASCULIN;SCOLAIRE;BAC TECHNOLOGIQUE;BAC STI2D;BAC STI2D INNOVATION TECHNO.  ET ECO CONCEPTION;109;109;97;0;12;4;8;101;0;1;13;41;46;8
7095.0;2021;19;REIMS;MASCULIN;SCOLAIRE;BAC TECHNOLOGIQUE;BAC STMG;BAC STMG GESTION ET FINANCE;165;165;137;7;21;11;10;148;0;6;20;51;71;17
7106.0;2021;14;RENNES;FEMININ;APPRENTISSAGE;BAC PROFESSIONNEL;BAC PRO PROD;BAC PRO 25408 REPARATION DES CARROSSERIES;2;2;2;0;0;0;0;2;0;0;1;1;0;0
7109.0;2021;14;RENNES;FEMININ;APPRENTISSAGE;BAC PROFESSIONNEL;BAC PRO PROD;BAC PRO 25515 SYST.NUM.OPT.C RES.INF.SYST.COMM.;1;1;1;0;0;0;0;1;0;0;1;0;0;0
7116.0;2021;14;RENNES;FEMININ;APPRENTISSAGE;BAC PROFESSIONNEL;BAC PRO SERV;BAC PRO 30001 GESTION-ADMINISTRATION;5;5;5;0;0;0;0;5;0;1;2;2;0;0
7117.0;2021;14;RENNES;FEMININ;APPRENTISSAGE;BAC PROFESSIONNEL;BAC PRO SERV;BAC PRO 31106 LOGISTIQUE;2;2;2;0;0;0;0;2;0;0;0;1;1;0
7122.0;2021;14;RENNES;FEMININ;APPRENTISSAGE;BAC PROFESSIONNEL;BAC PRO SERV;BAC PRO 33603 ESTHETIQUE COSMETIQUE PARFUMERIE;10;10;10;0;0;0;0;10;0;1;2;6;1;0
7128.0;2021;14;RENNES;FEMININ;ENSEIGNEMENT A DISTANCE;BAC PROFESSIONNEL;BAC PRO SERV;BAC PRO 31206 VENTE (PROSPECT.NEGO.SUIV.CLIENT;3;3;3;0;0;0;0;3;0;0;0;2;1;0
7137.0;2021;14;RENNES;FEMININ;FORMATION CONTINUE;BAC PROFESSIONNEL;BAC PRO PROD;BAC PRO 25303 AERONAUTIQUE OPTION SYSTEMES;2;2;2;0;0;0;0;2;0;1;1;0;0;0
7145.0;2021;14;RENNES;FEMININ;INDIVIDUEL;BAC PROFESSIONNEL;BAC PRO PROD;BAC PRO AG 21114 CONDUITE PRODUCTIONS HORTICOLES;10;7;7;0;0;0;0;7;0;0;0;1;6;0
7147.0;2021;14;RENNES;FEMININ;INDIVIDUEL;BAC PROFESSIONNEL;BAC PRO PROD;BAC PRO AG 21211 COND GEST ENTR HIPPIQUE;7;6;4;2;0;0;0;4;0;0;0;2;2;2
7157.0;2021;14;RENNES;FEMININ;INDIVIDUEL;BAC PROFESSIONNEL;BAC PRO SERV;BAC PRO 33004 ACC.SOINS-S.PERS. OPT.EN STRUCTUR;5;3;2;1;0;0;0;2;0;1;0;0;1;1
7166.0;2021;14;RENNES;FEMININ;SCOLAIRE;BAC GENERAL;BAC GENERAL;BAC GENE 10019 BAC GENERAL;10686;10684;10532;34;118;80;38;10612;164;1432;3343;3922;1751;72
7171.0;2021;14;RENNES;FEMININ;SCOLAIRE;BAC PROFESSIONNEL;BAC PRO PROD;BAC PRO 23003 ARTIS. & M.ART:MARCHANDISAGE VIS.;22;22;22;0;0;0;0;22;0;3;10;7;2;0
7176.0;2021;14;RENNES;FEMININ;SCOLAIRE;BAC PROFESSIONNEL;BAC PRO PROD;BAC PRO 23203 TECHNICIEN BAT. : ORG.REAL.GROS O;1;1;1;0;0;0;0;1;0;0;0;1;0;0
7177.0;2021;14;RENNES;FEMININ;SCOLAIRE;BAC PROFESSIONNEL;BAC PRO PROD;BAC PRO 23304 AMENAGEMENT FINITION BATIMENT;24;24;22;0;2;0;2;22;0;3;9;7;3;2
7179.0;2021;14;RENNES;FEMININ;SCOLAIRE;BAC PROFESSIONNEL;BAC PRO PROD;BAC PRO 23407 TECHNIC.FAB.BOIS ET MATERX ASSOC;3;3;2;1;0;0;0;2;0;1;0;1;0;1
7186.0;2021;14;RENNES;FEMININ;SCOLAIRE;BAC PROFESSIONNEL;BAC PRO PROD;BAC PRO 25106 TECHNICIEN D'USINAGE;5;5;5;0;0;0;0;5;0;0;2;2;1;0
7192.0;2021;14;RENNES;FEMININ;SCOLAIRE;BAC PROFESSIONNEL;BAC PRO PROD;BAC PRO 25302 AERONAUTIQUE OPTION AVIONIQUE;2;2;2;0;0;0;0;2;0;1;0;1;0;0
7193.0;2021;14;RENNES;FEMININ;SCOLAIRE;BAC PROFESSIONNEL;BAC PRO PROD;BAC PRO 25304 AERONAUTIQUE OPTION STRUCTURE;2;2;2;0;0;0;0;2;0;0;1;0;1;0
7195.0;2021;14;RENNES;FEMININ;SCOLAIRE;BAC PROFESSIONNEL;BAC PRO PROD;BAC PRO 25509 TECHNIC. FROID CONDITIONNEMT AIR;1;1;1;0;0;0;0;1;0;0;0;0;1;0
7197.0;2021;14;RENNES;FEMININ;SCOLAIRE;BAC PROFESSIONNEL;BAC PRO PROD;BAC PRO 25513 SYST.NUM.OPT.A SURETE SECURITE;2;2;0;2;0;0;0;0;0;0;0;0;0;2
7198.0;2021;14;RENNES;FEMININ;SCOLAIRE;BAC PROFESSIONNEL;BAC PRO PROD;BAC PRO 25514 SYST.NUM.OPT.B AUD.RES.EQUIP.DOM.;6;6;5;0;1;1;0;6;0;0;3;2;1;0
7208.0;2021;14;RENNES;FEMININ;SCOLAIRE;BAC PROFESSIONNEL;BAC PRO PROD;BAC PRO AG 21405 AMENAGEMENTS PAYSAGERS;10;10;10;0;0;0;0;10;0;0;4;4;2;0
7209.0;2021;14;RENNES;FEMININ;SCOLAIRE;BAC PROFESSIONNEL;BAC PRO PROD;BAC PRO AG 21406 TEC CONS VTE PROD DES JARDINS;18;18;17;1;0;0;0;17;0;0;2;9;6;1
7210.0;2021;14;RENNES;FEMININ;SCOLAIRE;BAC PROFESSIONNEL;BAC PRO PROD;BAC PRO AG 22105 LABORATOIRE CONTROLE QUALITE;22;22;22;0;0;0;0;22;0;2;2;8;10;0
7217.0;2021;14;RENNES;FEMININ;SCOLAIRE;BAC PROFESSIONNEL;BAC PRO SERV;BAC PRO 31206 VENTE (PROSPECT.NEGO.SUIV.CLIENT;194;193;176;11;6;4;2;180;0;2;23;92;63;13
7223.0;2021;14;RENNES;FEMININ;SCOLAIRE;BAC PROFESSIONNEL;BAC PRO SERV;BAC PRO 33003 ACC.SOINS-S.PERS. OPT.A DOMICILE;155;155;139;11;5;4;1;143;0;3;42;57;41;12
7228.0;2021;14;RENNES;FEMININ;SCOLAIRE;BAC PROFESSIONNEL;BAC PRO SERV;BAC PRO 34304 HYGIENE PROPRETE STERILISATION;12;12;11;1;0;0;0;11;0;0;2;4;5;1
7232.0;2021;14;RENNES;FEMININ;SCOLAIRE;BAC TECHNOLOGIQUE;BAC S2TMD;BAC S2TMD MUSIQUE;4;4;4;0;0;0;0;4;0;1;1;2;0;0
7234.0;2021;14;RENNES;FEMININ;SCOLAIRE;BAC TECHNOLOGIQUE;BAC STAV;BAC STAV AGRONOMIE ALIM ENV TERRITOI;187;185;180;5;0;0;0;180;0;4;23;89;64;5
7235.0;2021;14;RENNES;FEMININ;SCOLAIRE;BAC TECHNOLOGIQUE;BAC STD2A;BAC STD2A SCIENCES & TECHNO. DESIGN-ARTS APPLIQUES;103;103;102;1;0;0;0;102;1;16;51;29;5;1
7239.0;2021;14;RENNES;FEMININ;SCOLAIRE;BAC TECHNOLOGIQUE;BAC STI2D;BAC STI2D INNOVATION TECHNO.  ET ECO CONCEPTION;36;36;36;0;0;0;0;36;0;1;10;14;11;0
7240.0;2021;14;RENNES;FEMININ;SCOLAIRE;BAC TECHNOLOGIQUE;BAC STI2D;BAC STI2D SYSTÈME D'INFORMATION  ET NUMERIQUE;30;30;30;0;0;0;0;30;0;1;9;14;6;0
7242.0;2021;14;RENNES;FEMININ;SCOLAIRE;BAC TECHNOLOGIQUE;BAC STL;BAC STL SCIENCES PHYSIQUES CHIMIQUES  EN LABORAT.;51;51;49;0;2;1;1;50;0;3;10;15;22;1
7247.0;2021;14;RENNES;MASCULIN;APPRENTISSAGE;BAC PROFESSIONNEL;BAC PRO PROD;BAC PRO 22104 BOUCHER CHARCUTIER TRAITEUR;9;9;6;0;3;2;1;8;0;0;0;4;4;1
7250.0;2021;14;RENNES;MASCULIN;APPRENTISSAGE;BAC PROFESSIONNEL;BAC PRO PROD;BAC PRO 22703 TECHN.INSTALL.SYST.ENERG.CLIMATI;20;19;15;2;2;1;1;16;0;1;5;2;8;3
7252.0;2021;14;RENNES;MASCULIN;APPRENTISSAGE;BAC PROFESSIONNEL;BAC PRO PROD;BAC PRO 23102 TRAVAUX PUBLICS;23;23;20;3;0;0;0;20;0;1;6;5;8;3
7254.0;2021;14;RENNES;MASCULIN;APPRENTISSAGE;BAC PROFESSIONNEL;BAC PRO PROD;BAC PRO 23304 AMENAGEMENT FINITION BATIMENT;1;1;1;0;0;0;0;1;0;0;1;0;0;0
7258.0;2021;14;RENNES;MASCULIN;APPRENTISSAGE;BAC PROFESSIONNEL;BAC PRO PROD;BAC PRO 25007 MAINTENANCE EQUIPEMENTS INDUST.;36;34;31;2;1;1;0;32;0;2;6;10;14;2
7261.0;2021;14;RENNES;MASCULIN;APPRENTISSAGE;BAC PROFESSIONNEL;BAC PRO PROD;BAC PRO 25107 TECHNICIEN OUTILLEUR;5;5;1;2;2;2;0;3;0;0;0;0;3;2
7262.0;2021;14;RENNES;MASCULIN;APPRENTISSAGE;BAC PROFESSIONNEL;BAC PRO PROD;BAC PRO 25214 MAINT.VEHIC.OPTA VOIT.PARTICUL.;169;167;139;24;4;1;3;140;0;9;20;61;50;27
7265.0;2021;14;RENNES;MASCULIN;APPRENTISSAGE;BAC PROFESSIONNEL;BAC PRO PROD;BAC PRO 25219 MAINT.MATERIELS OPT.A AGRICOLES;21;21;21;0;0;0;0;21;0;1;3;11;6;0
7266.0;2021;14;RENNES;MASCULIN;APPRENTISSAGE;BAC PROFESSIONNEL;BAC PRO PROD;BAC PRO 25220 MAINT.MATERIELS OPT.B TP MANUT.;10;10;9;1;0;0;0;9;0;0;4;2;3;1
7272.0;2021;14;RENNES;MASCULIN;APPRENTISSAGE;BAC PROFESSIONNEL;BAC PRO PROD;BAC PRO 25509 TECHNIC. FROID CONDITIONNEMT AIR;2;2;2;0;0;0;0;2;0;1;0;1;0;0
7276.0;2021;14;RENNES;MASCULIN;APPRENTISSAGE;BAC PROFESSIONNEL;BAC PRO PROD;BAC PRO AG 21004 CGEA;37;36;30;6;0;0;0;30;0;0;0;4;26;6
7294.0;2021;14;RENNES;MASCULIN;ENSEIGNEMENT A DISTANCE;BAC TECHNOLOGIQUE;BAC ST2S;BAC ST2S SCIENCES & TECHNO. SANTE & SOCIAL;1;1;1;0;0;0;0;1;0;0;1;0;0;0
7309.0;2021;14;RENNES;MASCULIN;INDIVIDUEL;BAC PROFESSIONNEL;BAC PRO PROD;BAC PRO 23004 TECHN. ETUDES BAT.A ETUDES & ECO.;1;1;1;0;0;0;0;1;0;0;0;1;0;0
7311.0;2021;14;RENNES;MASCULIN;INDIVIDUEL;BAC PROFESSIONNEL;BAC PRO PROD;BAC PRO 23102 TRAVAUX PUBLICS;1;1;1;0;0;0;0;1;0;0;0;0;1;0
7313.0;2021;14;RENNES;MASCULIN;INDIVIDUEL;BAC PROFESSIONNEL;BAC PRO PROD;BAC PRO 25009 MAINTENANCE NAUTIQUE;1;0;0;0;0;0;0;0;0;0;0;0;0;0
7317.0;2021;14;RENNES;MASCULIN;INDIVIDUEL;BAC PROFESSIONNEL;BAC PRO PROD;BAC PRO 25513 SYST.NUM.OPT.A SURETE SECURITE;1;1;1;0;0;0;0;1;0;0;0;1;0;0
7318.0;2021;14;RENNES;MASCULIN;INDIVIDUEL;BAC PROFESSIONNEL;BAC PRO PROD;BAC PRO 25515 SYST.NUM.OPT.C RES.INF.SYST.COMM.;2;0;0;0;0;0;0;0;0;0;0;0;0;0
7319.0;2021;14;RENNES;MASCULIN;INDIVIDUEL;BAC PROFESSIONNEL;BAC PRO PROD;BAC PRO AG 21004 CGEA;8;5;4;1;0;0;0;4;0;0;0;0;4;1
7326.0;2021;14;RENNES;MASCULIN;INDIVIDUEL;BAC PROFESSIONNEL;BAC PRO SERV;BAC PRO 31206 VENTE (PROSPECT.NEGO.SUIV.CLIENT;2;2;2;0;0;0;0;2;0;0;1;0;1;0
7327.0;2021;14;RENNES;MASCULIN;INDIVIDUEL;BAC PROFESSIONNEL;BAC PRO SERV;BAC PRO 31210 ACCUEIL -RELATION CLIENTS USAGERS;1;0;0;0;0;0;0;0;0;0;0;0;0;0
7332.0;2021;14;RENNES;MASCULIN;INDIVIDUEL;BAC TECHNOLOGIQUE;BAC STI2D;BAC STI2D ARCHITECTURE ET CONSTRUCTION;1;0;0;0;0;0;0;0;0;0;0;0;0;0
7350.0;2021;14;RENNES;MASCULIN;SCOLAIRE;BAC PROFESSIONNEL;BAC PRO PROD;BAC PRO 23102 TRAVAUX PUBLICS;21;21;20;1;0;0;0;20;0;0;5;10;5;1
7358.0;2021;14;RENNES;MASCULIN;SCOLAIRE;BAC PROFESSIONNEL;BAC PRO PROD;BAC PRO 23408 Etude et réalisation d'agencement;17;17;17;0;0;0;0;17;0;1;6;5;5;0
7362.0;2021;14;RENNES;MASCULIN;SCOLAIRE;BAC PROFESSIONNEL;BAC PRO PROD;BAC PRO 25006 MICROTECHNIQUES;36;36;32;4;0;0;0;32;0;7;8;11;6;4
7365.0;2021;14;RENNES;MASCULIN;SCOLAIRE;BAC PROFESSIONNEL;BAC PRO PROD;BAC PRO 25106 TECHNICIEN D'USINAGE;87;87;79;4;4;4;0;83;0;6;22;33;22;4
7378.0;2021;14;RENNES;MASCULIN;SCOLAIRE;BAC PROFESSIONNEL;BAC PRO PROD;BAC PRO 25411 TECH.CHAUDRONNERIE INDUSTRIELLE;129;129;116;10;3;1;2;117;0;4;29;51;33;12
7385.0;2021;14;RENNES;MASCULIN;SCOLAIRE;BAC PROFESSIONNEL;BAC PRO PROD;BAC PRO AG 21004 CGEA;285;282;253;29;0;0;0;253;0;6;22;96;129;29
7387.0;2021;14;RENNES;MASCULIN;SCOLAIRE;BAC PROFESSIONNEL;BAC PRO PROD;BAC PRO AG 21203 TECHN CONSEIL DE VENTE ANIMAL;29;29;27;2;0;0;0;27;0;0;4;3;20;2
7390.0;2021;14;RENNES;MASCULIN;SCOLAIRE;BAC PROFESSIONNEL;BAC PRO PROD;BAC PRO AG 21211 COND GEST ENTR HIPPIQUE;6;6;5;1;0;0;0;5;0;0;0;2;3;1
7392.0;2021;14;RENNES;MASCULIN;SCOLAIRE;BAC PROFESSIONNEL;BAC PRO PROD;BAC PRO AG 21303 FORET;13;13;13;0;0;0;0;13;0;0;2;5;6;0
7396.0;2021;14;RENNES;MASCULIN;SCOLAIRE;BAC PROFESSIONNEL;BAC PRO PROD;BAC PRO AG 22107 TEC CONS VTE ALIMENTATION P.ALIM;98;94;82;12;0;0;0;82;0;0;8;27;47;12
7408.0;2021;14;RENNES;MASCULIN;SCOLAIRE;BAC PROFESSIONNEL;BAC PRO SERV;BAC PRO 33003 ACC.SOINS-S.PERS. OPT.A DOMICILE;7;7;5;1;1;1;0;6;0;0;1;4;1;1
7409.0;2021;14;RENNES;MASCULIN;SCOLAIRE;BAC PROFESSIONNEL;BAC PRO SERV;BAC PRO 33004 ACC.SOINS-S.PERS. OPT.EN STRUCTUR;44;44;44;0;0;0;0;44;0;1;8;23;12;0
7410.0;2021;14;RENNES;MASCULIN;SCOLAIRE;BAC PROFESSIONNEL;BAC PRO SERV;BAC PRO 33101 OPTIQUE LUNETTERIE;11;11;10;1;0;0;0;10;0;1;5;2;2;1
7411.0;2021;14;RENNES;MASCULIN;SCOLAIRE;BAC PROFESSIONNEL;BAC PRO SERV;BAC PRO 33403 COMMERC. SERVICES EN RESTAURATION;107;107;97;7;3;1;2;98;0;5;23;33;37;9
7415.0;2021;14;RENNES;MASCULIN;SCOLAIRE;BAC TECHNOLOGIQUE;BAC S2TMD;BAC S2TMD MUSIQUE;8;8;8;0;0;0;0;8;0;0;2;5;1;0
7422.0;2021;14;RENNES;MASCULIN;SCOLAIRE;BAC TECHNOLOGIQUE;BAC STI2D;BAC STI2D INNOVATION TECHNO.  ET ECO CONCEPTION;504;504;485;1;18;13;5;498;0;1;93;234;170;6
7424.0;2021;14;RENNES;MASCULIN;SCOLAIRE;BAC TECHNOLOGIQUE;BAC STL;BAC STL BIOCHIM.-BIOLOGIE-BIOTECHNOL.;70;70;61;1;8;5;3;66;0;1;7;19;39;4
7436.0;2021;15;STRASBOURG;FEMININ;APPRENTISSAGE;BAC PROFESSIONNEL;BAC PRO PROD;BAC PRO 25107 TECHNICIEN OUTILLEUR;1;1;1;0;0;0;0;1;0;0;0;1;0;0
7439.0;2021;15;STRASBOURG;FEMININ;APPRENTISSAGE;BAC PROFESSIONNEL;BAC PRO PROD;BAC PRO AG 21004 CGEA;4;4;3;1;0;0;0;3;0;0;0;2;1;1
7441.0;2021;15;STRASBOURG;FEMININ;APPRENTISSAGE;BAC PROFESSIONNEL;BAC PRO PROD;BAC PRO AG 21114 CONDUITE PRODUCTIONS HORTICOLES;6;6;6;0;0;0;0;6;0;0;2;3;1;0
7444.0;2021;15;STRASBOURG;FEMININ;APPRENTISSAGE;BAC PROFESSIONNEL;BAC PRO PROD;BAC PRO AG 21405 AMENAGEMENTS PAYSAGERS;2;1;1;0;0;0;0;1;0;0;0;1;0;0
7445.0;2021;15;STRASBOURG;FEMININ;APPRENTISSAGE;BAC PROFESSIONNEL;BAC PRO PROD;BAC PRO AG 21406 TEC CONS VTE PROD DES JARDINS;1;1;1;0;0;0;0;1;0;0;1;0;0;0
7446.0;2021;15;STRASBOURG;FEMININ;APPRENTISSAGE;BAC PROFESSIONNEL;BAC PRO SERV;BAC PRO 30001 GESTION-ADMINISTRATION;26;26;23;3;0;0;0;23;0;4;9;5;5;3
7447.0;2021;15;STRASBOURG;FEMININ;APPRENTISSAGE;BAC PROFESSIONNEL;BAC PRO SERV;BAC PRO 31106 LOGISTIQUE;4;4;4;0;0;0;0;4;0;0;4;0;0;0
7452.0;2021;15;STRASBOURG;FEMININ;APPRENTISSAGE;BAC PROFESSIONNEL;BAC PRO SERV;BAC PRO 33603 ESTHETIQUE COSMETIQUE PARFUMERIE;5;5;5;0;0;0;0;5;0;0;1;2;2;0
7454.0;2021;15;STRASBOURG;FEMININ;ENSEIGNEMENT A DISTANCE;BAC PROFESSIONNEL;BAC PRO SERV;BAC PRO 30001 GESTION-ADMINISTRATION;3;3;1;2;0;0;0;1;0;1;0;0;0;2
7458.0;2021;15;STRASBOURG;FEMININ;ENSEIGNEMENT A DISTANCE;BAC TECHNOLOGIQUE;BAC ST2S;BAC ST2S SCIENCES & TECHNO. SANTE & SOCIAL;3;3;3;0;0;0;0;3;0;1;1;1;0;0
7461.0;2021;15;STRASBOURG;FEMININ;FORMATION CONTINUE;BAC PROFESSIONNEL;BAC PRO PROD;BAC PRO 25106 TECHNICIEN D'USINAGE;3;3;3;0;0;0;0;3;0;1;1;0;1;0
7463.0;2021;15;STRASBOURG;FEMININ;FORMATION CONTINUE;BAC PROFESSIONNEL;BAC PRO PROD;BAC PRO 25411 TECH.CHAUDRONNERIE INDUSTRIELLE;2;2;2;0;0;0;0;2;0;2;0;0;0;0
7466.0;2021;15;STRASBOURG;FEMININ;INDIVIDUEL;BAC GENERAL;BAC GENERAL;BAC GENE 10019 BAC GENERAL;86;75;57;14;4;1;3;58;0;8;16;18;16;17
7467.0;2021;15;STRASBOURG;FEMININ;INDIVIDUEL;BAC PROFESSIONNEL;BAC PRO PROD;BAC PRO AG 21004 CGEA;2;0;0;0;0;0;0;0;0;0;0;0;0;0
7471.0;2021;15;STRASBOURG;FEMININ;INDIVIDUEL;BAC PROFESSIONNEL;BAC PRO SERV;BAC PRO 31202 COMMERCE;5;2;2;0;0;0;0;2;0;0;0;0;2;0
7500.0;2021;15;STRASBOURG;FEMININ;SCOLAIRE;BAC PROFESSIONNEL;BAC PRO PROD;BAC PRO 25406 OUVRAGES DU BATIMENT METALLERIE;1;1;1;0;0;0;0;1;0;0;0;0;1;0
7518.0;2021;15;STRASBOURG;FEMININ;SCOLAIRE;BAC PROFESSIONNEL;BAC PRO SERV;BAC PRO 31210 ACCUEIL -RELATION CLIENTS USAGERS;162;162;134;16;12;8;4;142;0;9;20;59;54;20
7519.0;2021;15;STRASBOURG;FEMININ;SCOLAIRE;BAC PROFESSIONNEL;BAC PRO SERV;BAC PRO 32207 REAL.PR.IMPR.PLURI.OPTA.PR.GRAPH.;12;12;11;1;0;0;0;11;0;1;3;6;1;1
7535.0;2021;15;STRASBOURG;FEMININ;SCOLAIRE;BAC TECHNOLOGIQUE;BAC STI2D;BAC STI2D ARCHITECTURE ET CONSTRUCTION;45;45;45;0;0;0;0;45;0;3;8;18;16;0
7537.0;2021;15;STRASBOURG;FEMININ;SCOLAIRE;BAC TECHNOLOGIQUE;BAC STI2D;BAC STI2D INNOVATION TECHNO.  ET ECO CONCEPTION;16;16;16;0;0;0;0;16;0;1;6;6;3;0
7542.0;2021;15;STRASBOURG;FEMININ;SCOLAIRE;BAC TECHNOLOGIQUE;BAC STMG;BAC STMG MERCATIQUE (MARKETING);386;386;354;8;24;5;19;359;0;6;66;146;141;27
7552.0;2021;15;STRASBOURG;MASCULIN;APPRENTISSAGE;BAC PROFESSIONNEL;BAC PRO PROD;BAC PRO 23203 TECHNICIEN BAT. : ORG.REAL.GROS O;4;4;4;0;0;0;0;4;0;0;1;2;1;0
7554.0;2021;15;STRASBOURG;MASCULIN;APPRENTISSAGE;BAC PROFESSIONNEL;BAC PRO PROD;BAC PRO 23404 TECHNICIEN CONSTRUCTEUR BOIS;4;4;3;1;0;0;0;3;0;0;0;2;1;1
7561.0;2021;15;STRASBOURG;MASCULIN;APPRENTISSAGE;BAC PROFESSIONNEL;BAC PRO PROD;BAC PRO 25215 MAINT.VEHIC.OPTB VEHIC.TRANS.ROUT;28;28;22;5;1;1;0;23;0;0;9;7;7;5
7569.0;2021;15;STRASBOURG;MASCULIN;APPRENTISSAGE;BAC PROFESSIONNEL;BAC PRO PROD;BAC PRO 25411 TECH.CHAUDRONNERIE INDUSTRIELLE;66;63;54;8;1;0;1;54;0;10;21;15;8;9
7570.0;2021;15;STRASBOURG;MASCULIN;APPRENTISSAGE;BAC PROFESSIONNEL;BAC PRO PROD;BAC PRO 25509 TECHNIC. FROID CONDITIONNEMT AIR;11;11;11;0;0;0;0;11;0;1;3;5;2;0
7572.0;2021;15;STRASBOURG;MASCULIN;APPRENTISSAGE;BAC PROFESSIONNEL;BAC PRO PROD;BAC PRO 25514 SYST.NUM.OPT.B AUD.RES.EQUIP.DOM.;3;3;3;0;0;0;0;3;0;1;2;0;0;0
7573.0;2021;15;STRASBOURG;MASCULIN;APPRENTISSAGE;BAC PROFESSIONNEL;BAC PRO PROD;BAC PRO 25515 SYST.NUM.OPT.C RES.INF.SYST.COMM.;7;7;7;0;0;0;0;7;0;0;3;4;0;0
7579.0;2021;15;STRASBOURG;MASCULIN;APPRENTISSAGE;BAC PROFESSIONNEL;BAC PRO PROD;BAC PRO AG 21405 AMENAGEMENTS PAYSAGERS;71;71;71;0;0;0;0;71;0;2;21;29;19;0
7581.0;2021;15;STRASBOURG;MASCULIN;APPRENTISSAGE;BAC PROFESSIONNEL;BAC PRO SERV;BAC PRO 30001 GESTION-ADMINISTRATION;3;3;2;1;0;0;0;2;0;0;1;1;0;1
7584.0;2021;15;STRASBOURG;MASCULIN;APPRENTISSAGE;BAC PROFESSIONNEL;BAC PRO SERV;BAC PRO 32207 REAL.PR.IMPR.PLURI.OPTA.PR.GRAPH.;1;1;1;0;0;0;0;1;0;0;0;0;1;0
7587.0;2021;15;STRASBOURG;MASCULIN;ENSEIGNEMENT A DISTANCE;BAC GENERAL;BAC GENERAL;BAC GENE 10019 BAC GENERAL;22;20;19;1;0;0;0;19;0;4;7;4;4;1
7588.0;2021;15;STRASBOURG;MASCULIN;ENSEIGNEMENT A DISTANCE;BAC PROFESSIONNEL;BAC PRO SERV;BAC PRO 30001 GESTION-ADMINISTRATION;3;0;0;0;0;0;0;0;0;0;0;0;0;0
7594.0;2021;15;STRASBOURG;MASCULIN;FORMATION CONTINUE;BAC PROFESSIONNEL;BAC PRO PROD;BAC PRO 22703 TECHN.INSTALL.SYST.ENERG.CLIMATI;9;9;8;1;0;0;0;8;0;3;3;1;1;1
7597.0;2021;15;STRASBOURG;MASCULIN;FORMATION CONTINUE;BAC PROFESSIONNEL;BAC PRO PROD;BAC PRO 23405 TECHNICIEN MENUISIER AGENCEUR;2;2;2;0;0;0;0;2;0;2;0;0;0;0
7606.0;2021;15;STRASBOURG;MASCULIN;FORMATION CONTINUE;BAC PROFESSIONNEL;BAC PRO SERV;BAC PRO 34403 METIERS DE LA SECURITE;7;7;7;0;0;0;0;7;0;0;1;2;4;0
7608.0;2021;15;STRASBOURG;MASCULIN;INDIVIDUEL;BAC PROFESSIONNEL;BAC PRO PROD;BAC PRO 22503 PLASTIQUES ET COMPOSITES;2;2;1;0;1;1;0;2;0;0;0;0;2;0
7617.0;2021;15;STRASBOURG;MASCULIN;INDIVIDUEL;BAC PROFESSIONNEL;BAC PRO PROD;BAC PRO AG 21114 CONDUITE PRODUCTIONS HORTICOLES;1;1;1;0;0;0;0;1;0;0;0;0;1;0
7620.0;2021;15;STRASBOURG;MASCULIN;INDIVIDUEL;BAC PROFESSIONNEL;BAC PRO SERV;BAC PRO 31106 LOGISTIQUE;1;1;1;0;0;0;0;1;0;0;0;1;0;0
7621.0;2021;15;STRASBOURG;MASCULIN;INDIVIDUEL;BAC PROFESSIONNEL;BAC PRO SERV;BAC PRO 31202 COMMERCE;4;3;1;1;1;1;0;2;0;0;0;0;2;1
7623.0;2021;15;STRASBOURG;MASCULIN;INDIVIDUEL;BAC PROFESSIONNEL;BAC PRO SERV;BAC PRO 33004 ACC.SOINS-S.PERS. OPT.EN STRUCTUR;1;0;0;0;0;0;0;0;0;0;0;0;0;0
7628.0;2021;15;STRASBOURG;MASCULIN;INDIVIDUEL;BAC TECHNOLOGIQUE;BAC STMG;BAC STMG GESTION ET FINANCE;2;1;0;0;1;1;0;1;0;0;0;0;1;0
7631.0;2021;15;STRASBOURG;MASCULIN;INDIVIDUEL;BAC TECHNOLOGIQUE;BAC STMG;BAC STMG SYSTEMES D'INFORMATION DE GESTION;1;1;0;0;1;0;1;0;0;0;0;0;0;1
7635.0;2021;15;STRASBOURG;MASCULIN;SCOLAIRE;BAC PROFESSIONNEL;BAC PRO PROD;BAC PRO 22105 BOULANGER-PÂTISSIER;13;13;13;0;0;0;0;13;0;0;7;2;4;0
7639.0;2021;15;STRASBOURG;MASCULIN;SCOLAIRE;BAC PROFESSIONNEL;BAC PRO PROD;BAC PRO 22704 TECHN. MAINT. SYST.ENERG.CLIMATI;23;23;16;3;4;2;2;18;0;0;0;5;13;5
7649.0;2021;15;STRASBOURG;MASCULIN;SCOLAIRE;BAC PROFESSIONNEL;BAC PRO PROD;BAC PRO 24203 METIERS DE LA MODE - VÊTEMENT;7;7;5;2;0;0;0;5;0;0;3;2;0;2
7651.0;2021;15;STRASBOURG;MASCULIN;SCOLAIRE;BAC PROFESSIONNEL;BAC PRO PROD;BAC PRO 25007 MAINTENANCE EQUIPEMENTS INDUST.;205;205;164;27;14;11;3;175;0;7;35;60;73;30
7656.0;2021;15;STRASBOURG;MASCULIN;SCOLAIRE;BAC PROFESSIONNEL;BAC PRO PROD;BAC PRO 25216 MAINT.VEHIC.OPTC MOTOCYCLES;11;11;11;0;0;0;0;11;0;3;4;3;1;0
7660.0;2021;15;STRASBOURG;MASCULIN;SCOLAIRE;BAC PROFESSIONNEL;BAC PRO PROD;BAC PRO 25406 OUVRAGES DU BATIMENT METALLERIE;19;19;18;0;1;1;0;19;0;1;4;6;8;0
7662.0;2021;15;STRASBOURG;MASCULIN;SCOLAIRE;BAC PROFESSIONNEL;BAC PRO PROD;BAC PRO 25411 TECH.CHAUDRONNERIE INDUSTRIELLE;71;71;58;7;6;0;6;58;0;3;13;20;22;13
7673.0;2021;15;STRASBOURG;MASCULIN;SCOLAIRE;BAC PROFESSIONNEL;BAC PRO PROD;BAC PRO AG 21405 AMENAGEMENTS PAYSAGERS;18;18;18;0;0;0;0;18;0;0;2;3;13;0
7679.0;2021;15;STRASBOURG;MASCULIN;SCOLAIRE;BAC PROFESSIONNEL;BAC PRO SERV;BAC PRO 31108 TRANSPORT;17;17;6;10;1;0;1;6;0;1;1;0;4;11
7685.0;2021;15;STRASBOURG;MASCULIN;SCOLAIRE;BAC PROFESSIONNEL;BAC PRO SERV;BAC PRO 32208 REAL.PR.IMPR.PLURI.OPTB.PR.IMPR.;18;18;13;5;0;0;0;13;0;0;1;4;8;5
7698.0;2021;15;STRASBOURG;MASCULIN;SCOLAIRE;BAC TECHNOLOGIQUE;BAC STHR;BAC STHR SC.&TEC. HOTELLERIE-RESTAURATION;42;42;40;1;1;0;1;40;0;1;5;18;16;2
7700.0;2021;15;STRASBOURG;MASCULIN;SCOLAIRE;BAC TECHNOLOGIQUE;BAC STI2D;BAC STI2D ENERGIES  ET ENVIRONNEMENT;121;120;112;3;5;4;1;116;0;2;27;40;47;4
7703.0;2021;15;STRASBOURG;MASCULIN;SCOLAIRE;BAC TECHNOLOGIQUE;BAC STL;BAC STL BIOCHIM.-BIOLOGIE-BIOTECHNOL.;70;70;59;0;11;8;3;67;0;2;4;23;38;3
7704.0;2021;15;STRASBOURG;MASCULIN;SCOLAIRE;BAC TECHNOLOGIQUE;BAC STL;BAC STL SCIENCES PHYSIQUES CHIMIQUES  EN LABORAT.;39;39;32;1;6;2;4;34;0;1;5;13;15;5
7710.0;2021;16;TOULOUSE;FEMININ;APPRENTISSAGE;BAC PROFESSIONNEL;BAC PRO PROD;BAC PRO 22105 BOULANGER-PÂTISSIER;1;1;1;0;0;0;0;1;0;0;1;0;0;0
7717.0;2021;16;TOULOUSE;FEMININ;APPRENTISSAGE;BAC PROFESSIONNEL;BAC PRO PROD;BAC PRO 23408 Etude et réalisation d'agencement;1;1;1;0;0;0;0;1;0;0;0;0;1;0
7720.0;2021;16;TOULOUSE;FEMININ;APPRENTISSAGE;BAC PROFESSIONNEL;BAC PRO PROD;BAC PRO 25106 TECHNICIEN D'USINAGE;4;4;4;0;0;0;0;4;0;1;2;0;1;0
7725.0;2021;16;TOULOUSE;FEMININ;APPRENTISSAGE;BAC PROFESSIONNEL;BAC PRO PROD;BAC PRO 25304 AERONAUTIQUE OPTION STRUCTURE;1;1;1;0;0;0;0;1;0;0;1;0;0;0
7730.0;2021;16;TOULOUSE;FEMININ;APPRENTISSAGE;BAC PROFESSIONNEL;BAC PRO PROD;BAC PRO AG 22107 TEC CONS VTE ALIMENTATION P.ALIM;7;7;6;1;0;0;0;6;0;0;0;3;3;1
7738.0;2021;16;TOULOUSE;FEMININ;APPRENTISSAGE;BAC PROFESSIONNEL;BAC PRO SERV;BAC PRO 33102 PROTHESE DENTAIRE;7;7;7;0;0;0;0;7;0;1;1;5;0;0
7739.0;2021;16;TOULOUSE;FEMININ;APPRENTISSAGE;BAC PROFESSIONNEL;BAC PRO SERV;BAC PRO 33403 COMMERC. SERVICES EN RESTAURATION;3;3;2;1;0;0;0;2;0;0;0;2;0;1
7751.0;2021;16;TOULOUSE;FEMININ;ENSEIGNEMENT A DISTANCE;BAC TECHNOLOGIQUE;BAC STMG;BAC STMG MERCATIQUE (MARKETING);3;3;2;0;1;0;1;2;0;0;1;0;1;1
7759.0;2021;16;TOULOUSE;FEMININ;FORMATION CONTINUE;BAC PROFESSIONNEL;BAC PRO SERV;BAC PRO 33403 COMMERC. SERVICES EN RESTAURATION;1;1;0;0;1;1;0;1;0;0;0;0;1;0
7760.0;2021;16;TOULOUSE;FEMININ;FORMATION CONTINUE;BAC PROFESSIONNEL;BAC PRO SERV;BAC PRO 33602 PERRUQUIER POSTICHEUR;1;1;1;0;0;0;0;1;0;1;0;0;0;0
7772.0;2021;16;TOULOUSE;FEMININ;INDIVIDUEL;BAC PROFESSIONNEL;BAC PRO SERV;BAC PRO 31210 ACCUEIL -RELATION CLIENTS USAGERS;6;4;1;2;1;0;1;1;0;0;1;0;0;3
7776.0;2021;16;TOULOUSE;FEMININ;INDIVIDUEL;BAC PROFESSIONNEL;BAC PRO SERV;BAC PRO AG 33002 SERV PERS TERRIT;1;1;1;0;0;0;0;1;0;0;0;0;1;0
7777.0;2021;16;TOULOUSE;FEMININ;INDIVIDUEL;BAC TECHNOLOGIQUE;BAC ST2S;BAC ST2S SCIENCES & TECHNO. SANTE & SOCIAL;12;3;0;1;2;1;1;1;0;0;0;0;1;2
7784.0;2021;16;TOULOUSE;FEMININ;SCOLAIRE;BAC PROFESSIONNEL;BAC PRO PROD;BACPRO 20002 ETUD.DEFINITION PRDTS INDUSTRIEL;1;1;1;0;0;0;0;1;0;0;0;0;1;0
7787.0;2021;16;TOULOUSE;FEMININ;SCOLAIRE;BAC PROFESSIONNEL;BAC PRO PROD;BAC PRO 22105 BOULANGER-PÂTISSIER;35;35;34;1;0;0;0;34;0;11;16;5;2;1
7789.0;2021;16;TOULOUSE;FEMININ;SCOLAIRE;BAC PROFESSIONNEL;BAC PRO PROD;BAC PRO 22403 ARTS.& MET.ART:MET.ENSEIGN SIGNA;8;8;7;1;0;0;0;7;0;0;2;4;1;1
7790.0;2021;16;TOULOUSE;FEMININ;SCOLAIRE;BAC PROFESSIONNEL;BAC PRO PROD;BAC PRO 22503 PLASTIQUES ET COMPOSITES;2;2;2;0;0;0;0;2;0;0;0;2;0;0
7800.0;2021;16;TOULOUSE;FEMININ;SCOLAIRE;BAC PROFESSIONNEL;BAC PRO PROD;BAC PRO 24202 ARTIS.& MET.ART : TAPIS.D'AMEUBL;12;12;8;1;3;2;1;10;0;2;0;4;4;2
7808.0;2021;16;TOULOUSE;FEMININ;SCOLAIRE;BAC PROFESSIONNEL;BAC PRO PROD;BAC PRO 25216 MAINT.VEHIC.OPTC MOTOCYCLES;3;3;3;0;0;0;0;3;0;0;0;3;0;0
7815.0;2021;16;TOULOUSE;FEMININ;SCOLAIRE;BAC PROFESSIONNEL;BAC PRO PROD;BAC PRO 25411 TECH.CHAUDRONNERIE INDUSTRIELLE;2;2;2;0;0;0;0;2;0;0;0;1;1;0
7824.0;2021;16;TOULOUSE;FEMININ;SCOLAIRE;BAC PROFESSIONNEL;BAC PRO PROD;BAC PRO AG 21210 COND GEST ENTR CANIN ET FELIN;32;31;30;1;0;0;0;30;0;0;6;16;8;1
7827.0;2021;16;TOULOUSE;FEMININ;SCOLAIRE;BAC PROFESSIONNEL;BAC PRO PROD;BAC PRO AG 21303 FORET;2;2;2;0;0;0;0;2;0;0;0;1;1;0
7833.0;2021;16;TOULOUSE;FEMININ;SCOLAIRE;BAC PROFESSIONNEL;BAC PRO SERV;BAC PRO 31106 LOGISTIQUE;7;7;4;1;2;2;0;6;0;0;0;3;3;1
7845.0;2021;16;TOULOUSE;FEMININ;SCOLAIRE;BAC PROFESSIONNEL;BAC PRO SERV;BAC PRO 33004 ACC.SOINS-S.PERS. OPT.EN STRUCTUR;575;575;538;17;20;10;10;548;0;13;148;227;160;27
7853.0;2021;16;TOULOUSE;FEMININ;SCOLAIRE;BAC PROFESSIONNEL;BAC PRO SERV;BAC PRO AG 33002 SERV PERS TERRIT;354;345;331;14;0;0;0;331;0;12;70;125;124;14
7861.0;2021;16;TOULOUSE;FEMININ;SCOLAIRE;BAC TECHNOLOGIQUE;BAC STI2D;BAC STI2D ENERGIES  ET ENVIRONNEMENT;8;8;7;0;1;0;1;7;0;0;2;2;3;1
7865.0;2021;16;TOULOUSE;FEMININ;SCOLAIRE;BAC TECHNOLOGIQUE;BAC STL;BAC STL SCIENCES PHYSIQUES CHIMIQUES  EN LABORAT.;103;103;94;0;9;9;0;103;0;6;23;34;40;0
7869.0;2021;16;TOULOUSE;FEMININ;SCOLAIRE;BAC TECHNOLOGIQUE;BAC STMG;BAC STMG SYSTEMES D'INFORMATION DE GESTION;11;11;11;0;0;0;0;11;0;0;2;1;8;0
7878.0;2021;16;TOULOUSE;MASCULIN;APPRENTISSAGE;BAC PROFESSIONNEL;BAC PRO PROD;BAC PRO 23004 TECHN. ETUDES BAT.A ETUDES & ECO.;1;1;1;0;0;0;0;1;0;0;0;1;0;0
7885.0;2021;16;TOULOUSE;MASCULIN;APPRENTISSAGE;BAC PROFESSIONNEL;BAC PRO PROD;BAC PRO 23304 AMENAGEMENT FINITION BATIMENT;8;8;4;2;2;2;0;6;0;0;1;0;5;2
7887.0;2021;16;TOULOUSE;MASCULIN;APPRENTISSAGE;BAC PROFESSIONNEL;BAC PRO PROD;BAC PRO 23405 TECHNICIEN MENUISIER AGENCEUR;2;2;1;1;0;0;0;1;0;0;0;1;0;1
7892.0;2021;16;TOULOUSE;MASCULIN;APPRENTISSAGE;BAC PROFESSIONNEL;BAC PRO PROD;BAC PRO 25215 MAINT.VEHIC.OPTB VEHIC.TRANS.ROUT;11;11;8;2;1;1;0;9;0;0;1;1;7;2
7895.0;2021;16;TOULOUSE;MASCULIN;APPRENTISSAGE;BAC PROFESSIONNEL;BAC PRO PROD;BAC PRO 25220 MAINT.MATERIELS OPT.B TP MANUT.;16;16;11;3;2;2;0;13;0;1;1;2;9;3
7899.0;2021;16;TOULOUSE;MASCULIN;APPRENTISSAGE;BAC PROFESSIONNEL;BAC PRO PROD;BAC PRO 25304 AERONAUTIQUE OPTION STRUCTURE;8;8;3;2;3;3;0;6;0;0;0;3;3;2
7903.0;2021;16;TOULOUSE;MASCULIN;APPRENTISSAGE;BAC PROFESSIONNEL;BAC PRO PROD;BAC PRO 25509 TECHNIC. FROID CONDITIONNEMT AIR;7;7;5;2;0;0;0;5;0;3;0;1;1;2
7909.0;2021;16;TOULOUSE;MASCULIN;APPRENTISSAGE;BAC PROFESSIONNEL;BAC PRO SERV;BAC PRO 30001 GESTION-ADMINISTRATION;1;1;1;0;0;0;0;1;0;0;0;1;0;0
7915.0;2021;16;TOULOUSE;MASCULIN;APPRENTISSAGE;BAC PROFESSIONNEL;BAC PRO SERV;BAC PRO 33102 PROTHESE DENTAIRE;4;4;4;0;0;0;0;4;0;0;1;2;1;0
7917.0;2021;16;TOULOUSE;MASCULIN;APPRENTISSAGE;BAC PROFESSIONNEL;BAC PRO SERV;BAC PRO 34304 HYGIENE PROPRETE STERILISATION;17;15;8;2;5;1;4;9;0;1;2;4;2;6
7930.0;2021;16;TOULOUSE;MASCULIN;FORMATION CONTINUE;BAC PROFESSIONNEL;BAC PRO PROD;BAC PRO 22704 TECHN. MAINT. SYST.ENERG.CLIMATI;4;4;4;0;0;0;0;4;0;0;2;0;2;0
7935.0;2021;16;TOULOUSE;MASCULIN;FORMATION CONTINUE;BAC PROFESSIONNEL;BAC PRO PROD;BAC PRO 25510 METIERS ELECT. ENVIRON. CONNECTES;2;2;2;0;0;0;0;2;0;0;0;2;0;0
7937.0;2021;16;TOULOUSE;MASCULIN;FORMATION CONTINUE;BAC PROFESSIONNEL;BAC PRO PROD;BAC PRO AG 21114 CONDUITE PRODUCTIONS HORTICOLES;2;2;2;0;0;0;0;2;0;1;0;0;1;0
7939.0;2021;16;TOULOUSE;MASCULIN;INDIVIDUEL;BAC GENERAL;BAC GENERAL;BAC GENE 10019 BAC GENERAL;93;54;26;13;15;7;8;33;0;1;3;6;23;21
7943.0;2021;16;TOULOUSE;MASCULIN;INDIVIDUEL;BAC PROFESSIONNEL;BAC PRO PROD;BAC PRO 25214 MAINT.VEHIC.OPTA VOIT.PARTICUL.;4;1;0;0;1;0;1;0;0;0;0;0;0;1
7954.0;2021;16;TOULOUSE;MASCULIN;INDIVIDUEL;BAC PROFESSIONNEL;BAC PRO SERV;BAC PRO 31107 CONDUCT. TRANSP.ROUT.MARCHANDISES;2;0;0;0;0;0;0;0;0;0;0;0;0;0
7958.0;2021;16;TOULOUSE;MASCULIN;INDIVIDUEL;BAC PROFESSIONNEL;BAC PRO SERV;BAC PRO AG 33002 SERV PERS TERRIT;2;1;1;0;0;0;0;1;0;0;0;0;1;0
7959.0;2021;16;TOULOUSE;MASCULIN;INDIVIDUEL;BAC TECHNOLOGIQUE;BAC ST2S;BAC ST2S SCIENCES & TECHNO. SANTE & SOCIAL;1;1;0;0;1;0;1;0;0;0;0;0;0;1
7969.0;2021;16;TOULOUSE;MASCULIN;INDIVIDUEL;BAC TECHNOLOGIQUE;BAC STMG;BAC STMG RESSOURCES HUMAINES ET COMMUNICATION;7;3;1;2;0;0;0;1;0;0;0;0;1;2
7979.0;2021;16;TOULOUSE;MASCULIN;SCOLAIRE;BAC PROFESSIONNEL;BAC PRO PROD;BAC PRO 22703 TECHN.INSTALL.SYST.ENERG.CLIMATI;106;106;80;18;8;6;2;86;0;1;14;30;41;20
7980.0;2021;16;TOULOUSE;MASCULIN;SCOLAIRE;BAC PROFESSIONNEL;BAC PRO PROD;BAC PRO 22704 TECHN. MAINT. SYST.ENERG.CLIMATI;32;32;21;10;1;1;0;22;0;0;3;9;10;10
7988.0;2021;16;TOULOUSE;MASCULIN;SCOLAIRE;BAC PROFESSIONNEL;BAC PRO PROD;BAC PRO 23303 MENUISERIE ALUMINIUM-VERRE;9;9;8;1;0;0;0;8;0;0;4;2;2;1
7989.0;2021;16;TOULOUSE;MASCULIN;SCOLAIRE;BAC PROFESSIONNEL;BAC PRO PROD;BAC PRO 23304 AMENAGEMENT FINITION BATIMENT;6;6;6;0;0;0;0;6;0;0;2;2;2;0
7997.0;2021;16;TOULOUSE;MASCULIN;SCOLAIRE;BAC PROFESSIONNEL;BAC PRO PROD;BAC PRO 25006 MICROTECHNIQUES;20;20;19;1;0;0;0;19;0;0;2;11;6;1
8000.0;2021;16;TOULOUSE;MASCULIN;SCOLAIRE;BAC PROFESSIONNEL;BAC PRO PROD;BAC PRO 25107 TECHNICIEN OUTILLEUR;24;24;17;7;0;0;0;17;0;1;3;2;11;7
8001.0;2021;16;TOULOUSE;MASCULIN;SCOLAIRE;BAC PROFESSIONNEL;BAC PRO PROD;BAC PRO 25108 TECHNICIEN MODELEUR;8;8;7;0;1;1;0;8;0;0;1;1;6;0
8004.0;2021;16;TOULOUSE;MASCULIN;SCOLAIRE;BAC PROFESSIONNEL;BAC PRO PROD;BAC PRO 25216 MAINT.VEHIC.OPTC MOTOCYCLES;53;53;43;6;4;2;2;45;0;3;10;19;13;8
8010.0;2021;16;TOULOUSE;MASCULIN;SCOLAIRE;BAC PROFESSIONNEL;BAC PRO PROD;BAC PRO 25304 AERONAUTIQUE OPTION STRUCTURE;69;69;67;2;0;0;0;67;0;11;21;13;22;2
8014.0;2021;16;TOULOUSE;MASCULIN;SCOLAIRE;BAC PROFESSIONNEL;BAC PRO PROD;BAC PRO 25509 TECHNIC. FROID CONDITIONNEMT AIR;28;28;17;8;3;2;1;19;0;3;1;8;7;9
8020.0;2021;16;TOULOUSE;MASCULIN;SCOLAIRE;BAC PROFESSIONNEL;BAC PRO PROD;BAC PRO AG 21004 CGEA;180;177;173;4;0;0;0;173;0;3;36;60;74;4
8027.0;2021;16;TOULOUSE;MASCULIN;SCOLAIRE;BAC PROFESSIONNEL;BAC PRO PROD;BAC PRO AG 21303 FORET;17;17;16;1;0;0;0;16;0;0;1;5;10;1
8030.0;2021;16;TOULOUSE;MASCULIN;SCOLAIRE;BAC PROFESSIONNEL;BAC PRO PROD;BAC PRO AG 22105 LABORATOIRE CONTROLE QUALITE;9;9;8;1;0;0;0;8;0;0;3;2;3;1
8038.0;2021;16;TOULOUSE;MASCULIN;SCOLAIRE;BAC PROFESSIONNEL;BAC PRO SERV;BAC PRO 31210 ACCUEIL -RELATION CLIENTS USAGERS;92;92;81;5;6;5;1;86;0;2;17;37;30;6
8044.0;2021;16;TOULOUSE;MASCULIN;SCOLAIRE;BAC PROFESSIONNEL;BAC PRO SERV;BAC PRO 33003 ACC.SOINS-S.PERS. OPT.A DOMICILE;4;4;4;0;0;0;0;4;0;0;0;2;2;0
8045.0;2021;16;TOULOUSE;MASCULIN;SCOLAIRE;BAC PROFESSIONNEL;BAC PRO SERV;BAC PRO 33004 ACC.SOINS-S.PERS. OPT.EN STRUCTUR;47;47;40;5;2;2;0;42;0;0;11;18;13;5
8048.0;2021;16;TOULOUSE;MASCULIN;SCOLAIRE;BAC PROFESSIONNEL;BAC PRO SERV;BAC PRO 33103 TECHNICIEN APPAREIL. ORTHOPEDIQUE;6;6;6;0;0;0;0;6;0;0;1;2;3;0
8054.0;2021;16;TOULOUSE;MASCULIN;SCOLAIRE;BAC TECHNOLOGIQUE;BAC ST2S;BAC ST2S SCIENCES & TECHNO. SANTE & SOCIAL;144;144;121;2;21;8;13;129;0;4;14;41;70;15
8057.0;2021;16;TOULOUSE;MASCULIN;SCOLAIRE;BAC TECHNOLOGIQUE;BAC STHR;BAC STHR SC.&TEC. HOTELLERIE-RESTAURATION;61;61;56;1;4;4;0;60;0;1;11;21;27;1
8071.0;2021;25;VERSAILLES;FEMININ;APPRENTISSAGE;BAC PROFESSIONNEL;BAC PRO PROD;BAC PRO 25106 TECHNICIEN D'USINAGE;2;2;1;1;0;0;0;1;0;0;0;1;0;1
8072.0;2021;25;VERSAILLES;FEMININ;APPRENTISSAGE;BAC PROFESSIONNEL;BAC PRO PROD;BAC PRO 25214 MAINT.VEHIC.OPTA VOIT.PARTICUL.;4;4;3;0;1;0;1;3;0;0;2;1;0;1
8083.0;2021;25;VERSAILLES;FEMININ;APPRENTISSAGE;BAC PROFESSIONNEL;BAC PRO PROD;BAC PRO AG 21405 AMENAGEMENTS PAYSAGERS;1;0;0;0;0;0;0;0;0;0;0;0;0;0
8089.0;2021;25;VERSAILLES;FEMININ;APPRENTISSAGE;BAC PROFESSIONNEL;BAC PRO SERV;BAC PRO 33004 ACC.SOINS-S.PERS. OPT.EN STRUCTUR;47;47;39;4;4;2;2;41;0;2;11;18;10;6
8097.0;2021;25;VERSAILLES;FEMININ;ENSEIGNEMENT A DISTANCE;BAC PROFESSIONNEL;BAC PRO SERV;BAC PRO 33003 ACC.SOINS-S.PERS. OPT.A DOMICILE;2;1;0;0;1;1;0;1;0;0;0;0;1;0
8108.0;2021;25;VERSAILLES;FEMININ;FORMATION CONTINUE;BAC PROFESSIONNEL;BAC PRO PROD;BAC PRO AG 21405 AMENAGEMENTS PAYSAGERS;2;2;2;0;0;0;0;2;0;0;0;0;2;0
8115.0;2021;25;VERSAILLES;FEMININ;INDIVIDUEL;BAC PROFESSIONNEL;BAC PRO PROD;BAC PRO 22106 CUISINE;1;1;1;0;0;0;0;1;0;0;0;0;1;0
8120.0;2021;25;VERSAILLES;FEMININ;INDIVIDUEL;BAC PROFESSIONNEL;BAC PRO PROD;BAC PRO AG 21113 CGEVV;1;0;0;0;0;0;0;0;0;0;0;0;0;0
8126.0;2021;25;VERSAILLES;FEMININ;INDIVIDUEL;BAC PROFESSIONNEL;BAC PRO SERV;BAC PRO 31107 CONDUCT. TRANSP.ROUT.MARCHANDISES;1;0;0;0;0;0;0;0;0;0;0;0;0;0
8127.0;2021;25;VERSAILLES;FEMININ;INDIVIDUEL;BAC PROFESSIONNEL;BAC PRO SERV;BAC PRO 31202 COMMERCE;14;10;6;2;2;2;0;8;0;0;0;0;8;2
8135.0;2021;25;VERSAILLES;FEMININ;INDIVIDUEL;BAC TECHNOLOGIQUE;BAC ST2S;BAC ST2S SCIENCES & TECHNO. SANTE & SOCIAL;37;24;11;9;4;3;1;14;0;0;1;4;9;10
8141.0;2021;25;VERSAILLES;FEMININ;INDIVIDUEL;BAC TECHNOLOGIQUE;BAC STMG;BAC STMG GESTION ET FINANCE;24;19;11;2;6;4;2;15;0;0;1;3;11;4
8147.0;2021;25;VERSAILLES;FEMININ;SCOLAIRE;BAC PROFESSIONNEL;BAC PRO PROD;BAC PRO 22004 PROC. CHIMIE EAU PAPIERS-CARTONS;1;1;1;0;0;0;0;1;0;0;0;1;0;0
8156.0;2021;25;VERSAILLES;FEMININ;SCOLAIRE;BAC PROFESSIONNEL;BAC PRO PROD;BAC PRO 23203 TECHNICIEN BAT. : ORG.REAL.GROS O;1;1;1;0;0;0;0;1;0;0;1;0;0;0
8159.0;2021;25;VERSAILLES;FEMININ;SCOLAIRE;BAC PROFESSIONNEL;BAC PRO PROD;BAC PRO 24202 ARTIS.& MET.ART : TAPIS.D'AMEUBL;7;7;5;0;2;2;0;7;0;0;0;4;3;0
8166.0;2021;25;VERSAILLES;FEMININ;SCOLAIRE;BAC PROFESSIONNEL;BAC PRO PROD;BAC PRO 25214 MAINT.VEHIC.OPTA VOIT.PARTICUL.;7;7;5;1;1;1;0;6;0;0;4;0;2;1
8173.0;2021;25;VERSAILLES;FEMININ;SCOLAIRE;BAC PROFESSIONNEL;BAC PRO PROD;BAC PRO 25515 SYST.NUM.OPT.C RES.INF.SYST.COMM.;3;3;3;0;0;0;0;3;0;0;1;2;0;0
8176.0;2021;25;VERSAILLES;FEMININ;SCOLAIRE;BAC PROFESSIONNEL;BAC PRO PROD;BAC PRO AG 21203 TECHN CONSEIL DE VENTE ANIMAL;35;35;35;0;0;0;0;35;0;1;8;9;17;0
8184.0;2021;25;VERSAILLES;FEMININ;SCOLAIRE;BAC PROFESSIONNEL;BAC PRO SERV;BAC PRO 31206 VENTE (PROSPECT.NEGO.SUIV.CLIENT;334;334;283;38;13;9;4;292;0;15;71;105;101;42
8186.0;2021;25;VERSAILLES;FEMININ;SCOLAIRE;BAC PROFESSIONNEL;BAC PRO SERV;BAC PRO 32206 FACONNAGE PRODTS IMPRIMES ROUTAGE;3;3;3;0;0;0;0;3;0;0;2;0;1;0
8191.0;2021;25;VERSAILLES;FEMININ;SCOLAIRE;BAC PROFESSIONNEL;BAC PRO SERV;BAC PRO 33002 SERVICES DE PROXIMITE  VIE LOCAL;160;159;127;17;15;10;5;137;0;4;24;48;61;22
8197.0;2021;25;VERSAILLES;FEMININ;SCOLAIRE;BAC PROFESSIONNEL;BAC PRO SERV;BAC PRO 33603 ESTHETIQUE COSMETIQUE PARFUMERIE;131;131;116;12;3;2;1;118;0;6;25;46;41;13
8200.0;2021;25;VERSAILLES;FEMININ;SCOLAIRE;BAC PROFESSIONNEL;BAC PRO SERV;BAC PRO AG 33002 SERV PERS TERRIT;37;35;28;7;0;0;0;28;0;0;4;12;12;7
8202.0;2021;25;VERSAILLES;FEMININ;SCOLAIRE;BAC TECHNOLOGIQUE;BAC S2TMD;BAC S2TMD MUSIQUE;5;5;5;0;0;0;0;5;1;0;1;2;1;0
8208.0;2021;25;VERSAILLES;FEMININ;SCOLAIRE;BAC TECHNOLOGIQUE;BAC STI2D;BAC STI2D ENERGIES  ET ENVIRONNEMENT;31;31;27;2;2;1;1;28;0;2;7;7;12;3
8211.0;2021;25;VERSAILLES;FEMININ;SCOLAIRE;BAC TECHNOLOGIQUE;BAC STL;BAC STL BIOCHIM.-BIOLOGIE-BIOTECHNOL.;276;276;252;8;16;7;9;259;2;12;66;99;80;17
8216.0;2021;25;VERSAILLES;FEMININ;SCOLAIRE;BAC TECHNOLOGIQUE;BAC STMG;BAC STMG SYSTEMES D'INFORMATION DE GESTION;123;123;99;7;17;9;8;108;0;4;8;32;64;15
8225.0;2021;25;VERSAILLES;MASCULIN;APPRENTISSAGE;BAC PROFESSIONNEL;BAC PRO PROD;BAC PRO 25214 MAINT.VEHIC.OPTA VOIT.PARTICUL.;266;253;218;28;7;7;0;225;0;17;50;94;64;28
8226.0;2021;25;VERSAILLES;MASCULIN;APPRENTISSAGE;BAC PROFESSIONNEL;BAC PRO PROD;BAC PRO 25215 MAINT.VEHIC.OPTB VEHIC.TRANS.ROUT;78;78;71;4;3;2;1;73;0;6;14;36;17;5
8227.0;2021;25;VERSAILLES;MASCULIN;APPRENTISSAGE;BAC PROFESSIONNEL;BAC PRO PROD;BAC PRO 25216 MAINT.VEHIC.OPTC MOTOCYCLES;29;29;24;4;1;1;0;25;0;2;8;5;10;4
8237.0;2021;25;VERSAILLES;MASCULIN;APPRENTISSAGE;BAC PROFESSIONNEL;BAC PRO PROD;BAC PRO 25514 SYST.NUM.OPT.B AUD.RES.EQUIP.DOM.;1;1;0;1;0;0;0;0;0;0;0;0;0;1
8240.0;2021;25;VERSAILLES;MASCULIN;APPRENTISSAGE;BAC PROFESSIONNEL;BAC PRO PROD;BAC PRO AG 21211 COND GEST ENTR HIPPIQUE;6;6;6;0;0;0;0;6;0;1;3;2;0;0
8241.0;2021;25;VERSAILLES;MASCULIN;APPRENTISSAGE;BAC PROFESSIONNEL;BAC PRO PROD;BAC PRO AG 21405 AMENAGEMENTS PAYSAGERS;32;25;22;3;0;0;0;22;0;1;4;13;4;3
8246.0;2021;25;VERSAILLES;MASCULIN;APPRENTISSAGE;BAC PROFESSIONNEL;BAC PRO SERV;BAC PRO 31202 COMMERCE;168;149;125;9;15;13;2;138;0;4;34;44;56;11
8248.0;2021;25;VERSAILLES;MASCULIN;APPRENTISSAGE;BAC PROFESSIONNEL;BAC PRO SERV;BAC PRO 33004 ACC.SOINS-S.PERS. OPT.EN STRUCTUR;1;1;0;1;0;0;0;0;0;0;0;0;0;1
8249.0;2021;25;VERSAILLES;MASCULIN;APPRENTISSAGE;BAC PROFESSIONNEL;BAC PRO SERV;BAC PRO 33403 COMMERC. SERVICES EN RESTAURATION;37;37;32;4;1;0;1;32;0;2;8;15;7;5
8250.0;2021;25;VERSAILLES;MASCULIN;APPRENTISSAGE;BAC PROFESSIONNEL;BAC PRO SERV;BAC PRO 34304 HYGIENE PROPRETE STERILISATION;11;8;4;4;0;0;0;4;0;0;1;2;1;4
8256.0;2021;25;VERSAILLES;MASCULIN;ENSEIGNEMENT A DISTANCE;BAC PROFESSIONNEL;BAC PRO SERV;BAC PRO 33004 ACC.SOINS-S.PERS. OPT.EN STRUCTUR;1;1;1;0;0;0;0;1;0;0;1;0;0;0
8261.0;2021;25;VERSAILLES;MASCULIN;ENSEIGNEMENT A DISTANCE;BAC TECHNOLOGIQUE;BAC STMG;BAC STMG SYSTEMES D'INFORMATION DE GESTION;2;2;1;0;1;1;0;2;0;0;1;0;1;0
8267.0;2021;25;VERSAILLES;MASCULIN;FORMATION CONTINUE;BAC PROFESSIONNEL;BAC PRO PROD;BAC PRO 25007 MAINTENANCE EQUIPEMENTS INDUST.;12;11;7;4;0;0;0;7;0;0;3;4;0;4
8269.0;2021;25;VERSAILLES;MASCULIN;FORMATION CONTINUE;BAC PROFESSIONNEL;BAC PRO PROD;BAC PRO 25514 SYST.NUM.OPT.B AUD.RES.EQUIP.DOM.;11;10;9;1;0;0;0;9;0;4;4;1;0;1
8271.0;2021;25;VERSAILLES;MASCULIN;FORMATION CONTINUE;BAC PROFESSIONNEL;BAC PRO SERV;BAC PRO 30001 GESTION-ADMINISTRATION;12;11;4;7;0;0;0;4;0;0;0;3;1;7
8272.0;2021;25;VERSAILLES;MASCULIN;FORMATION CONTINUE;BAC PROFESSIONNEL;BAC PRO SERV;BAC PRO 31202 COMMERCE;7;6;6;0;0;0;0;6;0;1;3;1;1;0
8276.0;2021;25;VERSAILLES;MASCULIN;INDIVIDUEL;BAC PROFESSIONNEL;BAC PRO PROD;BACPRO 20002 ETUD.DEFINITION PRDTS INDUSTRIEL;1;0;0;0;0;0;0;0;0;0;0;0;0;0
8281.0;2021;25;VERSAILLES;MASCULIN;INDIVIDUEL;BAC PROFESSIONNEL;BAC PRO PROD;BAC PRO 23203 TECHNICIEN BAT. : ORG.REAL.GROS O;1;1;0;0;1;1;0;1;0;0;0;0;1;0
8282.0;2021;25;VERSAILLES;MASCULIN;INDIVIDUEL;BAC PROFESSIONNEL;BAC PRO PROD;BAC PRO 25006 MICROTECHNIQUES;1;1;1;0;0;0;0;1;0;0;0;0;1;0
8285.0;2021;25;VERSAILLES;MASCULIN;INDIVIDUEL;BAC PROFESSIONNEL;BAC PRO PROD;BAC PRO 25214 MAINT.VEHIC.OPTA VOIT.PARTICUL.;6;5;4;1;0;0;0;4;0;0;1;1;2;1
8286.0;2021;25;VERSAILLES;MASCULIN;INDIVIDUEL;BAC PROFESSIONNEL;BAC PRO PROD;BAC PRO 25509 TECHNIC. FROID CONDITIONNEMT AIR;1;1;0;1;0;0;0;0;0;0;0;0;0;1
8292.0;2021;25;VERSAILLES;MASCULIN;INDIVIDUEL;BAC PROFESSIONNEL;BAC PRO PROD;BAC PRO AG 21113 CGEVV;3;2;2;0;0;0;0;2;0;0;0;0;2;0
8293.0;2021;25;VERSAILLES;MASCULIN;INDIVIDUEL;BAC PROFESSIONNEL;BAC PRO PROD;BAC PRO AG 21114 CONDUITE PRODUCTIONS HORTICOLES;5;4;4;0;0;0;0;4;0;0;0;0;4;0
8297.0;2021;25;VERSAILLES;MASCULIN;INDIVIDUEL;BAC PROFESSIONNEL;BAC PRO SERV;BAC PRO 30001 GESTION-ADMINISTRATION;43;36;22;12;2;1;1;23;0;0;0;5;18;13
8305.0;2021;25;VERSAILLES;MASCULIN;INDIVIDUEL;BAC PROFESSIONNEL;BAC PRO SERV;BAC PRO 33101 OPTIQUE LUNETTERIE;2;2;0;0;2;1;1;1;0;0;0;0;1;1
8308.0;2021;25;VERSAILLES;MASCULIN;INDIVIDUEL;BAC PROFESSIONNEL;BAC PRO SERV;BAC PRO 34403 METIERS DE LA SECURITE;1;1;1;0;0;0;0;1;0;0;1;0;0;0
8310.0;2021;25;VERSAILLES;MASCULIN;INDIVIDUEL;BAC TECHNOLOGIQUE;BAC STAV;BAC STAV AGRONOMIE ALIM ENV TERRITOI;1;1;1;0;0;0;0;1;0;0;0;0;1;0
8314.0;2021;25;VERSAILLES;MASCULIN;INDIVIDUEL;BAC TECHNOLOGIQUE;BAC STI2D;BAC STI2D ENERGIES  ET ENVIRONNEMENT;12;9;0;3;6;3;3;3;0;0;0;0;3;6
8320.0;2021;25;VERSAILLES;MASCULIN;INDIVIDUEL;BAC TECHNOLOGIQUE;BAC STMG;BAC STMG SYSTEMES D'INFORMATION DE GESTION;9;3;3;0;0;0;0;3;0;0;0;0;3;0
8337.0;2021;25;VERSAILLES;MASCULIN;SCOLAIRE;BAC PROFESSIONNEL;BAC PRO PROD;BAC PRO 23304 AMENAGEMENT FINITION BATIMENT;15;15;12;2;1;1;0;13;0;0;2;6;5;2
8338.0;2021;25;VERSAILLES;MASCULIN;SCOLAIRE;BAC PROFESSIONNEL;BAC PRO PROD;BAC PRO 23404 TECHNICIEN CONSTRUCTEUR BOIS;11;11;7;2;2;1;1;8;0;0;0;4;4;3
8339.0;2021;25;VERSAILLES;MASCULIN;SCOLAIRE;BAC PROFESSIONNEL;BAC PRO PROD;BAC PRO 23405 TECHNICIEN MENUISIER AGENCEUR;77;77;53;22;2;1;1;54;0;0;6;21;27;23
8340.0;2021;25;VERSAILLES;MASCULIN;SCOLAIRE;BAC PROFESSIONNEL;BAC PRO PROD;BAC PRO 23408 Etude et réalisation d'agencement;24;23;16;6;1;1;0;17;0;0;3;3;11;6
8350.0;2021;25;VERSAILLES;MASCULIN;SCOLAIRE;BAC PROFESSIONNEL;BAC PRO PROD;BAC PRO 25216 MAINT.VEHIC.OPTC MOTOCYCLES;41;41;38;0;3;2;1;40;0;2;12;14;12;1
8357.0;2021;25;VERSAILLES;MASCULIN;SCOLAIRE;BAC PROFESSIONNEL;BAC PRO PROD;BAC PRO 25406 OUVRAGES DU BATIMENT METALLERIE;8;8;5;1;2;2;0;7;0;0;2;3;2;1
8359.0;2021;25;VERSAILLES;MASCULIN;SCOLAIRE;BAC PROFESSIONNEL;BAC PRO PROD;BAC PRO 25410 CONSTRUCTION DES CARROSSERIES;12;12;12;0;0;0;0;12;0;0;4;3;5;0
8361.0;2021;25;VERSAILLES;MASCULIN;SCOLAIRE;BAC PROFESSIONNEL;BAC PRO PROD;BAC PRO 25509 TECHNIC. FROID CONDITIONNEMT AIR;90;89;56;28;5;5;0;61;0;1;10;19;31;28
8363.0;2021;25;VERSAILLES;MASCULIN;SCOLAIRE;BAC PROFESSIONNEL;BAC PRO PROD;BAC PRO 25513 SYST.NUM.OPT.A SURETE SECURITE;117;117;93;12;12;8;4;101;0;3;24;31;43;16
8365.0;2021;25;VERSAILLES;MASCULIN;SCOLAIRE;BAC PROFESSIONNEL;BAC PRO PROD;BAC PRO 25515 SYST.NUM.OPT.C RES.INF.SYST.COMM.;318;318;275;28;15;12;3;287;0;5;63;103;116;31
8367.0;2021;25;VERSAILLES;MASCULIN;SCOLAIRE;BAC PROFESSIONNEL;BAC PRO PROD;BAC PRO AG 21114 CONDUITE PRODUCTIONS HORTICOLES;8;8;7;1;0;0;0;7;0;1;0;2;4;1
8372.0;2021;25;VERSAILLES;MASCULIN;SCOLAIRE;BAC PROFESSIONNEL;BAC PRO SERV;BAC PRO 30001 GESTION-ADMINISTRATION;1027;1021;666;271;84;60;24;726;0;9;72;256;389;295
8373.0;2021;25;VERSAILLES;MASCULIN;SCOLAIRE;BAC PROFESSIONNEL;BAC PRO SERV;BAC PRO 31106 LOGISTIQUE;99;99;66;9;24;20;4;86;0;2;6;18;60;13
8377.0;2021;25;VERSAILLES;MASCULIN;SCOLAIRE;BAC PROFESSIONNEL;BAC PRO SERV;BAC PRO 31206 VENTE (PROSPECT.NEGO.SUIV.CLIENT;618;618;476;104;38;31;7;507;0;23;91;171;222;111
8396.0;2021;25;VERSAILLES;MASCULIN;SCOLAIRE;BAC TECHNOLOGIQUE;BAC STD2A;BAC STD2A SCIENCES & TECHNO. DESIGN-ARTS APPLIQUES;35;35;33;1;1;0;1;33;0;4;6;13;10;2
8397.0;2021;25;VERSAILLES;MASCULIN;SCOLAIRE;BAC TECHNOLOGIQUE;BAC STHR;BAC STHR SC.&TEC. HOTELLERIE-RESTAURATION;41;41;36;1;4;4;0;40;0;3;5;11;21;1
8400.0;2021;25;VERSAILLES;MASCULIN;SCOLAIRE;BAC TECHNOLOGIQUE;BAC STI2D;BAC STI2D INNOVATION TECHNO.  ET ECO CONCEPTION;751;751;685;12;54;17;37;702;0;25;99;279;299;49
8401.0;2021;25;VERSAILLES;MASCULIN;SCOLAIRE;BAC TECHNOLOGIQUE;BAC STI2D;BAC STI2D SYSTÈME D'INFORMATION  ET NUMERIQUE;894;894;815;12;67;35;32;850;0;14;146;346;344;44
8403.0;2021;25;VERSAILLES;MASCULIN;SCOLAIRE;BAC TECHNOLOGIQUE;BAC STL;BAC STL SCIENCES PHYSIQUES CHIMIQUES  EN LABORAT.;75;75;58;7;10;6;4;64;0;3;9;19;33;11
8407.0;2021;25;VERSAILLES;MASCULIN;SCOLAIRE;BAC TECHNOLOGIQUE;BAC STMG;BAC STMG SYSTEMES D'INFORMATION DE GESTION;288;287;218;28;41;32;9;250;0;3;19;69;159;37
8408.0;2022;02;AIX-MARSEILLE;FEMININ;APPRENTISSAGE;BAC PROFESSIONNEL;BAC PRO PROD;BAC PRO 22106 CUISINE;6;6;4;2;0;0;0;4;0;0;0;1;3;2
8411.0;2022;02;AIX-MARSEILLE;FEMININ;APPRENTISSAGE;BAC PROFESSIONNEL;BAC PRO PROD;BAC PRO 25106 TECHNICIEN D'USINAGE;1;1;1;0;0;0;0;1;0;1;0;0;0;0
8423.0;2022;02;AIX-MARSEILLE;FEMININ;APPRENTISSAGE;BAC PROFESSIONNEL;BAC PRO PROD;BAC PRO AG 21405 AMENAGEMENTS PAYSAGERS;4;3;3;0;0;0;0;3;0;0;0;0;3;0
8424.0;2022;02;AIX-MARSEILLE;FEMININ;APPRENTISSAGE;BAC PROFESSIONNEL;BAC PRO PROD;BAC PRO AG 21407 TEC CONS VTE UNIVERS JARDINERIE;1;1;0;1;0;0;0;0;0;0;0;0;0;1
8447.0;2022;02;AIX-MARSEILLE;FEMININ;ENSEIGNEMENT A DISTANCE;BAC TECHNOLOGIQUE;BAC STMG;BAC STMG RESSOURCES HUMAINES ET COMMUNICATION;3;3;2;0;1;0;1;2;0;0;0;0;2;1
8454.0;2022;02;AIX-MARSEILLE;FEMININ;FORMATION CONTINUE;BAC PROFESSIONNEL;BAC PRO SERV;BAC PRO 30001 GESTION-ADMINISTRATION;38;33;27;4;2;0;2;27;0;1;8;8;10;6
8455.0;2022;02;AIX-MARSEILLE;FEMININ;FORMATION CONTINUE;BAC PROFESSIONNEL;BAC PRO SERV;BAC PRO 31212 METIERS DE L'ACCUEIL;14;13;10;3;0;0;0;10;0;0;1;5;4;3
8464.0;2022;02;AIX-MARSEILLE;FEMININ;INDIVIDUEL;BAC PROFESSIONNEL;BAC PRO PROD;BAC PRO AG 21113 CGEVV;1;1;1;0;0;0;0;1;0;0;0;0;1;0
8466.0;2022;02;AIX-MARSEILLE;FEMININ;INDIVIDUEL;BAC PROFESSIONNEL;BAC PRO PROD;BAC PRO AG 21211 COND GEST ENTR HIPPIQUE;4;3;3;0;0;0;0;3;0;0;0;0;3;0
8467.0;2022;02;AIX-MARSEILLE;FEMININ;INDIVIDUEL;BAC PROFESSIONNEL;BAC PRO SERV;BAC PRO 30001 GESTION-ADMINISTRATION;9;4;0;4;0;0;0;0;0;0;0;0;0;4
8481.0;2022;02;AIX-MARSEILLE;FEMININ;SCOLAIRE;BAC GENERAL;BAC GENERAL;BAC GENE 10019 BAC GENERAL;9201;9201;8590;119;492;340;152;8930;249;1320;2423;2804;2134;271
8485.0;2022;02;AIX-MARSEILLE;FEMININ;SCOLAIRE;BAC PROFESSIONNEL;BAC PRO PROD;BAC PRO 22004 PROC. CHIMIE EAU PAPIERS-CARTONS;11;11;9;2;0;0;0;9;0;0;1;7;1;2
8491.0;2022;02;AIX-MARSEILLE;FEMININ;SCOLAIRE;BAC PROFESSIONNEL;BAC PRO PROD;BAC PRO 23005 TECHN. ETUDES BAT B ASSIST.ARCHI.;17;17;7;9;1;1;0;8;0;0;0;3;5;9
8496.0;2022;02;AIX-MARSEILLE;FEMININ;SCOLAIRE;BAC PROFESSIONNEL;BAC PRO PROD;BAC PRO 23405 TECHNICIEN MENUISIER AGENCEUR;6;6;4;2;0;0;0;4;0;0;2;0;2;2
8500.0;2022;02;AIX-MARSEILLE;FEMININ;SCOLAIRE;BAC PROFESSIONNEL;BAC PRO PROD;BAC PRO 25007 MAINTENANCE EQUIPEMENTS INDUST.;3;3;1;2;0;0;0;1;0;0;0;1;0;2
8506.0;2022;02;AIX-MARSEILLE;FEMININ;SCOLAIRE;BAC PROFESSIONNEL;BAC PRO PROD;BAC PRO 25406 OUVRAGES DU BATIMENT METALLERIE;1;1;1;0;0;0;0;1;0;0;0;1;0;0
8510.0;2022;02;AIX-MARSEILLE;FEMININ;SCOLAIRE;BAC PROFESSIONNEL;BAC PRO PROD;BAC PRO 25514 SYST.NUM.OPT.B AUD.RES.EQUIP.DOM.;5;5;3;1;1;1;0;4;0;1;1;1;1;1
8520.0;2022;02;AIX-MARSEILLE;FEMININ;SCOLAIRE;BAC PROFESSIONNEL;BAC PRO PROD;BAC PRO AG 21303 FORET;1;1;1;0;0;0;0;1;0;0;1;0;0;0
8528.0;2022;02;AIX-MARSEILLE;FEMININ;SCOLAIRE;BAC PROFESSIONNEL;BAC PRO SERV;BAC PRO 31108 TRANSPORT;13;13;10;2;1;0;1;10;0;0;2;4;4;3
8531.0;2022;02;AIX-MARSEILLE;FEMININ;SCOLAIRE;BAC PROFESSIONNEL;BAC PRO SERV;BAC PRO 31214 MET.COM.VEN.OP.B PR.CL.VA.OF.COM.;192;192;168;18;6;6;0;174;0;11;41;77;45;18
8533.0;2022;02;AIX-MARSEILLE;FEMININ;SCOLAIRE;BAC PROFESSIONNEL;BAC PRO SERV;BAC PRO 32208 REAL.PR.IMPR.PLURI.OPTB.PR.IMPR.;5;5;3;1;1;1;0;4;0;0;3;0;1;1
8534.0;2022;02;AIX-MARSEILLE;FEMININ;SCOLAIRE;BAC PROFESSIONNEL;BAC PRO SERV;BAC PRO 32303 ART.& MET.ART:COM.VIS.VIS.PLURI-M;33;33;27;6;0;0;0;27;0;3;5;10;9;6
8535.0;2022;02;AIX-MARSEILLE;FEMININ;SCOLAIRE;BAC PROFESSIONNEL;BAC PRO SERV;BAC PRO 32304 PHOTOGRAPHIE;17;17;12;5;0;0;0;12;0;1;3;5;3;5
8542.0;2022;02;AIX-MARSEILLE;FEMININ;SCOLAIRE;BAC PROFESSIONNEL;BAC PRO SERV;BAC PRO 33403 COMMERC. SERVICES EN RESTAURATION;33;33;26;7;0;0;0;26;0;2;6;8;10;7
8545.0;2022;02;AIX-MARSEILLE;FEMININ;SCOLAIRE;BAC PROFESSIONNEL;BAC PRO SERV;BAC PRO 34403 METIERS DE LA SECURITE;24;24;23;1;0;0;0;23;0;1;10;7;5;1
8556.0;2022;02;AIX-MARSEILLE;FEMININ;SCOLAIRE;BAC TECHNOLOGIQUE;BAC STL;BAC STL BIOCHIM.-BIOLOGIE-BIOTECHNOL.;123;123;109;2;12;8;4;117;0;6;31;37;43;6
8560.0;2022;02;AIX-MARSEILLE;FEMININ;SCOLAIRE;BAC TECHNOLOGIQUE;BAC STMG;BAC STMG RESSOURCES HUMAINES ET COMMUNICATION;644;644;520;27;97;58;39;578;0;8;50;197;323;66
8567.0;2022;02;AIX-MARSEILLE;MASCULIN;APPRENTISSAGE;BAC PROFESSIONNEL;BAC PRO PROD;BAC PRO 22704 TECHN. MAINT. SYST.ENERG.CLIMATI;15;15;12;2;1;1;0;13;0;0;1;6;6;2
8574.0;2022;02;AIX-MARSEILLE;MASCULIN;APPRENTISSAGE;BAC PROFESSIONNEL;BAC PRO PROD;BAC PRO 24203 METIERS DE LA MODE - VÊTEMENT;1;1;1;0;0;0;0;1;0;0;1;0;0;0
8585.0;2022;02;AIX-MARSEILLE;MASCULIN;APPRENTISSAGE;BAC PROFESSIONNEL;BAC PRO PROD;BAC PRO 25408 REPARATION DES CARROSSERIES;17;17;9;6;2;1;1;10;0;0;0;6;4;7
8586.0;2022;02;AIX-MARSEILLE;MASCULIN;APPRENTISSAGE;BAC PROFESSIONNEL;BAC PRO PROD;BAC PRO 25411 TECH.CHAUDRONNERIE INDUSTRIELLE;17;17;13;2;2;1;1;14;0;3;1;6;4;3
8588.0;2022;02;AIX-MARSEILLE;MASCULIN;APPRENTISSAGE;BAC PROFESSIONNEL;BAC PRO PROD;BAC PRO 25514 SYST.NUM.OPT.B AUD.RES.EQUIP.DOM.;4;2;1;1;0;0;0;1;0;0;0;0;1;1
8594.0;2022;02;AIX-MARSEILLE;MASCULIN;APPRENTISSAGE;BAC PROFESSIONNEL;BAC PRO PROD;BAC PRO AG 21210 COND GEST ENTR CANIN ET FELIN;1;1;1;0;0;0;0;1;0;0;0;0;1;0
8601.0;2022;02;AIX-MARSEILLE;MASCULIN;APPRENTISSAGE;BAC PROFESSIONNEL;BAC PRO SERV;BAC PRO 31212 METIERS DE L'ACCUEIL;13;7;3;4;0;0;0;3;0;0;0;0;3;4
8607.0;2022;02;AIX-MARSEILLE;MASCULIN;APPRENTISSAGE;BAC PROFESSIONNEL;BAC PRO SERV;BAC PRO 33101 OPTIQUE LUNETTERIE;2;2;1;0;1;1;0;2;0;0;0;1;1;0
8609.0;2022;02;AIX-MARSEILLE;MASCULIN;APPRENTISSAGE;BAC PROFESSIONNEL;BAC PRO SERV;BAC PRO 33403 COMMERC. SERVICES EN RESTAURATION;11;10;8;2;0;0;0;8;0;0;1;7;0;2
8612.0;2022;02;AIX-MARSEILLE;MASCULIN;ENSEIGNEMENT A DISTANCE;BAC GENERAL;BAC GENERAL;BAC GENE 10019 BAC GENERAL;57;54;41;9;4;2;2;43;0;1;7;18;17;11
8613.0;2022;02;AIX-MARSEILLE;MASCULIN;ENSEIGNEMENT A DISTANCE;BAC PROFESSIONNEL;BAC PRO SERV;BAC PRO 30001 GESTION-ADMINISTRATION;2;2;2;0;0;0;0;2;0;0;0;1;1;0
8617.0;2022;02;AIX-MARSEILLE;MASCULIN;ENSEIGNEMENT A DISTANCE;BAC TECHNOLOGIQUE;BAC STMG;BAC STMG MERCATIQUE (MARKETING);4;4;3;1;0;0;0;3;0;0;0;2;1;1
8619.0;2022;02;AIX-MARSEILLE;MASCULIN;ENSEIGNEMENT A DISTANCE;BAC TECHNOLOGIQUE;BAC STMG;BAC STMG SYSTEMES D'INFORMATION DE GESTION;1;1;0;1;0;0;0;0;0;0;0;0;0;1
8637.0;2022;02;AIX-MARSEILLE;MASCULIN;INDIVIDUEL;BAC PROFESSIONNEL;BAC PRO PROD;BAC PRO 25513 SYST.NUM.OPT.A SURETE SECURITE;1;0;0;0;0;0;0;0;0;0;0;0;0;0
8645.0;2022;02;AIX-MARSEILLE;MASCULIN;INDIVIDUEL;BAC PROFESSIONNEL;BAC PRO SERV;BAC PRO 30001 GESTION-ADMINISTRATION;6;4;1;3;0;0;0;1;0;0;0;0;1;3
8649.0;2022;02;AIX-MARSEILLE;MASCULIN;INDIVIDUEL;BAC PROFESSIONNEL;BAC PRO SERV;BAC PRO 32207 REAL.PR.IMPR.PLURI.OPTA.PR.GRAPH.;1;1;1;0;0;0;0;1;0;0;0;0;1;0
8651.0;2022;02;AIX-MARSEILLE;MASCULIN;INDIVIDUEL;BAC PROFESSIONNEL;BAC PRO SERV;BAC PRO 33004 ACC.SOINS-S.PERS. OPT.EN STRUCTUR;1;0;0;0;0;0;0;0;0;0;0;0;0;0
8654.0;2022;02;AIX-MARSEILLE;MASCULIN;INDIVIDUEL;BAC TECHNOLOGIQUE;BAC ST2S;BAC ST2S SCIENCES & TECHNO. SANTE & SOCIAL;3;1;0;1;0;0;0;0;0;0;0;0;0;1
8658.0;2022;02;AIX-MARSEILLE;MASCULIN;INDIVIDUEL;BAC TECHNOLOGIQUE;BAC STI2D;BAC STI2D SYSTÈME D'INFORMATION  ET NUMERIQUE;6;3;1;2;0;0;0;1;0;0;1;0;0;2
8659.0;2022;02;AIX-MARSEILLE;MASCULIN;INDIVIDUEL;BAC TECHNOLOGIQUE;BAC STL;BAC STL BIOCHIM.-BIOLOGIE-BIOTECHNOL.;1;1;0;1;0;0;0;0;0;0;0;0;0;1
8662.0;2022;02;AIX-MARSEILLE;MASCULIN;INDIVIDUEL;BAC TECHNOLOGIQUE;BAC STMG;BAC STMG MERCATIQUE (MARKETING);18;11;6;4;1;0;1;6;0;0;2;2;2;5
8666.0;2022;02;AIX-MARSEILLE;MASCULIN;SCOLAIRE;BAC PROFESSIONNEL;BAC PRO PROD;BACPRO 20002 ETUD.DEFINITION PRDTS INDUSTRIEL;30;30;21;8;1;1;0;22;0;4;4;6;8;8
8672.0;2022;02;AIX-MARSEILLE;MASCULIN;SCOLAIRE;BAC PROFESSIONNEL;BAC PRO PROD;BAC PRO 22403 ARTS.& MET.ART:MET.ENSEIGN SIGNA;1;1;1;0;0;0;0;1;0;0;1;0;0;0
8680.0;2022;02;AIX-MARSEILLE;MASCULIN;SCOLAIRE;BAC PROFESSIONNEL;BAC PRO PROD;BAC PRO 23203 TECHNICIEN BAT. : ORG.REAL.GROS O;29;29;16;8;5;2;3;18;0;0;3;7;8;11
8682.0;2022;02;AIX-MARSEILLE;MASCULIN;SCOLAIRE;BAC PROFESSIONNEL;BAC PRO PROD;BAC PRO 23303 MENUISERIE ALUMINIUM-VERRE;7;7;5;1;1;0;1;5;0;0;0;1;4;2
8685.0;2022;02;AIX-MARSEILLE;MASCULIN;SCOLAIRE;BAC PROFESSIONNEL;BAC PRO PROD;BAC PRO 23405 TECHNICIEN MENUISIER AGENCEUR;41;41;30;10;1;1;0;31;0;2;9;12;8;10
8688.0;2022;02;AIX-MARSEILLE;MASCULIN;SCOLAIRE;BAC PROFESSIONNEL;BAC PRO PROD;BAC PRO 25006 MICROTECHNIQUES;34;34;24;6;4;4;0;28;0;0;4;11;13;6
8694.0;2022;02;AIX-MARSEILLE;MASCULIN;SCOLAIRE;BAC PROFESSIONNEL;BAC PRO PROD;BAC PRO 25215 MAINT.VEHIC.OPTB VEHIC.TRANS.ROUT;34;34;27;5;2;2;0;29;0;0;6;14;9;5
8695.0;2022;02;AIX-MARSEILLE;MASCULIN;SCOLAIRE;BAC PROFESSIONNEL;BAC PRO PROD;BAC PRO 25216 MAINT.VEHIC.OPTC MOTOCYCLES;27;27;23;4;0;0;0;23;0;0;2;9;12;4
8696.0;2022;02;AIX-MARSEILLE;MASCULIN;SCOLAIRE;BAC PROFESSIONNEL;BAC PRO PROD;BAC PRO 25219 MAINT.MATERIELS OPT.A AGRICOLES;10;10;8;0;2;0;2;8;0;2;4;0;2;2
8697.0;2022;02;AIX-MARSEILLE;MASCULIN;SCOLAIRE;BAC PROFESSIONNEL;BAC PRO PROD;BAC PRO 25220 MAINT.MATERIELS OPT.B TP MANUT.;17;17;11;5;1;0;1;11;0;0;2;3;6;6
8703.0;2022;02;AIX-MARSEILLE;MASCULIN;SCOLAIRE;BAC PROFESSIONNEL;BAC PRO PROD;BAC PRO 25408 REPARATION DES CARROSSERIES;27;27;17;9;1;1;0;18;0;0;3;10;5;9
8705.0;2022;02;AIX-MARSEILLE;MASCULIN;SCOLAIRE;BAC PROFESSIONNEL;BAC PRO PROD;BAC PRO 25509 TECHNIC. FROID CONDITIONNEMT AIR;63;62;43;12;7;6;1;49;0;2;6;17;24;13
8707.0;2022;02;AIX-MARSEILLE;MASCULIN;SCOLAIRE;BAC PROFESSIONNEL;BAC PRO PROD;BAC PRO 25513 SYST.NUM.OPT.A SURETE SECURITE;84;83;53;23;7;5;2;58;0;1;12;19;26;25
8714.0;2022;02;AIX-MARSEILLE;MASCULIN;SCOLAIRE;BAC PROFESSIONNEL;BAC PRO PROD;BAC PRO AG 21203 TECHN CONSEIL DE VENTE ANIMAL;17;17;15;2;0;0;0;15;0;0;0;3;12;2
8717.0;2022;02;AIX-MARSEILLE;MASCULIN;SCOLAIRE;BAC PROFESSIONNEL;BAC PRO PROD;BAC PRO AG 21303 FORET;9;9;7;2;0;0;0;7;0;0;0;3;4;2
8726.0;2022;02;AIX-MARSEILLE;MASCULIN;SCOLAIRE;BAC PROFESSIONNEL;BAC PRO SERV;BAC PRO 31212 METIERS DE L'ACCUEIL;100;99;74;20;5;2;3;76;0;3;14;19;40;23
8727.0;2022;02;AIX-MARSEILLE;MASCULIN;SCOLAIRE;BAC PROFESSIONNEL;BAC PRO SERV;BAC PRO 31213 MET.COM.VEN.OP.A ANI.GES.ESP.COM.;357;353;278;55;20;14;6;292;0;5;43;100;144;61
8732.0;2022;02;AIX-MARSEILLE;MASCULIN;SCOLAIRE;BAC PROFESSIONNEL;BAC PRO SERV;BAC PRO 32304 PHOTOGRAPHIE;6;6;4;1;1;1;0;5;0;0;2;1;2;1
8738.0;2022;02;AIX-MARSEILLE;MASCULIN;SCOLAIRE;BAC PROFESSIONNEL;BAC PRO SERV;BAC PRO 33103 TECHNICIEN APPAREIL. ORTHOPEDIQUE;11;11;8;2;1;0;1;8;0;0;2;3;3;3
8745.0;2022;02;AIX-MARSEILLE;MASCULIN;SCOLAIRE;BAC TECHNOLOGIQUE;BAC STAV;BAC STAV AGRONOMIE ALIM ENV TERRITOI;82;81;78;3;0;0;0;78;0;1;12;27;38;3
8751.0;2022;02;AIX-MARSEILLE;MASCULIN;SCOLAIRE;BAC TECHNOLOGIQUE;BAC STI2D;BAC STI2D SYSTÈME D'INFORMATION  ET NUMERIQUE;390;390;335;14;41;30;11;365;1;8;47;123;186;25
8756.0;2022;02;AIX-MARSEILLE;MASCULIN;SCOLAIRE;BAC TECHNOLOGIQUE;BAC STMG;BAC STMG RESSOURCES HUMAINES ET COMMUNICATION;242;242;165;23;54;35;19;200;0;1;8;51;140;42
8760.0;2022;20;AMIENS;FEMININ;APPRENTISSAGE;BAC PROFESSIONNEL;BAC PRO PROD;BAC PRO 23304 AMENAGEMENT FINITION BATIMENT;1;1;1;0;0;0;0;1;0;0;0;0;1;0
8761.0;2022;20;AMIENS;FEMININ;APPRENTISSAGE;BAC PROFESSIONNEL;BAC PRO PROD;BAC PRO 25007 MAINTENANCE EQUIPEMENTS INDUST.;1;1;1;0;0;0;0;1;0;0;0;1;0;0
8762.0;2022;20;AMIENS;FEMININ;APPRENTISSAGE;BAC PROFESSIONNEL;BAC PRO PROD;BAC PRO 25106 TECHNICIEN D'USINAGE;1;1;1;0;0;0;0;1;0;0;0;1;0;0
8768.0;2022;20;AMIENS;FEMININ;APPRENTISSAGE;BAC PROFESSIONNEL;BAC PRO PROD;BAC PRO AG 21004 CGEA;6;6;6;0;0;0;0;6;0;0;1;1;4;0
8781.0;2022;20;AMIENS;FEMININ;ENSEIGNEMENT A DISTANCE;BAC TECHNOLOGIQUE;BAC STMG;BAC STMG MERCATIQUE (MARKETING);4;4;2;2;0;0;0;2;0;0;0;0;2;2
8785.0;2022;20;AMIENS;FEMININ;INDIVIDUEL;BAC GENERAL;BAC GENERAL;BAC GENE 10019 BAC GENERAL;64;46;24;12;10;6;4;30;0;3;9;7;11;16
8792.0;2022;20;AMIENS;FEMININ;INDIVIDUEL;BAC PROFESSIONNEL;BAC PRO SERV;BAC PRO 31212 METIERS DE L'ACCUEIL;2;1;1;0;0;0;0;1;0;0;0;0;1;0
8798.0;2022;20;AMIENS;FEMININ;INDIVIDUEL;BAC TECHNOLOGIQUE;BAC ST2S;BAC ST2S SCIENCES & TECHNO. SANTE & SOCIAL;7;4;0;4;0;0;0;0;0;0;0;0;0;4
8799.0;2022;20;AMIENS;FEMININ;INDIVIDUEL;BAC TECHNOLOGIQUE;BAC STAV;BAC STAV AGRONOMIE ALIM ENV TERRITOI;1;0;0;0;0;0;0;0;0;0;0;0;0;0
8803.0;2022;20;AMIENS;FEMININ;INDIVIDUEL;BAC TECHNOLOGIQUE;BAC STMG;BAC STMG RESSOURCES HUMAINES ET COMMUNICATION;3;1;0;1;0;0;0;0;0;0;0;0;0;1
8805.0;2022;20;AMIENS;FEMININ;SCOLAIRE;BAC PROFESSIONNEL;BAC PRO PROD;BACPRO 20002 ETUD.DEFINITION PRDTS INDUSTRIEL;2;2;2;0;0;0;0;2;0;0;1;1;0;0
8806.0;2022;20;AMIENS;FEMININ;SCOLAIRE;BAC PROFESSIONNEL;BAC PRO PROD;BAC PRO 22003 BIO-INDUSTRIES DE TRANSFORMATION;9;9;8;1;0;0;0;8;0;1;1;3;3;1
8812.0;2022;20;AMIENS;FEMININ;SCOLAIRE;BAC PROFESSIONNEL;BAC PRO PROD;BAC PRO 22703 TECHN.INSTALL.SYST.ENERG.CLIMATI;1;1;0;1;0;0;0;0;0;0;0;0;0;1
8813.0;2022;20;AMIENS;FEMININ;SCOLAIRE;BAC PROFESSIONNEL;BAC PRO PROD;BAC PRO 23004 TECHN. ETUDES BAT.A ETUDES & ECO.;3;3;3;0;0;0;0;3;0;0;0;1;2;0
8816.0;2022;20;AMIENS;FEMININ;SCOLAIRE;BAC PROFESSIONNEL;BAC PRO PROD;BAC PRO 23304 AMENAGEMENT FINITION BATIMENT;1;1;1;0;0;0;0;1;0;0;1;0;0;0
8823.0;2022;20;AMIENS;FEMININ;SCOLAIRE;BAC PROFESSIONNEL;BAC PRO PROD;BAC PRO 25106 TECHNICIEN D'USINAGE;4;4;3;1;0;0;0;3;0;1;1;0;1;1
8826.0;2022;20;AMIENS;FEMININ;SCOLAIRE;BAC PROFESSIONNEL;BAC PRO PROD;BAC PRO 25220 MAINT.MATERIELS OPT.B TP MANUT.;1;1;1;0;0;0;0;1;0;0;0;0;1;0
8827.0;2022;20;AMIENS;FEMININ;SCOLAIRE;BAC PROFESSIONNEL;BAC PRO PROD;BAC PRO 25303 AERONAUTIQUE OPTION SYSTEMES;1;1;1;0;0;0;0;1;0;0;0;1;0;0
8828.0;2022;20;AMIENS;FEMININ;SCOLAIRE;BAC PROFESSIONNEL;BAC PRO PROD;BAC PRO 25411 TECH.CHAUDRONNERIE INDUSTRIELLE;1;1;1;0;0;0;0;1;0;0;0;0;1;0
8836.0;2022;20;AMIENS;FEMININ;SCOLAIRE;BAC PROFESSIONNEL;BAC PRO PROD;BAC PRO AG 21203 TECHN CONSEIL DE VENTE ANIMAL;15;15;11;4;0;0;0;11;0;0;0;5;6;4
8838.0;2022;20;AMIENS;FEMININ;SCOLAIRE;BAC PROFESSIONNEL;BAC PRO PROD;BAC PRO AG 21302 GEST MILIEUX NATURELS FAUNE;14;14;13;1;0;0;0;13;0;0;2;3;8;1
8845.0;2022;20;AMIENS;FEMININ;SCOLAIRE;BAC PROFESSIONNEL;BAC PRO SERV;BAC PRO 31108 TRANSPORT;4;4;3;1;0;0;0;3;0;0;2;1;0;1
8847.0;2022;20;AMIENS;FEMININ;SCOLAIRE;BAC PROFESSIONNEL;BAC PRO SERV;BAC PRO 31213 MET.COM.VEN.OP.A ANI.GES.ESP.COM.;387;384;291;81;12;5;7;296;0;29;52;117;98;88
8848.0;2022;20;AMIENS;FEMININ;SCOLAIRE;BAC PROFESSIONNEL;BAC PRO SERV;BAC PRO 31214 MET.COM.VEN.OP.B PR.CL.VA.OF.COM.;128;128;103;21;4;3;1;106;0;7;20;42;37;22
8858.0;2022;20;AMIENS;FEMININ;SCOLAIRE;BAC PROFESSIONNEL;BAC PRO SERV;BAC PRO 34403 METIERS DE LA SECURITE;40;40;34;6;0;0;0;34;0;2;13;14;5;6
8860.0;2022;20;AMIENS;FEMININ;SCOLAIRE;BAC TECHNOLOGIQUE;BAC ST2S;BAC ST2S SCIENCES & TECHNO. SANTE & SOCIAL;688;688;557;25;106;61;45;618;4;18;99;208;289;70
8866.0;2022;20;AMIENS;FEMININ;SCOLAIRE;BAC TECHNOLOGIQUE;BAC STI2D;BAC STI2D INNOVATION TECHNO.  ET ECO CONCEPTION;12;12;11;0;1;1;0;12;0;0;0;5;7;0
8867.0;2022;20;AMIENS;FEMININ;SCOLAIRE;BAC TECHNOLOGIQUE;BAC STI2D;BAC STI2D SYSTÈME D'INFORMATION  ET NUMERIQUE;10;10;8;0;2;1;1;9;0;0;2;2;5;1
8869.0;2022;20;AMIENS;FEMININ;SCOLAIRE;BAC TECHNOLOGIQUE;BAC STL;BAC STL SCIENCES PHYSIQUES CHIMIQUES  EN LABORAT.;56;56;45;9;2;1;1;46;1;1;9;16;19;10
8870.0;2022;20;AMIENS;FEMININ;SCOLAIRE;BAC TECHNOLOGIQUE;BAC STMG;BAC STMG GESTION ET FINANCE;240;240;191;13;36;22;14;213;0;5;33;72;103;27
8874.0;2022;20;AMIENS;MASCULIN;APPRENTISSAGE;BAC PROFESSIONNEL;BAC PRO PROD;BAC PRO 20102 PILOTE DE LIGNE DE PRODUCTION;5;5;5;0;0;0;0;5;0;1;3;1;0;0
8875.0;2022;20;AMIENS;MASCULIN;APPRENTISSAGE;BAC PROFESSIONNEL;BAC PRO PROD;BAC PRO 22106 CUISINE;26;26;20;5;1;0;1;20;0;1;2;6;11;6
8877.0;2022;20;AMIENS;MASCULIN;APPRENTISSAGE;BAC PROFESSIONNEL;BAC PRO PROD;BAC PRO 22703 TECHN.INSTALL.SYST.ENERG.CLIMATI;2;2;1;1;0;0;0;1;0;0;0;0;1;1
8880.0;2022;20;AMIENS;MASCULIN;APPRENTISSAGE;BAC PROFESSIONNEL;BAC PRO PROD;BAC PRO 23102 TRAVAUX PUBLICS;20;19;18;1;0;0;0;18;0;1;2;12;3;1
8888.0;2022;20;AMIENS;MASCULIN;APPRENTISSAGE;BAC PROFESSIONNEL;BAC PRO PROD;BAC PRO 25106 TECHNICIEN D'USINAGE;16;16;12;4;0;0;0;12;0;1;2;3;6;4
8891.0;2022;20;AMIENS;MASCULIN;APPRENTISSAGE;BAC PROFESSIONNEL;BAC PRO PROD;BAC PRO 25216 MAINT.VEHIC.OPTC MOTOCYCLES;6;6;5;1;0;0;0;5;0;0;1;3;1;1
8897.0;2022;20;AMIENS;MASCULIN;APPRENTISSAGE;BAC PROFESSIONNEL;BAC PRO PROD;BAC PRO 25411 TECH.CHAUDRONNERIE INDUSTRIELLE;58;58;55;1;2;1;1;56;0;4;16;21;15;2
8902.0;2022;20;AMIENS;MASCULIN;APPRENTISSAGE;BAC PROFESSIONNEL;BAC PRO PROD;BAC PRO AG 21114 CONDUITE PRODUCTIONS HORTICOLES;1;1;1;0;0;0;0;1;0;0;1;0;0;0
8907.0;2022;20;AMIENS;MASCULIN;APPRENTISSAGE;BAC PROFESSIONNEL;BAC PRO SERV;BAC PRO 31213 MET.COM.VEN.OP.A ANI.GES.ESP.COM.;48;46;32;11;3;3;0;35;0;4;8;7;16;11
8911.0;2022;20;AMIENS;MASCULIN;ENSEIGNEMENT A DISTANCE;BAC GENERAL;BAC GENERAL;BAC GENE 10019 BAC GENERAL;10;9;7;1;1;0;1;7;0;1;0;3;3;2
8918.0;2022;20;AMIENS;MASCULIN;FORMATION CONTINUE;BAC PROFESSIONNEL;BAC PRO PROD;BAC PRO 23102 TRAVAUX PUBLICS;1;1;1;0;0;0;0;1;0;0;0;1;0;0
8931.0;2022;20;AMIENS;MASCULIN;INDIVIDUEL;BAC PROFESSIONNEL;BAC PRO PROD;BAC PRO 25513 SYST.NUM.OPT.A SURETE SECURITE;1;1;0;1;0;0;0;0;0;0;0;0;0;1
8938.0;2022;20;AMIENS;MASCULIN;INDIVIDUEL;BAC TECHNOLOGIQUE;BAC STI2D;BAC STI2D ARCHITECTURE ET CONSTRUCTION;1;1;1;0;0;0;0;1;0;0;0;0;1;0
8945.0;2022;20;AMIENS;MASCULIN;INDIVIDUEL;BAC TECHNOLOGIQUE;BAC STMG;BAC STMG SYSTEMES D'INFORMATION DE GESTION;2;2;1;1;0;0;0;1;0;0;0;0;1;1
8955.0;2022;20;AMIENS;MASCULIN;SCOLAIRE;BAC PROFESSIONNEL;BAC PRO PROD;BAC PRO 22703 TECHN.INSTALL.SYST.ENERG.CLIMATI;38;38;24;14;0;0;0;24;0;1;1;6;16;14
8957.0;2022;20;AMIENS;MASCULIN;SCOLAIRE;BAC PROFESSIONNEL;BAC PRO PROD;BAC PRO 23004 TECHN. ETUDES BAT.A ETUDES & ECO.;12;12;10;2;0;0;0;10;0;1;1;2;6;2
8958.0;2022;20;AMIENS;MASCULIN;SCOLAIRE;BAC PROFESSIONNEL;BAC PRO PROD;BAC PRO 23005 TECHN. ETUDES BAT B ASSIST.ARCHI.;23;23;18;5;0;0;0;18;0;1;5;5;7;5
8961.0;2022;20;AMIENS;MASCULIN;SCOLAIRE;BAC PROFESSIONNEL;BAC PRO PROD;BAC PRO 23203 TECHNICIEN BAT. : ORG.REAL.GROS O;31;31;18;9;4;3;1;21;0;1;2;11;7;10
8965.0;2022;20;AMIENS;MASCULIN;SCOLAIRE;BAC PROFESSIONNEL;BAC PRO PROD;BAC PRO 23404 TECHNICIEN CONSTRUCTEUR BOIS;10;10;7;3;0;0;0;7;0;1;0;2;4;3
8969.0;2022;20;AMIENS;MASCULIN;SCOLAIRE;BAC PROFESSIONNEL;BAC PRO PROD;BAC PRO 24203 METIERS DE LA MODE - VÊTEMENT;8;8;7;1;0;0;0;7;0;0;1;4;2;1
8970.0;2022;20;AMIENS;MASCULIN;SCOLAIRE;BAC PROFESSIONNEL;BAC PRO PROD;BAC PRO 25005 PRODUCTIQ.MECA. OPT.DECOLLETAGE;5;5;4;1;0;0;0;4;0;0;0;1;3;1
8978.0;2022;20;AMIENS;MASCULIN;SCOLAIRE;BAC PROFESSIONNEL;BAC PRO PROD;BAC PRO 25216 MAINT.VEHIC.OPTC MOTOCYCLES;17;17;17;0;0;0;0;17;0;5;4;3;5;0
8994.0;2022;20;AMIENS;MASCULIN;SCOLAIRE;BAC PROFESSIONNEL;BAC PRO PROD;BAC PRO AG 21114 CONDUITE PRODUCTIONS HORTICOLES;5;5;4;1;0;0;0;4;0;1;0;2;1;1
8998.0;2022;20;AMIENS;MASCULIN;SCOLAIRE;BAC PROFESSIONNEL;BAC PRO PROD;BAC PRO AG 21302 GEST MILIEUX NATURELS FAUNE;55;54;53;1;0;0;0;53;0;2;10;20;21;1
9013.0;2022;20;AMIENS;MASCULIN;SCOLAIRE;BAC PROFESSIONNEL;BAC PRO SERV;BAC PRO 33004 ACC.SOINS-S.PERS. OPT.EN STRUCTUR;36;36;34;2;0;0;0;34;0;2;11;10;11;2
9016.0;2022;20;AMIENS;MASCULIN;SCOLAIRE;BAC PROFESSIONNEL;BAC PRO SERV;BAC PRO 33603 ESTHETIQUE COSMETIQUE PARFUMERIE;1;1;1;0;0;0;0;1;0;0;0;1;0;0
9017.0;2022;20;AMIENS;MASCULIN;SCOLAIRE;BAC PROFESSIONNEL;BAC PRO SERV;BAC PRO 34304 HYGIENE PROPRETE STERILISATION;7;7;5;0;2;0;2;5;0;0;0;4;1;2
9023.0;2022;20;AMIENS;MASCULIN;SCOLAIRE;BAC TECHNOLOGIQUE;BAC STHR;BAC STHR SC.&TEC. HOTELLERIE-RESTAURATION;20;20;18;0;2;2;0;20;0;1;9;2;8;0
9025.0;2022;20;AMIENS;MASCULIN;SCOLAIRE;BAC TECHNOLOGIQUE;BAC STI2D;BAC STI2D ENERGIES  ET ENVIRONNEMENT;144;144;110;12;22;18;4;128;0;2;13;40;73;16
9028.0;2022;20;AMIENS;MASCULIN;SCOLAIRE;BAC TECHNOLOGIQUE;BAC STL;BAC STL BIOCHIM.-BIOLOGIE-BIOTECHNOL.;29;29;25;1;3;1;2;26;0;4;2;9;11;3
9031.0;2022;20;AMIENS;MASCULIN;SCOLAIRE;BAC TECHNOLOGIQUE;BAC STMG;BAC STMG MERCATIQUE (MARKETING);512;512;371;33;108;70;38;441;0;1;33;116;291;71
9036.0;2022;03;BESANCON;FEMININ;APPRENTISSAGE;BAC PROFESSIONNEL;BAC PRO PROD;BAC PRO 22106 CUISINE;3;3;3;0;0;0;0;3;0;0;1;1;1;0
9040.0;2022;03;BESANCON;FEMININ;APPRENTISSAGE;BAC PROFESSIONNEL;BAC PRO PROD;BACPRO 23103 TECHNICIEN GEOMETRE-TOPOGRAPHE;1;1;1;0;0;0;0;1;0;1;0;0;0;0
9042.0;2022;03;BESANCON;FEMININ;APPRENTISSAGE;BAC PROFESSIONNEL;BAC PRO PROD;BAC PRO 24002 METIERS PRESSING BLANCHISSERIE;2;2;1;1;0;0;0;1;0;0;0;0;1;1
9053.0;2022;03;BESANCON;FEMININ;APPRENTISSAGE;BAC PROFESSIONNEL;BAC PRO PROD;BAC PRO AG 22107 TEC CONS VTE ALIMENTATION P.ALIM;4;3;3;0;0;0;0;3;0;0;0;0;3;0
9057.0;2022;03;BESANCON;FEMININ;APPRENTISSAGE;BAC PROFESSIONNEL;BAC PRO SERV;BAC PRO 31213 MET.COM.VEN.OP.A ANI.GES.ESP.COM.;59;59;47;9;3;3;0;50;0;6;8;19;17;9
9060.0;2022;03;BESANCON;FEMININ;APPRENTISSAGE;BAC PROFESSIONNEL;BAC PRO SERV;BAC PRO 33004 ACC.SOINS-S.PERS. OPT.EN STRUCTUR;3;3;2;1;0;0;0;2;0;0;1;1;0;1
9061.0;2022;03;BESANCON;FEMININ;APPRENTISSAGE;BAC PROFESSIONNEL;BAC PRO SERV;BAC PRO 33101 OPTIQUE LUNETTERIE;1;1;1;0;0;0;0;1;0;0;0;1;0;0
9063.0;2022;03;BESANCON;FEMININ;APPRENTISSAGE;BAC PROFESSIONNEL;BAC PRO SERV;BAC PRO 33403 COMMERC. SERVICES EN RESTAURATION;5;5;4;1;0;0;0;4;0;1;1;0;2;1
9068.0;2022;03;BESANCON;FEMININ;ENSEIGNEMENT A DISTANCE;BAC PROFESSIONNEL;BAC PRO SERV;BAC PRO 30001 GESTION-ADMINISTRATION;1;1;1;0;0;0;0;1;0;0;1;0;0;0
9070.0;2022;03;BESANCON;FEMININ;ENSEIGNEMENT A DISTANCE;BAC PROFESSIONNEL;BAC PRO SERV;BAC PRO 33004 ACC.SOINS-S.PERS. OPT.EN STRUCTUR;1;1;1;0;0;0;0;1;0;0;1;0;0;0
9077.0;2022;03;BESANCON;FEMININ;INDIVIDUEL;BAC PROFESSIONNEL;BAC PRO PROD;BAC PRO AG 21004 CGEA;1;1;0;1;0;0;0;0;0;0;0;0;0;1
9086.0;2022;03;BESANCON;FEMININ;SCOLAIRE;BAC PROFESSIONNEL;BAC PRO PROD;BAC PRO 23005 TECHN. ETUDES BAT B ASSIST.ARCHI.;8;8;5;3;0;0;0;5;0;0;2;1;2;3
9091.0;2022;03;BESANCON;FEMININ;SCOLAIRE;BAC PROFESSIONNEL;BAC PRO PROD;BAC PRO 24002 METIERS PRESSING BLANCHISSERIE;4;4;2;2;0;0;0;2;0;0;0;0;2;2
9105.0;2022;03;BESANCON;FEMININ;SCOLAIRE;BAC PROFESSIONNEL;BAC PRO PROD;BAC PRO AG 21114 CONDUITE PRODUCTIONS HORTICOLES;2;1;1;0;0;0;0;1;0;0;0;0;1;0
9107.0;2022;03;BESANCON;FEMININ;SCOLAIRE;BAC PROFESSIONNEL;BAC PRO PROD;BAC PRO AG 21211 COND GEST ENTR HIPPIQUE;39;38;37;1;0;0;0;37;0;0;8;13;16;1
9113.0;2022;03;BESANCON;FEMININ;SCOLAIRE;BAC PROFESSIONNEL;BAC PRO SERV;BAC PRO 31106 LOGISTIQUE;3;3;2;1;0;0;0;2;0;1;0;0;1;1
9114.0;2022;03;BESANCON;FEMININ;SCOLAIRE;BAC PROFESSIONNEL;BAC PRO SERV;BAC PRO 31107 CONDUCT. TRANSP.ROUT.MARCHANDISES;4;4;4;0;0;0;0;4;0;0;0;2;2;0
9127.0;2022;03;BESANCON;FEMININ;SCOLAIRE;BAC TECHNOLOGIQUE;BAC S2TMD;BAC S2TMD DANSE;3;3;3;0;0;0;0;3;0;1;0;1;1;0
9129.0;2022;03;BESANCON;FEMININ;SCOLAIRE;BAC TECHNOLOGIQUE;BAC ST2S;BAC ST2S SCIENCES & TECHNO. SANTE & SOCIAL;273;273;234;9;30;18;12;252;0;6;51;94;101;21
9136.0;2022;03;BESANCON;FEMININ;SCOLAIRE;BAC TECHNOLOGIQUE;BAC STI2D;BAC STI2D SYSTÈME D'INFORMATION  ET NUMERIQUE;5;5;4;0;1;1;0;5;0;0;0;0;5;0
9139.0;2022;03;BESANCON;FEMININ;SCOLAIRE;BAC TECHNOLOGIQUE;BAC STMG;BAC STMG GESTION ET FINANCE;110;110;99;2;9;4;5;103;0;4;24;42;33;7
9144.0;2022;03;BESANCON;MASCULIN;APPRENTISSAGE;BAC PROFESSIONNEL;BAC PRO PROD;BAC PRO 22004 PROC. CHIMIE EAU PAPIERS-CARTONS;1;1;0;1;0;0;0;0;0;0;0;0;0;1
9152.0;2022;03;BESANCON;MASCULIN;APPRENTISSAGE;BAC PROFESSIONNEL;BAC PRO PROD;BAC PRO 23207 INTERV. SUR PATRIMOINE BATI OPT.C;6;6;6;0;0;0;0;6;0;1;1;3;1;0
9158.0;2022;03;BESANCON;MASCULIN;APPRENTISSAGE;BAC PROFESSIONNEL;BAC PRO PROD;BAC PRO 25006 MICROTECHNIQUES;6;6;6;0;0;0;0;6;0;0;3;2;1;0
9159.0;2022;03;BESANCON;MASCULIN;APPRENTISSAGE;BAC PROFESSIONNEL;BAC PRO PROD;BAC PRO 25007 MAINTENANCE EQUIPEMENTS INDUST.;20;20;17;2;1;1;0;18;0;0;6;7;5;2
9160.0;2022;03;BESANCON;MASCULIN;APPRENTISSAGE;BAC PROFESSIONNEL;BAC PRO PROD;BAC PRO 25106 TECHNICIEN D'USINAGE;31;31;19;10;2;1;1;20;0;2;4;5;9;11
9164.0;2022;03;BESANCON;MASCULIN;APPRENTISSAGE;BAC PROFESSIONNEL;BAC PRO PROD;BAC PRO 25216 MAINT.VEHIC.OPTC MOTOCYCLES;1;1;1;0;0;0;0;1;0;0;0;1;0;0
9170.0;2022;03;BESANCON;MASCULIN;APPRENTISSAGE;BAC PROFESSIONNEL;BAC PRO PROD;BAC PRO 25411 TECH.CHAUDRONNERIE INDUSTRIELLE;26;26;18;7;1;1;0;19;0;1;6;4;8;7
9172.0;2022;03;BESANCON;MASCULIN;APPRENTISSAGE;BAC PROFESSIONNEL;BAC PRO PROD;BAC PRO 25510 METIERS ELECT. ENVIRON. CONNECTES;44;44;35;6;3;2;1;37;0;8;10;7;12;7
9177.0;2022;03;BESANCON;MASCULIN;APPRENTISSAGE;BAC PROFESSIONNEL;BAC PRO PROD;BAC PRO AG 21114 CONDUITE PRODUCTIONS HORTICOLES;6;6;6;0;0;0;0;6;0;0;1;1;4;0
9178.0;2022;03;BESANCON;MASCULIN;APPRENTISSAGE;BAC PROFESSIONNEL;BAC PRO PROD;BAC PRO AG 21211 COND GEST ENTR HIPPIQUE;5;5;4;1;0;0;0;4;0;0;2;2;0;1
9179.0;2022;03;BESANCON;MASCULIN;APPRENTISSAGE;BAC PROFESSIONNEL;BAC PRO PROD;BAC PRO AG 21302 GEST MILIEUX NATURELS FAUNE;5;3;2;1;0;0;0;2;0;0;1;0;1;1
9201.0;2022;03;BESANCON;MASCULIN;INDIVIDUEL;BAC PROFESSIONNEL;BAC PRO PROD;BAC PRO 25411 TECH.CHAUDRONNERIE INDUSTRIELLE;1;1;0;1;0;0;0;0;0;0;0;0;0;1
9219.0;2022;03;BESANCON;MASCULIN;SCOLAIRE;BAC PROFESSIONNEL;BAC PRO PROD;BAC PRO 22703 TECHN.INSTALL.SYST.ENERG.CLIMATI;29;29;21;6;2;2;0;23;0;0;3;8;12;6
9221.0;2022;03;BESANCON;MASCULIN;SCOLAIRE;BAC PROFESSIONNEL;BAC PRO PROD;BAC PRO 23004 TECHN. ETUDES BAT.A ETUDES & ECO.;6;6;6;0;0;0;0;6;0;0;0;5;1;0
9225.0;2022;03;BESANCON;MASCULIN;SCOLAIRE;BAC PROFESSIONNEL;BAC PRO PROD;BAC PRO 23203 TECHNICIEN BAT. : ORG.REAL.GROS O;4;4;4;0;0;0;0;4;0;0;0;2;2;0
9227.0;2022;03;BESANCON;MASCULIN;SCOLAIRE;BAC PROFESSIONNEL;BAC PRO PROD;BAC PRO 23304 AMENAGEMENT FINITION BATIMENT;7;7;6;1;0;0;0;6;0;0;1;2;3;1
9238.0;2022;03;BESANCON;MASCULIN;SCOLAIRE;BAC PROFESSIONNEL;BAC PRO PROD;BAC PRO 25107 TECHNICIEN OUTILLEUR;6;6;5;0;1;1;0;6;0;2;0;2;2;0
9242.0;2022;03;BESANCON;MASCULIN;SCOLAIRE;BAC PROFESSIONNEL;BAC PRO PROD;BAC PRO 25408 REPARATION DES CARROSSERIES;23;23;15;7;1;1;0;16;0;2;4;6;4;7
9252.0;2022;03;BESANCON;MASCULIN;SCOLAIRE;BAC PROFESSIONNEL;BAC PRO PROD;BAC PRO AG 21203 TECHN CONSEIL DE VENTE ANIMAL;3;3;0;3;0;0;0;0;0;0;0;0;0;3
9253.0;2022;03;BESANCON;MASCULIN;SCOLAIRE;BAC PROFESSIONNEL;BAC PRO PROD;BAC PRO AG 21211 COND GEST ENTR HIPPIQUE;3;3;3;0;0;0;0;3;0;0;2;0;1;0
9261.0;2022;03;BESANCON;MASCULIN;SCOLAIRE;BAC PROFESSIONNEL;BAC PRO SERV;BAC PRO 31107 CONDUCT. TRANSP.ROUT.MARCHANDISES;50;49;39;9;1;1;0;40;0;2;7;16;15;9
9262.0;2022;03;BESANCON;MASCULIN;SCOLAIRE;BAC PROFESSIONNEL;BAC PRO SERV;BAC PRO 31212 METIERS DE L'ACCUEIL;8;8;7;0;1;1;0;8;0;2;3;0;3;0
9270.0;2022;03;BESANCON;MASCULIN;SCOLAIRE;BAC PROFESSIONNEL;BAC PRO SERV;BAC PRO 33603 ESTHETIQUE COSMETIQUE PARFUMERIE;1;1;1;0;0;0;0;1;0;0;0;1;0;0
9274.0;2022;03;BESANCON;MASCULIN;SCOLAIRE;BAC TECHNOLOGIQUE;BAC S2TMD;BAC S2TMD MUSIQUE;2;2;2;0;0;0;0;2;0;0;1;1;0;0
9284.0;2022;03;BESANCON;MASCULIN;SCOLAIRE;BAC TECHNOLOGIQUE;BAC STL;BAC STL SCIENCES PHYSIQUES CHIMIQUES  EN LABORAT.;36;36;33;1;2;2;0;35;0;1;7;15;12;1
9287.0;2022;03;BESANCON;MASCULIN;SCOLAIRE;BAC TECHNOLOGIQUE;BAC STMG;BAC STMG RESSOURCES HUMAINES ET COMMUNICATION;135;135;89;17;29;19;10;108;0;1;8;26;73;27
9293.0;2022;04;BORDEAUX;FEMININ;APPRENTISSAGE;BAC PROFESSIONNEL;BAC PRO PROD;BAC PRO 24302 METIERS DU CUIR : MAROQUINERIE;2;2;2;0;0;0;0;2;0;1;0;1;0;0
9298.0;2022;04;BORDEAUX;FEMININ;APPRENTISSAGE;BAC PROFESSIONNEL;BAC PRO PROD;BAC PRO 25215 MAINT.VEHIC.OPTB VEHIC.TRANS.ROUT;1;1;1;0;0;0;0;1;0;0;1;0;0;0
9300.0;2022;04;BORDEAUX;FEMININ;APPRENTISSAGE;BAC PROFESSIONNEL;BAC PRO PROD;BAC PRO 25303 AERONAUTIQUE OPTION SYSTEMES;3;3;3;0;0;0;0;3;0;0;1;2;0;0
9301.0;2022;04;BORDEAUX;FEMININ;APPRENTISSAGE;BAC PROFESSIONNEL;BAC PRO PROD;BAC PRO 25304 AERONAUTIQUE OPTION STRUCTURE;2;2;2;0;0;0;0;2;0;0;1;1;0;0
9308.0;2022;04;BORDEAUX;FEMININ;APPRENTISSAGE;BAC PROFESSIONNEL;BAC PRO PROD;BAC PRO AG 21405 AMENAGEMENTS PAYSAGERS;6;4;4;0;0;0;0;4;0;0;0;0;4;0
9309.0;2022;04;BORDEAUX;FEMININ;APPRENTISSAGE;BAC PROFESSIONNEL;BAC PRO PROD;BAC PRO AG 21407 TEC CONS VTE UNIVERS JARDINERIE;2;2;1;1;0;0;0;1;0;0;0;0;1;1
9311.0;2022;04;BORDEAUX;FEMININ;APPRENTISSAGE;BAC PROFESSIONNEL;BAC PRO SERV;BAC PRO 30001 GESTION-ADMINISTRATION;24;24;18;5;1;0;1;18;0;4;4;8;2;6
9324.0;2022;04;BORDEAUX;FEMININ;ENSEIGNEMENT A DISTANCE;BAC GENERAL;BAC GENERAL;BAC GENE 10019 BAC GENERAL;79;77;58;13;6;5;1;63;0;2;11;19;31;14
9328.0;2022;04;BORDEAUX;FEMININ;ENSEIGNEMENT A DISTANCE;BAC PROFESSIONNEL;BAC PRO SERV;BAC PRO 33004 ACC.SOINS-S.PERS. OPT.EN STRUCTUR;3;2;1;1;0;0;0;1;0;0;0;1;0;1
9330.0;2022;04;BORDEAUX;FEMININ;ENSEIGNEMENT A DISTANCE;BAC TECHNOLOGIQUE;BAC ST2S;BAC ST2S SCIENCES & TECHNO. SANTE & SOCIAL;10;10;5;1;4;2;2;7;0;0;1;2;4;3
9338.0;2022;04;BORDEAUX;FEMININ;FORMATION CONTINUE;BAC PROFESSIONNEL;BAC PRO SERV;BAC PRO 31213 MET.COM.VEN.OP.A ANI.GES.ESP.COM.;8;7;5;1;1;1;0;6;0;0;0;1;5;1
9340.0;2022;04;BORDEAUX;FEMININ;INDIVIDUEL;BAC GENERAL;BAC GENERAL;BAC GENE 10019 BAC GENERAL;91;61;35;16;10;7;3;42;0;1;9;10;22;19
9341.0;2022;04;BORDEAUX;FEMININ;INDIVIDUEL;BAC PROFESSIONNEL;BAC PRO PROD;BAC PRO 22106 CUISINE;1;1;0;1;0;0;0;0;0;0;0;0;0;1
9345.0;2022;04;BORDEAUX;FEMININ;INDIVIDUEL;BAC PROFESSIONNEL;BAC PRO PROD;BAC PRO AG 21114 CONDUITE PRODUCTIONS HORTICOLES;6;5;5;0;0;0;0;5;0;0;0;0;5;0
9350.0;2022;04;BORDEAUX;FEMININ;INDIVIDUEL;BAC PROFESSIONNEL;BAC PRO SERV;BAC PRO 31212 METIERS DE L'ACCUEIL;1;0;0;0;0;0;0;0;0;0;0;0;0;0
9352.0;2022;04;BORDEAUX;FEMININ;INDIVIDUEL;BAC PROFESSIONNEL;BAC PRO SERV;BAC PRO 32304 PHOTOGRAPHIE;1;0;0;0;0;0;0;0;0;0;0;0;0;0
9365.0;2022;04;BORDEAUX;FEMININ;SCOLAIRE;BAC PROFESSIONNEL;BAC PRO PROD;BAC PRO 22105 BOULANGER-PÂTISSIER;33;33;30;3;0;0;0;30;0;7;6;13;4;3
9369.0;2022;04;BORDEAUX;FEMININ;SCOLAIRE;BAC PROFESSIONNEL;BAC PRO PROD;BAC PRO 23004 TECHN. ETUDES BAT.A ETUDES & ECO.;12;12;11;1;0;0;0;11;0;0;0;4;7;1
9370.0;2022;04;BORDEAUX;FEMININ;SCOLAIRE;BAC PROFESSIONNEL;BAC PRO PROD;BAC PRO 23005 TECHN. ETUDES BAT B ASSIST.ARCHI.;7;7;6;1;0;0;0;6;0;0;2;0;4;1
9375.0;2022;04;BORDEAUX;FEMININ;SCOLAIRE;BAC PROFESSIONNEL;BAC PRO PROD;BAC PRO 23405 TECHNICIEN MENUISIER AGENCEUR;6;6;4;2;0;0;0;4;0;1;0;2;1;2
9382.0;2022;04;BORDEAUX;FEMININ;SCOLAIRE;BAC PROFESSIONNEL;BAC PRO PROD;BAC PRO 25106 TECHNICIEN D'USINAGE;1;1;1;0;0;0;0;1;0;0;0;0;1;0
9388.0;2022;04;BORDEAUX;FEMININ;SCOLAIRE;BAC PROFESSIONNEL;BAC PRO PROD;BAC PRO 25304 AERONAUTIQUE OPTION STRUCTURE;2;2;1;1;0;0;0;1;0;0;0;0;1;1
9390.0;2022;04;BORDEAUX;FEMININ;SCOLAIRE;BAC PROFESSIONNEL;BAC PRO PROD;BAC PRO 25411 TECH.CHAUDRONNERIE INDUSTRIELLE;2;2;2;0;0;0;0;2;0;0;1;1;0;0
9392.0;2022;04;BORDEAUX;FEMININ;SCOLAIRE;BAC PROFESSIONNEL;BAC PRO PROD;BAC PRO 25514 SYST.NUM.OPT.B AUD.RES.EQUIP.DOM.;9;9;7;2;0;0;0;7;0;0;3;4;0;2
9397.0;2022;04;BORDEAUX;FEMININ;SCOLAIRE;BAC PROFESSIONNEL;BAC PRO PROD;BAC PRO AG 21203 TECHN CONSEIL DE VENTE ANIMAL;38;37;34;3;0;0;0;34;0;2;2;17;13;3
9404.0;2022;04;BORDEAUX;FEMININ;SCOLAIRE;BAC PROFESSIONNEL;BAC PRO PROD;BAC PRO AG 21407 TEC CONS VTE UNIVERS JARDINERIE;11;10;9;1;0;0;0;9;0;0;2;0;7;1
9406.0;2022;04;BORDEAUX;FEMININ;SCOLAIRE;BAC PROFESSIONNEL;BAC PRO PROD;BAC PRO AG 22106 TEC CONS VTE ALIMENTATION VINS SP;8;7;7;0;0;0;0;7;0;0;0;2;5;0
9407.0;2022;04;BORDEAUX;FEMININ;SCOLAIRE;BAC PROFESSIONNEL;BAC PRO PROD;BAC PRO AG 22107 TEC CONS VTE ALIMENTATION P.ALIM;7;6;5;1;0;0;0;5;0;0;0;3;2;1
9414.0;2022;04;BORDEAUX;FEMININ;SCOLAIRE;BAC PROFESSIONNEL;BAC PRO SERV;BAC PRO 31214 MET.COM.VEN.OP.B PR.CL.VA.OF.COM.;142;142;116;25;1;1;0;117;0;5;20;47;45;25
9420.0;2022;04;BORDEAUX;FEMININ;SCOLAIRE;BAC PROFESSIONNEL;BAC PRO SERV;BAC PRO 33003 ACC.SOINS-S.PERS. OPT.A DOMICILE;301;301;256;33;12;4;8;260;0;10;59;109;82;41
9429.0;2022;04;BORDEAUX;FEMININ;SCOLAIRE;BAC PROFESSIONNEL;BAC PRO SERV;BAC PRO AG 33002 SERV PERS TERRIT;444;426;379;47;0;0;0;379;0;4;52;129;194;47
9431.0;2022;04;BORDEAUX;FEMININ;SCOLAIRE;BAC TECHNOLOGIQUE;BAC S2TMD;BAC S2TMD MUSIQUE;4;4;4;0;0;0;0;4;0;0;0;3;1;0
9434.0;2022;04;BORDEAUX;FEMININ;SCOLAIRE;BAC TECHNOLOGIQUE;BAC STD2A;BAC STD2A SCIENCES & TECHNO. DESIGN-ARTS APPLIQUES;181;181;178;2;1;1;0;179;0;9;62;73;35;2
9441.0;2022;04;BORDEAUX;FEMININ;SCOLAIRE;BAC TECHNOLOGIQUE;BAC STL;BAC STL SCIENCES PHYSIQUES CHIMIQUES  EN LABORAT.;71;71;61;4;6;3;3;64;0;2;9;23;30;7
9443.0;2022;04;BORDEAUX;FEMININ;SCOLAIRE;BAC TECHNOLOGIQUE;BAC STMG;BAC STMG MERCATIQUE (MARKETING);861;861;712;28;121;79;42;791;1;10;107;281;392;70
9449.0;2022;04;BORDEAUX;MASCULIN;APPRENTISSAGE;BAC PROFESSIONNEL;BAC PRO PROD;BAC PRO 22703 TECHN.INSTALL.SYST.ENERG.CLIMATI;23;23;18;5;0;0;0;18;0;0;1;7;10;5
9453.0;2022;04;BORDEAUX;MASCULIN;APPRENTISSAGE;BAC PROFESSIONNEL;BAC PRO PROD;BAC PRO 23203 TECHNICIEN BAT. : ORG.REAL.GROS O;6;6;4;1;1;1;0;5;0;0;1;2;2;1
9456.0;2022;04;BORDEAUX;MASCULIN;APPRENTISSAGE;BAC PROFESSIONNEL;BAC PRO PROD;BAC PRO 23303 MENUISERIE ALUMINIUM-VERRE;3;3;2;0;1;1;0;3;0;0;0;0;3;0
9460.0;2022;04;BORDEAUX;MASCULIN;APPRENTISSAGE;BAC PROFESSIONNEL;BAC PRO PROD;BAC PRO 23406 TECHNICIEN DE SCIERIE;1;1;1;0;0;0;0;1;0;0;1;0;0;0
9469.0;2022;04;BORDEAUX;MASCULIN;APPRENTISSAGE;BAC PROFESSIONNEL;BAC PRO PROD;BAC PRO 25219 MAINT.MATERIELS OPT.A AGRICOLES;2;2;2;0;0;0;0;2;0;0;0;0;2;0
9471.0;2022;04;BORDEAUX;MASCULIN;APPRENTISSAGE;BAC PROFESSIONNEL;BAC PRO PROD;BAC PRO 25221 MAINT.MATERIELS OPT.C ESP. VERTS;10;10;8;1;1;1;0;9;0;0;3;3;3;1
9473.0;2022;04;BORDEAUX;MASCULIN;APPRENTISSAGE;BAC PROFESSIONNEL;BAC PRO PROD;BAC PRO 25303 AERONAUTIQUE OPTION SYSTEMES;16;16;16;0;0;0;0;16;0;7;8;1;0;0
9476.0;2022;04;BORDEAUX;MASCULIN;APPRENTISSAGE;BAC PROFESSIONNEL;BAC PRO PROD;BAC PRO 25509 TECHNIC. FROID CONDITIONNEMT AIR;12;11;10;0;1;1;0;11;0;1;2;5;3;0
9481.0;2022;04;BORDEAUX;MASCULIN;APPRENTISSAGE;BAC PROFESSIONNEL;BAC PRO PROD;BAC PRO AG 21004 CGEA;44;40;32;8;0;0;0;32;0;0;2;9;21;8
9484.0;2022;04;BORDEAUX;MASCULIN;APPRENTISSAGE;BAC PROFESSIONNEL;BAC PRO PROD;BAC PRO AG 21211 COND GEST ENTR HIPPIQUE;4;4;3;1;0;0;0;3;0;0;2;0;1;1
9485.0;2022;04;BORDEAUX;MASCULIN;APPRENTISSAGE;BAC PROFESSIONNEL;BAC PRO PROD;BAC PRO AG 21303 FORET;7;7;6;1;0;0;0;6;0;0;1;1;4;1
9495.0;2022;04;BORDEAUX;MASCULIN;APPRENTISSAGE;BAC PROFESSIONNEL;BAC PRO SERV;BAC PRO 32208 REAL.PR.IMPR.PLURI.OPTB.PR.IMPR.;6;6;6;0;0;0;0;6;0;2;0;3;1;0
9497.0;2022;04;BORDEAUX;MASCULIN;APPRENTISSAGE;BAC PROFESSIONNEL;BAC PRO SERV;BAC PRO 33101 OPTIQUE LUNETTERIE;2;2;2;0;0;0;0;2;0;0;1;1;0;0
9498.0;2022;04;BORDEAUX;MASCULIN;APPRENTISSAGE;BAC PROFESSIONNEL;BAC PRO SERV;BAC PRO 33102 PROTHESE DENTAIRE;2;2;1;0;1;0;1;1;0;0;1;0;0;1
9501.0;2022;04;BORDEAUX;MASCULIN;APPRENTISSAGE;BAC PROFESSIONNEL;BAC PRO SERV;BAC PRO 34304 HYGIENE PROPRETE STERILISATION;18;18;9;8;1;1;0;10;0;2;2;3;3;8
9509.0;2022;04;BORDEAUX;MASCULIN;ENSEIGNEMENT A DISTANCE;BAC TECHNOLOGIQUE;BAC STMG;BAC STMG MERCATIQUE (MARKETING);9;8;4;3;1;0;1;4;0;0;0;1;3;4
9520.0;2022;04;BORDEAUX;MASCULIN;INDIVIDUEL;BAC PROFESSIONNEL;BAC PRO PROD;BAC PRO 23004 TECHN. ETUDES BAT.A ETUDES & ECO.;1;0;0;0;0;0;0;0;0;0;0;0;0;0
9524.0;2022;04;BORDEAUX;MASCULIN;INDIVIDUEL;BAC PROFESSIONNEL;BAC PRO PROD;BAC PRO 25510 METIERS ELECT. ENVIRON. CONNECTES;1;0;0;0;0;0;0;0;0;0;0;0;0;0
9537.0;2022;04;BORDEAUX;MASCULIN;INDIVIDUEL;BAC PROFESSIONNEL;BAC PRO SERV;BAC PRO 32207 REAL.PR.IMPR.PLURI.OPTA.PR.GRAPH.;1;0;0;0;0;0;0;0;0;0;0;0;0;0
9538.0;2022;04;BORDEAUX;MASCULIN;INDIVIDUEL;BAC PROFESSIONNEL;BAC PRO SERV;BAC PRO 33002 SERVICES DE PROXIMITE  VIE LOCAL;1;1;1;0;0;0;0;1;0;0;0;0;1;0
9539.0;2022;04;BORDEAUX;MASCULIN;INDIVIDUEL;BAC PROFESSIONNEL;BAC PRO SERV;BAC PRO AG 33002 SERV PERS TERRIT;1;1;0;1;0;0;0;0;0;0;0;0;0;1
9545.0;2022;04;BORDEAUX;MASCULIN;INDIVIDUEL;BAC TECHNOLOGIQUE;BAC STMG;BAC STMG RESSOURCES HUMAINES ET COMMUNICATION;5;1;0;0;1;1;0;1;0;0;0;0;1;0
9552.0;2022;04;BORDEAUX;MASCULIN;SCOLAIRE;BAC PROFESSIONNEL;BAC PRO PROD;BAC PRO 22105 BOULANGER-PÂTISSIER;35;35;32;3;0;0;0;32;0;1;6;18;7;3
9554.0;2022;04;BORDEAUX;MASCULIN;SCOLAIRE;BAC PROFESSIONNEL;BAC PRO PROD;BAC PRO 22503 PLASTIQUES ET COMPOSITES;25;25;17;6;2;2;0;19;0;1;4;6;8;6
9568.0;2022;04;BORDEAUX;MASCULIN;SCOLAIRE;BAC PROFESSIONNEL;BAC PRO PROD;BAC PRO 23408 Etude et réalisation d'agencement;7;7;7;0;0;0;0;7;0;0;3;4;0;0
9575.0;2022;04;BORDEAUX;MASCULIN;SCOLAIRE;BAC PROFESSIONNEL;BAC PRO PROD;BAC PRO 25214 MAINT.VEHIC.OPTA VOIT.PARTICUL.;140;140;106;25;9;7;2;113;0;4;14;40;55;27
9581.0;2022;04;BORDEAUX;MASCULIN;SCOLAIRE;BAC PROFESSIONNEL;BAC PRO PROD;BAC PRO 25302 AERONAUTIQUE OPTION AVIONIQUE;9;9;9;0;0;0;0;9;0;2;6;0;1;0
9588.0;2022;04;BORDEAUX;MASCULIN;SCOLAIRE;BAC PROFESSIONNEL;BAC PRO PROD;BAC PRO 25510 METIERS ELECT. ENVIRON. CONNECTES;478;473;365;83;25;18;7;383;0;19;79;124;161;90
9590.0;2022;04;BORDEAUX;MASCULIN;SCOLAIRE;BAC PROFESSIONNEL;BAC PRO PROD;BAC PRO 25514 SYST.NUM.OPT.B AUD.RES.EQUIP.DOM.;114;114;96;17;1;1;0;97;0;1;28;38;30;17
9593.0;2022;04;BORDEAUX;MASCULIN;SCOLAIRE;BAC PROFESSIONNEL;BAC PRO PROD;BAC PRO AG 21004 CGEA;103;102;88;14;0;0;0;88;0;5;7;22;54;14
9595.0;2022;04;BORDEAUX;MASCULIN;SCOLAIRE;BAC PROFESSIONNEL;BAC PRO PROD;BAC PRO AG 21114 CONDUITE PRODUCTIONS HORTICOLES;18;17;15;2;0;0;0;15;0;1;1;3;10;2
9607.0;2022;04;BORDEAUX;MASCULIN;SCOLAIRE;BAC PROFESSIONNEL;BAC PRO SERV;BAC PRO 30001 GESTION-ADMINISTRATION;213;212;153;57;2;2;0;155;0;5;24;53;73;57
9608.0;2022;04;BORDEAUX;MASCULIN;SCOLAIRE;BAC PROFESSIONNEL;BAC PRO SERV;BAC PRO 31106 LOGISTIQUE;88;88;59;25;4;3;1;62;0;3;13;24;22;26
9611.0;2022;04;BORDEAUX;MASCULIN;SCOLAIRE;BAC PROFESSIONNEL;BAC PRO SERV;BAC PRO 31212 METIERS DE L'ACCUEIL;103;100;82;12;6;4;2;86;0;2;12;39;33;14
9614.0;2022;04;BORDEAUX;MASCULIN;SCOLAIRE;BAC PROFESSIONNEL;BAC PRO SERV;BAC PRO 32207 REAL.PR.IMPR.PLURI.OPTA.PR.GRAPH.;35;35;31;3;1;0;1;31;0;0;8;11;12;4
9615.0;2022;04;BORDEAUX;MASCULIN;SCOLAIRE;BAC PROFESSIONNEL;BAC PRO SERV;BAC PRO 32208 REAL.PR.IMPR.PLURI.OPTB.PR.IMPR.;12;11;9;2;0;0;0;9;0;0;2;4;3;2
9616.0;2022;04;BORDEAUX;MASCULIN;SCOLAIRE;BAC PROFESSIONNEL;BAC PRO SERV;BAC PRO 32303 ART.& MET.ART:COM.VIS.VIS.PLURI-M;59;59;57;2;0;0;0;57;0;3;14;26;14;2
9620.0;2022;04;BORDEAUX;MASCULIN;SCOLAIRE;BAC PROFESSIONNEL;BAC PRO SERV;BAC PRO 33004 ACC.SOINS-S.PERS. OPT.EN STRUCTUR;22;22;18;4;0;0;0;18;0;1;3;10;4;4
9623.0;2022;04;BORDEAUX;MASCULIN;SCOLAIRE;BAC PROFESSIONNEL;BAC PRO SERV;BAC PRO 33403 COMMERC. SERVICES EN RESTAURATION;103;103;84;15;4;4;0;88;0;2;19;41;26;15
9627.0;2022;04;BORDEAUX;MASCULIN;SCOLAIRE;BAC PROFESSIONNEL;BAC PRO SERV;BAC PRO 34403 METIERS DE LA SECURITE;63;63;59;2;2;2;0;61;0;2;17;26;16;2
9628.0;2022;04;BORDEAUX;MASCULIN;SCOLAIRE;BAC PROFESSIONNEL;BAC PRO SERV;BAC PRO AG 33002 SERV PERS TERRIT;84;83;77;6;0;0;0;77;0;0;14;28;35;6
9629.0;2022;04;BORDEAUX;MASCULIN;SCOLAIRE;BAC TECHNOLOGIQUE;BAC S2TMD;BAC S2TMD DANSE;1;1;1;0;0;0;0;1;0;0;0;0;1;0
9632.0;2022;04;BORDEAUX;MASCULIN;SCOLAIRE;BAC TECHNOLOGIQUE;BAC STAV;BAC STAV AGRONOMIE ALIM ENV TERRITOI;135;135;134;1;0;0;0;134;0;1;26;55;52;1
9637.0;2022;04;BORDEAUX;MASCULIN;SCOLAIRE;BAC TECHNOLOGIQUE;BAC STI2D;BAC STI2D INNOVATION TECHNO.  ET ECO CONCEPTION;400;400;316;19;65;49;16;365;0;11;37;108;209;35
9641.0;2022;04;BORDEAUX;MASCULIN;SCOLAIRE;BAC TECHNOLOGIQUE;BAC STMG;BAC STMG GESTION ET FINANCE;406;406;325;20;61;42;19;367;0;5;31;126;205;39
9643.0;2022;04;BORDEAUX;MASCULIN;SCOLAIRE;BAC TECHNOLOGIQUE;BAC STMG;BAC STMG RESSOURCES HUMAINES ET COMMUNICATION;263;263;174;23;66;45;21;219;0;1;15;55;148;44
9644.0;2022;04;BORDEAUX;MASCULIN;SCOLAIRE;BAC TECHNOLOGIQUE;BAC STMG;BAC STMG SYSTEMES D'INFORMATION DE GESTION;42;42;30;1;11;8;3;38;0;0;3;11;24;4
9645.0;2022;06;CLERMONT-FERRAND;FEMININ;APPRENTISSAGE;BAC PROFESSIONNEL;BAC PRO PROD;BACPRO 20002 ETUD.DEFINITION PRDTS INDUSTRIEL;1;1;1;0;0;0;0;1;0;0;0;0;1;0
9648.0;2022;06;CLERMONT-FERRAND;FEMININ;APPRENTISSAGE;BAC PROFESSIONNEL;BAC PRO PROD;BAC PRO 23304 AMENAGEMENT FINITION BATIMENT;1;1;0;1;0;0;0;0;0;0;0;0;0;1
9650.0;2022;06;CLERMONT-FERRAND;FEMININ;APPRENTISSAGE;BAC PROFESSIONNEL;BAC PRO PROD;BAC PRO 24302 METIERS DU CUIR : MAROQUINERIE;6;6;4;2;0;0;0;4;0;1;1;2;0;2
9651.0;2022;06;CLERMONT-FERRAND;FEMININ;APPRENTISSAGE;BAC PROFESSIONNEL;BAC PRO PROD;BAC PRO 25007 MAINTENANCE EQUIPEMENTS INDUST.;2;2;2;0;0;0;0;2;0;0;0;1;1;0
9653.0;2022;06;CLERMONT-FERRAND;FEMININ;APPRENTISSAGE;BAC PROFESSIONNEL;BAC PRO PROD;BAC PRO 25214 MAINT.VEHIC.OPTA VOIT.PARTICUL.;2;2;2;0;0;0;0;2;0;0;1;1;0;0
9660.0;2022;06;CLERMONT-FERRAND;FEMININ;APPRENTISSAGE;BAC PROFESSIONNEL;BAC PRO PROD;BAC PRO AG 22107 TEC CONS VTE ALIMENTATION P.ALIM;1;0;0;0;0;0;0;0;0;0;0;0;0;0
9663.0;2022;06;CLERMONT-FERRAND;FEMININ;APPRENTISSAGE;BAC PROFESSIONNEL;BAC PRO SERV;BAC PRO 31212 METIERS DE L'ACCUEIL;8;8;8;0;0;0;0;8;0;2;2;2;2;0
9666.0;2022;06;CLERMONT-FERRAND;FEMININ;APPRENTISSAGE;BAC PROFESSIONNEL;BAC PRO SERV;BAC PRO 33004 ACC.SOINS-S.PERS. OPT.EN STRUCTUR;3;3;3;0;0;0;0;3;0;0;0;2;1;0
9667.0;2022;06;CLERMONT-FERRAND;FEMININ;APPRENTISSAGE;BAC PROFESSIONNEL;BAC PRO SERV;BAC PRO 33403 COMMERC. SERVICES EN RESTAURATION;1;1;0;0;1;0;1;0;0;0;0;0;0;1
9671.0;2022;06;CLERMONT-FERRAND;FEMININ;ENSEIGNEMENT A DISTANCE;BAC PROFESSIONNEL;BAC PRO PROD;BAC PRO AG 21113 CGEVV;8;6;5;1;0;0;0;5;0;0;0;1;4;1
9674.0;2022;06;CLERMONT-FERRAND;FEMININ;ENSEIGNEMENT A DISTANCE;BAC TECHNOLOGIQUE;BAC STAV;BAC STAV AGRONOMIE ALIM ENV TERRITOI;13;12;11;1;0;0;0;11;0;0;0;2;9;1
9676.0;2022;06;CLERMONT-FERRAND;FEMININ;ENSEIGNEMENT A DISTANCE;BAC TECHNOLOGIQUE;BAC STMG;BAC STMG MERCATIQUE (MARKETING);1;1;0;1;0;0;0;0;0;0;0;0;0;1
9696.0;2022;06;CLERMONT-FERRAND;FEMININ;INDIVIDUEL;BAC TECHNOLOGIQUE;BAC STMG;BAC STMG MERCATIQUE (MARKETING);4;3;2;0;1;0;1;2;0;0;0;0;2;1
9701.0;2022;06;CLERMONT-FERRAND;FEMININ;SCOLAIRE;BAC PROFESSIONNEL;BAC PRO PROD;BAC PRO 22106 CUISINE;43;43;32;10;1;1;0;33;0;2;8;13;10;10
9708.0;2022;06;CLERMONT-FERRAND;FEMININ;SCOLAIRE;BAC PROFESSIONNEL;BAC PRO PROD;BACPRO 23103 TECHNICIEN GEOMETRE-TOPOGRAPHE;1;1;1;0;0;0;0;1;0;0;1;0;0;0
9709.0;2022;06;CLERMONT-FERRAND;FEMININ;SCOLAIRE;BAC PROFESSIONNEL;BAC PRO PROD;BAC PRO 23304 AMENAGEMENT FINITION BATIMENT;4;4;4;0;0;0;0;4;0;0;1;0;3;0
9712.0;2022;06;CLERMONT-FERRAND;FEMININ;SCOLAIRE;BAC PROFESSIONNEL;BAC PRO PROD;BAC PRO 24203 METIERS DE LA MODE - VÊTEMENT;41;41;32;7;2;1;1;33;0;4;6;11;12;8
9713.0;2022;06;CLERMONT-FERRAND;FEMININ;SCOLAIRE;BAC PROFESSIONNEL;BAC PRO PROD;BAC PRO 24302 METIERS DU CUIR : MAROQUINERIE;17;17;16;0;1;0;1;16;0;4;3;5;4;1
9724.0;2022;06;CLERMONT-FERRAND;FEMININ;SCOLAIRE;BAC PROFESSIONNEL;BAC PRO PROD;BAC PRO AG 21203 TECHN CONSEIL DE VENTE ANIMAL;16;16;12;4;0;0;0;12;0;0;3;1;8;4
9726.0;2022;06;CLERMONT-FERRAND;FEMININ;SCOLAIRE;BAC PROFESSIONNEL;BAC PRO PROD;BAC PRO AG 21211 COND GEST ENTR HIPPIQUE;37;36;32;4;0;0;0;32;0;1;3;13;15;4
9740.0;2022;06;CLERMONT-FERRAND;FEMININ;SCOLAIRE;BAC PROFESSIONNEL;BAC PRO SERV;BAC PRO 32208 REAL.PR.IMPR.PLURI.OPTB.PR.IMPR.;6;6;6;0;0;0;0;6;0;1;2;2;1;0
9741.0;2022;06;CLERMONT-FERRAND;FEMININ;SCOLAIRE;BAC PROFESSIONNEL;BAC PRO SERV;BAC PRO 32303 ART.& MET.ART:COM.VIS.VIS.PLURI-M;34;34;30;4;0;0;0;30;0;3;5;13;9;4
9774.0;2022;06;CLERMONT-FERRAND;MASCULIN;APPRENTISSAGE;BAC PROFESSIONNEL;BAC PRO PROD;BAC PRO 23203 TECHNICIEN BAT. : ORG.REAL.GROS O;3;3;1;0;2;0;2;1;0;0;0;0;1;2
9783.0;2022;06;CLERMONT-FERRAND;MASCULIN;APPRENTISSAGE;BAC PROFESSIONNEL;BAC PRO PROD;BAC PRO 25215 MAINT.VEHIC.OPTB VEHIC.TRANS.ROUT;11;11;11;0;0;0;0;11;0;0;1;4;6;0
9795.0;2022;06;CLERMONT-FERRAND;MASCULIN;APPRENTISSAGE;BAC PROFESSIONNEL;BAC PRO PROD;BAC PRO 25513 SYST.NUM.OPT.A SURETE SECURITE;1;1;1;0;0;0;0;1;0;0;0;1;0;0
9814.0;2022;06;CLERMONT-FERRAND;MASCULIN;ENSEIGNEMENT A DISTANCE;BAC PROFESSIONNEL;BAC PRO PROD;BAC PRO AG 21113 CGEVV;18;14;14;0;0;0;0;14;0;0;0;0;14;0
9818.0;2022;06;CLERMONT-FERRAND;MASCULIN;ENSEIGNEMENT A DISTANCE;BAC TECHNOLOGIQUE;BAC STMG;BAC STMG GESTION ET FINANCE;1;1;0;0;1;1;0;1;0;0;0;0;1;0
9819.0;2022;06;CLERMONT-FERRAND;MASCULIN;FORMATION CONTINUE;BAC PROFESSIONNEL;BAC PRO PROD;BAC PRO 22704 TECHN. MAINT. SYST.ENERG.CLIMATI;1;1;1;0;0;0;0;1;0;1;0;0;0;0
9825.0;2022;06;CLERMONT-FERRAND;MASCULIN;FORMATION CONTINUE;BAC PROFESSIONNEL;BAC PRO SERV;BAC PRO 31213 MET.COM.VEN.OP.A ANI.GES.ESP.COM.;1;1;1;0;0;0;0;1;0;0;0;0;1;0
9828.0;2022;06;CLERMONT-FERRAND;MASCULIN;INDIVIDUEL;BAC PROFESSIONNEL;BAC PRO PROD;BAC PRO 25514 SYST.NUM.OPT.B AUD.RES.EQUIP.DOM.;1;1;0;1;0;0;0;0;0;0;0;0;0;1
9832.0;2022;06;CLERMONT-FERRAND;MASCULIN;INDIVIDUEL;BAC PROFESSIONNEL;BAC PRO PROD;BAC PRO AG 21210 COND GEST ENTR CANIN ET FELIN;1;1;1;0;0;0;0;1;0;0;0;0;1;0
9843.0;2022;06;CLERMONT-FERRAND;MASCULIN;SCOLAIRE;BAC PROFESSIONNEL;BAC PRO PROD;BAC PRO 22003 BIO-INDUSTRIES DE TRANSFORMATION;7;7;7;0;0;0;0;7;0;0;1;3;3;0
9845.0;2022;06;CLERMONT-FERRAND;MASCULIN;SCOLAIRE;BAC PROFESSIONNEL;BAC PRO PROD;BAC PRO 22403 ARTS.& MET.ART:MET.ENSEIGN SIGNA;5;5;5;0;0;0;0;5;0;0;1;3;1;0
9847.0;2022;06;CLERMONT-FERRAND;MASCULIN;SCOLAIRE;BAC PROFESSIONNEL;BAC PRO PROD;BAC PRO 22703 TECHN.INSTALL.SYST.ENERG.CLIMATI;24;24;20;2;2;1;1;21;0;0;5;4;12;3
9851.0;2022;06;CLERMONT-FERRAND;MASCULIN;SCOLAIRE;BAC PROFESSIONNEL;BAC PRO PROD;BAC PRO 23005 TECHN. ETUDES BAT B ASSIST.ARCHI.;9;9;6;3;0;0;0;6;0;0;1;4;1;3
9853.0;2022;06;CLERMONT-FERRAND;MASCULIN;SCOLAIRE;BAC PROFESSIONNEL;BAC PRO PROD;BACPRO 23103 TECHNICIEN GEOMETRE-TOPOGRAPHE;12;12;8;4;0;0;0;8;0;0;1;3;4;4
9855.0;2022;06;CLERMONT-FERRAND;MASCULIN;SCOLAIRE;BAC PROFESSIONNEL;BAC PRO PROD;BAC PRO 23304 AMENAGEMENT FINITION BATIMENT;8;8;7;0;1;1;0;8;0;1;1;3;3;0
9857.0;2022;06;CLERMONT-FERRAND;MASCULIN;SCOLAIRE;BAC PROFESSIONNEL;BAC PRO PROD;BAC PRO 23405 TECHNICIEN MENUISIER AGENCEUR;31;31;24;6;1;0;1;24;0;0;6;15;3;7
9862.0;2022;06;CLERMONT-FERRAND;MASCULIN;SCOLAIRE;BAC PROFESSIONNEL;BAC PRO PROD;BAC PRO 25106 TECHNICIEN D'USINAGE;26;26;16;9;1;0;1;16;0;0;3;9;4;10
9865.0;2022;06;CLERMONT-FERRAND;MASCULIN;SCOLAIRE;BAC PROFESSIONNEL;BAC PRO PROD;BAC PRO 25219 MAINT.MATERIELS OPT.A AGRICOLES;10;10;9;0;1;0;1;9;0;0;2;4;3;1
9869.0;2022;06;CLERMONT-FERRAND;MASCULIN;SCOLAIRE;BAC PROFESSIONNEL;BAC PRO PROD;BAC PRO 25303 AERONAUTIQUE OPTION SYSTEMES;10;10;10;0;0;0;0;10;0;0;5;5;0;0
9873.0;2022;06;CLERMONT-FERRAND;MASCULIN;SCOLAIRE;BAC PROFESSIONNEL;BAC PRO PROD;BAC PRO 25411 TECH.CHAUDRONNERIE INDUSTRIELLE;68;68;57;8;3;1;2;58;0;0;13;27;18;10
9878.0;2022;06;CLERMONT-FERRAND;MASCULIN;SCOLAIRE;BAC PROFESSIONNEL;BAC PRO PROD;BAC PRO 25515 SYST.NUM.OPT.C RES.INF.SYST.COMM.;56;56;52;4;0;0;0;52;0;4;14;20;14;4
9882.0;2022;06;CLERMONT-FERRAND;MASCULIN;SCOLAIRE;BAC PROFESSIONNEL;BAC PRO PROD;BAC PRO AG 21203 TECHN CONSEIL DE VENTE ANIMAL;11;11;10;1;0;0;0;10;0;0;1;5;4;1
9887.0;2022;06;CLERMONT-FERRAND;MASCULIN;SCOLAIRE;BAC PROFESSIONNEL;BAC PRO PROD;BAC PRO AG 21405 AMENAGEMENTS PAYSAGERS;61;60;53;7;0;0;0;53;0;2;7;21;23;7
9889.0;2022;06;CLERMONT-FERRAND;MASCULIN;SCOLAIRE;BAC PROFESSIONNEL;BAC PRO PROD;BAC PRO AG 22105 LABORATOIRE CONTROLE QUALITE;5;5;5;0;0;0;0;5;0;0;2;2;1;0
9892.0;2022;06;CLERMONT-FERRAND;MASCULIN;SCOLAIRE;BAC PROFESSIONNEL;BAC PRO SERV;BAC PRO 31106 LOGISTIQUE;22;22;13;7;2;0;2;13;0;0;0;8;5;9
9893.0;2022;06;CLERMONT-FERRAND;MASCULIN;SCOLAIRE;BAC PROFESSIONNEL;BAC PRO SERV;BAC PRO 31107 CONDUCT. TRANSP.ROUT.MARCHANDISES;19;19;17;2;0;0;0;17;0;0;7;3;7;2
9894.0;2022;06;CLERMONT-FERRAND;MASCULIN;SCOLAIRE;BAC PROFESSIONNEL;BAC PRO SERV;BAC PRO 31108 TRANSPORT;26;26;18;5;3;2;1;20;0;0;2;8;10;6
9897.0;2022;06;CLERMONT-FERRAND;MASCULIN;SCOLAIRE;BAC PROFESSIONNEL;BAC PRO SERV;BAC PRO 31214 MET.COM.VEN.OP.B PR.CL.VA.OF.COM.;71;71;57;13;1;1;0;58;0;2;12;20;24;13
9905.0;2022;06;CLERMONT-FERRAND;MASCULIN;SCOLAIRE;BAC PROFESSIONNEL;BAC PRO SERV;BAC PRO 33101 OPTIQUE LUNETTERIE;8;8;7;1;0;0;0;7;0;0;1;4;2;1
9918.0;2022;06;CLERMONT-FERRAND;MASCULIN;SCOLAIRE;BAC TECHNOLOGIQUE;BAC STI2D;BAC STI2D INNOVATION TECHNO.  ET ECO CONCEPTION;121;121;109;1;11;6;5;115;0;0;12;44;59;6
9923.0;2022;06;CLERMONT-FERRAND;MASCULIN;SCOLAIRE;BAC TECHNOLOGIQUE;BAC STMG;BAC STMG MERCATIQUE (MARKETING);244;244;171;17;56;31;25;202;0;0;7;70;125;42
9939.0;2022;27;CORSE;FEMININ;INDIVIDUEL;BAC PROFESSIONNEL;BAC PRO PROD;BAC PRO AG 21114 CONDUITE PRODUCTIONS HORTICOLES;19;14;11;3;0;0;0;11;0;0;0;0;11;3
9940.0;2022;27;CORSE;FEMININ;INDIVIDUEL;BAC PROFESSIONNEL;BAC PRO PROD;BAC PRO AG 21211 COND GEST ENTR HIPPIQUE;2;1;1;0;0;0;0;1;0;0;0;0;1;0
9944.0;2022;27;CORSE;FEMININ;INDIVIDUEL;BAC TECHNOLOGIQUE;BAC STMG;BAC STMG RESSOURCES HUMAINES ET COMMUNICATION;1;0;0;0;0;0;0;0;0;0;0;0;0;0
9951.0;2022;27;CORSE;FEMININ;SCOLAIRE;BAC PROFESSIONNEL;BAC PRO PROD;BAC PRO AG 21211 COND GEST ENTR HIPPIQUE;8;8;6;2;0;0;0;6;0;0;0;1;5;2
9958.0;2022;27;CORSE;FEMININ;SCOLAIRE;BAC PROFESSIONNEL;BAC PRO SERV;BAC PRO 33002 SERVICES DE PROXIMITE  VIE LOCAL;14;14;12;2;0;0;0;12;0;2;4;2;4;2
9975.0;2022;27;CORSE;MASCULIN;APPRENTISSAGE;BAC PROFESSIONNEL;BAC PRO PROD;BAC PRO 25007 MAINTENANCE EQUIPEMENTS INDUST.;2;2;1;1;0;0;0;1;0;0;0;1;0;1
9979.0;2022;27;CORSE;MASCULIN;APPRENTISSAGE;BAC PROFESSIONNEL;BAC PRO PROD;BAC PRO 25514 SYST.NUM.OPT.B AUD.RES.EQUIP.DOM.;1;1;1;0;0;0;0;1;0;0;0;0;1;0
9983.0;2022;27;CORSE;MASCULIN;APPRENTISSAGE;BAC PROFESSIONNEL;BAC PRO SERV;BAC PRO 31214 MET.COM.VEN.OP.B PR.CL.VA.OF.COM.;1;1;0;1;0;0;0;0;0;0;0;0;0;1
9988.0;2022;27;CORSE;MASCULIN;INDIVIDUEL;BAC PROFESSIONNEL;BAC PRO PROD;BAC PRO 25214 MAINT.VEHIC.OPTA VOIT.PARTICUL.;1;0;0;0;0;0;0;0;0;0;0;0;0;0
9990.0;2022;27;CORSE;MASCULIN;INDIVIDUEL;BAC PROFESSIONNEL;BAC PRO PROD;BAC PRO AG 21113 CGEVV;4;1;1;0;0;0;0;1;0;0;0;0;1;0
9991.0;2022;27;CORSE;MASCULIN;INDIVIDUEL;BAC PROFESSIONNEL;BAC PRO PROD;BAC PRO AG 21114 CONDUITE PRODUCTIONS HORTICOLES;28;15;13;2;0;0;0;13;0;0;0;0;13;2
9998.0;2022;27;CORSE;MASCULIN;SCOLAIRE;BAC PROFESSIONNEL;BAC PRO PROD;BAC PRO 23004 TECHN. ETUDES BAT.A ETUDES & ECO.;7;7;6;1;0;0;0;6;0;0;1;2;3;1
20008.0;2023;28;LA REUNION;MASCULIN;APPRENTISSAGE;BAC PROFESSIONNEL;BAC PRO PROD;BAC PRO 25007 MAINTENANCE EQUIPEMENTS INDUST.;4;4;2;1;1;1;0;3;0;0;0;2;1;1
20010.0;2023;28;LA REUNION;MASCULIN;APPRENTISSAGE;BAC PROFESSIONNEL;BAC PRO PROD;BAC PRO 25215 MAINT.VEHIC.OPTB VEHIC.TRANS.ROUT;1;1;1;0;0;0;0;1;0;0;0;1;0;0
20011.0;2023;28;LA REUNION;MASCULIN;APPRENTISSAGE;BAC PROFESSIONNEL;BAC PRO PROD;BAC PRO 25216 MAINT.VEHIC.OPTC MOTOCYCLES;1;1;1;0;0;0;0;1;0;0;0;1;0;0
20016.0;2023;28;LA REUNION;MASCULIN;APPRENTISSAGE;BAC PROFESSIONNEL;BAC PRO PROD;BAC PRO AG 21203 TECHN CONSEIL DE VENTE ANIMAL;1;1;1;0;0;0;0;1;0;0;0;0;1;0
20020.0;2023;28;LA REUNION;MASCULIN;ENSEIGNEMENT A DISTANCE;BAC GENERAL;BAC GENERAL;BAC GENE 10019 BAC GENERAL;5;5;5;0;0;0;0;5;0;1;0;3;1;0
20021.0;2023;28;LA REUNION;MASCULIN;ENSEIGNEMENT A DISTANCE;BAC TECHNOLOGIQUE;BAC STMG;BAC STMG SYSTEMES D'INFORMATION DE GESTION;1;1;1;0;0;0;0;1;0;0;0;0;1;0
20023.0;2023;28;LA REUNION;MASCULIN;FORMATION CONTINUE;BAC PROFESSIONNEL;BAC PRO SERV;BAC PRO 31106 LOGISTIQUE;1;0;0;0;0;0;0;0;0;0;0;0;0;0
20025.0;2023;28;LA REUNION;MASCULIN;INDIVIDUEL;BAC PROFESSIONNEL;BAC PRO PROD;BAC PRO 25214 MAINT.VEHIC.OPTA VOIT.PARTICUL.;2;1;1;0;0;0;0;1;0;0;0;0;1;0
20030.0;2023;28;LA REUNION;MASCULIN;INDIVIDUEL;BAC PROFESSIONNEL;BAC PRO SERV;BAC PRO 33002 SERVICES DE PROXIMITE  VIE LOCAL;2;0;0;0;0;0;0;0;0;0;0;0;0;0
20033.0;2023;28;LA REUNION;MASCULIN;INDIVIDUEL;BAC TECHNOLOGIQUE;BAC STAV;BAC STAV AGRONOMIE ALIM ENV TERRITOI;2;0;0;0;0;0;0;0;0;0;0;0;0;0
20034.0;2023;28;LA REUNION;MASCULIN;INDIVIDUEL;BAC TECHNOLOGIQUE;BAC STI2D;BAC STI2D ARCHITECTURE ET CONSTRUCTION;1;1;0;1;0;0;0;0;0;0;0;0;0;1
20035.0;2023;28;LA REUNION;MASCULIN;INDIVIDUEL;BAC TECHNOLOGIQUE;BAC STMG;BAC STMG MERCATIQUE (MARKETING);1;1;0;0;1;1;0;1;0;0;0;0;1;0
20039.0;2023;28;LA REUNION;MASCULIN;SCOLAIRE;BAC PROFESSIONNEL;BAC PRO PROD;BAC PRO 22003 BIO-INDUSTRIES DE TRANSFORMATION;15;15;10;5;0;0;0;10;0;0;2;4;4;5
20040.0;2023;28;LA REUNION;MASCULIN;SCOLAIRE;BAC PROFESSIONNEL;BAC PRO PROD;BAC PRO 22004 PROC. CHIMIE EAU PAPIERS-CARTONS;12;12;9;2;1;1;0;10;0;0;3;5;2;2
20042.0;2023;28;LA REUNION;MASCULIN;SCOLAIRE;BAC PROFESSIONNEL;BAC PRO PROD;BAC PRO 22106 CUISINE;12;12;12;0;0;0;0;12;0;2;1;6;3;0
20044.0;2023;28;LA REUNION;MASCULIN;SCOLAIRE;BAC PROFESSIONNEL;BAC PRO PROD;BAC PRO 22703 TECHN.INSTALL.SYST.ENERG.CLIMATI;19;19;12;3;4;1;3;13;0;0;0;7;6;6
20046.0;2023;28;LA REUNION;MASCULIN;SCOLAIRE;BAC PROFESSIONNEL;BAC PRO PROD;BAC PRO 23003 ARTIS. & M.ART:MARCHANDISAGE VIS.;4;4;2;2;0;0;0;2;0;0;0;0;2;2
20048.0;2023;28;LA REUNION;MASCULIN;SCOLAIRE;BAC PROFESSIONNEL;BAC PRO PROD;BAC PRO 23005 TECHN. ETUDES BAT B ASSIST.ARCHI.;31;31;29;1;1;0;1;29;0;2;6;13;8;2
20052.0;2023;28;LA REUNION;MASCULIN;SCOLAIRE;BAC PROFESSIONNEL;BAC PRO PROD;BAC PRO 23205 INTERV. SUR PATRIMOINE BATI OPT.A;5;5;4;1;0;0;0;4;0;0;0;3;1;1
20056.0;2023;28;LA REUNION;MASCULIN;SCOLAIRE;BAC PROFESSIONNEL;BAC PRO PROD;BAC PRO 23304 AMENAGEMENT FINITION BATIMENT;37;37;25;5;7;4;3;29;0;0;2;9;18;8
20059.0;2023;28;LA REUNION;MASCULIN;SCOLAIRE;BAC PROFESSIONNEL;BAC PRO PROD;BAC PRO 23407 TECHNIC.FAB.BOIS ET MATERX ASSOC;13;13;11;0;2;2;0;13;0;0;0;2;11;0
20066.0;2023;28;LA REUNION;MASCULIN;SCOLAIRE;BAC PROFESSIONNEL;BAC PRO PROD;BAC PRO 25219 MAINT.MATERIELS OPT.A AGRICOLES;3;3;2;1;0;0;0;2;0;0;0;1;1;1
20071.0;2023;28;LA REUNION;MASCULIN;SCOLAIRE;BAC PROFESSIONNEL;BAC PRO PROD;BAC PRO 25408 REPARATION DES CARROSSERIES;52;52;46;5;1;1;0;47;0;2;7;17;21;5
20073.0;2023;28;LA REUNION;MASCULIN;SCOLAIRE;BAC PROFESSIONNEL;BAC PRO PROD;BAC PRO 25509 TECHNIC. FROID CONDITIONNEMT AIR;28;28;14;11;3;3;0;17;0;0;5;3;9;11
20074.0;2023;28;LA REUNION;MASCULIN;SCOLAIRE;BAC PROFESSIONNEL;BAC PRO PROD;BAC PRO 25510 METIERS ELECT. ENVIRON. CONNECTES;244;243;175;61;7;5;2;180;0;17;26;74;63;63
20076.0;2023;28;LA REUNION;MASCULIN;SCOLAIRE;BAC PROFESSIONNEL;BAC PRO PROD;BAC PRO 25514 SYST.NUM.OPT.B AUD.RES.EQUIP.DOM.;39;39;27;9;3;0;3;27;0;1;3;12;11;12
20081.0;2023;28;LA REUNION;MASCULIN;SCOLAIRE;BAC PROFESSIONNEL;BAC PRO PROD;BAC PRO AG 21302 GEST MILIEUX NATURELS FAUNE;11;10;9;1;0;0;0;9;0;0;3;2;4;1
20084.0;2023;28;LA REUNION;MASCULIN;SCOLAIRE;BAC PROFESSIONNEL;BAC PRO PROD;BAC PRO AG 22108 TEC CONS VTE ALIMENTATION (PAB);12;11;8;3;0;0;0;8;0;0;0;0;8;3
20091.0;2023;28;LA REUNION;MASCULIN;SCOLAIRE;BAC PROFESSIONNEL;BAC PRO SERV;BAC PRO 32207 REAL.PR.IMPR.PLURI.OPTA.PR.GRAPH.;8;8;6;2;0;0;0;6;0;1;0;4;1;2
20092.0;2023;28;LA REUNION;MASCULIN;SCOLAIRE;BAC PROFESSIONNEL;BAC PRO SERV;BAC PRO 32208 REAL.PR.IMPR.PLURI.OPTB.PR.IMPR.;3;3;1;0;2;1;1;2;0;0;1;0;1;1
20093.0;2023;28;LA REUNION;MASCULIN;SCOLAIRE;BAC PROFESSIONNEL;BAC PRO SERV;BAC PRO 32303 ART.& MET.ART:COM.VIS.VIS.PLURI-M;13;13;10;3;0;0;0;10;0;1;1;4;4;3
20116.0;2023;09;LILLE;FEMININ;APPRENTISSAGE;BAC PROFESSIONNEL;BAC PRO PROD;BAC PRO 20102 PILOTE DE LIGNE DE PRODUCTION;4;4;3;1;0;0;0;3;0;1;2;0;0;1
20122.0;2023;09;LILLE;FEMININ;APPRENTISSAGE;BAC PROFESSIONNEL;BAC PRO PROD;BAC PRO 24203 METIERS DE LA MODE - VÊTEMENT;1;1;1;0;0;0;0;1;0;0;1;0;0;0
20138.0;2023;09;LILLE;FEMININ;APPRENTISSAGE;BAC PROFESSIONNEL;BAC PRO SERV;BAC PRO 31106 LOGISTIQUE;3;3;3;0;0;0;0;3;0;1;1;0;1;0
20140.0;2023;09;LILLE;FEMININ;APPRENTISSAGE;BAC PROFESSIONNEL;BAC PRO SERV;BAC PRO 31212 METIERS DE L'ACCUEIL;6;6;5;1;0;0;0;5;0;2;1;2;0;1
20141.0;2023;09;LILLE;FEMININ;APPRENTISSAGE;BAC PROFESSIONNEL;BAC PRO SERV;BAC PRO 31213 MET.COM.VEN.OP.A ANI.GES.ESP.COM.;153;135;93;30;12;7;5;100;0;6;11;43;40;35
20143.0;2023;09;LILLE;FEMININ;APPRENTISSAGE;BAC PROFESSIONNEL;BAC PRO SERV;BAC PRO 32303 ART.& MET.ART:COM.VIS.VIS.PLURI-M;2;1;0;1;0;0;0;0;0;0;0;0;0;1
20144.0;2023;09;LILLE;FEMININ;APPRENTISSAGE;BAC PROFESSIONNEL;BAC PRO SERV;BAC PRO 33403 COMMERC. SERVICES EN RESTAURATION;19;18;13;3;2;1;1;14;0;0;4;6;4;4
20146.0;2023;09;LILLE;FEMININ;APPRENTISSAGE;BAC PROFESSIONNEL;BAC PRO SERV;BAC PRO 33604 METIERS DE LA COIFFURE;2;2;1;0;1;1;0;2;0;0;0;0;2;0
20157.0;2023;09;LILLE;FEMININ;ENSEIGNEMENT A DISTANCE;BAC TECHNOLOGIQUE;BAC STMG;BAC STMG MERCATIQUE (MARKETING);4;4;2;1;1;1;0;3;0;0;0;1;2;1
20159.0;2023;09;LILLE;FEMININ;ENSEIGNEMENT A DISTANCE;BAC TECHNOLOGIQUE;BAC STMG;BAC STMG SYSTEMES D'INFORMATION DE GESTION;1;1;1;0;0;0;0;1;0;0;0;1;0;0
20160.0;2023;09;LILLE;FEMININ;FORMATION CONTINUE;BAC PROFESSIONNEL;BAC PRO PROD;BAC PRO 22106 CUISINE;1;1;1;0;0;0;0;1;0;0;1;0;0;0
20161.0;2023;09;LILLE;FEMININ;FORMATION CONTINUE;BAC PROFESSIONNEL;BAC PRO PROD;BAC PRO 22703 TECHN.INSTALL.SYST.ENERG.CLIMATI;1;1;1;0;0;0;0;1;0;1;0;0;0;0
20162.0;2023;09;LILLE;FEMININ;FORMATION CONTINUE;BAC PROFESSIONNEL;BAC PRO SERV;BAC PRO 30004 ASSISTANC.GEST.ORGANIS.ACTIVITES;14;14;11;3;0;0;0;11;0;1;5;4;1;3
20163.0;2023;09;LILLE;FEMININ;FORMATION CONTINUE;BAC PROFESSIONNEL;BAC PRO SERV;BAC PRO 31106 LOGISTIQUE;1;1;1;0;0;0;0;1;0;0;1;0;0;0
20176.0;2023;09;LILLE;FEMININ;INDIVIDUEL;BAC PROFESSIONNEL;BAC PRO SERV;BAC PRO 33003 ACC.SOINS-S.PERS. OPT.A DOMICILE;3;2;1;1;0;0;0;1;0;0;0;0;1;1
20177.0;2023;09;LILLE;FEMININ;INDIVIDUEL;BAC PROFESSIONNEL;BAC PRO SERV;BAC PRO 33004 ACC.SOINS-S.PERS. OPT.EN STRUCTUR;4;4;2;2;0;0;0;2;0;0;0;0;2;2
20186.0;2023;09;LILLE;FEMININ;INDIVIDUEL;BAC TECHNOLOGIQUE;BAC STMG;BAC STMG RESSOURCES HUMAINES ET COMMUNICATION;9;9;0;8;1;1;0;1;0;0;0;0;1;8
20206.0;2023;09;LILLE;FEMININ;SCOLAIRE;BAC PROFESSIONNEL;BAC PRO PROD;BAC PRO 23407 TECHNIC.FAB.BOIS ET MATERX ASSOC;3;3;2;1;0;0;0;2;0;0;0;1;1;1
20210.0;2023;09;LILLE;FEMININ;SCOLAIRE;BAC PROFESSIONNEL;BAC PRO PROD;BAC PRO 25007 MAINTENANCE EQUIPEMENTS INDUST.;8;8;5;2;1;1;0;6;0;0;0;0;6;2
20214.0;2023;09;LILLE;FEMININ;SCOLAIRE;BAC PROFESSIONNEL;BAC PRO PROD;BAC PRO 25303 AERONAUTIQUE OPTION SYSTEMES;1;1;1;0;0;0;0;1;0;0;0;1;0;0
20219.0;2023;09;LILLE;FEMININ;SCOLAIRE;BAC PROFESSIONNEL;BAC PRO PROD;BAC PRO 25515 SYST.NUM.OPT.C RES.INF.SYST.COMM.;8;8;6;2;0;0;0;6;0;0;3;3;0;2
20227.0;2023;09;LILLE;FEMININ;SCOLAIRE;BAC PROFESSIONNEL;BAC PRO PROD;BAC PRO AG 21405 AMENAGEMENTS PAYSAGERS;8;7;6;1;0;0;0;6;0;0;0;1;5;1
10003.0;2022;27;CORSE;MASCULIN;SCOLAIRE;BAC PROFESSIONNEL;BAC PRO PROD;BAC PRO 25406 OUVRAGES DU BATIMENT METALLERIE;11;11;5;5;1;1;0;6;0;0;0;0;6;5
20232.0;2023;09;LILLE;FEMININ;SCOLAIRE;BAC PROFESSIONNEL;BAC PRO SERV;BAC PRO 31106 LOGISTIQUE;14;14;8;5;1;1;0;9;0;0;2;3;4;5
10004.0;2022;27;CORSE;MASCULIN;SCOLAIRE;BAC PROFESSIONNEL;BAC PRO PROD;BAC PRO 25509 TECHNIC. FROID CONDITIONNEMT AIR;9;9;6;3;0;0;0;6;0;0;1;2;3;3
20254.0;2023;09;LILLE;FEMININ;SCOLAIRE;BAC PROFESSIONNEL;BAC PRO SERV;BAC PRO AG 33002 SERV PERS TERRIT;157;154;132;22;0;0;0;132;0;4;17;39;72;22
10013.0;2022;27;CORSE;MASCULIN;SCOLAIRE;BAC PROFESSIONNEL;BAC PRO SERV;BAC PRO 30001 GESTION-ADMINISTRATION;20;20;12;7;1;1;0;13;0;0;1;5;7;7
20263.0;2023;09;LILLE;FEMININ;SCOLAIRE;BAC TECHNOLOGIQUE;BAC STI2D;BAC STI2D INNOVATION TECHNO.  ET ECO CONCEPTION;23;23;21;0;2;1;1;22;0;0;2;9;11;1
10016.0;2022;27;CORSE;MASCULIN;SCOLAIRE;BAC PROFESSIONNEL;BAC PRO SERV;BAC PRO 31212 METIERS DE L'ACCUEIL;2;2;2;0;0;0;0;2;0;0;1;1;0;0
20265.0;2023;09;LILLE;FEMININ;SCOLAIRE;BAC TECHNOLOGIQUE;BAC STL;BAC STL BIOCHIM.-BIOLOGIE-BIOTECHNOL.;130;130;109;7;14;9;5;118;1;6;21;41;49;12
10019.0;2022;27;CORSE;MASCULIN;SCOLAIRE;BAC PROFESSIONNEL;BAC PRO SERV;BAC PRO 33004 ACC.SOINS-S.PERS. OPT.EN STRUCTUR;4;4;2;2;0;0;0;2;0;0;0;1;1;2
20271.0;2023;09;LILLE;MASCULIN;APPRENTISSAGE;BAC PROFESSIONNEL;BAC PRO PROD;BAC PRO 20102 PILOTE DE LIGNE DE PRODUCTION;32;30;24;5;1;1;0;25;0;7;8;4;6;5
10028.0;2022;27;CORSE;MASCULIN;SCOLAIRE;BAC TECHNOLOGIQUE;BAC STI2D;BAC STI2D SYSTÈME D'INFORMATION  ET NUMERIQUE;33;33;28;1;4;4;0;32;0;0;5;8;19;1
20273.0;2023;09;LILLE;MASCULIN;APPRENTISSAGE;BAC PROFESSIONNEL;BAC PRO PROD;BAC PRO 22105 BOULANGER-PÂTISSIER;3;3;3;0;0;0;0;3;0;0;1;0;2;0
10033.0;2022;24;CRETEIL;FEMININ;APPRENTISSAGE;BAC PROFESSIONNEL;BAC PRO PROD;BAC PRO 22105 BOULANGER-PÂTISSIER;1;1;1;0;0;0;0;1;0;1;0;0;0;0
20277.0;2023;09;LILLE;MASCULIN;APPRENTISSAGE;BAC PROFESSIONNEL;BAC PRO PROD;BAC PRO 22704 TECHN. MAINT. SYST.ENERG.CLIMATI;31;29;25;2;2;2;0;27;0;1;9;12;5;2
10034.0;2022;24;CRETEIL;FEMININ;APPRENTISSAGE;BAC PROFESSIONNEL;BAC PRO PROD;BAC PRO 22106 CUISINE;27;26;16;8;2;1;1;17;0;3;3;5;6;9
20281.0;2023;09;LILLE;MASCULIN;APPRENTISSAGE;BAC PROFESSIONNEL;BAC PRO PROD;BAC PRO 23304 AMENAGEMENT FINITION BATIMENT;30;30;20;4;6;4;2;24;0;2;1;8;13;6
10035.0;2022;24;CRETEIL;FEMININ;APPRENTISSAGE;BAC PROFESSIONNEL;BAC PRO PROD;BAC PRO 22704 TECHN. MAINT. SYST.ENERG.CLIMATI;1;1;1;0;0;0;0;1;0;0;0;1;0;0
20295.0;2023;09;LILLE;MASCULIN;APPRENTISSAGE;BAC PROFESSIONNEL;BAC PRO PROD;BAC PRO 25304 AERONAUTIQUE OPTION STRUCTURE;4;4;4;0;0;0;0;4;0;1;1;2;0;0
10036.0;2022;24;CRETEIL;FEMININ;APPRENTISSAGE;BAC PROFESSIONNEL;BAC PRO PROD;BAC PRO 24302 METIERS DU CUIR : MAROQUINERIE;21;21;21;0;0;0;0;21;0;10;8;3;0;0
20312.0;2023;09;LILLE;MASCULIN;APPRENTISSAGE;BAC PROFESSIONNEL;BAC PRO SERV;BAC PRO 31212 METIERS DE L'ACCUEIL;3;3;2;1;0;0;0;2;0;0;1;0;1;1
10045.0;2022;24;CRETEIL;FEMININ;APPRENTISSAGE;BAC PROFESSIONNEL;BAC PRO SERV;BAC PRO 31106 LOGISTIQUE;3;3;3;0;0;0;0;3;0;0;0;1;2;0
20315.0;2023;09;LILLE;MASCULIN;APPRENTISSAGE;BAC PROFESSIONNEL;BAC PRO SERV;BAC PRO 32303 ART.& MET.ART:COM.VIS.VIS.PLURI-M;2;2;2;0;0;0;0;2;0;1;0;1;0;0
10052.0;2022;24;CRETEIL;FEMININ;APPRENTISSAGE;BAC PROFESSIONNEL;BAC PRO SERV;BAC PRO 33603 ESTHETIQUE COSMETIQUE PARFUMERIE;11;11;6;5;0;0;0;6;0;0;1;2;3;5
20331.0;2023;09;LILLE;MASCULIN;FORMATION CONTINUE;BAC PROFESSIONNEL;BAC PRO PROD;BAC PRO 23405 TECHNICIEN MENUISIER AGENCEUR;2;2;2;0;0;0;0;2;0;2;0;0;0;0
10056.0;2022;24;CRETEIL;FEMININ;ENSEIGNEMENT A DISTANCE;BAC GENERAL;BAC GENERAL;BAC GENE 10019 BAC GENERAL;82;80;61;11;8;7;1;68;1;4;15;17;31;12
20332.0;2023;09;LILLE;MASCULIN;FORMATION CONTINUE;BAC PROFESSIONNEL;BAC PRO PROD;BAC PRO 25220 MAINT.MATERIELS OPT.B TP MANUT.;6;6;6;0;0;0;0;6;0;0;1;1;4;0
10062.0;2022;24;CRETEIL;FEMININ;ENSEIGNEMENT A DISTANCE;BAC TECHNOLOGIQUE;BAC STMG;BAC STMG GESTION ET FINANCE;4;4;1;3;0;0;0;1;0;0;0;0;1;3
20340.0;2023;09;LILLE;MASCULIN;INDIVIDUEL;BAC PROFESSIONNEL;BAC PRO PROD;BAC PRO 23005 TECHN. ETUDES BAT B ASSIST.ARCHI.;1;1;0;1;0;0;0;0;0;0;0;0;0;1
10064.0;2022;24;CRETEIL;FEMININ;ENSEIGNEMENT A DISTANCE;BAC TECHNOLOGIQUE;BAC STMG;BAC STMG RESSOURCES HUMAINES ET COMMUNICATION;7;7;4;2;1;1;0;5;0;1;1;0;3;2
20343.0;2023;09;LILLE;MASCULIN;INDIVIDUEL;BAC PROFESSIONNEL;BAC PRO PROD;BAC PRO 25007 MAINTENANCE EQUIPEMENTS INDUST.;2;2;1;1;0;0;0;1;0;0;0;1;0;1
10074.0;2022;24;CRETEIL;FEMININ;INDIVIDUEL;BAC GENERAL;BAC GENERAL;BAC GENE 10019 BAC GENERAL;223;150;79;43;28;20;8;99;0;5;19;25;50;51
20346.0;2023;09;LILLE;MASCULIN;INDIVIDUEL;BAC PROFESSIONNEL;BAC PRO PROD;BAC PRO 25411 TECH.CHAUDRONNERIE INDUSTRIELLE;1;1;1;0;0;0;0;1;0;0;0;1;0;0
10082.0;2022;24;CRETEIL;FEMININ;INDIVIDUEL;BAC PROFESSIONNEL;BAC PRO SERV;BAC PRO 31212 METIERS DE L'ACCUEIL;5;1;0;0;1;1;0;1;0;0;0;0;1;0
20347.0;2023;09;LILLE;MASCULIN;INDIVIDUEL;BAC PROFESSIONNEL;BAC PRO PROD;BAC PRO 25510 METIERS ELECT. ENVIRON. CONNECTES;7;5;3;2;0;0;0;3;0;0;0;0;3;2
10087.0;2022;24;CRETEIL;FEMININ;INDIVIDUEL;BAC PROFESSIONNEL;BAC PRO SERV;BAC PRO 33102 PROTHESE DENTAIRE;1;1;1;0;0;0;0;1;0;0;0;0;1;0
20351.0;2023;09;LILLE;MASCULIN;INDIVIDUEL;BAC PROFESSIONNEL;BAC PRO PROD;BAC PRO AG 21405 AMENAGEMENTS PAYSAGERS;1;1;1;0;0;0;0;1;0;0;0;0;1;0
10091.0;2022;24;CRETEIL;FEMININ;INDIVIDUEL;BAC TECHNOLOGIQUE;BAC STD2A;BAC STD2A SCIENCES & TECHNO. DESIGN-ARTS APPLIQUES;3;3;0;1;2;0;2;0;0;0;0;0;0;3
20363.0;2023;09;LILLE;MASCULIN;INDIVIDUEL;BAC TECHNOLOGIQUE;BAC STI2D;BAC STI2D INNOVATION TECHNO.  ET ECO CONCEPTION;1;1;0;1;0;0;0;0;0;0;0;0;0;1
10093.0;2022;24;CRETEIL;FEMININ;INDIVIDUEL;BAC TECHNOLOGIQUE;BAC STL;BAC STL BIOCHIM.-BIOLOGIE-BIOTECHNOL.;1;1;0;0;1;0;1;0;0;0;0;0;0;1
20367.0;2023;09;LILLE;MASCULIN;INDIVIDUEL;BAC TECHNOLOGIQUE;BAC STMG;BAC STMG GESTION ET FINANCE;4;4;1;3;0;0;0;1;0;0;0;0;1;3
10096.0;2022;24;CRETEIL;FEMININ;INDIVIDUEL;BAC TECHNOLOGIQUE;BAC STMG;BAC STMG MERCATIQUE (MARKETING);23;12;6;3;3;2;1;8;0;0;1;2;5;4
20368.0;2023;09;LILLE;MASCULIN;INDIVIDUEL;BAC TECHNOLOGIQUE;BAC STMG;BAC STMG MERCATIQUE (MARKETING);21;20;4;15;1;0;1;4;0;0;0;1;3;16
10100.0;2022;24;CRETEIL;FEMININ;SCOLAIRE;BAC PROFESSIONNEL;BAC PRO PROD;BAC PRO 22004 PROC. CHIMIE EAU PAPIERS-CARTONS;4;4;4;0;0;0;0;4;0;1;1;1;1;0
20369.0;2023;09;LILLE;MASCULIN;INDIVIDUEL;BAC TECHNOLOGIQUE;BAC STMG;BAC STMG RESSOURCES HUMAINES ET COMMUNICATION;18;18;5;11;2;2;0;7;0;0;0;0;7;11
10106.0;2022;24;CRETEIL;FEMININ;SCOLAIRE;BAC PROFESSIONNEL;BAC PRO PROD;BACPRO 23103 TECHNICIEN GEOMETRE-TOPOGRAPHE;1;1;0;1;0;0;0;0;0;0;0;0;0;1
20370.0;2023;09;LILLE;MASCULIN;INDIVIDUEL;BAC TECHNOLOGIQUE;BAC STMG;BAC STMG SYSTEMES D'INFORMATION DE GESTION;1;1;0;1;0;0;0;0;0;0;0;0;0;1
10107.0;2022;24;CRETEIL;FEMININ;SCOLAIRE;BAC PROFESSIONNEL;BAC PRO PROD;BAC PRO 23203 TECHNICIEN BAT. : ORG.REAL.GROS O;1;1;1;0;0;0;0;1;0;0;0;0;1;0
20376.0;2023;09;LILLE;MASCULIN;SCOLAIRE;BAC PROFESSIONNEL;BAC PRO PROD;BAC PRO 22105 BOULANGER-PÂTISSIER;81;81;60;17;4;4;0;64;0;0;11;24;29;17
10108.0;2022;24;CRETEIL;FEMININ;SCOLAIRE;BAC PROFESSIONNEL;BAC PRO PROD;BAC PRO 23304 AMENAGEMENT FINITION BATIMENT;4;4;4;0;0;0;0;4;0;1;3;0;0;0
20379.0;2023;09;LILLE;MASCULIN;SCOLAIRE;BAC PROFESSIONNEL;BAC PRO PROD;BAC PRO 22403 ARTS.& MET.ART:MET.ENSEIGN SIGNA;11;11;7;2;2;1;1;8;0;0;0;4;4;3
10113.0;2022;24;CRETEIL;FEMININ;SCOLAIRE;BAC PROFESSIONNEL;BAC PRO PROD;BAC PRO 24203 METIERS DE LA MODE - VÊTEMENT;191;188;150;32;6;5;1;155;0;28;37;39;51;33
20380.0;2023;09;LILLE;MASCULIN;SCOLAIRE;BAC PROFESSIONNEL;BAC PRO PROD;BAC PRO 22503 PLASTIQUES ET COMPOSITES;12;12;6;5;1;1;0;7;0;0;4;2;1;5
10114.0;2022;24;CRETEIL;FEMININ;SCOLAIRE;BAC PROFESSIONNEL;BAC PRO PROD;BAC PRO 24302 METIERS DU CUIR : MAROQUINERIE;14;14;10;4;0;0;0;10;0;3;2;4;1;4
20389.0;2023;09;LILLE;MASCULIN;SCOLAIRE;BAC PROFESSIONNEL;BAC PRO PROD;BAC PRO 23205 INTERV. SUR PATRIMOINE BATI OPT.A;4;4;4;0;0;0;0;4;0;1;0;1;2;0
10119.0;2022;24;CRETEIL;FEMININ;SCOLAIRE;BAC PROFESSIONNEL;BAC PRO PROD;BAC PRO 25216 MAINT.VEHIC.OPTC MOTOCYCLES;2;2;2;0;0;0;0;2;0;1;0;1;0;0
20391.0;2023;09;LILLE;MASCULIN;SCOLAIRE;BAC PROFESSIONNEL;BAC PRO PROD;BAC PRO 23304 AMENAGEMENT FINITION BATIMENT;106;106;79;19;8;4;4;83;0;2;16;38;27;23
10120.0;2022;24;CRETEIL;FEMININ;SCOLAIRE;BAC PROFESSIONNEL;BAC PRO PROD;BAC PRO 25304 AERONAUTIQUE OPTION STRUCTURE;1;1;1;0;0;0;0;1;0;0;1;0;0;0
20404.0;2023;09;LILLE;MASCULIN;SCOLAIRE;BAC PROFESSIONNEL;BAC PRO PROD;BAC PRO 25220 MAINT.MATERIELS OPT.B TP MANUT.;24;24;20;1;3;2;1;22;0;0;3;9;10;2
10129.0;2022;24;CRETEIL;FEMININ;SCOLAIRE;BAC PROFESSIONNEL;BAC PRO PROD;BAC PRO AG 21114 CONDUITE PRODUCTIONS HORTICOLES;8;8;6;2;0;0;0;6;0;0;0;1;5;2
20407.0;2023;09;LILLE;MASCULIN;SCOLAIRE;BAC PROFESSIONNEL;BAC PRO PROD;BAC PRO 25408 REPARATION DES CARROSSERIES;156;153;107;31;15;10;5;117;0;9;14;33;61;36
10133.0;2022;24;CRETEIL;FEMININ;SCOLAIRE;BAC PROFESSIONNEL;BAC PRO PROD;BAC PRO AG 22107 TEC CONS VTE ALIMENTATION P.ALIM;4;4;3;1;0;0;0;3;0;0;0;0;3;1
20410.0;2023;09;LILLE;MASCULIN;SCOLAIRE;BAC PROFESSIONNEL;BAC PRO PROD;BAC PRO 25509 TECHNIC. FROID CONDITIONNEMT AIR;59;58;44;11;3;1;2;45;0;3;12;12;18;13
10144.0;2022;24;CRETEIL;FEMININ;SCOLAIRE;BAC PROFESSIONNEL;BAC PRO SERV;BAC PRO 32304 PHOTOGRAPHIE;22;22;18;4;0;0;0;18;0;0;3;7;8;4
20422.0;2023;09;LILLE;MASCULIN;SCOLAIRE;BAC PROFESSIONNEL;BAC PRO PROD;BAC PRO AG 21302 GEST MILIEUX NATURELS FAUNE;34;34;25;9;0;0;0;25;0;0;3;10;12;9
10164.0;2022;24;CRETEIL;FEMININ;SCOLAIRE;BAC TECHNOLOGIQUE;BAC STMG;BAC STMG GESTION ET FINANCE;765;765;657;22;86;52;34;709;1;31;120;272;285;56
20431.0;2023;09;LILLE;MASCULIN;SCOLAIRE;BAC PROFESSIONNEL;BAC PRO SERV;BAC PRO 31114 ORGANIS. TRANSPORT MARCHANDISES;52;51;29;22;0;0;0;29;0;0;4;10;15;22
10166.0;2022;24;CRETEIL;FEMININ;SCOLAIRE;BAC TECHNOLOGIQUE;BAC STMG;BAC STMG RESSOURCES HUMAINES ET COMMUNICATION;1064;1064;832;52;180;137;43;969;1;20;113;306;529;95
20437.0;2023;09;LILLE;MASCULIN;SCOLAIRE;BAC PROFESSIONNEL;BAC PRO SERV;BAC PRO 32208 REAL.PR.IMPR.PLURI.OPTB.PR.IMPR.;4;4;3;1;0;0;0;3;0;0;1;2;0;1
10175.0;2022;24;CRETEIL;MASCULIN;APPRENTISSAGE;BAC PROFESSIONNEL;BAC PRO PROD;BAC PRO 25007 MAINTENANCE EQUIPEMENTS INDUST.;67;65;57;7;1;1;0;58;0;5;17;22;14;7
20439.0;2023;09;LILLE;MASCULIN;SCOLAIRE;BAC PROFESSIONNEL;BAC PRO SERV;BAC PRO 32304 PHOTOGRAPHIE;3;3;2;0;1;1;0;3;0;0;0;1;2;0
10180.0;2022;24;CRETEIL;MASCULIN;APPRENTISSAGE;BAC PROFESSIONNEL;BAC PRO PROD;BAC PRO 25219 MAINT.MATERIELS OPT.A AGRICOLES;1;1;1;0;0;0;0;1;0;0;0;1;0;0
20443.0;2023;09;LILLE;MASCULIN;SCOLAIRE;BAC PROFESSIONNEL;BAC PRO SERV;BAC PRO 33101 OPTIQUE LUNETTERIE;15;15;9;4;2;1;1;10;0;1;0;4;5;5
10188.0;2022;24;CRETEIL;MASCULIN;APPRENTISSAGE;BAC PROFESSIONNEL;BAC PRO PROD;BAC PRO 25515 SYST.NUM.OPT.C RES.INF.SYST.COMM.;12;12;11;1;0;0;0;11;0;1;4;5;1;1
20444.0;2023;09;LILLE;MASCULIN;SCOLAIRE;BAC PROFESSIONNEL;BAC PRO SERV;BAC PRO 33103 TECHNICIEN APPAREIL. ORTHOPEDIQUE;8;8;8;0;0;0;0;8;0;0;1;2;5;0
10190.0;2022;24;CRETEIL;MASCULIN;APPRENTISSAGE;BAC PROFESSIONNEL;BAC PRO PROD;BAC PRO AG 21211 COND GEST ENTR HIPPIQUE;7;7;7;0;0;0;0;7;0;0;1;2;4;0
20446.0;2023;09;LILLE;MASCULIN;SCOLAIRE;BAC PROFESSIONNEL;BAC PRO SERV;BAC PRO 33403 COMMERC. SERVICES EN RESTAURATION;124;123;100;19;4;3;1;103;0;4;19;34;46;20
10201.0;2022;24;CRETEIL;MASCULIN;ENSEIGNEMENT A DISTANCE;BAC GENERAL;BAC GENERAL;BAC GENE 10019 BAC GENERAL;31;29;22;4;3;3;0;25;0;1;7;7;10;4
20451.0;2023;09;LILLE;MASCULIN;SCOLAIRE;BAC PROFESSIONNEL;BAC PRO SERV;BAC PRO AG 33002 SERV PERS TERRIT;23;22;18;4;0;0;0;18;0;1;1;4;12;4
10209.0;2022;24;CRETEIL;MASCULIN;ENSEIGNEMENT A DISTANCE;BAC TECHNOLOGIQUE;BAC STMG;BAC STMG MERCATIQUE (MARKETING);7;7;4;3;0;0;0;4;0;0;1;0;3;3
20458.0;2023;09;LILLE;MASCULIN;SCOLAIRE;BAC TECHNOLOGIQUE;BAC STI2D;BAC STI2D ENERGIES  ET ENVIRONNEMENT;246;246;182;20;44;34;10;216;0;4;35;72;105;30
10213.0;2022;24;CRETEIL;MASCULIN;FORMATION CONTINUE;BAC PROFESSIONNEL;BAC PRO PROD;BAC PRO 24303 MET. DU CUIR: SELLERIE GARNISSAGE;3;3;2;1;0;0;0;2;0;1;0;0;1;1
20476.0;2023;22;LIMOGES;FEMININ;APPRENTISSAGE;BAC PROFESSIONNEL;BAC PRO SERV;BAC PRO 33003 ACC.SOINS-S.PERS. OPT.A DOMICILE;3;3;2;0;1;0;1;2;0;0;0;1;1;1
10214.0;2022;24;CRETEIL;MASCULIN;FORMATION CONTINUE;BAC PROFESSIONNEL;BAC PRO PROD;BAC PRO 25214 MAINT.VEHIC.OPTA VOIT.PARTICUL.;9;7;7;0;0;0;0;7;0;4;1;1;1;0
20482.0;2023;22;LIMOGES;FEMININ;ENSEIGNEMENT A DISTANCE;BAC PROFESSIONNEL;BAC PRO SERV;BAC PRO 33004 ACC.SOINS-S.PERS. OPT.EN STRUCTUR;1;1;0;1;0;0;0;0;0;0;0;0;0;1
10218.0;2022;24;CRETEIL;MASCULIN;FORMATION CONTINUE;BAC PROFESSIONNEL;BAC PRO PROD;BAC PRO 25515 SYST.NUM.OPT.C RES.INF.SYST.COMM.;11;11;8;3;0;0;0;8;0;1;0;4;3;3
20487.0;2023;22;LIMOGES;FEMININ;INDIVIDUEL;BAC GENERAL;BAC GENERAL;BAC GENE 10019 BAC GENERAL;13;12;5;2;5;2;3;7;0;0;2;1;4;5
10224.0;2022;24;CRETEIL;MASCULIN;INDIVIDUEL;BAC PROFESSIONNEL;BAC PRO PROD;BAC PRO 22703 TECHN.INSTALL.SYST.ENERG.CLIMATI;1;1;0;1;0;0;0;0;0;0;0;0;0;1
20499.0;2023;22;LIMOGES;FEMININ;INDIVIDUEL;BAC TECHNOLOGIQUE;BAC STMG;BAC STMG RESSOURCES HUMAINES ET COMMUNICATION;3;2;0;0;2;2;0;2;0;0;0;0;2;0
10235.0;2022;24;CRETEIL;MASCULIN;INDIVIDUEL;BAC PROFESSIONNEL;BAC PRO PROD;BAC PRO 25411 TECH.CHAUDRONNERIE INDUSTRIELLE;2;2;1;1;0;0;0;1;0;0;0;0;1;1
20503.0;2023;22;LIMOGES;FEMININ;SCOLAIRE;BAC PROFESSIONNEL;BAC PRO PROD;BAC PRO 22105 BOULANGER-PÂTISSIER;7;7;7;0;0;0;0;7;0;3;3;0;1;0
10244.0;2022;24;CRETEIL;MASCULIN;INDIVIDUEL;BAC PROFESSIONNEL;BAC PRO PROD;BAC PRO AG 22105 LABORATOIRE CONTROLE QUALITE;1;1;0;1;0;0;0;0;0;0;0;0;0;1
20530.0;2023;22;LIMOGES;FEMININ;SCOLAIRE;BAC PROFESSIONNEL;BAC PRO SERV;BAC PRO 32303 ART.& MET.ART:COM.VIS.VIS.PLURI-M;3;3;2;1;0;0;0;2;0;1;0;0;1;1
10245.0;2022;24;CRETEIL;MASCULIN;INDIVIDUEL;BAC PROFESSIONNEL;BAC PRO SERV;BAC PRO 30001 GESTION-ADMINISTRATION;25;16;7;9;0;0;0;7;0;0;0;2;5;9
20531.0;2023;22;LIMOGES;FEMININ;SCOLAIRE;BAC PROFESSIONNEL;BAC PRO SERV;BAC PRO 33003 ACC.SOINS-S.PERS. OPT.A DOMICILE;46;46;42;4;0;0;0;42;0;2;10;15;15;4
10256.0;2022;24;CRETEIL;MASCULIN;INDIVIDUEL;BAC TECHNOLOGIQUE;BAC STI2D;BAC STI2D ENERGIES  ET ENVIRONNEMENT;3;2;2;0;0;0;0;2;0;0;1;0;1;0
20532.0;2023;22;LIMOGES;FEMININ;SCOLAIRE;BAC PROFESSIONNEL;BAC PRO SERV;BAC PRO 33004 ACC.SOINS-S.PERS. OPT.EN STRUCTUR;139;139;128;6;5;4;1;132;0;5;28;55;44;7
10259.0;2022;24;CRETEIL;MASCULIN;INDIVIDUEL;BAC TECHNOLOGIQUE;BAC STMG;BAC STMG GESTION ET FINANCE;14;10;1;8;1;1;0;2;0;0;0;0;2;8
20539.0;2023;22;LIMOGES;FEMININ;SCOLAIRE;BAC PROFESSIONNEL;BAC PRO SERV;BAC PRO 34403 METIERS DE LA SECURITE;14;14;11;1;2;1;1;12;0;1;3;1;7;2
10265.0;2022;24;CRETEIL;MASCULIN;SCOLAIRE;BAC PROFESSIONNEL;BAC PRO PROD;BAC PRO 22004 PROC. CHIMIE EAU PAPIERS-CARTONS;10;9;8;1;0;0;0;8;0;1;2;4;1;1
20542.0;2023;22;LIMOGES;FEMININ;SCOLAIRE;BAC TECHNOLOGIQUE;BAC STAV;BAC STAV AGRONOMIE ALIM ENV TERRITOI;41;41;41;0;0;0;0;41;0;0;7;14;20;0
10280.0;2022;24;CRETEIL;MASCULIN;SCOLAIRE;BAC PROFESSIONNEL;BAC PRO PROD;BAC PRO 23407 TECHNIC.FAB.BOIS ET MATERX ASSOC;7;7;5;2;0;0;0;5;0;0;0;1;4;2
20543.0;2023;22;LIMOGES;FEMININ;SCOLAIRE;BAC TECHNOLOGIQUE;BAC STD2A;BAC STD2A SCIENCES & TECHNO. DESIGN-ARTS APPLIQUES;21;21;21;0;0;0;0;21;0;1;2;10;8;0
10287.0;2022;24;CRETEIL;MASCULIN;SCOLAIRE;BAC PROFESSIONNEL;BAC PRO PROD;BAC PRO 25106 TECHNICIEN D'USINAGE;125;125;92;24;9;8;1;100;0;6;23;35;36;25
20544.0;2023;22;LIMOGES;FEMININ;SCOLAIRE;BAC TECHNOLOGIQUE;BAC STHR;BAC STHR SC.&TEC. HOTELLERIE-RESTAURATION;11;11;10;1;0;0;0;10;0;0;5;3;2;1
10294.0;2022;24;CRETEIL;MASCULIN;SCOLAIRE;BAC PROFESSIONNEL;BAC PRO PROD;BAC PRO 25221 MAINT.MATERIELS OPT.C ESP. VERTS;26;26;25;1;0;0;0;25;0;0;4;15;6;1
20549.0;2023;22;LIMOGES;FEMININ;SCOLAIRE;BAC TECHNOLOGIQUE;BAC STL;BAC STL SCIENCES PHYSIQUES CHIMIQUES  EN LABORAT.;29;29;29;0;0;0;0;29;0;0;10;10;9;0
10300.0;2022;24;CRETEIL;MASCULIN;SCOLAIRE;BAC PROFESSIONNEL;BAC PRO PROD;BAC PRO 25410 CONSTRUCTION DES CARROSSERIES;12;12;11;1;0;0;0;11;0;0;1;6;4;1
20550.0;2023;22;LIMOGES;FEMININ;SCOLAIRE;BAC TECHNOLOGIQUE;BAC STMG;BAC STMG GESTION ET FINANCE;52;52;41;3;8;5;3;46;0;4;7;17;18;6
10306.0;2022;24;CRETEIL;MASCULIN;SCOLAIRE;BAC PROFESSIONNEL;BAC PRO PROD;BAC PRO 25515 SYST.NUM.OPT.C RES.INF.SYST.COMM.;488;486;415;62;9;9;0;424;0;20;102;160;142;62
20558.0;2023;22;LIMOGES;MASCULIN;APPRENTISSAGE;BAC PROFESSIONNEL;BAC PRO PROD;BAC PRO 23203 TECHNICIEN BAT. : ORG.REAL.GROS O;1;1;1;0;0;0;0;1;0;0;1;0;0;0
10310.0;2022;24;CRETEIL;MASCULIN;SCOLAIRE;BAC PROFESSIONNEL;BAC PRO PROD;BAC PRO AG 21407 TEC CONS VTE UNIVERS JARDINERIE;3;3;0;3;0;0;0;0;0;0;0;0;0;3
20570.0;2023;22;LIMOGES;MASCULIN;APPRENTISSAGE;BAC PROFESSIONNEL;BAC PRO PROD;BAC PRO 25216 MAINT.VEHIC.OPTC MOTOCYCLES;4;4;4;0;0;0;0;4;0;1;1;2;0;0
10311.0;2022;24;CRETEIL;MASCULIN;SCOLAIRE;BAC PROFESSIONNEL;BAC PRO PROD;BAC PRO AG 22105 LABORATOIRE CONTROLE QUALITE;9;9;5;4;0;0;0;5;0;0;0;0;5;4
20573.0;2023;22;LIMOGES;MASCULIN;APPRENTISSAGE;BAC PROFESSIONNEL;BAC PRO PROD;BAC PRO 25221 MAINT.MATERIELS OPT.C ESP. VERTS;2;2;2;0;0;0;0;2;0;0;0;1;1;0
10315.0;2022;24;CRETEIL;MASCULIN;SCOLAIRE;BAC PROFESSIONNEL;BAC PRO SERV;BAC PRO 31107 CONDUCT. TRANSP.ROUT.MARCHANDISES;41;41;27;12;2;1;1;28;0;2;7;14;5;13
20583.0;2023;22;LIMOGES;MASCULIN;APPRENTISSAGE;BAC PROFESSIONNEL;BAC PRO SERV;BAC PRO 31213 MET.COM.VEN.OP.A ANI.GES.ESP.COM.;35;34;23;6;5;4;1;27;0;1;2;7;17;7
10324.0;2022;24;CRETEIL;MASCULIN;SCOLAIRE;BAC PROFESSIONNEL;BAC PRO SERV;BAC PRO 32304 PHOTOGRAPHIE;18;18;14;4;0;0;0;14;0;0;2;7;5;4
20593.0;2023;22;LIMOGES;MASCULIN;INDIVIDUEL;BAC GENERAL;BAC GENERAL;BAC GENE 10019 BAC GENERAL;8;8;6;1;1;0;1;6;0;0;1;4;1;2
10326.0;2022;24;CRETEIL;MASCULIN;SCOLAIRE;BAC PROFESSIONNEL;BAC PRO SERV;BAC PRO 33004 ACC.SOINS-S.PERS. OPT.EN STRUCTUR;105;104;82;20;2;2;0;84;0;2;7;36;39;20
20600.0;2023;22;LIMOGES;MASCULIN;INDIVIDUEL;BAC PROFESSIONNEL;BAC PRO SERV;BAC PRO 30004 ASSISTANC.GEST.ORGANIS.ACTIVITES;1;0;0;0;0;0;0;0;0;0;0;0;0;0
10328.0;2022;24;CRETEIL;MASCULIN;SCOLAIRE;BAC PROFESSIONNEL;BAC PRO SERV;BAC PRO 33102 PROTHESE DENTAIRE;4;4;4;0;0;0;0;4;0;0;1;2;1;0
20608.0;2023;22;LIMOGES;MASCULIN;SCOLAIRE;BAC PROFESSIONNEL;BAC PRO PROD;BAC PRO 20102 PILOTE DE LIGNE DE PRODUCTION;12;12;9;2;1;1;0;10;0;0;4;2;4;2
10331.0;2022;24;CRETEIL;MASCULIN;SCOLAIRE;BAC PROFESSIONNEL;BAC PRO SERV;BAC PRO 34303 GEST. POLLUTIONS PROTEC. ENVIRON.;13;12;11;1;0;0;0;11;0;0;2;2;7;1
20609.0;2023;22;LIMOGES;MASCULIN;SCOLAIRE;BAC PROFESSIONNEL;BAC PRO PROD;BAC PRO 22004 PROC. CHIMIE EAU PAPIERS-CARTONS;9;9;8;0;1;1;0;9;0;0;2;3;4;0
10348.0;2022;24;CRETEIL;MASCULIN;SCOLAIRE;BAC TECHNOLOGIQUE;BAC STMG;BAC STMG SYSTEMES D'INFORMATION DE GESTION;210;210;136;26;48;34;14;170;0;4;6;48;112;40
20610.0;2023;22;LIMOGES;MASCULIN;SCOLAIRE;BAC PROFESSIONNEL;BAC PRO PROD;BAC PRO 22104 BOUCHER CHARCUTIER TRAITEUR;11;11;10;0;1;0;1;10;0;0;1;4;5;1
10352.0;2022;07;DIJON;FEMININ;APPRENTISSAGE;BAC PROFESSIONNEL;BAC PRO PROD;BAC PRO 23004 TECHN. ETUDES BAT.A ETUDES & ECO.;1;1;0;1;0;0;0;0;0;0;0;0;0;1
20613.0;2023;22;LIMOGES;MASCULIN;SCOLAIRE;BAC PROFESSIONNEL;BAC PRO PROD;BAC PRO 22704 TECHN. MAINT. SYST.ENERG.CLIMATI;4;4;0;2;2;0;2;0;0;0;0;0;0;4
10355.0;2022;07;DIJON;FEMININ;APPRENTISSAGE;BAC PROFESSIONNEL;BAC PRO PROD;BAC PRO 24202 ARTIS.& MET.ART : TAPIS.D'AMEUBL;1;1;1;0;0;0;0;1;0;0;0;1;0;0
20624.0;2023;22;LIMOGES;MASCULIN;SCOLAIRE;BAC PROFESSIONNEL;BAC PRO PROD;BAC PRO 25106 TECHNICIEN D'USINAGE;37;37;17;15;5;5;0;22;0;0;2;5;15;15
10356.0;2022;07;DIJON;FEMININ;APPRENTISSAGE;BAC PROFESSIONNEL;BAC PRO PROD;BAC PRO 25007 MAINTENANCE EQUIPEMENTS INDUST.;3;3;3;0;0;0;0;3;0;0;0;2;1;0
20625.0;2023;22;LIMOGES;MASCULIN;SCOLAIRE;BAC PROFESSIONNEL;BAC PRO PROD;BAC PRO 25107 TECHNICIEN OUTILLEUR;3;3;1;1;1;1;0;2;0;0;0;0;2;1
10359.0;2022;07;DIJON;FEMININ;APPRENTISSAGE;BAC PROFESSIONNEL;BAC PRO PROD;BAC PRO 25411 TECH.CHAUDRONNERIE INDUSTRIELLE;1;1;1;0;0;0;0;1;0;0;0;1;0;0
20632.0;2023;22;LIMOGES;MASCULIN;SCOLAIRE;BAC PROFESSIONNEL;BAC PRO PROD;BAC PRO 25221 MAINT.MATERIELS OPT.C ESP. VERTS;3;3;1;1;1;1;0;2;0;0;0;0;2;1
10362.0;2022;07;DIJON;FEMININ;APPRENTISSAGE;BAC PROFESSIONNEL;BAC PRO PROD;BAC PRO AG 21114 CONDUITE PRODUCTIONS HORTICOLES;2;2;2;0;0;0;0;2;0;1;1;0;0;0
20636.0;2023;22;LIMOGES;MASCULIN;SCOLAIRE;BAC PROFESSIONNEL;BAC PRO PROD;BAC PRO 25509 TECHNIC. FROID CONDITIONNEMT AIR;2;2;2;0;0;0;0;2;0;0;0;0;2;0
10365.0;2022;07;DIJON;FEMININ;APPRENTISSAGE;BAC PROFESSIONNEL;BAC PRO PROD;BAC PRO AG 21405 AMENAGEMENTS PAYSAGERS;2;2;2;0;0;0;0;2;0;0;1;0;1;0
20637.0;2023;22;LIMOGES;MASCULIN;SCOLAIRE;BAC PROFESSIONNEL;BAC PRO PROD;BAC PRO 25510 METIERS ELECT. ENVIRON. CONNECTES;94;93;64;21;8;8;0;72;0;5;12;23;32;21
10382.0;2022;07;DIJON;FEMININ;ENSEIGNEMENT A DISTANCE;BAC TECHNOLOGIQUE;BAC STMG;BAC STMG MERCATIQUE (MARKETING);2;1;1;0;0;0;0;1;0;0;0;1;0;0
20639.0;2023;22;LIMOGES;MASCULIN;SCOLAIRE;BAC PROFESSIONNEL;BAC PRO PROD;BAC PRO 25515 SYST.NUM.OPT.C RES.INF.SYST.COMM.;35;35;26;7;2;1;1;27;0;1;7;8;11;8
10383.0;2022;07;DIJON;FEMININ;FORMATION CONTINUE;BAC PROFESSIONNEL;BAC PRO PROD;BAC PRO 22106 CUISINE;3;3;0;3;0;0;0;0;0;0;0;0;0;3
20648.0;2023;22;LIMOGES;MASCULIN;SCOLAIRE;BAC PROFESSIONNEL;BAC PRO PROD;BAC PRO AG 21407 TEC CONS VTE UNIVERS JARDINERIE;1;1;1;0;0;0;0;1;0;0;1;0;0;0
10387.0;2022;07;DIJON;FEMININ;INDIVIDUEL;BAC GENERAL;BAC GENERAL;BAC GENE 10019 BAC GENERAL;45;29;20;5;4;1;3;21;0;1;7;6;7;8
20649.0;2023;22;LIMOGES;MASCULIN;SCOLAIRE;BAC PROFESSIONNEL;BAC PRO SERV;BAC PRO 30004 ASSISTANC.GEST.ORGANIS.ACTIVITES;26;26;15;11;0;0;0;15;0;0;1;3;11;11
10393.0;2022;07;DIJON;FEMININ;INDIVIDUEL;BAC PROFESSIONNEL;BAC PRO SERV;BAC PRO 33004 ACC.SOINS-S.PERS. OPT.EN STRUCTUR;1;1;1;0;0;0;0;1;0;0;0;1;0;0
20654.0;2023;22;LIMOGES;MASCULIN;SCOLAIRE;BAC PROFESSIONNEL;BAC PRO SERV;BAC PRO 31213 MET.COM.VEN.OP.A ANI.GES.ESP.COM.;71;71;56;11;4;2;2;58;0;0;5;29;24;13
10399.0;2022;07;DIJON;FEMININ;SCOLAIRE;BAC PROFESSIONNEL;BAC PRO PROD;BACPRO 20002 ETUD.DEFINITION PRDTS INDUSTRIEL;1;1;1;0;0;0;0;1;0;0;0;0;1;0
20658.0;2023;22;LIMOGES;MASCULIN;SCOLAIRE;BAC PROFESSIONNEL;BAC PRO SERV;BAC PRO 32303 ART.& MET.ART:COM.VIS.VIS.PLURI-M;8;8;7;1;0;0;0;7;0;1;2;2;2;1
10416.0;2022;07;DIJON;FEMININ;SCOLAIRE;BAC PROFESSIONNEL;BAC PRO PROD;BAC PRO 25007 MAINTENANCE EQUIPEMENTS INDUST.;7;7;4;3;0;0;0;4;0;0;0;3;1;3
20671.0;2023;22;LIMOGES;MASCULIN;SCOLAIRE;BAC TECHNOLOGIQUE;BAC STHR;BAC STHR SC.&TEC. HOTELLERIE-RESTAURATION;5;5;4;0;1;1;0;5;0;1;1;1;2;0
10421.0;2022;07;DIJON;FEMININ;SCOLAIRE;BAC PROFESSIONNEL;BAC PRO PROD;BAC PRO 25406 OUVRAGES DU BATIMENT METALLERIE;1;1;1;0;0;0;0;1;0;0;0;1;0;0
20673.0;2023;22;LIMOGES;MASCULIN;SCOLAIRE;BAC TECHNOLOGIQUE;BAC STI2D;BAC STI2D ENERGIES  ET ENVIRONNEMENT;58;58;43;1;14;7;7;50;0;1;5;14;30;8
10425.0;2022;07;DIJON;FEMININ;SCOLAIRE;BAC PROFESSIONNEL;BAC PRO PROD;BAC PRO AG 21113 CGEVV;5;5;4;1;0;0;0;4;0;0;1;2;1;1
20681.0;2023;22;LIMOGES;MASCULIN;SCOLAIRE;BAC TECHNOLOGIQUE;BAC STMG;BAC STMG SYSTEMES D'INFORMATION DE GESTION;17;17;13;0;4;4;0;17;0;0;0;2;15;0
10427.0;2022;07;DIJON;FEMININ;SCOLAIRE;BAC PROFESSIONNEL;BAC PRO PROD;BAC PRO AG 21203 TECHN CONSEIL DE VENTE ANIMAL;9;9;5;4;0;0;0;5;0;0;0;1;4;4
20685.0;2023;10;LYON;FEMININ;APPRENTISSAGE;BAC PROFESSIONNEL;BAC PRO PROD;BAC PRO 22106 CUISINE;11;11;11;0;0;0;0;11;0;3;1;2;5;0
10431.0;2022;07;DIJON;FEMININ;SCOLAIRE;BAC PROFESSIONNEL;BAC PRO PROD;BAC PRO AG 21405 AMENAGEMENTS PAYSAGERS;5;5;4;1;0;0;0;4;0;0;1;2;1;1
20690.0;2023;10;LYON;FEMININ;APPRENTISSAGE;BAC PROFESSIONNEL;BAC PRO PROD;BAC PRO 23405 TECHNICIEN MENUISIER AGENCEUR;2;2;2;0;0;0;0;2;0;1;1;0;0;0
10439.0;2022;07;DIJON;FEMININ;SCOLAIRE;BAC PROFESSIONNEL;BAC PRO SERV;BAC PRO 31214 MET.COM.VEN.OP.B PR.CL.VA.OF.COM.;51;51;46;4;1;1;0;47;0;2;8;25;12;4
20691.0;2023;10;LYON;FEMININ;APPRENTISSAGE;BAC PROFESSIONNEL;BAC PRO PROD;BAC PRO 24203 METIERS DE LA MODE - VÊTEMENT;9;8;8;0;0;0;0;8;0;2;4;1;1;0
10444.0;2022;07;DIJON;FEMININ;SCOLAIRE;BAC PROFESSIONNEL;BAC PRO SERV;BAC PRO 33004 ACC.SOINS-S.PERS. OPT.EN STRUCTUR;255;255;230;15;10;7;3;237;0;13;73;95;56;18
20699.0;2023;10;LYON;FEMININ;APPRENTISSAGE;BAC PROFESSIONNEL;BAC PRO PROD;BAC PRO 25408 REPARATION DES CARROSSERIES;3;2;2;0;0;0;0;2;0;0;0;1;1;0
10449.0;2022;07;DIJON;FEMININ;SCOLAIRE;BAC PROFESSIONNEL;BAC PRO SERV;BAC PRO 33603 ESTHETIQUE COSMETIQUE PARFUMERIE;68;67;63;4;0;0;0;63;0;5;18;21;19;4
20707.0;2023;10;LYON;FEMININ;APPRENTISSAGE;BAC PROFESSIONNEL;BAC PRO PROD;BAC PRO AG 21212 TECH EXPE ANIMALE;6;6;6;0;0;0;0;6;0;0;1;3;2;0
10451.0;2022;07;DIJON;FEMININ;SCOLAIRE;BAC PROFESSIONNEL;BAC PRO SERV;BAC PRO 34305 TECHN.D'INTERV.SUR INSTALL. NUCL.;1;1;0;1;0;0;0;0;0;0;0;0;0;1
20709.0;2023;10;LYON;FEMININ;APPRENTISSAGE;BAC PROFESSIONNEL;BAC PRO PROD;BAC PRO AG 22108 TEC CONS VTE ALIMENTATION (PAB);5;4;4;0;0;0;0;4;0;0;0;0;4;0
10456.0;2022;07;DIJON;FEMININ;SCOLAIRE;BAC TECHNOLOGIQUE;BAC ST2S;BAC ST2S SCIENCES & TECHNO. SANTE & SOCIAL;443;443;379;7;57;33;24;412;2;10;71;160;169;31
20710.0;2023;10;LYON;FEMININ;APPRENTISSAGE;BAC PROFESSIONNEL;BAC PRO SERV;BAC PRO 30004 ASSISTANC.GEST.ORGANIS.ACTIVITES;19;18;16;1;1;0;1;16;0;2;7;3;4;2
10457.0;2022;07;DIJON;FEMININ;SCOLAIRE;BAC TECHNOLOGIQUE;BAC STAV;BAC STAV AGRONOMIE ALIM ENV TERRITOI;97;94;87;7;0;0;0;87;0;2;15;29;41;7
20735.0;2023;10;LYON;FEMININ;INDIVIDUEL;BAC PROFESSIONNEL;BAC PRO PROD;BAC PRO 24303 MET. DU CUIR: SELLERIE GARNISSAGE;1;1;1;0;0;0;0;1;0;0;0;1;0;0
10462.0;2022;07;DIJON;FEMININ;SCOLAIRE;BAC TECHNOLOGIQUE;BAC STI2D;BAC STI2D INNOVATION TECHNO.  ET ECO CONCEPTION;11;11;11;0;0;0;0;11;0;0;1;6;4;0
20741.0;2023;10;LYON;FEMININ;INDIVIDUEL;BAC PROFESSIONNEL;BAC PRO SERV;BAC PRO 31106 LOGISTIQUE;1;0;0;0;0;0;0;0;0;0;0;0;0;0
10463.0;2022;07;DIJON;FEMININ;SCOLAIRE;BAC TECHNOLOGIQUE;BAC STI2D;BAC STI2D SYSTÈME D'INFORMATION  ET NUMERIQUE;8;8;7;0;1;1;0;8;0;1;1;1;5;0
20751.0;2023;10;LYON;FEMININ;INDIVIDUEL;BAC TECHNOLOGIQUE;BAC STD2A;BAC STD2A SCIENCES & TECHNO. DESIGN-ARTS APPLIQUES;19;19;17;0;2;2;0;19;0;0;0;8;11;0
10471.0;2022;07;DIJON;MASCULIN;APPRENTISSAGE;BAC PROFESSIONNEL;BAC PRO PROD;BAC PRO 22106 CUISINE;15;14;11;3;0;0;0;11;0;0;3;1;7;3
20755.0;2023;10;LYON;FEMININ;INDIVIDUEL;BAC TECHNOLOGIQUE;BAC STMG;BAC STMG MERCATIQUE (MARKETING);17;17;5;9;3;2;1;7;0;0;0;1;6;10
10475.0;2022;07;DIJON;MASCULIN;APPRENTISSAGE;BAC PROFESSIONNEL;BAC PRO PROD;BAC PRO 23004 TECHN. ETUDES BAT.A ETUDES & ECO.;2;2;1;1;0;0;0;1;0;0;0;1;0;1
20760.0;2023;10;LYON;FEMININ;SCOLAIRE;BAC PROFESSIONNEL;BAC PRO PROD;BAC PRO 22003 BIO-INDUSTRIES DE TRANSFORMATION;21;21;15;3;3;3;0;18;0;2;0;6;10;3
10478.0;2022;07;DIJON;MASCULIN;APPRENTISSAGE;BAC PROFESSIONNEL;BAC PRO PROD;BAC PRO 23203 TECHNICIEN BAT. : ORG.REAL.GROS O;1;1;0;0;1;1;0;1;0;0;0;0;1;0
20765.0;2023;10;LYON;FEMININ;SCOLAIRE;BAC PROFESSIONNEL;BAC PRO PROD;BAC PRO 22303 FONDERIE;1;1;1;0;0;0;0;1;0;0;0;1;0;0
10481.0;2022;07;DIJON;MASCULIN;APPRENTISSAGE;BAC PROFESSIONNEL;BAC PRO PROD;BAC PRO 23303 MENUISERIE ALUMINIUM-VERRE;6;6;5;0;1;1;0;6;0;0;0;4;2;0
20766.0;2023;10;LYON;FEMININ;SCOLAIRE;BAC PROFESSIONNEL;BAC PRO PROD;BAC PRO 22503 PLASTIQUES ET COMPOSITES;1;1;0;1;0;0;0;0;0;0;0;0;0;1
10484.0;2022;07;DIJON;MASCULIN;APPRENTISSAGE;BAC PROFESSIONNEL;BAC PRO PROD;BAC PRO 23405 TECHNICIEN MENUISIER AGENCEUR;5;5;2;3;0;0;0;2;0;0;0;1;1;3
20768.0;2023;10;LYON;FEMININ;SCOLAIRE;BAC PROFESSIONNEL;BAC PRO PROD;BAC PRO 23004 TECHN. ETUDES BAT.A ETUDES & ECO.;12;12;8;4;0;0;0;8;0;1;4;0;3;4
10500.0;2022;07;DIJON;MASCULIN;APPRENTISSAGE;BAC PROFESSIONNEL;BAC PRO PROD;BAC PRO AG 21001 AGRO-EQUIPEMENT;18;18;17;1;0;0;0;17;0;0;2;4;11;1
20779.0;2023;10;LYON;FEMININ;SCOLAIRE;BAC PROFESSIONNEL;BAC PRO PROD;BAC PRO 24302 METIERS DU CUIR : MAROQUINERIE;10;10;7;1;2;2;0;9;0;2;1;3;3;1
10502.0;2022;07;DIJON;MASCULIN;APPRENTISSAGE;BAC PROFESSIONNEL;BAC PRO PROD;BAC PRO AG 21113 CGEVV;27;20;8;12;0;0;0;8;0;0;2;1;5;12
20801.0;2023;10;LYON;FEMININ;SCOLAIRE;BAC PROFESSIONNEL;BAC PRO PROD;BAC PRO AG 22108 TEC CONS VTE ALIMENTATION (PAB);32;31;24;7;0;0;0;24;0;1;3;13;7;7
10510.0;2022;07;DIJON;MASCULIN;APPRENTISSAGE;BAC PROFESSIONNEL;BAC PRO SERV;BAC PRO 31106 LOGISTIQUE;12;12;8;2;2;0;2;8;0;1;2;1;4;4
20816.0;2023;10;LYON;FEMININ;SCOLAIRE;BAC PROFESSIONNEL;BAC PRO SERV;BAC PRO 33006 ANIMAT. ENFANCE& PERSONNES AGEES;55;55;45;7;3;2;1;47;0;3;12;17;15;8
10517.0;2022;07;DIJON;MASCULIN;APPRENTISSAGE;BAC PROFESSIONNEL;BAC PRO SERV;BAC PRO 34304 HYGIENE PROPRETE STERILISATION;2;2;2;0;0;0;0;2;0;0;0;0;2;0
20825.0;2023;10;LYON;FEMININ;SCOLAIRE;BAC PROFESSIONNEL;BAC PRO SERV;BAC PRO AG 33002 SERV PERS TERRIT;257;256;240;16;0;0;0;240;0;4;22;80;134;16
10529.0;2022;07;DIJON;MASCULIN;INDIVIDUEL;BAC PROFESSIONNEL;BAC PRO PROD;BAC PRO 23405 TECHNICIEN MENUISIER AGENCEUR;1;0;0;0;0;0;0;0;0;0;0;0;0;0
20826.0;2023;10;LYON;FEMININ;SCOLAIRE;BAC TECHNOLOGIQUE;BAC S2TMD;BAC S2TMD DANSE;4;4;4;0;0;0;0;4;0;3;1;0;0;0
10534.0;2022;07;DIJON;MASCULIN;INDIVIDUEL;BAC PROFESSIONNEL;BAC PRO PROD;BAC PRO AG 21004 CGEA;4;2;1;1;0;0;0;1;0;0;0;0;1;1
20829.0;2023;10;LYON;FEMININ;SCOLAIRE;BAC TECHNOLOGIQUE;BAC STAV;BAC STAV AGRONOMIE ALIM ENV TERRITOI;103;103;101;2;0;0;0;101;0;1;15;45;40;2
10537.0;2022;07;DIJON;MASCULIN;INDIVIDUEL;BAC PROFESSIONNEL;BAC PRO PROD;BAC PRO AG 21405 AMENAGEMENTS PAYSAGERS;2;0;0;0;0;0;0;0;0;0;0;0;0;0
20838.0;2023;10;LYON;FEMININ;SCOLAIRE;BAC TECHNOLOGIQUE;BAC STMG;BAC STMG GESTION ET FINANCE;532;532;456;20;56;39;17;495;0;14;78;191;212;37
10538.0;2022;07;DIJON;MASCULIN;INDIVIDUEL;BAC PROFESSIONNEL;BAC PRO SERV;BAC PRO 30001 GESTION-ADMINISTRATION;1;0;0;0;0;0;0;0;0;0;0;0;0;0
20849.0;2023;10;LYON;MASCULIN;APPRENTISSAGE;BAC PROFESSIONNEL;BAC PRO PROD;BAC PRO 22703 TECHN.INSTALL.SYST.ENERG.CLIMATI;58;57;46;8;3;2;1;48;0;2;10;22;14;9
10539.0;2022;07;DIJON;MASCULIN;INDIVIDUEL;BAC PROFESSIONNEL;BAC PRO SERV;BAC PRO 31213 MET.COM.VEN.OP.A ANI.GES.ESP.COM.;3;1;1;0;0;0;0;1;0;0;0;1;0;0
20850.0;2023;10;LYON;MASCULIN;APPRENTISSAGE;BAC PROFESSIONNEL;BAC PRO PROD;BAC PRO 22704 TECHN. MAINT. SYST.ENERG.CLIMATI;23;23;20;2;1;0;1;20;0;1;6;7;6;3
10543.0;2022;07;DIJON;MASCULIN;INDIVIDUEL;BAC PROFESSIONNEL;BAC PRO SERV;BAC PRO 34305 TECHN.D'INTERV.SUR INSTALL. NUCL.;1;1;1;0;0;0;0;1;0;0;0;0;1;0
20855.0;2023;10;LYON;MASCULIN;APPRENTISSAGE;BAC PROFESSIONNEL;BAC PRO PROD;BAC PRO 23205 INTERV. SUR PATRIMOINE BATI OPT.A;7;7;5;2;0;0;0;5;0;1;1;1;2;2
10558.0;2022;07;DIJON;MASCULIN;SCOLAIRE;BAC PROFESSIONNEL;BAC PRO PROD;BAC PRO 22106 CUISINE;69;69;58;6;5;4;1;62;0;5;10;25;22;7
20857.0;2023;10;LYON;MASCULIN;APPRENTISSAGE;BAC PROFESSIONNEL;BAC PRO PROD;BAC PRO 23304 AMENAGEMENT FINITION BATIMENT;13;12;5;6;1;0;1;5;0;1;1;2;1;7
10567.0;2022;07;DIJON;MASCULIN;SCOLAIRE;BAC PROFESSIONNEL;BAC PRO PROD;BAC PRO 23205 INTERV. SUR PATRIMOINE BATI OPT.A;2;2;1;1;0;0;0;1;0;0;0;0;1;1
20861.0;2023;10;LYON;MASCULIN;APPRENTISSAGE;BAC PROFESSIONNEL;BAC PRO PROD;BAC PRO 24203 METIERS DE LA MODE - VÊTEMENT;4;4;4;0;0;0;0;4;0;0;0;2;2;0
10569.0;2022;07;DIJON;MASCULIN;SCOLAIRE;BAC PROFESSIONNEL;BAC PRO PROD;BAC PRO 23304 AMENAGEMENT FINITION BATIMENT;12;12;6;4;2;1;1;7;0;0;0;3;4;5
20862.0;2023;10;LYON;MASCULIN;APPRENTISSAGE;BAC PROFESSIONNEL;BAC PRO PROD;BAC PRO 24302 METIERS DU CUIR : MAROQUINERIE;1;1;1;0;0;0;0;1;0;0;1;0;0;0
10577.0;2022;07;DIJON;MASCULIN;SCOLAIRE;BAC PROFESSIONNEL;BAC PRO PROD;BAC PRO 25106 TECHNICIEN D'USINAGE;49;49;37;9;3;3;0;40;0;1;7;14;18;9
20866.0;2023;10;LYON;MASCULIN;APPRENTISSAGE;BAC PROFESSIONNEL;BAC PRO PROD;BAC PRO 25107 TECHNICIEN OUTILLEUR;7;7;5;2;0;0;0;5;0;0;3;1;1;2
10586.0;2022;07;DIJON;MASCULIN;SCOLAIRE;BAC PROFESSIONNEL;BAC PRO PROD;BAC PRO 25305 AVIATION GENERALE;5;5;4;0;1;1;0;5;0;1;0;1;3;0
20873.0;2023;10;LYON;MASCULIN;APPRENTISSAGE;BAC PROFESSIONNEL;BAC PRO PROD;BAC PRO 25406 OUVRAGES DU BATIMENT METALLERIE;13;12;11;0;1;1;0;12;0;3;5;2;2;0
10593.0;2022;07;DIJON;MASCULIN;SCOLAIRE;BAC PROFESSIONNEL;BAC PRO PROD;BAC PRO 25514 SYST.NUM.OPT.B AUD.RES.EQUIP.DOM.;41;40;34;6;0;0;0;34;0;0;10;15;9;6
20889.0;2023;10;LYON;MASCULIN;APPRENTISSAGE;BAC PROFESSIONNEL;BAC PRO PROD;BAC PRO AG 21303 FORET;12;12;12;0;0;0;0;12;0;0;3;4;5;0
10596.0;2022;07;DIJON;MASCULIN;SCOLAIRE;BAC PROFESSIONNEL;BAC PRO PROD;BAC PRO AG 21004 CGEA;81;76;63;13;0;0;0;63;0;1;10;26;26;13
20890.0;2023;10;LYON;MASCULIN;APPRENTISSAGE;BAC PROFESSIONNEL;BAC PRO PROD;BAC PRO AG 21405 AMENAGEMENTS PAYSAGERS;91;89;81;8;0;0;0;81;0;2;10;29;40;8
10598.0;2022;07;DIJON;MASCULIN;SCOLAIRE;BAC PROFESSIONNEL;BAC PRO PROD;BAC PRO AG 21114 CONDUITE PRODUCTIONS HORTICOLES;12;12;11;1;0;0;0;11;0;2;2;3;4;1
20891.0;2023;10;LYON;MASCULIN;APPRENTISSAGE;BAC PROFESSIONNEL;BAC PRO PROD;BAC PRO AG 22108 TEC CONS VTE ALIMENTATION (PAB);5;5;5;0;0;0;0;5;0;0;0;2;3;0
10602.0;2022;07;DIJON;MASCULIN;SCOLAIRE;BAC PROFESSIONNEL;BAC PRO PROD;BAC PRO AG 21211 COND GEST ENTR HIPPIQUE;4;4;4;0;0;0;0;4;0;0;0;2;2;0
20906.0;2023;10;LYON;MASCULIN;ENSEIGNEMENT A DISTANCE;BAC TECHNOLOGIQUE;BAC STMG;BAC STMG MERCATIQUE (MARKETING);6;6;2;1;3;2;1;4;0;0;0;1;3;2
10617.0;2022;07;DIJON;MASCULIN;SCOLAIRE;BAC PROFESSIONNEL;BAC PRO SERV;BAC PRO 33002 SERVICES DE PROXIMITE  VIE LOCAL;24;24;18;4;2;1;1;19;0;1;0;8;10;5
20918.0;2023;10;LYON;MASCULIN;INDIVIDUEL;BAC PROFESSIONNEL;BAC PRO PROD;BAC PRO 22004 PROC. CHIMIE EAU PAPIERS-CARTONS;1;0;0;0;0;0;0;0;0;0;0;0;0;0
10623.0;2022;07;DIJON;MASCULIN;SCOLAIRE;BAC PROFESSIONNEL;BAC PRO SERV;BAC PRO 33403 COMMERC. SERVICES EN RESTAURATION;40;40;35;5;0;0;0;35;0;3;7;9;16;5
20920.0;2023;10;LYON;MASCULIN;INDIVIDUEL;BAC PROFESSIONNEL;BAC PRO PROD;BAC PRO 22704 TECHN. MAINT. SYST.ENERG.CLIMATI;2;1;1;0;0;0;0;1;0;0;0;0;1;0
10625.0;2022;07;DIJON;MASCULIN;SCOLAIRE;BAC PROFESSIONNEL;BAC PRO SERV;BAC PRO 34305 TECHN.D'INTERV.SUR INSTALL. NUCL.;10;10;9;1;0;0;0;9;0;0;1;2;6;1
20926.0;2023;10;LYON;MASCULIN;INDIVIDUEL;BAC PROFESSIONNEL;BAC PRO PROD;BAC PRO 25215 MAINT.VEHIC.OPTB VEHIC.TRANS.ROUT;1;1;0;1;0;0;0;0;0;0;0;0;0;1
10627.0;2022;07;DIJON;MASCULIN;SCOLAIRE;BAC PROFESSIONNEL;BAC PRO SERV;BAC PRO AG 33002 SERV PERS TERRIT;28;28;25;3;0;0;0;25;0;2;5;9;9;3
20933.0;2023;10;LYON;MASCULIN;INDIVIDUEL;BAC PROFESSIONNEL;BAC PRO PROD;BAC PRO AG 21113 CGEVV;1;0;0;0;0;0;0;0;0;0;0;0;0;0
10630.0;2022;07;DIJON;MASCULIN;SCOLAIRE;BAC TECHNOLOGIQUE;BAC STAV;BAC STAV AGRONOMIE ALIM ENV TERRITOI;112;110;106;4;0;0;0;106;0;1;8;44;53;4
20936.0;2023;10;LYON;MASCULIN;INDIVIDUEL;BAC PROFESSIONNEL;BAC PRO PROD;BAC PRO AG 21405 AMENAGEMENTS PAYSAGERS;2;2;2;0;0;0;0;2;0;0;0;1;1;0
10642.0;2022;07;DIJON;MASCULIN;SCOLAIRE;BAC TECHNOLOGIQUE;BAC STMG;BAC STMG SYSTEMES D'INFORMATION DE GESTION;15;15;13;0;2;2;0;15;0;0;0;4;11;0
20937.0;2023;10;LYON;MASCULIN;INDIVIDUEL;BAC PROFESSIONNEL;BAC PRO SERV;BAC PRO 30004 ASSISTANC.GEST.ORGANIS.ACTIVITES;3;2;1;1;0;0;0;1;0;0;0;0;1;1
10646.0;2022;08;GRENOBLE;FEMININ;APPRENTISSAGE;BAC PROFESSIONNEL;BAC PRO PROD;BAC PRO 22106 CUISINE;6;6;6;0;0;0;0;6;0;2;3;1;0;0
20938.0;2023;10;LYON;MASCULIN;INDIVIDUEL;BAC PROFESSIONNEL;BAC PRO SERV;BAC PRO 31106 LOGISTIQUE;5;4;0;4;0;0;0;0;0;0;0;0;0;4
10673.0;2022;08;GRENOBLE;FEMININ;APPRENTISSAGE;BAC PROFESSIONNEL;BAC PRO SERV;BAC PRO AG 33002 SERV PERS TERRIT;19;19;18;1;0;0;0;18;0;0;4;6;8;1
20939.0;2023;10;LYON;MASCULIN;INDIVIDUEL;BAC PROFESSIONNEL;BAC PRO SERV;BAC PRO 31212 METIERS DE L'ACCUEIL;1;1;1;0;0;0;0;1;0;0;0;1;0;0
10680.0;2022;08;GRENOBLE;FEMININ;ENSEIGNEMENT A DISTANCE;BAC PROFESSIONNEL;BAC PRO SERV;BAC PRO 33004 ACC.SOINS-S.PERS. OPT.EN STRUCTUR;4;3;2;1;0;0;0;2;0;0;0;2;0;1
20947.0;2023;10;LYON;MASCULIN;INDIVIDUEL;BAC TECHNOLOGIQUE;BAC STD2A;BAC STD2A SCIENCES & TECHNO. DESIGN-ARTS APPLIQUES;4;4;3;1;0;0;0;3;0;0;0;2;1;1
10689.0;2022;08;GRENOBLE;FEMININ;FORMATION CONTINUE;BAC PROFESSIONNEL;BAC PRO SERV;BAC PRO 31212 METIERS DE L'ACCUEIL;1;1;1;0;0;0;0;1;0;0;1;0;0;0
20956.0;2023;10;LYON;MASCULIN;SCOLAIRE;BAC GENERAL;BAC GENERAL;BAC GENE 10019 BAC GENERAL;8564;8564;7746;171;647;447;200;8193;131;949;1920;2603;2590;371
10706.0;2022;08;GRENOBLE;FEMININ;INDIVIDUEL;BAC TECHNOLOGIQUE;BAC STI2D;BAC STI2D INNOVATION TECHNO.  ET ECO CONCEPTION;1;0;0;0;0;0;0;0;0;0;0;0;0;0
20957.0;2023;10;LYON;MASCULIN;SCOLAIRE;BAC PROFESSIONNEL;BAC PRO PROD;BACPRO 20002 ETUD.DEFINITION PRDTS INDUSTRIEL;35;35;26;9;0;0;0;26;0;0;5;9;12;9
10722.0;2022;08;GRENOBLE;FEMININ;SCOLAIRE;BAC PROFESSIONNEL;BAC PRO PROD;BACPRO 23103 TECHNICIEN GEOMETRE-TOPOGRAPHE;1;1;1;0;0;0;0;1;0;0;1;0;0;0
20962.0;2023;10;LYON;MASCULIN;SCOLAIRE;BAC PROFESSIONNEL;BAC PRO PROD;BAC PRO 22105 BOULANGER-PÂTISSIER;22;22;21;0;1;1;0;22;0;0;8;8;6;0
10732.0;2022;08;GRENOBLE;FEMININ;SCOLAIRE;BAC PROFESSIONNEL;BAC PRO PROD;BAC PRO 25006 MICROTECHNIQUES;1;1;1;0;0;0;0;1;0;0;0;1;0;0
20968.0;2023;10;LYON;MASCULIN;SCOLAIRE;BAC PROFESSIONNEL;BAC PRO PROD;BAC PRO 23003 ARTIS. & M.ART:MARCHANDISAGE VIS.;8;8;6;2;0;0;0;6;0;0;0;4;2;2
10733.0;2022;08;GRENOBLE;FEMININ;SCOLAIRE;BAC PROFESSIONNEL;BAC PRO PROD;BAC PRO 25007 MAINTENANCE EQUIPEMENTS INDUST.;9;9;7;2;0;0;0;7;0;0;1;4;2;2
20977.0;2023;10;LYON;MASCULIN;SCOLAIRE;BAC PROFESSIONNEL;BAC PRO PROD;BAC PRO 23405 TECHNICIEN MENUISIER AGENCEUR;92;92;79;12;1;1;0;80;0;5;17;30;28;12
10734.0;2022;08;GRENOBLE;FEMININ;SCOLAIRE;BAC PROFESSIONNEL;BAC PRO PROD;BAC PRO 25106 TECHNICIEN D'USINAGE;3;3;3;0;0;0;0;3;0;0;0;1;2;0
20978.0;2023;10;LYON;MASCULIN;SCOLAIRE;BAC PROFESSIONNEL;BAC PRO PROD;BAC PRO 23406 TECHNICIEN DE SCIERIE;12;12;12;0;0;0;0;12;0;0;2;6;4;0
10735.0;2022;08;GRENOBLE;FEMININ;SCOLAIRE;BAC PROFESSIONNEL;BAC PRO PROD;BAC PRO 25214 MAINT.VEHIC.OPTA VOIT.PARTICUL.;9;9;9;0;0;0;0;9;0;0;0;4;5;0
20980.0;2023;10;LYON;MASCULIN;SCOLAIRE;BAC PROFESSIONNEL;BAC PRO PROD;BAC PRO 23408 Etude et réalisation d'agencement;9;9;7;2;0;0;0;7;0;0;0;3;4;2
10740.0;2022;08;GRENOBLE;FEMININ;SCOLAIRE;BAC PROFESSIONNEL;BAC PRO PROD;BAC PRO 25510 METIERS ELECT. ENVIRON. CONNECTES;5;5;4;1;0;0;0;4;0;0;0;2;2;1
20985.0;2023;10;LYON;MASCULIN;SCOLAIRE;BAC PROFESSIONNEL;BAC PRO PROD;BAC PRO 25005 PRODUCTIQ.MECA. OPT.DECOLLETAGE;6;6;5;0;1;1;0;6;0;0;0;2;4;0
10744.0;2022;08;GRENOBLE;FEMININ;SCOLAIRE;BAC PROFESSIONNEL;BAC PRO PROD;BAC PRO AG 21001 AGRO-EQUIPEMENT;1;1;0;1;0;0;0;0;0;0;0;0;0;1
21000.0;2023;10;LYON;MASCULIN;SCOLAIRE;BAC PROFESSIONNEL;BAC PRO PROD;BAC PRO 25509 TECHNIC. FROID CONDITIONNEMT AIR;36;36;19;14;3;1;2;20;0;1;2;9;8;16
10748.0;2022;08;GRENOBLE;FEMININ;SCOLAIRE;BAC PROFESSIONNEL;BAC PRO PROD;BAC PRO AG 21204 PROD-AQUACOLES;2;2;2;0;0;0;0;2;0;0;1;0;1;0
21002.0;2023;10;LYON;MASCULIN;SCOLAIRE;BAC PROFESSIONNEL;BAC PRO PROD;BAC PRO 25513 SYST.NUM.OPT.A SURETE SECURITE;22;22;19;1;2;1;1;20;0;1;3;10;6;2
10757.0;2022;08;GRENOBLE;FEMININ;SCOLAIRE;BAC PROFESSIONNEL;BAC PRO SERV;BAC PRO 30001 GESTION-ADMINISTRATION;649;648;520;110;18;10;8;530;0;11;93;201;225;118
21006.0;2023;10;LYON;MASCULIN;SCOLAIRE;BAC PROFESSIONNEL;BAC PRO PROD;BAC PRO AG 21004 CGEA;62;61;53;8;0;0;0;53;0;1;10;22;20;8
10764.0;2022;08;GRENOBLE;FEMININ;SCOLAIRE;BAC PROFESSIONNEL;BAC PRO SERV;BAC PRO 31214 MET.COM.VEN.OP.B PR.CL.VA.OF.COM.;193;193;178;12;3;2;1;180;0;6;41;73;60;13
21025.0;2023;10;LYON;MASCULIN;SCOLAIRE;BAC PROFESSIONNEL;BAC PRO SERV;BAC PRO 31214 MET.COM.VEN.OP.B PR.CL.VA.OF.COM.;230;229;208;15;6;4;2;212;0;8;43;94;67;17
10768.0;2022;08;GRENOBLE;FEMININ;SCOLAIRE;BAC PROFESSIONNEL;BAC PRO SERV;BAC PRO 33002 SERVICES DE PROXIMITE  VIE LOCAL;45;45;41;2;2;1;1;42;0;1;8;20;13;3
21027.0;2023;10;LYON;MASCULIN;SCOLAIRE;BAC PROFESSIONNEL;BAC PRO SERV;BAC PRO 32208 REAL.PR.IMPR.PLURI.OPTB.PR.IMPR.;17;17;11;3;3;3;0;14;0;0;4;5;5;3
10772.0;2022;08;GRENOBLE;FEMININ;SCOLAIRE;BAC PROFESSIONNEL;BAC PRO SERV;BAC PRO 33403 COMMERC. SERVICES EN RESTAURATION;80;80;62;13;5;2;3;64;0;2;23;17;22;16
21033.0;2023;10;LYON;MASCULIN;SCOLAIRE;BAC PROFESSIONNEL;BAC PRO SERV;BAC PRO 33101 OPTIQUE LUNETTERIE;10;10;7;2;1;1;0;8;0;0;1;2;5;2
10785.0;2022;08;GRENOBLE;FEMININ;SCOLAIRE;BAC TECHNOLOGIQUE;BAC STI2D;BAC STI2D ENERGIES  ET ENVIRONNEMENT;19;19;18;1;0;0;0;18;0;3;6;4;5;1
21036.0;2023;10;LYON;MASCULIN;SCOLAIRE;BAC PROFESSIONNEL;BAC PRO SERV;BAC PRO 33602 PERRUQUIER POSTICHEUR;1;1;1;0;0;0;0;1;0;0;0;0;1;0
10786.0;2022;08;GRENOBLE;FEMININ;SCOLAIRE;BAC TECHNOLOGIQUE;BAC STI2D;BAC STI2D INNOVATION TECHNO.  ET ECO CONCEPTION;29;29;24;0;5;3;2;27;0;1;9;6;11;2
21037.0;2023;10;LYON;MASCULIN;SCOLAIRE;BAC PROFESSIONNEL;BAC PRO SERV;BAC PRO 33603 ESTHETIQUE COSMETIQUE PARFUMERIE;1;1;1;0;0;0;0;1;0;0;1;0;0;0
10795.0;2022;08;GRENOBLE;MASCULIN;APPRENTISSAGE;BAC PROFESSIONNEL;BAC PRO PROD;BAC PRO 20102 PILOTE DE LIGNE DE PRODUCTION;11;10;10;0;0;0;0;10;0;2;4;3;1;0
21043.0;2023;10;LYON;MASCULIN;SCOLAIRE;BAC TECHNOLOGIQUE;BAC STAV;BAC STAV AGRONOMIE ALIM ENV TERRITOI;93;92;89;3;0;0;0;89;0;2;15;34;38;3
10801.0;2022;08;GRENOBLE;MASCULIN;APPRENTISSAGE;BAC PROFESSIONNEL;BAC PRO PROD;BAC PRO 22704 TECHN. MAINT. SYST.ENERG.CLIMATI;13;13;11;0;2;2;0;13;0;3;2;5;3;0
21045.0;2023;10;LYON;MASCULIN;SCOLAIRE;BAC TECHNOLOGIQUE;BAC STHR;BAC STHR SC.&TEC. HOTELLERIE-RESTAURATION;47;47;44;1;2;0;2;44;0;1;7;26;10;3
10811.0;2022;08;GRENOBLE;MASCULIN;APPRENTISSAGE;BAC PROFESSIONNEL;BAC PRO PROD;BAC PRO 25006 MICROTECHNIQUES;4;4;4;0;0;0;0;4;0;1;2;1;0;0
21047.0;2023;10;LYON;MASCULIN;SCOLAIRE;BAC TECHNOLOGIQUE;BAC STI2D;BAC STI2D ENERGIES  ET ENVIRONNEMENT;284;284;220;15;49;27;22;247;0;3;36;75;133;37
10815.0;2022;08;GRENOBLE;MASCULIN;APPRENTISSAGE;BAC PROFESSIONNEL;BAC PRO PROD;BAC PRO 25107 TECHNICIEN OUTILLEUR;1;1;1;0;0;0;0;1;0;0;0;0;1;0
21055.0;2023;10;LYON;MASCULIN;SCOLAIRE;BAC TECHNOLOGIQUE;BAC STMG;BAC STMG SYSTEMES D'INFORMATION DE GESTION;57;57;35;8;14;11;3;46;0;0;0;8;38;11
10819.0;2022;08;GRENOBLE;MASCULIN;APPRENTISSAGE;BAC PROFESSIONNEL;BAC PRO PROD;BAC PRO 25219 MAINT.MATERIELS OPT.A AGRICOLES;16;16;15;1;0;0;0;15;0;1;3;6;5;1
21059.0;2023;31;MARTINIQUE;FEMININ;APPRENTISSAGE;BAC PROFESSIONNEL;BAC PRO PROD;BAC PRO 25510 METIERS ELECT. ENVIRON. CONNECTES;1;1;1;0;0;0;0;1;0;0;1;0;0;0
10828.0;2022;08;GRENOBLE;MASCULIN;APPRENTISSAGE;BAC PROFESSIONNEL;BAC PRO PROD;BAC PRO 25515 SYST.NUM.OPT.C RES.INF.SYST.COMM.;8;8;6;2;0;0;0;6;0;2;2;0;2;2
21062.0;2023;31;MARTINIQUE;FEMININ;APPRENTISSAGE;BAC PROFESSIONNEL;BAC PRO SERV;BAC PRO 33004 ACC.SOINS-S.PERS. OPT.EN STRUCTUR;6;3;0;3;0;0;0;0;0;0;0;0;0;3
10831.0;2022;08;GRENOBLE;MASCULIN;APPRENTISSAGE;BAC PROFESSIONNEL;BAC PRO PROD;BAC PRO AG 21210 COND GEST ENTR CANIN ET FELIN;1;1;1;0;0;0;0;1;0;0;0;0;1;0
21066.0;2023;31;MARTINIQUE;FEMININ;INDIVIDUEL;BAC GENERAL;BAC GENERAL;BAC GENE 10019 BAC GENERAL;4;4;3;1;0;0;0;3;1;0;0;1;1;1
10835.0;2022;08;GRENOBLE;MASCULIN;APPRENTISSAGE;BAC PROFESSIONNEL;BAC PRO PROD;BAC PRO AG 22107 TEC CONS VTE ALIMENTATION P.ALIM;7;7;6;1;0;0;0;6;0;1;0;1;4;1
21069.0;2023;31;MARTINIQUE;FEMININ;INDIVIDUEL;BAC PROFESSIONNEL;BAC PRO SERV;BAC PRO 31212 METIERS DE L'ACCUEIL;1;0;0;0;0;0;0;0;0;0;0;0;0;0
10840.0;2022;08;GRENOBLE;MASCULIN;APPRENTISSAGE;BAC PROFESSIONNEL;BAC PRO SERV;BAC PRO 31212 METIERS DE L'ACCUEIL;11;10;10;0;0;0;0;10;0;1;2;4;3;0
21075.0;2023;31;MARTINIQUE;FEMININ;INDIVIDUEL;BAC TECHNOLOGIQUE;BAC STI2D;BAC STI2D ARCHITECTURE ET CONSTRUCTION;1;1;1;0;0;0;0;1;0;0;0;0;1;0
10841.0;2022;08;GRENOBLE;MASCULIN;APPRENTISSAGE;BAC PROFESSIONNEL;BAC PRO SERV;BAC PRO 31213 MET.COM.VEN.OP.A ANI.GES.ESP.COM.;150;147;120;16;11;3;8;123;0;4;22;51;46;24
21080.0;2023;31;MARTINIQUE;FEMININ;SCOLAIRE;BAC PROFESSIONNEL;BAC PRO PROD;BAC PRO 22106 CUISINE;21;21;20;0;1;0;1;20;0;2;4;9;5;1
10845.0;2022;08;GRENOBLE;MASCULIN;APPRENTISSAGE;BAC PROFESSIONNEL;BAC PRO SERV;BAC PRO 34403 METIERS DE LA SECURITE;3;3;3;0;0;0;0;3;0;0;0;2;1;0
21093.0;2023;31;MARTINIQUE;FEMININ;SCOLAIRE;BAC PROFESSIONNEL;BAC PRO PROD;BAC PRO AG 21004 CGEA;5;5;5;0;0;0;0;5;0;0;1;3;1;0
10851.0;2022;08;GRENOBLE;MASCULIN;ENSEIGNEMENT A DISTANCE;BAC TECHNOLOGIQUE;BAC ST2S;BAC ST2S SCIENCES & TECHNO. SANTE & SOCIAL;1;1;1;0;0;0;0;1;0;0;0;0;1;0
21094.0;2023;31;MARTINIQUE;FEMININ;SCOLAIRE;BAC PROFESSIONNEL;BAC PRO PROD;BAC PRO AG 21114 CONDUITE PRODUCTIONS HORTICOLES;4;4;4;0;0;0;0;4;0;0;1;1;2;0
10856.0;2022;08;GRENOBLE;MASCULIN;FORMATION CONTINUE;BAC PROFESSIONNEL;BAC PRO PROD;BAC PRO 22703 TECHN.INSTALL.SYST.ENERG.CLIMATI;5;5;5;0;0;0;0;5;0;3;2;0;0;0
21100.0;2023;31;MARTINIQUE;FEMININ;SCOLAIRE;BAC PROFESSIONNEL;BAC PRO SERV;BAC PRO 31213 MET.COM.VEN.OP.A ANI.GES.ESP.COM.;56;56;40;9;7;6;1;46;0;0;7;13;26;10
10857.0;2022;08;GRENOBLE;MASCULIN;FORMATION CONTINUE;BAC PROFESSIONNEL;BAC PRO PROD;BAC PRO 22704 TECHN. MAINT. SYST.ENERG.CLIMATI;1;1;1;0;0;0;0;1;0;1;0;0;0;0
21101.0;2023;31;MARTINIQUE;FEMININ;SCOLAIRE;BAC PROFESSIONNEL;BAC PRO SERV;BAC PRO 31214 MET.COM.VEN.OP.B PR.CL.VA.OF.COM.;36;36;27;8;1;1;0;28;0;4;6;9;9;8
10858.0;2022;08;GRENOBLE;MASCULIN;FORMATION CONTINUE;BAC PROFESSIONNEL;BAC PRO PROD;BAC PRO 25007 MAINTENANCE EQUIPEMENTS INDUST.;1;1;1;0;0;0;0;1;0;0;0;1;0;0
21104.0;2023;31;MARTINIQUE;FEMININ;SCOLAIRE;BAC PROFESSIONNEL;BAC PRO SERV;BAC PRO 33003 ACC.SOINS-S.PERS. OPT.A DOMICILE;56;56;45;6;5;5;0;50;0;1;7;18;24;6
10860.0;2022;08;GRENOBLE;MASCULIN;INDIVIDUEL;BAC PROFESSIONNEL;BAC PRO PROD;BACPRO 20002 ETUD.DEFINITION PRDTS INDUSTRIEL;1;0;0;0;0;0;0;0;0;0;0;0;0;0
21106.0;2023;31;MARTINIQUE;FEMININ;SCOLAIRE;BAC PROFESSIONNEL;BAC PRO SERV;BAC PRO 33006 ANIMAT. ENFANCE& PERSONNES AGEES;15;15;10;4;1;1;0;11;0;1;3;1;6;4
10863.0;2022;08;GRENOBLE;MASCULIN;INDIVIDUEL;BAC PROFESSIONNEL;BAC PRO PROD;BAC PRO 23203 TECHNICIEN BAT. : ORG.REAL.GROS O;1;1;0;1;0;0;0;0;0;0;0;0;0;1
21109.0;2023;31;MARTINIQUE;FEMININ;SCOLAIRE;BAC PROFESSIONNEL;BAC PRO SERV;BAC PRO 33604 METIERS DE LA COIFFURE;10;10;4;6;0;0;0;4;0;0;0;1;3;6
10866.0;2022;08;GRENOBLE;MASCULIN;INDIVIDUEL;BAC PROFESSIONNEL;BAC PRO PROD;BAC PRO 25106 TECHNICIEN D'USINAGE;3;2;0;2;0;0;0;0;0;0;0;0;0;2
21114.0;2023;31;MARTINIQUE;FEMININ;SCOLAIRE;BAC TECHNOLOGIQUE;BAC ST2S;BAC ST2S SCIENCES & TECHNO. SANTE & SOCIAL;181;181;162;3;16;11;5;173;0;3;14;61;95;8
10868.0;2022;08;GRENOBLE;MASCULIN;INDIVIDUEL;BAC PROFESSIONNEL;BAC PRO PROD;BAC PRO 25215 MAINT.VEHIC.OPTB VEHIC.TRANS.ROUT;1;1;1;0;0;0;0;1;0;0;0;0;1;0
21121.0;2023;31;MARTINIQUE;FEMININ;SCOLAIRE;BAC TECHNOLOGIQUE;BAC STL;BAC STL BIOCHIM.-BIOLOGIE-BIOTECHNOL.;26;26;20;1;5;4;1;24;0;2;0;12;10;2
10880.0;2022;08;GRENOBLE;MASCULIN;INDIVIDUEL;BAC PROFESSIONNEL;BAC PRO SERV;BAC PRO 33403 COMMERC. SERVICES EN RESTAURATION;1;0;0;0;0;0;0;0;0;0;0;0;0;0
21124.0;2023;31;MARTINIQUE;FEMININ;SCOLAIRE;BAC TECHNOLOGIQUE;BAC STMG;BAC STMG RESSOURCES HUMAINES ET COMMUNICATION;85;85;70;5;10;10;0;80;0;3;8;26;43;5
10881.0;2022;08;GRENOBLE;MASCULIN;INDIVIDUEL;BAC PROFESSIONNEL;BAC PRO SERV;BAC PRO 34403 METIERS DE LA SECURITE;1;0;0;0;0;0;0;0;0;0;0;0;0;0
21131.0;2023;31;MARTINIQUE;MASCULIN;APPRENTISSAGE;BAC PROFESSIONNEL;BAC PRO PROD;BAC PRO 23304 AMENAGEMENT FINITION BATIMENT;1;1;1;0;0;0;0;1;0;0;0;0;1;0
10890.0;2022;08;GRENOBLE;MASCULIN;INDIVIDUEL;BAC TECHNOLOGIQUE;BAC STMG;BAC STMG RESSOURCES HUMAINES ET COMMUNICATION;6;2;1;1;0;0;0;1;0;0;0;0;1;1
21138.0;2023;31;MARTINIQUE;MASCULIN;APPRENTISSAGE;BAC PROFESSIONNEL;BAC PRO SERV;BAC PRO 31213 MET.COM.VEN.OP.A ANI.GES.ESP.COM.;5;4;2;1;1;0;1;2;0;0;0;0;2;2
10891.0;2022;08;GRENOBLE;MASCULIN;INDIVIDUEL;BAC TECHNOLOGIQUE;BAC STMG;BAC STMG SYSTEMES D'INFORMATION DE GESTION;1;1;1;0;0;0;0;1;0;0;0;0;1;0
21145.0;2023;31;MARTINIQUE;MASCULIN;INDIVIDUEL;BAC PROFESSIONNEL;BAC PRO PROD;BAC PRO 23405 TECHNICIEN MENUISIER AGENCEUR;1;1;0;1;0;0;0;0;0;0;0;0;0;1
10900.0;2022;08;GRENOBLE;MASCULIN;SCOLAIRE;BAC PROFESSIONNEL;BAC PRO PROD;BAC PRO 22703 TECHN.INSTALL.SYST.ENERG.CLIMATI;90;90;53;32;5;4;1;57;0;3;9;17;28;33
21146.0;2023;31;MARTINIQUE;MASCULIN;INDIVIDUEL;BAC PROFESSIONNEL;BAC PRO PROD;BAC PRO 25408 REPARATION DES CARROSSERIES;1;1;0;0;1;1;0;1;0;0;0;0;1;0
10902.0;2022;08;GRENOBLE;MASCULIN;SCOLAIRE;BAC PROFESSIONNEL;BAC PRO PROD;BAC PRO 23003 ARTIS. & M.ART:MARCHANDISAGE VIS.;2;2;2;0;0;0;0;2;0;0;0;1;1;0
21149.0;2023;31;MARTINIQUE;MASCULIN;INDIVIDUEL;BAC PROFESSIONNEL;BAC PRO SERV;BAC PRO 30004 ASSISTANC.GEST.ORGANIS.ACTIVITES;1;1;0;1;0;0;0;0;0;0;0;0;0;1
10907.0;2022;08;GRENOBLE;MASCULIN;SCOLAIRE;BAC PROFESSIONNEL;BAC PRO PROD;BAC PRO 23303 MENUISERIE ALUMINIUM-VERRE;11;11;6;5;0;0;0;6;0;0;0;0;6;5
21161.0;2023;31;MARTINIQUE;MASCULIN;SCOLAIRE;BAC PROFESSIONNEL;BAC PRO PROD;BAC PRO 23102 TRAVAUX PUBLICS;4;4;1;1;2;2;0;3;0;0;0;0;3;1
10909.0;2022;08;GRENOBLE;MASCULIN;SCOLAIRE;BAC PROFESSIONNEL;BAC PRO PROD;BAC PRO 23404 TECHNICIEN CONSTRUCTEUR BOIS;47;46;39;7;0;0;0;39;0;2;6;18;13;7
21176.0;2023;31;MARTINIQUE;MASCULIN;SCOLAIRE;BAC PROFESSIONNEL;BAC PRO PROD;BAC PRO 25406 OUVRAGES DU BATIMENT METALLERIE;14;14;8;6;0;0;0;8;0;0;1;0;7;6
10913.0;2022;08;GRENOBLE;MASCULIN;SCOLAIRE;BAC PROFESSIONNEL;BAC PRO PROD;BAC PRO 24203 METIERS DE LA MODE - VÊTEMENT;11;11;9;1;1;1;0;10;0;0;2;3;5;1
21181.0;2023;31;MARTINIQUE;MASCULIN;SCOLAIRE;BAC PROFESSIONNEL;BAC PRO PROD;BAC PRO 25513 SYST.NUM.OPT.A SURETE SECURITE;11;11;5;5;1;1;0;6;0;0;0;1;5;5
10918.0;2022;08;GRENOBLE;MASCULIN;SCOLAIRE;BAC PROFESSIONNEL;BAC PRO PROD;BAC PRO 25007 MAINTENANCE EQUIPEMENTS INDUST.;384;384;268;112;4;3;1;271;0;8;45;98;120;113
21182.0;2023;31;MARTINIQUE;MASCULIN;SCOLAIRE;BAC PROFESSIONNEL;BAC PRO PROD;BAC PRO 25514 SYST.NUM.OPT.B AUD.RES.EQUIP.DOM.;27;26;21;3;2;2;0;23;0;2;6;9;6;3
10920.0;2022;08;GRENOBLE;MASCULIN;SCOLAIRE;BAC PROFESSIONNEL;BAC PRO PROD;BAC PRO 25107 TECHNICIEN OUTILLEUR;9;9;3;5;1;1;0;4;0;0;0;2;2;5
21190.0;2023;31;MARTINIQUE;MASCULIN;SCOLAIRE;BAC PROFESSIONNEL;BAC PRO SERV;BAC PRO 31106 LOGISTIQUE;23;23;18;2;3;2;1;20;0;0;1;4;15;3
10927.0;2022;08;GRENOBLE;MASCULIN;SCOLAIRE;BAC PROFESSIONNEL;BAC PRO PROD;BAC PRO 25411 TECH.CHAUDRONNERIE INDUSTRIELLE;54;54;44;7;3;2;1;46;0;1;10;21;14;8
21191.0;2023;31;MARTINIQUE;MASCULIN;SCOLAIRE;BAC PROFESSIONNEL;BAC PRO SERV;BAC PRO 31114 ORGANIS. TRANSPORT MARCHANDISES;24;23;19;2;2;2;0;21;0;0;1;3;17;2
10928.0;2022;08;GRENOBLE;MASCULIN;SCOLAIRE;BAC PROFESSIONNEL;BAC PRO PROD;BAC PRO 25509 TECHNIC. FROID CONDITIONNEMT AIR;35;35;24;10;1;1;0;25;0;0;5;9;11;10
21195.0;2023;31;MARTINIQUE;MASCULIN;SCOLAIRE;BAC PROFESSIONNEL;BAC PRO SERV;BAC PRO 32303 ART.& MET.ART:COM.VIS.VIS.PLURI-M;10;10;9;1;0;0;0;9;0;0;2;4;3;1
10929.0;2022;08;GRENOBLE;MASCULIN;SCOLAIRE;BAC PROFESSIONNEL;BAC PRO PROD;BAC PRO 25510 METIERS ELECT. ENVIRON. CONNECTES;559;559;400;128;31;21;10;421;0;29;78;136;178;138
21196.0;2023;31;MARTINIQUE;MASCULIN;SCOLAIRE;BAC PROFESSIONNEL;BAC PRO SERV;BAC PRO 33003 ACC.SOINS-S.PERS. OPT.A DOMICILE;4;4;4;0;0;0;0;4;0;0;1;1;2;0
10936.0;2022;08;GRENOBLE;MASCULIN;SCOLAIRE;BAC PROFESSIONNEL;BAC PRO PROD;BAC PRO AG 21203 TECHN CONSEIL DE VENTE ANIMAL;9;9;5;4;0;0;0;5;0;0;0;1;4;4
21203.0;2023;31;MARTINIQUE;MASCULIN;SCOLAIRE;BAC PROFESSIONNEL;BAC PRO SERV;BAC PRO 34403 METIERS DE LA SECURITE;10;10;6;2;2;2;0;8;0;0;1;4;3;2
10941.0;2022;08;GRENOBLE;MASCULIN;SCOLAIRE;BAC PROFESSIONNEL;BAC PRO PROD;BAC PRO AG 21303 FORET;35;35;33;2;0;0;0;33;0;0;3;13;17;2
21214.0;2023;31;MARTINIQUE;MASCULIN;SCOLAIRE;BAC TECHNOLOGIQUE;BAC STMG;BAC STMG GESTION ET FINANCE;57;57;46;2;9;9;0;55;0;0;8;20;27;2
10956.0;2022;08;GRENOBLE;MASCULIN;SCOLAIRE;BAC PROFESSIONNEL;BAC PRO SERV;BAC PRO 32303 ART.& MET.ART:COM.VIS.VIS.PLURI-M;33;33;31;2;0;0;0;31;0;3;8;14;6;2
21221.0;2023;43;MAYOTTE;FEMININ;APPRENTISSAGE;BAC PROFESSIONNEL;BAC PRO SERV;BAC PRO 31213 MET.COM.VEN.OP.A ANI.GES.ESP.COM.;12;12;9;2;1;1;0;10;0;1;2;3;4;2
10962.0;2022;08;GRENOBLE;MASCULIN;SCOLAIRE;BAC PROFESSIONNEL;BAC PRO SERV;BAC PRO 33603 ESTHETIQUE COSMETIQUE PARFUMERIE;1;1;1;0;0;0;0;1;0;0;0;1;0;0
21223.0;2023;43;MAYOTTE;FEMININ;ENSEIGNEMENT A DISTANCE;BAC PROFESSIONNEL;BAC PRO SERV;BAC PRO 30004 ASSISTANC.GEST.ORGANIS.ACTIVITES;1;1;0;0;1;1;0;1;0;0;0;0;1;0
10963.0;2022;08;GRENOBLE;MASCULIN;SCOLAIRE;BAC PROFESSIONNEL;BAC PRO SERV;BAC PRO 34304 HYGIENE PROPRETE STERILISATION;2;2;2;0;0;0;0;2;0;0;0;2;0;0
21235.0;2023;43;MAYOTTE;FEMININ;INDIVIDUEL;BAC TECHNOLOGIQUE;BAC STI2D;BAC STI2D ARCHITECTURE ET CONSTRUCTION;1;1;0;1;0;0;0;0;0;0;0;0;0;1
10969.0;2022;08;GRENOBLE;MASCULIN;SCOLAIRE;BAC TECHNOLOGIQUE;BAC ST2S;BAC ST2S SCIENCES & TECHNO. SANTE & SOCIAL;102;102;89;5;8;5;3;94;0;4;10;36;44;8
21246.0;2023;43;MAYOTTE;FEMININ;SCOLAIRE;BAC PROFESSIONNEL;BAC PRO PROD;BAC PRO 23102 TRAVAUX PUBLICS;3;3;1;0;2;2;0;3;0;0;0;1;2;0
10970.0;2022;08;GRENOBLE;MASCULIN;SCOLAIRE;BAC TECHNOLOGIQUE;BAC STAV;BAC STAV AGRONOMIE ALIM ENV TERRITOI;170;170;166;4;0;0;0;166;0;7;33;65;61;4
21251.0;2023;43;MAYOTTE;FEMININ;SCOLAIRE;BAC PROFESSIONNEL;BAC PRO PROD;BAC PRO 24203 METIERS DE LA MODE - VÊTEMENT;15;15;8;5;2;2;0;10;0;0;2;4;4;5
10979.0;2022;08;GRENOBLE;MASCULIN;SCOLAIRE;BAC TECHNOLOGIQUE;BAC STMG;BAC STMG GESTION ET FINANCE;479;479;390;20;69;49;20;439;0;3;50;150;236;40
21255.0;2023;43;MAYOTTE;FEMININ;SCOLAIRE;BAC PROFESSIONNEL;BAC PRO PROD;BAC PRO 25510 METIERS ELECT. ENVIRON. CONNECTES;2;2;1;0;1;1;0;2;0;0;0;0;2;0
10982.0;2022;08;GRENOBLE;MASCULIN;SCOLAIRE;BAC TECHNOLOGIQUE;BAC STMG;BAC STMG SYSTEMES D'INFORMATION DE GESTION;37;37;20;9;8;6;2;26;0;0;1;6;19;11
21260.0;2023;43;MAYOTTE;FEMININ;SCOLAIRE;BAC PROFESSIONNEL;BAC PRO PROD;BAC PRO AG 21114 CONDUITE PRODUCTIONS HORTICOLES;2;2;1;1;0;0;0;1;0;0;0;0;1;1
10984.0;2022;32;GUADELOUPE;FEMININ;APPRENTISSAGE;BAC PROFESSIONNEL;BAC PRO SERV;BAC PRO 31213 MET.COM.VEN.OP.A ANI.GES.ESP.COM.;9;6;5;1;0;0;0;5;0;1;2;1;1;1
21261.0;2023;43;MAYOTTE;FEMININ;SCOLAIRE;BAC PROFESSIONNEL;BAC PRO SERV;BAC PRO 30004 ASSISTANC.GEST.ORGANIS.ACTIVITES;70;70;42;12;16;11;5;53;0;1;7;19;26;17
10992.0;2022;32;GUADELOUPE;FEMININ;FORMATION CONTINUE;BAC PROFESSIONNEL;BAC PRO SERV;BAC PRO 31106 LOGISTIQUE;2;2;1;0;1;1;0;2;0;0;0;1;1;0
21262.0;2023;43;MAYOTTE;FEMININ;SCOLAIRE;BAC PROFESSIONNEL;BAC PRO SERV;BAC PRO 31106 LOGISTIQUE;12;12;4;2;6;5;1;9;0;0;0;1;8;3
10993.0;2022;32;GUADELOUPE;FEMININ;FORMATION CONTINUE;BAC PROFESSIONNEL;BAC PRO SERV;BAC PRO 31212 METIERS DE L'ACCUEIL;3;2;2;0;0;0;0;2;0;2;0;0;0;0
21264.0;2023;43;MAYOTTE;FEMININ;SCOLAIRE;BAC PROFESSIONNEL;BAC PRO SERV;BAC PRO 31212 METIERS DE L'ACCUEIL;107;104;63;29;12;6;6;69;0;3;7;27;32;35
10994.0;2022;32;GUADELOUPE;FEMININ;FORMATION CONTINUE;BAC PROFESSIONNEL;BAC PRO SERV;BAC PRO 31213 MET.COM.VEN.OP.A ANI.GES.ESP.COM.;4;3;1;2;0;0;0;1;0;0;0;0;1;2
21271.0;2023;43;MAYOTTE;FEMININ;SCOLAIRE;BAC PROFESSIONNEL;BAC PRO SERV;BAC PRO 33403 COMMERC. SERVICES EN RESTAURATION;17;17;8;7;2;2;0;10;0;0;1;3;6;7
10998.0;2022;32;GUADELOUPE;FEMININ;INDIVIDUEL;BAC PROFESSIONNEL;BAC PRO PROD;BAC PRO AG 21004 CGEA;1;0;0;0;0;0;0;0;0;0;0;0;0;0
21272.0;2023;43;MAYOTTE;FEMININ;SCOLAIRE;BAC PROFESSIONNEL;BAC PRO SERV;BAC PRO 34403 METIERS DE LA SECURITE;14;14;14;0;0;0;0;14;0;0;6;4;4;0
11004.0;2022;32;GUADELOUPE;FEMININ;INDIVIDUEL;BAC PROFESSIONNEL;BAC PRO SERV;BAC PRO 33002 SERVICES DE PROXIMITE  VIE LOCAL;2;0;0;0;0;0;0;0;0;0;0;0;0;0
21273.0;2023;43;MAYOTTE;FEMININ;SCOLAIRE;BAC PROFESSIONNEL;BAC PRO SERV;BAC PRO AG 33002 SERV PERS TERRIT;21;20;14;6;0;0;0;14;0;0;0;2;12;6
11007.0;2022;32;GUADELOUPE;FEMININ;INDIVIDUEL;BAC TECHNOLOGIQUE;BAC STMG;BAC STMG MERCATIQUE (MARKETING);8;8;8;0;0;0;0;8;0;2;5;1;0;0
21275.0;2023;43;MAYOTTE;FEMININ;SCOLAIRE;BAC TECHNOLOGIQUE;BAC STAV;BAC STAV AGRONOMIE ALIM ENV TERRITOI;9;8;2;6;0;0;0;2;0;0;0;0;2;6
11012.0;2022;32;GUADELOUPE;FEMININ;SCOLAIRE;BAC PROFESSIONNEL;BAC PRO PROD;BAC PRO 22704 TECHN. MAINT. SYST.ENERG.CLIMATI;2;2;2;0;0;0;0;2;0;0;0;1;1;0
21279.0;2023;43;MAYOTTE;FEMININ;SCOLAIRE;BAC TECHNOLOGIQUE;BAC STI2D;BAC STI2D ENERGIES  ET ENVIRONNEMENT;41;41;9;10;22;22;0;31;0;0;0;1;30;10
11019.0;2022;32;GUADELOUPE;FEMININ;SCOLAIRE;BAC PROFESSIONNEL;BAC PRO PROD;BAC PRO 24203 METIERS DE LA MODE - VÊTEMENT;23;23;20;3;0;0;0;20;0;0;9;3;8;3
21281.0;2023;43;MAYOTTE;FEMININ;SCOLAIRE;BAC TECHNOLOGIQUE;BAC STI2D;BAC STI2D SYSTÈME D'INFORMATION  ET NUMERIQUE;25;25;10;5;10;10;0;20;0;0;0;1;19;5
11022.0;2022;32;GUADELOUPE;FEMININ;SCOLAIRE;BAC PROFESSIONNEL;BAC PRO PROD;BAC PRO 25214 MAINT.VEHIC.OPTA VOIT.PARTICUL.;1;1;1;0;0;0;0;1;0;0;0;1;0;0
21284.0;2023;43;MAYOTTE;FEMININ;SCOLAIRE;BAC TECHNOLOGIQUE;BAC STMG;BAC STMG MERCATIQUE (MARKETING);228;228;87;52;89;78;11;165;0;0;4;15;146;63
11024.0;2022;32;GUADELOUPE;FEMININ;SCOLAIRE;BAC PROFESSIONNEL;BAC PRO PROD;BAC PRO 25220 MAINT.MATERIELS OPT.B TP MANUT.;1;1;0;1;0;0;0;0;0;0;0;0;0;1
21286.0;2023;43;MAYOTTE;MASCULIN;APPRENTISSAGE;BAC PROFESSIONNEL;BAC PRO PROD;BAC PRO 23203 TECHNICIEN BAT. : ORG.REAL.GROS O;8;8;6;1;1;0;1;6;0;0;1;2;3;2
11025.0;2022;32;GUADELOUPE;FEMININ;SCOLAIRE;BAC PROFESSIONNEL;BAC PRO PROD;BAC PRO 25406 OUVRAGES DU BATIMENT METALLERIE;2;1;1;0;0;0;0;1;0;0;1;0;0;0
21291.0;2023;43;MAYOTTE;MASCULIN;ENSEIGNEMENT A DISTANCE;BAC GENERAL;BAC GENERAL;BAC GENE 10019 BAC GENERAL;2;2;2;0;0;0;0;2;0;1;0;1;0;0
11029.0;2022;32;GUADELOUPE;FEMININ;SCOLAIRE;BAC PROFESSIONNEL;BAC PRO PROD;BAC PRO 25514 SYST.NUM.OPT.B AUD.RES.EQUIP.DOM.;2;2;2;0;0;0;0;2;0;0;0;1;1;0
21292.0;2023;43;MAYOTTE;MASCULIN;INDIVIDUEL;BAC GENERAL;BAC GENERAL;BAC GENE 10019 BAC GENERAL;43;43;4;32;7;4;3;8;0;0;0;1;7;35
11036.0;2022;32;GUADELOUPE;FEMININ;SCOLAIRE;BAC PROFESSIONNEL;BAC PRO SERV;BAC PRO 31106 LOGISTIQUE;6;6;6;0;0;0;0;6;0;1;1;2;2;0
21312.0;2023;43;MAYOTTE;MASCULIN;INDIVIDUEL;BAC TECHNOLOGIQUE;BAC STL;BAC STL SCIENCES PHYSIQUES CHIMIQUES  EN LABORAT.;1;1;0;1;0;0;0;0;0;0;0;0;0;1
11038.0;2022;32;GUADELOUPE;FEMININ;SCOLAIRE;BAC PROFESSIONNEL;BAC PRO SERV;BAC PRO 31212 METIERS DE L'ACCUEIL;77;77;60;8;9;8;1;68;0;1;9;21;37;9
21318.0;2023;43;MAYOTTE;MASCULIN;SCOLAIRE;BAC PROFESSIONNEL;BAC PRO PROD;BAC PRO 23004 TECHN. ETUDES BAT.A ETUDES & ECO.;25;25;11;14;0;0;0;11;0;0;0;3;8;14
11043.0;2022;32;GUADELOUPE;FEMININ;SCOLAIRE;BAC PROFESSIONNEL;BAC PRO SERV;BAC PRO 33003 ACC.SOINS-S.PERS. OPT.A DOMICILE;88;88;64;21;3;2;1;66;0;1;9;27;29;22
21326.0;2023;43;MAYOTTE;MASCULIN;SCOLAIRE;BAC PROFESSIONNEL;BAC PRO PROD;BAC PRO 23408 Etude et réalisation d'agencement;8;8;3;5;0;0;0;3;0;0;0;0;3;5
11051.0;2022;32;GUADELOUPE;FEMININ;SCOLAIRE;BAC TECHNOLOGIQUE;BAC S2TMD;BAC S2TMD THEATRE;4;4;4;0;0;0;0;4;0;0;4;0;0;0
21339.0;2023;43;MAYOTTE;MASCULIN;SCOLAIRE;BAC PROFESSIONNEL;BAC PRO PROD;BAC PRO AG 21114 CONDUITE PRODUCTIONS HORTICOLES;12;11;11;0;0;0;0;11;0;0;1;1;9;0
11057.0;2022;32;GUADELOUPE;FEMININ;SCOLAIRE;BAC TECHNOLOGIQUE;BAC STI2D;BAC STI2D ENERGIES  ET ENVIRONNEMENT;5;5;1;1;3;3;0;4;0;0;0;0;4;1
21350.0;2023;43;MAYOTTE;MASCULIN;SCOLAIRE;BAC PROFESSIONNEL;BAC PRO SERV;BAC PRO 33403 COMMERC. SERVICES EN RESTAURATION;4;4;0;2;2;1;1;1;0;0;0;0;1;3
11060.0;2022;32;GUADELOUPE;FEMININ;SCOLAIRE;BAC TECHNOLOGIQUE;BAC STL;BAC STL BIOCHIM.-BIOLOGIE-BIOTECHNOL.;21;21;12;1;8;5;3;17;0;1;2;4;10;4
21351.0;2023;43;MAYOTTE;MASCULIN;SCOLAIRE;BAC PROFESSIONNEL;BAC PRO SERV;BAC PRO 34403 METIERS DE LA SECURITE;30;30;27;1;2;2;0;29;0;1;6;12;10;1
11063.0;2022;32;GUADELOUPE;FEMININ;SCOLAIRE;BAC TECHNOLOGIQUE;BAC STMG;BAC STMG MERCATIQUE (MARKETING);100;100;87;1;12;11;1;98;0;7;18;41;32;2
21353.0;2023;43;MAYOTTE;MASCULIN;SCOLAIRE;BAC TECHNOLOGIQUE;BAC ST2S;BAC ST2S SCIENCES & TECHNO. SANTE & SOCIAL;24;24;16;1;7;5;2;21;0;0;4;1;16;3
11075.0;2022;32;GUADELOUPE;MASCULIN;ENSEIGNEMENT A DISTANCE;BAC GENERAL;BAC GENERAL;BAC GENE 10019 BAC GENERAL;4;4;3;0;1;0;1;3;0;0;2;1;0;1
21356.0;2023;43;MAYOTTE;MASCULIN;SCOLAIRE;BAC TECHNOLOGIQUE;BAC STHR;BAC STHR SC.&TEC. HOTELLERIE-RESTAURATION;4;4;0;2;2;0;2;0;0;0;0;0;0;4
11076.0;2022;32;GUADELOUPE;MASCULIN;ENSEIGNEMENT A DISTANCE;BAC TECHNOLOGIQUE;BAC STMG;BAC STMG GESTION ET FINANCE;1;1;1;0;0;0;0;1;0;0;1;0;0;0
21362.0;2023;43;MAYOTTE;MASCULIN;SCOLAIRE;BAC TECHNOLOGIQUE;BAC STMG;BAC STMG GESTION ET FINANCE;137;137;74;15;48;47;1;121;0;0;3;20;98;16
11082.0;2022;32;GUADELOUPE;MASCULIN;INDIVIDUEL;BAC GENERAL;BAC GENERAL;BAC GENE 10019 BAC GENERAL;8;6;6;0;0;0;0;6;0;5;1;0;0;0
21363.0;2023;43;MAYOTTE;MASCULIN;SCOLAIRE;BAC TECHNOLOGIQUE;BAC STMG;BAC STMG MERCATIQUE (MARKETING);184;184;70;41;73;63;10;133;0;0;2;15;116;51
11091.0;2022;32;GUADELOUPE;MASCULIN;INDIVIDUEL;BAC PROFESSIONNEL;BAC PRO SERV;BAC PRO 34304 HYGIENE PROPRETE STERILISATION;2;1;0;1;0;0;0;0;0;0;0;0;0;1
21371.0;2023;11;MONTPELLIER;FEMININ;APPRENTISSAGE;BAC PROFESSIONNEL;BAC PRO PROD;BAC PRO 25515 SYST.NUM.OPT.C RES.INF.SYST.COMM.;3;3;3;0;0;0;0;3;0;0;3;0;0;0
11092.0;2022;32;GUADELOUPE;MASCULIN;INDIVIDUEL;BAC PROFESSIONNEL;BAC PRO SERV;BAC PRO 34403 METIERS DE LA SECURITE;1;0;0;0;0;0;0;0;0;0;0;0;0;0
21379.0;2023;11;MONTPELLIER;FEMININ;APPRENTISSAGE;BAC PROFESSIONNEL;BAC PRO SERV;BAC PRO 31106 LOGISTIQUE;6;6;6;0;0;0;0;6;0;1;3;2;0;0
11094.0;2022;32;GUADELOUPE;MASCULIN;INDIVIDUEL;BAC TECHNOLOGIQUE;BAC STAV;BAC STAV AGRONOMIE ALIM ENV TERRITOI;1;0;0;0;0;0;0;0;0;0;0;0;0;0
21382.0;2023;11;MONTPELLIER;FEMININ;APPRENTISSAGE;BAC PROFESSIONNEL;BAC PRO SERV;BAC PRO 33004 ACC.SOINS-S.PERS. OPT.EN STRUCTUR;2;2;0;2;0;0;0;0;0;0;0;0;0;2
11096.0;2022;32;GUADELOUPE;MASCULIN;INDIVIDUEL;BAC TECHNOLOGIQUE;BAC STMG;BAC STMG MERCATIQUE (MARKETING);6;6;6;0;0;0;0;6;0;2;4;0;0;0
21390.0;2023;11;MONTPELLIER;FEMININ;ENSEIGNEMENT A DISTANCE;BAC PROFESSIONNEL;BAC PRO SERV;BAC PRO 30004 ASSISTANC.GEST.ORGANIS.ACTIVITES;2;2;0;2;0;0;0;0;0;0;0;0;0;2
11098.0;2022;32;GUADELOUPE;MASCULIN;SCOLAIRE;BAC PROFESSIONNEL;BAC PRO PROD;BAC PRO 22104 BOUCHER CHARCUTIER TRAITEUR;7;7;7;0;0;0;0;7;0;0;2;2;3;0
21391.0;2023;11;MONTPELLIER;FEMININ;ENSEIGNEMENT A DISTANCE;BAC PROFESSIONNEL;BAC PRO SERV;BAC PRO 31213 MET.COM.VEN.OP.A ANI.GES.ESP.COM.;2;1;0;1;0;0;0;0;0;0;0;0;0;1
11101.0;2022;32;GUADELOUPE;MASCULIN;SCOLAIRE;BAC PROFESSIONNEL;BAC PRO PROD;BAC PRO 22704 TECHN. MAINT. SYST.ENERG.CLIMATI;14;14;11;1;2;2;0;13;0;0;0;4;9;1
21392.0;2023;11;MONTPELLIER;FEMININ;ENSEIGNEMENT A DISTANCE;BAC PROFESSIONNEL;BAC PRO SERV;BAC PRO 31214 MET.COM.VEN.OP.B PR.CL.VA.OF.COM.;3;1;0;0;1;1;0;1;0;0;0;0;1;0
11102.0;2022;32;GUADELOUPE;MASCULIN;SCOLAIRE;BAC PROFESSIONNEL;BAC PRO PROD;BAC PRO 23003 ARTIS. & M.ART:MARCHANDISAGE VIS.;8;8;4;4;0;0;0;4;0;2;1;1;0;4
21396.0;2023;11;MONTPELLIER;FEMININ;ENSEIGNEMENT A DISTANCE;BAC PROFESSIONNEL;BAC PRO SERV;BAC PRO 33603 ESTHETIQUE COSMETIQUE PARFUMERIE;2;2;0;2;0;0;0;0;0;0;0;0;0;2
11107.0;2022;32;GUADELOUPE;MASCULIN;SCOLAIRE;BAC PROFESSIONNEL;BAC PRO PROD;BAC PRO 23304 AMENAGEMENT FINITION BATIMENT;27;27;23;2;2;2;0;25;0;0;3;9;13;2
21400.0;2023;11;MONTPELLIER;FEMININ;ENSEIGNEMENT A DISTANCE;BAC TECHNOLOGIQUE;BAC STMG;BAC STMG SYSTEMES D'INFORMATION DE GESTION;1;1;0;1;0;0;0;0;0;0;0;0;0;1
11111.0;2022;32;GUADELOUPE;MASCULIN;SCOLAIRE;BAC PROFESSIONNEL;BAC PRO PROD;BAC PRO 24203 METIERS DE LA MODE - VÊTEMENT;2;2;2;0;0;0;0;2;0;0;1;0;1;0
21404.0;2023;11;MONTPELLIER;FEMININ;INDIVIDUEL;BAC GENERAL;BAC GENERAL;BAC GENE 10019 BAC GENERAL;102;101;51;37;13;9;4;60;0;4;13;13;30;41
11112.0;2022;32;GUADELOUPE;MASCULIN;SCOLAIRE;BAC PROFESSIONNEL;BAC PRO PROD;BAC PRO 25007 MAINTENANCE EQUIPEMENTS INDUST.;49;49;25;18;6;3;3;28;0;0;2;11;15;21
21407.0;2023;11;MONTPELLIER;FEMININ;INDIVIDUEL;BAC PROFESSIONNEL;BAC PRO PROD;BAC PRO 24203 METIERS DE LA MODE - VÊTEMENT;1;0;0;0;0;0;0;0;0;0;0;0;0;0
11115.0;2022;32;GUADELOUPE;MASCULIN;SCOLAIRE;BAC PROFESSIONNEL;BAC PRO PROD;BAC PRO 25215 MAINT.VEHIC.OPTB VEHIC.TRANS.ROUT;10;10;8;1;1;0;1;8;0;0;0;5;3;2
21409.0;2023;11;MONTPELLIER;FEMININ;INDIVIDUEL;BAC PROFESSIONNEL;BAC PRO PROD;BAC PRO AG 21114 CONDUITE PRODUCTIONS HORTICOLES;2;2;2;0;0;0;0;2;0;0;0;0;2;0
11119.0;2022;32;GUADELOUPE;MASCULIN;SCOLAIRE;BAC PROFESSIONNEL;BAC PRO PROD;BAC PRO 25303 AERONAUTIQUE OPTION SYSTEMES;11;9;7;1;1;1;0;8;0;0;2;3;3;1
21415.0;2023;11;MONTPELLIER;FEMININ;INDIVIDUEL;BAC PROFESSIONNEL;BAC PRO SERV;BAC PRO 31214 MET.COM.VEN.OP.B PR.CL.VA.OF.COM.;2;1;0;1;0;0;0;0;0;0;0;0;0;1
11130.0;2022;32;GUADELOUPE;MASCULIN;SCOLAIRE;BAC PROFESSIONNEL;BAC PRO PROD;BAC PRO AG 21405 AMENAGEMENTS PAYSAGERS;18;18;18;0;0;0;0;18;0;0;1;6;11;0
21420.0;2023;11;MONTPELLIER;FEMININ;INDIVIDUEL;BAC PROFESSIONNEL;BAC PRO SERV;BAC PRO AG 33002 SERV PERS TERRIT;3;3;2;1;0;0;0;2;0;0;0;0;2;1
11133.0;2022;32;GUADELOUPE;MASCULIN;SCOLAIRE;BAC PROFESSIONNEL;BAC PRO SERV;BAC PRO 31106 LOGISTIQUE;8;8;7;0;1;1;0;8;0;2;4;0;2;0
21428.0;2023;11;MONTPELLIER;FEMININ;SCOLAIRE;BAC PROFESSIONNEL;BAC PRO PROD;BACPRO 20002 ETUD.DEFINITION PRDTS INDUSTRIEL;1;1;1;0;0;0;0;1;0;0;0;1;0;0
11142.0;2022;32;GUADELOUPE;MASCULIN;SCOLAIRE;BAC PROFESSIONNEL;BAC PRO SERV;BAC PRO 33403 COMMERC. SERVICES EN RESTAURATION;15;15;13;2;0;0;0;13;0;1;0;7;5;2
21429.0;2023;11;MONTPELLIER;FEMININ;SCOLAIRE;BAC PROFESSIONNEL;BAC PRO PROD;BAC PRO 22003 BIO-INDUSTRIES DE TRANSFORMATION;9;9;3;6;0;0;0;3;0;0;1;1;1;6
11144.0;2022;32;GUADELOUPE;MASCULIN;SCOLAIRE;BAC PROFESSIONNEL;BAC PRO SERV;BAC PRO 34403 METIERS DE LA SECURITE;38;38;29;8;1;1;0;30;0;1;3;10;16;8
21430.0;2023;11;MONTPELLIER;FEMININ;SCOLAIRE;BAC PROFESSIONNEL;BAC PRO PROD;BAC PRO 22004 PROC. CHIMIE EAU PAPIERS-CARTONS;4;4;3;1;0;0;0;3;0;0;2;1;0;1
11146.0;2022;32;GUADELOUPE;MASCULIN;SCOLAIRE;BAC TECHNOLOGIQUE;BAC S2TMD;BAC S2TMD DANSE;2;2;2;0;0;0;0;2;0;0;1;1;0;0
21433.0;2023;11;MONTPELLIER;FEMININ;SCOLAIRE;BAC PROFESSIONNEL;BAC PRO PROD;BAC PRO 22403 ARTS.& MET.ART:MET.ENSEIGN SIGNA;6;6;4;2;0;0;0;4;0;0;2;0;2;2
11152.0;2022;32;GUADELOUPE;MASCULIN;SCOLAIRE;BAC TECHNOLOGIQUE;BAC STHR;BAC STHR SC.&TEC. HOTELLERIE-RESTAURATION;12;12;11;1;0;0;0;11;0;1;0;5;5;1
21435.0;2023;11;MONTPELLIER;FEMININ;SCOLAIRE;BAC PROFESSIONNEL;BAC PRO PROD;BAC PRO 22704 TECHN. MAINT. SYST.ENERG.CLIMATI;1;1;1;0;0;0;0;1;0;0;0;0;1;0
11155.0;2022;32;GUADELOUPE;MASCULIN;SCOLAIRE;BAC TECHNOLOGIQUE;BAC STI2D;BAC STI2D INNOVATION TECHNO.  ET ECO CONCEPTION;48;48;19;5;24;22;2;41;0;1;0;5;35;7
21439.0;2023;11;MONTPELLIER;FEMININ;SCOLAIRE;BAC PROFESSIONNEL;BAC PRO PROD;BACPRO 23103 TECHNICIEN GEOMETRE-TOPOGRAPHE;6;6;3;3;0;0;0;3;0;0;0;0;3;3
11156.0;2022;32;GUADELOUPE;MASCULIN;SCOLAIRE;BAC TECHNOLOGIQUE;BAC STI2D;BAC STI2D SYSTÈME D'INFORMATION  ET NUMERIQUE;60;60;39;3;18;14;4;53;0;0;1;8;44;7
21448.0;2023;11;MONTPELLIER;FEMININ;SCOLAIRE;BAC PROFESSIONNEL;BAC PRO PROD;BAC PRO 25009 MAINTENANCE NAUTIQUE;1;1;1;0;0;0;0;1;0;0;0;0;1;0
11157.0;2022;32;GUADELOUPE;MASCULIN;SCOLAIRE;BAC TECHNOLOGIQUE;BAC STL;BAC STL BIOCHIM.-BIOLOGIE-BIOTECHNOL.;6;6;3;0;3;2;1;5;0;0;2;0;3;1
21466.0;2023;11;MONTPELLIER;FEMININ;SCOLAIRE;BAC PROFESSIONNEL;BAC PRO PROD;BAC PRO AG 21405 AMENAGEMENTS PAYSAGERS;9;9;8;1;0;0;0;8;0;0;0;4;4;1
11161.0;2022;32;GUADELOUPE;MASCULIN;SCOLAIRE;BAC TECHNOLOGIQUE;BAC STMG;BAC STMG RESSOURCES HUMAINES ET COMMUNICATION;58;58;40;5;13;13;0;53;0;2;3;15;33;5
21473.0;2023;11;MONTPELLIER;FEMININ;SCOLAIRE;BAC PROFESSIONNEL;BAC PRO SERV;BAC PRO 31114 ORGANIS. TRANSPORT MARCHANDISES;30;30;22;8;0;0;0;22;0;1;3;9;9;8
11162.0;2022;32;GUADELOUPE;MASCULIN;SCOLAIRE;BAC TECHNOLOGIQUE;BAC STMG;BAC STMG SYSTEMES D'INFORMATION DE GESTION;13;13;9;3;1;1;0;10;0;0;1;3;6;3
21475.0;2023;11;MONTPELLIER;FEMININ;SCOLAIRE;BAC PROFESSIONNEL;BAC PRO SERV;BAC PRO 31213 MET.COM.VEN.OP.A ANI.GES.ESP.COM.;422;422;352;57;13;6;7;358;0;25;65;145;123;64
11167.0;2022;33;GUYANE;FEMININ;FORMATION CONTINUE;BAC PROFESSIONNEL;BAC PRO PROD;BAC PRO AG 21004 CGEA;1;1;1;0;0;0;0;1;0;0;0;0;1;0
21482.0;2023;11;MONTPELLIER;FEMININ;SCOLAIRE;BAC PROFESSIONNEL;BAC PRO SERV;BAC PRO 33004 ACC.SOINS-S.PERS. OPT.EN STRUCTUR;591;589;510;57;22;12;10;522;0;26;127;201;168;67
11173.0;2022;33;GUYANE;FEMININ;INDIVIDUEL;BAC PROFESSIONNEL;BAC PRO SERV;BAC PRO 30001 GESTION-ADMINISTRATION;7;6;1;5;0;0;0;1;0;0;0;0;1;5
21486.0;2023;11;MONTPELLIER;FEMININ;SCOLAIRE;BAC PROFESSIONNEL;BAC PRO SERV;BAC PRO 33403 COMMERC. SERVICES EN RESTAURATION;54;54;45;8;1;1;0;46;0;4;7;12;23;8
11177.0;2022;33;GUYANE;FEMININ;INDIVIDUEL;BAC PROFESSIONNEL;BAC PRO SERV;BAC PRO 33002 SERVICES DE PROXIMITE  VIE LOCAL;1;1;1;0;0;0;0;1;0;0;0;0;1;0
21493.0;2023;11;MONTPELLIER;FEMININ;SCOLAIRE;BAC TECHNOLOGIQUE;BAC S2TMD;BAC S2TMD MUSIQUE;1;1;1;0;0;0;0;1;0;0;0;1;0;0
11188.0;2022;33;GUYANE;FEMININ;SCOLAIRE;BAC PROFESSIONNEL;BAC PRO PROD;BAC PRO 23003 ARTIS. & M.ART:MARCHANDISAGE VIS.;7;7;5;0;2;1;1;6;0;0;1;3;2;1
21494.0;2023;11;MONTPELLIER;FEMININ;SCOLAIRE;BAC TECHNOLOGIQUE;BAC ST2S;BAC ST2S SCIENCES & TECHNO. SANTE & SOCIAL;794;794;684;18;92;65;27;749;3;25;142;256;323;45
11202.0;2022;33;GUYANE;FEMININ;SCOLAIRE;BAC PROFESSIONNEL;BAC PRO PROD;BAC PRO AG 21114 CONDUITE PRODUCTIONS HORTICOLES;5;5;3;2;0;0;0;3;0;0;0;1;2;2
21509.0;2023;11;MONTPELLIER;MASCULIN;APPRENTISSAGE;BAC PROFESSIONNEL;BAC PRO PROD;BAC PRO 22004 PROC. CHIMIE EAU PAPIERS-CARTONS;10;9;9;0;0;0;0;9;0;4;3;2;0;0
11207.0;2022;33;GUYANE;FEMININ;SCOLAIRE;BAC PROFESSIONNEL;BAC PRO SERV;BAC PRO 31209 POISSONIER ECAILLER TRAITEUR;8;8;7;0;1;0;1;7;0;0;1;2;4;1
21524.0;2023;11;MONTPELLIER;MASCULIN;APPRENTISSAGE;BAC PROFESSIONNEL;BAC PRO PROD;BAC PRO 25214 MAINT.VEHIC.OPTA VOIT.PARTICUL.;96;93;83;7;3;0;3;83;0;22;23;22;16;10
11220.0;2022;33;GUYANE;FEMININ;SCOLAIRE;BAC TECHNOLOGIQUE;BAC ST2S;BAC ST2S SCIENCES & TECHNO. SANTE & SOCIAL;201;201;121;21;59;35;24;156;0;2;3;44;107;45
21525.0;2023;11;MONTPELLIER;MASCULIN;APPRENTISSAGE;BAC PROFESSIONNEL;BAC PRO PROD;BAC PRO 25215 MAINT.VEHIC.OPTB VEHIC.TRANS.ROUT;11;11;11;0;0;0;0;11;0;2;1;6;2;0
11221.0;2022;33;GUYANE;FEMININ;SCOLAIRE;BAC TECHNOLOGIQUE;BAC STAV;BAC STAV AGRONOMIE ALIM ENV TERRITOI;2;2;2;0;0;0;0;2;0;0;0;1;1;0
21528.0;2023;11;MONTPELLIER;MASCULIN;APPRENTISSAGE;BAC PROFESSIONNEL;BAC PRO PROD;BAC PRO 25303 AERONAUTIQUE OPTION SYSTEMES;5;5;5;0;0;0;0;5;0;0;1;3;1;0
11225.0;2022;33;GUYANE;FEMININ;SCOLAIRE;BAC TECHNOLOGIQUE;BAC STI2D;BAC STI2D INNOVATION TECHNO.  ET ECO CONCEPTION;6;6;2;0;4;4;0;6;0;0;0;1;5;0
21532.0;2023;11;MONTPELLIER;MASCULIN;APPRENTISSAGE;BAC PROFESSIONNEL;BAC PRO PROD;BAC PRO 25509 TECHNIC. FROID CONDITIONNEMT AIR;7;7;4;3;0;0;0;4;0;0;2;0;2;3
11233.0;2022;33;GUYANE;MASCULIN;APPRENTISSAGE;BAC PROFESSIONNEL;BAC PRO SERV;BAC PRO 31213 MET.COM.VEN.OP.A ANI.GES.ESP.COM.;4;3;1;2;0;0;0;1;0;0;0;0;1;2
21535.0;2023;11;MONTPELLIER;MASCULIN;APPRENTISSAGE;BAC PROFESSIONNEL;BAC PRO PROD;BAC PRO AG 21004 CGEA;1;1;1;0;0;0;0;1;0;0;0;0;1;0
11243.0;2022;33;GUYANE;MASCULIN;INDIVIDUEL;BAC PROFESSIONNEL;BAC PRO SERV;BAC PRO 30001 GESTION-ADMINISTRATION;2;2;0;2;0;0;0;0;0;0;0;0;0;2
21538.0;2023;11;MONTPELLIER;MASCULIN;APPRENTISSAGE;BAC PROFESSIONNEL;BAC PRO PROD;BAC PRO AG 21203 TECHN CONSEIL DE VENTE ANIMAL;1;1;1;0;0;0;0;1;0;0;0;1;0;0
11252.0;2022;33;GUYANE;MASCULIN;SCOLAIRE;BAC PROFESSIONNEL;BAC PRO PROD;BAC PRO 23003 ARTIS. & M.ART:MARCHANDISAGE VIS.;6;6;4;1;1;1;0;5;0;0;0;1;4;1
21547.0;2023;11;MONTPELLIER;MASCULIN;APPRENTISSAGE;BAC PROFESSIONNEL;BAC PRO SERV;BAC PRO 33403 COMMERC. SERVICES EN RESTAURATION;5;5;3;2;0;0;0;3;0;0;0;2;1;2
11254.0;2022;33;GUYANE;MASCULIN;SCOLAIRE;BAC PROFESSIONNEL;BAC PRO PROD;BAC PRO 23005 TECHN. ETUDES BAT B ASSIST.ARCHI.;12;12;1;11;0;0;0;1;0;0;0;0;1;11
21549.0;2023;11;MONTPELLIER;MASCULIN;ENSEIGNEMENT A DISTANCE;BAC GENERAL;BAC GENERAL;BAC GENE 10019 BAC GENERAL;47;47;35;7;5;3;2;38;0;3;5;5;25;9
11255.0;2022;33;GUYANE;MASCULIN;SCOLAIRE;BAC PROFESSIONNEL;BAC PRO PROD;BACPRO 23103 TECHNICIEN GEOMETRE-TOPOGRAPHE;9;9;4;5;0;0;0;4;0;0;0;0;4;5
21561.0;2023;11;MONTPELLIER;MASCULIN;INDIVIDUEL;BAC GENERAL;BAC GENERAL;BAC GENE 10019 BAC GENERAL;119;119;74;34;11;10;1;84;0;5;24;22;33;35
11261.0;2022;33;GUYANE;MASCULIN;SCOLAIRE;BAC PROFESSIONNEL;BAC PRO PROD;BAC PRO 23405 TECHNICIEN MENUISIER AGENCEUR;27;26;17;6;3;1;2;18;0;0;3;3;12;8
21563.0;2023;11;MONTPELLIER;MASCULIN;INDIVIDUEL;BAC PROFESSIONNEL;BAC PRO PROD;BAC PRO 22703 TECHN.INSTALL.SYST.ENERG.CLIMATI;3;3;0;2;1;1;0;1;0;0;0;0;1;2
11264.0;2022;33;GUYANE;MASCULIN;SCOLAIRE;BAC PROFESSIONNEL;BAC PRO PROD;BAC PRO 25007 MAINTENANCE EQUIPEMENTS INDUST.;23;21;6;14;1;1;0;7;0;0;0;4;3;14
21565.0;2023;11;MONTPELLIER;MASCULIN;INDIVIDUEL;BAC PROFESSIONNEL;BAC PRO PROD;BAC PRO 23004 TECHN. ETUDES BAT.A ETUDES & ECO.;1;0;0;0;0;0;0;0;0;0;0;0;0;0
11265.0;2022;33;GUYANE;MASCULIN;SCOLAIRE;BAC PROFESSIONNEL;BAC PRO PROD;BAC PRO 25214 MAINT.VEHIC.OPTA VOIT.PARTICUL.;53;53;16;28;9;6;3;22;0;0;1;5;16;31
21566.0;2023;11;MONTPELLIER;MASCULIN;INDIVIDUEL;BAC PROFESSIONNEL;BAC PRO PROD;BAC PRO 24303 MET. DU CUIR: SELLERIE GARNISSAGE;1;0;0;0;0;0;0;0;0;0;0;0;0;0
11267.0;2022;33;GUYANE;MASCULIN;SCOLAIRE;BAC PROFESSIONNEL;BAC PRO PROD;BAC PRO 25411 TECH.CHAUDRONNERIE INDUSTRIELLE;22;21;9;9;3;2;1;11;0;0;0;2;9;10
21567.0;2023;11;MONTPELLIER;MASCULIN;INDIVIDUEL;BAC PROFESSIONNEL;BAC PRO PROD;BAC PRO 25006 MICROTECHNIQUES;1;1;1;0;0;0;0;1;0;0;1;0;0;0
11270.0;2022;33;GUYANE;MASCULIN;SCOLAIRE;BAC PROFESSIONNEL;BAC PRO PROD;BAC PRO 25513 SYST.NUM.OPT.A SURETE SECURITE;11;11;7;3;1;1;0;8;0;0;2;2;4;3
21571.0;2023;11;MONTPELLIER;MASCULIN;INDIVIDUEL;BAC PROFESSIONNEL;BAC PRO PROD;BAC PRO 25215 MAINT.VEHIC.OPTB VEHIC.TRANS.ROUT;1;1;0;1;0;0;0;0;0;0;0;0;0;1
11278.0;2022;33;GUYANE;MASCULIN;SCOLAIRE;BAC PROFESSIONNEL;BAC PRO SERV;BAC PRO 31209 POISSONIER ECAILLER TRAITEUR;6;6;3;1;2;1;1;4;0;0;0;2;2;2
21574.0;2023;11;MONTPELLIER;MASCULIN;INDIVIDUEL;BAC PROFESSIONNEL;BAC PRO PROD;BAC PRO AG 21211 COND GEST ENTR HIPPIQUE;1;1;1;0;0;0;0;1;0;0;0;0;1;0
11283.0;2022;33;GUYANE;MASCULIN;SCOLAIRE;BAC PROFESSIONNEL;BAC PRO SERV;BAC PRO 33002 SERVICES DE PROXIMITE  VIE LOCAL;7;7;4;3;0;0;0;4;0;0;1;0;3;3
21575.0;2023;11;MONTPELLIER;MASCULIN;INDIVIDUEL;BAC PROFESSIONNEL;BAC PRO PROD;BAC PRO AG 21302 GEST MILIEUX NATURELS FAUNE;1;1;1;0;0;0;0;1;0;0;0;0;1;0
11286.0;2022;33;GUYANE;MASCULIN;SCOLAIRE;BAC PROFESSIONNEL;BAC PRO SERV;BAC PRO 33403 COMMERC. SERVICES EN RESTAURATION;9;9;5;4;0;0;0;5;0;0;0;1;4;4
21577.0;2023;11;MONTPELLIER;MASCULIN;INDIVIDUEL;BAC PROFESSIONNEL;BAC PRO SERV;BAC PRO 31106 LOGISTIQUE;3;0;0;0;0;0;0;0;0;0;0;0;0;0
11290.0;2022;33;GUYANE;MASCULIN;SCOLAIRE;BAC PROFESSIONNEL;BAC PRO SERV;BAC PRO AG 33002 SERV PERS TERRIT;4;4;4;0;0;0;0;4;0;0;1;2;1;0
21580.0;2023;11;MONTPELLIER;MASCULIN;INDIVIDUEL;BAC PROFESSIONNEL;BAC PRO SERV;BAC PRO 31214 MET.COM.VEN.OP.B PR.CL.VA.OF.COM.;2;1;0;1;0;0;0;0;0;0;0;0;0;1
11292.0;2022;33;GUYANE;MASCULIN;SCOLAIRE;BAC TECHNOLOGIQUE;BAC STAV;BAC STAV AGRONOMIE ALIM ENV TERRITOI;4;4;4;0;0;0;0;4;0;0;1;3;0;0
21591.0;2023;11;MONTPELLIER;MASCULIN;INDIVIDUEL;BAC TECHNOLOGIQUE;BAC STMG;BAC STMG MERCATIQUE (MARKETING);36;35;13;11;11;7;4;20;0;1;0;5;14;15
11296.0;2022;33;GUYANE;MASCULIN;SCOLAIRE;BAC TECHNOLOGIQUE;BAC STI2D;BAC STI2D INNOVATION TECHNO.  ET ECO CONCEPTION;19;19;13;3;3;3;0;16;0;0;0;4;12;3
21593.0;2023;11;MONTPELLIER;MASCULIN;INDIVIDUEL;BAC TECHNOLOGIQUE;BAC STMG;BAC STMG SYSTEMES D'INFORMATION DE GESTION;3;3;0;2;1;1;0;1;0;0;0;0;1;2
11299.0;2022;33;GUYANE;MASCULIN;SCOLAIRE;BAC TECHNOLOGIQUE;BAC STL;BAC STL SCIENCES PHYSIQUES CHIMIQUES  EN LABORAT.;9;9;4;1;4;4;0;8;0;0;1;1;6;1
21608.0;2023;11;MONTPELLIER;MASCULIN;SCOLAIRE;BAC PROFESSIONNEL;BAC PRO PROD;BAC PRO 23102 TRAVAUX PUBLICS;40;40;32;6;2;2;0;34;0;0;7;14;13;6
11304.0;2022;28;LA REUNION;FEMININ;APPRENTISSAGE;BAC PROFESSIONNEL;BAC PRO PROD;BAC PRO 20102 PILOTE DE LIGNE DE PRODUCTION;1;1;1;0;0;0;0;1;0;0;1;0;0;0
21609.0;2023;11;MONTPELLIER;MASCULIN;SCOLAIRE;BAC PROFESSIONNEL;BAC PRO PROD;BACPRO 23103 TECHNICIEN GEOMETRE-TOPOGRAPHE;18;18;17;1;0;0;0;17;0;0;3;9;5;1
11305.0;2022;28;LA REUNION;FEMININ;APPRENTISSAGE;BAC PROFESSIONNEL;BAC PRO PROD;BAC PRO 25408 REPARATION DES CARROSSERIES;1;0;0;0;0;0;0;0;0;0;0;0;0;0
21614.0;2023;11;MONTPELLIER;MASCULIN;SCOLAIRE;BAC PROFESSIONNEL;BAC PRO PROD;BAC PRO 23304 AMENAGEMENT FINITION BATIMENT;13;13;8;3;2;2;0;10;0;0;3;3;4;3
11309.0;2022;28;LA REUNION;FEMININ;ENSEIGNEMENT A DISTANCE;BAC GENERAL;BAC GENERAL;BAC GENE 10019 BAC GENERAL;14;14;11;2;1;1;0;12;0;1;2;3;6;2
21621.0;2023;11;MONTPELLIER;MASCULIN;SCOLAIRE;BAC PROFESSIONNEL;BAC PRO PROD;BAC PRO 25006 MICROTECHNIQUES;14;14;9;3;2;1;1;10;0;0;2;2;6;4
11311.0;2022;28;LA REUNION;FEMININ;ENSEIGNEMENT A DISTANCE;BAC TECHNOLOGIQUE;BAC STMG;BAC STMG RESSOURCES HUMAINES ET COMMUNICATION;1;1;0;1;0;0;0;0;0;0;0;0;0;1
21624.0;2023;11;MONTPELLIER;MASCULIN;SCOLAIRE;BAC PROFESSIONNEL;BAC PRO PROD;BAC PRO 25106 TECHNICIEN D'USINAGE;51;51;40;7;4;2;2;42;0;2;6;17;17;9
11322.0;2022;28;LA REUNION;FEMININ;INDIVIDUEL;BAC TECHNOLOGIQUE;BAC STL;BAC STL BIOCHIM.-BIOLOGIE-BIOTECHNOL.;1;1;0;1;0;0;0;0;0;0;0;0;0;1
21629.0;2023;11;MONTPELLIER;MASCULIN;SCOLAIRE;BAC PROFESSIONNEL;BAC PRO PROD;BAC PRO 25220 MAINT.MATERIELS OPT.B TP MANUT.;17;17;16;1;0;0;0;16;0;2;3;5;6;1
11325.0;2022;28;LA REUNION;FEMININ;INDIVIDUEL;BAC TECHNOLOGIQUE;BAC STMG;BAC STMG RESSOURCES HUMAINES ET COMMUNICATION;3;2;0;2;0;0;0;0;0;0;0;0;0;2
21634.0;2023;11;MONTPELLIER;MASCULIN;SCOLAIRE;BAC PROFESSIONNEL;BAC PRO PROD;BAC PRO 25411 TECH.CHAUDRONNERIE INDUSTRIELLE;49;49;41;6;2;2;0;43;0;2;8;16;17;6
11326.0;2022;28;LA REUNION;FEMININ;SCOLAIRE;BAC GENERAL;BAC GENERAL;BAC GENE 10019 BAC GENERAL;3106;3106;2847;55;204;147;57;2994;102;408;788;907;789;112
21636.0;2023;11;MONTPELLIER;MASCULIN;SCOLAIRE;BAC PROFESSIONNEL;BAC PRO PROD;BAC PRO 25510 METIERS ELECT. ENVIRON. CONNECTES;379;377;268;86;23;16;7;284;0;14;56;109;105;93
11332.0;2022;28;LA REUNION;FEMININ;SCOLAIRE;BAC PROFESSIONNEL;BAC PRO PROD;BAC PRO 22106 CUISINE;6;6;6;0;0;0;0;6;0;1;2;1;2;0
21642.0;2023;11;MONTPELLIER;MASCULIN;SCOLAIRE;BAC PROFESSIONNEL;BAC PRO PROD;BAC PRO AG 21113 CGEVV;25;25;18;7;0;0;0;18;0;0;2;6;10;7
11338.0;2022;28;LA REUNION;FEMININ;SCOLAIRE;BAC PROFESSIONNEL;BAC PRO PROD;BAC PRO 23206 INTERV. SUR PATRIMOINE BATI OPT.B;1;1;1;0;0;0;0;1;0;0;0;0;1;0
21643.0;2023;11;MONTPELLIER;MASCULIN;SCOLAIRE;BAC PROFESSIONNEL;BAC PRO PROD;BAC PRO AG 21114 CONDUITE PRODUCTIONS HORTICOLES;34;30;25;5;0;0;0;25;0;2;1;5;17;5
11342.0;2022;28;LA REUNION;FEMININ;SCOLAIRE;BAC PROFESSIONNEL;BAC PRO PROD;BAC PRO 23405 TECHNICIEN MENUISIER AGENCEUR;1;1;1;0;0;0;0;1;0;1;0;0;0;0
21644.0;2023;11;MONTPELLIER;MASCULIN;SCOLAIRE;BAC PROFESSIONNEL;BAC PRO PROD;BAC PRO AG 21203 TECHN CONSEIL DE VENTE ANIMAL;9;9;8;1;0;0;0;8;0;1;1;1;5;1
11343.0;2022;28;LA REUNION;FEMININ;SCOLAIRE;BAC PROFESSIONNEL;BAC PRO PROD;BAC PRO 23407 TECHNIC.FAB.BOIS ET MATERX ASSOC;1;1;1;0;0;0;0;1;0;0;1;0;0;0
21651.0;2023;11;MONTPELLIER;MASCULIN;SCOLAIRE;BAC PROFESSIONNEL;BAC PRO PROD;BAC PRO AG 21407 TEC CONS VTE UNIVERS JARDINERIE;4;3;2;1;0;0;0;2;0;0;0;0;2;1
11352.0;2022;28;LA REUNION;FEMININ;SCOLAIRE;BAC PROFESSIONNEL;BAC PRO PROD;BAC PRO 25515 SYST.NUM.OPT.C RES.INF.SYST.COMM.;4;4;2;1;1;1;0;3;0;0;1;1;1;1
21652.0;2023;11;MONTPELLIER;MASCULIN;SCOLAIRE;BAC PROFESSIONNEL;BAC PRO PROD;BAC PRO AG 22105 LABORATOIRE CONTROLE QUALITE;22;21;17;4;0;0;0;17;0;0;1;2;14;4
11353.0;2022;28;LA REUNION;FEMININ;SCOLAIRE;BAC PROFESSIONNEL;BAC PRO PROD;BAC PRO AG 21004 CGEA;3;3;2;1;0;0;0;2;0;0;1;0;1;1
21655.0;2023;11;MONTPELLIER;MASCULIN;SCOLAIRE;BAC PROFESSIONNEL;BAC PRO SERV;BAC PRO 31106 LOGISTIQUE;76;76;39;30;7;3;4;42;0;2;9;10;21;34
11356.0;2022;28;LA REUNION;FEMININ;SCOLAIRE;BAC PROFESSIONNEL;BAC PRO PROD;BAC PRO AG 22107 TEC CONS VTE ALIMENTATION P.ALIM;6;6;3;3;0;0;0;3;0;0;0;0;3;3
21656.0;2023;11;MONTPELLIER;MASCULIN;SCOLAIRE;BAC PROFESSIONNEL;BAC PRO SERV;BAC PRO 31107 CONDUCT. TRANSP.ROUT.MARCHANDISES;47;47;39;8;0;0;0;39;0;1;11;13;14;8
11368.0;2022;28;LA REUNION;FEMININ;SCOLAIRE;BAC PROFESSIONNEL;BAC PRO SERV;BAC PRO 33101 OPTIQUE LUNETTERIE;6;6;6;0;0;0;0;6;0;0;2;2;2;0
21658.0;2023;11;MONTPELLIER;MASCULIN;SCOLAIRE;BAC PROFESSIONNEL;BAC PRO SERV;BAC PRO 31212 METIERS DE L'ACCUEIL;66;66;57;6;3;2;1;59;0;2;15;24;18;7
11369.0;2022;28;LA REUNION;FEMININ;SCOLAIRE;BAC PROFESSIONNEL;BAC PRO SERV;BAC PRO 33403 COMMERC. SERVICES EN RESTAURATION;12;12;9;3;0;0;0;9;0;2;2;3;2;3
21660.0;2023;11;MONTPELLIER;MASCULIN;SCOLAIRE;BAC PROFESSIONNEL;BAC PRO SERV;BAC PRO 31214 MET.COM.VEN.OP.B PR.CL.VA.OF.COM.;175;175;147;18;10;6;4;153;0;6;33;59;55;22
11372.0;2022;28;LA REUNION;FEMININ;SCOLAIRE;BAC PROFESSIONNEL;BAC PRO SERV;BAC PRO 34304 HYGIENE PROPRETE STERILISATION;13;13;8;4;1;1;0;9;0;0;1;3;5;4
21666.0;2023;11;MONTPELLIER;MASCULIN;SCOLAIRE;BAC PROFESSIONNEL;BAC PRO SERV;BAC PRO 33004 ACC.SOINS-S.PERS. OPT.EN STRUCTUR;42;42;35;5;2;2;0;37;0;3;5;14;15;5
11380.0;2022;28;LA REUNION;FEMININ;SCOLAIRE;BAC TECHNOLOGIQUE;BAC STI2D;BAC STI2D ENERGIES  ET ENVIRONNEMENT;28;28;19;3;6;5;1;24;0;0;2;10;12;4
21667.0;2023;11;MONTPELLIER;MASCULIN;SCOLAIRE;BAC PROFESSIONNEL;BAC PRO SERV;BAC PRO 33006 ANIMAT. ENFANCE& PERSONNES AGEES;33;33;28;5;0;0;0;28;0;3;8;14;3;5
11387.0;2022;28;LA REUNION;FEMININ;SCOLAIRE;BAC TECHNOLOGIQUE;BAC STMG;BAC STMG RESSOURCES HUMAINES ET COMMUNICATION;326;326;256;15;55;46;9;302;0;10;29;84;179;24
21673.0;2023;11;MONTPELLIER;MASCULIN;SCOLAIRE;BAC PROFESSIONNEL;BAC PRO SERV;BAC PRO 34403 METIERS DE LA SECURITE;142;142;127;7;8;6;2;133;0;8;19;64;42;9
11390.0;2022;28;LA REUNION;MASCULIN;APPRENTISSAGE;BAC PROFESSIONNEL;BAC PRO PROD;BAC PRO 22503 PLASTIQUES ET COMPOSITES;1;1;0;1;0;0;0;0;0;0;0;0;0;1
21674.0;2023;11;MONTPELLIER;MASCULIN;SCOLAIRE;BAC PROFESSIONNEL;BAC PRO SERV;BAC PRO AG 33002 SERV PERS TERRIT;60;60;54;6;0;0;0;54;0;2;4;17;31;6
11398.0;2022;28;LA REUNION;MASCULIN;APPRENTISSAGE;BAC PROFESSIONNEL;BAC PRO PROD;BAC PRO 25406 OUVRAGES DU BATIMENT METALLERIE;10;10;6;1;3;3;0;9;0;0;1;2;6;1
21678.0;2023;11;MONTPELLIER;MASCULIN;SCOLAIRE;BAC TECHNOLOGIQUE;BAC STD2A;BAC STD2A SCIENCES & TECHNO. DESIGN-ARTS APPLIQUES;32;32;30;0;2;1;1;31;0;0;11;13;7;1
11401.0;2022;28;LA REUNION;MASCULIN;APPRENTISSAGE;BAC PROFESSIONNEL;BAC PRO PROD;BAC PRO AG 22107 TEC CONS VTE ALIMENTATION P.ALIM;4;2;1;1;0;0;0;1;0;0;0;0;1;1
21682.0;2023;11;MONTPELLIER;MASCULIN;SCOLAIRE;BAC TECHNOLOGIQUE;BAC STI2D;BAC STI2D INNOVATION TECHNO.  ET ECO CONCEPTION;246;246;215;8;23;14;9;229;2;8;37;81;101;17
11405.0;2022;28;LA REUNION;MASCULIN;ENSEIGNEMENT A DISTANCE;BAC TECHNOLOGIQUE;BAC STMG;BAC STMG GESTION ET FINANCE;1;1;1;0;0;0;0;1;0;0;0;1;0;0
21684.0;2023;11;MONTPELLIER;MASCULIN;SCOLAIRE;BAC TECHNOLOGIQUE;BAC STL;BAC STL BIOCHIM.-BIOLOGIE-BIOTECHNOL.;76;76;61;2;13;8;5;69;1;2;12;16;38;7
11409.0;2022;28;LA REUNION;MASCULIN;INDIVIDUEL;BAC GENERAL;BAC GENERAL;BAC GENE 10019 BAC GENERAL;17;7;3;4;0;0;0;3;0;0;1;1;1;4
21690.0;2023;12;NANCY-METZ;FEMININ;APPRENTISSAGE;BAC PROFESSIONNEL;BAC PRO PROD;BAC PRO 20102 PILOTE DE LIGNE DE PRODUCTION;1;1;1;0;0;0;0;1;0;0;0;1;0;0
11414.0;2022;28;LA REUNION;MASCULIN;INDIVIDUEL;BAC PROFESSIONNEL;BAC PRO PROD;BAC PRO AG 21004 CGEA;17;13;11;2;0;0;0;11;0;0;0;0;11;2
21696.0;2023;12;NANCY-METZ;FEMININ;APPRENTISSAGE;BAC PROFESSIONNEL;BAC PRO PROD;BAC PRO 25007 MAINTENANCE EQUIPEMENTS INDUST.;1;1;1;0;0;0;0;1;0;0;0;0;1;0
11418.0;2022;28;LA REUNION;MASCULIN;INDIVIDUEL;BAC PROFESSIONNEL;BAC PRO SERV;BAC PRO 31213 MET.COM.VEN.OP.A ANI.GES.ESP.COM.;2;1;0;1;0;0;0;0;0;0;0;0;0;1
21697.0;2023;12;NANCY-METZ;FEMININ;APPRENTISSAGE;BAC PROFESSIONNEL;BAC PRO PROD;BAC PRO 25106 TECHNICIEN D'USINAGE;1;1;1;0;0;0;0;1;0;0;1;0;0;0
11421.0;2022;28;LA REUNION;MASCULIN;INDIVIDUEL;BAC TECHNOLOGIQUE;BAC STMG;BAC STMG GESTION ET FINANCE;2;2;0;2;0;0;0;0;0;0;0;0;0;2
21704.0;2023;12;NANCY-METZ;FEMININ;APPRENTISSAGE;BAC PROFESSIONNEL;BAC PRO PROD;BAC PRO 25515 SYST.NUM.OPT.C RES.INF.SYST.COMM.;1;1;1;0;0;0;0;1;0;0;0;0;1;0
11431.0;2022;28;LA REUNION;MASCULIN;SCOLAIRE;BAC PROFESSIONNEL;BAC PRO PROD;BAC PRO 22503 PLASTIQUES ET COMPOSITES;3;3;3;0;0;0;0;3;0;0;1;1;1;0
21707.0;2023;12;NANCY-METZ;FEMININ;APPRENTISSAGE;BAC PROFESSIONNEL;BAC PRO PROD;BAC PRO AG 21114 CONDUITE PRODUCTIONS HORTICOLES;2;2;2;0;0;0;0;2;0;0;0;0;2;0
11438.0;2022;28;LA REUNION;MASCULIN;SCOLAIRE;BAC PROFESSIONNEL;BAC PRO PROD;BACPRO 23103 TECHNICIEN GEOMETRE-TOPOGRAPHE;31;31;26;5;0;0;0;26;0;0;4;6;16;5
21711.0;2023;12;NANCY-METZ;FEMININ;APPRENTISSAGE;BAC PROFESSIONNEL;BAC PRO PROD;BAC PRO AG 22108 TEC CONS VTE ALIMENTATION (PAB);3;3;2;1;0;0;0;2;0;0;0;1;1;1
11442.0;2022;28;LA REUNION;MASCULIN;SCOLAIRE;BAC PROFESSIONNEL;BAC PRO PROD;BAC PRO 23207 INTERV. SUR PATRIMOINE BATI OPT.C;8;8;7;1;0;0;0;7;0;0;1;3;3;1
21714.0;2023;12;NANCY-METZ;FEMININ;APPRENTISSAGE;BAC PROFESSIONNEL;BAC PRO SERV;BAC PRO 31107 CONDUCT. TRANSP.ROUT.MARCHANDISES;1;1;1;0;0;0;0;1;0;0;0;1;0;0
11445.0;2022;28;LA REUNION;MASCULIN;SCOLAIRE;BAC PROFESSIONNEL;BAC PRO PROD;BAC PRO 23404 TECHNICIEN CONSTRUCTEUR BOIS;30;30;21;9;0;0;0;21;0;0;1;5;15;9
21716.0;2023;12;NANCY-METZ;FEMININ;APPRENTISSAGE;BAC PROFESSIONNEL;BAC PRO SERV;BAC PRO 31213 MET.COM.VEN.OP.A ANI.GES.ESP.COM.;66;64;55;6;3;2;1;57;0;3;10;28;16;7
11467.0;2022;28;LA REUNION;MASCULIN;SCOLAIRE;BAC PROFESSIONNEL;BAC PRO PROD;BAC PRO AG 21004 CGEA;38;37;24;13;0;0;0;24;0;0;2;7;15;13
21718.0;2023;12;NANCY-METZ;FEMININ;APPRENTISSAGE;BAC PROFESSIONNEL;BAC PRO SERV;BAC PRO 32207 REAL.PR.IMPR.PLURI.OPTA.PR.GRAPH.;1;1;1;0;0;0;0;1;0;0;0;1;0;0
11470.0;2022;28;LA REUNION;MASCULIN;SCOLAIRE;BAC PROFESSIONNEL;BAC PRO PROD;BAC PRO AG 21405 AMENAGEMENTS PAYSAGERS;9;8;6;2;0;0;0;6;0;0;1;1;4;2
21736.0;2023;12;NANCY-METZ;FEMININ;FORMATION CONTINUE;BAC PROFESSIONNEL;BAC PRO PROD;BAC PRO 24203 METIERS DE LA MODE - VÊTEMENT;2;2;2;0;0;0;0;2;0;1;1;0;0;0
11476.0;2022;28;LA REUNION;MASCULIN;SCOLAIRE;BAC PROFESSIONNEL;BAC PRO SERV;BAC PRO 31212 METIERS DE L'ACCUEIL;21;21;15;2;4;4;0;19;0;0;3;9;7;2
21740.0;2023;12;NANCY-METZ;FEMININ;FORMATION CONTINUE;BAC PROFESSIONNEL;BAC PRO PROD;BAC PRO AG 22108 TEC CONS VTE ALIMENTATION (PAB);3;3;3;0;0;0;0;3;0;0;0;1;2;0
11480.0;2022;28;LA REUNION;MASCULIN;SCOLAIRE;BAC PROFESSIONNEL;BAC PRO SERV;BAC PRO 32208 REAL.PR.IMPR.PLURI.OPTB.PR.IMPR.;6;6;6;0;0;0;0;6;0;0;0;3;3;0
21745.0;2023;12;NANCY-METZ;FEMININ;FORMATION CONTINUE;BAC PROFESSIONNEL;BAC PRO SERV;BAC PRO 33403 COMMERC. SERVICES EN RESTAURATION;1;1;1;0;0;0;0;1;0;0;0;0;1;0
11482.0;2022;28;LA REUNION;MASCULIN;SCOLAIRE;BAC PROFESSIONNEL;BAC PRO SERV;BAC PRO 33002 SERVICES DE PROXIMITE  VIE LOCAL;12;12;10;1;1;0;1;10;0;1;3;4;2;2
21757.0;2023;12;NANCY-METZ;FEMININ;INDIVIDUEL;BAC TECHNOLOGIQUE;BAC ST2S;BAC ST2S SCIENCES & TECHNO. SANTE & SOCIAL;15;13;1;9;3;3;0;4;0;0;0;0;4;9
11483.0;2022;28;LA REUNION;MASCULIN;SCOLAIRE;BAC PROFESSIONNEL;BAC PRO SERV;BAC PRO 33003 ACC.SOINS-S.PERS. OPT.A DOMICILE;1;1;1;0;0;0;0;1;0;1;0;0;0;0
21759.0;2023;12;NANCY-METZ;FEMININ;INDIVIDUEL;BAC TECHNOLOGIQUE;BAC STL;BAC STL BIOCHIM.-BIOLOGIE-BIOTECHNOL.;1;0;0;0;0;0;0;0;0;0;0;0;0;0
11493.0;2022;28;LA REUNION;MASCULIN;SCOLAIRE;BAC TECHNOLOGIQUE;BAC STD2A;BAC STD2A SCIENCES & TECHNO. DESIGN-ARTS APPLIQUES;2;2;2;0;0;0;0;2;0;1;1;0;0;0
21762.0;2023;12;NANCY-METZ;FEMININ;INDIVIDUEL;BAC TECHNOLOGIQUE;BAC STMG;BAC STMG RESSOURCES HUMAINES ET COMMUNICATION;4;4;0;0;4;3;1;3;0;0;0;0;3;1
11495.0;2022;28;LA REUNION;MASCULIN;SCOLAIRE;BAC TECHNOLOGIQUE;BAC STI2D;BAC STI2D ARCHITECTURE ET CONSTRUCTION;119;119;93;3;23;20;3;113;0;1;11;34;67;6
21766.0;2023;12;NANCY-METZ;FEMININ;SCOLAIRE;BAC PROFESSIONNEL;BAC PRO PROD;BAC PRO 22004 PROC. CHIMIE EAU PAPIERS-CARTONS;3;3;3;0;0;0;0;3;0;0;0;0;3;0
11498.0;2022;28;LA REUNION;MASCULIN;SCOLAIRE;BAC TECHNOLOGIQUE;BAC STI2D;BAC STI2D SYSTÈME D'INFORMATION  ET NUMERIQUE;155;155;135;6;14;11;3;146;0;5;18;51;72;9
21770.0;2023;12;NANCY-METZ;FEMININ;SCOLAIRE;BAC PROFESSIONNEL;BAC PRO PROD;BAC PRO 22503 PLASTIQUES ET COMPOSITES;1;1;1;0;0;0;0;1;0;0;0;1;0;0
11499.0;2022;28;LA REUNION;MASCULIN;SCOLAIRE;BAC TECHNOLOGIQUE;BAC STL;BAC STL BIOCHIM.-BIOLOGIE-BIOTECHNOL.;46;46;35;3;8;6;2;41;0;1;7;7;26;5
21777.0;2023;12;NANCY-METZ;FEMININ;SCOLAIRE;BAC PROFESSIONNEL;BAC PRO PROD;BAC PRO 24202 ARTIS.& MET.ART : TAPIS.D'AMEUBL;6;6;4;2;0;0;0;4;0;0;1;3;0;2
11504.0;2022;28;LA REUNION;MASCULIN;SCOLAIRE;BAC TECHNOLOGIQUE;BAC STMG;BAC STMG SYSTEMES D'INFORMATION DE GESTION;39;39;24;4;11;6;5;30;0;0;6;5;19;9
21780.0;2023;12;NANCY-METZ;FEMININ;SCOLAIRE;BAC PROFESSIONNEL;BAC PRO PROD;BAC PRO 25106 TECHNICIEN D'USINAGE;2;2;1;1;0;0;0;1;0;0;0;0;1;1
11508.0;2022;09;LILLE;FEMININ;APPRENTISSAGE;BAC PROFESSIONNEL;BAC PRO PROD;BAC PRO 22704 TECHN. MAINT. SYST.ENERG.CLIMATI;1;1;1;0;0;0;0;1;0;1;0;0;0;0
21784.0;2023;12;NANCY-METZ;FEMININ;SCOLAIRE;BAC PROFESSIONNEL;BAC PRO PROD;BAC PRO 25408 REPARATION DES CARROSSERIES;5;5;5;0;0;0;0;5;0;0;4;1;0;0
11517.0;2022;09;LILLE;FEMININ;APPRENTISSAGE;BAC PROFESSIONNEL;BAC PRO PROD;BAC PRO 25216 MAINT.VEHIC.OPTC MOTOCYCLES;1;1;1;0;0;0;0;1;0;0;0;0;1;0
21786.0;2023;12;NANCY-METZ;FEMININ;SCOLAIRE;BAC PROFESSIONNEL;BAC PRO PROD;BAC PRO 25510 METIERS ELECT. ENVIRON. CONNECTES;6;6;4;1;1;1;0;5;0;0;1;2;2;1
11518.0;2022;09;LILLE;FEMININ;APPRENTISSAGE;BAC PROFESSIONNEL;BAC PRO PROD;BAC PRO 25303 AERONAUTIQUE OPTION SYSTEMES;3;3;3;0;0;0;0;3;0;1;1;1;0;0
21790.0;2023;12;NANCY-METZ;FEMININ;SCOLAIRE;BAC PROFESSIONNEL;BAC PRO PROD;BAC PRO AG 21004 CGEA;25;24;16;8;0;0;0;16;0;1;2;7;6;8
11520.0;2022;09;LILLE;FEMININ;APPRENTISSAGE;BAC PROFESSIONNEL;BAC PRO PROD;BAC PRO 25411 TECH.CHAUDRONNERIE INDUSTRIELLE;4;4;4;0;0;0;0;4;0;0;3;0;1;0
21791.0;2023;12;NANCY-METZ;FEMININ;SCOLAIRE;BAC PROFESSIONNEL;BAC PRO PROD;BAC PRO AG 21114 CONDUITE PRODUCTIONS HORTICOLES;2;1;0;1;0;0;0;0;0;0;0;0;0;1
11532.0;2022;09;LILLE;FEMININ;APPRENTISSAGE;BAC PROFESSIONNEL;BAC PRO SERV;BAC PRO 31214 MET.COM.VEN.OP.B PR.CL.VA.OF.COM.;1;1;1;0;0;0;0;1;0;0;0;0;1;0
21795.0;2023;12;NANCY-METZ;FEMININ;SCOLAIRE;BAC PROFESSIONNEL;BAC PRO PROD;BAC PRO AG 21405 AMENAGEMENTS PAYSAGERS;4;4;3;1;0;0;0;3;0;0;1;1;1;1
11539.0;2022;09;LILLE;FEMININ;ENSEIGNEMENT A DISTANCE;BAC PROFESSIONNEL;BAC PRO SERV;BAC PRO 31213 MET.COM.VEN.OP.A ANI.GES.ESP.COM.;2;2;2;0;0;0;0;2;0;1;0;0;1;0
21816.0;2023;12;NANCY-METZ;FEMININ;SCOLAIRE;BAC PROFESSIONNEL;BAC PRO SERV;BAC PRO 34303 GEST. POLLUTIONS PROTEC. ENVIRON.;2;2;1;1;0;0;0;1;0;1;0;0;0;1
11541.0;2022;09;LILLE;FEMININ;ENSEIGNEMENT A DISTANCE;BAC PROFESSIONNEL;BAC PRO SERV;BAC PRO 33004 ACC.SOINS-S.PERS. OPT.EN STRUCTUR;6;3;2;1;0;0;0;2;0;0;0;2;0;1
21820.0;2023;12;NANCY-METZ;FEMININ;SCOLAIRE;BAC TECHNOLOGIQUE;BAC S2TMD;BAC S2TMD DANSE;8;8;8;0;0;0;0;8;0;4;1;2;1;0
11542.0;2022;09;LILLE;FEMININ;ENSEIGNEMENT A DISTANCE;BAC PROFESSIONNEL;BAC PRO SERV;BAC PRO 33603 ESTHETIQUE COSMETIQUE PARFUMERIE;3;2;0;2;0;0;0;0;0;0;0;0;0;2
21829.0;2023;12;NANCY-METZ;FEMININ;SCOLAIRE;BAC TECHNOLOGIQUE;BAC STI2D;BAC STI2D INNOVATION TECHNO.  ET ECO CONCEPTION;21;21;18;0;3;3;0;21;1;0;3;8;9;0
11546.0;2022;09;LILLE;FEMININ;ENSEIGNEMENT A DISTANCE;BAC TECHNOLOGIQUE;BAC STMG;BAC STMG RESSOURCES HUMAINES ET COMMUNICATION;5;5;4;0;1;0;1;4;0;0;1;0;3;1
21837.0;2023;12;NANCY-METZ;MASCULIN;APPRENTISSAGE;BAC PROFESSIONNEL;BAC PRO PROD;BAC PRO 20102 PILOTE DE LIGNE DE PRODUCTION;6;6;5;0;1;1;0;6;0;1;2;2;1;0
11548.0;2022;09;LILLE;FEMININ;FORMATION CONTINUE;BAC PROFESSIONNEL;BAC PRO PROD;BAC PRO 25510 METIERS ELECT. ENVIRON. CONNECTES;1;1;1;0;0;0;0;1;0;1;0;0;0;0
21845.0;2023;12;NANCY-METZ;MASCULIN;APPRENTISSAGE;BAC PROFESSIONNEL;BAC PRO PROD;BAC PRO 23303 MENUISERIE ALUMINIUM-VERRE;1;1;1;0;0;0;0;1;0;0;0;0;1;0
11555.0;2022;09;LILLE;FEMININ;INDIVIDUEL;BAC GENERAL;BAC GENERAL;BAC GENE 10019 BAC GENERAL;90;43;16;15;12;7;5;23;0;3;2;3;15;20
21854.0;2023;12;NANCY-METZ;MASCULIN;APPRENTISSAGE;BAC PROFESSIONNEL;BAC PRO PROD;BAC PRO 25214 MAINT.VEHIC.OPTA VOIT.PARTICUL.;127;126;100;18;8;4;4;104;0;16;24;33;31;22
11561.0;2022;09;LILLE;FEMININ;INDIVIDUEL;BAC PROFESSIONNEL;BAC PRO SERV;BAC PRO 30001 GESTION-ADMINISTRATION;8;3;0;2;1;1;0;1;0;0;0;0;1;2
21856.0;2023;12;NANCY-METZ;MASCULIN;APPRENTISSAGE;BAC PROFESSIONNEL;BAC PRO PROD;BAC PRO 25216 MAINT.VEHIC.OPTC MOTOCYCLES;15;15;13;2;0;0;0;13;0;7;3;3;0;2
11564.0;2022;09;LILLE;FEMININ;INDIVIDUEL;BAC PROFESSIONNEL;BAC PRO SERV;BAC PRO 31214 MET.COM.VEN.OP.B PR.CL.VA.OF.COM.;1;0;0;0;0;0;0;0;0;0;0;0;0;0
21860.0;2023;12;NANCY-METZ;MASCULIN;APPRENTISSAGE;BAC PROFESSIONNEL;BAC PRO PROD;BAC PRO 25302 AERONAUTIQUE OPTION AVIONIQUE;2;2;2;0;0;0;0;2;0;1;1;0;0;0
11572.0;2022;09;LILLE;FEMININ;INDIVIDUEL;BAC TECHNOLOGIQUE;BAC STMG;BAC STMG GESTION ET FINANCE;3;0;0;0;0;0;0;0;0;0;0;0;0;0
21862.0;2023;12;NANCY-METZ;MASCULIN;APPRENTISSAGE;BAC PROFESSIONNEL;BAC PRO PROD;BAC PRO 25406 OUVRAGES DU BATIMENT METALLERIE;2;2;2;0;0;0;0;2;0;0;0;2;0;0
11585.0;2022;09;LILLE;FEMININ;SCOLAIRE;BAC PROFESSIONNEL;BAC PRO PROD;BAC PRO 23005 TECHN. ETUDES BAT B ASSIST.ARCHI.;11;11;10;1;0;0;0;10;0;2;3;3;2;1
21863.0;2023;12;NANCY-METZ;MASCULIN;APPRENTISSAGE;BAC PROFESSIONNEL;BAC PRO PROD;BAC PRO 25408 REPARATION DES CARROSSERIES;25;25;19;2;4;3;1;22;0;1;6;7;8;3
11588.0;2022;09;LILLE;FEMININ;SCOLAIRE;BAC PROFESSIONNEL;BAC PRO PROD;BAC PRO 23205 INTERV. SUR PATRIMOINE BATI OPT.A;1;1;0;0;1;1;0;1;0;0;0;0;1;0
21867.0;2023;12;NANCY-METZ;MASCULIN;APPRENTISSAGE;BAC PROFESSIONNEL;BAC PRO PROD;BAC PRO 25510 METIERS ELECT. ENVIRON. CONNECTES;83;81;62;12;7;5;2;67;0;7;18;21;21;14
11595.0;2022;09;LILLE;FEMININ;SCOLAIRE;BAC PROFESSIONNEL;BAC PRO PROD;BAC PRO 25106 TECHNICIEN D'USINAGE;3;3;2;1;0;0;0;2;0;0;1;0;1;1
21869.0;2023;12;NANCY-METZ;MASCULIN;APPRENTISSAGE;BAC PROFESSIONNEL;BAC PRO PROD;BAC PRO 25515 SYST.NUM.OPT.C RES.INF.SYST.COMM.;3;3;3;0;0;0;0;3;0;0;1;2;0;0
11600.0;2022;09;LILLE;FEMININ;SCOLAIRE;BAC PROFESSIONNEL;BAC PRO PROD;BAC PRO 25406 OUVRAGES DU BATIMENT METALLERIE;1;1;0;1;0;0;0;0;0;0;0;0;0;1
21875.0;2023;12;NANCY-METZ;MASCULIN;APPRENTISSAGE;BAC PROFESSIONNEL;BAC PRO PROD;BAC PRO AG 21211 COND GEST ENTR HIPPIQUE;2;2;2;0;0;0;0;2;0;0;1;0;1;0
11606.0;2022;09;LILLE;FEMININ;SCOLAIRE;BAC PROFESSIONNEL;BAC PRO PROD;BAC PRO AG 21004 CGEA;67;66;54;12;0;0;0;54;0;1;6;9;38;12
21880.0;2023;12;NANCY-METZ;MASCULIN;APPRENTISSAGE;BAC PROFESSIONNEL;BAC PRO SERV;BAC PRO 30004 ASSISTANC.GEST.ORGANIS.ACTIVITES;5;5;4;0;1;1;0;5;0;0;2;1;2;0
11607.0;2022;09;LILLE;FEMININ;SCOLAIRE;BAC PROFESSIONNEL;BAC PRO PROD;BAC PRO AG 21114 CONDUITE PRODUCTIONS HORTICOLES;6;6;6;0;0;0;0;6;0;0;0;3;3;0
21896.0;2023;12;NANCY-METZ;MASCULIN;FORMATION CONTINUE;BAC PROFESSIONNEL;BAC PRO PROD;BAC PRO 22704 TECHN. MAINT. SYST.ENERG.CLIMATI;7;7;7;0;0;0;0;7;0;3;3;1;0;0
11610.0;2022;09;LILLE;FEMININ;SCOLAIRE;BAC PROFESSIONNEL;BAC PRO PROD;BAC PRO AG 21211 COND GEST ENTR HIPPIQUE;24;21;20;1;0;0;0;20;0;0;2;10;8;1
21915.0;2023;12;NANCY-METZ;MASCULIN;INDIVIDUEL;BAC PROFESSIONNEL;BAC PRO PROD;BAC PRO AG 21302 GEST MILIEUX NATURELS FAUNE;1;0;0;0;0;0;0;0;0;0;0;0;0;0
11634.0;2022;09;LILLE;FEMININ;SCOLAIRE;BAC PROFESSIONNEL;BAC PRO SERV;BAC PRO 33403 COMMERC. SERVICES EN RESTAURATION;126;126;91;29;6;2;4;93;0;6;26;26;35;33
21925.0;2023;12;NANCY-METZ;MASCULIN;INDIVIDUEL;BAC TECHNOLOGIQUE;BAC STMG;BAC STMG GESTION ET FINANCE;7;7;2;5;0;0;0;2;0;0;0;1;1;5
11636.0;2022;09;LILLE;FEMININ;SCOLAIRE;BAC PROFESSIONNEL;BAC PRO SERV;BAC PRO 33603 ESTHETIQUE COSMETIQUE PARFUMERIE;212;212;181;28;3;3;0;184;0;7;28;80;69;28
21927.0;2023;12;NANCY-METZ;MASCULIN;INDIVIDUEL;BAC TECHNOLOGIQUE;BAC STMG;BAC STMG RESSOURCES HUMAINES ET COMMUNICATION;12;12;8;2;2;2;0;10;0;0;0;2;8;2
11639.0;2022;09;LILLE;FEMININ;SCOLAIRE;BAC PROFESSIONNEL;BAC PRO SERV;BAC PRO AG 33002 SERV PERS TERRIT;162;160;149;11;0;0;0;149;0;5;26;48;70;11
21929.0;2023;12;NANCY-METZ;MASCULIN;SCOLAIRE;BAC GENERAL;BAC GENERAL;BAC GENE 10019 BAC GENERAL;5069;5069;4602;70;397;287;110;4889;78;550;1039;1524;1698;180
11653.0;2022;09;LILLE;FEMININ;SCOLAIRE;BAC TECHNOLOGIQUE;BAC STMG;BAC STMG MERCATIQUE (MARKETING);790;790;615;68;107;82;25;697;1;14;94;245;343;93
21933.0;2023;12;NANCY-METZ;MASCULIN;SCOLAIRE;BAC PROFESSIONNEL;BAC PRO PROD;BAC PRO 22105 BOULANGER-PÂTISSIER;71;71;56;7;8;6;2;62;0;1;13;19;29;9
11655.0;2022;09;LILLE;FEMININ;SCOLAIRE;BAC TECHNOLOGIQUE;BAC STMG;BAC STMG SYSTEMES D'INFORMATION DE GESTION;3;3;3;0;0;0;0;3;0;0;2;0;1;0
21934.0;2023;12;NANCY-METZ;MASCULIN;SCOLAIRE;BAC PROFESSIONNEL;BAC PRO PROD;BAC PRO 22106 CUISINE;156;156;119;25;12;11;1;130;0;6;23;44;57;26
11678.0;2022;09;LILLE;MASCULIN;APPRENTISSAGE;BAC PROFESSIONNEL;BAC PRO PROD;BAC PRO 25219 MAINT.MATERIELS OPT.A AGRICOLES;23;23;20;2;1;0;1;20;0;0;1;7;12;3
21941.0;2023;12;NANCY-METZ;MASCULIN;SCOLAIRE;BAC PROFESSIONNEL;BAC PRO PROD;BAC PRO 23005 TECHN. ETUDES BAT B ASSIST.ARCHI.;25;25;13;11;1;1;0;14;0;0;0;4;10;11
11691.0;2022;09;LILLE;MASCULIN;APPRENTISSAGE;BAC PROFESSIONNEL;BAC PRO PROD;BAC PRO AG 21114 CONDUITE PRODUCTIONS HORTICOLES;5;5;4;1;0;0;0;4;0;0;1;2;1;1
21945.0;2023;12;NANCY-METZ;MASCULIN;SCOLAIRE;BAC PROFESSIONNEL;BAC PRO PROD;BAC PRO 23208 METIERS ET ARTS DE LA PIERRE;5;5;5;0;0;0;0;5;0;0;2;3;0;0
11692.0;2022;09;LILLE;MASCULIN;APPRENTISSAGE;BAC PROFESSIONNEL;BAC PRO PROD;BAC PRO AG 21203 TECHN CONSEIL DE VENTE ANIMAL;10;10;10;0;0;0;0;10;0;0;2;4;4;0
21953.0;2023;12;NANCY-METZ;MASCULIN;SCOLAIRE;BAC PROFESSIONNEL;BAC PRO PROD;BAC PRO 25006 MICROTECHNIQUES;21;21;18;2;1;1;0;19;0;1;6;7;5;2
11698.0;2022;09;LILLE;MASCULIN;APPRENTISSAGE;BAC PROFESSIONNEL;BAC PRO SERV;BAC PRO 31212 METIERS DE L'ACCUEIL;1;1;0;1;0;0;0;0;0;0;0;0;0;1
21958.0;2023;12;NANCY-METZ;MASCULIN;SCOLAIRE;BAC PROFESSIONNEL;BAC PRO PROD;BAC PRO 25216 MAINT.VEHIC.OPTC MOTOCYCLES;24;24;16;5;3;3;0;19;0;0;6;5;8;5
11721.0;2022;09;LILLE;MASCULIN;FORMATION CONTINUE;BAC PROFESSIONNEL;BAC PRO PROD;BAC PRO 25220 MAINT.MATERIELS OPT.B TP MANUT.;11;11;11;0;0;0;0;11;0;1;1;3;6;0
21963.0;2023;12;NANCY-METZ;MASCULIN;SCOLAIRE;BAC PROFESSIONNEL;BAC PRO PROD;BAC PRO 25303 AERONAUTIQUE OPTION SYSTEMES;10;10;10;0;0;0;0;10;0;2;5;2;1;0
11722.0;2022;09;LILLE;MASCULIN;FORMATION CONTINUE;BAC PROFESSIONNEL;BAC PRO PROD;BAC PRO 25411 TECH.CHAUDRONNERIE INDUSTRIELLE;1;1;1;0;0;0;0;1;0;1;0;0;0;0
21966.0;2023;12;NANCY-METZ;MASCULIN;SCOLAIRE;BAC PROFESSIONNEL;BAC PRO PROD;BAC PRO 25410 CONSTRUCTION DES CARROSSERIES;6;6;4;2;0;0;0;4;0;0;0;0;4;2
11725.0;2022;09;LILLE;MASCULIN;FORMATION CONTINUE;BAC PROFESSIONNEL;BAC PRO SERV;BAC PRO 30001 GESTION-ADMINISTRATION;6;6;4;2;0;0;0;4;0;0;1;1;2;2
21967.0;2023;12;NANCY-METZ;MASCULIN;SCOLAIRE;BAC PROFESSIONNEL;BAC PRO PROD;BAC PRO 25411 TECH.CHAUDRONNERIE INDUSTRIELLE;75;75;47;21;7;7;0;54;0;3;9;18;24;21
11726.0;2022;09;LILLE;MASCULIN;FORMATION CONTINUE;BAC PROFESSIONNEL;BAC PRO SERV;BAC PRO 31108 TRANSPORT;9;8;7;1;0;0;0;7;0;1;3;2;1;1
21968.0;2023;12;NANCY-METZ;MASCULIN;SCOLAIRE;BAC PROFESSIONNEL;BAC PRO PROD;BAC PRO 25509 TECHNIC. FROID CONDITIONNEMT AIR;47;45;34;9;2;2;0;36;0;1;7;8;20;9
11739.0;2022;09;LILLE;MASCULIN;INDIVIDUEL;BAC PROFESSIONNEL;BAC PRO PROD;BAC PRO 25515 SYST.NUM.OPT.C RES.INF.SYST.COMM.;1;1;1;0;0;0;0;1;0;0;0;0;1;0
21989.0;2023;12;NANCY-METZ;MASCULIN;SCOLAIRE;BAC PROFESSIONNEL;BAC PRO SERV;BAC PRO 31214 MET.COM.VEN.OP.B PR.CL.VA.OF.COM.;246;246;196;34;16;12;4;208;0;11;43;68;86;38
11742.0;2022;09;LILLE;MASCULIN;INDIVIDUEL;BAC PROFESSIONNEL;BAC PRO PROD;BAC PRO AG 21211 COND GEST ENTR HIPPIQUE;1;0;0;0;0;0;0;0;0;0;0;0;0;0
21990.0;2023;12;NANCY-METZ;MASCULIN;SCOLAIRE;BAC PROFESSIONNEL;BAC PRO SERV;BAC PRO 32207 REAL.PR.IMPR.PLURI.OPTA.PR.GRAPH.;16;16;16;0;0;0;0;16;0;2;3;6;5;0
11749.0;2022;09;LILLE;MASCULIN;INDIVIDUEL;BAC PROFESSIONNEL;BAC PRO SERV;BAC PRO 32207 REAL.PR.IMPR.PLURI.OPTA.PR.GRAPH.;1;1;1;0;0;0;0;1;0;0;0;0;1;0
22001.0;2023;12;NANCY-METZ;MASCULIN;SCOLAIRE;BAC PROFESSIONNEL;BAC PRO SERV;BAC PRO 33604 METIERS DE LA COIFFURE;5;5;4;1;0;0;0;4;0;0;3;1;0;1
11750.0;2022;09;LILLE;MASCULIN;INDIVIDUEL;BAC PROFESSIONNEL;BAC PRO SERV;BAC PRO 32304 PHOTOGRAPHIE;1;0;0;0;0;0;0;0;0;0;0;0;0;0
22018.0;2023;12;NANCY-METZ;MASCULIN;SCOLAIRE;BAC TECHNOLOGIQUE;BAC STL;BAC STL SCIENCES PHYSIQUES CHIMIQUES  EN LABORAT.;70;70;60;0;10;7;3;67;0;6;13;20;28;3
11757.0;2022;09;LILLE;MASCULIN;INDIVIDUEL;BAC TECHNOLOGIQUE;BAC STMG;BAC STMG MERCATIQUE (MARKETING);17;9;1;3;5;5;0;6;0;0;0;0;6;3
22024.0;2023;17;NANTES;FEMININ;APPRENTISSAGE;BAC PROFESSIONNEL;BAC PRO PROD;BAC PRO 22106 CUISINE;18;18;17;1;0;0;0;17;0;0;7;5;5;1
11758.0;2022;09;LILLE;MASCULIN;INDIVIDUEL;BAC TECHNOLOGIQUE;BAC STMG;BAC STMG RESSOURCES HUMAINES ET COMMUNICATION;10;1;1;0;0;0;0;1;0;0;0;1;0;0
22025.0;2023;17;NANTES;FEMININ;APPRENTISSAGE;BAC PROFESSIONNEL;BAC PRO PROD;BAC PRO 22302 Traitement des matériaux;1;1;1;0;0;0;0;1;0;0;0;1;0;0
11760.0;2022;09;LILLE;MASCULIN;SCOLAIRE;BAC PROFESSIONNEL;BAC PRO PROD;BACPRO 20002 ETUD.DEFINITION PRDTS INDUSTRIEL;18;18;11;7;0;0;0;11;0;0;1;3;7;7
22033.0;2023;17;NANTES;FEMININ;APPRENTISSAGE;BAC PROFESSIONNEL;BAC PRO PROD;BAC PRO 24302 METIERS DU CUIR : MAROQUINERIE;3;3;3;0;0;0;0;3;0;1;2;0;0;0
11763.0;2022;09;LILLE;MASCULIN;SCOLAIRE;BAC PROFESSIONNEL;BAC PRO PROD;BAC PRO 22104 BOUCHER CHARCUTIER TRAITEUR;2;2;2;0;0;0;0;2;0;0;0;1;1;0
22034.0;2023;17;NANTES;FEMININ;APPRENTISSAGE;BAC PROFESSIONNEL;BAC PRO PROD;BAC PRO 25007 MAINTENANCE EQUIPEMENTS INDUST.;4;4;4;0;0;0;0;4;0;0;2;2;0;0
11765.0;2022;09;LILLE;MASCULIN;SCOLAIRE;BAC PROFESSIONNEL;BAC PRO PROD;BAC PRO 22106 CUISINE;242;241;199;32;10;7;3;206;0;6;43;78;79;35
22036.0;2023;17;NANTES;FEMININ;APPRENTISSAGE;BAC PROFESSIONNEL;BAC PRO PROD;BAC PRO 25214 MAINT.VEHIC.OPTA VOIT.PARTICUL.;8;8;7;1;0;0;0;7;0;0;2;3;2;1
11767.0;2022;09;LILLE;MASCULIN;SCOLAIRE;BAC PROFESSIONNEL;BAC PRO PROD;BAC PRO 22403 ARTS.& MET.ART:MET.ENSEIGN SIGNA;11;11;8;2;1;0;1;8;0;0;3;4;1;3
22040.0;2023;17;NANTES;FEMININ;APPRENTISSAGE;BAC PROFESSIONNEL;BAC PRO PROD;BAC PRO 25221 MAINT.MATERIELS OPT.C ESP. VERTS;2;2;1;1;0;0;0;1;0;0;1;0;0;1
11773.0;2022;09;LILLE;MASCULIN;SCOLAIRE;BAC PROFESSIONNEL;BAC PRO PROD;BAC PRO 23005 TECHN. ETUDES BAT B ASSIST.ARCHI.;17;17;10;7;0;0;0;10;0;1;1;5;3;7
22055.0;2023;17;NANTES;FEMININ;APPRENTISSAGE;BAC PROFESSIONNEL;BAC PRO PROD;BAC PRO AG 21407 TEC CONS VTE UNIVERS JARDINERIE;1;1;1;0;0;0;0;1;0;0;0;0;1;0
11781.0;2022;09;LILLE;MASCULIN;SCOLAIRE;BAC PROFESSIONNEL;BAC PRO PROD;BAC PRO 23405 TECHNICIEN MENUISIER AGENCEUR;107;105;80;23;2;1;1;81;0;1;9;36;35;24
22061.0;2023;17;NANTES;FEMININ;APPRENTISSAGE;BAC PROFESSIONNEL;BAC PRO SERV;BAC PRO 31213 MET.COM.VEN.OP.A ANI.GES.ESP.COM.;327;322;260;44;18;13;5;273;0;18;60;106;89;49
11783.0;2022;09;LILLE;MASCULIN;SCOLAIRE;BAC PROFESSIONNEL;BAC PRO PROD;BAC PRO 23408 Etude et réalisation d'agencement;7;7;7;0;0;0;0;7;0;0;3;0;4;0
22062.0;2023;17;NANTES;FEMININ;APPRENTISSAGE;BAC PROFESSIONNEL;BAC PRO SERV;BAC PRO 31214 MET.COM.VEN.OP.B PR.CL.VA.OF.COM.;1;1;1;0;0;0;0;1;0;0;1;0;0;0
11787.0;2022;09;LILLE;MASCULIN;SCOLAIRE;BAC PROFESSIONNEL;BAC PRO PROD;BAC PRO 25214 MAINT.VEHIC.OPTA VOIT.PARTICUL.;444;440;303;111;26;23;3;326;0;7;57;111;151;114
22063.0;2023;17;NANTES;FEMININ;APPRENTISSAGE;BAC PROFESSIONNEL;BAC PRO SERV;BAC PRO 32206 FACONNAGE PRODTS IMPRIMES ROUTAGE;1;1;1;0;0;0;0;1;0;0;1;0;0;0
11788.0;2022;09;LILLE;MASCULIN;SCOLAIRE;BAC PROFESSIONNEL;BAC PRO PROD;BAC PRO 25215 MAINT.VEHIC.OPTB VEHIC.TRANS.ROUT;43;43;33;7;3;2;1;35;0;1;9;9;16;8
22065.0;2023;17;NANTES;FEMININ;APPRENTISSAGE;BAC PROFESSIONNEL;BAC PRO SERV;BAC PRO 32208 REAL.PR.IMPR.PLURI.OPTB.PR.IMPR.;1;1;1;0;0;0;0;1;0;1;0;0;0;0
11789.0;2022;09;LILLE;MASCULIN;SCOLAIRE;BAC PROFESSIONNEL;BAC PRO PROD;BAC PRO 25216 MAINT.VEHIC.OPTC MOTOCYCLES;31;31;23;8;0;0;0;23;0;2;3;11;7;8
22067.0;2023;17;NANTES;FEMININ;APPRENTISSAGE;BAC PROFESSIONNEL;BAC PRO SERV;BAC PRO 33004 ACC.SOINS-S.PERS. OPT.EN STRUCTUR;13;13;13;0;0;0;0;13;0;0;4;6;3;0
11790.0;2022;09;LILLE;MASCULIN;SCOLAIRE;BAC PROFESSIONNEL;BAC PRO PROD;BAC PRO 25219 MAINT.MATERIELS OPT.A AGRICOLES;42;42;36;5;1;1;0;37;0;5;11;14;7;5
22070.0;2023;17;NANTES;FEMININ;APPRENTISSAGE;BAC PROFESSIONNEL;BAC PRO SERV;BAC PRO 33603 ESTHETIQUE COSMETIQUE PARFUMERIE;12;12;11;1;0;0;0;11;0;2;4;3;2;1
11794.0;2022;09;LILLE;MASCULIN;SCOLAIRE;BAC PROFESSIONNEL;BAC PRO PROD;BAC PRO 25408 REPARATION DES CARROSSERIES;186;186;124;42;20;16;4;140;0;4;24;47;65;46
22078.0;2023;17;NANTES;FEMININ;ENSEIGNEMENT A DISTANCE;BAC PROFESSIONNEL;BAC PRO SERV;BAC PRO 31214 MET.COM.VEN.OP.B PR.CL.VA.OF.COM.;2;2;2;0;0;0;0;2;0;0;0;0;2;0
11798.0;2022;09;LILLE;MASCULIN;SCOLAIRE;BAC PROFESSIONNEL;BAC PRO PROD;BAC PRO 25510 METIERS ELECT. ENVIRON. CONNECTES;848;847;667;128;52;29;23;696;0;57;139;266;234;151
22092.0;2023;17;NANTES;FEMININ;INDIVIDUEL;BAC GENERAL;BAC GENERAL;BAC GENE 10019 BAC GENERAL;100;99;51;36;12;7;5;58;2;5;10;18;23;41
11807.0;2022;09;LILLE;MASCULIN;SCOLAIRE;BAC PROFESSIONNEL;BAC PRO PROD;BAC PRO AG 21210 COND GEST ENTR CANIN ET FELIN;9;9;7;2;0;0;0;7;0;1;2;2;2;2
22093.0;2023;17;NANTES;FEMININ;INDIVIDUEL;BAC PROFESSIONNEL;BAC PRO PROD;BAC PRO 22106 CUISINE;2;2;1;1;0;0;0;1;0;0;0;0;1;1
11808.0;2022;09;LILLE;MASCULIN;SCOLAIRE;BAC PROFESSIONNEL;BAC PRO PROD;BAC PRO AG 21211 COND GEST ENTR HIPPIQUE;4;4;4;0;0;0;0;4;0;0;0;3;1;0
22094.0;2023;17;NANTES;FEMININ;INDIVIDUEL;BAC PROFESSIONNEL;BAC PRO PROD;BAC PRO 24203 METIERS DE LA MODE - VÊTEMENT;2;2;0;2;0;0;0;0;0;0;0;0;0;2
11809.0;2022;09;LILLE;MASCULIN;SCOLAIRE;BAC PROFESSIONNEL;BAC PRO PROD;BAC PRO AG 21302 GEST MILIEUX NATURELS FAUNE;27;27;24;3;0;0;0;24;0;0;2;4;18;3
22096.0;2023;17;NANTES;FEMININ;INDIVIDUEL;BAC PROFESSIONNEL;BAC PRO PROD;BAC PRO AG 21114 CONDUITE PRODUCTIONS HORTICOLES;3;3;2;1;0;0;0;2;0;0;0;0;2;1
11810.0;2022;09;LILLE;MASCULIN;SCOLAIRE;BAC PROFESSIONNEL;BAC PRO PROD;BAC PRO AG 21303 FORET;8;8;7;1;0;0;0;7;0;0;0;3;4;1
22100.0;2023;17;NANTES;FEMININ;INDIVIDUEL;BAC PROFESSIONNEL;BAC PRO SERV;BAC PRO 30004 ASSISTANC.GEST.ORGANIS.ACTIVITES;7;3;1;2;0;0;0;1;0;0;0;0;1;2
11811.0;2022;09;LILLE;MASCULIN;SCOLAIRE;BAC PROFESSIONNEL;BAC PRO PROD;BAC PRO AG 21405 AMENAGEMENTS PAYSAGERS;100;97;86;11;0;0;0;86;0;2;7;33;44;11
22105.0;2023;17;NANTES;FEMININ;INDIVIDUEL;BAC PROFESSIONNEL;BAC PRO SERV;BAC PRO 33403 COMMERC. SERVICES EN RESTAURATION;1;0;0;0;0;0;0;0;0;0;0;0;0;0
11812.0;2022;09;LILLE;MASCULIN;SCOLAIRE;BAC PROFESSIONNEL;BAC PRO PROD;BAC PRO AG 21407 TEC CONS VTE UNIVERS JARDINERIE;11;11;8;3;0;0;0;8;0;0;1;4;3;3
22118.0;2023;17;NANTES;FEMININ;SCOLAIRE;BAC PROFESSIONNEL;BAC PRO PROD;BAC PRO 22105 BOULANGER-PÂTISSIER;29;29;27;2;0;0;0;27;0;5;9;11;2;2
11817.0;2022;09;LILLE;MASCULIN;SCOLAIRE;BAC PROFESSIONNEL;BAC PRO SERV;BAC PRO 31107 CONDUCT. TRANSP.ROUT.MARCHANDISES;115;115;98;17;0;0;0;98;0;11;28;46;13;17
22125.0;2023;17;NANTES;FEMININ;SCOLAIRE;BAC PROFESSIONNEL;BAC PRO PROD;BAC PRO 23203 TECHNICIEN BAT. : ORG.REAL.GROS O;1;1;1;0;0;0;0;1;0;1;0;0;0;0
11827.0;2022;09;LILLE;MASCULIN;SCOLAIRE;BAC PROFESSIONNEL;BAC PRO SERV;BAC PRO 33003 ACC.SOINS-S.PERS. OPT.A DOMICILE;18;18;15;3;0;0;0;15;0;0;3;8;4;3
22126.0;2023;17;NANTES;FEMININ;SCOLAIRE;BAC PROFESSIONNEL;BAC PRO PROD;BAC PRO 23303 MENUISERIE ALUMINIUM-VERRE;2;2;2;0;0;0;0;2;0;0;1;1;0;0
11834.0;2022;09;LILLE;MASCULIN;SCOLAIRE;BAC PROFESSIONNEL;BAC PRO SERV;BAC PRO 34304 HYGIENE PROPRETE STERILISATION;14;14;8;5;1;1;0;9;0;0;0;3;6;5
22137.0;2023;17;NANTES;FEMININ;SCOLAIRE;BAC PROFESSIONNEL;BAC PRO PROD;BAC PRO 25106 TECHNICIEN D'USINAGE;2;2;2;0;0;0;0;2;0;0;1;0;1;0
11843.0;2022;09;LILLE;MASCULIN;SCOLAIRE;BAC TECHNOLOGIQUE;BAC STI2D;BAC STI2D ARCHITECTURE ET CONSTRUCTION;321;321;269;13;39;25;14;294;1;5;40;104;144;27
22140.0;2023;17;NANTES;FEMININ;SCOLAIRE;BAC PROFESSIONNEL;BAC PRO PROD;BAC PRO 25220 MAINT.MATERIELS OPT.B TP MANUT.;1;1;0;1;0;0;0;0;0;0;0;0;0;1
11845.0;2022;09;LILLE;MASCULIN;SCOLAIRE;BAC TECHNOLOGIQUE;BAC STI2D;BAC STI2D INNOVATION TECHNO.  ET ECO CONCEPTION;381;381;328;11;42;28;14;356;1;5;41;131;178;25
22149.0;2023;17;NANTES;FEMININ;SCOLAIRE;BAC PROFESSIONNEL;BAC PRO PROD;BAC PRO AG 21004 CGEA;106;105;88;17;0;0;0;88;0;2;11;22;53;17
11846.0;2022;09;LILLE;MASCULIN;SCOLAIRE;BAC TECHNOLOGIQUE;BAC STI2D;BAC STI2D SYSTÈME D'INFORMATION  ET NUMERIQUE;506;506;410;14;82;51;31;461;0;12;69;165;215;45
22150.0;2023;17;NANTES;FEMININ;SCOLAIRE;BAC PROFESSIONNEL;BAC PRO PROD;BAC PRO AG 21113 CGEVV;1;1;1;0;0;0;0;1;0;0;0;1;0;0
11851.0;2022;09;LILLE;MASCULIN;SCOLAIRE;BAC TECHNOLOGIQUE;BAC STMG;BAC STMG RESSOURCES HUMAINES ET COMMUNICATION;538;538;351;65;122;94;28;445;0;5;25;117;298;93
22160.0;2023;17;NANTES;FEMININ;SCOLAIRE;BAC PROFESSIONNEL;BAC PRO PROD;BAC PRO AG 22108 TEC CONS VTE ALIMENTATION (PAB);97;96;84;12;0;0;0;84;0;0;9;31;44;12
11852.0;2022;09;LILLE;MASCULIN;SCOLAIRE;BAC TECHNOLOGIQUE;BAC STMG;BAC STMG SYSTEMES D'INFORMATION DE GESTION;15;15;13;0;2;1;1;14;0;1;2;6;5;1
22162.0;2023;17;NANTES;FEMININ;SCOLAIRE;BAC PROFESSIONNEL;BAC PRO SERV;BAC PRO 31106 LOGISTIQUE;16;16;15;1;0;0;0;15;0;0;2;7;6;1
11854.0;2022;22;LIMOGES;FEMININ;APPRENTISSAGE;BAC PROFESSIONNEL;BAC PRO PROD;BAC PRO 23208 METIERS ET ARTS DE LA PIERRE;1;1;1;0;0;0;0;1;0;0;0;0;1;0
22165.0;2023;17;NANTES;FEMININ;SCOLAIRE;BAC PROFESSIONNEL;BAC PRO SERV;BAC PRO 31212 METIERS DE L'ACCUEIL;273;273;220;28;25;20;5;240;0;14;59;74;93;33
11855.0;2022;22;LIMOGES;FEMININ;APPRENTISSAGE;BAC PROFESSIONNEL;BAC PRO PROD;BAC PRO 25220 MAINT.MATERIELS OPT.B TP MANUT.;1;1;1;0;0;0;0;1;0;0;0;1;0;0
22170.0;2023;17;NANTES;FEMININ;SCOLAIRE;BAC PROFESSIONNEL;BAC PRO SERV;BAC PRO 32304 PHOTOGRAPHIE;16;16;15;1;0;0;0;15;0;3;5;5;2;1
11858.0;2022;22;LIMOGES;FEMININ;APPRENTISSAGE;BAC PROFESSIONNEL;BAC PRO PROD;BAC PRO AG 21004 CGEA;1;0;0;0;0;0;0;0;0;0;0;0;0;0
22176.0;2023;17;NANTES;FEMININ;SCOLAIRE;BAC PROFESSIONNEL;BAC PRO SERV;BAC PRO 33104 TECHNICIEN EN PROTHESE DENTAIRE;22;22;20;2;0;0;0;20;0;0;9;4;7;2
11872.0;2022;22;LIMOGES;FEMININ;INDIVIDUEL;BAC PROFESSIONNEL;BAC PRO PROD;BAC PRO AG 21004 CGEA;4;4;3;1;0;0;0;3;0;0;0;0;3;1
22178.0;2023;17;NANTES;FEMININ;SCOLAIRE;BAC PROFESSIONNEL;BAC PRO SERV;BAC PRO 33603 ESTHETIQUE COSMETIQUE PARFUMERIE;198;198;177;19;2;2;0;179;0;4;16;81;78;19
11873.0;2022;22;LIMOGES;FEMININ;INDIVIDUEL;BAC PROFESSIONNEL;BAC PRO PROD;BAC PRO AG 21114 CONDUITE PRODUCTIONS HORTICOLES;2;1;1;0;0;0;0;1;0;0;0;0;1;0
22181.0;2023;17;NANTES;FEMININ;SCOLAIRE;BAC PROFESSIONNEL;BAC PRO SERV;BAC PRO 34304 HYGIENE PROPRETE STERILISATION;4;4;3;1;0;0;0;3;0;0;1;1;1;1
11876.0;2022;22;LIMOGES;FEMININ;INDIVIDUEL;BAC PROFESSIONNEL;BAC PRO SERV;BAC PRO 33002 SERVICES DE PROXIMITE  VIE LOCAL;1;0;0;0;0;0;0;0;0;0;0;0;0;0
22184.0;2023;17;NANTES;FEMININ;SCOLAIRE;BAC TECHNOLOGIQUE;BAC S2TMD;BAC S2TMD DANSE;12;12;12;0;0;0;0;12;0;4;6;1;1;0
11880.0;2022;22;LIMOGES;FEMININ;INDIVIDUEL;BAC TECHNOLOGIQUE;BAC STMG;BAC STMG RESSOURCES HUMAINES ET COMMUNICATION;2;1;0;1;0;0;0;0;0;0;0;0;0;1
22190.0;2023;17;NANTES;FEMININ;SCOLAIRE;BAC TECHNOLOGIQUE;BAC STI2D;BAC STI2D ARCHITECTURE ET CONSTRUCTION;40;40;36;1;3;1;2;37;0;1;9;17;10;3
11885.0;2022;22;LIMOGES;FEMININ;SCOLAIRE;BAC PROFESSIONNEL;BAC PRO PROD;BAC PRO 23005 TECHN. ETUDES BAT B ASSIST.ARCHI.;4;4;4;0;0;0;0;4;0;0;1;1;2;0
22193.0;2023;17;NANTES;FEMININ;SCOLAIRE;BAC TECHNOLOGIQUE;BAC STI2D;BAC STI2D SYSTÈME D'INFORMATION  ET NUMERIQUE;16;16;16;0;0;0;0;16;0;0;5;5;6;0
11891.0;2022;22;LIMOGES;FEMININ;SCOLAIRE;BAC PROFESSIONNEL;BAC PRO PROD;BAC PRO 25106 TECHNICIEN D'USINAGE;1;1;0;1;0;0;0;0;0;0;0;0;0;1
22195.0;2023;17;NANTES;FEMININ;SCOLAIRE;BAC TECHNOLOGIQUE;BAC STL;BAC STL SCIENCES PHYSIQUES CHIMIQUES  EN LABORAT.;72;72;64;2;6;4;2;68;0;6;15;25;22;4
11898.0;2022;22;LIMOGES;FEMININ;SCOLAIRE;BAC PROFESSIONNEL;BAC PRO PROD;BAC PRO AG 21004 CGEA;15;15;14;1;0;0;0;14;0;0;1;6;7;1
22205.0;2023;17;NANTES;MASCULIN;APPRENTISSAGE;BAC PROFESSIONNEL;BAC PRO PROD;BAC PRO 22503 PLASTIQUES ET COMPOSITES;6;6;5;1;0;0;0;5;0;0;1;3;1;1
11900.0;2022;22;LIMOGES;FEMININ;SCOLAIRE;BAC PROFESSIONNEL;BAC PRO PROD;BAC PRO AG 21203 TECHN CONSEIL DE VENTE ANIMAL;31;30;17;13;0;0;0;17;0;0;2;6;9;13
22206.0;2023;17;NANTES;MASCULIN;APPRENTISSAGE;BAC PROFESSIONNEL;BAC PRO PROD;BAC PRO 22703 TECHN.INSTALL.SYST.ENERG.CLIMATI;40;40;37;1;2;2;0;39;0;5;9;10;15;1
11901.0;2022;22;LIMOGES;FEMININ;SCOLAIRE;BAC PROFESSIONNEL;BAC PRO PROD;BAC PRO AG 21211 COND GEST ENTR HIPPIQUE;23;23;23;0;0;0;0;23;0;0;2;8;13;0
22227.0;2023;17;NANTES;MASCULIN;APPRENTISSAGE;BAC PROFESSIONNEL;BAC PRO PROD;BAC PRO 25221 MAINT.MATERIELS OPT.C ESP. VERTS;34;34;18;9;7;4;3;22;0;0;0;8;14;12
11903.0;2022;22;LIMOGES;FEMININ;SCOLAIRE;BAC PROFESSIONNEL;BAC PRO PROD;BAC PRO AG 21407 TEC CONS VTE UNIVERS JARDINERIE;6;6;5;1;0;0;0;5;0;1;0;0;4;1
22232.0;2023;17;NANTES;MASCULIN;APPRENTISSAGE;BAC PROFESSIONNEL;BAC PRO PROD;BAC PRO 25406 OUVRAGES DU BATIMENT METALLERIE;16;16;15;0;1;1;0;16;0;1;2;6;7;0
11915.0;2022;22;LIMOGES;FEMININ;SCOLAIRE;BAC PROFESSIONNEL;BAC PRO SERV;BAC PRO 33003 ACC.SOINS-S.PERS. OPT.A DOMICILE;50;50;38;9;3;3;0;41;0;0;7;18;16;9
22234.0;2023;17;NANTES;MASCULIN;APPRENTISSAGE;BAC PROFESSIONNEL;BAC PRO PROD;BAC PRO 25410 CONSTRUCTION DES CARROSSERIES;1;1;1;0;0;0;0;1;0;0;1;0;0;0
11920.0;2022;22;LIMOGES;FEMININ;SCOLAIRE;BAC PROFESSIONNEL;BAC PRO SERV;BAC PRO 34304 HYGIENE PROPRETE STERILISATION;3;3;2;1;0;0;0;2;0;0;0;2;0;1
22238.0;2023;17;NANTES;MASCULIN;APPRENTISSAGE;BAC PROFESSIONNEL;BAC PRO PROD;BAC PRO 25513 SYST.NUM.OPT.A SURETE SECURITE;3;3;3;0;0;0;0;3;0;0;1;1;1;0
11922.0;2022;22;LIMOGES;FEMININ;SCOLAIRE;BAC PROFESSIONNEL;BAC PRO SERV;BAC PRO AG 33002 SERV PERS TERRIT;86;82;74;8;0;0;0;74;0;2;5;26;41;8
22246.0;2023;17;NANTES;MASCULIN;APPRENTISSAGE;BAC PROFESSIONNEL;BAC PRO PROD;BAC PRO AG 21204 PROD-AQUACOLES;1;1;1;0;0;0;0;1;0;0;0;0;1;0
11927.0;2022;22;LIMOGES;FEMININ;SCOLAIRE;BAC TECHNOLOGIQUE;BAC STI2D;BAC STI2D ARCHITECTURE ET CONSTRUCTION;14;14;11;1;2;0;2;11;0;0;0;5;6;3
22247.0;2023;17;NANTES;MASCULIN;APPRENTISSAGE;BAC PROFESSIONNEL;BAC PRO PROD;BAC PRO AG 21210 COND GEST ENTR CANIN ET FELIN;2;2;1;1;0;0;0;1;0;0;0;0;1;1
11934.0;2022;22;LIMOGES;FEMININ;SCOLAIRE;BAC TECHNOLOGIQUE;BAC STMG;BAC STMG MERCATIQUE (MARKETING);150;150;116;8;26;17;9;133;0;3;17;57;56;17
22259.0;2023;17;NANTES;MASCULIN;APPRENTISSAGE;BAC PROFESSIONNEL;BAC PRO SERV;BAC PRO 32206 FACONNAGE PRODTS IMPRIMES ROUTAGE;1;1;1;0;0;0;0;1;0;0;0;0;1;0
11939.0;2022;22;LIMOGES;MASCULIN;APPRENTISSAGE;BAC PROFESSIONNEL;BAC PRO PROD;BAC PRO 22704 TECHN. MAINT. SYST.ENERG.CLIMATI;8;8;6;2;0;0;0;6;0;0;0;3;3;2
22262.0;2023;17;NANTES;MASCULIN;APPRENTISSAGE;BAC PROFESSIONNEL;BAC PRO SERV;BAC PRO 33004 ACC.SOINS-S.PERS. OPT.EN STRUCTUR;1;1;1;0;0;0;0;1;0;0;0;1;0;0
11945.0;2022;22;LIMOGES;MASCULIN;APPRENTISSAGE;BAC PROFESSIONNEL;BAC PRO PROD;BAC PRO 23304 AMENAGEMENT FINITION BATIMENT;3;3;1;1;1;1;0;2;0;0;0;0;2;1
22275.0;2023;17;NANTES;MASCULIN;ENSEIGNEMENT A DISTANCE;BAC TECHNOLOGIQUE;BAC STMG;BAC STMG MERCATIQUE (MARKETING);2;2;2;0;0;0;0;2;0;0;0;0;2;0
11951.0;2022;22;LIMOGES;MASCULIN;APPRENTISSAGE;BAC PROFESSIONNEL;BAC PRO PROD;BAC PRO 25214 MAINT.VEHIC.OPTA VOIT.PARTICUL.;26;26;22;4;0;0;0;22;0;3;5;5;9;4
22278.0;2023;17;NANTES;MASCULIN;FORMATION CONTINUE;BAC PROFESSIONNEL;BAC PRO PROD;BAC PRO 22704 TECHN. MAINT. SYST.ENERG.CLIMATI;4;4;4;0;0;0;0;4;0;3;0;1;0;0
11952.0;2022;22;LIMOGES;MASCULIN;APPRENTISSAGE;BAC PROFESSIONNEL;BAC PRO PROD;BAC PRO 25215 MAINT.VEHIC.OPTB VEHIC.TRANS.ROUT;8;8;6;2;0;0;0;6;0;1;3;2;0;2
22279.0;2023;17;NANTES;MASCULIN;FORMATION CONTINUE;BAC PROFESSIONNEL;BAC PRO PROD;BAC PRO 22705 TECHNICIEN GAZ;3;3;3;0;0;0;0;3;0;1;0;1;1;0
11957.0;2022;22;LIMOGES;MASCULIN;APPRENTISSAGE;BAC PROFESSIONNEL;BAC PRO PROD;BAC PRO 25408 REPARATION DES CARROSSERIES;10;10;10;0;0;0;0;10;0;0;4;4;2;0
22283.0;2023;17;NANTES;MASCULIN;FORMATION CONTINUE;BAC PROFESSIONNEL;BAC PRO PROD;BAC PRO 25411 TECH.CHAUDRONNERIE INDUSTRIELLE;1;1;1;0;0;0;0;1;0;0;1;0;0;0
11967.0;2022;22;LIMOGES;MASCULIN;APPRENTISSAGE;BAC PROFESSIONNEL;BAC PRO SERV;BAC PRO 34403 METIERS DE LA SECURITE;1;1;1;0;0;0;0;1;0;0;0;1;0;0
22284.0;2023;17;NANTES;MASCULIN;FORMATION CONTINUE;BAC PROFESSIONNEL;BAC PRO PROD;BAC PRO 25510 METIERS ELECT. ENVIRON. CONNECTES;12;12;11;0;1;0;1;11;0;4;4;1;2;1
11973.0;2022;22;LIMOGES;MASCULIN;FORMATION CONTINUE;BAC PROFESSIONNEL;BAC PRO PROD;BAC PRO 25510 METIERS ELECT. ENVIRON. CONNECTES;5;5;4;1;0;0;0;4;0;0;2;1;1;1
22300.0;2023;17;NANTES;MASCULIN;INDIVIDUEL;BAC PROFESSIONNEL;BAC PRO PROD;BAC PRO 25006 MICROTECHNIQUES;1;1;1;0;0;0;0;1;0;0;0;0;1;0
11981.0;2022;22;LIMOGES;MASCULIN;INDIVIDUEL;BAC PROFESSIONNEL;BAC PRO SERV;BAC PRO 30001 GESTION-ADMINISTRATION;4;2;0;2;0;0;0;0;0;0;0;0;0;2
22301.0;2023;17;NANTES;MASCULIN;INDIVIDUEL;BAC PROFESSIONNEL;BAC PRO PROD;BAC PRO 25007 MAINTENANCE EQUIPEMENTS INDUST.;6;4;2;2;0;0;0;2;0;0;0;0;2;2
11983.0;2022;22;LIMOGES;MASCULIN;INDIVIDUEL;BAC PROFESSIONNEL;BAC PRO SERV;BAC PRO 33002 SERVICES DE PROXIMITE  VIE LOCAL;1;1;1;0;0;0;0;1;0;0;0;0;1;0
22302.0;2023;17;NANTES;MASCULIN;INDIVIDUEL;BAC PROFESSIONNEL;BAC PRO PROD;BAC PRO 25106 TECHNICIEN D'USINAGE;1;1;0;1;0;0;0;0;0;0;0;0;0;1
11984.0;2022;22;LIMOGES;MASCULIN;INDIVIDUEL;BAC TECHNOLOGIQUE;BAC STI2D;BAC STI2D SYSTÈME D'INFORMATION  ET NUMERIQUE;1;0;0;0;0;0;0;0;0;0;0;0;0;0
22310.0;2023;17;NANTES;MASCULIN;INDIVIDUEL;BAC PROFESSIONNEL;BAC PRO PROD;BAC PRO AG 21114 CONDUITE PRODUCTIONS HORTICOLES;3;3;3;0;0;0;0;3;0;0;0;0;3;0
11989.0;2022;22;LIMOGES;MASCULIN;SCOLAIRE;BAC PROFESSIONNEL;BAC PRO PROD;BAC PRO 22104 BOUCHER CHARCUTIER TRAITEUR;6;6;5;1;0;0;0;5;0;2;1;0;2;1
22312.0;2023;17;NANTES;MASCULIN;INDIVIDUEL;BAC PROFESSIONNEL;BAC PRO SERV;BAC PRO 30004 ASSISTANC.GEST.ORGANIS.ACTIVITES;3;0;0;0;0;0;0;0;0;0;0;0;0;0
11995.0;2022;22;LIMOGES;MASCULIN;SCOLAIRE;BAC PROFESSIONNEL;BAC PRO PROD;BAC PRO 23102 TRAVAUX PUBLICS;108;108;98;9;1;1;0;99;0;6;31;47;15;9
22313.0;2023;17;NANTES;MASCULIN;INDIVIDUEL;BAC PROFESSIONNEL;BAC PRO SERV;BAC PRO 31106 LOGISTIQUE;2;2;1;1;0;0;0;1;0;0;0;0;1;1
12001.0;2022;22;LIMOGES;MASCULIN;SCOLAIRE;BAC PROFESSIONNEL;BAC PRO PROD;BAC PRO 25007 MAINTENANCE EQUIPEMENTS INDUST.;48;48;36;11;1;0;1;36;0;0;7;14;15;12
22314.0;2023;17;NANTES;MASCULIN;INDIVIDUEL;BAC PROFESSIONNEL;BAC PRO SERV;BAC PRO 31114 ORGANIS. TRANSPORT MARCHANDISES;1;1;0;1;0;0;0;0;0;0;0;0;0;1
12002.0;2022;22;LIMOGES;MASCULIN;SCOLAIRE;BAC PROFESSIONNEL;BAC PRO PROD;BAC PRO 25106 TECHNICIEN D'USINAGE;35;35;21;14;0;0;0;21;0;0;3;5;13;14
22316.0;2023;17;NANTES;MASCULIN;INDIVIDUEL;BAC PROFESSIONNEL;BAC PRO SERV;BAC PRO 31214 MET.COM.VEN.OP.B PR.CL.VA.OF.COM.;2;1;1;0;0;0;0;1;0;0;0;0;1;0
12006.0;2022;22;LIMOGES;MASCULIN;SCOLAIRE;BAC PROFESSIONNEL;BAC PRO PROD;BAC PRO 25215 MAINT.VEHIC.OPTB VEHIC.TRANS.ROUT;5;5;2;3;0;0;0;2;0;0;0;1;1;3
22320.0;2023;17;NANTES;MASCULIN;INDIVIDUEL;BAC TECHNOLOGIQUE;BAC ST2S;BAC ST2S SCIENCES & TECHNO. SANTE & SOCIAL;2;1;0;1;0;0;0;0;0;0;0;0;0;1
12007.0;2022;22;LIMOGES;MASCULIN;SCOLAIRE;BAC PROFESSIONNEL;BAC PRO PROD;BAC PRO 25216 MAINT.VEHIC.OPTC MOTOCYCLES;6;6;1;4;1;1;0;2;0;0;0;0;2;4
22327.0;2023;17;NANTES;MASCULIN;INDIVIDUEL;BAC TECHNOLOGIQUE;BAC STMG;BAC STMG MERCATIQUE (MARKETING);31;31;11;9;11;8;3;19;0;0;0;1;18;12
12009.0;2022;22;LIMOGES;MASCULIN;SCOLAIRE;BAC PROFESSIONNEL;BAC PRO PROD;BAC PRO 25220 MAINT.MATERIELS OPT.B TP MANUT.;27;27;27;0;0;0;0;27;0;4;8;13;2;0
22331.0;2023;17;NANTES;MASCULIN;SCOLAIRE;BAC PROFESSIONNEL;BAC PRO PROD;BAC PRO 20102 PILOTE DE LIGNE DE PRODUCTION;18;18;12;6;0;0;0;12;0;0;1;3;8;6
12010.0;2022;22;LIMOGES;MASCULIN;SCOLAIRE;BAC PROFESSIONNEL;BAC PRO PROD;BAC PRO 25221 MAINT.MATERIELS OPT.C ESP. VERTS;2;2;1;1;0;0;0;1;0;0;0;0;1;1
22335.0;2023;17;NANTES;MASCULIN;SCOLAIRE;BAC PROFESSIONNEL;BAC PRO PROD;BAC PRO 22403 ARTS.& MET.ART:MET.ENSEIGN SIGNA;8;8;8;0;0;0;0;8;0;0;1;1;6;0
12012.0;2022;22;LIMOGES;MASCULIN;SCOLAIRE;BAC PROFESSIONNEL;BAC PRO PROD;BAC PRO 25410 CONSTRUCTION DES CARROSSERIES;3;3;0;2;1;1;0;1;0;0;0;0;1;2
22339.0;2023;17;NANTES;MASCULIN;SCOLAIRE;BAC PROFESSIONNEL;BAC PRO PROD;BAC PRO 23003 ARTIS. & M.ART:MARCHANDISAGE VIS.;4;4;4;0;0;0;0;4;0;0;3;1;0;0
12014.0;2022;22;LIMOGES;MASCULIN;SCOLAIRE;BAC PROFESSIONNEL;BAC PRO PROD;BAC PRO 25509 TECHNIC. FROID CONDITIONNEMT AIR;4;4;3;1;0;0;0;3;0;0;0;2;1;1
22348.0;2023;17;NANTES;MASCULIN;SCOLAIRE;BAC PROFESSIONNEL;BAC PRO PROD;BAC PRO 23404 TECHNICIEN CONSTRUCTEUR BOIS;26;25;18;7;0;0;0;18;0;2;1;7;8;7
12017.0;2022;22;LIMOGES;MASCULIN;SCOLAIRE;BAC PROFESSIONNEL;BAC PRO PROD;BAC PRO 25515 SYST.NUM.OPT.C RES.INF.SYST.COMM.;33;33;29;4;0;0;0;29;0;3;7;12;7;4
22356.0;2023;17;NANTES;MASCULIN;SCOLAIRE;BAC PROFESSIONNEL;BAC PRO PROD;BAC PRO 25106 TECHNICIEN D'USINAGE;113;113;100;8;5;2;3;102;0;7;27;33;35;11
12020.0;2022;22;LIMOGES;MASCULIN;SCOLAIRE;BAC PROFESSIONNEL;BAC PRO PROD;BAC PRO AG 21114 CONDUITE PRODUCTIONS HORTICOLES;5;5;4;1;0;0;0;4;0;0;2;0;2;1
22359.0;2023;17;NANTES;MASCULIN;SCOLAIRE;BAC PROFESSIONNEL;BAC PRO PROD;BAC PRO 25215 MAINT.VEHIC.OPTB VEHIC.TRANS.ROUT;20;19;15;3;1;1;0;16;0;0;2;4;10;3
12028.0;2022;22;LIMOGES;MASCULIN;SCOLAIRE;BAC PROFESSIONNEL;BAC PRO SERV;BAC PRO 31106 LOGISTIQUE;15;15;7;6;2;0;2;7;0;0;1;0;6;8
22362.0;2023;17;NANTES;MASCULIN;SCOLAIRE;BAC PROFESSIONNEL;BAC PRO PROD;BAC PRO 25220 MAINT.MATERIELS OPT.B TP MANUT.;23;23;18;4;1;0;1;18;0;1;5;5;7;5
12031.0;2022;22;LIMOGES;MASCULIN;SCOLAIRE;BAC PROFESSIONNEL;BAC PRO SERV;BAC PRO 31212 METIERS DE L'ACCUEIL;4;4;4;0;0;0;0;4;0;0;1;0;3;0
22368.0;2023;17;NANTES;MASCULIN;SCOLAIRE;BAC PROFESSIONNEL;BAC PRO PROD;BAC PRO 25509 TECHNIC. FROID CONDITIONNEMT AIR;32;32;25;7;0;0;0;25;0;2;7;10;6;7
12032.0;2022;22;LIMOGES;MASCULIN;SCOLAIRE;BAC PROFESSIONNEL;BAC PRO SERV;BAC PRO 31213 MET.COM.VEN.OP.A ANI.GES.ESP.COM.;56;56;39;15;2;2;0;41;0;0;5;20;16;15
22369.0;2023;17;NANTES;MASCULIN;SCOLAIRE;BAC PROFESSIONNEL;BAC PRO PROD;BAC PRO 25510 METIERS ELECT. ENVIRON. CONNECTES;387;387;315;58;14;11;3;326;0;21;68;120;117;61
12042.0;2022;22;LIMOGES;MASCULIN;SCOLAIRE;BAC PROFESSIONNEL;BAC PRO SERV;BAC PRO 34304 HYGIENE PROPRETE STERILISATION;5;5;5;0;0;0;0;5;0;0;0;1;4;0
22373.0;2023;17;NANTES;MASCULIN;SCOLAIRE;BAC PROFESSIONNEL;BAC PRO PROD;BAC PRO AG 21001 AGRO-EQUIPEMENT;65;65;63;2;0;0;0;63;0;0;10;21;32;2
12048.0;2022;22;LIMOGES;MASCULIN;SCOLAIRE;BAC TECHNOLOGIQUE;BAC STHR;BAC STHR SC.&TEC. HOTELLERIE-RESTAURATION;7;7;7;0;0;0;0;7;0;0;0;2;5;0
22391.0;2023;17;NANTES;MASCULIN;SCOLAIRE;BAC PROFESSIONNEL;BAC PRO SERV;BAC PRO 31213 MET.COM.VEN.OP.A ANI.GES.ESP.COM.;555;553;439;81;33;26;7;465;0;10;80;179;196;88
12057.0;2022;22;LIMOGES;MASCULIN;SCOLAIRE;BAC TECHNOLOGIQUE;BAC STMG;BAC STMG RESSOURCES HUMAINES ET COMMUNICATION;59;59;44;3;12;8;4;52;0;0;0;12;40;7
22393.0;2023;17;NANTES;MASCULIN;SCOLAIRE;BAC PROFESSIONNEL;BAC PRO SERV;BAC PRO 32207 REAL.PR.IMPR.PLURI.OPTA.PR.GRAPH.;23;23;17;6;0;0;0;17;0;1;6;7;3;6
12058.0;2022;22;LIMOGES;MASCULIN;SCOLAIRE;BAC TECHNOLOGIQUE;BAC STMG;BAC STMG SYSTEMES D'INFORMATION DE GESTION;18;18;14;0;4;3;1;17;0;0;0;8;9;1
22395.0;2023;17;NANTES;MASCULIN;SCOLAIRE;BAC PROFESSIONNEL;BAC PRO SERV;BAC PRO 32303 ART.& MET.ART:COM.VIS.VIS.PLURI-M;37;37;34;3;0;0;0;34;0;5;9;13;7;3
12067.0;2022;10;LYON;FEMININ;APPRENTISSAGE;BAC PROFESSIONNEL;BAC PRO PROD;BAC PRO 23407 TECHNIC.FAB.BOIS ET MATERX ASSOC;1;1;0;1;0;0;0;0;0;0;0;0;0;1
22399.0;2023;17;NANTES;MASCULIN;SCOLAIRE;BAC PROFESSIONNEL;BAC PRO SERV;BAC PRO 33006 ANIMAT. ENFANCE& PERSONNES AGEES;58;58;51;7;0;0;0;51;0;5;14;17;15;7
12083.0;2022;10;LYON;FEMININ;APPRENTISSAGE;BAC PROFESSIONNEL;BAC PRO PROD;BAC PRO AG 21203 TECHN CONSEIL DE VENTE ANIMAL;1;1;1;0;0;0;0;1;0;0;0;0;1;0
22402.0;2023;17;NANTES;MASCULIN;SCOLAIRE;BAC PROFESSIONNEL;BAC PRO SERV;BAC PRO 33104 TECHNICIEN EN PROTHESE DENTAIRE;25;25;20;5;0;0;0;20;0;0;2;7;11;5
12086.0;2022;10;LYON;FEMININ;APPRENTISSAGE;BAC PROFESSIONNEL;BAC PRO PROD;BAC PRO AG 21212 TECH EXPE ANIMALE;3;2;2;0;0;0;0;2;0;0;0;0;2;0
22422.0;2023;17;NANTES;MASCULIN;SCOLAIRE;BAC TECHNOLOGIQUE;BAC STMG;BAC STMG MERCATIQUE (MARKETING);1194;1194;902;61;231;162;69;1064;0;2;58;308;696;130
12095.0;2022;10;LYON;FEMININ;APPRENTISSAGE;BAC PROFESSIONNEL;BAC PRO SERV;BAC PRO 32208 REAL.PR.IMPR.PLURI.OPTB.PR.IMPR.;4;4;4;0;0;0;0;4;0;3;1;0;0;0
22429.0;2023;23;NICE;FEMININ;APPRENTISSAGE;BAC PROFESSIONNEL;BAC PRO PROD;BAC PRO 25510 METIERS ELECT. ENVIRON. CONNECTES;2;2;2;0;0;0;0;2;0;1;1;0;0;0
12097.0;2022;10;LYON;FEMININ;APPRENTISSAGE;BAC PROFESSIONNEL;BAC PRO SERV;BAC PRO 33101 OPTIQUE LUNETTERIE;1;1;1;0;0;0;0;1;0;0;1;0;0;0
22440.0;2023;23;NICE;FEMININ;ENSEIGNEMENT A DISTANCE;BAC PROFESSIONNEL;BAC PRO SERV;BAC PRO 30004 ASSISTANC.GEST.ORGANIS.ACTIVITES;2;2;0;2;0;0;0;0;0;0;0;0;0;2
12099.0;2022;10;LYON;FEMININ;APPRENTISSAGE;BAC PROFESSIONNEL;BAC PRO SERV;BAC PRO 33403 COMMERC. SERVICES EN RESTAURATION;11;11;6;4;1;0;1;6;0;1;1;1;3;5
22442.0;2023;23;NICE;FEMININ;ENSEIGNEMENT A DISTANCE;BAC PROFESSIONNEL;BAC PRO SERV;BAC PRO 31213 MET.COM.VEN.OP.A ANI.GES.ESP.COM.;7;5;2;3;0;0;0;2;0;0;0;1;1;3
12100.0;2022;10;LYON;FEMININ;APPRENTISSAGE;BAC PROFESSIONNEL;BAC PRO SERV;BAC PRO 34304 HYGIENE PROPRETE STERILISATION;8;8;6;1;1;0;1;6;0;0;3;0;3;2
22449.0;2023;23;NICE;FEMININ;FORMATION CONTINUE;BAC PROFESSIONNEL;BAC PRO SERV;BAC PRO 30004 ASSISTANC.GEST.ORGANIS.ACTIVITES;6;4;4;0;0;0;0;4;0;1;0;0;3;0
12104.0;2022;10;LYON;FEMININ;ENSEIGNEMENT A DISTANCE;BAC TECHNOLOGIQUE;BAC STMG;BAC STMG GESTION ET FINANCE;1;1;0;1;0;0;0;0;0;0;0;0;0;1
22452.0;2023;23;NICE;FEMININ;FORMATION CONTINUE;BAC PROFESSIONNEL;BAC PRO SERV;BAC PRO 33003 ACC.SOINS-S.PERS. OPT.A DOMICILE;1;0;0;0;0;0;0;0;0;0;0;0;0;0
12105.0;2022;10;LYON;FEMININ;ENSEIGNEMENT A DISTANCE;BAC TECHNOLOGIQUE;BAC STMG;BAC STMG MERCATIQUE (MARKETING);9;9;6;2;1;1;0;7;0;0;1;2;4;2
22455.0;2023;23;NICE;FEMININ;INDIVIDUEL;BAC GENERAL;BAC GENERAL;BAC GENE 10019 BAC GENERAL;122;122;75;31;16;8;8;83;2;7;18;19;37;39
12113.0;2022;10;LYON;FEMININ;INDIVIDUEL;BAC PROFESSIONNEL;BAC PRO PROD;BAC PRO AG 21004 CGEA;2;2;2;0;0;0;0;2;0;0;0;0;2;0
22457.0;2023;23;NICE;FEMININ;INDIVIDUEL;BAC PROFESSIONNEL;BAC PRO PROD;BAC PRO 23004 TECHN. ETUDES BAT.A ETUDES & ECO.;1;1;0;1;0;0;0;0;0;0;0;0;0;1
12118.0;2022;10;LYON;FEMININ;INDIVIDUEL;BAC PROFESSIONNEL;BAC PRO SERV;BAC PRO 31212 METIERS DE L'ACCUEIL;1;0;0;0;0;0;0;0;0;0;0;0;0;0
22465.0;2023;23;NICE;FEMININ;INDIVIDUEL;BAC PROFESSIONNEL;BAC PRO SERV;BAC PRO 31213 MET.COM.VEN.OP.A ANI.GES.ESP.COM.;4;1;1;0;0;0;0;1;0;0;0;0;1;0
12129.0;2022;10;LYON;FEMININ;INDIVIDUEL;BAC TECHNOLOGIQUE;BAC STD2A;BAC STD2A SCIENCES & TECHNO. DESIGN-ARTS APPLIQUES;17;16;14;0;2;1;1;15;0;0;0;3;12;1
22466.0;2023;23;NICE;FEMININ;INDIVIDUEL;BAC PROFESSIONNEL;BAC PRO SERV;BAC PRO 31214 MET.COM.VEN.OP.B PR.CL.VA.OF.COM.;1;0;0;0;0;0;0;0;0;0;0;0;0;0
12141.0;2022;10;LYON;FEMININ;SCOLAIRE;BAC PROFESSIONNEL;BAC PRO PROD;BAC PRO 22106 CUISINE;54;54;49;2;3;3;0;52;0;3;13;17;19;2
22469.0;2023;23;NICE;FEMININ;INDIVIDUEL;BAC TECHNOLOGIQUE;BAC S2TMD;BAC S2TMD MUSIQUE;1;1;1;0;0;0;0;1;0;0;0;1;0;0
12155.0;2022;10;LYON;FEMININ;SCOLAIRE;BAC PROFESSIONNEL;BAC PRO PROD;BAC PRO 25007 MAINTENANCE EQUIPEMENTS INDUST.;2;2;2;0;0;0;0;2;0;1;0;0;1;0
22470.0;2023;23;NICE;FEMININ;INDIVIDUEL;BAC TECHNOLOGIQUE;BAC ST2S;BAC ST2S SCIENCES & TECHNO. SANTE & SOCIAL;4;3;0;2;1;0;1;0;0;0;0;0;0;3
12158.0;2022;10;LYON;FEMININ;SCOLAIRE;BAC PROFESSIONNEL;BAC PRO PROD;BAC PRO 25214 MAINT.VEHIC.OPTA VOIT.PARTICUL.;6;6;6;0;0;0;0;6;0;1;1;2;2;0
22477.0;2023;23;NICE;FEMININ;SCOLAIRE;BAC PROFESSIONNEL;BAC PRO PROD;BAC PRO 22105 BOULANGER-PÂTISSIER;19;19;17;1;1;1;0;18;0;2;5;4;7;1
12160.0;2022;10;LYON;FEMININ;SCOLAIRE;BAC PROFESSIONNEL;BAC PRO PROD;BAC PRO 25216 MAINT.VEHIC.OPTC MOTOCYCLES;1;1;1;0;0;0;0;1;0;0;0;1;0;0
22482.0;2023;23;NICE;FEMININ;SCOLAIRE;BAC PROFESSIONNEL;BAC PRO PROD;BAC PRO 23004 TECHN. ETUDES BAT.A ETUDES & ECO.;7;7;5;2;0;0;0;5;0;0;2;1;2;2
12161.0;2022;10;LYON;FEMININ;SCOLAIRE;BAC PROFESSIONNEL;BAC PRO PROD;BAC PRO 25220 MAINT.MATERIELS OPT.B TP MANUT.;1;1;1;0;0;0;0;1;0;0;0;1;0;0
22490.0;2023;23;NICE;FEMININ;SCOLAIRE;BAC PROFESSIONNEL;BAC PRO PROD;BAC PRO 24203 METIERS DE LA MODE - VÊTEMENT;63;63;58;5;0;0;0;58;0;13;17;18;10;5
12164.0;2022;10;LYON;FEMININ;SCOLAIRE;BAC PROFESSIONNEL;BAC PRO PROD;BAC PRO 25510 METIERS ELECT. ENVIRON. CONNECTES;4;4;3;1;0;0;0;3;0;1;1;1;0;1
22497.0;2023;23;NICE;FEMININ;SCOLAIRE;BAC PROFESSIONNEL;BAC PRO PROD;BAC PRO 25408 REPARATION DES CARROSSERIES;1;1;0;1;0;0;0;0;0;0;0;0;0;1
12166.0;2022;10;LYON;FEMININ;SCOLAIRE;BAC PROFESSIONNEL;BAC PRO PROD;BAC PRO 25515 SYST.NUM.OPT.C RES.INF.SYST.COMM.;5;5;5;0;0;0;0;5;0;1;2;1;1;0
22501.0;2023;23;NICE;FEMININ;SCOLAIRE;BAC PROFESSIONNEL;BAC PRO PROD;BAC PRO AG 21004 CGEA;22;22;15;7;0;0;0;15;0;0;2;5;8;7
12177.0;2022;10;LYON;FEMININ;SCOLAIRE;BAC PROFESSIONNEL;BAC PRO PROD;BAC PRO AG 22105 LABORATOIRE CONTROLE QUALITE;35;34;29;5;0;0;0;29;0;1;2;10;16;5
22503.0;2023;23;NICE;FEMININ;SCOLAIRE;BAC PROFESSIONNEL;BAC PRO PROD;BAC PRO AG 21114 CONDUITE PRODUCTIONS HORTICOLES;7;7;6;1;0;0;0;6;0;0;1;3;2;1
12179.0;2022;10;LYON;FEMININ;SCOLAIRE;BAC PROFESSIONNEL;BAC PRO SERV;BAC PRO 30001 GESTION-ADMINISTRATION;755;755;598;122;35;22;13;620;0;21;98;236;265;135
22511.0;2023;23;NICE;FEMININ;SCOLAIRE;BAC PROFESSIONNEL;BAC PRO SERV;BAC PRO 31214 MET.COM.VEN.OP.B PR.CL.VA.OF.COM.;123;123;97;16;10;9;1;106;0;2;22;35;47;17
12184.0;2022;10;LYON;FEMININ;SCOLAIRE;BAC PROFESSIONNEL;BAC PRO SERV;BAC PRO 31213 MET.COM.VEN.OP.A ANI.GES.ESP.COM.;333;333;292;32;9;8;1;300;0;16;71;110;103;33
22515.0;2023;23;NICE;FEMININ;SCOLAIRE;BAC PROFESSIONNEL;BAC PRO SERV;BAC PRO 33003 ACC.SOINS-S.PERS. OPT.A DOMICILE;49;49;40;8;1;0;1;40;0;3;7;21;9;9
12188.0;2022;10;LYON;FEMININ;SCOLAIRE;BAC PROFESSIONNEL;BAC PRO SERV;BAC PRO 32303 ART.& MET.ART:COM.VIS.VIS.PLURI-M;29;29;24;4;1;0;1;24;0;1;7;12;4;5
22517.0;2023;23;NICE;FEMININ;SCOLAIRE;BAC PROFESSIONNEL;BAC PRO SERV;BAC PRO 33006 ANIMAT. ENFANCE& PERSONNES AGEES;12;12;12;0;0;0;0;12;0;4;4;3;1;0
12191.0;2022;10;LYON;FEMININ;SCOLAIRE;BAC PROFESSIONNEL;BAC PRO SERV;BAC PRO 33003 ACC.SOINS-S.PERS. OPT.A DOMICILE;68;68;54;10;4;1;3;55;0;3;6;16;30;13
22518.0;2023;23;NICE;FEMININ;SCOLAIRE;BAC PROFESSIONNEL;BAC PRO SERV;BAC PRO 33101 OPTIQUE LUNETTERIE;8;8;8;0;0;0;0;8;0;1;1;3;3;0
12221.0;2022;10;LYON;MASCULIN;APPRENTISSAGE;BAC PROFESSIONNEL;BAC PRO PROD;BAC PRO 22106 CUISINE;14;14;13;1;0;0;0;13;0;0;2;6;5;1
22519.0;2023;23;NICE;FEMININ;SCOLAIRE;BAC PROFESSIONNEL;BAC PRO SERV;BAC PRO 33403 COMMERC. SERVICES EN RESTAURATION;48;46;40;5;1;0;1;40;0;2;10;15;13;6
12222.0;2022;10;LYON;MASCULIN;APPRENTISSAGE;BAC PROFESSIONNEL;BAC PRO PROD;BAC PRO 22403 ARTS.& MET.ART:MET.ENSEIGN SIGNA;2;2;2;0;0;0;0;2;0;0;2;0;0;0
22523.0;2023;23;NICE;FEMININ;SCOLAIRE;BAC PROFESSIONNEL;BAC PRO SERV;BAC PRO 34403 METIERS DE LA SECURITE;29;29;28;1;0;0;0;28;0;0;11;12;5;1
12225.0;2022;10;LYON;MASCULIN;APPRENTISSAGE;BAC PROFESSIONNEL;BAC PRO PROD;BAC PRO 22704 TECHN. MAINT. SYST.ENERG.CLIMATI;20;20;16;2;2;2;0;18;0;0;2;13;3;2
22527.0;2023;23;NICE;FEMININ;SCOLAIRE;BAC TECHNOLOGIQUE;BAC ST2S;BAC ST2S SCIENCES & TECHNO. SANTE & SOCIAL;358;358;296;13;49;37;12;333;0;12;44;104;173;25
12235.0;2022;10;LYON;MASCULIN;APPRENTISSAGE;BAC PROFESSIONNEL;BAC PRO PROD;BAC PRO 23406 TECHNICIEN DE SCIERIE;8;8;8;0;0;0;0;8;0;0;4;1;3;0
22532.0;2023;23;NICE;FEMININ;SCOLAIRE;BAC TECHNOLOGIQUE;BAC STI2D;BAC STI2D ENERGIES  ET ENVIRONNEMENT;6;6;4;0;2;2;0;6;0;0;0;3;3;0
12252.0;2022;10;LYON;MASCULIN;APPRENTISSAGE;BAC PROFESSIONNEL;BAC PRO PROD;BAC PRO 25411 TECH.CHAUDRONNERIE INDUSTRIELLE;70;70;59;10;1;0;1;59;0;4;16;24;15;11
22533.0;2023;23;NICE;FEMININ;SCOLAIRE;BAC TECHNOLOGIQUE;BAC STI2D;BAC STI2D INNOVATION TECHNO.  ET ECO CONCEPTION;28;28;26;0;2;2;0;28;0;1;4;8;15;0
12258.0;2022;10;LYON;MASCULIN;APPRENTISSAGE;BAC PROFESSIONNEL;BAC PRO PROD;BAC PRO AG 21114 CONDUITE PRODUCTIONS HORTICOLES;2;2;2;0;0;0;0;2;0;0;0;1;1;0
22535.0;2023;23;NICE;FEMININ;SCOLAIRE;BAC TECHNOLOGIQUE;BAC STL;BAC STL BIOCHIM.-BIOLOGIE-BIOTECHNOL.;76;76;72;1;3;2;1;74;3;4;22;25;20;2
12260.0;2022;10;LYON;MASCULIN;APPRENTISSAGE;BAC PROFESSIONNEL;BAC PRO PROD;BAC PRO AG 21204 PROD-AQUACOLES;1;1;1;0;0;0;0;1;0;0;0;1;0;0
22546.0;2023;23;NICE;MASCULIN;APPRENTISSAGE;BAC PROFESSIONNEL;BAC PRO PROD;BAC PRO 23303 MENUISERIE ALUMINIUM-VERRE;7;7;4;1;2;2;0;6;0;0;0;0;6;1
12261.0;2022;10;LYON;MASCULIN;APPRENTISSAGE;BAC PROFESSIONNEL;BAC PRO PROD;BAC PRO AG 21210 COND GEST ENTR CANIN ET FELIN;3;3;3;0;0;0;0;3;0;0;0;1;2;0
22547.0;2023;23;NICE;MASCULIN;APPRENTISSAGE;BAC PROFESSIONNEL;BAC PRO PROD;BAC PRO 23304 AMENAGEMENT FINITION BATIMENT;2;2;2;0;0;0;0;2;0;0;0;1;1;0
12266.0;2022;10;LYON;MASCULIN;APPRENTISSAGE;BAC PROFESSIONNEL;BAC PRO PROD;BAC PRO AG 22107 TEC CONS VTE ALIMENTATION P.ALIM;9;9;8;1;0;0;0;8;0;0;0;2;6;1
22549.0;2023;23;NICE;MASCULIN;APPRENTISSAGE;BAC PROFESSIONNEL;BAC PRO PROD;BAC PRO 24202 ARTIS.& MET.ART : TAPIS.D'AMEUBL;1;1;1;0;0;0;0;1;0;0;0;1;0;0
12268.0;2022;10;LYON;MASCULIN;APPRENTISSAGE;BAC PROFESSIONNEL;BAC PRO SERV;BAC PRO 31106 LOGISTIQUE;30;30;24;6;0;0;0;24;0;1;12;4;7;6
22551.0;2023;23;NICE;MASCULIN;APPRENTISSAGE;BAC PROFESSIONNEL;BAC PRO PROD;BAC PRO 25009 MAINTENANCE NAUTIQUE;27;27;12;13;2;2;0;14;0;0;3;3;8;13
12269.0;2022;10;LYON;MASCULIN;APPRENTISSAGE;BAC PROFESSIONNEL;BAC PRO SERV;BAC PRO 31107 CONDUCT. TRANSP.ROUT.MARCHANDISES;1;1;1;0;0;0;0;1;0;0;1;0;0;0
22554.0;2023;23;NICE;MASCULIN;APPRENTISSAGE;BAC PROFESSIONNEL;BAC PRO PROD;BAC PRO 25216 MAINT.VEHIC.OPTC MOTOCYCLES;20;19;16;2;1;0;1;16;0;3;4;6;3;3
12276.0;2022;10;LYON;MASCULIN;APPRENTISSAGE;BAC PROFESSIONNEL;BAC PRO SERV;BAC PRO 33403 COMMERC. SERVICES EN RESTAURATION;6;6;6;0;0;0;0;6;0;0;1;4;1;0
22561.0;2023;23;NICE;MASCULIN;APPRENTISSAGE;BAC PROFESSIONNEL;BAC PRO PROD;BAC PRO AG 21113 CGEVV;8;8;8;0;0;0;0;8;0;0;0;7;1;0
12277.0;2022;10;LYON;MASCULIN;APPRENTISSAGE;BAC PROFESSIONNEL;BAC PRO SERV;BAC PRO 34304 HYGIENE PROPRETE STERILISATION;17;16;6;7;3;2;1;8;0;1;0;1;6;8
22568.0;2023;23;NICE;MASCULIN;APPRENTISSAGE;BAC PROFESSIONNEL;BAC PRO SERV;BAC PRO 33403 COMMERC. SERVICES EN RESTAURATION;7;7;7;0;0;0;0;7;0;0;1;1;5;0
12283.0;2022;10;LYON;MASCULIN;FORMATION CONTINUE;BAC PROFESSIONNEL;BAC PRO PROD;BAC PRO 22704 TECHN. MAINT. SYST.ENERG.CLIMATI;14;14;14;0;0;0;0;14;0;1;6;5;2;0
22586.0;2023;23;NICE;MASCULIN;INDIVIDUEL;BAC PROFESSIONNEL;BAC PRO PROD;BAC PRO 23405 TECHNICIEN MENUISIER AGENCEUR;1;1;1;0;0;0;0;1;0;0;0;0;1;0
12288.0;2022;10;LYON;MASCULIN;FORMATION CONTINUE;BAC PROFESSIONNEL;BAC PRO SERV;BAC PRO 30001 GESTION-ADMINISTRATION;4;4;2;2;0;0;0;2;0;0;1;1;0;2
22592.0;2023;23;NICE;MASCULIN;INDIVIDUEL;BAC PROFESSIONNEL;BAC PRO PROD;BAC PRO AG 21113 CGEVV;4;3;3;0;0;0;0;3;0;0;0;0;3;0
12291.0;2022;10;LYON;MASCULIN;INDIVIDUEL;BAC GENERAL;BAC GENERAL;BAC GENE 10019 BAC GENERAL;156;108;61;31;16;8;8;69;0;10;12;14;33;39
22593.0;2023;23;NICE;MASCULIN;INDIVIDUEL;BAC PROFESSIONNEL;BAC PRO PROD;BAC PRO AG 21303 FORET;8;8;8;0;0;0;0;8;0;0;0;1;7;0
12295.0;2022;10;LYON;MASCULIN;INDIVIDUEL;BAC PROFESSIONNEL;BAC PRO PROD;BAC PRO 25007 MAINTENANCE EQUIPEMENTS INDUST.;1;1;1;0;0;0;0;1;0;0;0;1;0;0
22597.0;2023;23;NICE;MASCULIN;INDIVIDUEL;BAC PROFESSIONNEL;BAC PRO SERV;BAC PRO 31213 MET.COM.VEN.OP.A ANI.GES.ESP.COM.;7;4;2;2;0;0;0;2;0;0;0;0;2;2
12298.0;2022;10;LYON;MASCULIN;INDIVIDUEL;BAC PROFESSIONNEL;BAC PRO PROD;BAC PRO 25408 REPARATION DES CARROSSERIES;1;0;0;0;0;0;0;0;0;0;0;0;0;0
22611.0;2023;23;NICE;MASCULIN;SCOLAIRE;BAC PROFESSIONNEL;BAC PRO PROD;BAC PRO 22105 BOULANGER-PÂTISSIER;29;29;26;3;0;0;0;26;0;2;5;8;11;3
12299.0;2022;10;LYON;MASCULIN;INDIVIDUEL;BAC PROFESSIONNEL;BAC PRO PROD;BAC PRO 25411 TECH.CHAUDRONNERIE INDUSTRIELLE;1;1;0;1;0;0;0;0;0;0;0;0;0;1
22616.0;2023;23;NICE;MASCULIN;SCOLAIRE;BAC PROFESSIONNEL;BAC PRO PROD;BAC PRO 23004 TECHN. ETUDES BAT.A ETUDES & ECO.;28;28;22;6;0;0;0;22;0;1;8;7;6;6
12301.0;2022;10;LYON;MASCULIN;INDIVIDUEL;BAC PROFESSIONNEL;BAC PRO PROD;BAC PRO 25515 SYST.NUM.OPT.C RES.INF.SYST.COMM.;1;1;0;1;0;0;0;0;0;0;0;0;0;1
22621.0;2023;23;NICE;MASCULIN;SCOLAIRE;BAC PROFESSIONNEL;BAC PRO PROD;BAC PRO 23205 INTERV. SUR PATRIMOINE BATI OPT.A;1;1;1;0;0;0;0;1;0;0;0;0;1;0
12308.0;2022;10;LYON;MASCULIN;INDIVIDUEL;BAC PROFESSIONNEL;BAC PRO SERV;BAC PRO 31106 LOGISTIQUE;2;1;1;0;0;0;0;1;0;0;0;0;1;0
22623.0;2023;23;NICE;MASCULIN;SCOLAIRE;BAC PROFESSIONNEL;BAC PRO PROD;BAC PRO 23304 AMENAGEMENT FINITION BATIMENT;18;17;10;2;5;4;1;14;0;0;1;5;8;3
12309.0;2022;10;LYON;MASCULIN;INDIVIDUEL;BAC PROFESSIONNEL;BAC PRO SERV;BAC PRO 31107 CONDUCT. TRANSP.ROUT.MARCHANDISES;2;0;0;0;0;0;0;0;0;0;0;0;0;0
22626.0;2023;23;NICE;MASCULIN;SCOLAIRE;BAC PROFESSIONNEL;BAC PRO PROD;BAC PRO 23407 TECHNIC.FAB.BOIS ET MATERX ASSOC;6;6;5;1;0;0;0;5;0;0;1;2;2;1
12310.0;2022;10;LYON;MASCULIN;INDIVIDUEL;BAC PROFESSIONNEL;BAC PRO SERV;BAC PRO 31213 MET.COM.VEN.OP.A ANI.GES.ESP.COM.;5;2;1;1;0;0;0;1;0;0;0;0;1;1
22628.0;2023;23;NICE;MASCULIN;SCOLAIRE;BAC PROFESSIONNEL;BAC PRO PROD;BAC PRO 24202 ARTIS.& MET.ART : TAPIS.D'AMEUBL;2;2;1;1;0;0;0;1;0;0;0;0;1;1
12311.0;2022;10;LYON;MASCULIN;INDIVIDUEL;BAC PROFESSIONNEL;BAC PRO SERV;BAC PRO 31214 MET.COM.VEN.OP.B PR.CL.VA.OF.COM.;4;2;2;0;0;0;0;2;0;0;1;1;0;0
22631.0;2023;23;NICE;MASCULIN;SCOLAIRE;BAC PROFESSIONNEL;BAC PRO PROD;BAC PRO 25006 MICROTECHNIQUES;30;30;27;3;0;0;0;27;0;3;2;14;8;3
12312.0;2022;10;LYON;MASCULIN;INDIVIDUEL;BAC PROFESSIONNEL;BAC PRO SERV;BAC PRO 32304 PHOTOGRAPHIE;1;0;0;0;0;0;0;0;0;0;0;0;0;0
22634.0;2023;23;NICE;MASCULIN;SCOLAIRE;BAC PROFESSIONNEL;BAC PRO PROD;BAC PRO 25106 TECHNICIEN D'USINAGE;21;21;20;1;0;0;0;20;0;3;4;10;3;1
12318.0;2022;10;LYON;MASCULIN;INDIVIDUEL;BAC TECHNOLOGIQUE;BAC STI2D;BAC STI2D ARCHITECTURE ET CONSTRUCTION;2;1;1;0;0;0;0;1;0;0;0;0;1;0
22636.0;2023;23;NICE;MASCULIN;SCOLAIRE;BAC PROFESSIONNEL;BAC PRO PROD;BAC PRO 25214 MAINT.VEHIC.OPTA VOIT.PARTICUL.;139;139;107;28;4;3;1;110;0;7;30;33;40;29
12337.0;2022;10;LYON;MASCULIN;SCOLAIRE;BAC PROFESSIONNEL;BAC PRO PROD;BAC PRO 22704 TECHN. MAINT. SYST.ENERG.CLIMATI;38;38;29;7;2;2;0;31;0;1;3;16;11;7
22638.0;2023;23;NICE;MASCULIN;SCOLAIRE;BAC PROFESSIONNEL;BAC PRO PROD;BAC PRO 25216 MAINT.VEHIC.OPTC MOTOCYCLES;32;32;28;4;0;0;0;28;0;2;6;12;8;4
12339.0;2022;10;LYON;MASCULIN;SCOLAIRE;BAC PROFESSIONNEL;BAC PRO PROD;BAC PRO 23004 TECHN. ETUDES BAT.A ETUDES & ECO.;37;37;22;15;0;0;0;22;0;1;7;5;9;15
22640.0;2023;23;NICE;MASCULIN;SCOLAIRE;BAC PROFESSIONNEL;BAC PRO PROD;BAC PRO 25406 OUVRAGES DU BATIMENT METALLERIE;16;16;11;4;1;1;0;12;0;1;2;3;6;4
12352.0;2022;10;LYON;MASCULIN;SCOLAIRE;BAC PROFESSIONNEL;BAC PRO PROD;BAC PRO 24203 METIERS DE LA MODE - VÊTEMENT;13;13;11;1;1;1;0;12;0;2;2;3;5;1
22653.0;2023;23;NICE;MASCULIN;SCOLAIRE;BAC PROFESSIONNEL;BAC PRO SERV;BAC PRO 30004 ASSISTANC.GEST.ORGANIS.ACTIVITES;131;130;83;37;10;9;1;92;0;3;19;26;44;38
12355.0;2022;10;LYON;MASCULIN;SCOLAIRE;BAC PROFESSIONNEL;BAC PRO PROD;BAC PRO 25007 MAINTENANCE EQUIPEMENTS INDUST.;230;230;158;68;4;4;0;162;0;6;28;62;66;68
22654.0;2023;23;NICE;MASCULIN;SCOLAIRE;BAC PROFESSIONNEL;BAC PRO SERV;BAC PRO 31106 LOGISTIQUE;37;37;26;10;1;1;0;27;0;2;8;7;10;10
12356.0;2022;10;LYON;MASCULIN;SCOLAIRE;BAC PROFESSIONNEL;BAC PRO PROD;BAC PRO 25106 TECHNICIEN D'USINAGE;149;149;106;36;7;5;2;111;0;5;25;44;37;38
22657.0;2023;23;NICE;MASCULIN;SCOLAIRE;BAC PROFESSIONNEL;BAC PRO SERV;BAC PRO 31212 METIERS DE L'ACCUEIL;61;61;41;16;4;1;3;42;0;3;10;18;11;19
12363.0;2022;10;LYON;MASCULIN;SCOLAIRE;BAC PROFESSIONNEL;BAC PRO PROD;BAC PRO 25220 MAINT.MATERIELS OPT.B TP MANUT.;16;16;10;5;1;0;1;10;0;0;0;4;6;6
22660.0;2023;23;NICE;MASCULIN;SCOLAIRE;BAC PROFESSIONNEL;BAC PRO SERV;BAC PRO 32207 REAL.PR.IMPR.PLURI.OPTA.PR.GRAPH.;8;8;8;0;0;0;0;8;0;0;4;4;0;0
12367.0;2022;10;LYON;MASCULIN;SCOLAIRE;BAC PROFESSIONNEL;BAC PRO PROD;BAC PRO 25410 CONSTRUCTION DES CARROSSERIES;5;5;4;1;0;0;0;4;0;0;0;4;0;1
22673.0;2023;23;NICE;MASCULIN;SCOLAIRE;BAC TECHNOLOGIQUE;BAC ST2S;BAC ST2S SCIENCES & TECHNO. SANTE & SOCIAL;79;79;61;6;12;7;5;68;0;1;4;16;47;11
12370.0;2022;10;LYON;MASCULIN;SCOLAIRE;BAC PROFESSIONNEL;BAC PRO PROD;BAC PRO 25510 METIERS ELECT. ENVIRON. CONNECTES;508;508;392;93;23;14;9;406;0;22;85;133;166;102
22682.0;2023;23;NICE;MASCULIN;SCOLAIRE;BAC TECHNOLOGIQUE;BAC STL;BAC STL SCIENCES PHYSIQUES CHIMIQUES  EN LABORAT.;29;29;26;2;1;1;0;27;0;3;4;10;10;2
12380.0;2022;10;LYON;MASCULIN;SCOLAIRE;BAC PROFESSIONNEL;BAC PRO PROD;BAC PRO AG 21210 COND GEST ENTR CANIN ET FELIN;14;14;11;3;0;0;0;11;0;0;1;3;7;3
22688.0;2023;70;NORMANDIE;FEMININ;APPRENTISSAGE;BAC PROFESSIONNEL;BAC PRO PROD;BAC PRO 22003 BIO-INDUSTRIES DE TRANSFORMATION;1;1;1;0;0;0;0;1;0;0;0;1;0;0
12382.0;2022;10;LYON;MASCULIN;SCOLAIRE;BAC PROFESSIONNEL;BAC PRO PROD;BAC PRO AG 21212 TECH EXPE ANIMALE;7;7;7;0;0;0;0;7;0;0;2;3;2;0
22691.0;2023;70;NORMANDIE;FEMININ;APPRENTISSAGE;BAC PROFESSIONNEL;BAC PRO PROD;BAC PRO 22704 TECHN. MAINT. SYST.ENERG.CLIMATI;1;1;1;0;0;0;0;1;0;1;0;0;0;0
12387.0;2022;10;LYON;MASCULIN;SCOLAIRE;BAC PROFESSIONNEL;BAC PRO PROD;BAC PRO AG 22105 LABORATOIRE CONTROLE QUALITE;20;20;18;2;0;0;0;18;0;1;3;4;10;2
22702.0;2023;70;NORMANDIE;FEMININ;APPRENTISSAGE;BAC PROFESSIONNEL;BAC PRO PROD;BAC PRO 25214 MAINT.VEHIC.OPTA VOIT.PARTICUL.;8;7;7;0;0;0;0;7;0;2;2;2;1;0
12389.0;2022;10;LYON;MASCULIN;SCOLAIRE;BAC PROFESSIONNEL;BAC PRO SERV;BAC PRO 30001 GESTION-ADMINISTRATION;270;270;191;66;13;7;6;198;0;9;35;64;90;72
22706.0;2023;70;NORMANDIE;FEMININ;APPRENTISSAGE;BAC PROFESSIONNEL;BAC PRO PROD;BAC PRO 25411 TECH.CHAUDRONNERIE INDUSTRIELLE;6;6;5;1;0;0;0;5;0;2;1;1;1;1
12400.0;2022;10;LYON;MASCULIN;SCOLAIRE;BAC PROFESSIONNEL;BAC PRO SERV;BAC PRO 33002 SERVICES DE PROXIMITE  VIE LOCAL;13;13;12;1;0;0;0;12;0;0;2;3;7;1
22707.0;2023;70;NORMANDIE;FEMININ;APPRENTISSAGE;BAC PROFESSIONNEL;BAC PRO PROD;BAC PRO 25509 TECHNIC. FROID CONDITIONNEMT AIR;1;1;1;0;0;0;0;1;0;0;0;1;0;0
12405.0;2022;10;LYON;MASCULIN;SCOLAIRE;BAC PROFESSIONNEL;BAC PRO SERV;BAC PRO 33403 COMMERC. SERVICES EN RESTAURATION;68;68;54;9;5;4;1;58;0;2;11;22;23;10
22708.0;2023;70;NORMANDIE;FEMININ;APPRENTISSAGE;BAC PROFESSIONNEL;BAC PRO PROD;BAC PRO 25510 METIERS ELECT. ENVIRON. CONNECTES;5;5;5;0;0;0;0;5;0;1;2;0;2;0
12409.0;2022;10;LYON;MASCULIN;SCOLAIRE;BAC PROFESSIONNEL;BAC PRO SERV;BAC PRO AG 33002 SERV PERS TERRIT;40;39;38;1;0;0;0;38;0;0;5;10;23;1
22712.0;2023;70;NORMANDIE;FEMININ;APPRENTISSAGE;BAC PROFESSIONNEL;BAC PRO PROD;BAC PRO AG 21203 TECHN CONSEIL DE VENTE ANIMAL;15;15;14;1;0;0;0;14;0;0;0;4;10;1
12411.0;2022;10;LYON;MASCULIN;SCOLAIRE;BAC TECHNOLOGIQUE;BAC ST2S;BAC ST2S SCIENCES & TECHNO. SANTE & SOCIAL;124;124;93;7;24;13;11;106;0;0;7;40;59;18
22713.0;2023;70;NORMANDIE;FEMININ;APPRENTISSAGE;BAC PROFESSIONNEL;BAC PRO PROD;BAC PRO AG 21210 COND GEST ENTR CANIN ET FELIN;12;12;10;2;0;0;0;10;0;0;1;4;5;2
12415.0;2022;10;LYON;MASCULIN;SCOLAIRE;BAC TECHNOLOGIQUE;BAC STI2D;BAC STI2D ARCHITECTURE ET CONSTRUCTION;330;330;282;14;34;17;17;299;1;3;33;118;144;31
22732.0;2023;70;NORMANDIE;FEMININ;ENSEIGNEMENT A DISTANCE;BAC PROFESSIONNEL;BAC PRO SERV;BAC PRO 31214 MET.COM.VEN.OP.B PR.CL.VA.OF.COM.;5;4;2;2;0;0;0;2;0;0;1;0;1;2
12422.0;2022;10;LYON;MASCULIN;SCOLAIRE;BAC TECHNOLOGIQUE;BAC STMG;BAC STMG MERCATIQUE (MARKETING);985;985;700;82;203;142;61;842;0;4;43;244;551;143
22744.0;2023;70;NORMANDIE;FEMININ;FORMATION CONTINUE;BAC PROFESSIONNEL;BAC PRO PROD;BAC PRO 25106 TECHNICIEN D'USINAGE;3;3;3;0;0;0;0;3;0;1;2;0;0;0
12423.0;2022;10;LYON;MASCULIN;SCOLAIRE;BAC TECHNOLOGIQUE;BAC STMG;BAC STMG RESSOURCES HUMAINES ET COMMUNICATION;288;288;182;36;70;43;27;225;0;0;11;50;164;63
22747.0;2023;70;NORMANDIE;FEMININ;FORMATION CONTINUE;BAC PROFESSIONNEL;BAC PRO SERV;BAC PRO 30004 ASSISTANC.GEST.ORGANIS.ACTIVITES;16;16;16;0;0;0;0;16;0;4;7;4;1;0
12432.0;2022;31;MARTINIQUE;FEMININ;APPRENTISSAGE;BAC PROFESSIONNEL;BAC PRO SERV;BAC PRO 33403 COMMERC. SERVICES EN RESTAURATION;1;1;1;0;0;0;0;1;0;0;0;0;1;0
22749.0;2023;70;NORMANDIE;FEMININ;FORMATION CONTINUE;BAC PROFESSIONNEL;BAC PRO SERV;BAC PRO 31213 MET.COM.VEN.OP.A ANI.GES.ESP.COM.;1;1;0;1;0;0;0;0;0;0;0;0;0;1
12437.0;2022;31;MARTINIQUE;FEMININ;INDIVIDUEL;BAC PROFESSIONNEL;BAC PRO SERV;BAC PRO 33002 SERVICES DE PROXIMITE  VIE LOCAL;1;0;0;0;0;0;0;0;0;0;0;0;0;0
22750.0;2023;70;NORMANDIE;FEMININ;FORMATION CONTINUE;BAC PROFESSIONNEL;BAC PRO SERV;BAC PRO 32304 PHOTOGRAPHIE;6;3;3;0;0;0;0;3;0;1;1;0;1;0
12445.0;2022;31;MARTINIQUE;FEMININ;SCOLAIRE;BAC GENERAL;BAC GENERAL;BAC GENE 10019 BAC GENERAL;1145;1145;1023;19;103;89;14;1112;23;110;264;346;369;33
22752.0;2023;70;NORMANDIE;FEMININ;INDIVIDUEL;BAC GENERAL;BAC GENERAL;BAC GENE 10019 BAC GENERAL;100;100;45;38;17;10;7;55;0;4;9;16;26;45
12455.0;2022;31;MARTINIQUE;FEMININ;SCOLAIRE;BAC PROFESSIONNEL;BAC PRO PROD;BAC PRO 25106 TECHNICIEN D'USINAGE;2;2;1;0;1;1;0;2;0;1;0;0;1;0
22754.0;2023;70;NORMANDIE;FEMININ;INDIVIDUEL;BAC PROFESSIONNEL;BAC PRO PROD;BAC PRO AG 21114 CONDUITE PRODUCTIONS HORTICOLES;1;1;1;0;0;0;0;1;0;0;0;0;1;0
12459.0;2022;31;MARTINIQUE;FEMININ;SCOLAIRE;BAC PROFESSIONNEL;BAC PRO PROD;BAC PRO 25406 OUVRAGES DU BATIMENT METALLERIE;1;1;1;0;0;0;0;1;0;0;0;0;1;0
22755.0;2023;70;NORMANDIE;FEMININ;INDIVIDUEL;BAC PROFESSIONNEL;BAC PRO PROD;BAC PRO AG 21211 COND GEST ENTR HIPPIQUE;8;5;4;1;0;0;0;4;0;0;0;0;4;1
12461.0;2022;31;MARTINIQUE;FEMININ;SCOLAIRE;BAC PROFESSIONNEL;BAC PRO PROD;BAC PRO 25411 TECH.CHAUDRONNERIE INDUSTRIELLE;1;1;1;0;0;0;0;1;0;0;1;0;0;0
22759.0;2023;70;NORMANDIE;FEMININ;INDIVIDUEL;BAC PROFESSIONNEL;BAC PRO SERV;BAC PRO 32303 ART.& MET.ART:COM.VIS.VIS.PLURI-M;4;4;2;2;0;0;0;2;0;0;0;0;2;2
12467.0;2022;31;MARTINIQUE;FEMININ;SCOLAIRE;BAC PROFESSIONNEL;BAC PRO PROD;BAC PRO AG 22107 TEC CONS VTE ALIMENTATION P.ALIM;3;2;2;0;0;0;0;2;0;0;0;1;1;0
22762.0;2023;70;NORMANDIE;FEMININ;INDIVIDUEL;BAC PROFESSIONNEL;BAC PRO SERV;BAC PRO 33403 COMMERC. SERVICES EN RESTAURATION;1;0;0;0;0;0;0;0;0;0;0;0;0;0
12469.0;2022;31;MARTINIQUE;FEMININ;SCOLAIRE;BAC PROFESSIONNEL;BAC PRO SERV;BAC PRO 31106 LOGISTIQUE;6;6;6;0;0;0;0;6;0;1;1;1;3;0
22763.0;2023;70;NORMANDIE;FEMININ;INDIVIDUEL;BAC PROFESSIONNEL;BAC PRO SERV;BAC PRO 33603 ESTHETIQUE COSMETIQUE PARFUMERIE;2;1;0;1;0;0;0;0;0;0;0;0;0;1
12470.0;2022;31;MARTINIQUE;FEMININ;SCOLAIRE;BAC PROFESSIONNEL;BAC PRO SERV;BAC PRO 31212 METIERS DE L'ACCUEIL;50;50;43;3;4;2;2;45;0;0;13;19;13;5
22767.0;2023;70;NORMANDIE;FEMININ;INDIVIDUEL;BAC TECHNOLOGIQUE;BAC STAV;BAC STAV AGRONOMIE ALIM ENV TERRITOI;1;0;0;0;0;0;0;0;0;0;0;0;0;0
12472.0;2022;31;MARTINIQUE;FEMININ;SCOLAIRE;BAC PROFESSIONNEL;BAC PRO SERV;BAC PRO 31214 MET.COM.VEN.OP.B PR.CL.VA.OF.COM.;29;29;18;10;1;1;0;19;0;0;4;10;5;10
22774.0;2023;70;NORMANDIE;FEMININ;SCOLAIRE;BAC PROFESSIONNEL;BAC PRO PROD;BAC PRO 20102 PILOTE DE LIGNE DE PRODUCTION;1;1;1;0;0;0;0;1;0;0;0;0;1;0
12483.0;2022;31;MARTINIQUE;FEMININ;SCOLAIRE;BAC TECHNOLOGIQUE;BAC STAV;BAC STAV AGRONOMIE ALIM ENV TERRITOI;5;5;5;0;0;0;0;5;0;0;1;1;3;0
22776.0;2023;70;NORMANDIE;FEMININ;SCOLAIRE;BAC PROFESSIONNEL;BAC PRO PROD;BAC PRO 22004 PROC. CHIMIE EAU PAPIERS-CARTONS;14;14;9;5;0;0;0;9;0;0;1;5;3;5
12484.0;2022;31;MARTINIQUE;FEMININ;SCOLAIRE;BAC TECHNOLOGIQUE;BAC STD2A;BAC STD2A SCIENCES & TECHNO. DESIGN-ARTS APPLIQUES;17;17;17;0;0;0;0;17;0;1;2;11;3;0
22777.0;2023;70;NORMANDIE;FEMININ;SCOLAIRE;BAC PROFESSIONNEL;BAC PRO PROD;BAC PRO 22105 BOULANGER-PÂTISSIER;30;30;29;1;0;0;0;29;0;6;6;10;7;1
12486.0;2022;31;MARTINIQUE;FEMININ;SCOLAIRE;BAC TECHNOLOGIQUE;BAC STI2D;BAC STI2D ARCHITECTURE ET CONSTRUCTION;20;20;13;1;6;4;2;17;0;0;1;5;11;3
22784.0;2023;70;NORMANDIE;FEMININ;SCOLAIRE;BAC PROFESSIONNEL;BAC PRO PROD;BAC PRO 23203 TECHNICIEN BAT. : ORG.REAL.GROS O;3;3;2;1;0;0;0;2;0;0;1;0;1;1
12488.0;2022;31;MARTINIQUE;FEMININ;SCOLAIRE;BAC TECHNOLOGIQUE;BAC STI2D;BAC STI2D INNOVATION TECHNO.  ET ECO CONCEPTION;1;1;1;0;0;0;0;1;0;0;0;1;0;0
22790.0;2023;70;NORMANDIE;FEMININ;SCOLAIRE;BAC PROFESSIONNEL;BAC PRO PROD;BAC PRO 24203 METIERS DE LA MODE - VÊTEMENT;174;174;149;21;4;2;2;151;0;23;45;44;39;23
12498.0;2022;31;MARTINIQUE;MASCULIN;APPRENTISSAGE;BAC PROFESSIONNEL;BAC PRO PROD;BAC PRO 22704 TECHN. MAINT. SYST.ENERG.CLIMATI;5;3;1;2;0;0;0;1;0;0;0;0;1;2
22800.0;2023;70;NORMANDIE;FEMININ;SCOLAIRE;BAC PROFESSIONNEL;BAC PRO PROD;BAC PRO 25406 OUVRAGES DU BATIMENT METALLERIE;2;2;2;0;0;0;0;2;0;1;0;0;1;0
12503.0;2022;31;MARTINIQUE;MASCULIN;APPRENTISSAGE;BAC PROFESSIONNEL;BAC PRO PROD;BAC PRO 25009 MAINTENANCE NAUTIQUE;1;1;1;0;0;0;0;1;0;0;1;0;0;0
22803.0;2023;70;NORMANDIE;FEMININ;SCOLAIRE;BAC PROFESSIONNEL;BAC PRO PROD;BAC PRO 25509 TECHNIC. FROID CONDITIONNEMT AIR;1;1;1;0;0;0;0;1;0;0;0;1;0;0
12511.0;2022;31;MARTINIQUE;MASCULIN;ENSEIGNEMENT A DISTANCE;BAC TECHNOLOGIQUE;BAC STMG;BAC STMG RESSOURCES HUMAINES ET COMMUNICATION;1;1;0;1;0;0;0;0;0;0;0;0;0;1
22806.0;2023;70;NORMANDIE;FEMININ;SCOLAIRE;BAC PROFESSIONNEL;BAC PRO PROD;BAC PRO 25514 SYST.NUM.OPT.B AUD.RES.EQUIP.DOM.;3;3;3;0;0;0;0;3;0;0;0;2;1;0
12516.0;2022;31;MARTINIQUE;MASCULIN;INDIVIDUEL;BAC PROFESSIONNEL;BAC PRO PROD;BAC PRO 22003 BIO-INDUSTRIES DE TRANSFORMATION;1;1;0;1;0;0;0;0;0;0;0;0;0;1
22823.0;2023;70;NORMANDIE;FEMININ;SCOLAIRE;BAC PROFESSIONNEL;BAC PRO SERV;BAC PRO 31114 ORGANIS. TRANSPORT MARCHANDISES;28;27;21;4;2;2;0;23;0;0;2;9;12;4
12519.0;2022;31;MARTINIQUE;MASCULIN;INDIVIDUEL;BAC PROFESSIONNEL;BAC PRO PROD;BAC PRO 23003 ARTIS. & M.ART:MARCHANDISAGE VIS.;1;1;1;0;0;0;0;1;0;0;0;0;1;0
22825.0;2023;70;NORMANDIE;FEMININ;SCOLAIRE;BAC PROFESSIONNEL;BAC PRO SERV;BAC PRO 31213 MET.COM.VEN.OP.A ANI.GES.ESP.COM.;570;570;471;67;32;20;12;491;0;25;89;171;206;79
12522.0;2022;31;MARTINIQUE;MASCULIN;INDIVIDUEL;BAC PROFESSIONNEL;BAC PRO PROD;BAC PRO 25510 METIERS ELECT. ENVIRON. CONNECTES;2;2;1;1;0;0;0;1;0;0;0;0;1;1
22827.0;2023;70;NORMANDIE;FEMININ;SCOLAIRE;BAC PROFESSIONNEL;BAC PRO SERV;BAC PRO 32207 REAL.PR.IMPR.PLURI.OPTA.PR.GRAPH.;14;14;14;0;0;0;0;14;0;1;2;7;4;0
12527.0;2022;31;MARTINIQUE;MASCULIN;INDIVIDUEL;BAC TECHNOLOGIQUE;BAC STI2D;BAC STI2D INNOVATION TECHNO.  ET ECO CONCEPTION;1;1;0;1;0;0;0;0;0;0;0;0;0;1
22828.0;2023;70;NORMANDIE;FEMININ;SCOLAIRE;BAC PROFESSIONNEL;BAC PRO SERV;BAC PRO 32208 REAL.PR.IMPR.PLURI.OPTB.PR.IMPR.;8;8;7;0;1;0;1;7;0;1;2;3;1;1
12544.0;2022;31;MARTINIQUE;MASCULIN;SCOLAIRE;BAC PROFESSIONNEL;BAC PRO PROD;BAC PRO 23405 TECHNICIEN MENUISIER AGENCEUR;12;12;6;6;0;0;0;6;0;0;0;3;3;6
22830.0;2023;70;NORMANDIE;FEMININ;SCOLAIRE;BAC PROFESSIONNEL;BAC PRO SERV;BAC PRO 32304 PHOTOGRAPHIE;14;14;14;0;0;0;0;14;0;0;3;7;4;0
12545.0;2022;31;MARTINIQUE;MASCULIN;SCOLAIRE;BAC PROFESSIONNEL;BAC PRO PROD;BAC PRO 23408 Etude et réalisation d'agencement;2;2;2;0;0;0;0;2;0;0;0;1;1;0
22837.0;2023;70;NORMANDIE;FEMININ;SCOLAIRE;BAC PROFESSIONNEL;BAC PRO SERV;BAC PRO 33602 PERRUQUIER POSTICHEUR;11;11;11;0;0;0;0;11;0;4;4;1;2;0
12547.0;2022;31;MARTINIQUE;MASCULIN;SCOLAIRE;BAC PROFESSIONNEL;BAC PRO PROD;BAC PRO 25007 MAINTENANCE EQUIPEMENTS INDUST.;17;17;7;9;1;1;0;8;0;0;0;5;3;9
22840.0;2023;70;NORMANDIE;FEMININ;SCOLAIRE;BAC PROFESSIONNEL;BAC PRO SERV;BAC PRO 34303 GEST. POLLUTIONS PROTEC. ENVIRON.;3;3;2;0;1;1;0;3;0;0;1;1;1;0
12553.0;2022;31;MARTINIQUE;MASCULIN;SCOLAIRE;BAC PROFESSIONNEL;BAC PRO PROD;BAC PRO 25406 OUVRAGES DU BATIMENT METALLERIE;10;10;4;4;2;2;0;6;0;0;0;1;5;4
22841.0;2023;70;NORMANDIE;FEMININ;SCOLAIRE;BAC PROFESSIONNEL;BAC PRO SERV;BAC PRO 34304 HYGIENE PROPRETE STERILISATION;50;49;37;6;6;4;2;41;0;1;7;16;17;8
12561.0;2022;31;MARTINIQUE;MASCULIN;SCOLAIRE;BAC PROFESSIONNEL;BAC PRO PROD;BAC PRO AG 21001 AGRO-EQUIPEMENT;6;6;6;0;0;0;0;6;0;0;0;0;6;0
22843.0;2023;70;NORMANDIE;FEMININ;SCOLAIRE;BAC PROFESSIONNEL;BAC PRO SERV;BAC PRO AG 33002 SERV PERS TERRIT;318;310;271;39;0;0;0;271;0;6;17;80;168;39
12563.0;2022;31;MARTINIQUE;MASCULIN;SCOLAIRE;BAC PROFESSIONNEL;BAC PRO PROD;BAC PRO AG 21114 CONDUITE PRODUCTIONS HORTICOLES;5;5;4;1;0;0;0;4;0;0;1;2;1;1
22847.0;2023;70;NORMANDIE;FEMININ;SCOLAIRE;BAC TECHNOLOGIQUE;BAC STAV;BAC STAV AGRONOMIE ALIM ENV TERRITOI;166;166;157;9;0;0;0;157;0;0;13;64;80;9
12573.0;2022;31;MARTINIQUE;MASCULIN;SCOLAIRE;BAC PROFESSIONNEL;BAC PRO SERV;BAC PRO 33002 SERVICES DE PROXIMITE  VIE LOCAL;4;4;3;1;0;0;0;3;0;0;0;2;1;1
22856.0;2023;70;NORMANDIE;FEMININ;SCOLAIRE;BAC TECHNOLOGIQUE;BAC STMG;BAC STMG GESTION ET FINANCE;370;370;295;11;64;46;18;341;0;8;47;112;174;29
12574.0;2022;31;MARTINIQUE;MASCULIN;SCOLAIRE;BAC PROFESSIONNEL;BAC PRO SERV;BAC PRO 33003 ACC.SOINS-S.PERS. OPT.A DOMICILE;7;7;6;1;0;0;0;6;0;0;1;3;2;1
22870.0;2023;70;NORMANDIE;MASCULIN;APPRENTISSAGE;BAC PROFESSIONNEL;BAC PRO PROD;BAC PRO 23304 AMENAGEMENT FINITION BATIMENT;4;4;3;0;1;1;0;4;0;0;0;1;3;0
12579.0;2022;31;MARTINIQUE;MASCULIN;SCOLAIRE;BAC PROFESSIONNEL;BAC PRO SERV;BAC PRO 34304 HYGIENE PROPRETE STERILISATION;6;6;3;3;0;0;0;3;0;0;1;1;1;3
22871.0;2023;70;NORMANDIE;MASCULIN;APPRENTISSAGE;BAC PROFESSIONNEL;BAC PRO PROD;BAC PRO 23404 TECHNICIEN CONSTRUCTEUR BOIS;20;20;17;3;0;0;0;17;0;4;6;3;4;3
12581.0;2022;31;MARTINIQUE;MASCULIN;SCOLAIRE;BAC TECHNOLOGIQUE;BAC ST2S;BAC ST2S SCIENCES & TECHNO. SANTE & SOCIAL;35;35;31;0;4;3;1;34;0;0;2;12;20;1
22873.0;2023;70;NORMANDIE;MASCULIN;APPRENTISSAGE;BAC PROFESSIONNEL;BAC PRO PROD;BAC PRO 23406 TECHNICIEN DE SCIERIE;1;1;1;0;0;0;0;1;0;1;0;0;0;0
12582.0;2022;31;MARTINIQUE;MASCULIN;SCOLAIRE;BAC TECHNOLOGIQUE;BAC STAV;BAC STAV AGRONOMIE ALIM ENV TERRITOI;6;6;5;1;0;0;0;5;0;0;0;2;3;1
22877.0;2023;70;NORMANDIE;MASCULIN;APPRENTISSAGE;BAC PROFESSIONNEL;BAC PRO PROD;BAC PRO 25007 MAINTENANCE EQUIPEMENTS INDUST.;80;80;68;9;3;2;1;70;0;6;14;26;24;10
12583.0;2022;31;MARTINIQUE;MASCULIN;SCOLAIRE;BAC TECHNOLOGIQUE;BAC STD2A;BAC STD2A SCIENCES & TECHNO. DESIGN-ARTS APPLIQUES;14;14;14;0;0;0;0;14;0;1;3;6;4;0
22878.0;2023;70;NORMANDIE;MASCULIN;APPRENTISSAGE;BAC PROFESSIONNEL;BAC PRO PROD;BAC PRO 25009 MAINTENANCE NAUTIQUE;4;4;4;0;0;0;0;4;0;0;0;3;1;0
12585.0;2022;31;MARTINIQUE;MASCULIN;SCOLAIRE;BAC TECHNOLOGIQUE;BAC STI2D;BAC STI2D ARCHITECTURE ET CONSTRUCTION;17;17;13;0;4;4;0;17;0;0;1;4;12;0
22885.0;2023;70;NORMANDIE;MASCULIN;APPRENTISSAGE;BAC PROFESSIONNEL;BAC PRO PROD;BAC PRO 25220 MAINT.MATERIELS OPT.B TP MANUT.;6;6;4;1;1;0;1;4;0;0;2;2;0;2
12590.0;2022;31;MARTINIQUE;MASCULIN;SCOLAIRE;BAC TECHNOLOGIQUE;BAC STMG;BAC STMG GESTION ET FINANCE;69;69;54;2;13;12;1;66;0;0;4;25;37;3
22889.0;2023;70;NORMANDIE;MASCULIN;APPRENTISSAGE;BAC PROFESSIONNEL;BAC PRO PROD;BAC PRO 25408 REPARATION DES CARROSSERIES;69;69;54;5;10;7;3;61;0;6;5;18;32;8
12592.0;2022;31;MARTINIQUE;MASCULIN;SCOLAIRE;BAC TECHNOLOGIQUE;BAC STMG;BAC STMG RESSOURCES HUMAINES ET COMMUNICATION;46;46;36;2;8;7;1;43;0;0;2;14;27;3
22895.0;2023;70;NORMANDIE;MASCULIN;APPRENTISSAGE;BAC PROFESSIONNEL;BAC PRO PROD;BAC PRO 25515 SYST.NUM.OPT.C RES.INF.SYST.COMM.;7;7;7;0;0;0;0;7;0;1;2;2;2;0
12598.0;2022;43;MAYOTTE;FEMININ;INDIVIDUEL;BAC GENERAL;BAC GENERAL;BAC GENE 10019 BAC GENERAL;25;17;1;10;6;4;2;5;0;0;0;0;5;12
22898.0;2023;70;NORMANDIE;MASCULIN;APPRENTISSAGE;BAC PROFESSIONNEL;BAC PRO PROD;BAC PRO AG 21114 CONDUITE PRODUCTIONS HORTICOLES;4;4;3;1;0;0;0;3;0;0;0;2;1;1
12601.0;2022;43;MAYOTTE;FEMININ;INDIVIDUEL;BAC PROFESSIONNEL;BAC PRO SERV;BAC PRO 31212 METIERS DE L'ACCUEIL;2;2;1;0;1;1;0;2;0;0;0;0;2;0
22899.0;2023;70;NORMANDIE;MASCULIN;APPRENTISSAGE;BAC PROFESSIONNEL;BAC PRO PROD;BAC PRO AG 21203 TECHN CONSEIL DE VENTE ANIMAL;9;9;8;1;0;0;0;8;0;0;1;5;2;1
12604.0;2022;43;MAYOTTE;FEMININ;INDIVIDUEL;BAC TECHNOLOGIQUE;BAC STHR;BAC STHR SC.&TEC. HOTELLERIE-RESTAURATION;1;1;0;1;0;0;0;0;0;0;0;0;0;1
22900.0;2023;70;NORMANDIE;MASCULIN;APPRENTISSAGE;BAC PROFESSIONNEL;BAC PRO PROD;BAC PRO AG 21210 COND GEST ENTR CANIN ET FELIN;2;2;2;0;0;0;0;2;0;0;0;1;1;0
12606.0;2022;43;MAYOTTE;FEMININ;INDIVIDUEL;BAC TECHNOLOGIQUE;BAC STMG;BAC STMG MERCATIQUE (MARKETING);2;2;0;2;0;0;0;0;0;0;0;0;0;2
22902.0;2023;70;NORMANDIE;MASCULIN;APPRENTISSAGE;BAC PROFESSIONNEL;BAC PRO PROD;BAC PRO AG 21303 FORET;10;9;7;2;0;0;0;7;0;0;1;5;1;2
12611.0;2022;43;MAYOTTE;FEMININ;SCOLAIRE;BAC PROFESSIONNEL;BAC PRO PROD;BAC PRO 23005 TECHN. ETUDES BAT B ASSIST.ARCHI.;1;1;0;0;1;1;0;1;0;0;0;0;1;0
22908.0;2023;70;NORMANDIE;MASCULIN;APPRENTISSAGE;BAC PROFESSIONNEL;BAC PRO SERV;BAC PRO 31214 MET.COM.VEN.OP.B PR.CL.VA.OF.COM.;4;4;4;0;0;0;0;4;0;0;1;1;2;0
12613.0;2022;43;MAYOTTE;FEMININ;SCOLAIRE;BAC PROFESSIONNEL;BAC PRO PROD;BAC PRO 23408 Etude et réalisation d'agencement;4;3;3;0;0;0;0;3;0;0;0;1;2;0
22915.0;2023;70;NORMANDIE;MASCULIN;ENSEIGNEMENT A DISTANCE;BAC PROFESSIONNEL;BAC PRO SERV;BAC PRO 31214 MET.COM.VEN.OP.B PR.CL.VA.OF.COM.;2;2;0;2;0;0;0;0;0;0;0;0;0;2
12628.0;2022;43;MAYOTTE;FEMININ;SCOLAIRE;BAC PROFESSIONNEL;BAC PRO SERV;BAC PRO 33003 ACC.SOINS-S.PERS. OPT.A DOMICILE;49;49;36;10;3;2;1;38;0;0;4;9;25;11
22916.0;2023;70;NORMANDIE;MASCULIN;ENSEIGNEMENT A DISTANCE;BAC PROFESSIONNEL;BAC PRO SERV;BAC PRO 33004 ACC.SOINS-S.PERS. OPT.EN STRUCTUR;1;0;0;0;0;0;0;0;0;0;0;0;0;0
12653.0;2022;43;MAYOTTE;MASCULIN;INDIVIDUEL;BAC PROFESSIONNEL;BAC PRO PROD;BAC PRO 23408 Etude et réalisation d'agencement;1;1;0;1;0;0;0;0;0;0;0;0;0;1
22919.0;2023;70;NORMANDIE;MASCULIN;ENSEIGNEMENT A DISTANCE;BAC TECHNOLOGIQUE;BAC STMG;BAC STMG RESSOURCES HUMAINES ET COMMUNICATION;1;1;0;1;0;0;0;0;0;0;0;0;0;1
12659.0;2022;43;MAYOTTE;MASCULIN;INDIVIDUEL;BAC PROFESSIONNEL;BAC PRO SERV;BAC PRO 31213 MET.COM.VEN.OP.A ANI.GES.ESP.COM.;2;2;0;2;0;0;0;0;0;0;0;0;0;2
22920.0;2023;70;NORMANDIE;MASCULIN;ENSEIGNEMENT A DISTANCE;BAC TECHNOLOGIQUE;BAC STMG;BAC STMG SYSTEMES D'INFORMATION DE GESTION;1;1;0;1;0;0;0;0;0;0;0;0;0;1
12666.0;2022;43;MAYOTTE;MASCULIN;SCOLAIRE;BAC PROFESSIONNEL;BAC PRO PROD;BAC PRO 22106 CUISINE;8;8;5;2;1;0;1;5;0;0;0;4;1;3
22921.0;2023;70;NORMANDIE;MASCULIN;FORMATION CONTINUE;BAC PROFESSIONNEL;BAC PRO PROD;BACPRO 20002 ETUD.DEFINITION PRDTS INDUSTRIEL;5;5;5;0;0;0;0;5;0;0;1;2;2;0
12668.0;2022;43;MAYOTTE;MASCULIN;SCOLAIRE;BAC PROFESSIONNEL;BAC PRO PROD;BAC PRO 23005 TECHN. ETUDES BAT B ASSIST.ARCHI.;16;16;9;6;1;1;0;10;0;0;1;3;6;6
22924.0;2023;70;NORMANDIE;MASCULIN;FORMATION CONTINUE;BAC PROFESSIONNEL;BAC PRO PROD;BAC PRO 22703 TECHN.INSTALL.SYST.ENERG.CLIMATI;1;1;0;1;0;0;0;0;0;0;0;0;0;1
12669.0;2022;43;MAYOTTE;MASCULIN;SCOLAIRE;BAC PROFESSIONNEL;BAC PRO PROD;BAC PRO 23102 TRAVAUX PUBLICS;35;35;8;18;9;7;2;15;0;0;1;2;12;20
22935.0;2023;70;NORMANDIE;MASCULIN;FORMATION CONTINUE;BAC PROFESSIONNEL;BAC PRO SERV;BAC PRO 32304 PHOTOGRAPHIE;1;1;1;0;0;0;0;1;0;1;0;0;0;0
12671.0;2022;43;MAYOTTE;MASCULIN;SCOLAIRE;BAC PROFESSIONNEL;BAC PRO PROD;BAC PRO 23203 TECHNICIEN BAT. : ORG.REAL.GROS O;33;33;19;2;12;8;4;27;0;0;0;4;23;6
22937.0;2023;70;NORMANDIE;MASCULIN;INDIVIDUEL;BAC GENERAL;BAC GENERAL;BAC GENE 10019 BAC GENERAL;96;95;36;45;14;10;4;46;0;3;13;12;18;49
12672.0;2022;43;MAYOTTE;MASCULIN;SCOLAIRE;BAC PROFESSIONNEL;BAC PRO PROD;BAC PRO 23304 AMENAGEMENT FINITION BATIMENT;15;12;7;2;3;3;0;10;0;0;1;1;8;2
22942.0;2023;70;NORMANDIE;MASCULIN;INDIVIDUEL;BAC PROFESSIONNEL;BAC PRO PROD;BAC PRO 25007 MAINTENANCE EQUIPEMENTS INDUST.;7;5;2;2;1;1;0;3;0;0;0;0;3;2
12674.0;2022;43;MAYOTTE;MASCULIN;SCOLAIRE;BAC PROFESSIONNEL;BAC PRO PROD;BAC PRO 23405 TECHNICIEN MENUISIER AGENCEUR;15;14;7;2;5;1;4;8;0;0;0;0;8;6
22949.0;2023;70;NORMANDIE;MASCULIN;INDIVIDUEL;BAC PROFESSIONNEL;BAC PRO PROD;BAC PRO AG 21004 CGEA;7;5;2;3;0;0;0;2;0;0;0;0;2;3
12676.0;2022;43;MAYOTTE;MASCULIN;SCOLAIRE;BAC PROFESSIONNEL;BAC PRO PROD;BAC PRO 25007 MAINTENANCE EQUIPEMENTS INDUST.;32;32;18;11;3;3;0;21;0;0;0;9;12;11
22950.0;2023;70;NORMANDIE;MASCULIN;INDIVIDUEL;BAC PROFESSIONNEL;BAC PRO PROD;BAC PRO AG 21114 CONDUITE PRODUCTIONS HORTICOLES;2;2;2;0;0;0;0;2;0;0;0;0;2;0
12681.0;2022;43;MAYOTTE;MASCULIN;SCOLAIRE;BAC PROFESSIONNEL;BAC PRO PROD;BAC PRO 25303 AERONAUTIQUE OPTION SYSTEMES;9;9;7;2;0;0;0;7;0;0;1;4;2;2
22952.0;2023;70;NORMANDIE;MASCULIN;INDIVIDUEL;BAC PROFESSIONNEL;BAC PRO SERV;BAC PRO 30004 ASSISTANC.GEST.ORGANIS.ACTIVITES;7;5;2;3;0;0;0;2;0;0;0;0;2;3
12688.0;2022;43;MAYOTTE;MASCULIN;SCOLAIRE;BAC PROFESSIONNEL;BAC PRO PROD;BAC PRO AG 21114 CONDUITE PRODUCTIONS HORTICOLES;7;7;6;1;0;0;0;6;0;0;0;1;5;1
22959.0;2023;70;NORMANDIE;MASCULIN;INDIVIDUEL;BAC PROFESSIONNEL;BAC PRO SERV;BAC PRO 33004 ACC.SOINS-S.PERS. OPT.EN STRUCTUR;1;0;0;0;0;0;0;0;0;0;0;0;0;0
12690.0;2022;43;MAYOTTE;MASCULIN;SCOLAIRE;BAC PROFESSIONNEL;BAC PRO SERV;BAC PRO 31106 LOGISTIQUE;32;31;10;17;4;3;1;13;0;2;0;2;9;18
22961.0;2023;70;NORMANDIE;MASCULIN;INDIVIDUEL;BAC PROFESSIONNEL;BAC PRO SERV;BAC PRO 34304 HYGIENE PROPRETE STERILISATION;1;1;1;0;0;0;0;1;0;0;0;1;0;0
12694.0;2022;43;MAYOTTE;MASCULIN;SCOLAIRE;BAC PROFESSIONNEL;BAC PRO SERV;BAC PRO 31214 MET.COM.VEN.OP.B PR.CL.VA.OF.COM.;36;36;20;11;5;3;2;23;0;0;3;11;9;13
22965.0;2023;70;NORMANDIE;MASCULIN;INDIVIDUEL;BAC TECHNOLOGIQUE;BAC STI2D;BAC STI2D INNOVATION TECHNO.  ET ECO CONCEPTION;1;1;0;0;1;0;1;0;0;0;0;0;0;1
12698.0;2022;43;MAYOTTE;MASCULIN;SCOLAIRE;BAC PROFESSIONNEL;BAC PRO SERV;BAC PRO 33004 ACC.SOINS-S.PERS. OPT.EN STRUCTUR;1;1;1;0;0;0;0;1;0;0;1;0;0;0
22971.0;2023;70;NORMANDIE;MASCULIN;SCOLAIRE;BAC GENERAL;BAC GENERAL;BAC GENE 10019 BAC GENERAL;7720;7720;6912;132;676;481;195;7393;122;762;1591;2287;2631;327
12699.0;2022;43;MAYOTTE;MASCULIN;SCOLAIRE;BAC PROFESSIONNEL;BAC PRO SERV;BAC PRO 33403 COMMERC. SERVICES EN RESTAURATION;7;7;5;0;2;2;0;7;0;0;0;3;4;0
22980.0;2023;70;NORMANDIE;MASCULIN;SCOLAIRE;BAC PROFESSIONNEL;BAC PRO PROD;BAC PRO 22703 TECHN.INSTALL.SYST.ENERG.CLIMATI;29;29;17;10;2;2;0;19;0;1;2;9;7;10
12700.0;2022;43;MAYOTTE;MASCULIN;SCOLAIRE;BAC PROFESSIONNEL;BAC PRO SERV;BAC PRO 34403 METIERS DE LA SECURITE;25;25;19;0;6;5;1;24;0;1;4;10;9;1
22982.0;2023;70;NORMANDIE;MASCULIN;SCOLAIRE;BAC PROFESSIONNEL;BAC PRO PROD;BAC PRO 23003 ARTIS. & M.ART:MARCHANDISAGE VIS.;2;2;2;0;0;0;0;2;0;0;0;1;1;0
12701.0;2022;43;MAYOTTE;MASCULIN;SCOLAIRE;BAC PROFESSIONNEL;BAC PRO SERV;BAC PRO AG 33002 SERV PERS TERRIT;4;4;3;1;0;0;0;3;0;0;0;3;0;1
22986.0;2023;70;NORMANDIE;MASCULIN;SCOLAIRE;BAC PROFESSIONNEL;BAC PRO PROD;BACPRO 23103 TECHNICIEN GEOMETRE-TOPOGRAPHE;26;26;23;3;0;0;0;23;0;1;3;10;9;3
12708.0;2022;43;MAYOTTE;MASCULIN;SCOLAIRE;BAC TECHNOLOGIQUE;BAC STI2D;BAC STI2D SYSTÈME D'INFORMATION  ET NUMERIQUE;65;65;26;10;29;27;2;53;0;1;3;2;47;12
22999.0;2023;70;NORMANDIE;MASCULIN;SCOLAIRE;BAC PROFESSIONNEL;BAC PRO PROD;BAC PRO 25009 MAINTENANCE NAUTIQUE;11;11;10;1;0;0;0;10;0;0;2;3;5;1
12712.0;2022;43;MAYOTTE;MASCULIN;SCOLAIRE;BAC TECHNOLOGIQUE;BAC STMG;BAC STMG RESSOURCES HUMAINES ET COMMUNICATION;149;149;67;26;56;45;11;112;0;1;2;18;91;37
23001.0;2023;70;NORMANDIE;MASCULIN;SCOLAIRE;BAC PROFESSIONNEL;BAC PRO PROD;BAC PRO 25107 TECHNICIEN OUTILLEUR;16;16;13;2;1;0;1;13;0;1;2;4;6;3
12716.0;2022;11;MONTPELLIER;FEMININ;APPRENTISSAGE;BAC PROFESSIONNEL;BAC PRO PROD;BAC PRO 23004 TECHN. ETUDES BAT.A ETUDES & ECO.;1;1;1;0;0;0;0;1;0;0;0;0;1;0
23002.0;2023;70;NORMANDIE;MASCULIN;SCOLAIRE;BAC PROFESSIONNEL;BAC PRO PROD;BAC PRO 25214 MAINT.VEHIC.OPTA VOIT.PARTICUL.;184;184;153;22;9;6;3;159;0;12;34;62;51;25
12717.0;2022;11;MONTPELLIER;FEMININ;APPRENTISSAGE;BAC PROFESSIONNEL;BAC PRO PROD;BAC PRO 23102 TRAVAUX PUBLICS;1;1;1;0;0;0;0;1;0;0;0;1;0;0
23010.0;2023;70;NORMANDIE;MASCULIN;SCOLAIRE;BAC PROFESSIONNEL;BAC PRO PROD;BAC PRO 25408 REPARATION DES CARROSSERIES;41;41;22;13;6;3;3;25;0;0;7;9;9;16
12726.0;2022;11;MONTPELLIER;FEMININ;APPRENTISSAGE;BAC PROFESSIONNEL;BAC PRO PROD;BAC PRO AG 21114 CONDUITE PRODUCTIONS HORTICOLES;1;1;1;0;0;0;0;1;0;0;0;1;0;0
23012.0;2023;70;NORMANDIE;MASCULIN;SCOLAIRE;BAC PROFESSIONNEL;BAC PRO PROD;BAC PRO 25509 TECHNIC. FROID CONDITIONNEMT AIR;64;64;45;16;3;3;0;48;0;1;7;16;24;16
12730.0;2022;11;MONTPELLIER;FEMININ;APPRENTISSAGE;BAC PROFESSIONNEL;BAC PRO SERV;BAC PRO 30001 GESTION-ADMINISTRATION;4;4;4;0;0;0;0;4;0;1;3;0;0;0
23020.0;2023;70;NORMANDIE;MASCULIN;SCOLAIRE;BAC PROFESSIONNEL;BAC PRO PROD;BAC PRO AG 21203 TECHN CONSEIL DE VENTE ANIMAL;6;6;6;0;0;0;0;6;0;0;0;3;3;0
12744.0;2022;11;MONTPELLIER;FEMININ;ENSEIGNEMENT A DISTANCE;BAC PROFESSIONNEL;BAC PRO SERV;BAC PRO 33004 ACC.SOINS-S.PERS. OPT.EN STRUCTUR;7;2;1;1;0;0;0;1;0;0;0;0;1;1
23022.0;2023;70;NORMANDIE;MASCULIN;SCOLAIRE;BAC PROFESSIONNEL;BAC PRO PROD;BAC PRO AG 21210 COND GEST ENTR CANIN ET FELIN;15;15;14;1;0;0;0;14;0;0;0;4;10;1
12745.0;2022;11;MONTPELLIER;FEMININ;ENSEIGNEMENT A DISTANCE;BAC PROFESSIONNEL;BAC PRO SERV;BAC PRO 33603 ESTHETIQUE COSMETIQUE PARFUMERIE;1;0;0;0;0;0;0;0;0;0;0;0;0;0
23028.0;2023;70;NORMANDIE;MASCULIN;SCOLAIRE;BAC PROFESSIONNEL;BAC PRO PROD;BAC PRO AG 22105 LABORATOIRE CONTROLE QUALITE;15;15;15;0;0;0;0;15;0;0;1;7;7;0
12748.0;2022;11;MONTPELLIER;FEMININ;ENSEIGNEMENT A DISTANCE;BAC TECHNOLOGIQUE;BAC STMG;BAC STMG MERCATIQUE (MARKETING);31;31;27;3;1;1;0;28;0;2;3;17;6;3
23044.0;2023;70;NORMANDIE;MASCULIN;SCOLAIRE;BAC PROFESSIONNEL;BAC PRO SERV;BAC PRO 33101 OPTIQUE LUNETTERIE;2;2;2;0;0;0;0;2;0;0;1;0;1;0
12755.0;2022;11;MONTPELLIER;FEMININ;INDIVIDUEL;BAC GENERAL;BAC GENERAL;BAC GENE 10019 BAC GENERAL;95;73;42;14;17;12;5;54;1;3;13;12;25;19
23049.0;2023;70;NORMANDIE;MASCULIN;SCOLAIRE;BAC PROFESSIONNEL;BAC PRO SERV;BAC PRO 34304 HYGIENE PROPRETE STERILISATION;13;13;10;0;3;2;1;12;0;2;2;2;6;1
12756.0;2022;11;MONTPELLIER;FEMININ;INDIVIDUEL;BAC PROFESSIONNEL;BAC PRO PROD;BAC PRO 22106 CUISINE;2;1;1;0;0;0;0;1;0;0;0;0;1;0
23050.0;2023;70;NORMANDIE;MASCULIN;SCOLAIRE;BAC PROFESSIONNEL;BAC PRO SERV;BAC PRO 34305 TECHN.D'INTERV.SUR INSTALL. NUCL.;13;13;13;0;0;0;0;13;0;1;5;5;2;0
12759.0;2022;11;MONTPELLIER;FEMININ;INDIVIDUEL;BAC PROFESSIONNEL;BAC PRO PROD;BAC PRO AG 21113 CGEVV;2;1;1;0;0;0;0;1;0;0;0;0;1;0
23053.0;2023;70;NORMANDIE;MASCULIN;SCOLAIRE;BAC TECHNOLOGIQUE;BAC S2TMD;BAC S2TMD DANSE;2;2;1;1;0;0;0;1;0;1;0;0;0;1
12760.0;2022;11;MONTPELLIER;FEMININ;INDIVIDUEL;BAC PROFESSIONNEL;BAC PRO PROD;BAC PRO AG 21114 CONDUITE PRODUCTIONS HORTICOLES;3;3;2;1;0;0;0;2;0;0;0;0;2;1
23060.0;2023;70;NORMANDIE;MASCULIN;SCOLAIRE;BAC TECHNOLOGIQUE;BAC STI2D;BAC STI2D ENERGIES  ET ENVIRONNEMENT;292;292;246;7;39;21;18;267;0;2;34;98;133;25
12764.0;2022;11;MONTPELLIER;FEMININ;INDIVIDUEL;BAC PROFESSIONNEL;BAC PRO SERV;BAC PRO 31213 MET.COM.VEN.OP.A ANI.GES.ESP.COM.;2;1;1;0;0;0;0;1;0;0;0;1;0;0
23065.0;2023;70;NORMANDIE;MASCULIN;SCOLAIRE;BAC TECHNOLOGIQUE;BAC STMG;BAC STMG GESTION ET FINANCE;402;402;287;30;85;68;17;355;0;3;28;77;247;47
12767.0;2022;11;MONTPELLIER;FEMININ;INDIVIDUEL;BAC PROFESSIONNEL;BAC PRO SERV;BAC PRO 33003 ACC.SOINS-S.PERS. OPT.A DOMICILE;1;1;1;0;0;0;0;1;0;0;0;0;1;0
23079.0;2023;18;ORLEANS-TOURS;FEMININ;APPRENTISSAGE;BAC PROFESSIONNEL;BAC PRO PROD;BAC PRO AG 21004 CGEA;9;9;7;2;0;0;0;7;0;0;0;3;4;2
12773.0;2022;11;MONTPELLIER;FEMININ;INDIVIDUEL;BAC TECHNOLOGIQUE;BAC STI2D;BAC STI2D ARCHITECTURE ET CONSTRUCTION;2;1;0;0;1;1;0;1;0;0;0;0;1;0
23085.0;2023;18;ORLEANS-TOURS;FEMININ;APPRENTISSAGE;BAC PROFESSIONNEL;BAC PRO PROD;BAC PRO AG 22108 TEC CONS VTE ALIMENTATION (PAB);5;5;3;2;0;0;0;3;0;0;0;0;3;2
12774.0;2022;11;MONTPELLIER;FEMININ;INDIVIDUEL;BAC TECHNOLOGIQUE;BAC STL;BAC STL BIOCHIM.-BIOLOGIE-BIOTECHNOL.;1;0;0;0;0;0;0;0;0;0;0;0;0;0
23089.0;2023;18;ORLEANS-TOURS;FEMININ;APPRENTISSAGE;BAC PROFESSIONNEL;BAC PRO SERV;BAC PRO 31212 METIERS DE L'ACCUEIL;8;8;7;0;1;0;1;7;0;2;1;3;1;1
12782.0;2022;11;MONTPELLIER;FEMININ;SCOLAIRE;BAC PROFESSIONNEL;BAC PRO PROD;BAC PRO 22105 BOULANGER-PÂTISSIER;24;24;23;1;0;0;0;23;0;2;9;10;2;1
23090.0;2023;18;ORLEANS-TOURS;FEMININ;APPRENTISSAGE;BAC PROFESSIONNEL;BAC PRO SERV;BAC PRO 31213 MET.COM.VEN.OP.A ANI.GES.ESP.COM.;97;95;77;12;6;4;2;81;0;3;14;32;32;14
12784.0;2022;11;MONTPELLIER;FEMININ;SCOLAIRE;BAC PROFESSIONNEL;BAC PRO PROD;BAC PRO 22403 ARTS.& MET.ART:MET.ENSEIGN SIGNA;4;4;3;1;0;0;0;3;0;0;0;1;2;1
23094.0;2023;18;ORLEANS-TOURS;FEMININ;APPRENTISSAGE;BAC PROFESSIONNEL;BAC PRO SERV;BAC PRO 33006 ANIMAT. ENFANCE& PERSONNES AGEES;1;1;1;0;0;0;0;1;0;0;1;0;0;0
12795.0;2022;11;MONTPELLIER;FEMININ;SCOLAIRE;BAC PROFESSIONNEL;BAC PRO PROD;BAC PRO 24202 ARTIS.& MET.ART : TAPIS.D'AMEUBL;13;13;9;4;0;0;0;9;0;0;2;3;4;4
23095.0;2023;18;ORLEANS-TOURS;FEMININ;APPRENTISSAGE;BAC PROFESSIONNEL;BAC PRO SERV;BAC PRO 33403 COMMERC. SERVICES EN RESTAURATION;3;3;2;1;0;0;0;2;0;0;0;1;1;1
12804.0;2022;11;MONTPELLIER;FEMININ;SCOLAIRE;BAC PROFESSIONNEL;BAC PRO PROD;BAC PRO 25220 MAINT.MATERIELS OPT.B TP MANUT.;1;1;0;0;1;1;0;1;0;0;0;0;1;0
23097.0;2023;18;ORLEANS-TOURS;FEMININ;APPRENTISSAGE;BAC PROFESSIONNEL;BAC PRO SERV;BAC PRO AG 33002 SERV PERS TERRIT;12;12;12;0;0;0;0;12;0;0;0;1;11;0
12805.0;2022;11;MONTPELLIER;FEMININ;SCOLAIRE;BAC PROFESSIONNEL;BAC PRO PROD;BAC PRO 25303 AERONAUTIQUE OPTION SYSTEMES;2;2;2;0;0;0;0;2;0;1;1;0;0;0
23104.0;2023;18;ORLEANS-TOURS;FEMININ;FORMATION CONTINUE;BAC PROFESSIONNEL;BAC PRO PROD;BAC PRO 25106 TECHNICIEN D'USINAGE;1;1;1;0;0;0;0;1;0;1;0;0;0;0
12812.0;2022;11;MONTPELLIER;FEMININ;SCOLAIRE;BAC PROFESSIONNEL;BAC PRO PROD;BAC PRO AG 21113 CGEVV;11;11;11;0;0;0;0;11;0;0;1;3;7;0
23106.0;2023;18;ORLEANS-TOURS;FEMININ;FORMATION CONTINUE;BAC PROFESSIONNEL;BAC PRO PROD;BAC PRO 25215 MAINT.VEHIC.OPTB VEHIC.TRANS.ROUT;1;1;1;0;0;0;0;1;0;0;0;1;0;0
12816.0;2022;11;MONTPELLIER;FEMININ;SCOLAIRE;BAC PROFESSIONNEL;BAC PRO PROD;BAC PRO AG 21211 COND GEST ENTR HIPPIQUE;52;51;46;5;0;0;0;46;0;1;6;12;27;5
23107.0;2023;18;ORLEANS-TOURS;FEMININ;FORMATION CONTINUE;BAC PROFESSIONNEL;BAC PRO PROD;BAC PRO 25303 AERONAUTIQUE OPTION SYSTEMES;1;1;1;0;0;0;0;1;0;1;0;0;0;0
12822.0;2022;11;MONTPELLIER;FEMININ;SCOLAIRE;BAC PROFESSIONNEL;BAC PRO SERV;BAC PRO 30001 GESTION-ADMINISTRATION;537;535;412;103;20;14;6;426;0;15;85;154;172;109
23109.0;2023;18;ORLEANS-TOURS;FEMININ;FORMATION CONTINUE;BAC PROFESSIONNEL;BAC PRO SERV;BAC PRO 30004 ASSISTANC.GEST.ORGANIS.ACTIVITES;19;19;14;5;0;0;0;14;0;0;2;7;5;5
12823.0;2022;11;MONTPELLIER;FEMININ;SCOLAIRE;BAC PROFESSIONNEL;BAC PRO SERV;BAC PRO 31106 LOGISTIQUE;17;17;11;5;1;0;1;11;0;1;5;2;3;6
23111.0;2023;18;ORLEANS-TOURS;FEMININ;FORMATION CONTINUE;BAC PROFESSIONNEL;BAC PRO SERV;BAC PRO 31214 MET.COM.VEN.OP.B PR.CL.VA.OF.COM.;2;2;0;2;0;0;0;0;0;0;0;0;0;2
12830.0;2022;11;MONTPELLIER;FEMININ;SCOLAIRE;BAC PROFESSIONNEL;BAC PRO SERV;BAC PRO 32208 REAL.PR.IMPR.PLURI.OPTB.PR.IMPR.;4;4;4;0;0;0;0;4;0;0;1;1;2;0
23116.0;2023;18;ORLEANS-TOURS;FEMININ;INDIVIDUEL;BAC PROFESSIONNEL;BAC PRO PROD;BAC PRO AG 21203 TECHN CONSEIL DE VENTE ANIMAL;1;1;0;1;0;0;0;0;0;0;0;0;0;1
12837.0;2022;11;MONTPELLIER;FEMININ;SCOLAIRE;BAC PROFESSIONNEL;BAC PRO SERV;BAC PRO 33102 PROTHESE DENTAIRE;11;11;5;6;0;0;0;5;0;0;1;2;2;6
23131.0;2023;18;ORLEANS-TOURS;FEMININ;INDIVIDUEL;BAC TECHNOLOGIQUE;BAC STMG;BAC STMG GESTION ET FINANCE;3;3;0;3;0;0;0;0;0;0;0;0;0;3
12847.0;2022;11;MONTPELLIER;FEMININ;SCOLAIRE;BAC TECHNOLOGIQUE;BAC STD2A;BAC STD2A SCIENCES & TECHNO. DESIGN-ARTS APPLIQUES;117;117;113;1;3;2;1;115;0;7;32;48;28;2
23137.0;2023;18;ORLEANS-TOURS;FEMININ;SCOLAIRE;BAC PROFESSIONNEL;BAC PRO PROD;BAC PRO 22003 BIO-INDUSTRIES DE TRANSFORMATION;12;12;7;5;0;0;0;7;0;0;1;1;5;5
12854.0;2022;11;MONTPELLIER;FEMININ;SCOLAIRE;BAC TECHNOLOGIQUE;BAC STL;BAC STL SCIENCES PHYSIQUES CHIMIQUES  EN LABORAT.;60;60;49;3;8;5;3;54;1;4;7;16;26;6
23140.0;2023;18;ORLEANS-TOURS;FEMININ;SCOLAIRE;BAC PROFESSIONNEL;BAC PRO PROD;BAC PRO 22403 ARTS.& MET.ART:MET.ENSEIGN SIGNA;4;4;4;0;0;0;0;4;0;0;0;2;2;0
12856.0;2022;11;MONTPELLIER;FEMININ;SCOLAIRE;BAC TECHNOLOGIQUE;BAC STMG;BAC STMG MERCATIQUE (MARKETING);762;762;667;24;71;44;27;711;0;26;124;257;304;51
23152.0;2023;18;ORLEANS-TOURS;FEMININ;SCOLAIRE;BAC PROFESSIONNEL;BAC PRO PROD;BAC PRO 24203 METIERS DE LA MODE - VÊTEMENT;91;91;77;9;5;5;0;82;0;8;18;27;29;9
12870.0;2022;11;MONTPELLIER;MASCULIN;APPRENTISSAGE;BAC PROFESSIONNEL;BAC PRO PROD;BAC PRO 23404 TECHNICIEN CONSTRUCTEUR BOIS;4;4;2;2;0;0;0;2;0;0;0;0;2;2
23161.0;2023;18;ORLEANS-TOURS;FEMININ;SCOLAIRE;BAC PROFESSIONNEL;BAC PRO PROD;BAC PRO 25221 MAINT.MATERIELS OPT.C ESP. VERTS;1;1;1;0;0;0;0;1;0;0;0;0;1;0
12874.0;2022;11;MONTPELLIER;MASCULIN;APPRENTISSAGE;BAC PROFESSIONNEL;BAC PRO PROD;BAC PRO 25106 TECHNICIEN D'USINAGE;6;6;6;0;0;0;0;6;0;1;3;1;1;0
23163.0;2023;18;ORLEANS-TOURS;FEMININ;SCOLAIRE;BAC PROFESSIONNEL;BAC PRO PROD;BAC PRO 25509 TECHNIC. FROID CONDITIONNEMT AIR;1;1;0;1;0;0;0;0;0;0;0;0;0;1
12878.0;2022;11;MONTPELLIER;MASCULIN;APPRENTISSAGE;BAC PROFESSIONNEL;BAC PRO PROD;BAC PRO 25220 MAINT.MATERIELS OPT.B TP MANUT.;5;5;5;0;0;0;0;5;0;0;1;3;1;0
23172.0;2023;18;ORLEANS-TOURS;FEMININ;SCOLAIRE;BAC PROFESSIONNEL;BAC PRO PROD;BAC PRO AG 21203 TECHN CONSEIL DE VENTE ANIMAL;27;27;22;5;0;0;0;22;0;0;1;7;14;5
12879.0;2022;11;MONTPELLIER;MASCULIN;APPRENTISSAGE;BAC PROFESSIONNEL;BAC PRO PROD;BAC PRO 25302 AERONAUTIQUE OPTION AVIONIQUE;1;1;1;0;0;0;0;1;0;0;1;0;0;0
23189.0;2023;18;ORLEANS-TOURS;FEMININ;SCOLAIRE;BAC PROFESSIONNEL;BAC PRO SERV;BAC PRO 32208 REAL.PR.IMPR.PLURI.OPTB.PR.IMPR.;6;6;6;0;0;0;0;6;0;0;2;1;3;0
12881.0;2022;11;MONTPELLIER;MASCULIN;APPRENTISSAGE;BAC PROFESSIONNEL;BAC PRO PROD;BAC PRO 25406 OUVRAGES DU BATIMENT METALLERIE;4;4;3;0;1;1;0;4;0;0;0;3;1;0
23196.0;2023;18;ORLEANS-TOURS;FEMININ;SCOLAIRE;BAC PROFESSIONNEL;BAC PRO SERV;BAC PRO 33403 COMMERC. SERVICES EN RESTAURATION;53;53;39;9;5;3;2;42;0;3;9;11;19;11
12889.0;2022;11;MONTPELLIER;MASCULIN;APPRENTISSAGE;BAC PROFESSIONNEL;BAC PRO PROD;BAC PRO AG 21211 COND GEST ENTR HIPPIQUE;1;1;1;0;0;0;0;1;0;0;0;0;1;0
23197.0;2023;18;ORLEANS-TOURS;FEMININ;SCOLAIRE;BAC PROFESSIONNEL;BAC PRO SERV;BAC PRO 33603 ESTHETIQUE COSMETIQUE PARFUMERIE;128;128;116;12;0;0;0;116;0;6;27;47;36;12
12892.0;2022;11;MONTPELLIER;MASCULIN;APPRENTISSAGE;BAC PROFESSIONNEL;BAC PRO PROD;BAC PRO AG 22107 TEC CONS VTE ALIMENTATION P.ALIM;1;1;0;1;0;0;0;0;0;0;0;0;0;1
23204.0;2023;18;ORLEANS-TOURS;FEMININ;SCOLAIRE;BAC TECHNOLOGIQUE;BAC ST2S;BAC ST2S SCIENCES & TECHNO. SANTE & SOCIAL;530;530;452;9;69;42;27;494;2;20;76;167;229;36
12896.0;2022;11;MONTPELLIER;MASCULIN;APPRENTISSAGE;BAC PROFESSIONNEL;BAC PRO SERV;BAC PRO 33101 OPTIQUE LUNETTERIE;10;10;7;3;0;0;0;7;0;0;3;1;3;3
23210.0;2023;18;ORLEANS-TOURS;FEMININ;SCOLAIRE;BAC TECHNOLOGIQUE;BAC STI2D;BAC STI2D INNOVATION TECHNO.  ET ECO CONCEPTION;23;23;20;1;2;1;1;21;0;1;2;7;11;2
12900.0;2022;11;MONTPELLIER;MASCULIN;APPRENTISSAGE;BAC PROFESSIONNEL;BAC PRO SERV;BAC PRO AG 33002 SERV PERS TERRIT;2;2;2;0;0;0;0;2;0;0;0;2;0;0
23211.0;2023;18;ORLEANS-TOURS;FEMININ;SCOLAIRE;BAC TECHNOLOGIQUE;BAC STI2D;BAC STI2D SYSTÈME D'INFORMATION  ET NUMERIQUE;21;21;20;0;1;1;0;21;0;1;6;8;6;0
12907.0;2022;11;MONTPELLIER;MASCULIN;ENSEIGNEMENT A DISTANCE;BAC TECHNOLOGIQUE;BAC STMG;BAC STMG MERCATIQUE (MARKETING);36;36;28;6;2;1;1;29;0;1;2;14;12;7
23217.0;2023;18;ORLEANS-TOURS;FEMININ;SCOLAIRE;BAC TECHNOLOGIQUE;BAC STMG;BAC STMG SYSTEMES D'INFORMATION DE GESTION;8;8;7;0;1;0;1;7;0;0;2;2;3;1
12918.0;2022;11;MONTPELLIER;MASCULIN;FORMATION CONTINUE;BAC PROFESSIONNEL;BAC PRO SERV;BAC PRO 31213 MET.COM.VEN.OP.A ANI.GES.ESP.COM.;11;11;11;0;0;0;0;11;0;3;1;5;2;0
23218.0;2023;18;ORLEANS-TOURS;MASCULIN;APPRENTISSAGE;BAC PROFESSIONNEL;BAC PRO PROD;BAC PRO 22104 BOUCHER CHARCUTIER TRAITEUR;3;3;3;0;0;0;0;3;0;0;1;1;1;0
12920.0;2022;11;MONTPELLIER;MASCULIN;INDIVIDUEL;BAC PROFESSIONNEL;BAC PRO PROD;BAC PRO 22004 PROC. CHIMIE EAU PAPIERS-CARTONS;1;1;1;0;0;0;0;1;0;0;0;0;1;0
23223.0;2023;18;ORLEANS-TOURS;MASCULIN;APPRENTISSAGE;BAC PROFESSIONNEL;BAC PRO PROD;BACPRO 23103 TECHNICIEN GEOMETRE-TOPOGRAPHE;3;3;3;0;0;0;0;3;0;0;1;2;0;0
12921.0;2022;11;MONTPELLIER;MASCULIN;INDIVIDUEL;BAC PROFESSIONNEL;BAC PRO PROD;BAC PRO 22106 CUISINE;2;1;1;0;0;0;0;1;0;0;1;0;0;0
23227.0;2023;18;ORLEANS-TOURS;MASCULIN;APPRENTISSAGE;BAC PROFESSIONNEL;BAC PRO PROD;BAC PRO 23303 MENUISERIE ALUMINIUM-VERRE;8;8;4;3;1;1;0;5;0;1;2;0;2;3
12929.0;2022;11;MONTPELLIER;MASCULIN;INDIVIDUEL;BAC PROFESSIONNEL;BAC PRO PROD;BAC PRO AG 21114 CONDUITE PRODUCTIONS HORTICOLES;2;2;2;0;0;0;0;2;0;0;0;0;2;0
23229.0;2023;18;ORLEANS-TOURS;MASCULIN;APPRENTISSAGE;BAC PROFESSIONNEL;BAC PRO PROD;BAC PRO 23404 TECHNICIEN CONSTRUCTEUR BOIS;6;6;4;2;0;0;0;4;0;0;0;1;3;2
12930.0;2022;11;MONTPELLIER;MASCULIN;INDIVIDUEL;BAC PROFESSIONNEL;BAC PRO PROD;BAC PRO AG 21211 COND GEST ENTR HIPPIQUE;1;0;0;0;0;0;0;0;0;0;0;0;0;0
23230.0;2023;18;ORLEANS-TOURS;MASCULIN;APPRENTISSAGE;BAC PROFESSIONNEL;BAC PRO PROD;BAC PRO 23405 TECHNICIEN MENUISIER AGENCEUR;8;8;7;1;0;0;0;7;0;1;1;1;4;1
12933.0;2022;11;MONTPELLIER;MASCULIN;INDIVIDUEL;BAC PROFESSIONNEL;BAC PRO SERV;BAC PRO 33004 ACC.SOINS-S.PERS. OPT.EN STRUCTUR;2;0;0;0;0;0;0;0;0;0;0;0;0;0
23240.0;2023;18;ORLEANS-TOURS;MASCULIN;APPRENTISSAGE;BAC PROFESSIONNEL;BAC PRO PROD;BAC PRO 25406 OUVRAGES DU BATIMENT METALLERIE;1;1;0;1;0;0;0;0;0;0;0;0;0;1
12934.0;2022;11;MONTPELLIER;MASCULIN;INDIVIDUEL;BAC PROFESSIONNEL;BAC PRO SERV;BAC PRO 33102 PROTHESE DENTAIRE;2;2;0;2;0;0;0;0;0;0;0;0;0;2
23249.0;2023;18;ORLEANS-TOURS;MASCULIN;APPRENTISSAGE;BAC PROFESSIONNEL;BAC PRO PROD;BAC PRO AG 21004 CGEA;104;102;68;34;0;0;0;68;0;1;2;20;45;34
12940.0;2022;11;MONTPELLIER;MASCULIN;INDIVIDUEL;BAC TECHNOLOGIQUE;BAC STI2D;BAC STI2D INNOVATION TECHNO.  ET ECO CONCEPTION;1;1;0;1;0;0;0;0;0;0;0;0;0;1
23263.0;2023;18;ORLEANS-TOURS;MASCULIN;APPRENTISSAGE;BAC PROFESSIONNEL;BAC PRO SERV;BAC PRO 33403 COMMERC. SERVICES EN RESTAURATION;5;5;4;0;1;0;1;4;0;0;1;1;2;1
12948.0;2022;11;MONTPELLIER;MASCULIN;SCOLAIRE;BAC PROFESSIONNEL;BAC PRO PROD;BACPRO 20002 ETUD.DEFINITION PRDTS INDUSTRIEL;24;24;16;7;1;1;0;17;0;0;2;7;8;7
23264.0;2023;18;ORLEANS-TOURS;MASCULIN;APPRENTISSAGE;BAC PROFESSIONNEL;BAC PRO SERV;BAC PRO 34304 HYGIENE PROPRETE STERILISATION;4;4;3;0;1;0;1;3;0;2;0;0;1;1
12949.0;2022;11;MONTPELLIER;MASCULIN;SCOLAIRE;BAC PROFESSIONNEL;BAC PRO PROD;BAC PRO 20102 PILOTE DE LIGNE DE PRODUCTION;7;7;5;2;0;0;0;5;0;0;1;1;3;2
23265.0;2023;18;ORLEANS-TOURS;MASCULIN;APPRENTISSAGE;BAC PROFESSIONNEL;BAC PRO SERV;BAC PRO AG 33002 SERV PERS TERRIT;2;2;2;0;0;0;0;2;0;0;0;1;1;0
12950.0;2022;11;MONTPELLIER;MASCULIN;SCOLAIRE;BAC PROFESSIONNEL;BAC PRO PROD;BAC PRO 22003 BIO-INDUSTRIES DE TRANSFORMATION;8;8;3;5;0;0;0;3;0;0;1;1;1;5
23269.0;2023;18;ORLEANS-TOURS;MASCULIN;ENSEIGNEMENT A DISTANCE;BAC TECHNOLOGIQUE;BAC STMG;BAC STMG MERCATIQUE (MARKETING);2;2;1;0;1;1;0;2;0;0;0;0;2;0
12958.0;2022;11;MONTPELLIER;MASCULIN;SCOLAIRE;BAC PROFESSIONNEL;BAC PRO PROD;BAC PRO 23003 ARTIS. & M.ART:MARCHANDISAGE VIS.;1;1;1;0;0;0;0;1;0;0;0;1;0;0
23273.0;2023;18;ORLEANS-TOURS;MASCULIN;FORMATION CONTINUE;BAC PROFESSIONNEL;BAC PRO PROD;BAC PRO 23303 MENUISERIE ALUMINIUM-VERRE;1;1;1;0;0;0;0;1;0;0;0;0;1;0
12963.0;2022;11;MONTPELLIER;MASCULIN;SCOLAIRE;BAC PROFESSIONNEL;BAC PRO PROD;BAC PRO 23203 TECHNICIEN BAT. : ORG.REAL.GROS O;10;10;8;2;0;0;0;8;0;0;1;1;6;2
23276.0;2023;18;ORLEANS-TOURS;MASCULIN;FORMATION CONTINUE;BAC PROFESSIONNEL;BAC PRO PROD;BAC PRO 25106 TECHNICIEN D'USINAGE;1;1;1;0;0;0;0;1;0;0;0;1;0;0
12965.0;2022;11;MONTPELLIER;MASCULIN;SCOLAIRE;BAC PROFESSIONNEL;BAC PRO PROD;BAC PRO 23208 METIERS ET ARTS DE LA PIERRE;2;2;2;0;0;0;0;2;0;0;0;0;2;0
23277.0;2023;18;ORLEANS-TOURS;MASCULIN;FORMATION CONTINUE;BAC PROFESSIONNEL;BAC PRO PROD;BAC PRO 25214 MAINT.VEHIC.OPTA VOIT.PARTICUL.;1;1;1;0;0;0;0;1;0;1;0;0;0;0
12967.0;2022;11;MONTPELLIER;MASCULIN;SCOLAIRE;BAC PROFESSIONNEL;BAC PRO PROD;BAC PRO 23304 AMENAGEMENT FINITION BATIMENT;10;10;6;4;0;0;0;6;0;0;1;1;4;4
23278.0;2023;18;ORLEANS-TOURS;MASCULIN;FORMATION CONTINUE;BAC PROFESSIONNEL;BAC PRO PROD;BAC PRO 25215 MAINT.VEHIC.OPTB VEHIC.TRANS.ROUT;22;22;20;2;0;0;0;20;0;1;8;8;3;2
12969.0;2022;11;MONTPELLIER;MASCULIN;SCOLAIRE;BAC PROFESSIONNEL;BAC PRO PROD;BAC PRO 23405 TECHNICIEN MENUISIER AGENCEUR;45;44;29;13;2;1;1;30;0;3;9;8;10;14
23280.0;2023;18;ORLEANS-TOURS;MASCULIN;FORMATION CONTINUE;BAC PROFESSIONNEL;BAC PRO PROD;BAC PRO 25303 AERONAUTIQUE OPTION SYSTEMES;22;22;22;0;0;0;0;22;0;0;7;13;2;0
12979.0;2022;11;MONTPELLIER;MASCULIN;SCOLAIRE;BAC PROFESSIONNEL;BAC PRO PROD;BAC PRO 25214 MAINT.VEHIC.OPTA VOIT.PARTICUL.;212;211;137;65;9;5;4;142;0;7;24;53;58;69
23284.0;2023;18;ORLEANS-TOURS;MASCULIN;FORMATION CONTINUE;BAC PROFESSIONNEL;BAC PRO PROD;BAC PRO AG 21405 AMENAGEMENTS PAYSAGERS;11;11;11;0;0;0;0;11;0;1;0;0;10;0
12984.0;2022;11;MONTPELLIER;MASCULIN;SCOLAIRE;BAC PROFESSIONNEL;BAC PRO PROD;BAC PRO 25302 AERONAUTIQUE OPTION AVIONIQUE;13;13;13;0;0;0;0;13;0;5;1;5;2;0
23295.0;2023;18;ORLEANS-TOURS;MASCULIN;INDIVIDUEL;BAC PROFESSIONNEL;BAC PRO PROD;BAC PRO 25410 CONSTRUCTION DES CARROSSERIES;1;1;1;0;0;0;0;1;0;1;0;0;0;0
12988.0;2022;11;MONTPELLIER;MASCULIN;SCOLAIRE;BAC PROFESSIONNEL;BAC PRO PROD;BAC PRO 25411 TECH.CHAUDRONNERIE INDUSTRIELLE;54;54;42;8;4;3;1;45;0;3;8;20;14;9
23308.0;2023;18;ORLEANS-TOURS;MASCULIN;INDIVIDUEL;BAC PROFESSIONNEL;BAC PRO SERV;BAC PRO 33002 SERVICES DE PROXIMITE  VIE LOCAL;1;1;1;0;0;0;0;1;0;0;0;0;1;0
12990.0;2022;11;MONTPELLIER;MASCULIN;SCOLAIRE;BAC PROFESSIONNEL;BAC PRO PROD;BAC PRO 25510 METIERS ELECT. ENVIRON. CONNECTES;420;419;296;100;23;15;8;311;0;17;46;110;138;108
23310.0;2023;18;ORLEANS-TOURS;MASCULIN;INDIVIDUEL;BAC TECHNOLOGIQUE;BAC STD2A;BAC STD2A SCIENCES & TECHNO. DESIGN-ARTS APPLIQUES;1;1;0;1;0;0;0;0;0;0;0;0;0;1
12999.0;2022;11;MONTPELLIER;MASCULIN;SCOLAIRE;BAC PROFESSIONNEL;BAC PRO PROD;BAC PRO AG 21204 PROD-AQUACOLES;10;10;9;1;0;0;0;9;0;0;1;3;5;1
23311.0;2023;18;ORLEANS-TOURS;MASCULIN;INDIVIDUEL;BAC TECHNOLOGIQUE;BAC STI2D;BAC STI2D ARCHITECTURE ET CONSTRUCTION;1;1;1;0;0;0;0;1;0;0;1;0;0;0
13010.0;2022;11;MONTPELLIER;MASCULIN;SCOLAIRE;BAC PROFESSIONNEL;BAC PRO SERV;BAC PRO 31107 CONDUCT. TRANSP.ROUT.MARCHANDISES;44;44;33;9;2;2;0;35;0;1;5;19;10;9
23314.0;2023;18;ORLEANS-TOURS;MASCULIN;INDIVIDUEL;BAC TECHNOLOGIQUE;BAC STMG;BAC STMG GESTION ET FINANCE;2;2;0;2;0;0;0;0;0;0;0;0;0;2
13021.0;2022;11;MONTPELLIER;MASCULIN;SCOLAIRE;BAC PROFESSIONNEL;BAC PRO SERV;BAC PRO 33004 ACC.SOINS-S.PERS. OPT.EN STRUCTUR;50;50;42;7;1;1;0;43;0;3;7;14;19;7
23328.0;2023;18;ORLEANS-TOURS;MASCULIN;SCOLAIRE;BAC PROFESSIONNEL;BAC PRO PROD;BAC PRO 23003 ARTIS. & M.ART:MARCHANDISAGE VIS.;1;1;1;0;0;0;0;1;0;0;0;1;0;0
13022.0;2022;11;MONTPELLIER;MASCULIN;SCOLAIRE;BAC PROFESSIONNEL;BAC PRO SERV;BAC PRO 33101 OPTIQUE LUNETTERIE;1;1;1;0;0;0;0;1;0;0;0;1;0;0
23332.0;2023;18;ORLEANS-TOURS;MASCULIN;SCOLAIRE;BAC PROFESSIONNEL;BAC PRO PROD;BACPRO 23103 TECHNICIEN GEOMETRE-TOPOGRAPHE;20;20;14;5;1;1;0;15;0;1;3;3;8;5
13025.0;2022;11;MONTPELLIER;MASCULIN;SCOLAIRE;BAC PROFESSIONNEL;BAC PRO SERV;BAC PRO 34304 HYGIENE PROPRETE STERILISATION;2;2;2;0;0;0;0;2;0;0;0;1;1;0
23333.0;2023;18;ORLEANS-TOURS;MASCULIN;SCOLAIRE;BAC PROFESSIONNEL;BAC PRO PROD;BAC PRO 23203 TECHNICIEN BAT. : ORG.REAL.GROS O;18;18;11;3;4;3;1;14;0;0;0;6;8;4
13031.0;2022;11;MONTPELLIER;MASCULIN;SCOLAIRE;BAC TECHNOLOGIQUE;BAC STD2A;BAC STD2A SCIENCES & TECHNO. DESIGN-ARTS APPLIQUES;31;31;29;0;2;1;1;30;0;0;9;11;10;1
23353.0;2023;18;ORLEANS-TOURS;MASCULIN;SCOLAIRE;BAC PROFESSIONNEL;BAC PRO PROD;BAC PRO 25219 MAINT.MATERIELS OPT.A AGRICOLES;10;10;7;1;2;2;0;9;0;0;1;5;3;1
13040.0;2022;11;MONTPELLIER;MASCULIN;SCOLAIRE;BAC TECHNOLOGIQUE;BAC STMG;BAC STMG MERCATIQUE (MARKETING);814;814;632;52;130;92;38;724;0;3;71;262;388;90
23354.0;2023;18;ORLEANS-TOURS;MASCULIN;SCOLAIRE;BAC PROFESSIONNEL;BAC PRO PROD;BAC PRO 25220 MAINT.MATERIELS OPT.B TP MANUT.;2;2;2;0;0;0;0;2;0;0;0;2;0;0
13041.0;2022;11;MONTPELLIER;MASCULIN;SCOLAIRE;BAC TECHNOLOGIQUE;BAC STMG;BAC STMG RESSOURCES HUMAINES ET COMMUNICATION;302;302;238;18;46;24;22;262;0;3;22;82;155;40
23357.0;2023;18;ORLEANS-TOURS;MASCULIN;SCOLAIRE;BAC PROFESSIONNEL;BAC PRO PROD;BAC PRO 25408 REPARATION DES CARROSSERIES;47;47;30;13;4;3;1;33;0;1;3;12;17;14
13042.0;2022;11;MONTPELLIER;MASCULIN;SCOLAIRE;BAC TECHNOLOGIQUE;BAC STMG;BAC STMG SYSTEMES D'INFORMATION DE GESTION;29;29;17;7;5;1;4;18;0;0;1;8;9;11
23360.0;2023;18;ORLEANS-TOURS;MASCULIN;SCOLAIRE;BAC PROFESSIONNEL;BAC PRO PROD;BAC PRO 25509 TECHNIC. FROID CONDITIONNEMT AIR;38;38;24;12;2;1;1;25;0;2;6;10;7;13
13043.0;2022;12;NANCY-METZ;FEMININ;APPRENTISSAGE;BAC PROFESSIONNEL;BAC PRO PROD;BAC PRO 20102 PILOTE DE LIGNE DE PRODUCTION;1;1;1;0;0;0;0;1;0;1;0;0;0;0
23361.0;2023;18;ORLEANS-TOURS;MASCULIN;SCOLAIRE;BAC PROFESSIONNEL;BAC PRO PROD;BAC PRO 25510 METIERS ELECT. ENVIRON. CONNECTES;427;427;307;91;29;26;3;333;0;15;42;122;154;94
13056.0;2022;12;NANCY-METZ;FEMININ;APPRENTISSAGE;BAC PROFESSIONNEL;BAC PRO PROD;BAC PRO AG 21001 AGRO-EQUIPEMENT;1;1;1;0;0;0;0;1;0;0;1;0;0;0
23363.0;2023;18;ORLEANS-TOURS;MASCULIN;SCOLAIRE;BAC PROFESSIONNEL;BAC PRO PROD;BAC PRO 25514 SYST.NUM.OPT.B AUD.RES.EQUIP.DOM.;64;64;54;7;3;3;0;57;0;7;15;17;18;7
13059.0;2022;12;NANCY-METZ;FEMININ;APPRENTISSAGE;BAC PROFESSIONNEL;BAC PRO PROD;BAC PRO AG 21203 TECHN CONSEIL DE VENTE ANIMAL;1;1;0;1;0;0;0;0;0;0;0;0;0;1
23377.0;2023;18;ORLEANS-TOURS;MASCULIN;SCOLAIRE;BAC PROFESSIONNEL;BAC PRO PROD;BAC PRO AG 22108 TEC CONS VTE ALIMENTATION (PAB);18;17;14;3;0;0;0;14;0;0;1;3;10;3
13060.0;2022;12;NANCY-METZ;FEMININ;APPRENTISSAGE;BAC PROFESSIONNEL;BAC PRO PROD;BAC PRO AG 21210 COND GEST ENTR CANIN ET FELIN;11;11;10;1;0;0;0;10;0;0;2;3;5;1
23380.0;2023;18;ORLEANS-TOURS;MASCULIN;SCOLAIRE;BAC PROFESSIONNEL;BAC PRO SERV;BAC PRO 31107 CONDUCT. TRANSP.ROUT.MARCHANDISES;69;69;59;10;0;0;0;59;0;3;16;24;16;10
13061.0;2022;12;NANCY-METZ;FEMININ;APPRENTISSAGE;BAC PROFESSIONNEL;BAC PRO PROD;BAC PRO AG 21211 COND GEST ENTR HIPPIQUE;12;11;9;2;0;0;0;9;0;0;1;2;6;2
23384.0;2023;18;ORLEANS-TOURS;MASCULIN;SCOLAIRE;BAC PROFESSIONNEL;BAC PRO SERV;BAC PRO 31214 MET.COM.VEN.OP.B PR.CL.VA.OF.COM.;228;227;184;36;7;5;2;189;0;9;44;75;61;38
13062.0;2022;12;NANCY-METZ;FEMININ;APPRENTISSAGE;BAC PROFESSIONNEL;BAC PRO PROD;BAC PRO AG 21302 GEST MILIEUX NATURELS FAUNE;1;1;1;0;0;0;0;1;0;0;0;1;0;0
23395.0;2023;18;ORLEANS-TOURS;MASCULIN;SCOLAIRE;BAC PROFESSIONNEL;BAC PRO SERV;BAC PRO 33604 METIERS DE LA COIFFURE;1;1;0;1;0;0;0;0;0;0;0;0;0;1
13065.0;2022;12;NANCY-METZ;FEMININ;APPRENTISSAGE;BAC PROFESSIONNEL;BAC PRO SERV;BAC PRO 31106 LOGISTIQUE;2;2;1;0;1;1;0;2;0;0;0;1;1;0
23414.0;2023;18;ORLEANS-TOURS;MASCULIN;SCOLAIRE;BAC TECHNOLOGIQUE;BAC STMG;BAC STMG RESSOURCES HUMAINES ET COMMUNICATION;248;248;171;22;55;40;15;211;0;2;9;47;153;37
13070.0;2022;12;NANCY-METZ;FEMININ;APPRENTISSAGE;BAC PROFESSIONNEL;BAC PRO SERV;BAC PRO 33101 OPTIQUE LUNETTERIE;2;2;2;0;0;0;0;2;0;0;1;1;0;0
23426.0;2023;01;PARIS;FEMININ;APPRENTISSAGE;BAC PROFESSIONNEL;BAC PRO SERV;BAC PRO 31213 MET.COM.VEN.OP.A ANI.GES.ESP.COM.;52;52;37;13;2;1;1;38;0;4;5;13;16;14
13076.0;2022;12;NANCY-METZ;FEMININ;ENSEIGNEMENT A DISTANCE;BAC TECHNOLOGIQUE;BAC ST2S;BAC ST2S SCIENCES & TECHNO. SANTE & SOCIAL;4;4;2;1;1;0;1;2;0;0;0;1;1;2
23433.0;2023;01;PARIS;FEMININ;APPRENTISSAGE;BAC PROFESSIONNEL;BAC PRO SERV;BAC PRO 33403 COMMERC. SERVICES EN RESTAURATION;27;27;20;6;1;1;0;21;0;2;6;6;7;6
13081.0;2022;12;NANCY-METZ;FEMININ;FORMATION CONTINUE;BAC PROFESSIONNEL;BAC PRO PROD;BAC PRO 22703 TECHN.INSTALL.SYST.ENERG.CLIMATI;1;1;1;0;0;0;0;1;0;0;0;1;0;0
23435.0;2023;01;PARIS;FEMININ;ENSEIGNEMENT A DISTANCE;BAC GENERAL;BAC GENERAL;BAC GENE 10019 BAC GENERAL;58;57;39;8;10;6;4;45;0;2;8;15;20;12
13085.0;2022;12;NANCY-METZ;FEMININ;FORMATION CONTINUE;BAC PROFESSIONNEL;BAC PRO SERV;BAC PRO 30001 GESTION-ADMINISTRATION;44;44;41;2;1;1;0;42;0;7;15;12;8;2
23445.0;2023;01;PARIS;FEMININ;INDIVIDUEL;BAC GENERAL;BAC GENERAL;BAC GENE 10019 BAC GENERAL;403;396;221;117;58;40;18;261;0;24;50;58;129;135
13094.0;2022;12;NANCY-METZ;FEMININ;INDIVIDUEL;BAC PROFESSIONNEL;BAC PRO PROD;BAC PRO AG 21004 CGEA;1;1;0;1;0;0;0;0;0;0;0;0;0;1
23459.0;2023;01;PARIS;FEMININ;INDIVIDUEL;BAC PROFESSIONNEL;BAC PRO SERV;BAC PRO 32303 ART.& MET.ART:COM.VIS.VIS.PLURI-M;2;2;0;2;0;0;0;0;0;0;0;0;0;2
13106.0;2022;12;NANCY-METZ;FEMININ;INDIVIDUEL;BAC PROFESSIONNEL;BAC PRO SERV;BAC PRO 33004 ACC.SOINS-S.PERS. OPT.EN STRUCTUR;6;3;2;1;0;0;0;2;0;0;0;1;1;1
23460.0;2023;01;PARIS;FEMININ;INDIVIDUEL;BAC PROFESSIONNEL;BAC PRO SERV;BAC PRO 33003 ACC.SOINS-S.PERS. OPT.A DOMICILE;3;2;0;2;0;0;0;0;0;0;0;0;0;2
13112.0;2022;12;NANCY-METZ;FEMININ;INDIVIDUEL;BAC TECHNOLOGIQUE;BAC STL;BAC STL BIOCHIM.-BIOLOGIE-BIOTECHNOL.;2;2;0;1;1;0;1;0;0;0;0;0;0;2
23462.0;2023;01;PARIS;FEMININ;INDIVIDUEL;BAC PROFESSIONNEL;BAC PRO SERV;BAC PRO 33104 TECHNICIEN EN PROTHESE DENTAIRE;1;0;0;0;0;0;0;0;0;0;0;0;0;0
13119.0;2022;12;NANCY-METZ;FEMININ;SCOLAIRE;BAC PROFESSIONNEL;BAC PRO PROD;BAC PRO 22105 BOULANGER-PÂTISSIER;61;61;52;7;2;2;0;54;0;3;14;17;20;7
23464.0;2023;01;PARIS;FEMININ;INDIVIDUEL;BAC TECHNOLOGIQUE;BAC S2TMD;BAC S2TMD DANSE;1;1;1;0;0;0;0;1;0;1;0;0;0;0
13120.0;2022;12;NANCY-METZ;FEMININ;SCOLAIRE;BAC PROFESSIONNEL;BAC PRO PROD;BAC PRO 22106 CUISINE;66;66;57;8;1;1;0;58;0;7;15;18;18;8
23467.0;2023;01;PARIS;FEMININ;INDIVIDUEL;BAC TECHNOLOGIQUE;BAC STI2D;BAC STI2D SYSTÈME D'INFORMATION  ET NUMERIQUE;1;1;0;1;0;0;0;0;0;0;0;0;0;1
13124.0;2022;12;NANCY-METZ;FEMININ;SCOLAIRE;BAC PROFESSIONNEL;BAC PRO PROD;BAC PRO 23004 TECHN. ETUDES BAT.A ETUDES & ECO.;11;11;5;6;0;0;0;5;0;0;1;2;2;6
23469.0;2023;01;PARIS;FEMININ;INDIVIDUEL;BAC TECHNOLOGIQUE;BAC STMG;BAC STMG GESTION ET FINANCE;18;18;15;3;0;0;0;15;0;1;4;8;2;3
13129.0;2022;12;NANCY-METZ;FEMININ;SCOLAIRE;BAC PROFESSIONNEL;BAC PRO PROD;BAC PRO 23406 TECHNICIEN DE SCIERIE;1;1;1;0;0;0;0;1;0;0;1;0;0;0
23471.0;2023;01;PARIS;FEMININ;INDIVIDUEL;BAC TECHNOLOGIQUE;BAC STMG;BAC STMG RESSOURCES HUMAINES ET COMMUNICATION;18;18;8;5;5;5;0;13;0;0;2;1;10;5
13136.0;2022;12;NANCY-METZ;FEMININ;SCOLAIRE;BAC PROFESSIONNEL;BAC PRO PROD;BAC PRO 25215 MAINT.VEHIC.OPTB VEHIC.TRANS.ROUT;2;2;2;0;0;0;0;2;0;0;0;1;1;0
23475.0;2023;01;PARIS;FEMININ;SCOLAIRE;BAC PROFESSIONNEL;BAC PRO PROD;BAC PRO 20102 PILOTE DE LIGNE DE PRODUCTION;1;1;1;0;0;0;0;1;0;0;0;1;0;0
13142.0;2022;12;NANCY-METZ;FEMININ;SCOLAIRE;BAC PROFESSIONNEL;BAC PRO PROD;BAC PRO 25514 SYST.NUM.OPT.B AUD.RES.EQUIP.DOM.;2;2;1;1;0;0;0;1;0;1;0;0;0;1
23477.0;2023;01;PARIS;FEMININ;SCOLAIRE;BAC PROFESSIONNEL;BAC PRO PROD;BAC PRO 22004 PROC. CHIMIE EAU PAPIERS-CARTONS;3;3;2;1;0;0;0;2;0;0;0;1;1;1
13147.0;2022;12;NANCY-METZ;FEMININ;SCOLAIRE;BAC PROFESSIONNEL;BAC PRO PROD;BAC PRO AG 21203 TECHN CONSEIL DE VENTE ANIMAL;7;7;5;2;0;0;0;5;0;0;0;0;5;2
23485.0;2023;01;PARIS;FEMININ;SCOLAIRE;BAC PROFESSIONNEL;BAC PRO PROD;BAC PRO 23304 AMENAGEMENT FINITION BATIMENT;1;1;1;0;0;0;0;1;0;0;0;1;0;0
13151.0;2022;12;NANCY-METZ;FEMININ;SCOLAIRE;BAC PROFESSIONNEL;BAC PRO PROD;BAC PRO AG 22107 TEC CONS VTE ALIMENTATION P.ALIM;4;4;4;0;0;0;0;4;0;0;2;1;1;0
23491.0;2023;01;PARIS;FEMININ;SCOLAIRE;BAC PROFESSIONNEL;BAC PRO PROD;BAC PRO 25006 MICROTECHNIQUES;1;1;1;0;0;0;0;1;0;0;1;0;0;0
13152.0;2022;12;NANCY-METZ;FEMININ;SCOLAIRE;BAC PROFESSIONNEL;BAC PRO SERV;BAC PRO 30001 GESTION-ADMINISTRATION;417;417;337;65;15;12;3;349;0;13;79;135;122;68
23504.0;2023;01;PARIS;FEMININ;SCOLAIRE;BAC PROFESSIONNEL;BAC PRO SERV;BAC PRO 32206 FACONNAGE PRODTS IMPRIMES ROUTAGE;2;2;2;0;0;0;0;2;0;0;1;0;1;0
13158.0;2022;12;NANCY-METZ;FEMININ;SCOLAIRE;BAC PROFESSIONNEL;BAC PRO SERV;BAC PRO 31214 MET.COM.VEN.OP.B PR.CL.VA.OF.COM.;150;150;124;19;7;5;2;129;0;7;22;47;53;21
23505.0;2023;01;PARIS;FEMININ;SCOLAIRE;BAC PROFESSIONNEL;BAC PRO SERV;BAC PRO 32207 REAL.PR.IMPR.PLURI.OPTA.PR.GRAPH.;7;7;6;1;0;0;0;6;0;0;0;1;5;1
13160.0;2022;12;NANCY-METZ;FEMININ;SCOLAIRE;BAC PROFESSIONNEL;BAC PRO SERV;BAC PRO 32208 REAL.PR.IMPR.PLURI.OPTB.PR.IMPR.;4;4;2;2;0;0;0;2;0;0;0;1;1;2
23510.0;2023;01;PARIS;FEMININ;SCOLAIRE;BAC PROFESSIONNEL;BAC PRO SERV;BAC PRO 33004 ACC.SOINS-S.PERS. OPT.EN STRUCTUR;221;221;196;16;9;5;4;201;0;15;40;98;48;20
13163.0;2022;12;NANCY-METZ;FEMININ;SCOLAIRE;BAC PROFESSIONNEL;BAC PRO SERV;BAC PRO 33002 SERVICES DE PROXIMITE  VIE LOCAL;72;72;64;6;2;1;1;65;0;5;19;24;17;7
23514.0;2023;01;PARIS;FEMININ;SCOLAIRE;BAC PROFESSIONNEL;BAC PRO SERV;BAC PRO 33104 TECHNICIEN EN PROTHESE DENTAIRE;15;15;10;5;0;0;0;10;0;1;1;2;6;5
13165.0;2022;12;NANCY-METZ;FEMININ;SCOLAIRE;BAC PROFESSIONNEL;BAC PRO SERV;BAC PRO 33004 ACC.SOINS-S.PERS. OPT.EN STRUCTUR;567;566;515;43;8;4;4;519;0;37;161;217;104;47
23526.0;2023;01;PARIS;FEMININ;SCOLAIRE;BAC TECHNOLOGIQUE;BAC STHR;BAC STHR SC.&TEC. HOTELLERIE-RESTAURATION;42;42;38;4;0;0;0;38;0;7;6;14;11;4
13191.0;2022;12;NANCY-METZ;MASCULIN;APPRENTISSAGE;BAC PROFESSIONNEL;BAC PRO PROD;BAC PRO 22004 PROC. CHIMIE EAU PAPIERS-CARTONS;4;4;4;0;0;0;0;4;0;1;0;0;3;0
23529.0;2023;01;PARIS;FEMININ;SCOLAIRE;BAC TECHNOLOGIQUE;BAC STI2D;BAC STI2D INNOVATION TECHNO.  ET ECO CONCEPTION;25;25;18;1;6;6;0;24;0;1;4;2;17;1
13207.0;2022;12;NANCY-METZ;MASCULIN;APPRENTISSAGE;BAC PROFESSIONNEL;BAC PRO PROD;BAC PRO 25106 TECHNICIEN D'USINAGE;20;20;18;1;1;1;0;19;0;1;4;9;5;1
23531.0;2023;01;PARIS;FEMININ;SCOLAIRE;BAC TECHNOLOGIQUE;BAC STL;BAC STL BIOCHIM.-BIOLOGIE-BIOTECHNOL.;56;56;46;4;6;4;2;50;0;3;17;14;16;6
13210.0;2022;12;NANCY-METZ;MASCULIN;APPRENTISSAGE;BAC PROFESSIONNEL;BAC PRO PROD;BAC PRO 25215 MAINT.VEHIC.OPTB VEHIC.TRANS.ROUT;15;15;10;3;2;1;1;11;0;2;1;3;5;4
23534.0;2023;01;PARIS;FEMININ;SCOLAIRE;BAC TECHNOLOGIQUE;BAC STMG;BAC STMG MERCATIQUE (MARKETING);414;414;344;15;55;39;16;383;0;6;50;130;197;31
13213.0;2022;12;NANCY-METZ;MASCULIN;APPRENTISSAGE;BAC PROFESSIONNEL;BAC PRO PROD;BAC PRO 25220 MAINT.MATERIELS OPT.B TP MANUT.;8;8;5;1;2;2;0;7;0;0;0;3;4;1
23535.0;2023;01;PARIS;FEMININ;SCOLAIRE;BAC TECHNOLOGIQUE;BAC STMG;BAC STMG RESSOURCES HUMAINES ET COMMUNICATION;350;350;246;36;68;57;11;303;0;3;16;85;199;47
13219.0;2022;12;NANCY-METZ;MASCULIN;APPRENTISSAGE;BAC PROFESSIONNEL;BAC PRO PROD;BAC PRO 25410 CONSTRUCTION DES CARROSSERIES;2;2;0;2;0;0;0;0;0;0;0;0;0;2
23539.0;2023;01;PARIS;MASCULIN;APPRENTISSAGE;BAC PROFESSIONNEL;BAC PRO PROD;BAC PRO 22106 CUISINE;122;122;106;11;5;4;1;110;0;13;29;38;30;12
13220.0;2022;12;NANCY-METZ;MASCULIN;APPRENTISSAGE;BAC PROFESSIONNEL;BAC PRO PROD;BAC PRO 25411 TECH.CHAUDRONNERIE INDUSTRIELLE;53;53;40;8;5;4;1;44;0;7;13;4;20;9
23543.0;2023;01;PARIS;MASCULIN;APPRENTISSAGE;BAC PROFESSIONNEL;BAC PRO PROD;BAC PRO 23005 TECHN. ETUDES BAT B ASSIST.ARCHI.;7;7;4;3;0;0;0;4;0;0;0;3;1;3
13222.0;2022;12;NANCY-METZ;MASCULIN;APPRENTISSAGE;BAC PROFESSIONNEL;BAC PRO PROD;BAC PRO 25510 METIERS ELECT. ENVIRON. CONNECTES;83;81;61;11;9;3;6;64;0;10;12;17;25;17
23546.0;2023;01;PARIS;MASCULIN;APPRENTISSAGE;BAC PROFESSIONNEL;BAC PRO PROD;BAC PRO 25411 TECH.CHAUDRONNERIE INDUSTRIELLE;13;13;10;3;0;0;0;10;0;2;5;3;0;3
13233.0;2022;12;NANCY-METZ;MASCULIN;APPRENTISSAGE;BAC PROFESSIONNEL;BAC PRO PROD;BAC PRO AG 22107 TEC CONS VTE ALIMENTATION P.ALIM;1;1;0;1;0;0;0;0;0;0;0;0;0;1
23547.0;2023;01;PARIS;MASCULIN;APPRENTISSAGE;BAC PROFESSIONNEL;BAC PRO PROD;BAC PRO 25509 TECHNIC. FROID CONDITIONNEMT AIR;25;25;19;1;5;4;1;23;0;2;3;5;13;2
13241.0;2022;12;NANCY-METZ;MASCULIN;APPRENTISSAGE;BAC PROFESSIONNEL;BAC PRO SERV;BAC PRO 33102 PROTHESE DENTAIRE;5;5;4;1;0;0;0;4;0;0;1;1;2;1
23551.0;2023;01;PARIS;MASCULIN;APPRENTISSAGE;BAC PROFESSIONNEL;BAC PRO SERV;BAC PRO 31209 POISSONIER ECAILLER TRAITEUR;7;7;5;2;0;0;0;5;0;0;0;4;1;2
13251.0;2022;12;NANCY-METZ;MASCULIN;FORMATION CONTINUE;BAC PROFESSIONNEL;BAC PRO PROD;BAC PRO 22704 TECHN. MAINT. SYST.ENERG.CLIMATI;8;8;8;0;0;0;0;8;0;2;4;1;1;0
23562.0;2023;01;PARIS;MASCULIN;ENSEIGNEMENT A DISTANCE;BAC PROFESSIONNEL;BAC PRO PROD;BAC PRO 25515 SYST.NUM.OPT.C RES.INF.SYST.COMM.;1;0;0;0;0;0;0;0;0;0;0;0;0;0
13253.0;2022;12;NANCY-METZ;MASCULIN;FORMATION CONTINUE;BAC PROFESSIONNEL;BAC PRO PROD;BAC PRO 25007 MAINTENANCE EQUIPEMENTS INDUST.;9;9;7;2;0;0;0;7;0;4;1;0;2;2
23566.0;2023;01;PARIS;MASCULIN;ENSEIGNEMENT A DISTANCE;BAC TECHNOLOGIQUE;BAC STMG;BAC STMG RESSOURCES HUMAINES ET COMMUNICATION;1;1;1;0;0;0;0;1;0;0;0;0;1;0
13259.0;2022;12;NANCY-METZ;MASCULIN;FORMATION CONTINUE;BAC PROFESSIONNEL;BAC PRO PROD;BAC PRO AG 22107 TEC CONS VTE ALIMENTATION P.ALIM;2;2;2;0;0;0;0;2;0;0;1;1;0;0
23570.0;2023;01;PARIS;MASCULIN;FORMATION CONTINUE;BAC PROFESSIONNEL;BAC PRO PROD;BAC PRO 25106 TECHNICIEN D'USINAGE;6;4;4;0;0;0;0;4;0;0;4;0;0;0
13265.0;2022;12;NANCY-METZ;MASCULIN;FORMATION CONTINUE;BAC PROFESSIONNEL;BAC PRO SERV;BAC PRO 33102 PROTHESE DENTAIRE;5;5;5;0;0;0;0;5;0;1;2;1;1;0
23573.0;2023;01;PARIS;MASCULIN;FORMATION CONTINUE;BAC PROFESSIONNEL;BAC PRO PROD;BAC PRO 25515 SYST.NUM.OPT.C RES.INF.SYST.COMM.;9;9;7;2;0;0;0;7;0;0;2;3;2;2
13271.0;2022;12;NANCY-METZ;MASCULIN;INDIVIDUEL;BAC PROFESSIONNEL;BAC PRO PROD;BAC PRO 25106 TECHNICIEN D'USINAGE;1;1;1;0;0;0;0;1;0;0;0;0;1;0
23578.0;2023;01;PARIS;MASCULIN;INDIVIDUEL;BAC PROFESSIONNEL;BAC PRO PROD;BAC PRO 25007 MAINTENANCE EQUIPEMENTS INDUST.;2;2;1;1;0;0;0;1;0;0;0;1;0;1
13288.0;2022;12;NANCY-METZ;MASCULIN;INDIVIDUEL;BAC TECHNOLOGIQUE;BAC STMG;BAC STMG RESSOURCES HUMAINES ET COMMUNICATION;8;6;3;1;2;1;1;4;0;0;0;1;3;2
23580.0;2023;01;PARIS;MASCULIN;INDIVIDUEL;BAC PROFESSIONNEL;BAC PRO PROD;BAC PRO 25303 AERONAUTIQUE OPTION SYSTEMES;2;1;1;0;0;0;0;1;0;0;0;0;1;0
13296.0;2022;12;NANCY-METZ;MASCULIN;SCOLAIRE;BAC PROFESSIONNEL;BAC PRO PROD;BAC PRO 22303 FONDERIE;5;5;5;0;0;0;0;5;0;0;3;1;1;0
23582.0;2023;01;PARIS;MASCULIN;INDIVIDUEL;BAC PROFESSIONNEL;BAC PRO PROD;BAC PRO AG 21004 CGEA;6;5;3;2;0;0;0;3;0;0;0;0;3;2
13297.0;2022;12;NANCY-METZ;MASCULIN;SCOLAIRE;BAC PROFESSIONNEL;BAC PRO PROD;BAC PRO 22403 ARTS.& MET.ART:MET.ENSEIGN SIGNA;4;4;3;1;0;0;0;3;0;0;0;3;0;1
23595.0;2023;01;PARIS;MASCULIN;INDIVIDUEL;BAC TECHNOLOGIQUE;BAC STI2D;BAC STI2D SYSTÈME D'INFORMATION  ET NUMERIQUE;1;1;0;1;0;0;0;0;0;0;0;0;0;1
13305.0;2022;12;NANCY-METZ;MASCULIN;SCOLAIRE;BAC PROFESSIONNEL;BAC PRO PROD;BAC PRO 23208 METIERS ET ARTS DE LA PIERRE;9;9;7;2;0;0;0;7;0;0;2;4;1;2
23599.0;2023;01;PARIS;MASCULIN;INDIVIDUEL;BAC TECHNOLOGIQUE;BAC STMG;BAC STMG MERCATIQUE (MARKETING);92;91;40;21;30;23;7;63;0;0;5;9;49;28
13313.0;2022;12;NANCY-METZ;MASCULIN;SCOLAIRE;BAC PROFESSIONNEL;BAC PRO PROD;BAC PRO 25006 MICROTECHNIQUES;19;19;14;4;1;1;0;15;0;0;5;6;4;4
23610.0;2023;01;PARIS;MASCULIN;SCOLAIRE;BAC PROFESSIONNEL;BAC PRO PROD;BAC PRO 22403 ARTS.& MET.ART:MET.ENSEIGN SIGNA;4;4;4;0;0;0;0;4;0;1;2;1;0;0
13316.0;2022;12;NANCY-METZ;MASCULIN;SCOLAIRE;BAC PROFESSIONNEL;BAC PRO PROD;BAC PRO 25107 TECHNICIEN OUTILLEUR;7;7;5;2;0;0;0;5;0;0;1;2;2;2
23611.0;2023;01;PARIS;MASCULIN;SCOLAIRE;BAC PROFESSIONNEL;BAC PRO PROD;BAC PRO 22703 TECHN.INSTALL.SYST.ENERG.CLIMATI;9;9;4;4;1;1;0;5;0;0;0;2;3;4
13333.0;2022;12;NANCY-METZ;MASCULIN;SCOLAIRE;BAC PROFESSIONNEL;BAC PRO PROD;BAC PRO AG 21001 AGRO-EQUIPEMENT;37;37;35;2;0;0;0;35;0;1;1;8;25;2
23615.0;2023;01;PARIS;MASCULIN;SCOLAIRE;BAC PROFESSIONNEL;BAC PRO PROD;BAC PRO 23005 TECHN. ETUDES BAT B ASSIST.ARCHI.;14;14;11;1;2;1;1;12;0;1;5;2;4;2
13335.0;2022;12;NANCY-METZ;MASCULIN;SCOLAIRE;BAC PROFESSIONNEL;BAC PRO PROD;BAC PRO AG 21114 CONDUITE PRODUCTIONS HORTICOLES;1;1;1;0;0;0;0;1;0;0;0;0;1;0
23616.0;2023;01;PARIS;MASCULIN;SCOLAIRE;BAC PROFESSIONNEL;BAC PRO PROD;BACPRO 23103 TECHNICIEN GEOMETRE-TOPOGRAPHE;9;9;6;2;1;1;0;7;0;0;2;4;1;2
13349.0;2022;12;NANCY-METZ;MASCULIN;SCOLAIRE;BAC PROFESSIONNEL;BAC PRO SERV;BAC PRO 32207 REAL.PR.IMPR.PLURI.OPTA.PR.GRAPH.;11;11;7;3;1;0;1;7;0;1;0;3;3;4
23627.0;2023;01;PARIS;MASCULIN;SCOLAIRE;BAC PROFESSIONNEL;BAC PRO PROD;BAC PRO 24302 METIERS DU CUIR : MAROQUINERIE;3;3;3;0;0;0;0;3;0;0;0;3;0;0
13359.0;2022;12;NANCY-METZ;MASCULIN;SCOLAIRE;BAC PROFESSIONNEL;BAC PRO SERV;BAC PRO 34303 GEST. POLLUTIONS PROTEC. ENVIRON.;9;9;9;0;0;0;0;9;0;0;2;6;1;0
23628.0;2023;01;PARIS;MASCULIN;SCOLAIRE;BAC PROFESSIONNEL;BAC PRO PROD;BAC PRO 25006 MICROTECHNIQUES;32;32;29;0;3;2;1;31;0;1;6;12;12;1
13360.0;2022;12;NANCY-METZ;MASCULIN;SCOLAIRE;BAC PROFESSIONNEL;BAC PRO SERV;BAC PRO 34304 HYGIENE PROPRETE STERILISATION;1;1;1;0;0;0;0;1;0;0;0;1;0;0
23633.0;2023;01;PARIS;MASCULIN;SCOLAIRE;BAC PROFESSIONNEL;BAC PRO PROD;BAC PRO 25216 MAINT.VEHIC.OPTC MOTOCYCLES;5;5;2;3;0;0;0;2;0;0;0;1;1;3
13362.0;2022;12;NANCY-METZ;MASCULIN;SCOLAIRE;BAC PROFESSIONNEL;BAC PRO SERV;BAC PRO AG 33002 SERV PERS TERRIT;6;4;3;1;0;0;0;3;0;0;1;1;1;1
23634.0;2023;01;PARIS;MASCULIN;SCOLAIRE;BAC PROFESSIONNEL;BAC PRO PROD;BAC PRO 25406 OUVRAGES DU BATIMENT METALLERIE;7;7;3;3;1;1;0;4;0;0;0;1;3;3
13366.0;2022;12;NANCY-METZ;MASCULIN;SCOLAIRE;BAC TECHNOLOGIQUE;BAC STAV;BAC STAV AGRONOMIE ALIM ENV TERRITOI;62;62;59;3;0;0;0;59;0;1;11;25;22;3
23636.0;2023;01;PARIS;MASCULIN;SCOLAIRE;BAC PROFESSIONNEL;BAC PRO PROD;BAC PRO 25509 TECHNIC. FROID CONDITIONNEMT AIR;15;15;6;8;1;0;1;6;0;1;2;1;2;9
13371.0;2022;12;NANCY-METZ;MASCULIN;SCOLAIRE;BAC TECHNOLOGIQUE;BAC STI2D;BAC STI2D INNOVATION TECHNO.  ET ECO CONCEPTION;365;365;308;7;50;28;22;336;0;4;30;119;183;29
23637.0;2023;01;PARIS;MASCULIN;SCOLAIRE;BAC PROFESSIONNEL;BAC PRO PROD;BAC PRO 25510 METIERS ELECT. ENVIRON. CONNECTES;217;217;170;30;17;14;3;184;0;13;36;56;79;33
13378.0;2022;12;NANCY-METZ;MASCULIN;SCOLAIRE;BAC TECHNOLOGIQUE;BAC STMG;BAC STMG SYSTEMES D'INFORMATION DE GESTION;32;32;18;2;12;7;5;25;0;0;1;6;18;7
23645.0;2023;01;PARIS;MASCULIN;SCOLAIRE;BAC PROFESSIONNEL;BAC PRO SERV;BAC PRO 31114 ORGANIS. TRANSPORT MARCHANDISES;27;27;13;12;2;0;2;13;0;1;3;4;5;14
13382.0;2022;17;NANTES;FEMININ;APPRENTISSAGE;BAC PROFESSIONNEL;BAC PRO PROD;BAC PRO 22703 TECHN.INSTALL.SYST.ENERG.CLIMATI;1;1;1;0;0;0;0;1;0;0;0;1;0;0
23653.0;2023;01;PARIS;MASCULIN;SCOLAIRE;BAC PROFESSIONNEL;BAC PRO SERV;BAC PRO 32304 PHOTOGRAPHIE;27;27;19;8;0;0;0;19;0;3;5;7;4;8
13384.0;2022;17;NANTES;FEMININ;APPRENTISSAGE;BAC PROFESSIONNEL;BAC PRO PROD;BAC PRO 22705 TECHNICIEN GAZ;2;2;2;0;0;0;0;2;0;2;0;0;0;0
23659.0;2023;01;PARIS;MASCULIN;SCOLAIRE;BAC PROFESSIONNEL;BAC PRO SERV;BAC PRO 33104 TECHNICIEN EN PROTHESE DENTAIRE;11;11;5;4;2;1;1;6;0;1;3;0;2;5
13388.0;2022;17;NANTES;FEMININ;APPRENTISSAGE;BAC PROFESSIONNEL;BAC PRO PROD;BAC PRO 23304 AMENAGEMENT FINITION BATIMENT;3;3;3;0;0;0;0;3;0;0;1;0;2;0
23666.0;2023;01;PARIS;MASCULIN;SCOLAIRE;BAC TECHNOLOGIQUE;BAC S2TMD;BAC S2TMD MUSIQUE;14;14;14;0;0;0;0;14;1;3;3;5;2;0
13390.0;2022;17;NANTES;FEMININ;APPRENTISSAGE;BAC PROFESSIONNEL;BAC PRO PROD;BAC PRO 25007 MAINTENANCE EQUIPEMENTS INDUST.;3;3;2;1;0;0;0;2;0;0;1;1;0;1
23672.0;2023;01;PARIS;MASCULIN;SCOLAIRE;BAC TECHNOLOGIQUE;BAC STI2D;BAC STI2D ENERGIES  ET ENVIRONNEMENT;36;36;27;4;5;3;2;30;0;0;1;10;19;6
13397.0;2022;17;NANTES;FEMININ;APPRENTISSAGE;BAC PROFESSIONNEL;BAC PRO PROD;BAC PRO 25411 TECH.CHAUDRONNERIE INDUSTRIELLE;3;3;3;0;0;0;0;3;0;2;0;1;0;0
23675.0;2023;01;PARIS;MASCULIN;SCOLAIRE;BAC TECHNOLOGIQUE;BAC STL;BAC STL BIOCHIM.-BIOLOGIE-BIOTECHNOL.;41;41;34;1;6;4;2;38;0;2;9;9;18;3
13399.0;2022;17;NANTES;FEMININ;APPRENTISSAGE;BAC PROFESSIONNEL;BAC PRO PROD;BAC PRO 25515 SYST.NUM.OPT.C RES.INF.SYST.COMM.;1;1;1;0;0;0;0;1;0;0;1;0;0;0
23690.0;2023;13;POITIERS;FEMININ;APPRENTISSAGE;BAC PROFESSIONNEL;BAC PRO PROD;BAC PRO 25510 METIERS ELECT. ENVIRON. CONNECTES;1;1;1;0;0;0;0;1;0;0;0;1;0;0
13402.0;2022;17;NANTES;FEMININ;APPRENTISSAGE;BAC PROFESSIONNEL;BAC PRO PROD;BAC PRO AG 21113 CGEVV;8;8;8;0;0;0;0;8;0;0;0;0;8;0
23693.0;2023;13;POITIERS;FEMININ;APPRENTISSAGE;BAC PROFESSIONNEL;BAC PRO PROD;BAC PRO AG 21114 CONDUITE PRODUCTIONS HORTICOLES;2;2;2;0;0;0;0;2;0;0;0;0;2;0
13410.0;2022;17;NANTES;FEMININ;APPRENTISSAGE;BAC PROFESSIONNEL;BAC PRO SERV;BAC PRO 30001 GESTION-ADMINISTRATION;16;16;15;1;0;0;0;15;0;4;4;6;1;1
23698.0;2023;13;POITIERS;FEMININ;APPRENTISSAGE;BAC PROFESSIONNEL;BAC PRO SERV;BAC PRO 30004 ASSISTANC.GEST.ORGANIS.ACTIVITES;14;14;12;1;1;1;0;13;0;1;4;6;2;1
13412.0;2022;17;NANTES;FEMININ;APPRENTISSAGE;BAC PROFESSIONNEL;BAC PRO SERV;BAC PRO 31108 TRANSPORT;2;2;2;0;0;0;0;2;0;1;0;1;0;0
23701.0;2023;13;POITIERS;FEMININ;APPRENTISSAGE;BAC PROFESSIONNEL;BAC PRO SERV;BAC PRO 31213 MET.COM.VEN.OP.A ANI.GES.ESP.COM.;107;104;79;14;11;4;7;83;0;5;15;27;36;21
13413.0;2022;17;NANTES;FEMININ;APPRENTISSAGE;BAC PROFESSIONNEL;BAC PRO SERV;BAC PRO 31212 METIERS DE L'ACCUEIL;13;13;11;2;0;0;0;11;0;3;3;3;2;2
23706.0;2023;13;POITIERS;FEMININ;APPRENTISSAGE;BAC PROFESSIONNEL;BAC PRO SERV;BAC PRO 33101 OPTIQUE LUNETTERIE;5;5;5;0;0;0;0;5;0;0;0;2;3;0
13416.0;2022;17;NANTES;FEMININ;APPRENTISSAGE;BAC PROFESSIONNEL;BAC PRO SERV;BAC PRO 32206 FACONNAGE PRODTS IMPRIMES ROUTAGE;1;1;1;0;0;0;0;1;0;0;0;1;0;0
23716.0;2023;13;POITIERS;FEMININ;ENSEIGNEMENT A DISTANCE;BAC TECHNOLOGIQUE;BAC STMG;BAC STMG RESSOURCES HUMAINES ET COMMUNICATION;1;1;0;1;0;0;0;0;0;0;0;0;0;1
13425.0;2022;17;NANTES;FEMININ;ENSEIGNEMENT A DISTANCE;BAC GENERAL;BAC GENERAL;BAC GENE 10019 BAC GENERAL;59;57;39;9;9;5;4;44;1;4;7;14;18;13
23717.0;2023;13;POITIERS;FEMININ;INDIVIDUEL;BAC GENERAL;BAC GENERAL;BAC GENE 10019 BAC GENERAL;43;42;15;20;7;5;2;20;0;0;7;2;11;22
13429.0;2022;17;NANTES;FEMININ;ENSEIGNEMENT A DISTANCE;BAC PROFESSIONNEL;BAC PRO SERV;BAC PRO 31213 MET.COM.VEN.OP.A ANI.GES.ESP.COM.;6;6;5;0;1;1;0;6;0;0;0;0;6;0
23718.0;2023;13;POITIERS;FEMININ;INDIVIDUEL;BAC PROFESSIONNEL;BAC PRO PROD;BAC PRO AG 21004 CGEA;7;6;4;2;0;0;0;4;0;0;0;0;4;2
13435.0;2022;17;NANTES;FEMININ;ENSEIGNEMENT A DISTANCE;BAC TECHNOLOGIQUE;BAC STMG;BAC STMG RESSOURCES HUMAINES ET COMMUNICATION;3;3;1;2;0;0;0;1;0;0;0;0;1;2
23719.0;2023;13;POITIERS;FEMININ;INDIVIDUEL;BAC PROFESSIONNEL;BAC PRO PROD;BAC PRO AG 21113 CGEVV;1;1;1;0;0;0;0;1;0;0;0;0;1;0
13436.0;2022;17;NANTES;FEMININ;FORMATION CONTINUE;BAC PROFESSIONNEL;BAC PRO PROD;BAC PRO 23004 TECHN. ETUDES BAT.A ETUDES & ECO.;15;14;14;0;0;0;0;14;0;3;7;3;1;0
23725.0;2023;13;POITIERS;FEMININ;INDIVIDUEL;BAC PROFESSIONNEL;BAC PRO SERV;BAC PRO 31213 MET.COM.VEN.OP.A ANI.GES.ESP.COM.;2;1;0;1;0;0;0;0;0;0;0;0;0;1
13437.0;2022;17;NANTES;FEMININ;FORMATION CONTINUE;BAC PROFESSIONNEL;BAC PRO PROD;BAC PRO 25007 MAINTENANCE EQUIPEMENTS INDUST.;2;2;2;0;0;0;0;2;0;2;0;0;0;0
23732.0;2023;13;POITIERS;FEMININ;INDIVIDUEL;BAC TECHNOLOGIQUE;BAC STMG;BAC STMG MERCATIQUE (MARKETING);4;4;2;1;1;0;1;2;0;0;0;0;2;2
13438.0;2022;17;NANTES;FEMININ;FORMATION CONTINUE;BAC PROFESSIONNEL;BAC PRO PROD;BAC PRO 25515 SYST.NUM.OPT.C RES.INF.SYST.COMM.;1;1;1;0;0;0;0;1;0;0;1;0;0;0
23742.0;2023;13;POITIERS;FEMININ;SCOLAIRE;BAC PROFESSIONNEL;BAC PRO PROD;BAC PRO 22503 PLASTIQUES ET COMPOSITES;1;1;0;1;0;0;0;0;0;0;0;0;0;1
13439.0;2022;17;NANTES;FEMININ;FORMATION CONTINUE;BAC PROFESSIONNEL;BAC PRO PROD;BAC PRO AG 21113 CGEVV;2;2;2;0;0;0;0;2;0;0;0;0;2;0
23745.0;2023;13;POITIERS;FEMININ;SCOLAIRE;BAC PROFESSIONNEL;BAC PRO PROD;BACPRO 23103 TECHNICIEN GEOMETRE-TOPOGRAPHE;4;4;4;0;0;0;0;4;0;0;3;0;1;0
13445.0;2022;17;NANTES;FEMININ;INDIVIDUEL;BAC PROFESSIONNEL;BAC PRO PROD;BAC PRO AG 21004 CGEA;4;3;1;2;0;0;0;1;0;0;0;0;1;2
23748.0;2023;13;POITIERS;FEMININ;SCOLAIRE;BAC PROFESSIONNEL;BAC PRO PROD;BAC PRO 23404 TECHNICIEN CONSTRUCTEUR BOIS;1;1;1;0;0;0;0;1;0;0;0;0;1;0
13446.0;2022;17;NANTES;FEMININ;INDIVIDUEL;BAC PROFESSIONNEL;BAC PRO PROD;BAC PRO AG 21114 CONDUITE PRODUCTIONS HORTICOLES;5;4;4;0;0;0;0;4;0;0;0;0;4;0
23749.0;2023;13;POITIERS;FEMININ;SCOLAIRE;BAC PROFESSIONNEL;BAC PRO PROD;BAC PRO 23405 TECHNICIEN MENUISIER AGENCEUR;2;2;2;0;0;0;0;2;0;0;1;0;1;0
13452.0;2022;17;NANTES;FEMININ;INDIVIDUEL;BAC PROFESSIONNEL;BAC PRO SERV;BAC PRO 33002 SERVICES DE PROXIMITE  VIE LOCAL;1;1;1;0;0;0;0;1;0;0;0;0;1;0
23755.0;2023;13;POITIERS;FEMININ;SCOLAIRE;BAC PROFESSIONNEL;BAC PRO PROD;BAC PRO 25107 TECHNICIEN OUTILLEUR;1;1;1;0;0;0;0;1;0;0;0;0;1;0
13457.0;2022;17;NANTES;FEMININ;INDIVIDUEL;BAC TECHNOLOGIQUE;BAC STD2A;BAC STD2A SCIENCES & TECHNO. DESIGN-ARTS APPLIQUES;2;1;0;1;0;0;0;0;0;0;0;0;0;1
23756.0;2023;13;POITIERS;FEMININ;SCOLAIRE;BAC PROFESSIONNEL;BAC PRO PROD;BAC PRO 25214 MAINT.VEHIC.OPTA VOIT.PARTICUL.;6;6;4;2;0;0;0;4;0;0;2;2;0;2
13463.0;2022;17;NANTES;FEMININ;SCOLAIRE;BAC PROFESSIONNEL;BAC PRO PROD;BAC PRO 22105 BOULANGER-PÂTISSIER;41;41;40;0;1;1;0;41;0;3;14;14;10;0
23759.0;2023;13;POITIERS;FEMININ;SCOLAIRE;BAC PROFESSIONNEL;BAC PRO PROD;BAC PRO 25303 AERONAUTIQUE OPTION SYSTEMES;2;2;2;0;0;0;0;2;0;0;1;1;0;0
13468.0;2022;17;NANTES;FEMININ;SCOLAIRE;BAC PROFESSIONNEL;BAC PRO PROD;BAC PRO 23004 TECHN. ETUDES BAT.A ETUDES & ECO.;20;20;17;3;0;0;0;17;0;1;3;3;10;3
23760.0;2023;13;POITIERS;FEMININ;SCOLAIRE;BAC PROFESSIONNEL;BAC PRO PROD;BAC PRO 25408 REPARATION DES CARROSSERIES;1;1;0;0;1;0;1;0;0;0;0;0;0;1
13476.0;2022;17;NANTES;FEMININ;SCOLAIRE;BAC PROFESSIONNEL;BAC PRO PROD;BAC PRO 24302 METIERS DU CUIR : MAROQUINERIE;10;10;9;1;0;0;0;9;0;0;1;2;6;1
23763.0;2023;13;POITIERS;FEMININ;SCOLAIRE;BAC PROFESSIONNEL;BAC PRO PROD;BAC PRO 25513 SYST.NUM.OPT.A SURETE SECURITE;2;2;2;0;0;0;0;2;0;0;0;0;2;0
13478.0;2022;17;NANTES;FEMININ;SCOLAIRE;BAC PROFESSIONNEL;BAC PRO PROD;BAC PRO 25009 MAINTENANCE NAUTIQUE;3;3;3;0;0;0;0;3;0;0;0;1;2;0
23780.0;2023;13;POITIERS;FEMININ;SCOLAIRE;BAC PROFESSIONNEL;BAC PRO SERV;BAC PRO 31107 CONDUCT. TRANSP.ROUT.MARCHANDISES;5;5;3;1;1;1;0;4;0;1;0;0;3;1
13480.0;2022;17;NANTES;FEMININ;SCOLAIRE;BAC PROFESSIONNEL;BAC PRO PROD;BAC PRO 25214 MAINT.VEHIC.OPTA VOIT.PARTICUL.;7;7;5;1;1;1;0;6;0;1;0;1;4;1
23783.0;2023;13;POITIERS;FEMININ;SCOLAIRE;BAC PROFESSIONNEL;BAC PRO SERV;BAC PRO 31213 MET.COM.VEN.OP.A ANI.GES.ESP.COM.;206;206;181;17;8;6;2;187;0;8;40;79;60;19
13482.0;2022;17;NANTES;FEMININ;SCOLAIRE;BAC PROFESSIONNEL;BAC PRO PROD;BAC PRO 25219 MAINT.MATERIELS OPT.A AGRICOLES;1;1;1;0;0;0;0;1;0;0;0;1;0;0
23784.0;2023;13;POITIERS;FEMININ;SCOLAIRE;BAC PROFESSIONNEL;BAC PRO SERV;BAC PRO 31214 MET.COM.VEN.OP.B PR.CL.VA.OF.COM.;103;103;89;6;8;7;1;96;0;5;23;35;33;7
13483.0;2022;17;NANTES;FEMININ;SCOLAIRE;BAC PROFESSIONNEL;BAC PRO PROD;BAC PRO 25221 MAINT.MATERIELS OPT.C ESP. VERTS;1;1;0;0;1;1;0;1;0;0;0;0;1;0
23786.0;2023;13;POITIERS;FEMININ;SCOLAIRE;BAC PROFESSIONNEL;BAC PRO SERV;BAC PRO 32208 REAL.PR.IMPR.PLURI.OPTB.PR.IMPR.;3;3;3;0;0;0;0;3;0;1;1;1;0;0
13486.0;2022;17;NANTES;FEMININ;SCOLAIRE;BAC PROFESSIONNEL;BAC PRO PROD;BAC PRO 25411 TECH.CHAUDRONNERIE INDUSTRIELLE;3;3;2;1;0;0;0;2;0;0;0;2;0;1
23790.0;2023;13;POITIERS;FEMININ;SCOLAIRE;BAC PROFESSIONNEL;BAC PRO SERV;BAC PRO 33006 ANIMAT. ENFANCE& PERSONNES AGEES;52;52;45;5;2;1;1;46;0;5;10;21;10;6
13489.0;2022;17;NANTES;FEMININ;SCOLAIRE;BAC PROFESSIONNEL;BAC PRO PROD;BAC PRO 25514 SYST.NUM.OPT.B AUD.RES.EQUIP.DOM.;3;3;3;0;0;0;0;3;0;0;1;2;0;0
23803.0;2023;13;POITIERS;FEMININ;SCOLAIRE;BAC TECHNOLOGIQUE;BAC STI2D;BAC STI2D ENERGIES  ET ENVIRONNEMENT;4;4;3;0;1;1;0;4;0;0;0;0;4;0
13491.0;2022;17;NANTES;FEMININ;SCOLAIRE;BAC PROFESSIONNEL;BAC PRO PROD;BAC PRO AG 21001 AGRO-EQUIPEMENT;3;3;2;1;0;0;0;2;0;0;0;1;1;1
23805.0;2023;13;POITIERS;FEMININ;SCOLAIRE;BAC TECHNOLOGIQUE;BAC STI2D;BAC STI2D SYSTÈME D'INFORMATION  ET NUMERIQUE;21;21;20;0;1;1;0;21;0;0;4;10;7;0
13497.0;2022;17;NANTES;FEMININ;SCOLAIRE;BAC PROFESSIONNEL;BAC PRO PROD;BAC PRO AG 21211 COND GEST ENTR HIPPIQUE;79;78;64;14;0;0;0;64;0;1;11;16;36;14
23816.0;2023;13;POITIERS;MASCULIN;APPRENTISSAGE;BAC PROFESSIONNEL;BAC PRO PROD;BAC PRO 22704 TECHN. MAINT. SYST.ENERG.CLIMATI;5;5;3;1;1;1;0;4;0;0;1;0;3;1
13500.0;2022;17;NANTES;FEMININ;SCOLAIRE;BAC PROFESSIONNEL;BAC PRO PROD;BAC PRO AG 21407 TEC CONS VTE UNIVERS JARDINERIE;3;3;3;0;0;0;0;3;0;0;1;1;1;0
23818.0;2023;13;POITIERS;MASCULIN;APPRENTISSAGE;BAC PROFESSIONNEL;BAC PRO PROD;BAC PRO 23203 TECHNICIEN BAT. : ORG.REAL.GROS O;5;5;3;2;0;0;0;3;0;0;2;0;1;2
13513.0;2022;17;NANTES;FEMININ;SCOLAIRE;BAC PROFESSIONNEL;BAC PRO SERV;BAC PRO 32303 ART.& MET.ART:COM.VIS.VIS.PLURI-M;51;51;47;4;0;0;0;47;0;2;15;20;10;4
23827.0;2023;13;POITIERS;MASCULIN;APPRENTISSAGE;BAC PROFESSIONNEL;BAC PRO PROD;BAC PRO 25214 MAINT.VEHIC.OPTA VOIT.PARTICUL.;125;124;100;11;13;9;4;109;0;9;24;38;38;15
13514.0;2022;17;NANTES;FEMININ;SCOLAIRE;BAC PROFESSIONNEL;BAC PRO SERV;BAC PRO 32304 PHOTOGRAPHIE;20;20;18;2;0;0;0;18;0;3;5;5;5;2
23834.0;2023;13;POITIERS;MASCULIN;APPRENTISSAGE;BAC PROFESSIONNEL;BAC PRO PROD;BAC PRO 25408 REPARATION DES CARROSSERIES;11;11;8;1;2;2;0;10;0;0;2;2;6;1
13531.0;2022;17;NANTES;FEMININ;SCOLAIRE;BAC TECHNOLOGIQUE;BAC STD2A;BAC STD2A SCIENCES & TECHNO. DESIGN-ARTS APPLIQUES;187;187;184;1;2;1;1;185;2;8;60;90;25;2
23842.0;2023;13;POITIERS;MASCULIN;APPRENTISSAGE;BAC PROFESSIONNEL;BAC PRO PROD;BAC PRO AG 21113 CGEVV;11;11;9;2;0;0;0;9;0;0;1;2;6;2
13538.0;2022;17;NANTES;FEMININ;SCOLAIRE;BAC TECHNOLOGIQUE;BAC STL;BAC STL SCIENCES PHYSIQUES CHIMIQUES  EN LABORAT.;61;61;53;2;6;4;2;57;0;2;11;18;26;4
23859.0;2023;13;POITIERS;MASCULIN;APPRENTISSAGE;BAC PROFESSIONNEL;BAC PRO SERV;BAC PRO AG 33002 SERV PERS TERRIT;3;3;2;1;0;0;0;2;0;0;1;1;0;1
13542.0;2022;17;NANTES;FEMININ;SCOLAIRE;BAC TECHNOLOGIQUE;BAC STMG;BAC STMG SYSTEMES D'INFORMATION DE GESTION;2;2;2;0;0;0;0;2;0;0;0;1;1;0
23864.0;2023;13;POITIERS;MASCULIN;ENSEIGNEMENT A DISTANCE;BAC TECHNOLOGIQUE;BAC STMG;BAC STMG MERCATIQUE (MARKETING);1;1;0;0;1;0;1;0;0;0;0;0;0;1
13544.0;2022;17;NANTES;MASCULIN;APPRENTISSAGE;BAC PROFESSIONNEL;BAC PRO PROD;BAC PRO 22105 BOULANGER-PÂTISSIER;10;10;10;0;0;0;0;10;0;2;2;1;5;0
23872.0;2023;13;POITIERS;MASCULIN;INDIVIDUEL;BAC PROFESSIONNEL;BAC PRO PROD;BAC PRO 25106 TECHNICIEN D'USINAGE;1;1;0;1;0;0;0;0;0;0;0;0;0;1
13552.0;2022;17;NANTES;MASCULIN;APPRENTISSAGE;BAC PROFESSIONNEL;BAC PRO PROD;BAC PRO 23005 TECHN. ETUDES BAT B ASSIST.ARCHI.;1;0;0;0;0;0;0;0;0;0;0;0;0;0
23876.0;2023;13;POITIERS;MASCULIN;INDIVIDUEL;BAC PROFESSIONNEL;BAC PRO PROD;BAC PRO 25510 METIERS ELECT. ENVIRON. CONNECTES;1;0;0;0;0;0;0;0;0;0;0;0;0;0
13558.0;2022;17;NANTES;MASCULIN;APPRENTISSAGE;BAC PROFESSIONNEL;BAC PRO PROD;BAC PRO 23404 TECHNICIEN CONSTRUCTEUR BOIS;6;6;5;1;0;0;0;5;0;0;0;1;4;1
23882.0;2023;13;POITIERS;MASCULIN;INDIVIDUEL;BAC PROFESSIONNEL;BAC PRO SERV;BAC PRO 31213 MET.COM.VEN.OP.A ANI.GES.ESP.COM.;7;4;3;0;1;1;0;4;0;0;0;1;3;0
13567.0;2022;17;NANTES;MASCULIN;APPRENTISSAGE;BAC PROFESSIONNEL;BAC PRO PROD;BAC PRO 25216 MAINT.VEHIC.OPTC MOTOCYCLES;14;14;13;1;0;0;0;13;0;1;4;6;2;1
23883.0;2023;13;POITIERS;MASCULIN;INDIVIDUEL;BAC PROFESSIONNEL;BAC PRO SERV;BAC PRO 31214 MET.COM.VEN.OP.B PR.CL.VA.OF.COM.;1;1;0;1;0;0;0;0;0;0;0;0;0;1
13569.0;2022;17;NANTES;MASCULIN;APPRENTISSAGE;BAC PROFESSIONNEL;BAC PRO PROD;BAC PRO 25220 MAINT.MATERIELS OPT.B TP MANUT.;23;23;19;0;4;4;0;23;0;2;6;6;9;0
23898.0;2023;13;POITIERS;MASCULIN;SCOLAIRE;BAC PROFESSIONNEL;BAC PRO PROD;BAC PRO 22105 BOULANGER-PÂTISSIER;21;21;19;1;1;1;0;20;0;1;9;5;5;1
13574.0;2022;17;NANTES;MASCULIN;APPRENTISSAGE;BAC PROFESSIONNEL;BAC PRO PROD;BAC PRO 25406 OUVRAGES DU BATIMENT METALLERIE;12;12;9;2;1;1;0;10;0;2;1;1;6;2
23899.0;2023;13;POITIERS;MASCULIN;SCOLAIRE;BAC PROFESSIONNEL;BAC PRO PROD;BAC PRO 22106 CUISINE;69;69;60;8;1;1;0;61;0;9;14;22;16;8
13578.0;2022;17;NANTES;MASCULIN;APPRENTISSAGE;BAC PROFESSIONNEL;BAC PRO PROD;BAC PRO 25509 TECHNIC. FROID CONDITIONNEMT AIR;17;16;14;2;0;0;0;14;0;3;3;2;6;2
23903.0;2023;13;POITIERS;MASCULIN;SCOLAIRE;BAC PROFESSIONNEL;BAC PRO PROD;BAC PRO 23004 TECHN. ETUDES BAT.A ETUDES & ECO.;21;21;13;7;1;1;0;14;0;0;2;3;9;7
13588.0;2022;17;NANTES;MASCULIN;APPRENTISSAGE;BAC PROFESSIONNEL;BAC PRO PROD;BAC PRO AG 21204 PROD-AQUACOLES;5;4;4;0;0;0;0;4;0;0;0;0;4;0
23910.0;2023;13;POITIERS;MASCULIN;SCOLAIRE;BAC PROFESSIONNEL;BAC PRO PROD;BAC PRO 23304 AMENAGEMENT FINITION BATIMENT;13;13;8;4;1;0;1;8;0;0;3;4;1;5
13591.0;2022;17;NANTES;MASCULIN;APPRENTISSAGE;BAC PROFESSIONNEL;BAC PRO PROD;BAC PRO AG 21302 GEST MILIEUX NATURELS FAUNE;2;2;2;0;0;0;0;2;0;1;0;0;1;0
23911.0;2023;13;POITIERS;MASCULIN;SCOLAIRE;BAC PROFESSIONNEL;BAC PRO PROD;BAC PRO 23404 TECHNICIEN CONSTRUCTEUR BOIS;6;6;6;0;0;0;0;6;0;0;1;2;3;0
13608.0;2022;17;NANTES;MASCULIN;ENSEIGNEMENT A DISTANCE;BAC GENERAL;BAC GENERAL;BAC GENE 10019 BAC GENERAL;22;22;10;7;5;4;1;14;0;1;2;3;8;8
23917.0;2023;13;POITIERS;MASCULIN;SCOLAIRE;BAC PROFESSIONNEL;BAC PRO PROD;BAC PRO 25007 MAINTENANCE EQUIPEMENTS INDUST.;106;106;70;31;5;4;1;74;0;3;6;17;48;32
13615.0;2022;17;NANTES;MASCULIN;ENSEIGNEMENT A DISTANCE;BAC TECHNOLOGIQUE;BAC STMG;BAC STMG MERCATIQUE (MARKETING);2;2;2;0;0;0;0;2;0;0;0;1;1;0
23924.0;2023;13;POITIERS;MASCULIN;SCOLAIRE;BAC PROFESSIONNEL;BAC PRO PROD;BAC PRO 25219 MAINT.MATERIELS OPT.A AGRICOLES;12;12;6;4;2;0;2;6;0;0;3;1;2;6
13618.0;2022;17;NANTES;MASCULIN;FORMATION CONTINUE;BAC PROFESSIONNEL;BAC PRO PROD;BAC PRO 22703 TECHN.INSTALL.SYST.ENERG.CLIMATI;1;1;1;0;0;0;0;1;0;1;0;0;0;0
23925.0;2023;13;POITIERS;MASCULIN;SCOLAIRE;BAC PROFESSIONNEL;BAC PRO PROD;BAC PRO 25220 MAINT.MATERIELS OPT.B TP MANUT.;10;10;4;5;1;1;0;5;0;0;0;2;3;5
13624.0;2022;17;NANTES;MASCULIN;FORMATION CONTINUE;BAC PROFESSIONNEL;BAC PRO PROD;BAC PRO 25009 MAINTENANCE NAUTIQUE;1;1;1;0;0;0;0;1;0;0;0;0;1;0
23936.0;2023;13;POITIERS;MASCULIN;SCOLAIRE;BAC PROFESSIONNEL;BAC PRO PROD;BAC PRO 25515 SYST.NUM.OPT.C RES.INF.SYST.COMM.;109;109;96;13;0;0;0;96;0;13;30;41;12;13
13627.0;2022;17;NANTES;MASCULIN;FORMATION CONTINUE;BAC PROFESSIONNEL;BAC PRO PROD;BAC PRO 25510 METIERS ELECT. ENVIRON. CONNECTES;17;17;17;0;0;0;0;17;0;5;4;5;3;0
23940.0;2023;13;POITIERS;MASCULIN;SCOLAIRE;BAC PROFESSIONNEL;BAC PRO PROD;BAC PRO AG 21114 CONDUITE PRODUCTIONS HORTICOLES;13;13;10;3;0;0;0;10;0;1;1;3;5;3
13638.0;2022;17;NANTES;MASCULIN;INDIVIDUEL;BAC PROFESSIONNEL;BAC PRO PROD;BAC PRO 23407 TECHNIC.FAB.BOIS ET MATERX ASSOC;1;0;0;0;0;0;0;0;0;0;0;0;0;0
23944.0;2023;13;POITIERS;MASCULIN;SCOLAIRE;BAC PROFESSIONNEL;BAC PRO PROD;BAC PRO AG 21211 COND GEST ENTR HIPPIQUE;7;6;5;1;0;0;0;5;0;0;1;1;3;1
13644.0;2022;17;NANTES;MASCULIN;INDIVIDUEL;BAC PROFESSIONNEL;BAC PRO PROD;BAC PRO 25510 METIERS ELECT. ENVIRON. CONNECTES;2;0;0;0;0;0;0;0;0;0;0;0;0;0
23946.0;2023;13;POITIERS;MASCULIN;SCOLAIRE;BAC PROFESSIONNEL;BAC PRO PROD;BAC PRO AG 21303 FORET;7;7;7;0;0;0;0;7;0;0;0;2;5;0
13647.0;2022;17;NANTES;MASCULIN;INDIVIDUEL;BAC PROFESSIONNEL;BAC PRO PROD;BAC PRO AG 21001 AGRO-EQUIPEMENT;1;1;1;0;0;0;0;1;0;0;0;0;1;0
23953.0;2023;13;POITIERS;MASCULIN;SCOLAIRE;BAC PROFESSIONNEL;BAC PRO SERV;BAC PRO 31107 CONDUCT. TRANSP.ROUT.MARCHANDISES;48;48;39;5;4;4;0;43;0;3;17;12;11;5
13649.0;2022;17;NANTES;MASCULIN;INDIVIDUEL;BAC PROFESSIONNEL;BAC PRO PROD;BAC PRO AG 21113 CGEVV;1;0;0;0;0;0;0;0;0;0;0;0;0;0
23956.0;2023;13;POITIERS;MASCULIN;SCOLAIRE;BAC PROFESSIONNEL;BAC PRO SERV;BAC PRO 31213 MET.COM.VEN.OP.A ANI.GES.ESP.COM.;181;181;152;19;10;9;1;161;0;5;26;61;69;20
13651.0;2022;17;NANTES;MASCULIN;INDIVIDUEL;BAC PROFESSIONNEL;BAC PRO PROD;BAC PRO AG 21211 COND GEST ENTR HIPPIQUE;1;1;1;0;0;0;0;1;0;0;0;0;1;0
23963.0;2023;13;POITIERS;MASCULIN;SCOLAIRE;BAC PROFESSIONNEL;BAC PRO SERV;BAC PRO 33004 ACC.SOINS-S.PERS. OPT.EN STRUCTUR;19;19;15;3;1;1;0;16;0;0;3;6;7;3
13652.0;2022;17;NANTES;MASCULIN;INDIVIDUEL;BAC PROFESSIONNEL;BAC PRO PROD;BAC PRO AG 21302 GEST MILIEUX NATURELS FAUNE;1;1;1;0;0;0;0;1;0;0;1;0;0;0
23975.0;2023;13;POITIERS;MASCULIN;SCOLAIRE;BAC TECHNOLOGIQUE;BAC STI2D;BAC STI2D ARCHITECTURE ET CONSTRUCTION;88;88;78;2;8;4;4;82;1;5;10;38;28;6
13656.0;2022;17;NANTES;MASCULIN;INDIVIDUEL;BAC PROFESSIONNEL;BAC PRO SERV;BAC PRO 31213 MET.COM.VEN.OP.A ANI.GES.ESP.COM.;4;2;0;2;0;0;0;0;0;0;0;0;0;2
23979.0;2023;13;POITIERS;MASCULIN;SCOLAIRE;BAC TECHNOLOGIQUE;BAC STL;BAC STL BIOCHIM.-BIOLOGIE-BIOTECHNOL.;51;51;41;3;7;4;3;45;0;0;10;21;14;6
13658.0;2022;17;NANTES;MASCULIN;INDIVIDUEL;BAC PROFESSIONNEL;BAC PRO SERV;BAC PRO 34304 HYGIENE PROPRETE STERILISATION;1;1;1;0;0;0;0;1;0;0;0;0;1;0
23980.0;2023;13;POITIERS;MASCULIN;SCOLAIRE;BAC TECHNOLOGIQUE;BAC STL;BAC STL SCIENCES PHYSIQUES CHIMIQUES  EN LABORAT.;13;13;11;1;1;1;0;12;0;1;4;3;4;1
13679.0;2022;17;NANTES;MASCULIN;SCOLAIRE;BAC PROFESSIONNEL;BAC PRO PROD;BAC PRO 22403 ARTS.& MET.ART:MET.ENSEIGN SIGNA;9;9;7;2;0;0;0;7;0;0;2;3;2;2
23991.0;2023;19;REIMS;FEMININ;APPRENTISSAGE;BAC PROFESSIONNEL;BAC PRO PROD;BAC PRO 25510 METIERS ELECT. ENVIRON. CONNECTES;1;1;1;0;0;0;0;1;0;0;1;0;0;0
13681.0;2022;17;NANTES;MASCULIN;SCOLAIRE;BAC PROFESSIONNEL;BAC PRO PROD;BAC PRO 22703 TECHN.INSTALL.SYST.ENERG.CLIMATI;62;62;41;18;3;1;2;42;0;3;3;16;20;20
23993.0;2023;19;REIMS;FEMININ;APPRENTISSAGE;BAC PROFESSIONNEL;BAC PRO PROD;BAC PRO AG 21113 CGEVV;6;6;4;2;0;0;0;4;0;0;0;0;4;2
13691.0;2022;17;NANTES;MASCULIN;SCOLAIRE;BAC PROFESSIONNEL;BAC PRO PROD;BAC PRO 23304 AMENAGEMENT FINITION BATIMENT;30;30;18;7;5;4;1;22;0;0;2;9;11;8
23994.0;2023;19;REIMS;FEMININ;APPRENTISSAGE;BAC PROFESSIONNEL;BAC PRO PROD;BAC PRO AG 21211 COND GEST ENTR HIPPIQUE;10;10;9;1;0;0;0;9;0;0;1;2;6;1
13693.0;2022;17;NANTES;MASCULIN;SCOLAIRE;BAC PROFESSIONNEL;BAC PRO PROD;BAC PRO 23405 TECHNICIEN MENUISIER AGENCEUR;99;99;83;15;1;1;0;84;0;8;15;37;24;15
24000.0;2023;19;REIMS;FEMININ;APPRENTISSAGE;BAC PROFESSIONNEL;BAC PRO SERV;BAC PRO 33604 METIERS DE LA COIFFURE;5;5;5;0;0;0;0;5;0;1;0;1;3;0
13696.0;2022;17;NANTES;MASCULIN;SCOLAIRE;BAC PROFESSIONNEL;BAC PRO PROD;BAC PRO 24202 ARTIS.& MET.ART : TAPIS.D'AMEUBL;1;1;0;1;0;0;0;0;0;0;0;0;0;1
24005.0;2023;19;REIMS;FEMININ;ENSEIGNEMENT A DISTANCE;BAC PROFESSIONNEL;BAC PRO SERV;BAC PRO 31212 METIERS DE L'ACCUEIL;1;1;1;0;0;0;0;1;0;0;1;0;0;0
13699.0;2022;17;NANTES;MASCULIN;SCOLAIRE;BAC PROFESSIONNEL;BAC PRO PROD;BAC PRO 25006 MICROTECHNIQUES;22;22;17;3;2;0;2;17;0;0;2;8;7;5
24006.0;2023;19;REIMS;FEMININ;ENSEIGNEMENT A DISTANCE;BAC PROFESSIONNEL;BAC PRO SERV;BAC PRO 31213 MET.COM.VEN.OP.A ANI.GES.ESP.COM.;1;1;1;0;0;0;0;1;0;0;0;0;1;0
13706.0;2022;17;NANTES;MASCULIN;SCOLAIRE;BAC PROFESSIONNEL;BAC PRO PROD;BAC PRO 25216 MAINT.VEHIC.OPTC MOTOCYCLES;30;30;30;0;0;0;0;30;0;2;12;8;8;0
24009.0;2023;19;REIMS;FEMININ;ENSEIGNEMENT A DISTANCE;BAC TECHNOLOGIQUE;BAC ST2S;BAC ST2S SCIENCES & TECHNO. SANTE & SOCIAL;3;3;3;0;0;0;0;3;0;0;1;0;2;0
13708.0;2022;17;NANTES;MASCULIN;SCOLAIRE;BAC PROFESSIONNEL;BAC PRO PROD;BAC PRO 25220 MAINT.MATERIELS OPT.B TP MANUT.;12;11;8;2;1;0;1;8;0;1;0;5;2;3
24010.0;2023;19;REIMS;FEMININ;ENSEIGNEMENT A DISTANCE;BAC TECHNOLOGIQUE;BAC STMG;BAC STMG MERCATIQUE (MARKETING);5;5;4;0;1;1;0;5;0;0;1;1;3;0
13716.0;2022;17;NANTES;MASCULIN;SCOLAIRE;BAC PROFESSIONNEL;BAC PRO PROD;BAC PRO 25513 SYST.NUM.OPT.A SURETE SECURITE;80;80;53;25;2;2;0;55;0;2;14;23;16;25
24019.0;2023;19;REIMS;FEMININ;INDIVIDUEL;BAC PROFESSIONNEL;BAC PRO PROD;BAC PRO AG 21004 CGEA;2;2;1;1;0;0;0;1;0;0;0;0;1;1
13718.0;2022;17;NANTES;MASCULIN;SCOLAIRE;BAC PROFESSIONNEL;BAC PRO PROD;BAC PRO 25515 SYST.NUM.OPT.C RES.INF.SYST.COMM.;188;188;174;14;0;0;0;174;0;14;51;73;36;14
24026.0;2023;19;REIMS;FEMININ;INDIVIDUEL;BAC PROFESSIONNEL;BAC PRO SERV;BAC PRO 33004 ACC.SOINS-S.PERS. OPT.EN STRUCTUR;4;1;0;1;0;0;0;0;0;0;0;0;0;1
13723.0;2022;17;NANTES;MASCULIN;SCOLAIRE;BAC PROFESSIONNEL;BAC PRO PROD;BAC PRO AG 21203 TECHN CONSEIL DE VENTE ANIMAL;36;36;30;6;0;0;0;30;0;0;3;10;17;6
24031.0;2023;19;REIMS;FEMININ;INDIVIDUEL;BAC TECHNOLOGIQUE;BAC STMG;BAC STMG MERCATIQUE (MARKETING);5;5;1;4;0;0;0;1;0;0;0;0;1;4
13725.0;2022;17;NANTES;MASCULIN;SCOLAIRE;BAC PROFESSIONNEL;BAC PRO PROD;BAC PRO AG 21210 COND GEST ENTR CANIN ET FELIN;13;12;11;1;0;0;0;11;0;0;0;4;7;1
24041.0;2023;19;REIMS;FEMININ;SCOLAIRE;BAC PROFESSIONNEL;BAC PRO PROD;BACPRO 23103 TECHNICIEN GEOMETRE-TOPOGRAPHE;2;2;0;2;0;0;0;0;0;0;0;0;0;2
13735.0;2022;17;NANTES;MASCULIN;SCOLAIRE;BAC PROFESSIONNEL;BAC PRO SERV;BAC PRO 31106 LOGISTIQUE;97;97;83;10;4;1;3;84;0;6;24;27;27;13
24056.0;2023;19;REIMS;FEMININ;SCOLAIRE;BAC PROFESSIONNEL;BAC PRO PROD;BAC PRO AG 21114 CONDUITE PRODUCTIONS HORTICOLES;3;3;3;0;0;0;0;3;0;0;0;1;2;0
13742.0;2022;17;NANTES;MASCULIN;SCOLAIRE;BAC PROFESSIONNEL;BAC PRO SERV;BAC PRO 32208 REAL.PR.IMPR.PLURI.OPTB.PR.IMPR.;10;10;9;1;0;0;0;9;0;0;4;3;2;1
24059.0;2023;19;REIMS;FEMININ;SCOLAIRE;BAC PROFESSIONNEL;BAC PRO PROD;BAC PRO AG 21211 COND GEST ENTR HIPPIQUE;9;9;6;3;0;0;0;6;0;0;3;1;2;3
13746.0;2022;17;NANTES;MASCULIN;SCOLAIRE;BAC PROFESSIONNEL;BAC PRO SERV;BAC PRO 33003 ACC.SOINS-S.PERS. OPT.A DOMICILE;6;6;3;3;0;0;0;3;0;0;1;0;2;3
24061.0;2023;19;REIMS;FEMININ;SCOLAIRE;BAC PROFESSIONNEL;BAC PRO PROD;BAC PRO AG 21303 FORET;1;1;0;1;0;0;0;0;0;0;0;0;0;1
13749.0;2022;17;NANTES;MASCULIN;SCOLAIRE;BAC PROFESSIONNEL;BAC PRO SERV;BAC PRO 33102 PROTHESE DENTAIRE;21;20;11;9;0;0;0;11;0;0;3;5;3;9
24068.0;2023;19;REIMS;FEMININ;SCOLAIRE;BAC PROFESSIONNEL;BAC PRO SERV;BAC PRO 31213 MET.COM.VEN.OP.A ANI.GES.ESP.COM.;238;238;180;29;29;19;10;199;0;4;35;71;89;39
13750.0;2022;17;NANTES;MASCULIN;SCOLAIRE;BAC PROFESSIONNEL;BAC PRO SERV;BAC PRO 33103 TECHNICIEN APPAREIL. ORTHOPEDIQUE;4;4;3;1;0;0;0;3;0;0;0;2;1;1
24079.0;2023;19;REIMS;FEMININ;SCOLAIRE;BAC PROFESSIONNEL;BAC PRO SERV;BAC PRO 33603 ESTHETIQUE COSMETIQUE PARFUMERIE;71;70;53;17;0;0;0;53;0;0;5;24;24;17
13762.0;2022;17;NANTES;MASCULIN;SCOLAIRE;BAC TECHNOLOGIQUE;BAC STI2D;BAC STI2D ARCHITECTURE ET CONSTRUCTION;228;228;196;2;30;16;14;212;0;3;27;73;109;16
24082.0;2023;19;REIMS;FEMININ;SCOLAIRE;BAC PROFESSIONNEL;BAC PRO SERV;BAC PRO 34403 METIERS DE LA SECURITE;36;36;32;3;1;1;0;33;0;0;11;11;11;3
13764.0;2022;17;NANTES;MASCULIN;SCOLAIRE;BAC TECHNOLOGIQUE;BAC STI2D;BAC STI2D INNOVATION TECHNO.  ET ECO CONCEPTION;409;409;346;8;55;35;20;381;0;7;45;147;182;28
24088.0;2023;19;REIMS;FEMININ;SCOLAIRE;BAC TECHNOLOGIQUE;BAC STD2A;BAC STD2A SCIENCES & TECHNO. DESIGN-ARTS APPLIQUES;75;75;70;0;5;3;2;73;1;5;14;29;24;2
13765.0;2022;17;NANTES;MASCULIN;SCOLAIRE;BAC TECHNOLOGIQUE;BAC STI2D;BAC STI2D SYSTÈME D'INFORMATION  ET NUMERIQUE;471;471;401;14;56;33;23;434;0;7;51;175;201;37
24097.0;2023;19;REIMS;FEMININ;SCOLAIRE;BAC TECHNOLOGIQUE;BAC STMG;BAC STMG MERCATIQUE (MARKETING);335;335;251;19;65;42;23;293;0;5;19;86;183;42
13768.0;2022;17;NANTES;MASCULIN;SCOLAIRE;BAC TECHNOLOGIQUE;BAC STMG;BAC STMG GESTION ET FINANCE;470;470;396;12;62;45;17;441;0;4;46;166;225;29
24099.0;2023;19;REIMS;FEMININ;SCOLAIRE;BAC TECHNOLOGIQUE;BAC STMG;BAC STMG SYSTEMES D'INFORMATION DE GESTION;5;5;2;2;1;1;0;3;0;0;0;1;2;2
13770.0;2022;17;NANTES;MASCULIN;SCOLAIRE;BAC TECHNOLOGIQUE;BAC STMG;BAC STMG RESSOURCES HUMAINES ET COMMUNICATION;300;300;209;23;68;42;26;251;0;0;11;76;164;49
24100.0;2023;19;REIMS;MASCULIN;APPRENTISSAGE;BAC PROFESSIONNEL;BAC PRO PROD;BAC PRO 20102 PILOTE DE LIGNE DE PRODUCTION;5;5;5;0;0;0;0;5;0;0;1;3;1;0
13775.0;2022;23;NICE;FEMININ;APPRENTISSAGE;BAC PROFESSIONNEL;BAC PRO PROD;BAC PRO 23005 TECHN. ETUDES BAT B ASSIST.ARCHI.;1;1;1;0;0;0;0;1;0;0;0;0;1;0
24102.0;2023;19;REIMS;MASCULIN;APPRENTISSAGE;BAC PROFESSIONNEL;BAC PRO PROD;BAC PRO 22106 CUISINE;2;2;1;1;0;0;0;1;0;0;0;1;0;1
13783.0;2022;23;NICE;FEMININ;APPRENTISSAGE;BAC PROFESSIONNEL;BAC PRO PROD;BAC PRO AG 21302 GEST MILIEUX NATURELS FAUNE;1;1;1;0;0;0;0;1;0;1;0;0;0;0
24110.0;2023;19;REIMS;MASCULIN;APPRENTISSAGE;BAC PROFESSIONNEL;BAC PRO PROD;BAC PRO 23404 TECHNICIEN CONSTRUCTEUR BOIS;3;3;3;0;0;0;0;3;0;0;1;0;2;0
13785.0;2022;23;NICE;FEMININ;APPRENTISSAGE;BAC PROFESSIONNEL;BAC PRO SERV;BAC PRO 30001 GESTION-ADMINISTRATION;21;18;16;2;0;0;0;16;0;2;5;5;4;2
24112.0;2023;19;REIMS;MASCULIN;APPRENTISSAGE;BAC PROFESSIONNEL;BAC PRO PROD;BAC PRO 25007 MAINTENANCE EQUIPEMENTS INDUST.;41;41;35;3;3;3;0;38;0;2;10;12;14;3
13795.0;2022;23;NICE;FEMININ;ENSEIGNEMENT A DISTANCE;BAC PROFESSIONNEL;BAC PRO SERV;BAC PRO 31213 MET.COM.VEN.OP.A ANI.GES.ESP.COM.;4;2;1;1;0;0;0;1;0;0;0;0;1;1
24116.0;2023;19;REIMS;MASCULIN;APPRENTISSAGE;BAC PROFESSIONNEL;BAC PRO PROD;BAC PRO 25215 MAINT.VEHIC.OPTB VEHIC.TRANS.ROUT;9;9;7;1;1;0;1;7;0;0;0;3;4;2
13797.0;2022;23;NICE;FEMININ;ENSEIGNEMENT A DISTANCE;BAC PROFESSIONNEL;BAC PRO SERV;BAC PRO 33004 ACC.SOINS-S.PERS. OPT.EN STRUCTUR;2;1;1;0;0;0;0;1;0;0;0;0;1;0
24135.0;2023;19;REIMS;MASCULIN;APPRENTISSAGE;BAC PROFESSIONNEL;BAC PRO SERV;BAC PRO 31214 MET.COM.VEN.OP.B PR.CL.VA.OF.COM.;3;3;2;1;0;0;0;2;0;0;0;2;0;1
13803.0;2022;23;NICE;FEMININ;ENSEIGNEMENT A DISTANCE;BAC TECHNOLOGIQUE;BAC STMG;BAC STMG SYSTEMES D'INFORMATION DE GESTION;1;1;0;0;1;0;1;0;0;0;0;0;0;1
24139.0;2023;19;REIMS;MASCULIN;ENSEIGNEMENT A DISTANCE;BAC GENERAL;BAC GENERAL;BAC GENE 10019 BAC GENERAL;9;9;4;3;2;0;2;4;0;0;0;1;3;5
13805.0;2022;23;NICE;FEMININ;FORMATION CONTINUE;BAC PROFESSIONNEL;BAC PRO SERV;BAC PRO 30001 GESTION-ADMINISTRATION;14;14;13;1;0;0;0;13;0;1;4;7;1;1
24141.0;2023;19;REIMS;MASCULIN;ENSEIGNEMENT A DISTANCE;BAC PROFESSIONNEL;BAC PRO SERV;BAC PRO 31213 MET.COM.VEN.OP.A ANI.GES.ESP.COM.;1;1;0;1;0;0;0;0;0;0;0;0;0;1
13806.0;2022;23;NICE;FEMININ;FORMATION CONTINUE;BAC PROFESSIONNEL;BAC PRO SERV;BAC PRO 31212 METIERS DE L'ACCUEIL;20;17;16;1;0;0;0;16;0;2;7;5;2;1
24143.0;2023;19;REIMS;MASCULIN;ENSEIGNEMENT A DISTANCE;BAC TECHNOLOGIQUE;BAC STMG;BAC STMG MERCATIQUE (MARKETING);2;2;1;1;0;0;0;1;0;0;1;0;0;1
13808.0;2022;23;NICE;FEMININ;FORMATION CONTINUE;BAC PROFESSIONNEL;BAC PRO SERV;BAC PRO 33101 OPTIQUE LUNETTERIE;10;8;8;0;0;0;0;8;0;0;1;3;4;0
24156.0;2023;19;REIMS;MASCULIN;INDIVIDUEL;BAC PROFESSIONNEL;BAC PRO PROD;BAC PRO 25515 SYST.NUM.OPT.C RES.INF.SYST.COMM.;1;0;0;0;0;0;0;0;0;0;0;0;0;0
13813.0;2022;23;NICE;FEMININ;INDIVIDUEL;BAC PROFESSIONNEL;BAC PRO PROD;BAC PRO AG 21004 CGEA;3;1;1;0;0;0;0;1;0;0;0;0;1;0
24158.0;2023;19;REIMS;MASCULIN;INDIVIDUEL;BAC PROFESSIONNEL;BAC PRO SERV;BAC PRO 31106 LOGISTIQUE;1;0;0;0;0;0;0;0;0;0;0;0;0;0
13816.0;2022;23;NICE;FEMININ;INDIVIDUEL;BAC PROFESSIONNEL;BAC PRO PROD;BAC PRO AG 21211 COND GEST ENTR HIPPIQUE;5;3;2;1;0;0;0;2;0;0;0;0;2;1
24160.0;2023;19;REIMS;MASCULIN;INDIVIDUEL;BAC PROFESSIONNEL;BAC PRO SERV;BAC PRO 34403 METIERS DE LA SECURITE;1;0;0;0;0;0;0;0;0;0;0;0;0;0
13821.0;2022;23;NICE;FEMININ;INDIVIDUEL;BAC TECHNOLOGIQUE;BAC S2TMD;BAC S2TMD MUSIQUE;1;1;0;1;0;0;0;0;0;0;0;0;0;1
24162.0;2023;19;REIMS;MASCULIN;INDIVIDUEL;BAC TECHNOLOGIQUE;BAC STI2D;BAC STI2D ENERGIES  ET ENVIRONNEMENT;3;3;0;3;0;0;0;0;0;0;0;0;0;3
13827.0;2022;23;NICE;FEMININ;INDIVIDUEL;BAC TECHNOLOGIQUE;BAC STMG;BAC STMG SYSTEMES D'INFORMATION DE GESTION;2;2;1;1;0;0;0;1;0;1;0;0;0;1
24164.0;2023;19;REIMS;MASCULIN;INDIVIDUEL;BAC TECHNOLOGIQUE;BAC STMG;BAC STMG GESTION ET FINANCE;2;2;0;2;0;0;0;0;0;0;0;0;0;2
13835.0;2022;23;NICE;FEMININ;SCOLAIRE;BAC PROFESSIONNEL;BAC PRO PROD;BAC PRO 23005 TECHN. ETUDES BAT B ASSIST.ARCHI.;8;8;5;3;0;0;0;5;0;0;0;2;3;3
24167.0;2023;19;REIMS;MASCULIN;SCOLAIRE;BAC GENERAL;BAC GENERAL;BAC GENE 10019 BAC GENERAL;3015;3015;2670;72;273;180;93;2850;31;274;585;863;1097;165
13840.0;2022;23;NICE;FEMININ;SCOLAIRE;BAC PROFESSIONNEL;BAC PRO PROD;BAC PRO 24202 ARTIS.& MET.ART : TAPIS.D'AMEUBL;3;3;3;0;0;0;0;3;0;0;2;0;1;0
24169.0;2023;19;REIMS;MASCULIN;SCOLAIRE;BAC PROFESSIONNEL;BAC PRO PROD;BAC PRO 20102 PILOTE DE LIGNE DE PRODUCTION;15;15;9;4;2;1;1;10;0;0;0;4;6;5
13850.0;2022;23;NICE;FEMININ;SCOLAIRE;BAC PROFESSIONNEL;BAC PRO PROD;BAC PRO 25411 TECH.CHAUDRONNERIE INDUSTRIELLE;1;1;0;1;0;0;0;0;0;0;0;0;0;1
24174.0;2023;19;REIMS;MASCULIN;SCOLAIRE;BAC PROFESSIONNEL;BAC PRO PROD;BAC PRO 22303 FONDERIE;5;5;4;1;0;0;0;4;0;0;1;0;3;1
13856.0;2022;23;NICE;FEMININ;SCOLAIRE;BAC PROFESSIONNEL;BAC PRO PROD;BAC PRO AG 21113 CGEVV;5;4;4;0;0;0;0;4;0;0;1;0;3;0
24175.0;2023;19;REIMS;MASCULIN;SCOLAIRE;BAC PROFESSIONNEL;BAC PRO PROD;BAC PRO 22503 PLASTIQUES ET COMPOSITES;17;17;13;3;1;0;1;13;0;1;2;6;4;4
13864.0;2022;23;NICE;FEMININ;SCOLAIRE;BAC PROFESSIONNEL;BAC PRO SERV;BAC PRO 31212 METIERS DE L'ACCUEIL;183;182;143;28;11;6;5;149;0;10;31;58;50;33
24183.0;2023;19;REIMS;MASCULIN;SCOLAIRE;BAC PROFESSIONNEL;BAC PRO PROD;BAC PRO 23303 MENUISERIE ALUMINIUM-VERRE;2;2;0;1;1;0;1;0;0;0;0;0;0;2
13870.0;2022;23;NICE;FEMININ;SCOLAIRE;BAC PROFESSIONNEL;BAC PRO SERV;BAC PRO 33003 ACC.SOINS-S.PERS. OPT.A DOMICILE;48;48;36;11;1;1;0;37;0;0;5;25;7;11
24195.0;2023;19;REIMS;MASCULIN;SCOLAIRE;BAC PROFESSIONNEL;BAC PRO PROD;BAC PRO 25220 MAINT.MATERIELS OPT.B TP MANUT.;5;5;1;2;2;1;1;2;0;0;0;1;1;3
13873.0;2022;23;NICE;FEMININ;SCOLAIRE;BAC PROFESSIONNEL;BAC PRO SERV;BAC PRO 33403 COMMERC. SERVICES EN RESTAURATION;63;63;56;7;0;0;0;56;0;1;7;30;18;7
24201.0;2023;19;REIMS;MASCULIN;SCOLAIRE;BAC PROFESSIONNEL;BAC PRO PROD;BAC PRO 25514 SYST.NUM.OPT.B AUD.RES.EQUIP.DOM.;62;62;52;7;3;2;1;54;0;3;13;26;12;8
13883.0;2022;23;NICE;FEMININ;SCOLAIRE;BAC TECHNOLOGIQUE;BAC STHR;BAC STHR SC.&TEC. HOTELLERIE-RESTAURATION;60;60;59;0;1;1;0;60;0;3;10;22;25;0
24202.0;2023;19;REIMS;MASCULIN;SCOLAIRE;BAC PROFESSIONNEL;BAC PRO PROD;BAC PRO 25515 SYST.NUM.OPT.C RES.INF.SYST.COMM.;83;83;76;3;4;4;0;80;0;4;13;36;27;3
13892.0;2022;23;NICE;FEMININ;SCOLAIRE;BAC TECHNOLOGIQUE;BAC STMG;BAC STMG RESSOURCES HUMAINES ET COMMUNICATION;396;396;319;19;58;36;22;355;0;1;38;124;192;41
24203.0;2023;19;REIMS;MASCULIN;SCOLAIRE;BAC PROFESSIONNEL;BAC PRO PROD;BAC PRO AG 21001 AGRO-EQUIPEMENT;25;25;22;3;0;0;0;22;0;0;3;6;13;3
13898.0;2022;23;NICE;MASCULIN;APPRENTISSAGE;BAC PROFESSIONNEL;BAC PRO PROD;BAC PRO 23102 TRAVAUX PUBLICS;11;11;9;2;0;0;0;9;0;0;1;5;3;2
24204.0;2023;19;REIMS;MASCULIN;SCOLAIRE;BAC PROFESSIONNEL;BAC PRO PROD;BAC PRO AG 21004 CGEA;72;72;59;13;0;0;0;59;0;0;10;24;25;13
13900.0;2022;23;NICE;MASCULIN;APPRENTISSAGE;BAC PROFESSIONNEL;BAC PRO PROD;BAC PRO 23304 AMENAGEMENT FINITION BATIMENT;3;3;2;0;1;0;1;2;0;0;0;0;2;1
24205.0;2023;19;REIMS;MASCULIN;SCOLAIRE;BAC PROFESSIONNEL;BAC PRO PROD;BAC PRO AG 21113 CGEVV;30;30;25;5;0;0;0;25;0;0;3;9;13;5
13904.0;2022;23;NICE;MASCULIN;APPRENTISSAGE;BAC PROFESSIONNEL;BAC PRO PROD;BAC PRO 25107 TECHNICIEN OUTILLEUR;1;1;1;0;0;0;0;1;0;0;0;0;1;0
24207.0;2023;19;REIMS;MASCULIN;SCOLAIRE;BAC PROFESSIONNEL;BAC PRO PROD;BAC PRO AG 21203 TECHN CONSEIL DE VENTE ANIMAL;7;7;6;1;0;0;0;6;0;0;2;2;2;1
13908.0;2022;23;NICE;MASCULIN;APPRENTISSAGE;BAC PROFESSIONNEL;BAC PRO PROD;BAC PRO 25220 MAINT.MATERIELS OPT.B TP MANUT.;3;3;3;0;0;0;0;3;0;1;0;2;0;0
24223.0;2023;19;REIMS;MASCULIN;SCOLAIRE;BAC PROFESSIONNEL;BAC PRO SERV;BAC PRO 32304 PHOTOGRAPHIE;4;4;3;1;0;0;0;3;0;0;1;1;1;1
13923.0;2022;23;NICE;MASCULIN;APPRENTISSAGE;BAC PROFESSIONNEL;BAC PRO SERV;BAC PRO 31213 MET.COM.VEN.OP.A ANI.GES.ESP.COM.;54;54;39;12;3;2;1;41;0;2;6;20;13;13
24226.0;2023;19;REIMS;MASCULIN;SCOLAIRE;BAC PROFESSIONNEL;BAC PRO SERV;BAC PRO 33006 ANIMAT. ENFANCE& PERSONNES AGEES;6;6;3;2;1;1;0;4;0;1;0;0;3;2
13924.0;2022;23;NICE;MASCULIN;APPRENTISSAGE;BAC PROFESSIONNEL;BAC PRO SERV;BAC PRO 31214 MET.COM.VEN.OP.B PR.CL.VA.OF.COM.;4;4;4;0;0;0;0;4;0;0;1;1;2;0
24231.0;2023;19;REIMS;MASCULIN;SCOLAIRE;BAC PROFESSIONNEL;BAC PRO SERV;BAC PRO 34305 TECHN.D'INTERV.SUR INSTALL. NUCL.;8;8;8;0;0;0;0;8;0;0;2;3;3;0
13925.0;2022;23;NICE;MASCULIN;APPRENTISSAGE;BAC PROFESSIONNEL;BAC PRO SERV;BAC PRO 33004 ACC.SOINS-S.PERS. OPT.EN STRUCTUR;1;0;0;0;0;0;0;0;0;0;0;0;0;0
24239.0;2023;19;REIMS;MASCULIN;SCOLAIRE;BAC TECHNOLOGIQUE;BAC STI2D;BAC STI2D ARCHITECTURE ET CONSTRUCTION;104;104;72;10;22;12;10;84;0;2;7;31;44;20
13928.0;2022;23;NICE;MASCULIN;ENSEIGNEMENT A DISTANCE;BAC GENERAL;BAC GENERAL;BAC GENE 10019 BAC GENERAL;36;36;24;8;4;3;1;27;0;2;5;7;13;9
24247.0;2023;19;REIMS;MASCULIN;SCOLAIRE;BAC TECHNOLOGIQUE;BAC STMG;BAC STMG RESSOURCES HUMAINES ET COMMUNICATION;162;162;92;19;51;37;14;129;0;0;5;21;103;33
13929.0;2022;23;NICE;MASCULIN;ENSEIGNEMENT A DISTANCE;BAC PROFESSIONNEL;BAC PRO SERV;BAC PRO 30001 GESTION-ADMINISTRATION;3;3;2;1;0;0;0;2;0;0;0;1;1;1
24253.0;2023;14;RENNES;FEMININ;APPRENTISSAGE;BAC PROFESSIONNEL;BAC PRO PROD;BAC PRO 23203 TECHNICIEN BAT. : ORG.REAL.GROS O;1;1;1;0;0;0;0;1;0;0;0;1;0;0
13931.0;2022;23;NICE;MASCULIN;ENSEIGNEMENT A DISTANCE;BAC PROFESSIONNEL;BAC PRO SERV;BAC PRO 31214 MET.COM.VEN.OP.B PR.CL.VA.OF.COM.;1;0;0;0;0;0;0;0;0;0;0;0;0;0
24256.0;2023;14;RENNES;FEMININ;APPRENTISSAGE;BAC PROFESSIONNEL;BAC PRO PROD;BAC PRO 23408 Etude et réalisation d'agencement;2;2;2;0;0;0;0;2;0;0;1;1;0;0
13948.0;2022;23;NICE;MASCULIN;INDIVIDUEL;BAC PROFESSIONNEL;BAC PRO PROD;BAC PRO 25509 TECHNIC. FROID CONDITIONNEMT AIR;2;1;0;1;0;0;0;0;0;0;0;0;0;1
24259.0;2023;14;RENNES;FEMININ;APPRENTISSAGE;BAC PROFESSIONNEL;BAC PRO PROD;BAC PRO 25214 MAINT.VEHIC.OPTA VOIT.PARTICUL.;6;6;6;0;0;0;0;6;0;2;1;2;1;0
13966.0;2022;23;NICE;MASCULIN;INDIVIDUEL;BAC TECHNOLOGIQUE;BAC STMG;BAC STMG MERCATIQUE (MARKETING);22;22;7;10;5;2;3;9;0;0;0;1;8;13
24271.0;2023;14;RENNES;FEMININ;APPRENTISSAGE;BAC PROFESSIONNEL;BAC PRO PROD;BAC PRO AG 21405 AMENAGEMENTS PAYSAGERS;3;3;3;0;0;0;0;3;0;0;0;0;3;0
13975.0;2022;23;NICE;MASCULIN;SCOLAIRE;BAC PROFESSIONNEL;BAC PRO PROD;BAC PRO 22704 TECHN. MAINT. SYST.ENERG.CLIMATI;69;69;58;10;1;1;0;59;0;2;9;18;30;10
24272.0;2023;14;RENNES;FEMININ;APPRENTISSAGE;BAC PROFESSIONNEL;BAC PRO PROD;BAC PRO AG 22108 TEC CONS VTE ALIMENTATION (PAB);5;5;3;2;0;0;0;3;0;0;0;0;3;2
13976.0;2022;23;NICE;MASCULIN;SCOLAIRE;BAC PROFESSIONNEL;BAC PRO PROD;BAC PRO 23004 TECHN. ETUDES BAT.A ETUDES & ECO.;26;26;15;11;0;0;0;15;0;0;3;6;6;11
24273.0;2023;14;RENNES;FEMININ;APPRENTISSAGE;BAC PROFESSIONNEL;BAC PRO SERV;BAC PRO 30004 ASSISTANC.GEST.ORGANIS.ACTIVITES;4;3;2;1;0;0;0;2;0;0;1;0;1;1
13997.0;2022;23;NICE;MASCULIN;SCOLAIRE;BAC PROFESSIONNEL;BAC PRO PROD;BAC PRO 25216 MAINT.VEHIC.OPTC MOTOCYCLES;30;30;21;7;2;0;2;21;0;3;4;10;4;9
24280.0;2023;14;RENNES;FEMININ;APPRENTISSAGE;BAC PROFESSIONNEL;BAC PRO SERV;BAC PRO 33604 METIERS DE LA COIFFURE;4;4;3;1;0;0;0;3;0;0;1;1;1;1
14005.0;2022;23;NICE;MASCULIN;SCOLAIRE;BAC PROFESSIONNEL;BAC PRO PROD;BAC PRO 25514 SYST.NUM.OPT.B AUD.RES.EQUIP.DOM.;71;70;66;4;0;0;0;66;0;5;18;29;14;4
24282.0;2023;14;RENNES;FEMININ;APPRENTISSAGE;BAC PROFESSIONNEL;BAC PRO SERV;BAC PRO AG 33002 SERV PERS TERRIT;49;48;41;7;0;0;0;41;0;1;2;16;22;7
14009.0;2022;23;NICE;MASCULIN;SCOLAIRE;BAC PROFESSIONNEL;BAC PRO PROD;BAC PRO AG 21114 CONDUITE PRODUCTIONS HORTICOLES;16;16;11;5;0;0;0;11;0;0;0;2;9;5
24284.0;2023;14;RENNES;FEMININ;ENSEIGNEMENT A DISTANCE;BAC PROFESSIONNEL;BAC PRO SERV;BAC PRO 30004 ASSISTANC.GEST.ORGANIS.ACTIVITES;3;1;1;0;0;0;0;1;0;0;0;1;0;0
14012.0;2022;23;NICE;MASCULIN;SCOLAIRE;BAC PROFESSIONNEL;BAC PRO PROD;BAC PRO AG 22105 LABORATOIRE CONTROLE QUALITE;10;10;9;1;0;0;0;9;0;0;3;2;4;1
24288.0;2023;14;RENNES;FEMININ;ENSEIGNEMENT A DISTANCE;BAC TECHNOLOGIQUE;BAC STMG;BAC STMG GESTION ET FINANCE;2;2;1;0;1;1;0;2;0;0;1;0;1;0
14016.0;2022;23;NICE;MASCULIN;SCOLAIRE;BAC PROFESSIONNEL;BAC PRO SERV;BAC PRO 31108 TRANSPORT;13;13;5;7;1;0;1;5;0;0;0;2;3;8
24290.0;2023;14;RENNES;FEMININ;ENSEIGNEMENT A DISTANCE;BAC TECHNOLOGIQUE;BAC STMG;BAC STMG RESSOURCES HUMAINES ET COMMUNICATION;5;5;1;1;3;2;1;3;0;0;0;0;3;2
14021.0;2022;23;NICE;MASCULIN;SCOLAIRE;BAC PROFESSIONNEL;BAC PRO SERV;BAC PRO 32208 REAL.PR.IMPR.PLURI.OPTB.PR.IMPR.;4;4;4;0;0;0;0;4;0;0;2;2;0;0
24304.0;2023;14;RENNES;FEMININ;INDIVIDUEL;BAC PROFESSIONNEL;BAC PRO SERV;BAC PRO AG 33002 SERV PERS TERRIT;3;2;0;2;0;0;0;0;0;0;0;0;0;2
14023.0;2022;23;NICE;MASCULIN;SCOLAIRE;BAC PROFESSIONNEL;BAC PRO SERV;BAC PRO 33002 SERVICES DE PROXIMITE  VIE LOCAL;4;4;4;0;0;0;0;4;0;0;0;2;2;0
24308.0;2023;14;RENNES;FEMININ;INDIVIDUEL;BAC TECHNOLOGIQUE;BAC STMG;BAC STMG GESTION ET FINANCE;2;2;1;0;1;0;1;1;0;0;0;0;1;1
14029.0;2022;23;NICE;MASCULIN;SCOLAIRE;BAC PROFESSIONNEL;BAC PRO SERV;BAC PRO 34304 HYGIENE PROPRETE STERILISATION;1;1;1;0;0;0;0;1;0;0;0;0;1;0
24312.0;2023;14;RENNES;FEMININ;SCOLAIRE;BAC PROFESSIONNEL;BAC PRO PROD;BAC PRO 22105 BOULANGER-PÂTISSIER;48;48;48;0;0;0;0;48;0;2;13;20;13;0
14032.0;2022;23;NICE;MASCULIN;SCOLAIRE;BAC TECHNOLOGIQUE;BAC S2TMD;BAC S2TMD MUSIQUE;3;3;3;0;0;0;0;3;0;1;1;1;0;0
24321.0;2023;14;RENNES;FEMININ;SCOLAIRE;BAC PROFESSIONNEL;BAC PRO PROD;BAC PRO 23304 AMENAGEMENT FINITION BATIMENT;22;22;19;2;1;1;0;20;0;4;4;8;4;2
14039.0;2022;23;NICE;MASCULIN;SCOLAIRE;BAC TECHNOLOGIQUE;BAC STI2D;BAC STI2D INNOVATION TECHNO.  ET ECO CONCEPTION;254;254;209;15;30;18;12;227;0;5;25;85;112;27
24322.0;2023;14;RENNES;FEMININ;SCOLAIRE;BAC PROFESSIONNEL;BAC PRO PROD;BAC PRO 23404 TECHNICIEN CONSTRUCTEUR BOIS;2;2;2;0;0;0;0;2;0;0;0;1;1;0
14051.0;2022;70;NORMANDIE;FEMININ;APPRENTISSAGE;BAC PROFESSIONNEL;BAC PRO PROD;BAC PRO 23004 TECHN. ETUDES BAT.A ETUDES & ECO.;1;1;1;0;0;0;0;1;0;0;0;0;1;0
24327.0;2023;14;RENNES;FEMININ;SCOLAIRE;BAC PROFESSIONNEL;BAC PRO PROD;BAC PRO 24203 METIERS DE LA MODE - VÊTEMENT;147;147;134;10;3;3;0;137;0;11;34;48;44;10
14053.0;2022;70;NORMANDIE;FEMININ;APPRENTISSAGE;BAC PROFESSIONNEL;BAC PRO PROD;BAC PRO 24203 METIERS DE LA MODE - VÊTEMENT;1;1;1;0;0;0;0;1;0;0;0;1;0;0
24334.0;2023;14;RENNES;FEMININ;SCOLAIRE;BAC PROFESSIONNEL;BAC PRO PROD;BAC PRO 25216 MAINT.VEHIC.OPTC MOTOCYCLES;2;2;2;0;0;0;0;2;0;0;0;2;0;0
14057.0;2022;70;NORMANDIE;FEMININ;APPRENTISSAGE;BAC PROFESSIONNEL;BAC PRO PROD;BAC PRO 25303 AERONAUTIQUE OPTION SYSTEMES;1;1;1;0;0;0;0;1;0;0;1;0;0;0
24337.0;2023;14;RENNES;FEMININ;SCOLAIRE;BAC PROFESSIONNEL;BAC PRO PROD;BAC PRO 25408 REPARATION DES CARROSSERIES;2;2;2;0;0;0;0;2;0;0;1;1;0;0
14068.0;2022;70;NORMANDIE;FEMININ;APPRENTISSAGE;BAC PROFESSIONNEL;BAC PRO SERV;BAC PRO 30001 GESTION-ADMINISTRATION;26;26;25;1;0;0;0;25;0;4;8;11;2;1
24349.0;2023;14;RENNES;FEMININ;SCOLAIRE;BAC PROFESSIONNEL;BAC PRO PROD;BAC PRO AG 21210 COND GEST ENTR CANIN ET FELIN;41;41;39;2;0;0;0;39;0;2;11;12;14;2
14076.0;2022;70;NORMANDIE;FEMININ;ENSEIGNEMENT A DISTANCE;BAC GENERAL;BAC GENERAL;BAC GENE 10019 BAC GENERAL;62;61;49;9;3;2;1;51;0;5;8;14;24;10
24351.0;2023;14;RENNES;FEMININ;SCOLAIRE;BAC PROFESSIONNEL;BAC PRO PROD;BAC PRO AG 21302 GEST MILIEUX NATURELS FAUNE;13;12;12;0;0;0;0;12;0;0;1;7;4;0
14078.0;2022;70;NORMANDIE;FEMININ;ENSEIGNEMENT A DISTANCE;BAC PROFESSIONNEL;BAC PRO SERV;BAC PRO 31213 MET.COM.VEN.OP.A ANI.GES.ESP.COM.;3;2;1;1;0;0;0;1;0;0;0;0;1;1
24356.0;2023;14;RENNES;FEMININ;SCOLAIRE;BAC PROFESSIONNEL;BAC PRO SERV;BAC PRO 30004 ASSISTANC.GEST.ORGANIS.ACTIVITES;372;371;314;42;15;13;2;327;0;14;66;127;120;44
14081.0;2022;70;NORMANDIE;FEMININ;ENSEIGNEMENT A DISTANCE;BAC TECHNOLOGIQUE;BAC ST2S;BAC ST2S SCIENCES & TECHNO. SANTE & SOCIAL;4;4;2;1;1;1;0;3;0;0;1;0;2;1
24371.0;2023;14;RENNES;FEMININ;SCOLAIRE;BAC PROFESSIONNEL;BAC PRO SERV;BAC PRO 33603 ESTHETIQUE COSMETIQUE PARFUMERIE;141;141;130;7;4;3;1;133;0;4;36;59;34;8
14091.0;2022;70;NORMANDIE;FEMININ;FORMATION CONTINUE;BAC PROFESSIONNEL;BAC PRO PROD;BAC PRO 25007 MAINTENANCE EQUIPEMENTS INDUST.;6;6;6;0;0;0;0;6;0;2;2;2;0;0
24380.0;2023;14;RENNES;FEMININ;SCOLAIRE;BAC TECHNOLOGIQUE;BAC ST2S;BAC ST2S SCIENCES & TECHNO. SANTE & SOCIAL;834;834;753;13;68;41;27;794;0;30;148;302;314;40
14092.0;2022;70;NORMANDIE;FEMININ;FORMATION CONTINUE;BAC PROFESSIONNEL;BAC PRO PROD;BAC PRO 25106 TECHNICIEN D'USINAGE;1;1;1;0;0;0;0;1;0;0;1;0;0;0
24386.0;2023;14;RENNES;FEMININ;SCOLAIRE;BAC TECHNOLOGIQUE;BAC STI2D;BAC STI2D INNOVATION TECHNO.  ET ECO CONCEPTION;37;37;35;0;2;0;2;35;0;2;4;18;11;2
14097.0;2022;70;NORMANDIE;FEMININ;FORMATION CONTINUE;BAC PROFESSIONNEL;BAC PRO SERV;BAC PRO 32207 REAL.PR.IMPR.PLURI.OPTA.PR.GRAPH.;4;2;0;2;0;0;0;0;0;0;0;0;0;2
24388.0;2023;14;RENNES;FEMININ;SCOLAIRE;BAC TECHNOLOGIQUE;BAC STL;BAC STL BIOCHIM.-BIOLOGIE-BIOTECHNOL.;55;55;51;1;3;3;0;54;0;4;12;19;19;1
14099.0;2022;70;NORMANDIE;FEMININ;FORMATION CONTINUE;BAC PROFESSIONNEL;BAC PRO SERV;BAC PRO 34303 GEST. POLLUTIONS PROTEC. ENVIRON.;1;1;1;0;0;0;0;1;0;0;1;0;0;0
24395.0;2023;14;RENNES;MASCULIN;APPRENTISSAGE;BAC PROFESSIONNEL;BAC PRO PROD;BAC PRO 22105 BOULANGER-PÂTISSIER;14;14;14;0;0;0;0;14;0;1;6;6;1;0
14112.0;2022;70;NORMANDIE;FEMININ;INDIVIDUEL;BAC PROFESSIONNEL;BAC PRO SERV;BAC PRO AG 33002 SERV PERS TERRIT;1;1;0;1;0;0;0;0;0;0;0;0;0;1
24396.0;2023;14;RENNES;MASCULIN;APPRENTISSAGE;BAC PROFESSIONNEL;BAC PRO PROD;BAC PRO 22106 CUISINE;41;40;33;5;2;2;0;35;0;1;5;16;13;5
14118.0;2022;70;NORMANDIE;FEMININ;SCOLAIRE;BAC GENERAL;BAC GENERAL;BAC GENE 10019 BAC GENERAL;9771;9771;9066;130;575;417;158;9483;201;1257;2400;2945;2680;288
24398.0;2023;14;RENNES;MASCULIN;APPRENTISSAGE;BAC PROFESSIONNEL;BAC PRO PROD;BAC PRO 22704 TECHN. MAINT. SYST.ENERG.CLIMATI;6;6;6;0;0;0;0;6;0;1;0;3;2;0
14119.0;2022;70;NORMANDIE;FEMININ;SCOLAIRE;BAC PROFESSIONNEL;BAC PRO PROD;BACPRO 20002 ETUD.DEFINITION PRDTS INDUSTRIEL;2;2;0;2;0;0;0;0;0;0;0;0;0;2
24408.0;2023;14;RENNES;MASCULIN;APPRENTISSAGE;BAC PROFESSIONNEL;BAC PRO PROD;BAC PRO 25107 TECHNICIEN OUTILLEUR;6;6;4;2;0;0;0;4;0;0;1;1;2;2
14128.0;2022;70;NORMANDIE;FEMININ;SCOLAIRE;BAC PROFESSIONNEL;BAC PRO PROD;BAC PRO 23004 TECHN. ETUDES BAT.A ETUDES & ECO.;10;10;10;0;0;0;0;10;0;2;1;3;4;0
24430.0;2023;14;RENNES;MASCULIN;APPRENTISSAGE;BAC PROFESSIONNEL;BAC PRO SERV;BAC PRO 31209 POISSONIER ECAILLER TRAITEUR;7;7;6;0;1;1;0;7;0;0;3;2;2;0
14130.0;2022;70;NORMANDIE;FEMININ;SCOLAIRE;BAC PROFESSIONNEL;BAC PRO PROD;BAC PRO 23203 TECHNICIEN BAT. : ORG.REAL.GROS O;2;2;1;1;0;0;0;1;0;0;0;1;0;1
24436.0;2023;14;RENNES;MASCULIN;APPRENTISSAGE;BAC PROFESSIONNEL;BAC PRO SERV;BAC PRO AG 33002 SERV PERS TERRIT;5;5;5;0;0;0;0;5;0;0;1;1;3;0
14132.0;2022;70;NORMANDIE;FEMININ;SCOLAIRE;BAC PROFESSIONNEL;BAC PRO PROD;BAC PRO 23304 AMENAGEMENT FINITION BATIMENT;10;9;6;3;0;0;0;6;0;1;1;1;3;3
24438.0;2023;14;RENNES;MASCULIN;ENSEIGNEMENT A DISTANCE;BAC PROFESSIONNEL;BAC PRO SERV;BAC PRO 31213 MET.COM.VEN.OP.A ANI.GES.ESP.COM.;1;1;1;0;0;0;0;1;0;0;0;1;0;0
14139.0;2022;70;NORMANDIE;FEMININ;SCOLAIRE;BAC PROFESSIONNEL;BAC PRO PROD;BAC PRO 25006 MICROTECHNIQUES;1;1;1;0;0;0;0;1;0;0;0;1;0;0
24440.0;2023;14;RENNES;MASCULIN;ENSEIGNEMENT A DISTANCE;BAC PROFESSIONNEL;BAC PRO SERV;BAC PRO 33004 ACC.SOINS-S.PERS. OPT.EN STRUCTUR;1;1;0;1;0;0;0;0;0;0;0;0;0;1
14143.0;2022;70;NORMANDIE;FEMININ;SCOLAIRE;BAC PROFESSIONNEL;BAC PRO PROD;BAC PRO 25215 MAINT.VEHIC.OPTB VEHIC.TRANS.ROUT;2;2;2;0;0;0;0;2;0;1;1;0;0;0
24441.0;2023;14;RENNES;MASCULIN;ENSEIGNEMENT A DISTANCE;BAC TECHNOLOGIQUE;BAC STMG;BAC STMG GESTION ET FINANCE;1;1;1;0;0;0;0;1;0;0;0;1;0;0
14144.0;2022;70;NORMANDIE;FEMININ;SCOLAIRE;BAC PROFESSIONNEL;BAC PRO PROD;BAC PRO 25216 MAINT.VEHIC.OPTC MOTOCYCLES;1;1;1;0;0;0;0;1;0;0;0;1;0;0
24454.0;2023;14;RENNES;MASCULIN;INDIVIDUEL;BAC PROFESSIONNEL;BAC PRO PROD;BAC PRO 25411 TECH.CHAUDRONNERIE INDUSTRIELLE;1;0;0;0;0;0;0;0;0;0;0;0;0;0
14152.0;2022;70;NORMANDIE;FEMININ;SCOLAIRE;BAC PROFESSIONNEL;BAC PRO PROD;BAC PRO AG 21001 AGRO-EQUIPEMENT;2;2;2;0;0;0;0;2;0;0;0;0;2;0
24462.0;2023;14;RENNES;MASCULIN;INDIVIDUEL;BAC PROFESSIONNEL;BAC PRO PROD;BAC PRO AG 21302 GEST MILIEUX NATURELS FAUNE;2;2;2;0;0;0;0;2;0;0;0;1;1;0
14154.0;2022;70;NORMANDIE;FEMININ;SCOLAIRE;BAC PROFESSIONNEL;BAC PRO PROD;BAC PRO AG 21114 CONDUITE PRODUCTIONS HORTICOLES;28;27;22;5;0;0;0;22;0;0;2;7;13;5
24465.0;2023;14;RENNES;MASCULIN;INDIVIDUEL;BAC PROFESSIONNEL;BAC PRO SERV;BAC PRO 31213 MET.COM.VEN.OP.A ANI.GES.ESP.COM.;3;2;1;1;0;0;0;1;0;0;0;0;1;1
14156.0;2022;70;NORMANDIE;FEMININ;SCOLAIRE;BAC PROFESSIONNEL;BAC PRO PROD;BAC PRO AG 21210 COND GEST ENTR CANIN ET FELIN;56;56;50;6;0;0;0;50;0;0;6;18;26;6
24472.0;2023;14;RENNES;MASCULIN;INDIVIDUEL;BAC TECHNOLOGIQUE;BAC STMG;BAC STMG MERCATIQUE (MARKETING);23;23;9;6;8;7;1;16;0;0;0;1;15;7
14157.0;2022;70;NORMANDIE;FEMININ;SCOLAIRE;BAC PROFESSIONNEL;BAC PRO PROD;BAC PRO AG 21211 COND GEST ENTR HIPPIQUE;27;27;24;3;0;0;0;24;0;1;4;6;13;3
24484.0;2023;14;RENNES;MASCULIN;SCOLAIRE;BAC PROFESSIONNEL;BAC PRO PROD;BAC PRO 23005 TECHN. ETUDES BAT B ASSIST.ARCHI.;32;32;31;0;1;1;0;32;0;4;10;12;6;0
14158.0;2022;70;NORMANDIE;FEMININ;SCOLAIRE;BAC PROFESSIONNEL;BAC PRO PROD;BAC PRO AG 21302 GEST MILIEUX NATURELS FAUNE;13;12;12;0;0;0;0;12;0;0;3;6;3;0
24486.0;2023;14;RENNES;MASCULIN;SCOLAIRE;BAC PROFESSIONNEL;BAC PRO PROD;BACPRO 23103 TECHNICIEN GEOMETRE-TOPOGRAPHE;15;15;8;7;0;0;0;8;0;0;0;3;5;7
14173.0;2022;70;NORMANDIE;FEMININ;SCOLAIRE;BAC PROFESSIONNEL;BAC PRO SERV;BAC PRO 32303 ART.& MET.ART:COM.VIS.VIS.PLURI-M;32;32;27;5;0;0;0;27;0;1;5;12;9;5
24500.0;2023;14;RENNES;MASCULIN;SCOLAIRE;BAC PROFESSIONNEL;BAC PRO PROD;BAC PRO 25106 TECHNICIEN D'USINAGE;82;82;69;11;2;1;1;70;0;2;17;27;24;12
14175.0;2022;70;NORMANDIE;FEMININ;SCOLAIRE;BAC PROFESSIONNEL;BAC PRO SERV;BAC PRO 33002 SERVICES DE PROXIMITE  VIE LOCAL;85;85;77;8;0;0;0;77;0;3;24;30;20;8
24501.0;2023;14;RENNES;MASCULIN;SCOLAIRE;BAC PROFESSIONNEL;BAC PRO PROD;BAC PRO 25107 TECHNICIEN OUTILLEUR;6;6;5;0;1;0;1;5;0;0;2;2;1;1
14179.0;2022;70;NORMANDIE;FEMININ;SCOLAIRE;BAC PROFESSIONNEL;BAC PRO SERV;BAC PRO 33102 PROTHESE DENTAIRE;11;11;8;3;0;0;0;8;0;0;1;3;4;3
24503.0;2023;14;RENNES;MASCULIN;SCOLAIRE;BAC PROFESSIONNEL;BAC PRO PROD;BAC PRO 25215 MAINT.VEHIC.OPTB VEHIC.TRANS.ROUT;51;51;37;8;6;6;0;43;0;3;5;8;27;8
14180.0;2022;70;NORMANDIE;FEMININ;SCOLAIRE;BAC PROFESSIONNEL;BAC PRO SERV;BAC PRO 33403 COMMERC. SERVICES EN RESTAURATION;80;80;60;17;3;2;1;62;0;3;9;23;27;18
24514.0;2023;14;RENNES;MASCULIN;SCOLAIRE;BAC PROFESSIONNEL;BAC PRO PROD;BAC PRO 25509 TECHNIC. FROID CONDITIONNEMT AIR;37;37;24;9;4;3;1;27;0;0;5;10;12;10
14185.0;2022;70;NORMANDIE;FEMININ;SCOLAIRE;BAC PROFESSIONNEL;BAC PRO SERV;BAC PRO 34403 METIERS DE LA SECURITE;37;37;34;3;0;0;0;34;0;1;13;17;3;3
24526.0;2023;14;RENNES;MASCULIN;SCOLAIRE;BAC PROFESSIONNEL;BAC PRO PROD;BAC PRO AG 21302 GEST MILIEUX NATURELS FAUNE;55;55;52;3;0;0;0;52;0;3;10;22;17;3
14188.0;2022;70;NORMANDIE;FEMININ;SCOLAIRE;BAC TECHNOLOGIQUE;BAC S2TMD;BAC S2TMD MUSIQUE;7;7;6;1;0;0;0;6;0;2;2;0;2;1
24527.0;2023;14;RENNES;MASCULIN;SCOLAIRE;BAC PROFESSIONNEL;BAC PRO PROD;BAC PRO AG 21303 FORET;15;15;14;1;0;0;0;14;0;0;1;0;13;1
14193.0;2022;70;NORMANDIE;FEMININ;SCOLAIRE;BAC TECHNOLOGIQUE;BAC STI2D;BAC STI2D ARCHITECTURE ET CONSTRUCTION;45;45;41;1;3;3;0;44;0;1;9;13;21;1
24528.0;2023;14;RENNES;MASCULIN;SCOLAIRE;BAC PROFESSIONNEL;BAC PRO PROD;BAC PRO AG 21405 AMENAGEMENTS PAYSAGERS;171;168;155;13;0;0;0;155;0;1;22;64;68;13
14194.0;2022;70;NORMANDIE;FEMININ;SCOLAIRE;BAC TECHNOLOGIQUE;BAC STI2D;BAC STI2D ENERGIES  ET ENVIRONNEMENT;18;18;15;2;1;1;0;16;0;0;1;4;11;2
24531.0;2023;14;RENNES;MASCULIN;SCOLAIRE;BAC PROFESSIONNEL;BAC PRO PROD;BAC PRO AG 22108 TEC CONS VTE ALIMENTATION (PAB);74;73;65;8;0;0;0;65;0;1;5;23;36;8
14202.0;2022;70;NORMANDIE;FEMININ;SCOLAIRE;BAC TECHNOLOGIQUE;BAC STMG;BAC STMG SYSTEMES D'INFORMATION DE GESTION;5;5;5;0;0;0;0;5;0;0;1;3;1;0
24538.0;2023;14;RENNES;MASCULIN;SCOLAIRE;BAC PROFESSIONNEL;BAC PRO SERV;BAC PRO 31214 MET.COM.VEN.OP.B PR.CL.VA.OF.COM.;297;297;255;35;7;5;2;260;0;10;33;108;109;37
14210.0;2022;70;NORMANDIE;MASCULIN;APPRENTISSAGE;BAC PROFESSIONNEL;BAC PRO PROD;BAC PRO 23004 TECHN. ETUDES BAT.A ETUDES & ECO.;10;10;6;4;0;0;0;6;0;0;2;2;2;4
24545.0;2023;14;RENNES;MASCULIN;SCOLAIRE;BAC PROFESSIONNEL;BAC PRO SERV;BAC PRO 33101 OPTIQUE LUNETTERIE;12;12;11;1;0;0;0;11;0;1;5;5;0;1
14211.0;2022;70;NORMANDIE;MASCULIN;APPRENTISSAGE;BAC PROFESSIONNEL;BAC PRO PROD;BAC PRO 23102 TRAVAUX PUBLICS;28;28;26;2;0;0;0;26;0;4;8;10;4;2
24546.0;2023;14;RENNES;MASCULIN;SCOLAIRE;BAC PROFESSIONNEL;BAC PRO SERV;BAC PRO 33403 COMMERC. SERVICES EN RESTAURATION;106;106;93;4;9;7;2;100;0;3;17;41;39;6
14212.0;2022;70;NORMANDIE;MASCULIN;APPRENTISSAGE;BAC PROFESSIONNEL;BAC PRO PROD;BAC PRO 23203 TECHNICIEN BAT. : ORG.REAL.GROS O;14;14;12;2;0;0;0;12;0;1;3;5;3;2
24547.0;2023;14;RENNES;MASCULIN;SCOLAIRE;BAC PROFESSIONNEL;BAC PRO SERV;BAC PRO 33604 METIERS DE LA COIFFURE;10;10;8;2;0;0;0;8;0;0;1;3;4;2
14217.0;2022;70;NORMANDIE;MASCULIN;APPRENTISSAGE;BAC PROFESSIONNEL;BAC PRO PROD;BAC PRO 25007 MAINTENANCE EQUIPEMENTS INDUST.;69;68;56;11;1;1;0;57;0;4;11;20;22;11
24552.0;2023;14;RENNES;MASCULIN;SCOLAIRE;BAC TECHNOLOGIQUE;BAC S2TMD;BAC S2TMD MUSIQUE;4;4;4;0;0;0;0;4;0;0;3;1;0;0
14220.0;2022;70;NORMANDIE;MASCULIN;APPRENTISSAGE;BAC PROFESSIONNEL;BAC PRO PROD;BAC PRO 25107 TECHNICIEN OUTILLEUR;15;15;11;3;1;1;0;12;0;0;3;4;5;3
24566.0;2023;14;RENNES;MASCULIN;SCOLAIRE;BAC TECHNOLOGIQUE;BAC STMG;BAC STMG RESSOURCES HUMAINES ET COMMUNICATION;274;274;204;10;60;43;17;247;0;2;8;54;183;27
14224.0;2022;70;NORMANDIE;MASCULIN;APPRENTISSAGE;BAC PROFESSIONNEL;BAC PRO PROD;BAC PRO 25219 MAINT.MATERIELS OPT.A AGRICOLES;1;1;1;0;0;0;0;1;0;0;0;0;1;0
24569.0;2023;15;STRASBOURG;FEMININ;APPRENTISSAGE;BAC PROFESSIONNEL;BAC PRO PROD;BAC PRO 20102 PILOTE DE LIGNE DE PRODUCTION;3;3;3;0;0;0;0;3;0;1;1;1;0;0
14228.0;2022;70;NORMANDIE;MASCULIN;APPRENTISSAGE;BAC PROFESSIONNEL;BAC PRO PROD;BAC PRO 25408 REPARATION DES CARROSSERIES;50;50;43;6;1;0;1;43;0;4;11;12;16;7
24572.0;2023;15;STRASBOURG;FEMININ;APPRENTISSAGE;BAC PROFESSIONNEL;BAC PRO PROD;BAC PRO 23102 TRAVAUX PUBLICS;1;1;1;0;0;0;0;1;0;0;0;1;0;0
14238.0;2022;70;NORMANDIE;MASCULIN;APPRENTISSAGE;BAC PROFESSIONNEL;BAC PRO PROD;BAC PRO AG 21203 TECHN CONSEIL DE VENTE ANIMAL;6;6;6;0;0;0;0;6;0;0;1;1;4;0
24573.0;2023;15;STRASBOURG;FEMININ;APPRENTISSAGE;BAC PROFESSIONNEL;BAC PRO PROD;BAC PRO 23407 TECHNIC.FAB.BOIS ET MATERX ASSOC;2;2;2;0;0;0;0;2;0;0;0;0;2;0
14242.0;2022;70;NORMANDIE;MASCULIN;APPRENTISSAGE;BAC PROFESSIONNEL;BAC PRO PROD;BAC PRO AG 21303 FORET;12;12;12;0;0;0;0;12;0;1;1;1;9;0
24579.0;2023;15;STRASBOURG;FEMININ;APPRENTISSAGE;BAC PROFESSIONNEL;BAC PRO PROD;BAC PRO 25510 METIERS ELECT. ENVIRON. CONNECTES;2;2;1;1;0;0;0;1;0;1;0;0;0;1
14244.0;2022;70;NORMANDIE;MASCULIN;APPRENTISSAGE;BAC PROFESSIONNEL;BAC PRO PROD;BAC PRO AG 22107 TEC CONS VTE ALIMENTATION P.ALIM;5;4;3;1;0;0;0;3;0;0;0;1;2;1
24581.0;2023;15;STRASBOURG;FEMININ;APPRENTISSAGE;BAC PROFESSIONNEL;BAC PRO PROD;BAC PRO AG 21004 CGEA;4;4;3;1;0;0;0;3;0;0;0;2;1;1
14245.0;2022;70;NORMANDIE;MASCULIN;APPRENTISSAGE;BAC PROFESSIONNEL;BAC PRO SERV;BAC PRO 30001 GESTION-ADMINISTRATION;4;4;3;1;0;0;0;3;0;0;1;1;1;1
24582.0;2023;15;STRASBOURG;FEMININ;APPRENTISSAGE;BAC PROFESSIONNEL;BAC PRO PROD;BAC PRO AG 21114 CONDUITE PRODUCTIONS HORTICOLES;5;5;5;0;0;0;0;5;0;0;0;1;4;0
14247.0;2022;70;NORMANDIE;MASCULIN;APPRENTISSAGE;BAC PROFESSIONNEL;BAC PRO SERV;BAC PRO 31213 MET.COM.VEN.OP.A ANI.GES.ESP.COM.;93;91;73;15;3;2;1;75;0;3;18;21;33;16
24583.0;2023;15;STRASBOURG;FEMININ;APPRENTISSAGE;BAC PROFESSIONNEL;BAC PRO PROD;BAC PRO AG 21203 TECHN CONSEIL DE VENTE ANIMAL;5;5;5;0;0;0;0;5;0;0;2;0;3;0
14251.0;2022;70;NORMANDIE;MASCULIN;APPRENTISSAGE;BAC PROFESSIONNEL;BAC PRO SERV;BAC PRO 33403 COMMERC. SERVICES EN RESTAURATION;7;7;5;1;1;1;0;6;0;0;0;2;4;1
24595.0;2023;15;STRASBOURG;FEMININ;ENSEIGNEMENT A DISTANCE;BAC GENERAL;BAC GENERAL;BAC GENE 10019 BAC GENERAL;46;46;30;8;8;6;2;36;0;3;5;12;16;10
14256.0;2022;70;NORMANDIE;MASCULIN;ENSEIGNEMENT A DISTANCE;BAC PROFESSIONNEL;BAC PRO SERV;BAC PRO 31213 MET.COM.VEN.OP.A ANI.GES.ESP.COM.;1;1;0;1;0;0;0;0;0;0;0;0;0;1
24597.0;2023;15;STRASBOURG;FEMININ;ENSEIGNEMENT A DISTANCE;BAC PROFESSIONNEL;BAC PRO SERV;BAC PRO 31213 MET.COM.VEN.OP.A ANI.GES.ESP.COM.;3;3;2;1;0;0;0;2;0;0;0;1;1;1
14262.0;2022;70;NORMANDIE;MASCULIN;FORMATION CONTINUE;BAC PROFESSIONNEL;BAC PRO PROD;BACPRO 20002 ETUD.DEFINITION PRDTS INDUSTRIEL;8;8;3;5;0;0;0;3;0;1;0;2;0;5
24598.0;2023;15;STRASBOURG;FEMININ;ENSEIGNEMENT A DISTANCE;BAC PROFESSIONNEL;BAC PRO SERV;BAC PRO 33603 ESTHETIQUE COSMETIQUE PARFUMERIE;2;2;1;1;0;0;0;1;0;0;0;0;1;1
14265.0;2022;70;NORMANDIE;MASCULIN;FORMATION CONTINUE;BAC PROFESSIONNEL;BAC PRO PROD;BAC PRO 22004 PROC. CHIMIE EAU PAPIERS-CARTONS;20;20;20;0;0;0;0;20;0;9;10;1;0;0
24600.0;2023;15;STRASBOURG;FEMININ;ENSEIGNEMENT A DISTANCE;BAC TECHNOLOGIQUE;BAC STMG;BAC STMG GESTION ET FINANCE;2;2;2;0;0;0;0;2;0;1;0;0;1;0
14267.0;2022;70;NORMANDIE;MASCULIN;FORMATION CONTINUE;BAC PROFESSIONNEL;BAC PRO PROD;BAC PRO 22703 TECHN.INSTALL.SYST.ENERG.CLIMATI;5;4;4;0;0;0;0;4;0;1;2;1;0;0
24610.0;2023;15;STRASBOURG;FEMININ;INDIVIDUEL;BAC PROFESSIONNEL;BAC PRO PROD;BAC PRO AG 21004 CGEA;1;1;1;0;0;0;0;1;0;0;0;0;1;0
14274.0;2022;70;NORMANDIE;MASCULIN;FORMATION CONTINUE;BAC PROFESSIONNEL;BAC PRO PROD;BAC PRO 25215 MAINT.VEHIC.OPTB VEHIC.TRANS.ROUT;1;1;1;0;0;0;0;1;0;1;0;0;0;0
24611.0;2023;15;STRASBOURG;FEMININ;INDIVIDUEL;BAC PROFESSIONNEL;BAC PRO PROD;BAC PRO AG 21114 CONDUITE PRODUCTIONS HORTICOLES;1;1;1;0;0;0;0;1;0;0;0;0;1;0
14288.0;2022;70;NORMANDIE;MASCULIN;INDIVIDUEL;BAC PROFESSIONNEL;BAC PRO PROD;BAC PRO 23404 TECHNICIEN CONSTRUCTEUR BOIS;1;1;0;1;0;0;0;0;0;0;0;0;0;1
24627.0;2023;15;STRASBOURG;FEMININ;SCOLAIRE;BAC GENERAL;BAC GENERAL;BAC GENE 10019 BAC GENERAL;5632;5632;5330;72;230;145;85;5475;138;931;1585;1677;1144;157
14291.0;2022;70;NORMANDIE;MASCULIN;INDIVIDUEL;BAC PROFESSIONNEL;BAC PRO PROD;BAC PRO 25214 MAINT.VEHIC.OPTA VOIT.PARTICUL.;3;1;1;0;0;0;0;1;0;0;0;0;1;0
24648.0;2023;15;STRASBOURG;FEMININ;SCOLAIRE;BAC PROFESSIONNEL;BAC PRO PROD;BAC PRO 25513 SYST.NUM.OPT.A SURETE SECURITE;1;1;1;0;0;0;0;1;0;0;0;0;1;0
14299.0;2022;70;NORMANDIE;MASCULIN;INDIVIDUEL;BAC PROFESSIONNEL;BAC PRO PROD;BAC PRO AG 21211 COND GEST ENTR HIPPIQUE;1;1;1;0;0;0;0;1;0;0;0;0;1;0
24649.0;2023;15;STRASBOURG;FEMININ;SCOLAIRE;BAC PROFESSIONNEL;BAC PRO PROD;BAC PRO 25515 SYST.NUM.OPT.C RES.INF.SYST.COMM.;2;2;1;1;0;0;0;1;0;0;1;0;0;1
14304.0;2022;70;NORMANDIE;MASCULIN;INDIVIDUEL;BAC PROFESSIONNEL;BAC PRO SERV;BAC PRO 31214 MET.COM.VEN.OP.B PR.CL.VA.OF.COM.;1;0;0;0;0;0;0;0;0;0;0;0;0;0
24650.0;2023;15;STRASBOURG;FEMININ;SCOLAIRE;BAC PROFESSIONNEL;BAC PRO PROD;BAC PRO AG 21004 CGEA;16;15;12;3;0;0;0;12;0;0;0;7;5;3
14306.0;2022;70;NORMANDIE;MASCULIN;INDIVIDUEL;BAC PROFESSIONNEL;BAC PRO SERV;BAC PRO 33403 COMMERC. SERVICES EN RESTAURATION;1;0;0;0;0;0;0;0;0;0;0;0;0;0
24656.0;2023;15;STRASBOURG;FEMININ;SCOLAIRE;BAC PROFESSIONNEL;BAC PRO SERV;BAC PRO 30004 ASSISTANC.GEST.ORGANIS.ACTIVITES;349;349;258;67;24;19;5;277;0;10;29;106;132;72
14316.0;2022;70;NORMANDIE;MASCULIN;SCOLAIRE;BAC GENERAL;BAC GENERAL;BAC GENE 10019 BAC GENERAL;7541;7541;6800;140;601;403;198;7203;106;758;1649;2338;2352;338
24664.0;2023;15;STRASBOURG;FEMININ;SCOLAIRE;BAC PROFESSIONNEL;BAC PRO SERV;BAC PRO 32207 REAL.PR.IMPR.PLURI.OPTA.PR.GRAPH.;7;7;7;0;0;0;0;7;0;2;2;1;2;0
14321.0;2022;70;NORMANDIE;MASCULIN;SCOLAIRE;BAC PROFESSIONNEL;BAC PRO PROD;BAC PRO 22105 BOULANGER-PÂTISSIER;30;30;28;2;0;0;0;28;0;4;6;14;4;2
24667.0;2023;15;STRASBOURG;FEMININ;SCOLAIRE;BAC PROFESSIONNEL;BAC PRO SERV;BAC PRO 33004 ACC.SOINS-S.PERS. OPT.EN STRUCTUR;391;391;325;46;20;15;5;340;0;18;77;126;119;51
14334.0;2022;70;NORMANDIE;MASCULIN;SCOLAIRE;BAC PROFESSIONNEL;BAC PRO PROD;BAC PRO 23303 MENUISERIE ALUMINIUM-VERRE;9;9;9;0;0;0;0;9;0;0;0;4;5;0
24670.0;2023;15;STRASBOURG;FEMININ;SCOLAIRE;BAC PROFESSIONNEL;BAC PRO SERV;BAC PRO 33104 TECHNICIEN EN PROTHESE DENTAIRE;6;6;4;2;0;0;0;4;0;0;1;1;2;2
14336.0;2022;70;NORMANDIE;MASCULIN;SCOLAIRE;BAC PROFESSIONNEL;BAC PRO PROD;BAC PRO 23404 TECHNICIEN CONSTRUCTEUR BOIS;50;50;29;21;0;0;0;29;0;0;2;11;16;21
24677.0;2023;15;STRASBOURG;FEMININ;SCOLAIRE;BAC TECHNOLOGIQUE;BAC ST2S;BAC ST2S SCIENCES & TECHNO. SANTE & SOCIAL;463;463;386;19;58;37;21;423;3;16;68;135;201;40
14338.0;2022;70;NORMANDIE;MASCULIN;SCOLAIRE;BAC PROFESSIONNEL;BAC PRO PROD;BAC PRO 23406 TECHNICIEN DE SCIERIE;10;10;10;0;0;0;0;10;0;1;2;2;5;0
24683.0;2023;15;STRASBOURG;FEMININ;SCOLAIRE;BAC TECHNOLOGIQUE;BAC STI2D;BAC STI2D INNOVATION TECHNO.  ET ECO CONCEPTION;17;17;15;0;2;2;0;17;0;0;3;5;9;0
14341.0;2022;70;NORMANDIE;MASCULIN;SCOLAIRE;BAC PROFESSIONNEL;BAC PRO PROD;BAC PRO 24202 ARTIS.& MET.ART : TAPIS.D'AMEUBL;2;2;1;1;0;0;0;1;0;0;0;0;1;1
24685.0;2023;15;STRASBOURG;FEMININ;SCOLAIRE;BAC TECHNOLOGIQUE;BAC STL;BAC STL BIOCHIM.-BIOLOGIE-BIOTECHNOL.;138;138;117;7;14;5;9;122;2;14;29;42;35;16
14342.0;2022;70;NORMANDIE;MASCULIN;SCOLAIRE;BAC PROFESSIONNEL;BAC PRO PROD;BAC PRO 24203 METIERS DE LA MODE - VÊTEMENT;15;15;14;1;0;0;0;14;0;2;0;8;4;1
24686.0;2023;15;STRASBOURG;FEMININ;SCOLAIRE;BAC TECHNOLOGIQUE;BAC STL;BAC STL SCIENCES PHYSIQUES CHIMIQUES  EN LABORAT.;24;24;20;2;2;0;2;20;2;4;3;5;6;4
14351.0;2022;70;NORMANDIE;MASCULIN;SCOLAIRE;BAC PROFESSIONNEL;BAC PRO PROD;BAC PRO 25216 MAINT.VEHIC.OPTC MOTOCYCLES;11;11;8;3;0;0;0;8;0;0;2;2;4;3
24688.0;2023;15;STRASBOURG;FEMININ;SCOLAIRE;BAC TECHNOLOGIQUE;BAC STMG;BAC STMG MERCATIQUE (MARKETING);403;403;327;13;63;43;20;370;0;11;59;118;182;33
14353.0;2022;70;NORMANDIE;MASCULIN;SCOLAIRE;BAC PROFESSIONNEL;BAC PRO PROD;BAC PRO 25220 MAINT.MATERIELS OPT.B TP MANUT.;10;10;9;0;1;1;0;10;0;0;3;4;3;0
24690.0;2023;15;STRASBOURG;FEMININ;SCOLAIRE;BAC TECHNOLOGIQUE;BAC STMG;BAC STMG SYSTEMES D'INFORMATION DE GESTION;15;15;12;2;1;0;1;12;0;0;2;4;6;3
14355.0;2022;70;NORMANDIE;MASCULIN;SCOLAIRE;BAC PROFESSIONNEL;BAC PRO PROD;BAC PRO 25304 AERONAUTIQUE OPTION STRUCTURE;13;13;13;0;0;0;0;13;0;1;4;8;0;0
24691.0;2023;15;STRASBOURG;MASCULIN;APPRENTISSAGE;BAC PROFESSIONNEL;BAC PRO PROD;ART.MET.ART-FACT.ORG. OPT.TUYAUT.;1;1;1;0;0;0;0;1;0;0;1;0;0;0
14367.0;2022;70;NORMANDIE;MASCULIN;SCOLAIRE;BAC PROFESSIONNEL;BAC PRO PROD;BAC PRO AG 21203 TECHN CONSEIL DE VENTE ANIMAL;5;5;5;0;0;0;0;5;0;0;0;2;3;0
24693.0;2023;15;STRASBOURG;MASCULIN;APPRENTISSAGE;BAC PROFESSIONNEL;BAC PRO PROD;BAC PRO 22106 CUISINE;28;27;21;6;0;0;0;21;0;1;9;10;1;6
14370.0;2022;70;NORMANDIE;MASCULIN;SCOLAIRE;BAC PROFESSIONNEL;BAC PRO PROD;BAC PRO AG 21211 COND GEST ENTR HIPPIQUE;8;8;7;1;0;0;0;7;0;0;2;1;4;1
24697.0;2023;15;STRASBOURG;MASCULIN;APPRENTISSAGE;BAC PROFESSIONNEL;BAC PRO PROD;BAC PRO 22703 TECHN.INSTALL.SYST.ENERG.CLIMATI;21;21;16;5;0;0;0;16;0;3;5;4;4;5
14372.0;2022;70;NORMANDIE;MASCULIN;SCOLAIRE;BAC PROFESSIONNEL;BAC PRO PROD;BAC PRO AG 21303 FORET;39;39;34;5;0;0;0;34;0;1;1;11;21;5
24698.0;2023;15;STRASBOURG;MASCULIN;APPRENTISSAGE;BAC PROFESSIONNEL;BAC PRO PROD;BAC PRO 22704 TECHN. MAINT. SYST.ENERG.CLIMATI;4;4;3;1;0;0;0;3;0;0;2;0;1;1
14374.0;2022;70;NORMANDIE;MASCULIN;SCOLAIRE;BAC PROFESSIONNEL;BAC PRO PROD;BAC PRO AG 21407 TEC CONS VTE UNIVERS JARDINERIE;9;9;8;1;0;0;0;8;0;0;1;3;4;1
24699.0;2023;15;STRASBOURG;MASCULIN;APPRENTISSAGE;BAC PROFESSIONNEL;BAC PRO PROD;BAC PRO 23102 TRAVAUX PUBLICS;27;27;24;2;1;1;0;25;0;1;3;7;14;2
14377.0;2022;70;NORMANDIE;MASCULIN;SCOLAIRE;BAC PROFESSIONNEL;BAC PRO SERV;BAC PRO 30001 GESTION-ADMINISTRATION;289;286;195;80;11;10;1;205;0;4;27;74;100;81
24700.0;2023;15;STRASBOURG;MASCULIN;APPRENTISSAGE;BAC PROFESSIONNEL;BAC PRO PROD;BAC PRO 23203 TECHNICIEN BAT. : ORG.REAL.GROS O;5;5;3;2;0;0;0;3;0;0;1;1;1;2
14385.0;2022;70;NORMANDIE;MASCULIN;SCOLAIRE;BAC PROFESSIONNEL;BAC PRO SERV;BAC PRO 32208 REAL.PR.IMPR.PLURI.OPTB.PR.IMPR.;16;16;12;3;1;1;0;13;0;0;1;8;4;3
24701.0;2023;15;STRASBOURG;MASCULIN;APPRENTISSAGE;BAC PROFESSIONNEL;BAC PRO PROD;BAC PRO 23404 TECHNICIEN CONSTRUCTEUR BOIS;3;2;1;0;1;0;1;1;0;0;0;1;0;1
14387.0;2022;70;NORMANDIE;MASCULIN;SCOLAIRE;BAC PROFESSIONNEL;BAC PRO SERV;BAC PRO 32304 PHOTOGRAPHIE;8;8;7;1;0;0;0;7;0;1;3;3;0;1
24707.0;2023;15;STRASBOURG;MASCULIN;APPRENTISSAGE;BAC PROFESSIONNEL;BAC PRO PROD;BAC PRO 25107 TECHNICIEN OUTILLEUR;4;4;3;0;1;1;0;4;0;0;2;1;1;0
14391.0;2022;70;NORMANDIE;MASCULIN;SCOLAIRE;BAC PROFESSIONNEL;BAC PRO SERV;BAC PRO 33101 OPTIQUE LUNETTERIE;7;7;6;1;0;0;0;6;0;0;2;3;1;1
24711.0;2023;15;STRASBOURG;MASCULIN;APPRENTISSAGE;BAC PROFESSIONNEL;BAC PRO PROD;BAC PRO 25219 MAINT.MATERIELS OPT.A AGRICOLES;18;18;12;2;4;3;1;15;0;1;1;6;7;3
14402.0;2022;70;NORMANDIE;MASCULIN;SCOLAIRE;BAC TECHNOLOGIQUE;BAC STAV;BAC STAV AGRONOMIE ALIM ENV TERRITOI;117;116;114;2;0;0;0;114;0;5;14;42;53;2
24713.0;2023;15;STRASBOURG;MASCULIN;APPRENTISSAGE;BAC PROFESSIONNEL;BAC PRO PROD;BAC PRO 25221 MAINT.MATERIELS OPT.C ESP. VERTS;8;8;4;1;3;1;2;5;0;0;1;0;4;3
14405.0;2022;70;NORMANDIE;MASCULIN;SCOLAIRE;BAC TECHNOLOGIQUE;BAC STI2D;BAC STI2D ARCHITECTURE ET CONSTRUCTION;135;135;111;7;17;11;6;122;0;1;16;41;64;13
24719.0;2023;15;STRASBOURG;MASCULIN;APPRENTISSAGE;BAC PROFESSIONNEL;BAC PRO PROD;BAC PRO 25510 METIERS ELECT. ENVIRON. CONNECTES;96;96;73;17;6;6;0;79;0;3;16;26;34;17
14406.0;2022;70;NORMANDIE;MASCULIN;SCOLAIRE;BAC TECHNOLOGIQUE;BAC STI2D;BAC STI2D ENERGIES  ET ENVIRONNEMENT;290;290;209;12;69;56;13;265;0;2;19;69;175;25
24722.0;2023;15;STRASBOURG;MASCULIN;APPRENTISSAGE;BAC PROFESSIONNEL;BAC PRO PROD;BAC PRO AG 21001 AGRO-EQUIPEMENT;14;13;13;0;0;0;0;13;0;0;2;3;8;0
14410.0;2022;70;NORMANDIE;MASCULIN;SCOLAIRE;BAC TECHNOLOGIQUE;BAC STL;BAC STL SCIENCES PHYSIQUES CHIMIQUES  EN LABORAT.;65;65;52;2;11;9;2;61;0;1;10;23;27;4
24724.0;2023;15;STRASBOURG;MASCULIN;APPRENTISSAGE;BAC PROFESSIONNEL;BAC PRO PROD;BAC PRO AG 21113 CGEVV;6;6;6;0;0;0;0;6;0;0;0;2;4;0
14414.0;2022;70;NORMANDIE;MASCULIN;SCOLAIRE;BAC TECHNOLOGIQUE;BAC STMG;BAC STMG SYSTEMES D'INFORMATION DE GESTION;23;23;15;2;6;5;1;20;0;0;1;2;17;3
24729.0;2023;15;STRASBOURG;MASCULIN;APPRENTISSAGE;BAC PROFESSIONNEL;BAC PRO PROD;BAC PRO AG 21407 TEC CONS VTE UNIVERS JARDINERIE;1;1;1;0;0;0;0;1;0;0;0;0;1;0
14415.0;2022;18;ORLEANS-TOURS;FEMININ;APPRENTISSAGE;BAC PROFESSIONNEL;BAC PRO PROD;BAC PRO 22106 CUISINE;5;5;4;1;0;0;0;4;0;1;0;2;1;1
24736.0;2023;15;STRASBOURG;MASCULIN;APPRENTISSAGE;BAC PROFESSIONNEL;BAC PRO SERV;BAC PRO 32208 REAL.PR.IMPR.PLURI.OPTB.PR.IMPR.;2;2;1;1;0;0;0;1;0;0;0;0;1;1
14419.0;2022;18;ORLEANS-TOURS;FEMININ;APPRENTISSAGE;BAC PROFESSIONNEL;BAC PRO PROD;BAC PRO 24302 METIERS DU CUIR : MAROQUINERIE;7;7;7;0;0;0;0;7;0;3;3;1;0;0
24747.0;2023;15;STRASBOURG;MASCULIN;FORMATION CONTINUE;BAC PROFESSIONNEL;BAC PRO PROD;BAC PRO 22704 TECHN. MAINT. SYST.ENERG.CLIMATI;3;3;2;1;0;0;0;2;0;0;1;1;0;1
14428.0;2022;18;ORLEANS-TOURS;FEMININ;APPRENTISSAGE;BAC PROFESSIONNEL;BAC PRO PROD;BAC PRO AG 21114 CONDUITE PRODUCTIONS HORTICOLES;5;5;3;2;0;0;0;3;0;0;0;2;1;2
24756.0;2023;15;STRASBOURG;MASCULIN;FORMATION CONTINUE;BAC PROFESSIONNEL;BAC PRO SERV;BAC PRO 30004 ASSISTANC.GEST.ORGANIS.ACTIVITES;1;0;0;0;0;0;0;0;0;0;0;0;0;0
14441.0;2022;18;ORLEANS-TOURS;FEMININ;APPRENTISSAGE;BAC PROFESSIONNEL;BAC PRO SERV;BAC PRO 33004 ACC.SOINS-S.PERS. OPT.EN STRUCTUR;1;1;1;0;0;0;0;1;0;0;0;1;0;0
24760.0;2023;15;STRASBOURG;MASCULIN;INDIVIDUEL;BAC PROFESSIONNEL;BAC PRO PROD;BAC PRO 23004 TECHN. ETUDES BAT.A ETUDES & ECO.;1;1;1;0;0;0;0;1;0;0;0;0;1;0
14444.0;2022;18;ORLEANS-TOURS;FEMININ;APPRENTISSAGE;BAC PROFESSIONNEL;BAC PRO SERV;BAC PRO 34403 METIERS DE LA SECURITE;2;2;2;0;0;0;0;2;0;0;2;0;0;0
24767.0;2023;15;STRASBOURG;MASCULIN;INDIVIDUEL;BAC PROFESSIONNEL;BAC PRO PROD;BAC PRO AG 21113 CGEVV;1;1;1;0;0;0;0;1;0;0;0;0;1;0
14453.0;2022;18;ORLEANS-TOURS;FEMININ;FORMATION CONTINUE;BAC PROFESSIONNEL;BAC PRO PROD;BAC PRO 23102 TRAVAUX PUBLICS;1;1;1;0;0;0;0;1;0;0;0;1;0;0
24775.0;2023;15;STRASBOURG;MASCULIN;INDIVIDUEL;BAC PROFESSIONNEL;BAC PRO SERV;BAC PRO 31214 MET.COM.VEN.OP.B PR.CL.VA.OF.COM.;1;1;1;0;0;0;0;1;0;0;0;0;1;0
14456.0;2022;18;ORLEANS-TOURS;FEMININ;FORMATION CONTINUE;BAC PROFESSIONNEL;BAC PRO PROD;BAC PRO 25303 AERONAUTIQUE OPTION SYSTEMES;2;2;2;0;0;0;0;2;0;1;0;1;0;0
24776.0;2023;15;STRASBOURG;MASCULIN;INDIVIDUEL;BAC TECHNOLOGIQUE;BAC ST2S;BAC ST2S SCIENCES & TECHNO. SANTE & SOCIAL;1;1;0;1;0;0;0;0;0;0;0;0;0;1
14458.0;2022;18;ORLEANS-TOURS;FEMININ;FORMATION CONTINUE;BAC PROFESSIONNEL;BAC PRO SERV;BAC PRO 30001 GESTION-ADMINISTRATION;14;13;11;1;1;1;0;12;0;0;3;3;6;1
24783.0;2023;15;STRASBOURG;MASCULIN;SCOLAIRE;BAC GENERAL;BAC GENERAL;BAC GENE 10019 BAC GENERAL;4600;4600;4207;81;312;199;113;4406;89;642;1090;1327;1258;194
14462.0;2022;18;ORLEANS-TOURS;FEMININ;INDIVIDUEL;BAC PROFESSIONNEL;BAC PRO PROD;BAC PRO AG 21004 CGEA;7;7;6;1;0;0;0;6;0;0;0;0;6;1
24789.0;2023;15;STRASBOURG;MASCULIN;SCOLAIRE;BAC PROFESSIONNEL;BAC PRO PROD;BAC PRO 22703 TECHN.INSTALL.SYST.ENERG.CLIMATI;32;32;22;7;3;3;0;25;0;1;5;5;14;7
14467.0;2022;18;ORLEANS-TOURS;FEMININ;INDIVIDUEL;BAC PROFESSIONNEL;BAC PRO SERV;BAC PRO 31214 MET.COM.VEN.OP.B PR.CL.VA.OF.COM.;2;2;1;1;0;0;0;1;0;0;0;0;1;1
24797.0;2023;15;STRASBOURG;MASCULIN;SCOLAIRE;BAC PROFESSIONNEL;BAC PRO PROD;BAC PRO 23404 TECHNICIEN CONSTRUCTEUR BOIS;18;18;12;6;0;0;0;12;0;1;4;3;4;6
14481.0;2022;18;ORLEANS-TOURS;FEMININ;INDIVIDUEL;BAC TECHNOLOGIQUE;BAC STMG;BAC STMG RESSOURCES HUMAINES ET COMMUNICATION;5;4;2;2;0;0;0;2;0;0;0;2;0;2
24798.0;2023;15;STRASBOURG;MASCULIN;SCOLAIRE;BAC PROFESSIONNEL;BAC PRO PROD;BAC PRO 23405 TECHNICIEN MENUISIER AGENCEUR;38;38;29;9;0;0;0;29;0;3;7;9;10;9
14484.0;2022;18;ORLEANS-TOURS;FEMININ;SCOLAIRE;BAC PROFESSIONNEL;BAC PRO PROD;BACPRO 20002 ETUD.DEFINITION PRDTS INDUSTRIEL;4;4;3;0;1;1;0;4;0;0;1;2;1;0
24799.0;2023;15;STRASBOURG;MASCULIN;SCOLAIRE;BAC PROFESSIONNEL;BAC PRO PROD;BAC PRO 23407 TECHNIC.FAB.BOIS ET MATERX ASSOC;8;8;6;1;1;1;0;7;0;0;2;2;3;1
14485.0;2022;18;ORLEANS-TOURS;FEMININ;SCOLAIRE;BAC PROFESSIONNEL;BAC PRO PROD;BAC PRO 20102 PILOTE DE LIGNE DE PRODUCTION;1;1;1;0;0;0;0;1;0;1;0;0;0;0
24801.0;2023;15;STRASBOURG;MASCULIN;SCOLAIRE;BAC PROFESSIONNEL;BAC PRO PROD;BAC PRO 25006 MICROTECHNIQUES;12;12;11;1;0;0;0;11;0;1;2;3;5;1
14486.0;2022;18;ORLEANS-TOURS;FEMININ;SCOLAIRE;BAC PROFESSIONNEL;BAC PRO PROD;BAC PRO 22003 BIO-INDUSTRIES DE TRANSFORMATION;9;9;9;0;0;0;0;9;0;3;3;2;1;0
24805.0;2023;15;STRASBOURG;MASCULIN;SCOLAIRE;BAC PROFESSIONNEL;BAC PRO PROD;BAC PRO 25214 MAINT.VEHIC.OPTA VOIT.PARTICUL.;93;92;67;20;5;4;1;71;0;3;16;24;28;21
14494.0;2022;18;ORLEANS-TOURS;FEMININ;SCOLAIRE;BAC PROFESSIONNEL;BAC PRO PROD;BAC PRO 23004 TECHN. ETUDES BAT.A ETUDES & ECO.;7;7;6;1;0;0;0;6;0;0;0;1;5;1
24813.0;2023;15;STRASBOURG;MASCULIN;SCOLAIRE;BAC PROFESSIONNEL;BAC PRO PROD;BAC PRO 25411 TECH.CHAUDRONNERIE INDUSTRIELLE;55;55;48;5;2;1;1;49;0;3;10;23;13;6
14500.0;2022;18;ORLEANS-TOURS;FEMININ;SCOLAIRE;BAC PROFESSIONNEL;BAC PRO PROD;BAC PRO 23405 TECHNICIEN MENUISIER AGENCEUR;7;7;5;1;1;0;1;5;0;0;2;0;3;2
24817.0;2023;15;STRASBOURG;MASCULIN;SCOLAIRE;BAC PROFESSIONNEL;BAC PRO PROD;BAC PRO 25514 SYST.NUM.OPT.B AUD.RES.EQUIP.DOM.;43;43;35;4;4;3;1;38;0;3;8;12;15;5
14509.0;2022;18;ORLEANS-TOURS;FEMININ;SCOLAIRE;BAC PROFESSIONNEL;BAC PRO PROD;BAC PRO 25214 MAINT.VEHIC.OPTA VOIT.PARTICUL.;7;7;7;0;0;0;0;7;0;1;1;3;2;0
24823.0;2023;15;STRASBOURG;MASCULIN;SCOLAIRE;BAC PROFESSIONNEL;BAC PRO PROD;BAC PRO AG 21303 FORET;7;7;5;2;0;0;0;5;0;0;0;2;3;2
14515.0;2022;18;ORLEANS-TOURS;FEMININ;SCOLAIRE;BAC PROFESSIONNEL;BAC PRO PROD;BAC PRO 25510 METIERS ELECT. ENVIRON. CONNECTES;8;8;7;1;0;0;0;7;0;0;1;5;1;1
24824.0;2023;15;STRASBOURG;MASCULIN;SCOLAIRE;BAC PROFESSIONNEL;BAC PRO PROD;BAC PRO AG 21405 AMENAGEMENTS PAYSAGERS;18;18;18;0;0;0;0;18;0;0;2;6;10;0
14521.0;2022;18;ORLEANS-TOURS;FEMININ;SCOLAIRE;BAC PROFESSIONNEL;BAC PRO PROD;BAC PRO AG 21203 TECHN CONSEIL DE VENTE ANIMAL;36;36;31;5;0;0;0;31;0;0;2;9;20;5
24829.0;2023;15;STRASBOURG;MASCULIN;SCOLAIRE;BAC PROFESSIONNEL;BAC PRO SERV;BAC PRO 31107 CONDUCT. TRANSP.ROUT.MARCHANDISES;40;40;30;8;2;2;0;32;0;2;9;11;10;8
14523.0;2022;18;ORLEANS-TOURS;FEMININ;SCOLAIRE;BAC PROFESSIONNEL;BAC PRO PROD;BAC PRO AG 21212 TECH EXPE ANIMALE;14;14;12;2;0;0;0;12;0;0;2;5;5;2
24834.0;2023;15;STRASBOURG;MASCULIN;SCOLAIRE;BAC PROFESSIONNEL;BAC PRO SERV;BAC PRO 31214 MET.COM.VEN.OP.B PR.CL.VA.OF.COM.;79;79;62;8;9;8;1;70;0;5;6;24;35;9
14527.0;2022;18;ORLEANS-TOURS;FEMININ;SCOLAIRE;BAC PROFESSIONNEL;BAC PRO PROD;BAC PRO AG 21407 TEC CONS VTE UNIVERS JARDINERIE;17;17;13;4;0;0;0;13;0;0;3;2;8;4
24848.0;2023;15;STRASBOURG;MASCULIN;SCOLAIRE;BAC TECHNOLOGIQUE;BAC STAV;BAC STAV AGRONOMIE ALIM ENV TERRITOI;61;61;59;2;0;0;0;59;0;1;2;25;31;2
14543.0;2022;18;ORLEANS-TOURS;FEMININ;SCOLAIRE;BAC PROFESSIONNEL;BAC PRO SERV;BAC PRO 33003 ACC.SOINS-S.PERS. OPT.A DOMICILE;216;215;181;27;7;4;3;185;0;7;33;71;74;30
24850.0;2023;15;STRASBOURG;MASCULIN;SCOLAIRE;BAC TECHNOLOGIQUE;BAC STHR;BAC STHR SC.&TEC. HOTELLERIE-RESTAURATION;58;58;54;1;3;1;2;55;0;1;14;21;19;3
14545.0;2022;18;ORLEANS-TOURS;FEMININ;SCOLAIRE;BAC PROFESSIONNEL;BAC PRO SERV;BAC PRO 33102 PROTHESE DENTAIRE;10;10;10;0;0;0;0;10;0;0;0;8;2;0
24855.0;2023;15;STRASBOURG;MASCULIN;SCOLAIRE;BAC TECHNOLOGIQUE;BAC STL;BAC STL BIOCHIM.-BIOLOGIE-BIOTECHNOL.;86;86;64;7;15;8;7;72;0;2;11;19;40;14
14559.0;2022;18;ORLEANS-TOURS;FEMININ;SCOLAIRE;BAC TECHNOLOGIQUE;BAC STI2D;BAC STI2D INNOVATION TECHNO.  ET ECO CONCEPTION;22;22;19;1;2;1;1;20;0;1;3;7;9;2
24856.0;2023;15;STRASBOURG;MASCULIN;SCOLAIRE;BAC TECHNOLOGIQUE;BAC STL;BAC STL SCIENCES PHYSIQUES CHIMIQUES  EN LABORAT.;41;41;27;9;5;4;1;31;0;1;7;9;14;10
14560.0;2022;18;ORLEANS-TOURS;FEMININ;SCOLAIRE;BAC TECHNOLOGIQUE;BAC STI2D;BAC STI2D SYSTÈME D'INFORMATION  ET NUMERIQUE;15;15;15;0;0;0;0;15;0;1;3;9;2;0
24857.0;2023;15;STRASBOURG;MASCULIN;SCOLAIRE;BAC TECHNOLOGIQUE;BAC STMG;BAC STMG GESTION ET FINANCE;212;212;175;8;29;20;9;195;0;2;19;58;116;17
14562.0;2022;18;ORLEANS-TOURS;FEMININ;SCOLAIRE;BAC TECHNOLOGIQUE;BAC STL;BAC STL SCIENCES PHYSIQUES CHIMIQUES  EN LABORAT.;45;45;43;2;0;0;0;43;0;2;7;19;15;2
24862.0;2023;16;TOULOUSE;FEMININ;APPRENTISSAGE;BAC PROFESSIONNEL;BAC PRO PROD;BAC PRO 22105 BOULANGER-PÂTISSIER;4;4;2;2;0;0;0;2;0;0;1;1;0;2
14572.0;2022;18;ORLEANS-TOURS;MASCULIN;APPRENTISSAGE;BAC PROFESSIONNEL;BAC PRO PROD;BAC PRO 23203 TECHNICIEN BAT. : ORG.REAL.GROS O;10;10;8;0;2;1;1;9;0;2;3;2;2;1
24868.0;2023;16;TOULOUSE;FEMININ;APPRENTISSAGE;BAC PROFESSIONNEL;BAC PRO PROD;BAC PRO 25106 TECHNICIEN D'USINAGE;3;3;3;0;0;0;0;3;0;2;1;0;0;0
14574.0;2022;18;ORLEANS-TOURS;MASCULIN;APPRENTISSAGE;BAC PROFESSIONNEL;BAC PRO PROD;BAC PRO 23303 MENUISERIE ALUMINIUM-VERRE;3;3;2;1;0;0;0;2;0;0;0;0;2;1
24873.0;2023;16;TOULOUSE;FEMININ;APPRENTISSAGE;BAC PROFESSIONNEL;BAC PRO PROD;BAC PRO 25303 AERONAUTIQUE OPTION SYSTEMES;2;2;2;0;0;0;0;2;0;0;1;1;0;0
14575.0;2022;18;ORLEANS-TOURS;MASCULIN;APPRENTISSAGE;BAC PROFESSIONNEL;BAC PRO PROD;BAC PRO 23304 AMENAGEMENT FINITION BATIMENT;1;1;1;0;0;0;0;1;0;0;0;0;1;0
24878.0;2023;16;TOULOUSE;FEMININ;APPRENTISSAGE;BAC PROFESSIONNEL;BAC PRO PROD;BAC PRO AG 21405 AMENAGEMENTS PAYSAGERS;1;1;1;0;0;0;0;1;0;0;0;0;1;0
14580.0;2022;18;ORLEANS-TOURS;MASCULIN;APPRENTISSAGE;BAC PROFESSIONNEL;BAC PRO PROD;BAC PRO 25107 TECHNICIEN OUTILLEUR;2;2;1;1;0;0;0;1;0;1;0;0;0;1
24879.0;2023;16;TOULOUSE;FEMININ;APPRENTISSAGE;BAC PROFESSIONNEL;BAC PRO PROD;BAC PRO AG 22108 TEC CONS VTE ALIMENTATION (PAB);9;9;9;0;0;0;0;9;0;0;0;3;6;0
14600.0;2022;18;ORLEANS-TOURS;MASCULIN;APPRENTISSAGE;BAC PROFESSIONNEL;BAC PRO PROD;BAC PRO AG 21302 GEST MILIEUX NATURELS FAUNE;1;1;1;0;0;0;0;1;0;0;0;0;1;0
24881.0;2023;16;TOULOUSE;FEMININ;APPRENTISSAGE;BAC PROFESSIONNEL;BAC PRO SERV;BAC PRO 31106 LOGISTIQUE;5;5;5;0;0;0;0;5;0;1;2;2;0;0
14602.0;2022;18;ORLEANS-TOURS;MASCULIN;APPRENTISSAGE;BAC PROFESSIONNEL;BAC PRO PROD;BAC PRO AG 21405 AMENAGEMENTS PAYSAGERS;101;94;77;17;0;0;0;77;0;2;4;28;43;17
24907.0;2023;16;TOULOUSE;FEMININ;FORMATION CONTINUE;BAC PROFESSIONNEL;BAC PRO PROD;BAC PRO 23005 TECHN. ETUDES BAT B ASSIST.ARCHI.;7;6;6;0;0;0;0;6;0;0;3;3;0;0
14604.0;2022;18;ORLEANS-TOURS;MASCULIN;APPRENTISSAGE;BAC PROFESSIONNEL;BAC PRO SERV;BAC PRO 30001 GESTION-ADMINISTRATION;1;1;1;0;0;0;0;1;0;0;1;0;0;0
24913.0;2023;16;TOULOUSE;FEMININ;INDIVIDUEL;BAC PROFESSIONNEL;BAC PRO PROD;BAC PRO 22106 CUISINE;1;0;0;0;0;0;0;0;0;0;0;0;0;0
14606.0;2022;18;ORLEANS-TOURS;MASCULIN;APPRENTISSAGE;BAC PROFESSIONNEL;BAC PRO SERV;BAC PRO 31212 METIERS DE L'ACCUEIL;5;5;5;0;0;0;0;5;0;1;2;1;1;0
24915.0;2023;16;TOULOUSE;FEMININ;INDIVIDUEL;BAC PROFESSIONNEL;BAC PRO PROD;BAC PRO AG 21004 CGEA;5;4;3;1;0;0;0;3;0;0;0;0;3;1
14611.0;2022;18;ORLEANS-TOURS;MASCULIN;APPRENTISSAGE;BAC PROFESSIONNEL;BAC PRO SERV;BAC PRO 33004 ACC.SOINS-S.PERS. OPT.EN STRUCTUR;1;1;1;0;0;0;0;1;0;0;0;0;1;0
24920.0;2023;16;TOULOUSE;FEMININ;INDIVIDUEL;BAC PROFESSIONNEL;BAC PRO SERV;BAC PRO 31114 ORGANIS. TRANSPORT MARCHANDISES;1;0;0;0;0;0;0;0;0;0;0;0;0;0
14620.0;2022;18;ORLEANS-TOURS;MASCULIN;FORMATION CONTINUE;BAC PROFESSIONNEL;BAC PRO PROD;BAC PRO 22704 TECHN. MAINT. SYST.ENERG.CLIMATI;3;3;3;0;0;0;0;3;0;1;1;0;1;0
24924.0;2023;16;TOULOUSE;FEMININ;INDIVIDUEL;BAC PROFESSIONNEL;BAC PRO SERV;BAC PRO 33003 ACC.SOINS-S.PERS. OPT.A DOMICILE;1;1;0;0;1;1;0;1;0;0;0;0;1;0
14623.0;2022;18;ORLEANS-TOURS;MASCULIN;FORMATION CONTINUE;BAC PROFESSIONNEL;BAC PRO PROD;BAC PRO 25007 MAINTENANCE EQUIPEMENTS INDUST.;1;1;1;0;0;0;0;1;0;1;0;0;0;0
24926.0;2023;16;TOULOUSE;FEMININ;INDIVIDUEL;BAC PROFESSIONNEL;BAC PRO SERV;BAC PRO 33101 OPTIQUE LUNETTERIE;1;1;0;1;0;0;0;0;0;0;0;0;0;1
14628.0;2022;18;ORLEANS-TOURS;MASCULIN;FORMATION CONTINUE;BAC PROFESSIONNEL;BAC PRO PROD;BAC PRO 25509 TECHNIC. FROID CONDITIONNEMT AIR;4;4;4;0;0;0;0;4;0;1;1;1;1;0
24931.0;2023;16;TOULOUSE;FEMININ;INDIVIDUEL;BAC TECHNOLOGIQUE;BAC STMG;BAC STMG MERCATIQUE (MARKETING);11;11;2;7;2;2;0;4;0;0;0;0;4;7
14632.0;2022;18;ORLEANS-TOURS;MASCULIN;INDIVIDUEL;BAC GENERAL;BAC GENERAL;BAC GENE 10019 BAC GENERAL;67;48;23;14;11;6;5;29;0;3;1;7;18;19
24934.0;2023;16;TOULOUSE;FEMININ;SCOLAIRE;BAC PROFESSIONNEL;BAC PRO PROD;BACPRO 20002 ETUD.DEFINITION PRDTS INDUSTRIEL;2;2;2;0;0;0;0;2;0;0;1;0;1;0
14638.0;2022;18;ORLEANS-TOURS;MASCULIN;INDIVIDUEL;BAC PROFESSIONNEL;BAC PRO PROD;BAC PRO 25214 MAINT.VEHIC.OPTA VOIT.PARTICUL.;2;2;1;1;0;0;0;1;0;0;0;0;1;1
24935.0;2023;16;TOULOUSE;FEMININ;SCOLAIRE;BAC PROFESSIONNEL;BAC PRO PROD;BAC PRO 20102 PILOTE DE LIGNE DE PRODUCTION;1;1;1;0;0;0;0;1;0;0;0;0;1;0
14644.0;2022;18;ORLEANS-TOURS;MASCULIN;INDIVIDUEL;BAC PROFESSIONNEL;BAC PRO PROD;BAC PRO AG 22107 TEC CONS VTE ALIMENTATION P.ALIM;1;1;1;0;0;0;0;1;0;0;0;0;1;0
24941.0;2023;16;TOULOUSE;FEMININ;SCOLAIRE;BAC PROFESSIONNEL;BAC PRO PROD;BAC PRO 22403 ARTS.& MET.ART:MET.ENSEIGN SIGNA;8;8;8;0;0;0;0;8;0;1;0;4;3;0
14655.0;2022;18;ORLEANS-TOURS;MASCULIN;INDIVIDUEL;BAC TECHNOLOGIQUE;BAC STI2D;BAC STI2D SYSTÈME D'INFORMATION  ET NUMERIQUE;4;2;0;1;1;0;1;0;0;0;0;0;0;2
24946.0;2023;16;TOULOUSE;FEMININ;SCOLAIRE;BAC PROFESSIONNEL;BAC PRO PROD;BAC PRO 23203 TECHNICIEN BAT. : ORG.REAL.GROS O;1;1;0;0;1;1;0;1;0;0;0;0;1;0
14664.0;2022;18;ORLEANS-TOURS;MASCULIN;SCOLAIRE;BAC PROFESSIONNEL;BAC PRO PROD;BAC PRO 22003 BIO-INDUSTRIES DE TRANSFORMATION;14;14;12;2;0;0;0;12;0;0;4;3;5;2
24952.0;2023;16;TOULOUSE;FEMININ;SCOLAIRE;BAC PROFESSIONNEL;BAC PRO PROD;BAC PRO 24302 METIERS DU CUIR : MAROQUINERIE;7;7;5;0;2;1;1;6;0;0;1;3;2;1
14671.0;2022;18;ORLEANS-TOURS;MASCULIN;SCOLAIRE;BAC PROFESSIONNEL;BAC PRO PROD;BAC PRO 22704 TECHN. MAINT. SYST.ENERG.CLIMATI;57;57;23;29;5;3;2;26;0;2;2;6;16;31
24958.0;2023;16;TOULOUSE;FEMININ;SCOLAIRE;BAC PROFESSIONNEL;BAC PRO PROD;BAC PRO 25216 MAINT.VEHIC.OPTC MOTOCYCLES;2;2;2;0;0;0;0;2;0;0;2;0;0;0
14672.0;2022;18;ORLEANS-TOURS;MASCULIN;SCOLAIRE;BAC PROFESSIONNEL;BAC PRO PROD;BAC PRO 23003 ARTIS. & M.ART:MARCHANDISAGE VIS.;2;2;2;0;0;0;0;2;0;0;0;2;0;0
24959.0;2023;16;TOULOUSE;FEMININ;SCOLAIRE;BAC PROFESSIONNEL;BAC PRO PROD;BAC PRO 25219 MAINT.MATERIELS OPT.A AGRICOLES;1;1;1;0;0;0;0;1;0;0;0;0;1;0
14680.0;2022;18;ORLEANS-TOURS;MASCULIN;SCOLAIRE;BAC PROFESSIONNEL;BAC PRO PROD;BAC PRO 23303 MENUISERIE ALUMINIUM-VERRE;11;11;8;2;1;1;0;9;0;0;0;3;6;2
24973.0;2023;16;TOULOUSE;FEMININ;SCOLAIRE;BAC PROFESSIONNEL;BAC PRO PROD;BAC PRO AG 21210 COND GEST ENTR CANIN ET FELIN;35;32;24;8;0;0;0;24;0;0;2;7;15;8
14681.0;2022;18;ORLEANS-TOURS;MASCULIN;SCOLAIRE;BAC PROFESSIONNEL;BAC PRO PROD;BAC PRO 23304 AMENAGEMENT FINITION BATIMENT;20;20;11;6;3;2;1;13;0;0;2;3;8;7
24975.0;2023;16;TOULOUSE;FEMININ;SCOLAIRE;BAC PROFESSIONNEL;BAC PRO PROD;BAC PRO AG 21302 GEST MILIEUX NATURELS FAUNE;24;24;24;0;0;0;0;24;0;1;3;9;11;0
14683.0;2022;18;ORLEANS-TOURS;MASCULIN;SCOLAIRE;BAC PROFESSIONNEL;BAC PRO PROD;BAC PRO 23405 TECHNICIEN MENUISIER AGENCEUR;73;73;52;15;6;6;0;58;0;3;10;18;27;15
24976.0;2023;16;TOULOUSE;FEMININ;SCOLAIRE;BAC PROFESSIONNEL;BAC PRO PROD;BAC PRO AG 21405 AMENAGEMENTS PAYSAGERS;10;10;9;1;0;0;0;9;0;0;2;4;3;1
14686.0;2022;18;ORLEANS-TOURS;MASCULIN;SCOLAIRE;BAC PROFESSIONNEL;BAC PRO PROD;BAC PRO 24203 METIERS DE LA MODE - VÊTEMENT;10;10;9;1;0;0;0;9;0;1;2;4;2;1
24977.0;2023;16;TOULOUSE;FEMININ;SCOLAIRE;BAC PROFESSIONNEL;BAC PRO PROD;BAC PRO AG 21407 TEC CONS VTE UNIVERS JARDINERIE;8;8;7;1;0;0;0;7;0;0;2;2;3;1
14689.0;2022;18;ORLEANS-TOURS;MASCULIN;SCOLAIRE;BAC PROFESSIONNEL;BAC PRO PROD;BAC PRO 25006 MICROTECHNIQUES;10;10;6;4;0;0;0;6;0;1;1;1;3;4
24987.0;2023;16;TOULOUSE;FEMININ;SCOLAIRE;BAC PROFESSIONNEL;BAC PRO SERV;BAC PRO 32207 REAL.PR.IMPR.PLURI.OPTA.PR.GRAPH.;5;5;4;1;0;0;0;4;0;0;1;2;1;1
14696.0;2022;18;ORLEANS-TOURS;MASCULIN;SCOLAIRE;BAC PROFESSIONNEL;BAC PRO PROD;BAC PRO 25216 MAINT.VEHIC.OPTC MOTOCYCLES;18;18;14;3;1;0;1;14;0;0;5;5;4;4
24997.0;2023;16;TOULOUSE;FEMININ;SCOLAIRE;BAC PROFESSIONNEL;BAC PRO SERV;BAC PRO 33403 COMMERC. SERVICES EN RESTAURATION;65;65;49;7;9;6;3;55;0;5;10;17;23;10
14698.0;2022;18;ORLEANS-TOURS;MASCULIN;SCOLAIRE;BAC PROFESSIONNEL;BAC PRO PROD;BAC PRO 25220 MAINT.MATERIELS OPT.B TP MANUT.;3;3;3;0;0;0;0;3;0;0;1;1;1;0
24999.0;2023;16;TOULOUSE;FEMININ;SCOLAIRE;BAC PROFESSIONNEL;BAC PRO SERV;BAC PRO 33603 ESTHETIQUE COSMETIQUE PARFUMERIE;134;134;115;18;1;1;0;116;0;2;25;51;38;18
14705.0;2022;18;ORLEANS-TOURS;MASCULIN;SCOLAIRE;BAC PROFESSIONNEL;BAC PRO PROD;BAC PRO 25510 METIERS ELECT. ENVIRON. CONNECTES;420;418;313;87;18;12;6;325;0;14;57;114;140;93
25001.0;2023;16;TOULOUSE;FEMININ;SCOLAIRE;BAC PROFESSIONNEL;BAC PRO SERV;BAC PRO 34304 HYGIENE PROPRETE STERILISATION;6;6;5;0;1;0;1;5;0;0;2;2;1;1
14710.0;2022;18;ORLEANS-TOURS;MASCULIN;SCOLAIRE;BAC PROFESSIONNEL;BAC PRO PROD;BAC PRO AG 21004 CGEA;157;155;122;33;0;0;0;122;0;0;16;42;64;33
25009.0;2023;16;TOULOUSE;FEMININ;SCOLAIRE;BAC TECHNOLOGIQUE;BAC STD2A;BAC STD2A SCIENCES & TECHNO. DESIGN-ARTS APPLIQUES;136;136;132;2;2;2;0;134;2;17;32;68;15;2
14711.0;2022;18;ORLEANS-TOURS;MASCULIN;SCOLAIRE;BAC PROFESSIONNEL;BAC PRO PROD;BAC PRO AG 21113 CGEVV;9;9;8;1;0;0;0;8;0;0;3;2;3;1
25014.0;2023;16;TOULOUSE;FEMININ;SCOLAIRE;BAC TECHNOLOGIQUE;BAC STI2D;BAC STI2D SYSTÈME D'INFORMATION  ET NUMERIQUE;18;18;16;1;1;0;1;16;0;2;5;7;2;2
14716.0;2022;18;ORLEANS-TOURS;MASCULIN;SCOLAIRE;BAC PROFESSIONNEL;BAC PRO PROD;BAC PRO AG 21302 GEST MILIEUX NATURELS FAUNE;31;29;24;5;0;0;0;24;0;0;5;9;10;5
25019.0;2023;16;TOULOUSE;FEMININ;SCOLAIRE;BAC TECHNOLOGIQUE;BAC STMG;BAC STMG RESSOURCES HUMAINES ET COMMUNICATION;453;453;374;19;60;41;19;415;0;6;50;135;224;38
14723.0;2022;18;ORLEANS-TOURS;MASCULIN;SCOLAIRE;BAC PROFESSIONNEL;BAC PRO SERV;BAC PRO 30001 GESTION-ADMINISTRATION;190;188;129;50;9;8;1;137;0;2;15;50;70;51
25021.0;2023;16;TOULOUSE;MASCULIN;APPRENTISSAGE;BAC PROFESSIONNEL;BAC PRO PROD;BAC PRO 22003 BIO-INDUSTRIES DE TRANSFORMATION;3;3;2;1;0;0;0;2;0;0;1;1;0;1
14729.0;2022;18;ORLEANS-TOURS;MASCULIN;SCOLAIRE;BAC PROFESSIONNEL;BAC PRO SERV;BAC PRO 31214 MET.COM.VEN.OP.B PR.CL.VA.OF.COM.;210;208;170;33;5;3;2;173;0;5;30;80;58;35
25026.0;2023;16;TOULOUSE;MASCULIN;APPRENTISSAGE;BAC PROFESSIONNEL;BAC PRO PROD;BAC PRO 22703 TECHN.INSTALL.SYST.ENERG.CLIMATI;34;33;27;2;4;4;0;31;0;2;5;11;13;2
14733.0;2022;18;ORLEANS-TOURS;MASCULIN;SCOLAIRE;BAC PROFESSIONNEL;BAC PRO SERV;BAC PRO 32304 PHOTOGRAPHIE;9;9;7;2;0;0;0;7;0;1;3;0;3;2
25035.0;2023;16;TOULOUSE;MASCULIN;APPRENTISSAGE;BAC PROFESSIONNEL;BAC PRO PROD;BAC PRO 23206 INTERV. SUR PATRIMOINE BATI OPT.B;1;1;1;0;0;0;0;1;0;0;0;1;0;0
14744.0;2022;18;ORLEANS-TOURS;MASCULIN;SCOLAIRE;BAC TECHNOLOGIQUE;BAC S2TMD;BAC S2TMD MUSIQUE;8;8;8;0;0;0;0;8;0;0;4;4;0;0
25038.0;2023;16;TOULOUSE;MASCULIN;APPRENTISSAGE;BAC PROFESSIONNEL;BAC PRO PROD;BAC PRO 23404 TECHNICIEN CONSTRUCTEUR BOIS;2;2;1;1;0;0;0;1;0;0;1;0;0;1
14752.0;2022;18;ORLEANS-TOURS;MASCULIN;SCOLAIRE;BAC TECHNOLOGIQUE;BAC STI2D;BAC STI2D SYSTÈME D'INFORMATION  ET NUMERIQUE;343;343;311;5;27;15;12;326;0;9;55;131;131;17
25048.0;2023;16;TOULOUSE;MASCULIN;APPRENTISSAGE;BAC PROFESSIONNEL;BAC PRO PROD;BAC PRO 25219 MAINT.MATERIELS OPT.A AGRICOLES;34;34;26;8;0;0;0;26;0;3;7;8;8;8
14755.0;2022;18;ORLEANS-TOURS;MASCULIN;SCOLAIRE;BAC TECHNOLOGIQUE;BAC STMG;BAC STMG GESTION ET FINANCE;306;306;246;16;44;30;14;276;0;5;32;106;133;30
25049.0;2023;16;TOULOUSE;MASCULIN;APPRENTISSAGE;BAC PROFESSIONNEL;BAC PRO PROD;BAC PRO 25220 MAINT.MATERIELS OPT.B TP MANUT.;21;21;15;6;0;0;0;15;0;1;2;5;7;6
14760.0;2022;01;PARIS;FEMININ;APPRENTISSAGE;BAC PROFESSIONNEL;BAC PRO PROD;BAC PRO 22105 BOULANGER-PÂTISSIER;26;25;24;1;0;0;0;24;0;6;7;6;5;1
25056.0;2023;16;TOULOUSE;MASCULIN;APPRENTISSAGE;BAC PROFESSIONNEL;BAC PRO PROD;BAC PRO 25411 TECH.CHAUDRONNERIE INDUSTRIELLE;56;55;47;6;2;0;2;47;0;10;19;11;7;8
14763.0;2022;01;PARIS;FEMININ;APPRENTISSAGE;BAC PROFESSIONNEL;BAC PRO PROD;BAC PRO 23005 TECHN. ETUDES BAT B ASSIST.ARCHI.;3;1;1;0;0;0;0;1;0;0;0;1;0;0
25068.0;2023;16;TOULOUSE;MASCULIN;APPRENTISSAGE;BAC PROFESSIONNEL;BAC PRO SERV;BAC PRO 32207 REAL.PR.IMPR.PLURI.OPTA.PR.GRAPH.;5;5;4;1;0;0;0;4;0;0;1;3;0;1
14764.0;2022;01;PARIS;FEMININ;APPRENTISSAGE;BAC PROFESSIONNEL;BAC PRO PROD;BAC PRO 24302 METIERS DU CUIR : MAROQUINERIE;8;8;8;0;0;0;0;8;0;0;5;3;0;0
25069.0;2023;16;TOULOUSE;MASCULIN;APPRENTISSAGE;BAC PROFESSIONNEL;BAC PRO SERV;BAC PRO 32208 REAL.PR.IMPR.PLURI.OPTB.PR.IMPR.;1;1;1;0;0;0;0;1;0;0;1;0;0;0
14768.0;2022;01;PARIS;FEMININ;APPRENTISSAGE;BAC PROFESSIONNEL;BAC PRO SERV;BAC PRO 31212 METIERS DE L'ACCUEIL;11;11;8;3;0;0;0;8;0;2;3;3;0;3
25082.0;2023;16;TOULOUSE;MASCULIN;ENSEIGNEMENT A DISTANCE;BAC TECHNOLOGIQUE;BAC STMG;BAC STMG GESTION ET FINANCE;1;1;1;0;0;0;0;1;0;0;0;1;0;0
14774.0;2022;01;PARIS;FEMININ;APPRENTISSAGE;BAC PROFESSIONNEL;BAC PRO SERV;BAC PRO 33101 OPTIQUE LUNETTERIE;48;45;35;10;0;0;0;35;0;3;9;12;11;10
25090.0;2023;16;TOULOUSE;MASCULIN;FORMATION CONTINUE;BAC PROFESSIONNEL;BAC PRO PROD;BAC PRO 25214 MAINT.VEHIC.OPTA VOIT.PARTICUL.;1;1;1;0;0;0;0;1;0;1;0;0;0;0
14781.0;2022;01;PARIS;FEMININ;ENSEIGNEMENT A DISTANCE;BAC PROFESSIONNEL;BAC PRO SERV;BAC PRO 33003 ACC.SOINS-S.PERS. OPT.A DOMICILE;1;0;0;0;0;0;0;0;0;0;0;0;0;0
25096.0;2023;16;TOULOUSE;MASCULIN;INDIVIDUEL;BAC GENERAL;BAC GENERAL;BAC GENE 10019 BAC GENERAL;68;65;18;39;8;7;1;25;0;2;1;4;18;40
14796.0;2022;01;PARIS;FEMININ;INDIVIDUEL;BAC PROFESSIONNEL;BAC PRO PROD;BAC PRO 24203 METIERS DE LA MODE - VÊTEMENT;1;0;0;0;0;0;0;0;0;0;0;0;0;0
25100.0;2023;16;TOULOUSE;MASCULIN;INDIVIDUEL;BAC PROFESSIONNEL;BAC PRO PROD;BAC PRO 24203 METIERS DE LA MODE - VÊTEMENT;1;0;0;0;0;0;0;0;0;0;0;0;0;0
14797.0;2022;01;PARIS;FEMININ;INDIVIDUEL;BAC PROFESSIONNEL;BAC PRO PROD;BAC PRO 25214 MAINT.VEHIC.OPTA VOIT.PARTICUL.;2;1;1;0;0;0;0;1;0;0;1;0;0;0
25101.0;2023;16;TOULOUSE;MASCULIN;INDIVIDUEL;BAC PROFESSIONNEL;BAC PRO PROD;BAC PRO 25007 MAINTENANCE EQUIPEMENTS INDUST.;5;2;0;2;0;0;0;0;0;0;0;0;0;2
14802.0;2022;01;PARIS;FEMININ;INDIVIDUEL;BAC PROFESSIONNEL;BAC PRO PROD;BAC PRO AG 21405 AMENAGEMENTS PAYSAGERS;1;1;1;0;0;0;0;1;0;0;0;0;1;0
25103.0;2023;16;TOULOUSE;MASCULIN;INDIVIDUEL;BAC PROFESSIONNEL;BAC PRO PROD;BAC PRO 25215 MAINT.VEHIC.OPTB VEHIC.TRANS.ROUT;1;1;1;0;0;0;0;1;0;0;0;1;0;0
14804.0;2022;01;PARIS;FEMININ;INDIVIDUEL;BAC PROFESSIONNEL;BAC PRO SERV;BAC PRO 31212 METIERS DE L'ACCUEIL;1;0;0;0;0;0;0;0;0;0;0;0;0;0
25107.0;2023;16;TOULOUSE;MASCULIN;INDIVIDUEL;BAC PROFESSIONNEL;BAC PRO PROD;BAC PRO 25303 AERONAUTIQUE OPTION SYSTEMES;1;1;1;0;0;0;0;1;0;0;0;0;1;0
14805.0;2022;01;PARIS;FEMININ;INDIVIDUEL;BAC PROFESSIONNEL;BAC PRO SERV;BAC PRO 31213 MET.COM.VEN.OP.A ANI.GES.ESP.COM.;2;2;0;2;0;0;0;0;0;0;0;0;0;2
25115.0;2023;16;TOULOUSE;MASCULIN;INDIVIDUEL;BAC PROFESSIONNEL;BAC PRO PROD;BAC PRO AG 22108 TEC CONS VTE ALIMENTATION (PAB);1;1;1;0;0;0;0;1;0;0;0;0;1;0
14808.0;2022;01;PARIS;FEMININ;INDIVIDUEL;BAC PROFESSIONNEL;BAC PRO SERV;BAC PRO 33004 ACC.SOINS-S.PERS. OPT.EN STRUCTUR;3;1;0;1;0;0;0;0;0;0;0;0;0;1
25125.0;2023;16;TOULOUSE;MASCULIN;INDIVIDUEL;BAC TECHNOLOGIQUE;BAC STMG;BAC STMG GESTION ET FINANCE;3;3;0;3;0;0;0;0;0;0;0;0;0;3
14811.0;2022;01;PARIS;FEMININ;INDIVIDUEL;BAC TECHNOLOGIQUE;BAC S2TMD;BAC S2TMD MUSIQUE;1;1;1;0;0;0;0;1;0;0;1;0;0;0
25135.0;2023;16;TOULOUSE;MASCULIN;SCOLAIRE;BAC PROFESSIONNEL;BAC PRO PROD;BAC PRO 22106 CUISINE;153;152;133;14;5;5;0;138;0;10;38;45;45;14
14814.0;2022;01;PARIS;FEMININ;INDIVIDUEL;BAC TECHNOLOGIQUE;BAC STD2A;BAC STD2A SCIENCES & TECHNO. DESIGN-ARTS APPLIQUES;18;17;11;2;4;1;3;12;0;0;1;2;9;5
25142.0;2023;16;TOULOUSE;MASCULIN;SCOLAIRE;BAC PROFESSIONNEL;BAC PRO PROD;BAC PRO 23005 TECHN. ETUDES BAT B ASSIST.ARCHI.;39;39;27;11;1;1;0;28;0;1;5;12;10;11
14820.0;2022;01;PARIS;FEMININ;SCOLAIRE;BAC PROFESSIONNEL;BAC PRO PROD;BAC PRO 20102 PILOTE DE LIGNE DE PRODUCTION;3;3;3;0;0;0;0;3;0;0;1;2;0;0
25145.0;2023;16;TOULOUSE;MASCULIN;SCOLAIRE;BAC PROFESSIONNEL;BAC PRO PROD;BAC PRO 23203 TECHNICIEN BAT. : ORG.REAL.GROS O;31;31;24;5;2;2;0;26;0;1;7;8;10;5
14822.0;2022;01;PARIS;FEMININ;SCOLAIRE;BAC PROFESSIONNEL;BAC PRO PROD;BAC PRO 22004 PROC. CHIMIE EAU PAPIERS-CARTONS;9;9;7;1;1;1;0;8;0;0;1;1;6;1
25160.0;2023;16;TOULOUSE;MASCULIN;SCOLAIRE;BAC PROFESSIONNEL;BAC PRO PROD;BAC PRO 25107 TECHNICIEN OUTILLEUR;15;15;11;4;0;0;0;11;0;0;1;2;8;4
14827.0;2022;01;PARIS;FEMININ;SCOLAIRE;BAC PROFESSIONNEL;BAC PRO PROD;BAC PRO 23004 TECHN. ETUDES BAT.A ETUDES & ECO.;1;1;1;0;0;0;0;1;0;0;0;1;0;0
25161.0;2023;16;TOULOUSE;MASCULIN;SCOLAIRE;BAC PROFESSIONNEL;BAC PRO PROD;BAC PRO 25108 TECHNICIEN MODELEUR;11;11;9;2;0;0;0;9;0;0;0;7;2;2
14830.0;2022;01;PARIS;FEMININ;SCOLAIRE;BAC PROFESSIONNEL;BAC PRO PROD;BAC PRO 23304 AMENAGEMENT FINITION BATIMENT;1;1;1;0;0;0;0;1;0;1;0;0;0;0
25163.0;2023;16;TOULOUSE;MASCULIN;SCOLAIRE;BAC PROFESSIONNEL;BAC PRO PROD;BAC PRO 25215 MAINT.VEHIC.OPTB VEHIC.TRANS.ROUT;20;20;14;3;3;3;0;17;0;2;0;8;7;3
14832.0;2022;01;PARIS;FEMININ;SCOLAIRE;BAC PROFESSIONNEL;BAC PRO PROD;BAC PRO 24202 ARTIS.& MET.ART : TAPIS.D'AMEUBL;6;5;5;0;0;0;0;5;0;2;1;1;1;0
25165.0;2023;16;TOULOUSE;MASCULIN;SCOLAIRE;BAC PROFESSIONNEL;BAC PRO PROD;BAC PRO 25219 MAINT.MATERIELS OPT.A AGRICOLES;53;53;43;8;2;1;1;44;0;9;13;14;8;9
14833.0;2022;01;PARIS;FEMININ;SCOLAIRE;BAC PROFESSIONNEL;BAC PRO PROD;BAC PRO 24203 METIERS DE LA MODE - VÊTEMENT;132;132;117;14;1;1;0;118;0;13;35;42;28;14
25168.0;2023;16;TOULOUSE;MASCULIN;SCOLAIRE;BAC PROFESSIONNEL;BAC PRO PROD;BAC PRO 25302 AERONAUTIQUE OPTION AVIONIQUE;30;30;29;0;1;1;0;30;0;3;10;11;6;0
14835.0;2022;01;PARIS;FEMININ;SCOLAIRE;BAC PROFESSIONNEL;BAC PRO PROD;BAC PRO 24302 METIERS DU CUIR : MAROQUINERIE;10;10;10;0;0;0;0;10;0;2;5;3;0;0
25170.0;2023;16;TOULOUSE;MASCULIN;SCOLAIRE;BAC PROFESSIONNEL;BAC PRO PROD;BAC PRO 25304 AERONAUTIQUE OPTION STRUCTURE;70;70;61;6;3;3;0;64;0;4;31;16;13;6
14841.0;2022;01;PARIS;FEMININ;SCOLAIRE;BAC PROFESSIONNEL;BAC PRO PROD;BAC PRO AG 22105 LABORATOIRE CONTROLE QUALITE;8;8;7;1;0;0;0;7;0;1;0;1;5;1
25171.0;2023;16;TOULOUSE;MASCULIN;SCOLAIRE;BAC PROFESSIONNEL;BAC PRO PROD;BAC PRO 25406 OUVRAGES DU BATIMENT METALLERIE;8;8;8;0;0;0;0;8;0;0;2;4;2;0
14842.0;2022;01;PARIS;FEMININ;SCOLAIRE;BAC PROFESSIONNEL;BAC PRO SERV;BAC PRO 30001 GESTION-ADMINISTRATION;302;302;245;50;7;4;3;249;0;15;56;98;80;53
25173.0;2023;16;TOULOUSE;MASCULIN;SCOLAIRE;BAC PROFESSIONNEL;BAC PRO PROD;BAC PRO 25411 TECH.CHAUDRONNERIE INDUSTRIELLE;105;105;82;12;11;8;3;90;0;7;16;29;38;15
14843.0;2022;01;PARIS;FEMININ;SCOLAIRE;BAC PROFESSIONNEL;BAC PRO SERV;BAC PRO 31106 LOGISTIQUE;1;1;1;0;0;0;0;1;0;0;0;0;1;0
25185.0;2023;16;TOULOUSE;MASCULIN;SCOLAIRE;BAC PROFESSIONNEL;BAC PRO PROD;BAC PRO AG 21211 COND GEST ENTR HIPPIQUE;5;5;4;1;0;0;0;4;0;0;0;3;1;1
14846.0;2022;01;PARIS;FEMININ;SCOLAIRE;BAC PROFESSIONNEL;BAC PRO SERV;BAC PRO 31213 MET.COM.VEN.OP.A ANI.GES.ESP.COM.;224;221;182;29;10;6;4;188;0;12;45;74;57;33
25194.0;2023;16;TOULOUSE;MASCULIN;SCOLAIRE;BAC PROFESSIONNEL;BAC PRO SERV;BAC PRO 31107 CONDUCT. TRANSP.ROUT.MARCHANDISES;38;38;33;4;1;1;0;34;0;1;14;9;10;4
14861.0;2022;01;PARIS;FEMININ;SCOLAIRE;BAC PROFESSIONNEL;BAC PRO SERV;BAC PRO 33603 ESTHETIQUE COSMETIQUE PARFUMERIE;87;87;79;7;1;1;0;80;0;7;12;32;29;7
25199.0;2023;16;TOULOUSE;MASCULIN;SCOLAIRE;BAC PROFESSIONNEL;BAC PRO SERV;BAC PRO 32207 REAL.PR.IMPR.PLURI.OPTA.PR.GRAPH.;7;7;7;0;0;0;0;7;0;1;2;2;2;0
14865.0;2022;01;PARIS;FEMININ;SCOLAIRE;BAC TECHNOLOGIQUE;BAC S2TMD;BAC S2TMD MUSIQUE;4;4;4;0;0;0;0;4;0;2;2;0;0;0
25204.0;2023;16;TOULOUSE;MASCULIN;SCOLAIRE;BAC PROFESSIONNEL;BAC PRO SERV;BAC PRO 33004 ACC.SOINS-S.PERS. OPT.EN STRUCTUR;54;54;46;3;5;4;1;50;0;1;8;20;21;4
14866.0;2022;01;PARIS;FEMININ;SCOLAIRE;BAC TECHNOLOGIQUE;BAC ST2S;BAC ST2S SCIENCES & TECHNO. SANTE & SOCIAL;282;282;237;9;36;21;15;258;0;10;52;91;105;24
25208.0;2023;16;TOULOUSE;MASCULIN;SCOLAIRE;BAC PROFESSIONNEL;BAC PRO SERV;BAC PRO 33104 TECHNICIEN EN PROTHESE DENTAIRE;9;8;8;0;0;0;0;8;0;1;1;4;2;0
14867.0;2022;01;PARIS;FEMININ;SCOLAIRE;BAC TECHNOLOGIQUE;BAC STD2A;BAC STD2A SCIENCES & TECHNO. DESIGN-ARTS APPLIQUES;152;152;149;0;3;1;2;150;1;9;57;59;24;2
25210.0;2023;16;TOULOUSE;MASCULIN;SCOLAIRE;BAC PROFESSIONNEL;BAC PRO SERV;BAC PRO 33602 PERRUQUIER POSTICHEUR;1;1;1;0;0;0;0;1;0;0;1;0;0;0
14868.0;2022;01;PARIS;FEMININ;SCOLAIRE;BAC TECHNOLOGIQUE;BAC STHR;BAC STHR SC.&TEC. HOTELLERIE-RESTAURATION;33;33;33;0;0;0;0;33;0;1;8;15;9;0
25218.0;2023;16;TOULOUSE;MASCULIN;SCOLAIRE;BAC TECHNOLOGIQUE;BAC ST2S;BAC ST2S SCIENCES & TECHNO. SANTE & SOCIAL;158;158;128;4;26;17;9;145;0;2;15;44;84;13
14870.0;2022;01;PARIS;FEMININ;SCOLAIRE;BAC TECHNOLOGIQUE;BAC STI2D;BAC STI2D ENERGIES  ET ENVIRONNEMENT;3;3;3;0;0;0;0;3;0;0;0;1;2;0
25220.0;2023;16;TOULOUSE;MASCULIN;SCOLAIRE;BAC TECHNOLOGIQUE;BAC STD2A;BAC STD2A SCIENCES & TECHNO. DESIGN-ARTS APPLIQUES;34;34;34;0;0;0;0;34;0;7;14;8;5;0
14878.0;2022;01;PARIS;FEMININ;SCOLAIRE;BAC TECHNOLOGIQUE;BAC STMG;BAC STMG SYSTEMES D'INFORMATION DE GESTION;42;42;30;1;11;8;3;38;0;1;8;11;18;4
25225.0;2023;16;TOULOUSE;MASCULIN;SCOLAIRE;BAC TECHNOLOGIQUE;BAC STI2D;BAC STI2D SYSTÈME D'INFORMATION  ET NUMERIQUE;413;413;359;8;46;33;13;392;2;19;69;137;165;21
14879.0;2022;01;PARIS;MASCULIN;APPRENTISSAGE;BAC PROFESSIONNEL;BAC PRO PROD;BAC PRO 22004 PROC. CHIMIE EAU PAPIERS-CARTONS;9;9;8;1;0;0;0;8;0;1;5;2;0;1
25229.0;2023;16;TOULOUSE;MASCULIN;SCOLAIRE;BAC TECHNOLOGIQUE;BAC STMG;BAC STMG MERCATIQUE (MARKETING);778;778;625;40;113;77;36;702;1;6;55;219;421;76
14880.0;2022;01;PARIS;MASCULIN;APPRENTISSAGE;BAC PROFESSIONNEL;BAC PRO PROD;BAC PRO 22105 BOULANGER-PÂTISSIER;42;41;39;2;0;0;0;39;0;4;9;13;13;2
25233.0;2023;25;VERSAILLES;FEMININ;APPRENTISSAGE;BAC PROFESSIONNEL;BAC PRO PROD;BAC PRO 22106 CUISINE;19;19;15;4;0;0;0;15;0;2;2;3;8;4
14885.0;2022;01;PARIS;MASCULIN;APPRENTISSAGE;BAC PROFESSIONNEL;BAC PRO PROD;BAC PRO 23005 TECHN. ETUDES BAT B ASSIST.ARCHI.;3;2;0;2;0;0;0;0;0;0;0;0;0;2
25254.0;2023;25;VERSAILLES;FEMININ;APPRENTISSAGE;BAC PROFESSIONNEL;BAC PRO SERV;BAC PRO 33403 COMMERC. SERVICES EN RESTAURATION;26;26;21;5;0;0;0;21;0;1;7;8;5;5
14890.0;2022;01;PARIS;MASCULIN;APPRENTISSAGE;BAC PROFESSIONNEL;BAC PRO PROD;BAC PRO 25510 METIERS ELECT. ENVIRON. CONNECTES;143;141;119;11;11;8;3;127;0;15;33;32;47;14
25256.0;2023;25;VERSAILLES;FEMININ;APPRENTISSAGE;BAC PROFESSIONNEL;BAC PRO SERV;BAC PRO 34403 METIERS DE LA SECURITE;11;11;9;1;1;1;0;10;0;0;1;5;4;1
14897.0;2022;01;PARIS;MASCULIN;APPRENTISSAGE;BAC PROFESSIONNEL;BAC PRO SERV;BAC PRO 32208 REAL.PR.IMPR.PLURI.OPTB.PR.IMPR.;4;4;4;0;0;0;0;4;0;0;2;1;1;0
25274.0;2023;25;VERSAILLES;FEMININ;FORMATION CONTINUE;BAC PROFESSIONNEL;BAC PRO SERV;BAC PRO 31213 MET.COM.VEN.OP.A ANI.GES.ESP.COM.;5;4;4;0;0;0;0;4;0;1;0;3;0;0
14900.0;2022;01;PARIS;MASCULIN;APPRENTISSAGE;BAC PROFESSIONNEL;BAC PRO SERV;BAC PRO 34403 METIERS DE LA SECURITE;7;7;2;4;1;1;0;3;0;0;0;1;2;4
25275.0;2023;25;VERSAILLES;FEMININ;FORMATION CONTINUE;BAC PROFESSIONNEL;BAC PRO SERV;BAC PRO 32303 ART.& MET.ART:COM.VIS.VIS.PLURI-M;3;3;3;0;0;0;0;3;0;0;2;1;0;0
14905.0;2022;01;PARIS;MASCULIN;ENSEIGNEMENT A DISTANCE;BAC TECHNOLOGIQUE;BAC STMG;BAC STMG MERCATIQUE (MARKETING);6;5;4;0;1;1;0;5;0;0;0;0;5;0
25276.0;2023;25;VERSAILLES;FEMININ;FORMATION CONTINUE;BAC PROFESSIONNEL;BAC PRO SERV;BAC PRO 33104 TECHNICIEN EN PROTHESE DENTAIRE;2;2;2;0;0;0;0;2;0;0;2;0;0;0
14913.0;2022;01;PARIS;MASCULIN;FORMATION CONTINUE;BAC PROFESSIONNEL;BAC PRO PROD;BAC PRO 25510 METIERS ELECT. ENVIRON. CONNECTES;21;20;16;4;0;0;0;16;0;9;4;3;0;4
25281.0;2023;25;VERSAILLES;FEMININ;INDIVIDUEL;BAC PROFESSIONNEL;BAC PRO PROD;BAC PRO 24203 METIERS DE LA MODE - VÊTEMENT;2;2;1;1;0;0;0;1;0;0;0;0;1;1
14916.0;2022;01;PARIS;MASCULIN;FORMATION CONTINUE;BAC PROFESSIONNEL;BAC PRO SERV;BAC PRO 30001 GESTION-ADMINISTRATION;2;2;1;1;0;0;0;1;0;0;0;1;0;1
25286.0;2023;25;VERSAILLES;FEMININ;INDIVIDUEL;BAC PROFESSIONNEL;BAC PRO SERV;BAC PRO 30004 ASSISTANC.GEST.ORGANIS.ACTIVITES;43;25;10;14;1;0;1;10;0;0;0;1;9;15
14924.0;2022;01;PARIS;MASCULIN;INDIVIDUEL;BAC PROFESSIONNEL;BAC PRO PROD;BAC PRO 25510 METIERS ELECT. ENVIRON. CONNECTES;26;24;17;4;3;2;1;19;0;1;1;6;11;5
25310.0;2023;25;VERSAILLES;FEMININ;SCOLAIRE;BAC PROFESSIONNEL;BAC PRO PROD;BACPRO 23103 TECHNICIEN GEOMETRE-TOPOGRAPHE;6;6;6;0;0;0;0;6;0;1;1;3;1;0
14925.0;2022;01;PARIS;MASCULIN;INDIVIDUEL;BAC PROFESSIONNEL;BAC PRO PROD;BAC PRO AG 21004 CGEA;8;7;7;0;0;0;0;7;0;0;0;0;7;0
25311.0;2023;25;VERSAILLES;FEMININ;SCOLAIRE;BAC PROFESSIONNEL;BAC PRO PROD;BAC PRO 23303 MENUISERIE ALUMINIUM-VERRE;1;1;1;0;0;0;0;1;0;0;0;0;1;0
14928.0;2022;01;PARIS;MASCULIN;INDIVIDUEL;BAC PROFESSIONNEL;BAC PRO PROD;BAC PRO AG 21405 AMENAGEMENTS PAYSAGERS;1;0;0;0;0;0;0;0;0;0;0;0;0;0
25327.0;2023;25;VERSAILLES;FEMININ;SCOLAIRE;BAC PROFESSIONNEL;BAC PRO PROD;BAC PRO 25408 REPARATION DES CARROSSERIES;1;1;1;0;0;0;0;1;0;0;0;1;0;0
14929.0;2022;01;PARIS;MASCULIN;INDIVIDUEL;BAC PROFESSIONNEL;BAC PRO SERV;BAC PRO 30001 GESTION-ADMINISTRATION;6;5;3;2;0;0;0;3;0;0;0;0;3;2
25334.0;2023;25;VERSAILLES;FEMININ;SCOLAIRE;BAC PROFESSIONNEL;BAC PRO PROD;BAC PRO AG 21203 TECHN CONSEIL DE VENTE ANIMAL;26;25;18;7;0;0;0;18;0;0;3;6;9;7
14932.0;2022;01;PARIS;MASCULIN;INDIVIDUEL;BAC PROFESSIONNEL;BAC PRO SERV;BAC PRO 31214 MET.COM.VEN.OP.B PR.CL.VA.OF.COM.;1;0;0;0;0;0;0;0;0;0;0;0;0;0
25347.0;2023;25;VERSAILLES;FEMININ;SCOLAIRE;BAC PROFESSIONNEL;BAC PRO SERV;BAC PRO 32208 REAL.PR.IMPR.PLURI.OPTB.PR.IMPR.;4;4;4;0;0;0;0;4;0;2;0;2;0;0
14934.0;2022;01;PARIS;MASCULIN;INDIVIDUEL;BAC PROFESSIONNEL;BAC PRO SERV;BAC PRO 33101 OPTIQUE LUNETTERIE;1;1;0;1;0;0;0;0;0;0;0;0;0;1
25348.0;2023;25;VERSAILLES;FEMININ;SCOLAIRE;BAC PROFESSIONNEL;BAC PRO SERV;BAC PRO 32303 ART.& MET.ART:COM.VIS.VIS.PLURI-M;60;60;57;3;0;0;0;57;0;4;17;21;15;3
14937.0;2022;01;PARIS;MASCULIN;INDIVIDUEL;BAC TECHNOLOGIQUE;BAC S2TMD;BAC S2TMD DANSE;1;1;1;0;0;0;0;1;0;0;1;0;0;0
25354.0;2023;25;VERSAILLES;FEMININ;SCOLAIRE;BAC PROFESSIONNEL;BAC PRO SERV;BAC PRO 33101 OPTIQUE LUNETTERIE;17;17;16;1;0;0;0;16;0;1;3;7;5;1
14940.0;2022;01;PARIS;MASCULIN;INDIVIDUEL;BAC TECHNOLOGIQUE;BAC STI2D;BAC STI2D SYSTÈME D'INFORMATION  ET NUMERIQUE;3;3;0;3;0;0;0;0;0;0;0;0;0;3
25356.0;2023;25;VERSAILLES;FEMININ;SCOLAIRE;BAC PROFESSIONNEL;BAC PRO SERV;BAC PRO 33603 ESTHETIQUE COSMETIQUE PARFUMERIE;133;133;97;32;4;4;0;101;0;7;16;30;48;32
14941.0;2022;01;PARIS;MASCULIN;INDIVIDUEL;BAC TECHNOLOGIQUE;BAC STL;BAC STL SCIENCES PHYSIQUES CHIMIQUES  EN LABORAT.;2;1;0;1;0;0;0;0;0;0;0;0;0;1
25359.0;2023;25;VERSAILLES;FEMININ;SCOLAIRE;BAC PROFESSIONNEL;BAC PRO SERV;BAC PRO 34403 METIERS DE LA SECURITE;64;64;57;4;3;2;1;59;0;2;16;22;19;5
14951.0;2022;01;PARIS;MASCULIN;SCOLAIRE;BAC PROFESSIONNEL;BAC PRO PROD;BAC PRO 22106 CUISINE;69;69;61;7;1;1;0;62;0;1;16;26;19;7
25363.0;2023;25;VERSAILLES;FEMININ;SCOLAIRE;BAC TECHNOLOGIQUE;BAC ST2S;BAC ST2S SCIENCES & TECHNO. SANTE & SOCIAL;1493;1493;1164;80;249;129;120;1293;3;43;195;414;638;200
14959.0;2022;01;PARIS;MASCULIN;SCOLAIRE;BAC PROFESSIONNEL;BAC PRO PROD;BACPRO 23103 TECHNICIEN GEOMETRE-TOPOGRAPHE;10;10;7;2;1;1;0;8;0;0;0;3;5;2
25367.0;2023;25;VERSAILLES;FEMININ;SCOLAIRE;BAC TECHNOLOGIQUE;BAC STI2D;BAC STI2D ARCHITECTURE ET CONSTRUCTION;51;51;48;1;2;1;1;49;1;3;6;12;27;2
14961.0;2022;01;PARIS;MASCULIN;SCOLAIRE;BAC PROFESSIONNEL;BAC PRO PROD;BAC PRO 23205 INTERV. SUR PATRIMOINE BATI OPT.A;5;4;2;2;0;0;0;2;0;0;0;0;2;2
25369.0;2023;25;VERSAILLES;FEMININ;SCOLAIRE;BAC TECHNOLOGIQUE;BAC STI2D;BAC STI2D INNOVATION TECHNO.  ET ECO CONCEPTION;64;64;48;6;10;10;0;58;0;2;8;16;32;6
14978.0;2022;01;PARIS;MASCULIN;SCOLAIRE;BAC PROFESSIONNEL;BAC PRO PROD;BAC PRO 25411 TECH.CHAUDRONNERIE INDUSTRIELLE;11;11;7;3;1;1;0;8;0;3;3;0;2;3
25372.0;2023;25;VERSAILLES;FEMININ;SCOLAIRE;BAC TECHNOLOGIQUE;BAC STL;BAC STL SCIENCES PHYSIQUES CHIMIQUES  EN LABORAT.;54;54;46;2;6;3;3;49;0;5;11;13;20;5
14980.0;2022;01;PARIS;MASCULIN;SCOLAIRE;BAC PROFESSIONNEL;BAC PRO PROD;BAC PRO 25510 METIERS ELECT. ENVIRON. CONNECTES;225;223;190;9;24;13;11;203;0;26;35;59;83;20
25378.0;2023;25;VERSAILLES;MASCULIN;APPRENTISSAGE;BAC PROFESSIONNEL;BAC PRO PROD;BAC PRO 22106 CUISINE;111;111;78;27;6;4;2;82;0;4;17;28;33;29
14987.0;2022;01;PARIS;MASCULIN;SCOLAIRE;BAC PROFESSIONNEL;BAC PRO SERV;BAC PRO 31106 LOGISTIQUE;14;14;6;8;0;0;0;6;0;0;3;1;2;8
25385.0;2023;25;VERSAILLES;MASCULIN;APPRENTISSAGE;BAC PROFESSIONNEL;BAC PRO PROD;BAC PRO 23304 AMENAGEMENT FINITION BATIMENT;15;15;9;4;2;2;0;11;0;2;0;3;6;4
14990.0;2022;01;PARIS;MASCULIN;SCOLAIRE;BAC PROFESSIONNEL;BAC PRO SERV;BAC PRO 31213 MET.COM.VEN.OP.A ANI.GES.ESP.COM.;332;332;221;88;23;16;7;237;0;3;33;94;107;95
25390.0;2023;25;VERSAILLES;MASCULIN;APPRENTISSAGE;BAC PROFESSIONNEL;BAC PRO PROD;BAC PRO 25215 MAINT.VEHIC.OPTB VEHIC.TRANS.ROUT;56;56;42;11;3;2;1;44;0;5;9;19;11;12
14992.0;2022;01;PARIS;MASCULIN;SCOLAIRE;BAC PROFESSIONNEL;BAC PRO SERV;BAC PRO 32206 FACONNAGE PRODTS IMPRIMES ROUTAGE;5;5;5;0;0;0;0;5;0;0;2;1;2;0
25394.0;2023;25;VERSAILLES;MASCULIN;APPRENTISSAGE;BAC PROFESSIONNEL;BAC PRO PROD;BAC PRO 25302 AERONAUTIQUE OPTION AVIONIQUE;7;7;7;0;0;0;0;7;0;4;2;1;0;0
14993.0;2022;01;PARIS;MASCULIN;SCOLAIRE;BAC PROFESSIONNEL;BAC PRO SERV;BAC PRO 32207 REAL.PR.IMPR.PLURI.OPTA.PR.GRAPH.;16;16;14;2;0;0;0;14;0;1;1;8;4;2
25406.0;2023;25;VERSAILLES;MASCULIN;APPRENTISSAGE;BAC PROFESSIONNEL;BAC PRO PROD;BAC PRO AG 21405 AMENAGEMENTS PAYSAGERS;32;30;22;8;0;0;0;22;0;0;2;4;16;8
15022.0;2022;13;POITIERS;FEMININ;APPRENTISSAGE;BAC PROFESSIONNEL;BAC PRO PROD;BAC PRO 20102 PILOTE DE LIGNE DE PRODUCTION;1;1;1;0;0;0;0;1;0;1;0;0;0;0
25409.0;2023;25;VERSAILLES;MASCULIN;APPRENTISSAGE;BAC PROFESSIONNEL;BAC PRO SERV;BAC PRO 31106 LOGISTIQUE;38;38;26;9;3;3;0;29;0;2;4;7;16;9
15027.0;2022;13;POITIERS;FEMININ;APPRENTISSAGE;BAC PROFESSIONNEL;BAC PRO PROD;BAC PRO 25214 MAINT.VEHIC.OPTA VOIT.PARTICUL.;4;3;3;0;0;0;0;3;0;0;1;1;1;0
25413.0;2023;25;VERSAILLES;MASCULIN;APPRENTISSAGE;BAC PROFESSIONNEL;BAC PRO SERV;BAC PRO 31213 MET.COM.VEN.OP.A ANI.GES.ESP.COM.;151;151;100;37;14;10;4;110;0;2;11;43;54;41
15032.0;2022;13;POITIERS;FEMININ;APPRENTISSAGE;BAC PROFESSIONNEL;BAC PRO PROD;BAC PRO 25510 METIERS ELECT. ENVIRON. CONNECTES;2;2;2;0;0;0;0;2;0;1;1;0;0;0
25416.0;2023;25;VERSAILLES;MASCULIN;APPRENTISSAGE;BAC PROFESSIONNEL;BAC PRO SERV;BAC PRO 33004 ACC.SOINS-S.PERS. OPT.EN STRUCTUR;2;2;1;1;0;0;0;1;0;0;1;0;0;1
15041.0;2022;13;POITIERS;FEMININ;APPRENTISSAGE;BAC PROFESSIONNEL;BAC PRO SERV;BAC PRO 31213 MET.COM.VEN.OP.A ANI.GES.ESP.COM.;111;107;79;20;8;5;3;84;0;4;6;34;40;23
25427.0;2023;25;VERSAILLES;MASCULIN;ENSEIGNEMENT A DISTANCE;BAC TECHNOLOGIQUE;BAC ST2S;BAC ST2S SCIENCES & TECHNO. SANTE & SOCIAL;1;1;0;1;0;0;0;0;0;0;0;0;0;1
15048.0;2022;13;POITIERS;FEMININ;APPRENTISSAGE;BAC PROFESSIONNEL;BAC PRO SERV;BAC PRO 33603 ESTHETIQUE COSMETIQUE PARFUMERIE;5;5;5;0;0;0;0;5;0;0;1;4;0;0
25430.0;2023;25;VERSAILLES;MASCULIN;ENSEIGNEMENT A DISTANCE;BAC TECHNOLOGIQUE;BAC STMG;BAC STMG RESSOURCES HUMAINES ET COMMUNICATION;4;4;1;2;1;1;0;2;0;0;0;0;2;2
15056.0;2022;13;POITIERS;FEMININ;ENSEIGNEMENT A DISTANCE;BAC PROFESSIONNEL;BAC PRO SERV;BAC PRO 33603 ESTHETIQUE COSMETIQUE PARFUMERIE;1;1;0;1;0;0;0;0;0;0;0;0;0;1
25433.0;2023;25;VERSAILLES;MASCULIN;FORMATION CONTINUE;BAC PROFESSIONNEL;BAC PRO PROD;BAC PRO 23004 TECHN. ETUDES BAT.A ETUDES & ECO.;2;2;2;0;0;0;0;2;0;0;0;2;0;0
15060.0;2022;13;POITIERS;FEMININ;ENSEIGNEMENT A DISTANCE;BAC TECHNOLOGIQUE;BAC STMG;BAC STMG RESSOURCES HUMAINES ET COMMUNICATION;3;3;3;0;0;0;0;3;0;0;0;2;1;0
25435.0;2023;25;VERSAILLES;MASCULIN;FORMATION CONTINUE;BAC PROFESSIONNEL;BAC PRO PROD;BAC PRO 23203 TECHNICIEN BAT. : ORG.REAL.GROS O;1;1;1;0;0;0;0;1;0;0;0;0;1;0
15070.0;2022;13;POITIERS;FEMININ;INDIVIDUEL;BAC PROFESSIONNEL;BAC PRO PROD;BAC PRO AG 21211 COND GEST ENTR HIPPIQUE;2;2;1;1;0;0;0;1;0;0;0;0;1;1
25440.0;2023;25;VERSAILLES;MASCULIN;FORMATION CONTINUE;BAC PROFESSIONNEL;BAC PRO PROD;BAC PRO 25510 METIERS ELECT. ENVIRON. CONNECTES;18;17;13;4;0;0;0;13;0;3;4;3;3;4
15073.0;2022;13;POITIERS;FEMININ;INDIVIDUEL;BAC PROFESSIONNEL;BAC PRO SERV;BAC PRO 31214 MET.COM.VEN.OP.B PR.CL.VA.OF.COM.;1;1;0;1;0;0;0;0;0;0;0;0;0;1
25444.0;2023;25;VERSAILLES;MASCULIN;FORMATION CONTINUE;BAC PROFESSIONNEL;BAC PRO SERV;BAC PRO 31213 MET.COM.VEN.OP.A ANI.GES.ESP.COM.;6;4;1;3;0;0;0;1;0;0;0;1;0;3
15075.0;2022;13;POITIERS;FEMININ;INDIVIDUEL;BAC PROFESSIONNEL;BAC PRO SERV;BAC PRO 33004 ACC.SOINS-S.PERS. OPT.EN STRUCTUR;2;0;0;0;0;0;0;0;0;0;0;0;0;0
25448.0;2023;25;VERSAILLES;MASCULIN;INDIVIDUEL;BAC PROFESSIONNEL;BAC PRO PROD;BAC PRO 22703 TECHN.INSTALL.SYST.ENERG.CLIMATI;4;2;0;2;0;0;0;0;0;0;0;0;0;2
15076.0;2022;13;POITIERS;FEMININ;INDIVIDUEL;BAC PROFESSIONNEL;BAC PRO SERV;BAC PRO 33603 ESTHETIQUE COSMETIQUE PARFUMERIE;2;1;0;1;0;0;0;0;0;0;0;0;0;1
25460.0;2023;25;VERSAILLES;MASCULIN;INDIVIDUEL;BAC PROFESSIONNEL;BAC PRO PROD;BAC PRO 25408 REPARATION DES CARROSSERIES;1;1;1;0;0;0;0;1;0;0;0;0;1;0
15079.0;2022;13;POITIERS;FEMININ;INDIVIDUEL;BAC TECHNOLOGIQUE;BAC STMG;BAC STMG GESTION ET FINANCE;2;1;1;0;0;0;0;1;0;0;0;0;1;0
25468.0;2023;25;VERSAILLES;MASCULIN;INDIVIDUEL;BAC PROFESSIONNEL;BAC PRO PROD;BAC PRO AG 21114 CONDUITE PRODUCTIONS HORTICOLES;4;4;4;0;0;0;0;4;0;0;0;0;4;0
15084.0;2022;13;POITIERS;FEMININ;SCOLAIRE;BAC PROFESSIONNEL;BAC PRO PROD;BACPRO 20002 ETUD.DEFINITION PRDTS INDUSTRIEL;2;2;1;1;0;0;0;1;0;0;0;1;0;1
25473.0;2023;25;VERSAILLES;MASCULIN;INDIVIDUEL;BAC PROFESSIONNEL;BAC PRO SERV;BAC PRO 31212 METIERS DE L'ACCUEIL;6;4;1;2;1;1;0;2;0;0;0;1;1;2
15089.0;2022;13;POITIERS;FEMININ;SCOLAIRE;BAC PROFESSIONNEL;BAC PRO PROD;BAC PRO 22106 CUISINE;48;48;43;5;0;0;0;43;0;5;15;12;11;5
25475.0;2023;25;VERSAILLES;MASCULIN;INDIVIDUEL;BAC PROFESSIONNEL;BAC PRO SERV;BAC PRO 31214 MET.COM.VEN.OP.B PR.CL.VA.OF.COM.;11;9;6;2;1;0;1;6;0;0;0;1;5;3
15111.0;2022;13;POITIERS;FEMININ;SCOLAIRE;BAC PROFESSIONNEL;BAC PRO PROD;BAC PRO 25510 METIERS ELECT. ENVIRON. CONNECTES;3;3;2;1;0;0;0;2;0;0;0;1;1;1
25476.0;2023;25;VERSAILLES;MASCULIN;INDIVIDUEL;BAC PROFESSIONNEL;BAC PRO SERV;BAC PRO 32207 REAL.PR.IMPR.PLURI.OPTA.PR.GRAPH.;1;0;0;0;0;0;0;0;0;0;0;0;0;0
15119.0;2022;13;POITIERS;FEMININ;SCOLAIRE;BAC PROFESSIONNEL;BAC PRO PROD;BAC PRO AG 21211 COND GEST ENTR HIPPIQUE;70;70;65;5;0;0;0;65;0;1;4;29;31;5
25479.0;2023;25;VERSAILLES;MASCULIN;INDIVIDUEL;BAC PROFESSIONNEL;BAC PRO SERV;BAC PRO 33002 SERVICES DE PROXIMITE  VIE LOCAL;1;1;1;0;0;0;0;1;0;0;0;0;1;0
15120.0;2022;13;POITIERS;FEMININ;SCOLAIRE;BAC PROFESSIONNEL;BAC PRO PROD;BAC PRO AG 21302 GEST MILIEUX NATURELS FAUNE;21;21;19;2;0;0;0;19;0;0;3;5;11;2
25485.0;2023;25;VERSAILLES;MASCULIN;INDIVIDUEL;BAC TECHNOLOGIQUE;BAC STD2A;BAC STD2A SCIENCES & TECHNO. DESIGN-ARTS APPLIQUES;6;6;4;1;1;1;0;5;0;0;0;2;3;1
15139.0;2022;13;POITIERS;FEMININ;SCOLAIRE;BAC PROFESSIONNEL;BAC PRO SERV;BAC PRO 33004 ACC.SOINS-S.PERS. OPT.EN STRUCTUR;291;290;265;17;8;6;2;271;0;15;74;103;79;19
25489.0;2023;25;VERSAILLES;MASCULIN;INDIVIDUEL;BAC TECHNOLOGIQUE;BAC STI2D;BAC STI2D SYSTÈME D'INFORMATION  ET NUMERIQUE;9;9;1;6;2;1;1;2;0;0;0;0;2;7
15144.0;2022;13;POITIERS;FEMININ;SCOLAIRE;BAC PROFESSIONNEL;BAC PRO SERV;BAC PRO 34403 METIERS DE LA SECURITE;17;17;17;0;0;0;0;17;0;2;9;3;3;0
25499.0;2023;25;VERSAILLES;MASCULIN;SCOLAIRE;BAC PROFESSIONNEL;BAC PRO PROD;BAC PRO 22105 BOULANGER-PÂTISSIER;51;51;42;7;2;2;0;44;0;3;8;16;17;7
15145.0;2022;13;POITIERS;FEMININ;SCOLAIRE;BAC PROFESSIONNEL;BAC PRO SERV;BAC PRO AG 33002 SERV PERS TERRIT;274;264;233;31;0;0;0;233;0;3;28;91;111;31
25508.0;2023;25;VERSAILLES;MASCULIN;SCOLAIRE;BAC PROFESSIONNEL;BAC PRO PROD;BAC PRO 23203 TECHNICIEN BAT. : ORG.REAL.GROS O;37;37;31;5;1;1;0;32;0;3;7;7;15;5
15148.0;2022;13;POITIERS;FEMININ;SCOLAIRE;BAC TECHNOLOGIQUE;BAC STD2A;BAC STD2A SCIENCES & TECHNO. DESIGN-ARTS APPLIQUES;88;88;87;0;1;1;0;88;0;4;25;44;15;0
25518.0;2023;25;VERSAILLES;MASCULIN;SCOLAIRE;BAC PROFESSIONNEL;BAC PRO PROD;BAC PRO 25009 MAINTENANCE NAUTIQUE;18;18;13;3;2;2;0;15;0;0;2;7;6;3
15149.0;2022;13;POITIERS;FEMININ;SCOLAIRE;BAC TECHNOLOGIQUE;BAC STHR;BAC STHR SC.&TEC. HOTELLERIE-RESTAURATION;37;37;34;0;3;2;1;36;0;4;2;15;15;1
25524.0;2023;25;VERSAILLES;MASCULIN;SCOLAIRE;BAC PROFESSIONNEL;BAC PRO PROD;BAC PRO 25219 MAINT.MATERIELS OPT.A AGRICOLES;6;6;3;2;1;1;0;4;0;0;0;1;3;2
15154.0;2022;13;POITIERS;FEMININ;SCOLAIRE;BAC TECHNOLOGIQUE;BAC STL;BAC STL BIOCHIM.-BIOLOGIE-BIOTECHNOL.;58;58;50;1;7;6;1;56;1;5;8;19;23;2
25525.0;2023;25;VERSAILLES;MASCULIN;SCOLAIRE;BAC PROFESSIONNEL;BAC PRO PROD;BAC PRO 25220 MAINT.MATERIELS OPT.B TP MANUT.;14;14;12;2;0;0;0;12;0;1;1;2;8;2
15167.0;2022;13;POITIERS;MASCULIN;APPRENTISSAGE;BAC PROFESSIONNEL;BAC PRO PROD;BAC PRO 23303 MENUISERIE ALUMINIUM-VERRE;5;5;3;2;0;0;0;3;0;1;1;0;1;2
25530.0;2023;25;VERSAILLES;MASCULIN;SCOLAIRE;BAC PROFESSIONNEL;BAC PRO PROD;BAC PRO 25406 OUVRAGES DU BATIMENT METALLERIE;10;10;8;2;0;0;0;8;0;1;1;3;3;2
15181.0;2022;13;POITIERS;MASCULIN;APPRENTISSAGE;BAC PROFESSIONNEL;BAC PRO PROD;BAC PRO 25406 OUVRAGES DU BATIMENT METALLERIE;4;4;3;0;1;1;0;4;0;2;1;0;1;0
25531.0;2023;25;VERSAILLES;MASCULIN;SCOLAIRE;BAC PROFESSIONNEL;BAC PRO PROD;BAC PRO 25408 REPARATION DES CARROSSERIES;64;64;50;8;6;6;0;56;0;4;12;17;23;8
15184.0;2022;13;POITIERS;MASCULIN;APPRENTISSAGE;BAC PROFESSIONNEL;BAC PRO PROD;BAC PRO 25509 TECHNIC. FROID CONDITIONNEMT AIR;11;11;10;1;0;0;0;10;0;0;1;5;4;1
25537.0;2023;25;VERSAILLES;MASCULIN;SCOLAIRE;BAC PROFESSIONNEL;BAC PRO PROD;BAC PRO 25514 SYST.NUM.OPT.B AUD.RES.EQUIP.DOM.;248;247;197;31;19;9;10;206;0;4;42;77;83;41
15187.0;2022;13;POITIERS;MASCULIN;APPRENTISSAGE;BAC PROFESSIONNEL;BAC PRO PROD;BAC PRO 25515 SYST.NUM.OPT.C RES.INF.SYST.COMM.;2;2;2;0;0;0;0;2;0;0;1;1;0;0
25539.0;2023;25;VERSAILLES;MASCULIN;SCOLAIRE;BAC PROFESSIONNEL;BAC PRO PROD;BAC PRO AG 21001 AGRO-EQUIPEMENT;3;3;3;0;0;0;0;3;0;0;0;0;3;0
15189.0;2022;13;POITIERS;MASCULIN;APPRENTISSAGE;BAC PROFESSIONNEL;BAC PRO PROD;BAC PRO AG 21004 CGEA;54;52;44;8;0;0;0;44;0;0;3;15;26;8
25554.0;2023;25;VERSAILLES;MASCULIN;SCOLAIRE;BAC PROFESSIONNEL;BAC PRO SERV;BAC PRO 32207 REAL.PR.IMPR.PLURI.OPTA.PR.GRAPH.;61;61;60;1;0;0;0;60;0;3;16;28;13;1
15203.0;2022;13;POITIERS;MASCULIN;APPRENTISSAGE;BAC PROFESSIONNEL;BAC PRO SERV;BAC PRO 33403 COMMERC. SERVICES EN RESTAURATION;4;4;3;1;0;0;0;3;0;0;1;0;2;1
25559.0;2023;25;VERSAILLES;MASCULIN;SCOLAIRE;BAC PROFESSIONNEL;BAC PRO SERV;BAC PRO 33004 ACC.SOINS-S.PERS. OPT.EN STRUCTUR;67;67;55;6;6;5;1;60;0;1;13;21;25;7
15212.0;2022;13;POITIERS;MASCULIN;FORMATION CONTINUE;BAC PROFESSIONNEL;BAC PRO PROD;BAC PRO 22704 TECHN. MAINT. SYST.ENERG.CLIMATI;1;1;1;0;0;0;0;1;0;0;1;0;0;0
25560.0;2023;25;VERSAILLES;MASCULIN;SCOLAIRE;BAC PROFESSIONNEL;BAC PRO SERV;BAC PRO 33006 ANIMAT. ENFANCE& PERSONNES AGEES;61;61;46;11;4;2;2;48;0;1;11;18;18;13
15213.0;2022;13;POITIERS;MASCULIN;FORMATION CONTINUE;BAC PROFESSIONNEL;BAC PRO PROD;BAC PRO 25214 MAINT.VEHIC.OPTA VOIT.PARTICUL.;2;2;2;0;0;0;0;2;0;1;1;0;0;0
25563.0;2023;25;VERSAILLES;MASCULIN;SCOLAIRE;BAC PROFESSIONNEL;BAC PRO SERV;BAC PRO 33603 ESTHETIQUE COSMETIQUE PARFUMERIE;1;1;0;1;0;0;0;0;0;0;0;0;0;1
15220.0;2022;13;POITIERS;MASCULIN;INDIVIDUEL;BAC PROFESSIONNEL;BAC PRO PROD;BAC PRO AG 21004 CGEA;2;2;1;1;0;0;0;1;0;0;0;0;1;1
25571.0;2023;25;VERSAILLES;MASCULIN;SCOLAIRE;BAC TECHNOLOGIQUE;BAC STD2A;BAC STD2A SCIENCES & TECHNO. DESIGN-ARTS APPLIQUES;23;23;23;0;0;0;0;23;0;0;5;8;10;0
15221.0;2022;13;POITIERS;MASCULIN;INDIVIDUEL;BAC PROFESSIONNEL;BAC PRO PROD;BAC PRO AG 21113 CGEVV;1;0;0;0;0;0;0;0;0;0;0;0;0;0
25576.0;2023;25;VERSAILLES;MASCULIN;SCOLAIRE;BAC TECHNOLOGIQUE;BAC STI2D;BAC STI2D SYSTÈME D'INFORMATION  ET NUMERIQUE;942;942;771;44;127;78;49;849;2;18;127;291;411;93
15222.0;2022;13;POITIERS;MASCULIN;INDIVIDUEL;BAC PROFESSIONNEL;BAC PRO PROD;BAC PRO AG 21114 CONDUITE PRODUCTIONS HORTICOLES;2;2;2;0;0;0;0;2;0;0;0;1;1;0
25577.0;2023;25;VERSAILLES;MASCULIN;SCOLAIRE;BAC TECHNOLOGIQUE;BAC STL;BAC STL BIOCHIM.-BIOLOGIE-BIOTECHNOL.;184;184;149;10;25;11;14;160;0;4;29;56;71;24
15233.0;2022;13;POITIERS;MASCULIN;SCOLAIRE;BAC PROFESSIONNEL;BAC PRO PROD;BAC PRO 22003 BIO-INDUSTRIES DE TRANSFORMATION;12;12;7;4;1;1;0;8;0;0;3;3;2;4
15243.0;2022;13;POITIERS;MASCULIN;SCOLAIRE;BAC PROFESSIONNEL;BAC PRO PROD;BACPRO 23103 TECHNICIEN GEOMETRE-TOPOGRAPHE;23;22;22;0;0;0;0;22;0;1;5;10;6;0
15247.0;2022;13;POITIERS;MASCULIN;SCOLAIRE;BAC PROFESSIONNEL;BAC PRO PROD;BAC PRO 23304 AMENAGEMENT FINITION BATIMENT;21;21;15;3;3;2;1;17;0;0;4;8;5;4
15249.0;2022;13;POITIERS;MASCULIN;SCOLAIRE;BAC PROFESSIONNEL;BAC PRO PROD;BAC PRO 23405 TECHNICIEN MENUISIER AGENCEUR;61;61;47;13;1;1;0;48;0;1;7;18;22;13
15253.0;2022;13;POITIERS;MASCULIN;SCOLAIRE;BAC PROFESSIONNEL;BAC PRO PROD;BAC PRO 25006 MICROTECHNIQUES;13;13;9;3;1;1;0;10;0;0;1;6;3;3
15258.0;2022;13;POITIERS;MASCULIN;SCOLAIRE;BAC PROFESSIONNEL;BAC PRO PROD;BAC PRO 25214 MAINT.VEHIC.OPTA VOIT.PARTICUL.;118;117;90;20;7;4;3;94;0;3;19;28;44;23
15268.0;2022;13;POITIERS;MASCULIN;SCOLAIRE;BAC PROFESSIONNEL;BAC PRO PROD;BAC PRO 25411 TECH.CHAUDRONNERIE INDUSTRIELLE;45;45;38;6;1;1;0;39;0;3;8;21;7;6
15276.0;2022;13;POITIERS;MASCULIN;SCOLAIRE;BAC PROFESSIONNEL;BAC PRO PROD;BAC PRO AG 21113 CGEVV;34;34;30;4;0;0;0;30;0;0;5;7;18;4
15278.0;2022;13;POITIERS;MASCULIN;SCOLAIRE;BAC PROFESSIONNEL;BAC PRO PROD;BAC PRO AG 21203 TECHN CONSEIL DE VENTE ANIMAL;10;10;10;0;0;0;0;10;0;0;1;3;6;0
15280.0;2022;13;POITIERS;MASCULIN;SCOLAIRE;BAC PROFESSIONNEL;BAC PRO PROD;BAC PRO AG 21210 COND GEST ENTR CANIN ET FELIN;8;8;8;0;0;0;0;8;0;0;1;3;4;0
15294.0;2022;13;POITIERS;MASCULIN;SCOLAIRE;BAC PROFESSIONNEL;BAC PRO SERV;BAC PRO 31213 MET.COM.VEN.OP.A ANI.GES.ESP.COM.;189;189;155;22;12;6;6;161;0;1;28;62;70;28
15301.0;2022;13;POITIERS;MASCULIN;SCOLAIRE;BAC PROFESSIONNEL;BAC PRO SERV;BAC PRO 33004 ACC.SOINS-S.PERS. OPT.EN STRUCTUR;25;25;22;3;0;0;0;22;0;0;2;11;9;3
15306.0;2022;13;POITIERS;MASCULIN;SCOLAIRE;BAC PROFESSIONNEL;BAC PRO SERV;BAC PRO AG 33002 SERV PERS TERRIT;29;28;26;2;0;0;0;26;0;0;2;8;16;2
15309.0;2022;13;POITIERS;MASCULIN;SCOLAIRE;BAC TECHNOLOGIQUE;BAC STD2A;BAC STD2A SCIENCES & TECHNO. DESIGN-ARTS APPLIQUES;28;28;28;0;0;0;0;28;0;1;7;15;5;0
15311.0;2022;13;POITIERS;MASCULIN;SCOLAIRE;BAC TECHNOLOGIQUE;BAC STI2D;BAC STI2D ARCHITECTURE ET CONSTRUCTION;116;116;95;5;16;10;6;105;0;2;10;42;51;11
15315.0;2022;13;POITIERS;MASCULIN;SCOLAIRE;BAC TECHNOLOGIQUE;BAC STL;BAC STL BIOCHIM.-BIOLOGIE-BIOTECHNOL.;51;51;42;1;8;6;2;48;0;0;6;13;29;3
15321.0;2022;19;REIMS;FEMININ;APPRENTISSAGE;BAC PROFESSIONNEL;BAC PRO PROD;BAC PRO 20102 PILOTE DE LIGNE DE PRODUCTION;3;3;3;0;0;0;0;3;0;1;2;0;0;0
15322.0;2022;19;REIMS;FEMININ;APPRENTISSAGE;BAC PROFESSIONNEL;BAC PRO PROD;BAC PRO 22704 TECHN. MAINT. SYST.ENERG.CLIMATI;1;1;1;0;0;0;0;1;0;0;0;0;1;0
15324.0;2022;19;REIMS;FEMININ;APPRENTISSAGE;BAC PROFESSIONNEL;BAC PRO PROD;BAC PRO 25106 TECHNICIEN D'USINAGE;2;2;2;0;0;0;0;2;0;1;0;1;0;0
15338.0;2022;19;REIMS;FEMININ;APPRENTISSAGE;BAC PROFESSIONNEL;BAC PRO SERV;BAC PRO 33603 ESTHETIQUE COSMETIQUE PARFUMERIE;4;4;2;2;0;0;0;2;0;0;0;0;2;2
15346.0;2022;19;REIMS;FEMININ;ENSEIGNEMENT A DISTANCE;BAC TECHNOLOGIQUE;BAC ST2S;BAC ST2S SCIENCES & TECHNO. SANTE & SOCIAL;2;2;2;0;0;0;0;2;0;0;1;1;0;0
15351.0;2022;19;REIMS;FEMININ;FORMATION CONTINUE;BAC PROFESSIONNEL;BAC PRO SERV;BAC PRO 31212 METIERS DE L'ACCUEIL;2;1;1;0;0;0;0;1;0;0;0;1;0;0
15352.0;2022;19;REIMS;FEMININ;FORMATION CONTINUE;BAC PROFESSIONNEL;BAC PRO SERV;BAC PRO 31213 MET.COM.VEN.OP.A ANI.GES.ESP.COM.;1;1;1;0;0;0;0;1;0;0;0;1;0;0
15365.0;2022;19;REIMS;FEMININ;INDIVIDUEL;BAC TECHNOLOGIQUE;BAC ST2S;BAC ST2S SCIENCES & TECHNO. SANTE & SOCIAL;4;3;1;2;0;0;0;1;0;0;0;0;1;2
15376.0;2022;19;REIMS;FEMININ;SCOLAIRE;BAC PROFESSIONNEL;BAC PRO PROD;BAC PRO 23004 TECHN. ETUDES BAT.A ETUDES & ECO.;7;7;7;0;0;0;0;7;0;0;0;4;3;0
15378.0;2022;19;REIMS;FEMININ;SCOLAIRE;BAC PROFESSIONNEL;BAC PRO PROD;BAC PRO 23304 AMENAGEMENT FINITION BATIMENT;3;3;3;0;0;0;0;3;0;0;2;1;0;0
15380.0;2022;19;REIMS;FEMININ;SCOLAIRE;BAC PROFESSIONNEL;BAC PRO PROD;BAC PRO 23408 Etude et réalisation d'agencement;3;3;3;0;0;0;0;3;0;0;1;0;2;0
15384.0;2022;19;REIMS;FEMININ;SCOLAIRE;BAC PROFESSIONNEL;BAC PRO PROD;BAC PRO 25106 TECHNICIEN D'USINAGE;2;2;2;0;0;0;0;2;0;0;1;0;1;0
15387.0;2022;19;REIMS;FEMININ;SCOLAIRE;BAC PROFESSIONNEL;BAC PRO PROD;BAC PRO 25509 TECHNIC. FROID CONDITIONNEMT AIR;1;1;1;0;0;0;0;1;0;0;1;0;0;0
15392.0;2022;19;REIMS;FEMININ;SCOLAIRE;BAC PROFESSIONNEL;BAC PRO PROD;BAC PRO AG 21004 CGEA;31;28;20;8;0;0;0;20;0;1;3;6;10;8
15393.0;2022;19;REIMS;FEMININ;SCOLAIRE;BAC PROFESSIONNEL;BAC PRO PROD;BAC PRO AG 21113 CGEVV;10;10;2;8;0;0;0;2;0;0;0;0;2;8
15404.0;2022;19;REIMS;FEMININ;SCOLAIRE;BAC PROFESSIONNEL;BAC PRO SERV;BAC PRO 30001 GESTION-ADMINISTRATION;235;234;175;46;13;10;3;185;0;5;29;74;77;49
15406.0;2022;19;REIMS;FEMININ;SCOLAIRE;BAC PROFESSIONNEL;BAC PRO SERV;BAC PRO 31107 CONDUCT. TRANSP.ROUT.MARCHANDISES;5;5;5;0;0;0;0;5;0;2;3;0;0;0
15407.0;2022;19;REIMS;FEMININ;SCOLAIRE;BAC PROFESSIONNEL;BAC PRO SERV;BAC PRO 31108 TRANSPORT;3;3;2;0;1;1;0;3;0;1;0;0;2;0
15410.0;2022;19;REIMS;FEMININ;SCOLAIRE;BAC PROFESSIONNEL;BAC PRO SERV;BAC PRO 31214 MET.COM.VEN.OP.B PR.CL.VA.OF.COM.;113;113;75;29;9;8;1;83;0;1;14;30;38;30
15412.0;2022;19;REIMS;FEMININ;SCOLAIRE;BAC PROFESSIONNEL;BAC PRO SERV;BAC PRO 32208 REAL.PR.IMPR.PLURI.OPTB.PR.IMPR.;2;2;2;0;0;0;0;2;0;0;1;1;0;0
15413.0;2022;19;REIMS;FEMININ;SCOLAIRE;BAC PROFESSIONNEL;BAC PRO SERV;BAC PRO 32303 ART.& MET.ART:COM.VIS.VIS.PLURI-M;24;24;22;2;0;0;0;22;0;1;9;9;3;2
15414.0;2022;19;REIMS;FEMININ;SCOLAIRE;BAC PROFESSIONNEL;BAC PRO SERV;BAC PRO 33002 SERVICES DE PROXIMITE  VIE LOCAL;10;10;9;1;0;0;0;9;0;0;3;4;2;1
15422.0;2022;19;REIMS;FEMININ;SCOLAIRE;BAC PROFESSIONNEL;BAC PRO SERV;BAC PRO 34305 TECHN.D'INTERV.SUR INSTALL. NUCL.;1;1;1;0;0;0;0;1;0;0;0;0;1;0
15423.0;2022;19;REIMS;FEMININ;SCOLAIRE;BAC PROFESSIONNEL;BAC PRO SERV;BAC PRO 34403 METIERS DE LA SECURITE;33;33;28;4;1;0;1;28;0;2;4;12;10;5
15426.0;2022;19;REIMS;FEMININ;SCOLAIRE;BAC TECHNOLOGIQUE;BAC S2TMD;BAC S2TMD MUSIQUE;3;3;3;0;0;0;0;3;0;1;1;1;0;0
15430.0;2022;19;REIMS;FEMININ;SCOLAIRE;BAC TECHNOLOGIQUE;BAC STHR;BAC STHR SC.&TEC. HOTELLERIE-RESTAURATION;16;16;16;0;0;0;0;16;0;3;1;6;6;0
15436.0;2022;19;REIMS;FEMININ;SCOLAIRE;BAC TECHNOLOGIQUE;BAC STL;BAC STL SCIENCES PHYSIQUES CHIMIQUES  EN LABORAT.;16;16;14;1;1;0;1;14;0;0;2;4;8;2
15447.0;2022;19;REIMS;MASCULIN;APPRENTISSAGE;BAC PROFESSIONNEL;BAC PRO PROD;BAC PRO 23102 TRAVAUX PUBLICS;26;25;21;2;2;0;2;21;0;3;3;11;4;4
15452.0;2022;19;REIMS;MASCULIN;APPRENTISSAGE;BAC PROFESSIONNEL;BAC PRO PROD;BAC PRO 24203 METIERS DE LA MODE - VÊTEMENT;1;1;0;0;1;0;1;0;0;0;0;0;0;1
15457.0;2022;19;REIMS;MASCULIN;APPRENTISSAGE;BAC PROFESSIONNEL;BAC PRO PROD;BAC PRO 25215 MAINT.VEHIC.OPTB VEHIC.TRANS.ROUT;15;15;10;2;3;2;1;12;0;0;4;4;4;3
15461.0;2022;19;REIMS;MASCULIN;APPRENTISSAGE;BAC PROFESSIONNEL;BAC PRO PROD;BAC PRO 25221 MAINT.MATERIELS OPT.C ESP. VERTS;2;2;0;2;0;0;0;0;0;0;0;0;0;2
15463.0;2022;19;REIMS;MASCULIN;APPRENTISSAGE;BAC PROFESSIONNEL;BAC PRO PROD;BAC PRO 25411 TECH.CHAUDRONNERIE INDUSTRIELLE;32;32;13;16;3;0;3;13;0;0;1;6;6;19
15464.0;2022;19;REIMS;MASCULIN;APPRENTISSAGE;BAC PROFESSIONNEL;BAC PRO PROD;BAC PRO 25509 TECHNIC. FROID CONDITIONNEMT AIR;1;1;1;0;0;0;0;1;0;0;0;0;1;0
15467.0;2022;19;REIMS;MASCULIN;APPRENTISSAGE;BAC PROFESSIONNEL;BAC PRO PROD;BAC PRO 25515 SYST.NUM.OPT.C RES.INF.SYST.COMM.;2;2;2;0;0;0;0;2;0;0;1;0;1;0
15477.0;2022;19;REIMS;MASCULIN;APPRENTISSAGE;BAC PROFESSIONNEL;BAC PRO SERV;BAC PRO 32303 ART.& MET.ART:COM.VIS.VIS.PLURI-M;1;1;1;0;0;0;0;1;0;0;1;0;0;0
15479.0;2022;19;REIMS;MASCULIN;APPRENTISSAGE;BAC PROFESSIONNEL;BAC PRO SERV;BAC PRO 34305 TECHN.D'INTERV.SUR INSTALL. NUCL.;5;5;5;0;0;0;0;5;0;0;0;5;0;0
15488.0;2022;19;REIMS;MASCULIN;FORMATION CONTINUE;BAC PROFESSIONNEL;BAC PRO PROD;BAC PRO 23405 TECHNICIEN MENUISIER AGENCEUR;6;6;6;0;0;0;0;6;0;2;2;2;0;0
15491.0;2022;19;REIMS;MASCULIN;FORMATION CONTINUE;BAC PROFESSIONNEL;BAC PRO SERV;BAC PRO 34403 METIERS DE LA SECURITE;4;4;4;0;0;0;0;4;0;0;1;0;3;0
15494.0;2022;19;REIMS;MASCULIN;INDIVIDUEL;BAC PROFESSIONNEL;BAC PRO PROD;BAC PRO 25214 MAINT.VEHIC.OPTA VOIT.PARTICUL.;1;1;0;1;0;0;0;0;0;0;0;0;0;1
15496.0;2022;19;REIMS;MASCULIN;INDIVIDUEL;BAC PROFESSIONNEL;BAC PRO PROD;BAC PRO AG 21405 AMENAGEMENTS PAYSAGERS;1;1;1;0;0;0;0;1;0;0;0;0;1;0
15501.0;2022;19;REIMS;MASCULIN;INDIVIDUEL;BAC TECHNOLOGIQUE;BAC STI2D;BAC STI2D INNOVATION TECHNO.  ET ECO CONCEPTION;1;1;0;0;1;1;0;1;0;0;0;0;1;0
15507.0;2022;19;REIMS;MASCULIN;SCOLAIRE;BAC PROFESSIONNEL;BAC PRO PROD;BACPRO 20002 ETUD.DEFINITION PRDTS INDUSTRIEL;10;10;7;3;0;0;0;7;0;0;0;3;4;3
15526.0;2022;19;REIMS;MASCULIN;SCOLAIRE;BAC PROFESSIONNEL;BAC PRO PROD;BAC PRO 23408 Etude et réalisation d'agencement;3;3;2;1;0;0;0;2;0;0;0;1;1;1
15533.0;2022;19;REIMS;MASCULIN;SCOLAIRE;BAC PROFESSIONNEL;BAC PRO PROD;BAC PRO 25216 MAINT.VEHIC.OPTC MOTOCYCLES;7;7;6;1;0;0;0;6;0;1;3;0;2;1
15542.0;2022;19;REIMS;MASCULIN;SCOLAIRE;BAC PROFESSIONNEL;BAC PRO PROD;BAC PRO 25514 SYST.NUM.OPT.B AUD.RES.EQUIP.DOM.;55;55;47;6;2;2;0;49;0;4;7;20;18;6
15546.0;2022;19;REIMS;MASCULIN;SCOLAIRE;BAC PROFESSIONNEL;BAC PRO PROD;BAC PRO AG 21113 CGEVV;33;32;27;5;0;0;0;27;0;0;1;9;17;5
15551.0;2022;19;REIMS;MASCULIN;SCOLAIRE;BAC PROFESSIONNEL;BAC PRO PROD;BAC PRO AG 21302 GEST MILIEUX NATURELS FAUNE;47;47;40;7;0;0;0;40;0;0;1;14;25;7
15556.0;2022;19;REIMS;MASCULIN;SCOLAIRE;BAC PROFESSIONNEL;BAC PRO PROD;BAC PRO AG 22107 TEC CONS VTE ALIMENTATION P.ALIM;4;3;3;0;0;0;0;3;0;0;1;2;0;0
15559.0;2022;19;REIMS;MASCULIN;SCOLAIRE;BAC PROFESSIONNEL;BAC PRO SERV;BAC PRO 31107 CONDUCT. TRANSP.ROUT.MARCHANDISES;61;61;52;8;1;0;1;52;0;2;19;24;7;9
15562.0;2022;19;REIMS;MASCULIN;SCOLAIRE;BAC PROFESSIONNEL;BAC PRO SERV;BAC PRO 31213 MET.COM.VEN.OP.A ANI.GES.ESP.COM.;172;171;113;38;20;16;4;129;0;1;10;48;70;42
15567.0;2022;19;REIMS;MASCULIN;SCOLAIRE;BAC PROFESSIONNEL;BAC PRO SERV;BAC PRO 33002 SERVICES DE PROXIMITE  VIE LOCAL;5;5;4;0;1;0;1;4;0;0;1;1;2;1
15573.0;2022;19;REIMS;MASCULIN;SCOLAIRE;BAC PROFESSIONNEL;BAC PRO SERV;BAC PRO 34305 TECHN.D'INTERV.SUR INSTALL. NUCL.;12;12;10;2;0;0;0;10;0;0;2;5;3;2
15577.0;2022;19;REIMS;MASCULIN;SCOLAIRE;BAC TECHNOLOGIQUE;BAC ST2S;BAC ST2S SCIENCES & TECHNO. SANTE & SOCIAL;58;58;46;1;11;7;4;53;0;1;2;17;33;5
15591.0;2022;14;RENNES;FEMININ;APPRENTISSAGE;BAC PROFESSIONNEL;BAC PRO PROD;BAC PRO 22105 BOULANGER-PÂTISSIER;5;5;5;0;0;0;0;5;0;1;1;3;0;0
15593.0;2022;14;RENNES;FEMININ;APPRENTISSAGE;BAC PROFESSIONNEL;BAC PRO PROD;BAC PRO 23304 AMENAGEMENT FINITION BATIMENT;1;1;1;0;0;0;0;1;0;0;0;1;0;0
15600.0;2022;14;RENNES;FEMININ;APPRENTISSAGE;BAC PROFESSIONNEL;BAC PRO PROD;BAC PRO AG 21004 CGEA;25;24;18;6;0;0;0;18;0;0;0;2;16;6
15611.0;2022;14;RENNES;FEMININ;APPRENTISSAGE;BAC PROFESSIONNEL;BAC PRO SERV;BAC PRO 33403 COMMERC. SERVICES EN RESTAURATION;9;9;7;2;0;0;0;7;0;0;1;2;4;2
15613.0;2022;14;RENNES;FEMININ;APPRENTISSAGE;BAC PROFESSIONNEL;BAC PRO SERV;BAC PRO 34304 HYGIENE PROPRETE STERILISATION;15;15;13;1;1;0;1;13;0;2;4;5;2;2
15617.0;2022;14;RENNES;FEMININ;ENSEIGNEMENT A DISTANCE;BAC PROFESSIONNEL;BAC PRO SERV;BAC PRO 31213 MET.COM.VEN.OP.A ANI.GES.ESP.COM.;1;0;0;0;0;0;0;0;0;0;0;0;0;0
15622.0;2022;14;RENNES;FEMININ;ENSEIGNEMENT A DISTANCE;BAC TECHNOLOGIQUE;BAC STMG;BAC STMG MERCATIQUE (MARKETING);9;9;7;1;1;1;0;8;0;0;3;3;2;1
15623.0;2022;14;RENNES;FEMININ;ENSEIGNEMENT A DISTANCE;BAC TECHNOLOGIQUE;BAC STMG;BAC STMG RESSOURCES HUMAINES ET COMMUNICATION;5;5;4;0;1;1;0;5;0;0;1;2;2;0
15636.0;2022;14;RENNES;FEMININ;INDIVIDUEL;BAC PROFESSIONNEL;BAC PRO SERV;BAC PRO 31212 METIERS DE L'ACCUEIL;1;0;0;0;0;0;0;0;0;0;0;0;0;0
15649.0;2022;14;RENNES;FEMININ;SCOLAIRE;BAC PROFESSIONNEL;BAC PRO PROD;BACPRO 20002 ETUD.DEFINITION PRDTS INDUSTRIEL;1;1;0;1;0;0;0;0;0;0;0;0;0;1
15652.0;2022;14;RENNES;FEMININ;SCOLAIRE;BAC PROFESSIONNEL;BAC PRO PROD;BAC PRO 22403 ARTS.& MET.ART:MET.ENSEIGN SIGNA;3;3;3;0;0;0;0;3;0;0;0;2;1;0
15654.0;2022;14;RENNES;FEMININ;SCOLAIRE;BAC PROFESSIONNEL;BAC PRO PROD;BAC PRO 23003 ARTIS. & M.ART:MARCHANDISAGE VIS.;20;20;19;0;1;1;0;20;0;3;10;5;2;0
15655.0;2022;14;RENNES;FEMININ;SCOLAIRE;BAC PROFESSIONNEL;BAC PRO PROD;BAC PRO 23004 TECHN. ETUDES BAT.A ETUDES & ECO.;15;15;14;1;0;0;0;14;0;0;2;6;6;1
15664.0;2022;14;RENNES;FEMININ;SCOLAIRE;BAC PROFESSIONNEL;BAC PRO PROD;BAC PRO 24203 METIERS DE LA MODE - VÊTEMENT;134;134;108;23;3;3;0;111;0;15;19;42;35;23
15666.0;2022;14;RENNES;FEMININ;SCOLAIRE;BAC PROFESSIONNEL;BAC PRO PROD;BAC PRO 25006 MICROTECHNIQUES;2;2;2;0;0;0;0;2;0;0;1;1;0;0
15667.0;2022;14;RENNES;FEMININ;SCOLAIRE;BAC PROFESSIONNEL;BAC PRO PROD;BAC PRO 25007 MAINTENANCE EQUIPEMENTS INDUST.;8;8;8;0;0;0;0;8;0;1;1;6;0;0
15672.0;2022;14;RENNES;FEMININ;SCOLAIRE;BAC PROFESSIONNEL;BAC PRO PROD;BAC PRO 25215 MAINT.VEHIC.OPTB VEHIC.TRANS.ROUT;1;1;1;0;0;0;0;1;0;1;0;0;0;0
15673.0;2022;14;RENNES;FEMININ;SCOLAIRE;BAC PROFESSIONNEL;BAC PRO PROD;BAC PRO 25216 MAINT.VEHIC.OPTC MOTOCYCLES;3;3;3;0;0;0;0;3;0;0;0;1;2;0
15676.0;2022;14;RENNES;FEMININ;SCOLAIRE;BAC PROFESSIONNEL;BAC PRO PROD;BAC PRO 25304 AERONAUTIQUE OPTION STRUCTURE;7;7;7;0;0;0;0;7;0;0;0;4;3;0
15679.0;2022;14;RENNES;FEMININ;SCOLAIRE;BAC PROFESSIONNEL;BAC PRO PROD;BAC PRO 25509 TECHNIC. FROID CONDITIONNEMT AIR;1;1;1;0;0;0;0;1;0;0;0;1;0;0
15680.0;2022;14;RENNES;FEMININ;SCOLAIRE;BAC PROFESSIONNEL;BAC PRO PROD;BAC PRO 25510 METIERS ELECT. ENVIRON. CONNECTES;8;8;8;0;0;0;0;8;0;0;2;4;2;0
15681.0;2022;14;RENNES;FEMININ;SCOLAIRE;BAC PROFESSIONNEL;BAC PRO PROD;BAC PRO 25513 SYST.NUM.OPT.A SURETE SECURITE;1;1;1;0;0;0;0;1;0;0;0;0;1;0
15683.0;2022;14;RENNES;FEMININ;SCOLAIRE;BAC PROFESSIONNEL;BAC PRO PROD;BAC PRO 25515 SYST.NUM.OPT.C RES.INF.SYST.COMM.;6;6;5;1;0;0;0;5;0;1;1;3;0;1
15700.0;2022;14;RENNES;FEMININ;SCOLAIRE;BAC PROFESSIONNEL;BAC PRO SERV;BAC PRO 31212 METIERS DE L'ACCUEIL;171;171;154;9;8;8;0;162;0;9;35;65;53;9
15701.0;2022;14;RENNES;FEMININ;SCOLAIRE;BAC PROFESSIONNEL;BAC PRO SERV;BAC PRO 31213 MET.COM.VEN.OP.A ANI.GES.ESP.COM.;555;555;494;53;8;5;3;499;0;18;118;216;147;56
15705.0;2022;14;RENNES;FEMININ;SCOLAIRE;BAC PROFESSIONNEL;BAC PRO SERV;BAC PRO 32303 ART.& MET.ART:COM.VIS.VIS.PLURI-M;15;15;15;0;0;0;0;15;0;4;9;1;1;0
15716.0;2022;14;RENNES;FEMININ;SCOLAIRE;BAC TECHNOLOGIQUE;BAC S2TMD;BAC S2TMD DANSE;9;9;9;0;0;0;0;9;0;2;3;1;3;0
15719.0;2022;14;RENNES;FEMININ;SCOLAIRE;BAC TECHNOLOGIQUE;BAC STAV;BAC STAV AGRONOMIE ALIM ENV TERRITOI;187;187;183;4;0;0;0;183;0;0;19;69;95;4
15727.0;2022;14;RENNES;FEMININ;SCOLAIRE;BAC TECHNOLOGIQUE;BAC STL;BAC STL SCIENCES PHYSIQUES CHIMIQUES  EN LABORAT.;39;39;37;1;1;1;0;38;2;3;10;14;9;1
15739.0;2022;14;RENNES;MASCULIN;APPRENTISSAGE;BAC PROFESSIONNEL;BAC PRO PROD;BAC PRO 23203 TECHNICIEN BAT. : ORG.REAL.GROS O;16;16;13;2;1;1;0;14;0;1;4;6;3;2
15740.0;2022;14;RENNES;MASCULIN;APPRENTISSAGE;BAC PROFESSIONNEL;BAC PRO PROD;BAC PRO 23304 AMENAGEMENT FINITION BATIMENT;5;5;4;1;0;0;0;4;0;0;0;3;1;1
15741.0;2022;14;RENNES;MASCULIN;APPRENTISSAGE;BAC PROFESSIONNEL;BAC PRO PROD;BAC PRO 23404 TECHNICIEN CONSTRUCTEUR BOIS;3;3;2;1;0;0;0;2;0;1;0;1;0;1
15751.0;2022;14;RENNES;MASCULIN;APPRENTISSAGE;BAC PROFESSIONNEL;BAC PRO PROD;BAC PRO 25220 MAINT.MATERIELS OPT.B TP MANUT.;19;19;15;2;2;2;0;17;0;2;3;6;6;2
15757.0;2022;14;RENNES;MASCULIN;APPRENTISSAGE;BAC PROFESSIONNEL;BAC PRO PROD;BAC PRO 25510 METIERS ELECT. ENVIRON. CONNECTES;98;97;83;13;1;0;1;83;0;11;11;29;32;14
15764.0;2022;14;RENNES;MASCULIN;APPRENTISSAGE;BAC PROFESSIONNEL;BAC PRO PROD;BAC PRO AG 21211 COND GEST ENTR HIPPIQUE;2;2;2;0;0;0;0;2;0;0;0;0;2;0
15780.0;2022;14;RENNES;MASCULIN;ENSEIGNEMENT A DISTANCE;BAC PROFESSIONNEL;BAC PRO SERV;BAC PRO 33004 ACC.SOINS-S.PERS. OPT.EN STRUCTUR;1;0;0;0;0;0;0;0;0;0;0;0;0;0
15781.0;2022;14;RENNES;MASCULIN;ENSEIGNEMENT A DISTANCE;BAC TECHNOLOGIQUE;BAC STMG;BAC STMG GESTION ET FINANCE;1;1;0;0;1;1;0;1;0;0;0;0;1;0
15793.0;2022;14;RENNES;MASCULIN;INDIVIDUEL;BAC PROFESSIONNEL;BAC PRO PROD;BAC PRO 23303 MENUISERIE ALUMINIUM-VERRE;1;0;0;0;0;0;0;0;0;0;0;0;0;0
15806.0;2022;14;RENNES;MASCULIN;INDIVIDUEL;BAC PROFESSIONNEL;BAC PRO PROD;BAC PRO AG 21302 GEST MILIEUX NATURELS FAUNE;1;0;0;0;0;0;0;0;0;0;0;0;0;0
15815.0;2022;14;RENNES;MASCULIN;INDIVIDUEL;BAC TECHNOLOGIQUE;BAC ST2S;BAC ST2S SCIENCES & TECHNO. SANTE & SOCIAL;1;1;0;1;0;0;0;0;0;0;0;0;0;1
15819.0;2022;14;RENNES;MASCULIN;INDIVIDUEL;BAC TECHNOLOGIQUE;BAC STMG;BAC STMG MERCATIQUE (MARKETING);20;15;9;2;4;1;3;10;0;0;0;2;8;5
15825.0;2022;14;RENNES;MASCULIN;SCOLAIRE;BAC PROFESSIONNEL;BAC PRO PROD;BAC PRO 22106 CUISINE;182;181;171;9;1;0;1;171;0;11;36;82;42;10
15826.0;2022;14;RENNES;MASCULIN;SCOLAIRE;BAC PROFESSIONNEL;BAC PRO PROD;BAC PRO 22403 ARTS.& MET.ART:MET.ENSEIGN SIGNA;11;11;7;1;3;2;1;9;0;0;0;2;7;2
15838.0;2022;14;RENNES;MASCULIN;SCOLAIRE;BAC PROFESSIONNEL;BAC PRO PROD;BAC PRO 23404 TECHNICIEN CONSTRUCTEUR BOIS;76;76;63;10;3;2;1;65;0;2;19;18;26;11
15840.0;2022;14;RENNES;MASCULIN;SCOLAIRE;BAC PROFESSIONNEL;BAC PRO PROD;BAC PRO 23407 TECHNIC.FAB.BOIS ET MATERX ASSOC;19;19;16;2;1;0;1;16;0;1;2;10;3;3
15843.0;2022;14;RENNES;MASCULIN;SCOLAIRE;BAC PROFESSIONNEL;BAC PRO PROD;BAC PRO 24302 METIERS DU CUIR : MAROQUINERIE;2;2;2;0;0;0;0;2;0;0;0;1;1;0
15849.0;2022;14;RENNES;MASCULIN;SCOLAIRE;BAC PROFESSIONNEL;BAC PRO PROD;BAC PRO 25214 MAINT.VEHIC.OPTA VOIT.PARTICUL.;262;262;223;32;7;6;1;229;0;10;65;78;76;33
15850.0;2022;14;RENNES;MASCULIN;SCOLAIRE;BAC PROFESSIONNEL;BAC PRO PROD;BAC PRO 25215 MAINT.VEHIC.OPTB VEHIC.TRANS.ROUT;53;53;37;11;5;4;1;41;0;2;6;15;18;12
15857.0;2022;14;RENNES;MASCULIN;SCOLAIRE;BAC PROFESSIONNEL;BAC PRO PROD;BAC PRO 25304 AERONAUTIQUE OPTION STRUCTURE;27;27;25;2;0;0;0;25;0;0;5;13;7;2
15864.0;2022;14;RENNES;MASCULIN;SCOLAIRE;BAC PROFESSIONNEL;BAC PRO PROD;BAC PRO 25514 SYST.NUM.OPT.B AUD.RES.EQUIP.DOM.;141;141;127;11;3;2;1;129;0;10;36;56;27;12
15873.0;2022;14;RENNES;MASCULIN;SCOLAIRE;BAC PROFESSIONNEL;BAC PRO PROD;BAC PRO AG 21302 GEST MILIEUX NATURELS FAUNE;47;47;39;8;0;0;0;39;0;0;6;14;19;8
15883.0;2022;14;RENNES;MASCULIN;SCOLAIRE;BAC PROFESSIONNEL;BAC PRO SERV;BAC PRO 31212 METIERS DE L'ACCUEIL;72;72;54;16;2;2;0;56;0;0;6;19;31;16
15886.0;2022;14;RENNES;MASCULIN;SCOLAIRE;BAC PROFESSIONNEL;BAC PRO SERV;BAC PRO 32207 REAL.PR.IMPR.PLURI.OPTA.PR.GRAPH.;24;24;23;1;0;0;0;23;0;2;7;10;4;1
15892.0;2022;14;RENNES;MASCULIN;SCOLAIRE;BAC PROFESSIONNEL;BAC PRO SERV;BAC PRO 33101 OPTIQUE LUNETTERIE;11;10;10;0;0;0;0;10;0;3;1;2;4;0
15897.0;2022;14;RENNES;MASCULIN;SCOLAIRE;BAC PROFESSIONNEL;BAC PRO SERV;BAC PRO 34403 METIERS DE LA SECURITE;32;32;32;0;0;0;0;32;0;2;14;10;6;0
15905.0;2022;14;RENNES;MASCULIN;SCOLAIRE;BAC TECHNOLOGIQUE;BAC STI2D;BAC STI2D ARCHITECTURE ET CONSTRUCTION;205;205;194;1;10;8;2;202;0;4;28;96;74;3
15908.0;2022;14;RENNES;MASCULIN;SCOLAIRE;BAC TECHNOLOGIQUE;BAC STI2D;BAC STI2D SYSTÈME D'INFORMATION  ET NUMERIQUE;447;447;420;8;19;13;6;433;0;11;77;181;164;14
15912.0;2022;14;RENNES;MASCULIN;SCOLAIRE;BAC TECHNOLOGIQUE;BAC STMG;BAC STMG MERCATIQUE (MARKETING);1123;1123;911;26;186;134;52;1045;0;1;64;326;654;78
15914.0;2022;14;RENNES;MASCULIN;SCOLAIRE;BAC TECHNOLOGIQUE;BAC STMG;BAC STMG SYSTEMES D'INFORMATION DE GESTION;22;22;19;0;3;1;2;20;0;0;2;5;13;2
15920.0;2022;15;STRASBOURG;FEMININ;APPRENTISSAGE;BAC PROFESSIONNEL;BAC PRO PROD;BAC PRO 25006 MICROTECHNIQUES;1;1;1;0;0;0;0;1;0;0;1;0;0;0
15922.0;2022;15;STRASBOURG;FEMININ;APPRENTISSAGE;BAC PROFESSIONNEL;BAC PRO PROD;BAC PRO 25106 TECHNICIEN D'USINAGE;1;1;1;0;0;0;0;1;0;0;1;0;0;0
15927.0;2022;15;STRASBOURG;FEMININ;APPRENTISSAGE;BAC PROFESSIONNEL;BAC PRO PROD;BAC PRO 25510 METIERS ELECT. ENVIRON. CONNECTES;3;3;3;0;0;0;0;3;0;0;2;1;0;0
15930.0;2022;15;STRASBOURG;FEMININ;APPRENTISSAGE;BAC PROFESSIONNEL;BAC PRO PROD;BAC PRO AG 21114 CONDUITE PRODUCTIONS HORTICOLES;4;4;3;1;0;0;0;3;0;0;0;0;3;1
15931.0;2022;15;STRASBOURG;FEMININ;APPRENTISSAGE;BAC PROFESSIONNEL;BAC PRO PROD;BAC PRO AG 21203 TECHN CONSEIL DE VENTE ANIMAL;4;4;4;0;0;0;0;4;0;0;0;2;2;0
15937.0;2022;15;STRASBOURG;FEMININ;APPRENTISSAGE;BAC PROFESSIONNEL;BAC PRO SERV;BAC PRO 31212 METIERS DE L'ACCUEIL;9;9;8;1;0;0;0;8;0;1;1;2;4;1
15938.0;2022;15;STRASBOURG;FEMININ;APPRENTISSAGE;BAC PROFESSIONNEL;BAC PRO SERV;BAC PRO 31213 MET.COM.VEN.OP.A ANI.GES.ESP.COM.;100;100;76;18;6;5;1;81;0;10;21;23;27;19
15941.0;2022;15;STRASBOURG;FEMININ;APPRENTISSAGE;BAC PROFESSIONNEL;BAC PRO SERV;BAC PRO 33603 ESTHETIQUE COSMETIQUE PARFUMERIE;9;9;6;2;1;0;1;6;0;0;0;5;1;3
15948.0;2022;15;STRASBOURG;FEMININ;ENSEIGNEMENT A DISTANCE;BAC TECHNOLOGIQUE;BAC ST2S;BAC ST2S SCIENCES & TECHNO. SANTE & SOCIAL;2;2;2;0;0;0;0;2;0;0;1;1;0;0
15956.0;2022;15;STRASBOURG;FEMININ;FORMATION CONTINUE;BAC PROFESSIONNEL;BAC PRO SERV;BAC PRO 31213 MET.COM.VEN.OP.A ANI.GES.ESP.COM.;4;4;4;0;0;0;0;4;0;0;1;3;0;0
15958.0;2022;15;STRASBOURG;FEMININ;INDIVIDUEL;BAC PROFESSIONNEL;BAC PRO PROD;BAC PRO 22106 CUISINE;1;0;0;0;0;0;0;0;0;0;0;0;0;0
15959.0;2022;15;STRASBOURG;FEMININ;INDIVIDUEL;BAC PROFESSIONNEL;BAC PRO PROD;BAC PRO 24203 METIERS DE LA MODE - VÊTEMENT;1;0;0;0;0;0;0;0;0;0;0;0;0;0
15970.0;2022;15;STRASBOURG;FEMININ;INDIVIDUEL;BAC PROFESSIONNEL;BAC PRO SERV;BAC PRO 33603 ESTHETIQUE COSMETIQUE PARFUMERIE;1;1;1;0;0;0;0;1;0;0;0;0;1;0
15972.0;2022;15;STRASBOURG;FEMININ;INDIVIDUEL;BAC TECHNOLOGIQUE;BAC ST2S;BAC ST2S SCIENCES & TECHNO. SANTE & SOCIAL;7;5;2;2;1;1;0;3;0;0;0;0;3;2
15979.0;2022;15;STRASBOURG;FEMININ;SCOLAIRE;BAC PROFESSIONNEL;BAC PRO PROD;BAC PRO 22003 BIO-INDUSTRIES DE TRANSFORMATION;22;22;11;9;2;1;1;12;0;0;3;2;7;10
15980.0;2022;15;STRASBOURG;FEMININ;SCOLAIRE;BAC PROFESSIONNEL;BAC PRO PROD;BAC PRO 22004 PROC. CHIMIE EAU PAPIERS-CARTONS;4;4;4;0;0;0;0;4;0;1;1;1;1;0
15983.0;2022;15;STRASBOURG;FEMININ;SCOLAIRE;BAC PROFESSIONNEL;BAC PRO PROD;BAC PRO 22503 PLASTIQUES ET COMPOSITES;2;2;2;0;0;0;0;2;0;0;0;0;2;0
15985.0;2022;15;STRASBOURG;FEMININ;SCOLAIRE;BAC PROFESSIONNEL;BAC PRO PROD;BAC PRO 23005 TECHN. ETUDES BAT B ASSIST.ARCHI.;10;10;10;0;0;0;0;10;0;2;2;3;3;0
15996.0;2022;15;STRASBOURG;FEMININ;SCOLAIRE;BAC PROFESSIONNEL;BAC PRO PROD;BAC PRO 25219 MAINT.MATERIELS OPT.A AGRICOLES;1;1;0;1;0;0;0;0;0;0;0;0;0;1
16003.0;2022;15;STRASBOURG;FEMININ;SCOLAIRE;BAC PROFESSIONNEL;BAC PRO PROD;BAC PRO AG 21114 CONDUITE PRODUCTIONS HORTICOLES;10;10;9;1;0;0;0;9;0;0;0;6;3;1
16005.0;2022;15;STRASBOURG;FEMININ;SCOLAIRE;BAC PROFESSIONNEL;BAC PRO PROD;BAC PRO AG 21303 FORET;3;3;3;0;0;0;0;3;0;0;1;2;0;0
16008.0;2022;15;STRASBOURG;FEMININ;SCOLAIRE;BAC PROFESSIONNEL;BAC PRO PROD;BAC PRO AG 22107 TEC CONS VTE ALIMENTATION P.ALIM;8;8;8;0;0;0;0;8;0;0;0;2;6;0
16015.0;2022;15;STRASBOURG;FEMININ;SCOLAIRE;BAC PROFESSIONNEL;BAC PRO SERV;BAC PRO 31213 MET.COM.VEN.OP.A ANI.GES.ESP.COM.;405;404;334;42;28;15;13;349;0;20;83;114;132;55
16016.0;2022;15;STRASBOURG;FEMININ;SCOLAIRE;BAC PROFESSIONNEL;BAC PRO SERV;BAC PRO 31214 MET.COM.VEN.OP.B PR.CL.VA.OF.COM.;35;35;33;1;1;0;1;33;0;2;2;16;13;2
16019.0;2022;15;STRASBOURG;FEMININ;SCOLAIRE;BAC PROFESSIONNEL;BAC PRO SERV;BAC PRO 32303 ART.& MET.ART:COM.VIS.VIS.PLURI-M;13;13;13;0;0;0;0;13;0;2;6;4;1;0
16020.0;2022;15;STRASBOURG;FEMININ;SCOLAIRE;BAC PROFESSIONNEL;BAC PRO SERV;BAC PRO 33002 SERVICES DE PROXIMITE  VIE LOCAL;93;93;71;14;8;3;5;74;0;2;15;34;23;19
16034.0;2022;15;STRASBOURG;FEMININ;SCOLAIRE;BAC TECHNOLOGIQUE;BAC STI2D;BAC STI2D ENERGIES  ET ENVIRONNEMENT;8;8;8;0;0;0;0;8;0;1;3;1;3;0
16037.0;2022;15;STRASBOURG;FEMININ;SCOLAIRE;BAC TECHNOLOGIQUE;BAC STL;BAC STL BIOCHIM.-BIOLOGIE-BIOTECHNOL.;139;139;102;13;24;16;8;118;0;9;24;31;54;21
16038.0;2022;15;STRASBOURG;FEMININ;SCOLAIRE;BAC TECHNOLOGIQUE;BAC STL;BAC STL SCIENCES PHYSIQUES CHIMIQUES  EN LABORAT.;33;33;23;2;8;5;3;28;0;2;3;7;16;5
16044.0;2022;15;STRASBOURG;MASCULIN;APPRENTISSAGE;BAC PROFESSIONNEL;BAC PRO PROD;BAC PRO 22304 ART.MET.ART-FACT.ORG. OPT.ORGAN.;2;2;1;1;0;0;0;1;0;0;1;0;0;1
16047.0;2022;15;STRASBOURG;MASCULIN;APPRENTISSAGE;BAC PROFESSIONNEL;BAC PRO PROD;BAC PRO 22703 TECHN.INSTALL.SYST.ENERG.CLIMATI;14;14;10;4;0;0;0;10;0;0;6;1;3;4
16049.0;2022;15;STRASBOURG;MASCULIN;APPRENTISSAGE;BAC PROFESSIONNEL;BAC PRO PROD;BAC PRO 23102 TRAVAUX PUBLICS;9;9;9;0;0;0;0;9;0;2;2;3;2;0
16050.0;2022;15;STRASBOURG;MASCULIN;APPRENTISSAGE;BAC PROFESSIONNEL;BAC PRO PROD;BAC PRO 23203 TECHNICIEN BAT. : ORG.REAL.GROS O;7;7;6;1;0;0;0;6;0;0;0;2;4;1
16053.0;2022;15;STRASBOURG;MASCULIN;APPRENTISSAGE;BAC PROFESSIONNEL;BAC PRO PROD;BAC PRO 23407 TECHNIC.FAB.BOIS ET MATERX ASSOC;18;18;16;1;1;1;0;17;0;1;2;7;7;1
16064.0;2022;15;STRASBOURG;MASCULIN;APPRENTISSAGE;BAC PROFESSIONNEL;BAC PRO PROD;BAC PRO 25406 OUVRAGES DU BATIMENT METALLERIE;5;5;4;1;0;0;0;4;0;0;0;0;4;1
16065.0;2022;15;STRASBOURG;MASCULIN;APPRENTISSAGE;BAC PROFESSIONNEL;BAC PRO PROD;BAC PRO 25408 REPARATION DES CARROSSERIES;22;22;13;8;1;1;0;14;0;1;6;3;4;8
16067.0;2022;15;STRASBOURG;MASCULIN;APPRENTISSAGE;BAC PROFESSIONNEL;BAC PRO PROD;BAC PRO 25411 TECH.CHAUDRONNERIE INDUSTRIELLE;76;76;67;5;4;4;0;71;0;6;14;24;27;5
16071.0;2022;15;STRASBOURG;MASCULIN;APPRENTISSAGE;BAC PROFESSIONNEL;BAC PRO PROD;BAC PRO 25515 SYST.NUM.OPT.C RES.INF.SYST.COMM.;7;7;7;0;0;0;0;7;0;1;2;2;2;0
16076.0;2022;15;STRASBOURG;MASCULIN;APPRENTISSAGE;BAC PROFESSIONNEL;BAC PRO PROD;BAC PRO AG 21203 TECHN CONSEIL DE VENTE ANIMAL;2;2;2;0;0;0;0;2;0;0;0;1;1;0
16081.0;2022;15;STRASBOURG;MASCULIN;APPRENTISSAGE;BAC PROFESSIONNEL;BAC PRO SERV;BAC PRO 31106 LOGISTIQUE;25;25;17;7;1;1;0;18;0;1;6;3;8;7
16082.0;2022;15;STRASBOURG;MASCULIN;APPRENTISSAGE;BAC PROFESSIONNEL;BAC PRO SERV;BAC PRO 31213 MET.COM.VEN.OP.A ANI.GES.ESP.COM.;50;49;35;7;7;6;1;41;0;3;8;16;14;8
16085.0;2022;15;STRASBOURG;MASCULIN;APPRENTISSAGE;BAC PROFESSIONNEL;BAC PRO SERV;BAC PRO 33403 COMMERC. SERVICES EN RESTAURATION;10;10;10;0;0;0;0;10;0;0;2;4;4;0
16089.0;2022;15;STRASBOURG;MASCULIN;ENSEIGNEMENT A DISTANCE;BAC TECHNOLOGIQUE;BAC STMG;BAC STMG MERCATIQUE (MARKETING);2;2;0;1;1;1;0;1;0;0;0;0;1;1
16091.0;2022;15;STRASBOURG;MASCULIN;FORMATION CONTINUE;BAC PROFESSIONNEL;BAC PRO PROD;BAC PRO 22704 TECHN. MAINT. SYST.ENERG.CLIMATI;16;14;11;2;1;1;0;12;0;2;5;2;3;2
16093.0;2022;15;STRASBOURG;MASCULIN;FORMATION CONTINUE;BAC PROFESSIONNEL;BAC PRO PROD;BAC PRO 23404 TECHNICIEN CONSTRUCTEUR BOIS;1;1;1;0;0;0;0;1;0;1;0;0;0;0
16096.0;2022;15;STRASBOURG;MASCULIN;FORMATION CONTINUE;BAC PROFESSIONNEL;BAC PRO PROD;BAC PRO 25106 TECHNICIEN D'USINAGE;5;5;3;2;0;0;0;3;0;0;3;0;0;2
16101.0;2022;15;STRASBOURG;MASCULIN;FORMATION CONTINUE;BAC PROFESSIONNEL;BAC PRO SERV;BAC PRO 31213 MET.COM.VEN.OP.A ANI.GES.ESP.COM.;5;5;4;0;1;1;0;5;0;0;1;2;2;0
16108.0;2022;15;STRASBOURG;MASCULIN;INDIVIDUEL;BAC PROFESSIONNEL;BAC PRO PROD;BAC PRO 25006 MICROTECHNIQUES;2;2;1;1;0;0;0;1;0;0;0;0;1;1
16132.0;2022;15;STRASBOURG;MASCULIN;INDIVIDUEL;BAC TECHNOLOGIQUE;BAC STMG;BAC STMG SYSTEMES D'INFORMATION DE GESTION;2;1;0;1;0;0;0;0;0;0;0;0;0;1
16140.0;2022;15;STRASBOURG;MASCULIN;SCOLAIRE;BAC PROFESSIONNEL;BAC PRO PROD;BAC PRO 22704 TECHN. MAINT. SYST.ENERG.CLIMATI;31;31;17;11;3;3;0;20;0;0;1;8;11;11
16148.0;2022;15;STRASBOURG;MASCULIN;SCOLAIRE;BAC PROFESSIONNEL;BAC PRO PROD;BAC PRO 23405 TECHNICIEN MENUISIER AGENCEUR;47;47;33;12;2;2;0;35;0;4;5;15;11;12
16150.0;2022;15;STRASBOURG;MASCULIN;SCOLAIRE;BAC PROFESSIONNEL;BAC PRO PROD;BAC PRO 24203 METIERS DE LA MODE - VÊTEMENT;5;5;3;2;0;0;0;3;0;0;2;1;0;2
16157.0;2022;15;STRASBOURG;MASCULIN;SCOLAIRE;BAC PROFESSIONNEL;BAC PRO PROD;BAC PRO 25216 MAINT.VEHIC.OPTC MOTOCYCLES;9;9;7;2;0;0;0;7;0;0;3;2;2;2
16158.0;2022;15;STRASBOURG;MASCULIN;SCOLAIRE;BAC PROFESSIONNEL;BAC PRO PROD;BAC PRO 25219 MAINT.MATERIELS OPT.A AGRICOLES;11;11;11;0;0;0;0;11;0;1;4;5;1;0
16163.0;2022;15;STRASBOURG;MASCULIN;SCOLAIRE;BAC PROFESSIONNEL;BAC PRO PROD;BAC PRO 25509 TECHNIC. FROID CONDITIONNEMT AIR;5;5;4;1;0;0;0;4;0;0;2;0;2;1
16164.0;2022;15;STRASBOURG;MASCULIN;SCOLAIRE;BAC PROFESSIONNEL;BAC PRO PROD;BAC PRO 25510 METIERS ELECT. ENVIRON. CONNECTES;363;363;270;74;19;12;7;282;0;16;46;96;124;81
16167.0;2022;15;STRASBOURG;MASCULIN;SCOLAIRE;BAC PROFESSIONNEL;BAC PRO PROD;BAC PRO 25515 SYST.NUM.OPT.C RES.INF.SYST.COMM.;123;123;102;18;3;3;0;105;0;6;22;39;38;18
16171.0;2022;15;STRASBOURG;MASCULIN;SCOLAIRE;BAC PROFESSIONNEL;BAC PRO PROD;BAC PRO AG 21302 GEST MILIEUX NATURELS FAUNE;18;18;15;3;0;0;0;15;0;2;2;5;6;3
16172.0;2022;15;STRASBOURG;MASCULIN;SCOLAIRE;BAC PROFESSIONNEL;BAC PRO PROD;BAC PRO AG 21303 FORET;9;9;6;3;0;0;0;6;0;0;1;1;4;3
16176.0;2022;15;STRASBOURG;MASCULIN;SCOLAIRE;BAC PROFESSIONNEL;BAC PRO SERV;BAC PRO 30001 GESTION-ADMINISTRATION;134;134;91;33;10;8;2;99;0;1;16;33;49;35
16185.0;2022;15;STRASBOURG;MASCULIN;SCOLAIRE;BAC PROFESSIONNEL;BAC PRO SERV;BAC PRO 32208 REAL.PR.IMPR.PLURI.OPTB.PR.IMPR.;17;17;14;3;0;0;0;14;0;0;1;6;7;3
16187.0;2022;15;STRASBOURG;MASCULIN;SCOLAIRE;BAC PROFESSIONNEL;BAC PRO SERV;BAC PRO 33002 SERVICES DE PROXIMITE  VIE LOCAL;24;24;22;1;1;1;0;23;0;1;3;14;5;1
16190.0;2022;15;STRASBOURG;MASCULIN;SCOLAIRE;BAC PROFESSIONNEL;BAC PRO SERV;BAC PRO 33102 PROTHESE DENTAIRE;5;5;3;2;0;0;0;3;0;0;0;0;3;2
16196.0;2022;15;STRASBOURG;MASCULIN;SCOLAIRE;BAC TECHNOLOGIQUE;BAC ST2S;BAC ST2S SCIENCES & TECHNO. SANTE & SOCIAL;75;75;56;5;14;6;8;62;0;0;8;27;27;13
16207.0;2022;15;STRASBOURG;MASCULIN;SCOLAIRE;BAC TECHNOLOGIQUE;BAC STMG;BAC STMG MERCATIQUE (MARKETING);415;415;319;17;79;53;26;372;0;3;26;118;225;43
16208.0;2022;15;STRASBOURG;MASCULIN;SCOLAIRE;BAC TECHNOLOGIQUE;BAC STMG;BAC STMG RESSOURCES HUMAINES ET COMMUNICATION;148;148;109;11;28;18;10;127;0;0;8;29;90;21
16211.0;2022;16;TOULOUSE;FEMININ;APPRENTISSAGE;BAC PROFESSIONNEL;BAC PRO PROD;BAC PRO 22104 BOUCHER CHARCUTIER TRAITEUR;1;1;1;0;0;0;0;1;0;0;1;0;0;0
16212.0;2022;16;TOULOUSE;FEMININ;APPRENTISSAGE;BAC PROFESSIONNEL;BAC PRO PROD;BAC PRO 22105 BOULANGER-PÂTISSIER;1;1;1;0;0;0;0;1;0;1;0;0;0;0
16219.0;2022;16;TOULOUSE;FEMININ;APPRENTISSAGE;BAC PROFESSIONNEL;BAC PRO PROD;BAC PRO 25007 MAINTENANCE EQUIPEMENTS INDUST.;1;1;1;0;0;0;0;1;0;0;1;0;0;0
16221.0;2022;16;TOULOUSE;FEMININ;APPRENTISSAGE;BAC PROFESSIONNEL;BAC PRO PROD;BAC PRO 25214 MAINT.VEHIC.OPTA VOIT.PARTICUL.;5;5;3;2;0;0;0;3;0;2;0;1;0;2
16224.0;2022;16;TOULOUSE;FEMININ;APPRENTISSAGE;BAC PROFESSIONNEL;BAC PRO PROD;BAC PRO 25302 AERONAUTIQUE OPTION AVIONIQUE;4;4;4;0;0;0;0;4;0;0;1;2;1;0
16225.0;2022;16;TOULOUSE;FEMININ;APPRENTISSAGE;BAC PROFESSIONNEL;BAC PRO PROD;BAC PRO 25303 AERONAUTIQUE OPTION SYSTEMES;1;1;1;0;0;0;0;1;0;0;0;1;0;0
16231.0;2022;16;TOULOUSE;FEMININ;APPRENTISSAGE;BAC PROFESSIONNEL;BAC PRO PROD;BAC PRO AG 21004 CGEA;1;1;1;0;0;0;0;1;0;0;1;0;0;0
16236.0;2022;16;TOULOUSE;FEMININ;APPRENTISSAGE;BAC PROFESSIONNEL;BAC PRO SERV;BAC PRO 31106 LOGISTIQUE;1;1;1;0;0;0;0;1;0;0;0;1;0;0
16245.0;2022;16;TOULOUSE;FEMININ;APPRENTISSAGE;BAC PROFESSIONNEL;BAC PRO SERV;BAC PRO 33102 PROTHESE DENTAIRE;6;6;6;0;0;0;0;6;0;0;2;3;1;0
16261.0;2022;16;TOULOUSE;FEMININ;FORMATION CONTINUE;BAC PROFESSIONNEL;BAC PRO PROD;BAC PRO AG 21114 CONDUITE PRODUCTIONS HORTICOLES;11;11;11;0;0;0;0;11;0;3;4;2;2;0
16264.0;2022;16;TOULOUSE;FEMININ;INDIVIDUEL;BAC GENERAL;BAC GENERAL;BAC GENE 10019 BAC GENERAL;65;40;22;11;7;7;0;29;0;3;5;6;15;11
16268.0;2022;16;TOULOUSE;FEMININ;INDIVIDUEL;BAC PROFESSIONNEL;BAC PRO PROD;BAC PRO AG 21004 CGEA;2;1;1;0;0;0;0;1;0;0;0;0;1;0
16270.0;2022;16;TOULOUSE;FEMININ;INDIVIDUEL;BAC PROFESSIONNEL;BAC PRO PROD;BAC PRO AG 21114 CONDUITE PRODUCTIONS HORTICOLES;9;7;7;0;0;0;0;7;0;0;1;0;6;0
16274.0;2022;16;TOULOUSE;FEMININ;INDIVIDUEL;BAC PROFESSIONNEL;BAC PRO SERV;BAC PRO 31213 MET.COM.VEN.OP.A ANI.GES.ESP.COM.;2;1;0;1;0;0;0;0;0;0;0;0;0;1
16276.0;2022;16;TOULOUSE;FEMININ;INDIVIDUEL;BAC PROFESSIONNEL;BAC PRO SERV;BAC PRO 33004 ACC.SOINS-S.PERS. OPT.EN STRUCTUR;1;1;1;0;0;0;0;1;0;0;0;0;1;0
16278.0;2022;16;TOULOUSE;FEMININ;INDIVIDUEL;BAC PROFESSIONNEL;BAC PRO SERV;BAC PRO AG 33002 SERV PERS TERRIT;1;0;0;0;0;0;0;0;0;0;0;0;0;0
16279.0;2022;16;TOULOUSE;FEMININ;INDIVIDUEL;BAC TECHNOLOGIQUE;BAC S2TMD;BAC S2TMD DANSE;1;1;1;0;0;0;0;1;0;1;0;0;0;0
16291.0;2022;16;TOULOUSE;FEMININ;SCOLAIRE;BAC PROFESSIONNEL;BAC PRO PROD;BAC PRO 22106 CUISINE;60;59;56;2;1;1;0;57;0;8;8;28;13;2
16293.0;2022;16;TOULOUSE;FEMININ;SCOLAIRE;BAC PROFESSIONNEL;BAC PRO PROD;BAC PRO 22503 PLASTIQUES ET COMPOSITES;5;5;3;2;0;0;0;3;0;0;1;0;2;2
16304.0;2022;16;TOULOUSE;FEMININ;SCOLAIRE;BAC PROFESSIONNEL;BAC PRO PROD;BAC PRO 24302 METIERS DU CUIR : MAROQUINERIE;9;9;7;2;0;0;0;7;0;1;2;1;3;2
16306.0;2022;16;TOULOUSE;FEMININ;SCOLAIRE;BAC PROFESSIONNEL;BAC PRO PROD;BAC PRO 25106 TECHNICIEN D'USINAGE;4;4;3;1;0;0;0;3;0;0;2;1;0;1
16316.0;2022;16;TOULOUSE;FEMININ;SCOLAIRE;BAC PROFESSIONNEL;BAC PRO PROD;BAC PRO 25515 SYST.NUM.OPT.C RES.INF.SYST.COMM.;4;4;3;1;0;0;0;3;0;0;1;2;0;1
16318.0;2022;16;TOULOUSE;FEMININ;SCOLAIRE;BAC PROFESSIONNEL;BAC PRO PROD;BAC PRO AG 21113 CGEVV;5;5;5;0;0;0;0;5;0;0;0;3;2;0
16325.0;2022;16;TOULOUSE;FEMININ;SCOLAIRE;BAC PROFESSIONNEL;BAC PRO PROD;BAC PRO AG 21405 AMENAGEMENTS PAYSAGERS;9;9;8;1;0;0;0;8;0;0;2;2;4;1
16330.0;2022;16;TOULOUSE;FEMININ;SCOLAIRE;BAC PROFESSIONNEL;BAC PRO SERV;BAC PRO 31106 LOGISTIQUE;7;7;5;1;1;1;0;6;0;1;0;4;1;1
16338.0;2022;16;TOULOUSE;FEMININ;SCOLAIRE;BAC PROFESSIONNEL;BAC PRO SERV;BAC PRO 32303 ART.& MET.ART:COM.VIS.VIS.PLURI-M;40;40;34;5;1;1;0;35;0;5;15;7;8;5
16340.0;2022;16;TOULOUSE;FEMININ;SCOLAIRE;BAC PROFESSIONNEL;BAC PRO SERV;BAC PRO 33002 SERVICES DE PROXIMITE  VIE LOCAL;19;19;17;0;2;1;1;18;0;2;6;4;6;1
16354.0;2022;16;TOULOUSE;FEMININ;SCOLAIRE;BAC TECHNOLOGIQUE;BAC S2TMD;BAC S2TMD THEATRE;1;1;1;0;0;0;0;1;0;0;1;0;0;0
16355.0;2022;16;TOULOUSE;FEMININ;SCOLAIRE;BAC TECHNOLOGIQUE;BAC ST2S;BAC ST2S SCIENCES & TECHNO. SANTE & SOCIAL;806;806;679;19;108;65;43;744;0;18;102;274;350;62
16356.0;2022;16;TOULOUSE;FEMININ;SCOLAIRE;BAC TECHNOLOGIQUE;BAC STAV;BAC STAV AGRONOMIE ALIM ENV TERRITOI;195;195;192;3;0;0;0;192;0;2;33;80;77;3
16361.0;2022;16;TOULOUSE;FEMININ;SCOLAIRE;BAC TECHNOLOGIQUE;BAC STI2D;BAC STI2D INNOVATION TECHNO.  ET ECO CONCEPTION;17;17;16;0;1;0;1;16;0;0;1;7;8;1
16363.0;2022;16;TOULOUSE;FEMININ;SCOLAIRE;BAC TECHNOLOGIQUE;BAC STL;BAC STL BIOCHIM.-BIOLOGIE-BIOTECHNOL.;117;117;95;4;18;7;11;102;0;4;17;38;43;15
16364.0;2022;16;TOULOUSE;FEMININ;SCOLAIRE;BAC TECHNOLOGIQUE;BAC STL;BAC STL SCIENCES PHYSIQUES CHIMIQUES  EN LABORAT.;100;100;90;3;7;2;5;92;0;4;20;40;28;8
16371.0;2022;16;TOULOUSE;MASCULIN;APPRENTISSAGE;BAC PROFESSIONNEL;BAC PRO PROD;BAC PRO 22104 BOUCHER CHARCUTIER TRAITEUR;6;6;4;2;0;0;0;4;0;0;1;2;1;2
16377.0;2022;16;TOULOUSE;MASCULIN;APPRENTISSAGE;BAC PROFESSIONNEL;BAC PRO PROD;BAC PRO 23004 TECHN. ETUDES BAT.A ETUDES & ECO.;1;1;0;1;0;0;0;0;0;0;0;0;0;1
16383.0;2022;16;TOULOUSE;MASCULIN;APPRENTISSAGE;BAC PROFESSIONNEL;BAC PRO PROD;BAC PRO 23206 INTERV. SUR PATRIMOINE BATI OPT.B;2;2;2;0;0;0;0;2;0;0;0;1;1;0
16390.0;2022;16;TOULOUSE;MASCULIN;APPRENTISSAGE;BAC PROFESSIONNEL;BAC PRO PROD;BAC PRO 25007 MAINTENANCE EQUIPEMENTS INDUST.;29;29;23;5;1;1;0;24;0;4;8;7;5;5
16393.0;2022;16;TOULOUSE;MASCULIN;APPRENTISSAGE;BAC PROFESSIONNEL;BAC PRO PROD;BAC PRO 25215 MAINT.VEHIC.OPTB VEHIC.TRANS.ROUT;16;16;12;2;2;2;0;14;0;1;4;1;8;2
16398.0;2022;16;TOULOUSE;MASCULIN;APPRENTISSAGE;BAC PROFESSIONNEL;BAC PRO PROD;BAC PRO 25302 AERONAUTIQUE OPTION AVIONIQUE;30;30;27;2;1;1;0;28;0;7;14;2;5;2
16405.0;2022;16;TOULOUSE;MASCULIN;APPRENTISSAGE;BAC PROFESSIONNEL;BAC PRO PROD;BAC PRO 25510 METIERS ELECT. ENVIRON. CONNECTES;81;80;60;10;10;8;2;68;0;9;12;19;28;12
16412.0;2022;16;TOULOUSE;MASCULIN;APPRENTISSAGE;BAC PROFESSIONNEL;BAC PRO SERV;BAC PRO 31213 MET.COM.VEN.OP.A ANI.GES.ESP.COM.;69;69;41;23;5;4;1;45;0;1;5;12;27;24
16414.0;2022;16;TOULOUSE;MASCULIN;APPRENTISSAGE;BAC PROFESSIONNEL;BAC PRO SERV;BAC PRO 32207 REAL.PR.IMPR.PLURI.OPTA.PR.GRAPH.;7;6;5;1;0;0;0;5;0;0;0;2;3;1
16416.0;2022;16;TOULOUSE;MASCULIN;APPRENTISSAGE;BAC PROFESSIONNEL;BAC PRO SERV;BAC PRO 33004 ACC.SOINS-S.PERS. OPT.EN STRUCTUR;1;1;1;0;0;0;0;1;0;0;1;0;0;0
16424.0;2022;16;TOULOUSE;MASCULIN;ENSEIGNEMENT A DISTANCE;BAC PROFESSIONNEL;BAC PRO SERV;BAC PRO 31213 MET.COM.VEN.OP.A ANI.GES.ESP.COM.;5;2;0;1;1;0;1;0;0;0;0;0;0;2
16432.0;2022;16;TOULOUSE;MASCULIN;FORMATION CONTINUE;BAC PROFESSIONNEL;BAC PRO PROD;BAC PRO 25007 MAINTENANCE EQUIPEMENTS INDUST.;1;1;1;0;0;0;0;1;0;1;0;0;0;0
16437.0;2022;16;TOULOUSE;MASCULIN;FORMATION CONTINUE;BAC PROFESSIONNEL;BAC PRO PROD;BAC PRO 25510 METIERS ELECT. ENVIRON. CONNECTES;2;2;2;0;0;0;0;2;0;1;1;0;0;0
16442.0;2022;16;TOULOUSE;MASCULIN;INDIVIDUEL;BAC GENERAL;BAC GENERAL;BAC GENE 10019 BAC GENERAL;72;49;25;15;9;8;1;33;0;0;5;7;21;16
16444.0;2022;16;TOULOUSE;MASCULIN;INDIVIDUEL;BAC PROFESSIONNEL;BAC PRO PROD;BAC PRO 22106 CUISINE;1;1;1;0;0;0;0;1;0;0;0;1;0;0
16450.0;2022;16;TOULOUSE;MASCULIN;INDIVIDUEL;BAC PROFESSIONNEL;BAC PRO PROD;BAC PRO 25220 MAINT.MATERIELS OPT.B TP MANUT.;1;0;0;0;0;0;0;0;0;0;0;0;0;0
16462.0;2022;16;TOULOUSE;MASCULIN;INDIVIDUEL;BAC PROFESSIONNEL;BAC PRO SERV;BAC PRO 31213 MET.COM.VEN.OP.A ANI.GES.ESP.COM.;1;0;0;0;0;0;0;0;0;0;0;0;0;0
16464.0;2022;16;TOULOUSE;MASCULIN;INDIVIDUEL;BAC PROFESSIONNEL;BAC PRO SERV;BAC PRO 34403 METIERS DE LA SECURITE;1;1;0;0;1;1;0;1;0;0;0;0;1;0
16468.0;2022;16;TOULOUSE;MASCULIN;INDIVIDUEL;BAC TECHNOLOGIQUE;BAC STI2D;BAC STI2D INNOVATION TECHNO.  ET ECO CONCEPTION;2;0;0;0;0;0;0;0;0;0;0;0;0;0
16470.0;2022;16;TOULOUSE;MASCULIN;INDIVIDUEL;BAC TECHNOLOGIQUE;BAC STMG;BAC STMG GESTION ET FINANCE;4;3;1;2;0;0;0;1;0;0;0;0;1;2
16472.0;2022;16;TOULOUSE;MASCULIN;INDIVIDUEL;BAC TECHNOLOGIQUE;BAC STMG;BAC STMG RESSOURCES HUMAINES ET COMMUNICATION;3;0;0;0;0;0;0;0;0;0;0;0;0;0
16473.0;2022;16;TOULOUSE;MASCULIN;SCOLAIRE;BAC GENERAL;BAC GENERAL;BAC GENE 10019 BAC GENERAL;7023;7023;6490;104;429;293;136;6783;124;810;1708;2210;1931;240
16475.0;2022;16;TOULOUSE;MASCULIN;SCOLAIRE;BAC PROFESSIONNEL;BAC PRO PROD;BAC PRO 22003 BIO-INDUSTRIES DE TRANSFORMATION;18;18;17;1;0;0;0;17;0;1;2;8;6;1
16476.0;2022;16;TOULOUSE;MASCULIN;SCOLAIRE;BAC PROFESSIONNEL;BAC PRO PROD;BAC PRO 22004 PROC. CHIMIE EAU PAPIERS-CARTONS;11;11;8;3;0;0;0;8;0;1;2;2;3;3
16478.0;2022;16;TOULOUSE;MASCULIN;SCOLAIRE;BAC PROFESSIONNEL;BAC PRO PROD;BAC PRO 22105 BOULANGER-PÂTISSIER;40;40;35;4;1;1;0;36;0;0;12;16;8;4
16482.0;2022;16;TOULOUSE;MASCULIN;SCOLAIRE;BAC PROFESSIONNEL;BAC PRO PROD;BAC PRO 22703 TECHN.INSTALL.SYST.ENERG.CLIMATI;101;101;69;28;4;3;1;72;0;0;11;21;40;29
16489.0;2022;16;TOULOUSE;MASCULIN;SCOLAIRE;BAC PROFESSIONNEL;BAC PRO PROD;BACPRO 23103 TECHNICIEN GEOMETRE-TOPOGRAPHE;10;10;8;2;0;0;0;8;0;0;0;5;3;2
16490.0;2022;16;TOULOUSE;MASCULIN;SCOLAIRE;BAC PROFESSIONNEL;BAC PRO PROD;BAC PRO 23203 TECHNICIEN BAT. : ORG.REAL.GROS O;29;29;17;8;4;3;1;20;0;1;2;6;11;9
16496.0;2022;16;TOULOUSE;MASCULIN;SCOLAIRE;BAC PROFESSIONNEL;BAC PRO PROD;BAC PRO 23406 TECHNICIEN DE SCIERIE;7;7;7;0;0;0;0;7;0;1;3;0;3;0
16499.0;2022;16;TOULOUSE;MASCULIN;SCOLAIRE;BAC PROFESSIONNEL;BAC PRO PROD;BAC PRO 24202 ARTIS.& MET.ART : TAPIS.D'AMEUBL;4;4;3;1;0;0;0;3;0;0;0;3;0;1
16503.0;2022;16;TOULOUSE;MASCULIN;SCOLAIRE;BAC PROFESSIONNEL;BAC PRO PROD;BAC PRO 25007 MAINTENANCE EQUIPEMENTS INDUST.;250;249;185;56;8;7;1;192;0;7;26;70;89;57
16510.0;2022;16;TOULOUSE;MASCULIN;SCOLAIRE;BAC PROFESSIONNEL;BAC PRO PROD;BAC PRO 25219 MAINT.MATERIELS OPT.A AGRICOLES;53;53;42;10;1;1;0;43;0;4;8;18;13;10
16513.0;2022;16;TOULOUSE;MASCULIN;SCOLAIRE;BAC PROFESSIONNEL;BAC PRO PROD;BAC PRO 25302 AERONAUTIQUE OPTION AVIONIQUE;21;21;19;2;0;0;0;19;0;0;7;7;5;2
16515.0;2022;16;TOULOUSE;MASCULIN;SCOLAIRE;BAC PROFESSIONNEL;BAC PRO PROD;BAC PRO 25304 AERONAUTIQUE OPTION STRUCTURE;44;44;37;5;2;1;1;38;0;3;5;13;17;6
16516.0;2022;16;TOULOUSE;MASCULIN;SCOLAIRE;BAC PROFESSIONNEL;BAC PRO PROD;BAC PRO 25406 OUVRAGES DU BATIMENT METALLERIE;12;12;9;3;0;0;0;9;0;0;2;4;3;3
16517.0;2022;16;TOULOUSE;MASCULIN;SCOLAIRE;BAC PROFESSIONNEL;BAC PRO PROD;BAC PRO 25408 REPARATION DES CARROSSERIES;46;46;33;8;5;4;1;37;0;1;4;16;16;9
16529.0;2022;16;TOULOUSE;MASCULIN;SCOLAIRE;BAC PROFESSIONNEL;BAC PRO PROD;BAC PRO AG 21210 COND GEST ENTR CANIN ET FELIN;10;10;8;2;0;0;0;8;0;0;0;5;3;2
16541.0;2022;16;TOULOUSE;MASCULIN;SCOLAIRE;BAC PROFESSIONNEL;BAC PRO SERV;BAC PRO 31212 METIERS DE L'ACCUEIL;80;80;65;12;3;1;2;66;0;1;9;31;25;14
16548.0;2022;16;TOULOUSE;MASCULIN;SCOLAIRE;BAC PROFESSIONNEL;BAC PRO SERV;BAC PRO 33002 SERVICES DE PROXIMITE  VIE LOCAL;7;7;6;1;0;0;0;6;0;0;1;4;1;1
16550.0;2022;16;TOULOUSE;MASCULIN;SCOLAIRE;BAC PROFESSIONNEL;BAC PRO SERV;BAC PRO 33004 ACC.SOINS-S.PERS. OPT.EN STRUCTUR;40;40;33;3;4;3;1;36;0;1;6;13;16;4
16551.0;2022;16;TOULOUSE;MASCULIN;SCOLAIRE;BAC PROFESSIONNEL;BAC PRO SERV;BAC PRO 33101 OPTIQUE LUNETTERIE;6;6;6;0;0;0;0;6;0;0;0;4;2;0
16553.0;2022;16;TOULOUSE;MASCULIN;SCOLAIRE;BAC PROFESSIONNEL;BAC PRO SERV;BAC PRO 33103 TECHNICIEN APPAREIL. ORTHOPEDIQUE;8;8;8;0;0;0;0;8;0;0;2;4;2;0
16574.0;2022;16;TOULOUSE;MASCULIN;SCOLAIRE;BAC TECHNOLOGIQUE;BAC STMG;BAC STMG RESSOURCES HUMAINES ET COMMUNICATION;202;202;134;18;50;31;19;165;0;0;12;40;113;37
16577.0;2022;25;VERSAILLES;FEMININ;APPRENTISSAGE;BAC PROFESSIONNEL;BAC PRO PROD;BAC PRO 22106 CUISINE;33;33;24;3;6;0;6;24;0;2;7;4;11;9
16579.0;2022;25;VERSAILLES;FEMININ;APPRENTISSAGE;BAC PROFESSIONNEL;BAC PRO PROD;BAC PRO 23304 AMENAGEMENT FINITION BATIMENT;1;1;1;0;0;0;0;1;0;0;0;0;1;0
16582.0;2022;25;VERSAILLES;FEMININ;APPRENTISSAGE;BAC PROFESSIONNEL;BAC PRO PROD;BAC PRO 25214 MAINT.VEHIC.OPTA VOIT.PARTICUL.;7;7;6;1;0;0;0;6;0;2;2;2;0;1
16594.0;2022;25;VERSAILLES;FEMININ;APPRENTISSAGE;BAC PROFESSIONNEL;BAC PRO SERV;BAC PRO 31109 TRANSPORT FLUVIAL;1;1;1;0;0;0;0;1;0;0;1;0;0;0
16596.0;2022;25;VERSAILLES;FEMININ;APPRENTISSAGE;BAC PROFESSIONNEL;BAC PRO SERV;BAC PRO 31214 MET.COM.VEN.OP.B PR.CL.VA.OF.COM.;15;14;11;3;0;0;0;11;0;0;1;5;5;3
16598.0;2022;25;VERSAILLES;FEMININ;APPRENTISSAGE;BAC PROFESSIONNEL;BAC PRO SERV;BAC PRO 33102 PROTHESE DENTAIRE;1;1;1;0;0;0;0;1;0;0;0;1;0;0
16604.0;2022;25;VERSAILLES;FEMININ;ENSEIGNEMENT A DISTANCE;BAC GENERAL;BAC GENERAL;BAC GENE 10019 BAC GENERAL;112;112;90;11;11;4;7;94;1;9;21;32;31;18
16622.0;2022;25;VERSAILLES;FEMININ;FORMATION CONTINUE;BAC PROFESSIONNEL;BAC PRO SERV;BAC PRO 31212 METIERS DE L'ACCUEIL;3;3;2;1;0;0;0;2;0;0;0;2;0;1
16623.0;2022;25;VERSAILLES;FEMININ;FORMATION CONTINUE;BAC PROFESSIONNEL;BAC PRO SERV;BAC PRO 32303 ART.& MET.ART:COM.VIS.VIS.PLURI-M;2;2;2;0;0;0;0;2;0;0;1;0;1;0
16634.0;2022;25;VERSAILLES;FEMININ;INDIVIDUEL;BAC PROFESSIONNEL;BAC PRO SERV;BAC PRO 30001 GESTION-ADMINISTRATION;43;26;6;19;1;0;1;6;0;0;0;0;6;20
16642.0;2022;25;VERSAILLES;FEMININ;INDIVIDUEL;BAC PROFESSIONNEL;BAC PRO SERV;BAC PRO 33101 OPTIQUE LUNETTERIE;2;1;0;1;0;0;0;0;0;0;0;0;0;1
16665.0;2022;25;VERSAILLES;FEMININ;SCOLAIRE;BAC PROFESSIONNEL;BAC PRO PROD;BAC PRO 24203 METIERS DE LA MODE - VÊTEMENT;121;121;88;31;2;1;1;89;0;14;18;27;30;32
16667.0;2022;25;VERSAILLES;FEMININ;SCOLAIRE;BAC PROFESSIONNEL;BAC PRO PROD;BAC PRO 25006 MICROTECHNIQUES;2;2;2;0;0;0;0;2;0;0;1;0;1;0
16674.0;2022;25;VERSAILLES;FEMININ;SCOLAIRE;BAC PROFESSIONNEL;BAC PRO PROD;BAC PRO 25303 AERONAUTIQUE OPTION SYSTEMES;2;2;2;0;0;0;0;2;0;0;1;1;0;0
16676.0;2022;25;VERSAILLES;FEMININ;SCOLAIRE;BAC PROFESSIONNEL;BAC PRO PROD;BAC PRO 25406 OUVRAGES DU BATIMENT METALLERIE;1;1;1;0;0;0;0;1;0;0;0;0;1;0
16687.0;2022;25;VERSAILLES;FEMININ;SCOLAIRE;BAC PROFESSIONNEL;BAC PRO PROD;BAC PRO AG 21405 AMENAGEMENTS PAYSAGERS;4;3;3;0;0;0;0;3;0;0;1;1;1;0
16697.0;2022;25;VERSAILLES;FEMININ;SCOLAIRE;BAC PROFESSIONNEL;BAC PRO SERV;BAC PRO 32208 REAL.PR.IMPR.PLURI.OPTB.PR.IMPR.;7;7;7;0;0;0;0;7;0;2;1;2;2;0
16701.0;2022;25;VERSAILLES;FEMININ;SCOLAIRE;BAC PROFESSIONNEL;BAC PRO SERV;BAC PRO 33003 ACC.SOINS-S.PERS. OPT.A DOMICILE;79;79;71;4;4;4;0;75;0;4;25;21;25;4
16710.0;2022;25;VERSAILLES;FEMININ;SCOLAIRE;BAC TECHNOLOGIQUE;BAC S2TMD;BAC S2TMD MUSIQUE;3;3;3;0;0;0;0;3;0;1;1;1;0;0
16713.0;2022;25;VERSAILLES;FEMININ;SCOLAIRE;BAC TECHNOLOGIQUE;BAC STD2A;BAC STD2A SCIENCES & TECHNO. DESIGN-ARTS APPLIQUES;159;159;149;3;7;3;4;152;0;6;34;70;42;7
16716.0;2022;25;VERSAILLES;FEMININ;SCOLAIRE;BAC TECHNOLOGIQUE;BAC STI2D;BAC STI2D ENERGIES  ET ENVIRONNEMENT;20;20;18;0;2;2;0;20;0;0;1;7;12;0
16727.0;2022;25;VERSAILLES;MASCULIN;APPRENTISSAGE;BAC PROFESSIONNEL;BAC PRO PROD;BAC PRO 22703 TECHN.INSTALL.SYST.ENERG.CLIMATI;75;71;44;17;10;5;5;49;0;0;7;15;27;22
16729.0;2022;25;VERSAILLES;MASCULIN;APPRENTISSAGE;BAC PROFESSIONNEL;BAC PRO PROD;BAC PRO 23004 TECHN. ETUDES BAT.A ETUDES & ECO.;1;1;1;0;0;0;0;1;0;0;0;0;1;0
16732.0;2022;25;VERSAILLES;MASCULIN;APPRENTISSAGE;BAC PROFESSIONNEL;BAC PRO PROD;BAC PRO 23304 AMENAGEMENT FINITION BATIMENT;11;11;5;6;0;0;0;5;0;0;1;3;1;6
16737.0;2022;25;VERSAILLES;MASCULIN;APPRENTISSAGE;BAC PROFESSIONNEL;BAC PRO PROD;BAC PRO 25214 MAINT.VEHIC.OPTA VOIT.PARTICUL.;273;267;211;43;13;9;4;220;0;22;55;67;76;47
16741.0;2022;25;VERSAILLES;MASCULIN;APPRENTISSAGE;BAC PROFESSIONNEL;BAC PRO PROD;BAC PRO 25220 MAINT.MATERIELS OPT.B TP MANUT.;19;19;13;4;2;2;0;15;0;0;5;4;6;4
16745.0;2022;25;VERSAILLES;MASCULIN;APPRENTISSAGE;BAC PROFESSIONNEL;BAC PRO PROD;BAC PRO 25304 AERONAUTIQUE OPTION STRUCTURE;12;12;12;0;0;0;0;12;0;2;3;4;3;0
16751.0;2022;25;VERSAILLES;MASCULIN;APPRENTISSAGE;BAC PROFESSIONNEL;BAC PRO PROD;BAC PRO 25514 SYST.NUM.OPT.B AUD.RES.EQUIP.DOM.;1;1;1;0;0;0;0;1;0;0;0;0;1;0
16759.0;2022;25;VERSAILLES;MASCULIN;APPRENTISSAGE;BAC PROFESSIONNEL;BAC PRO SERV;BAC PRO 31108 TRANSPORT;1;1;0;0;1;0;1;0;0;0;0;0;0;1
16767.0;2022;25;VERSAILLES;MASCULIN;APPRENTISSAGE;BAC PROFESSIONNEL;BAC PRO SERV;BAC PRO AG 33002 SERV PERS TERRIT;1;1;0;1;0;0;0;0;0;0;0;0;0;1
16769.0;2022;25;VERSAILLES;MASCULIN;ENSEIGNEMENT A DISTANCE;BAC PROFESSIONNEL;BAC PRO PROD;BAC PRO 22704 TECHN. MAINT. SYST.ENERG.CLIMATI;1;0;0;0;0;0;0;0;0;0;0;0;0;0
16772.0;2022;25;VERSAILLES;MASCULIN;ENSEIGNEMENT A DISTANCE;BAC PROFESSIONNEL;BAC PRO SERV;BAC PRO 31214 MET.COM.VEN.OP.B PR.CL.VA.OF.COM.;3;1;1;0;0;0;0;1;0;0;0;0;1;0
16775.0;2022;25;VERSAILLES;MASCULIN;ENSEIGNEMENT A DISTANCE;BAC TECHNOLOGIQUE;BAC STMG;BAC STMG MERCATIQUE (MARKETING);16;15;12;2;1;1;0;13;0;0;1;6;6;2
16789.0;2022;25;VERSAILLES;MASCULIN;FORMATION CONTINUE;BAC PROFESSIONNEL;BAC PRO SERV;BAC PRO 33102 PROTHESE DENTAIRE;1;1;0;1;0;0;0;0;0;0;0;0;0;1
16790.0;2022;25;VERSAILLES;MASCULIN;FORMATION CONTINUE;BAC PROFESSIONNEL;BAC PRO SERV;BAC PRO 34303 GEST. POLLUTIONS PROTEC. ENVIRON.;5;5;4;1;0;0;0;4;0;1;2;0;1;1
16795.0;2022;25;VERSAILLES;MASCULIN;INDIVIDUEL;BAC PROFESSIONNEL;BAC PRO PROD;BAC PRO 22703 TECHN.INSTALL.SYST.ENERG.CLIMATI;3;2;2;0;0;0;0;2;0;0;0;1;1;0
16799.0;2022;25;VERSAILLES;MASCULIN;INDIVIDUEL;BAC PROFESSIONNEL;BAC PRO PROD;BAC PRO 23408 Etude et réalisation d'agencement;1;1;0;1;0;0;0;0;0;0;0;0;0;1
16806.0;2022;25;VERSAILLES;MASCULIN;INDIVIDUEL;BAC PROFESSIONNEL;BAC PRO PROD;BAC PRO 25509 TECHNIC. FROID CONDITIONNEMT AIR;1;1;1;0;0;0;0;1;0;0;0;1;0;0
16811.0;2022;25;VERSAILLES;MASCULIN;INDIVIDUEL;BAC PROFESSIONNEL;BAC PRO PROD;BAC PRO AG 21114 CONDUITE PRODUCTIONS HORTICOLES;9;6;6;0;0;0;0;6;0;0;0;0;6;0
16818.0;2022;25;VERSAILLES;MASCULIN;INDIVIDUEL;BAC PROFESSIONNEL;BAC PRO SERV;BAC PRO 31107 CONDUCT. TRANSP.ROUT.MARCHANDISES;1;1;0;1;0;0;0;0;0;0;0;0;0;1
16832.0;2022;25;VERSAILLES;MASCULIN;INDIVIDUEL;BAC TECHNOLOGIQUE;BAC STI2D;BAC STI2D ARCHITECTURE ET CONSTRUCTION;5;2;0;2;0;0;0;0;0;0;0;0;0;2
16836.0;2022;25;VERSAILLES;MASCULIN;INDIVIDUEL;BAC TECHNOLOGIQUE;BAC STL;BAC STL BIOCHIM.-BIOLOGIE-BIOTECHNOL.;1;1;0;1;0;0;0;0;0;0;0;0;0;1
16837.0;2022;25;VERSAILLES;MASCULIN;INDIVIDUEL;BAC TECHNOLOGIQUE;BAC STL;BAC STL SCIENCES PHYSIQUES CHIMIQUES  EN LABORAT.;1;0;0;0;0;0;0;0;0;0;0;0;0;0
16853.0;2022;25;VERSAILLES;MASCULIN;SCOLAIRE;BAC PROFESSIONNEL;BAC PRO PROD;BAC PRO 23005 TECHN. ETUDES BAT B ASSIST.ARCHI.;54;54;41;13;0;0;0;41;0;1;6;19;15;13
16854.0;2022;25;VERSAILLES;MASCULIN;SCOLAIRE;BAC PROFESSIONNEL;BAC PRO PROD;BAC PRO 23102 TRAVAUX PUBLICS;10;10;5;5;0;0;0;5;0;0;1;3;1;5
16856.0;2022;25;VERSAILLES;MASCULIN;SCOLAIRE;BAC PROFESSIONNEL;BAC PRO PROD;BAC PRO 23203 TECHNICIEN BAT. : ORG.REAL.GROS O;50;50;32;12;6;4;2;36;0;4;8;7;17;14
16858.0;2022;25;VERSAILLES;MASCULIN;SCOLAIRE;BAC PROFESSIONNEL;BAC PRO PROD;BAC PRO 23304 AMENAGEMENT FINITION BATIMENT;14;14;10;2;2;2;0;12;0;1;1;0;10;2
16860.0;2022;25;VERSAILLES;MASCULIN;SCOLAIRE;BAC PROFESSIONNEL;BAC PRO PROD;BAC PRO 23405 TECHNICIEN MENUISIER AGENCEUR;77;77;52;20;5;2;3;54;0;4;7;21;22;23
16869.0;2022;25;VERSAILLES;MASCULIN;SCOLAIRE;BAC PROFESSIONNEL;BAC PRO PROD;BAC PRO 25108 TECHNICIEN MODELEUR;18;18;17;1;0;0;0;17;0;2;5;5;5;1
16886.0;2022;25;VERSAILLES;MASCULIN;SCOLAIRE;BAC PROFESSIONNEL;BAC PRO PROD;BAC PRO 25514 SYST.NUM.OPT.B AUD.RES.EQUIP.DOM.;223;221;182;31;8;6;2;188;0;12;36;60;80;33
16887.0;2022;25;VERSAILLES;MASCULIN;SCOLAIRE;BAC PROFESSIONNEL;BAC PRO PROD;BAC PRO 25515 SYST.NUM.OPT.C RES.INF.SYST.COMM.;319;318;286;28;4;4;0;290;0;21;55;120;94;28
16905.0;2022;25;VERSAILLES;MASCULIN;SCOLAIRE;BAC PROFESSIONNEL;BAC PRO SERV;BAC PRO 32304 PHOTOGRAPHIE;12;12;10;2;0;0;0;10;0;1;0;5;4;2
16911.0;2022;25;VERSAILLES;MASCULIN;SCOLAIRE;BAC PROFESSIONNEL;BAC PRO SERV;BAC PRO 33403 COMMERC. SERVICES EN RESTAURATION;88;87;61;24;2;2;0;63;0;4;15;23;21;24
16921.0;2022;25;VERSAILLES;MASCULIN;SCOLAIRE;BAC TECHNOLOGIQUE;BAC STI2D;BAC STI2D ENERGIES  ET ENVIRONNEMENT;584;584;423;53;108;58;50;481;0;11;51;147;272;103
16922.0;2022;25;VERSAILLES;MASCULIN;SCOLAIRE;BAC TECHNOLOGIQUE;BAC STI2D;BAC STI2D INNOVATION TECHNO.  ET ECO CONCEPTION;733;733;586;36;111;69;42;655;1;10;83;205;356;78
16927.0;2022;25;VERSAILLES;MASCULIN;SCOLAIRE;BAC TECHNOLOGIQUE;BAC STMG;BAC STMG MERCATIQUE (MARKETING);1572;1572;1309;76;187;148;39;1457;0;24;158;525;750;115
16929.0;2022;25;VERSAILLES;MASCULIN;SCOLAIRE;BAC TECHNOLOGIQUE;BAC STMG;BAC STMG SYSTEMES D'INFORMATION DE GESTION;273;273;198;26;49;33;16;231;0;3;20;61;147;42
16932.0;2023;02;AIX-MARSEILLE;FEMININ;APPRENTISSAGE;BAC PROFESSIONNEL;BAC PRO PROD;BAC PRO 23102 TRAVAUX PUBLICS;1;1;1;0;0;0;0;1;0;0;1;0;0;0
16945.0;2023;02;AIX-MARSEILLE;FEMININ;APPRENTISSAGE;BAC PROFESSIONNEL;BAC PRO PROD;BAC PRO AG 21211 COND GEST ENTR HIPPIQUE;33;33;28;5;0;0;0;28;0;1;2;8;17;5
16946.0;2023;02;AIX-MARSEILLE;FEMININ;APPRENTISSAGE;BAC PROFESSIONNEL;BAC PRO PROD;BAC PRO AG 21405 AMENAGEMENTS PAYSAGERS;1;1;1;0;0;0;0;1;0;0;0;0;1;0
16952.0;2023;02;AIX-MARSEILLE;FEMININ;APPRENTISSAGE;BAC PROFESSIONNEL;BAC PRO SERV;BAC PRO 31214 MET.COM.VEN.OP.B PR.CL.VA.OF.COM.;11;11;8;2;1;1;0;9;0;0;2;1;6;2
16954.0;2023;02;AIX-MARSEILLE;FEMININ;APPRENTISSAGE;BAC PROFESSIONNEL;BAC PRO SERV;BAC PRO 33004 ACC.SOINS-S.PERS. OPT.EN STRUCTUR;1;1;1;0;0;0;0;1;0;0;0;1;0;0
16960.0;2023;02;AIX-MARSEILLE;FEMININ;APPRENTISSAGE;BAC PROFESSIONNEL;BAC PRO SERV;BAC PRO AG 33002 SERV PERS TERRIT;13;13;11;2;0;0;0;11;0;0;2;3;6;2
16961.0;2023;02;AIX-MARSEILLE;FEMININ;ENSEIGNEMENT A DISTANCE;BAC GENERAL;BAC GENERAL;BAC GENE 10019 BAC GENERAL;99;99;67;21;11;7;4;74;1;6;13;23;31;25
16969.0;2023;02;AIX-MARSEILLE;FEMININ;ENSEIGNEMENT A DISTANCE;BAC TECHNOLOGIQUE;BAC STMG;BAC STMG GESTION ET FINANCE;2;2;1;1;0;0;0;1;0;0;0;0;1;1
16971.0;2023;02;AIX-MARSEILLE;FEMININ;ENSEIGNEMENT A DISTANCE;BAC TECHNOLOGIQUE;BAC STMG;BAC STMG RESSOURCES HUMAINES ET COMMUNICATION;6;6;4;2;0;0;0;4;0;0;0;2;2;2
16974.0;2023;02;AIX-MARSEILLE;FEMININ;FORMATION CONTINUE;BAC PROFESSIONNEL;BAC PRO PROD;BAC PRO 25510 METIERS ELECT. ENVIRON. CONNECTES;1;1;1;0;0;0;0;1;0;0;0;1;0;0
16976.0;2023;02;AIX-MARSEILLE;FEMININ;FORMATION CONTINUE;BAC PROFESSIONNEL;BAC PRO SERV;BAC PRO 30004 ASSISTANC.GEST.ORGANIS.ACTIVITES;23;19;12;5;2;1;1;13;0;1;3;7;2;6
16983.0;2023;02;AIX-MARSEILLE;FEMININ;INDIVIDUEL;BAC GENERAL;BAC GENERAL;BAC GENE 10019 BAC GENERAL;161;160;53;86;21;11;10;64;1;6;10;23;24;96
16987.0;2023;02;AIX-MARSEILLE;FEMININ;INDIVIDUEL;BAC PROFESSIONNEL;BAC PRO PROD;BAC PRO 25220 MAINT.MATERIELS OPT.B TP MANUT.;1;1;1;0;0;0;0;1;0;1;0;0;0;0
16993.0;2023;02;AIX-MARSEILLE;FEMININ;INDIVIDUEL;BAC PROFESSIONNEL;BAC PRO SERV;BAC PRO 31212 METIERS DE L'ACCUEIL;3;2;2;0;0;0;0;2;0;0;0;0;2;0
16996.0;2023;02;AIX-MARSEILLE;FEMININ;INDIVIDUEL;BAC PROFESSIONNEL;BAC PRO SERV;BAC PRO 33003 ACC.SOINS-S.PERS. OPT.A DOMICILE;1;0;0;0;0;0;0;0;0;0;0;0;0;0
16997.0;2023;02;AIX-MARSEILLE;FEMININ;INDIVIDUEL;BAC PROFESSIONNEL;BAC PRO SERV;BAC PRO 33004 ACC.SOINS-S.PERS. OPT.EN STRUCTUR;4;2;1;1;0;0;0;1;0;0;0;0;1;1
16999.0;2023;02;AIX-MARSEILLE;FEMININ;INDIVIDUEL;BAC PROFESSIONNEL;BAC PRO SERV;BAC PRO 33603 ESTHETIQUE COSMETIQUE PARFUMERIE;5;4;2;2;0;0;0;2;0;0;0;0;2;2
17001.0;2023;02;AIX-MARSEILLE;FEMININ;INDIVIDUEL;BAC TECHNOLOGIQUE;BAC ST2S;BAC ST2S SCIENCES & TECHNO. SANTE & SOCIAL;16;16;1;14;1;0;1;1;0;0;0;0;1;15
17009.0;2023;02;AIX-MARSEILLE;FEMININ;INDIVIDUEL;BAC TECHNOLOGIQUE;BAC STMG;BAC STMG RESSOURCES HUMAINES ET COMMUNICATION;11;11;2;7;2;1;1;3;0;0;0;1;2;8
17017.0;2023;02;AIX-MARSEILLE;FEMININ;SCOLAIRE;BAC PROFESSIONNEL;BAC PRO PROD;BAC PRO 22703 TECHN.INSTALL.SYST.ENERG.CLIMATI;1;1;1;0;0;0;0;1;0;0;0;0;1;0
17019.0;2023;02;AIX-MARSEILLE;FEMININ;SCOLAIRE;BAC PROFESSIONNEL;BAC PRO PROD;BAC PRO 23005 TECHN. ETUDES BAT B ASSIST.ARCHI.;20;20;17;3;0;0;0;17;0;3;5;5;4;3
17025.0;2023;02;AIX-MARSEILLE;FEMININ;SCOLAIRE;BAC PROFESSIONNEL;BAC PRO PROD;BAC PRO 24203 METIERS DE LA MODE - VÊTEMENT;71;71;58;10;3;2;1;60;0;8;13;19;20;11
17026.0;2023;02;AIX-MARSEILLE;FEMININ;SCOLAIRE;BAC PROFESSIONNEL;BAC PRO PROD;BAC PRO 25006 MICROTECHNIQUES;2;2;2;0;0;0;0;2;0;0;0;0;2;0
17028.0;2023;02;AIX-MARSEILLE;FEMININ;SCOLAIRE;BAC PROFESSIONNEL;BAC PRO PROD;BAC PRO 25009 MAINTENANCE NAUTIQUE;1;1;0;1;0;0;0;0;0;0;0;0;0;1
17029.0;2023;02;AIX-MARSEILLE;FEMININ;SCOLAIRE;BAC PROFESSIONNEL;BAC PRO PROD;BAC PRO 25214 MAINT.VEHIC.OPTA VOIT.PARTICUL.;6;6;4;2;0;0;0;4;0;0;1;0;3;2
17034.0;2023;02;AIX-MARSEILLE;FEMININ;SCOLAIRE;BAC PROFESSIONNEL;BAC PRO PROD;BAC PRO 25411 TECH.CHAUDRONNERIE INDUSTRIELLE;3;3;3;0;0;0;0;3;0;0;1;0;2;0
17035.0;2023;02;AIX-MARSEILLE;FEMININ;SCOLAIRE;BAC PROFESSIONNEL;BAC PRO PROD;BAC PRO 25510 METIERS ELECT. ENVIRON. CONNECTES;6;6;5;0;1;1;0;6;0;0;2;2;2;0
17037.0;2023;02;AIX-MARSEILLE;FEMININ;SCOLAIRE;BAC PROFESSIONNEL;BAC PRO PROD;BAC PRO 25514 SYST.NUM.OPT.B AUD.RES.EQUIP.DOM.;5;5;4;1;0;0;0;4;0;1;2;1;0;1
17038.0;2023;02;AIX-MARSEILLE;FEMININ;SCOLAIRE;BAC PROFESSIONNEL;BAC PRO PROD;BAC PRO 25515 SYST.NUM.OPT.C RES.INF.SYST.COMM.;8;8;8;0;0;0;0;8;0;0;2;4;2;0
17042.0;2023;02;AIX-MARSEILLE;FEMININ;SCOLAIRE;BAC PROFESSIONNEL;BAC PRO PROD;BAC PRO AG 21203 TECHN CONSEIL DE VENTE ANIMAL;20;20;18;2;0;0;0;18;0;0;1;6;11;2
17051.0;2023;02;AIX-MARSEILLE;FEMININ;SCOLAIRE;BAC PROFESSIONNEL;BAC PRO SERV;BAC PRO 31106 LOGISTIQUE;2;2;1;1;0;0;0;1;0;0;0;0;1;1
17058.0;2023;02;AIX-MARSEILLE;FEMININ;SCOLAIRE;BAC PROFESSIONNEL;BAC PRO SERV;BAC PRO 32208 REAL.PR.IMPR.PLURI.OPTB.PR.IMPR.;2;2;2;0;0;0;0;2;0;0;0;1;1;0
17059.0;2023;02;AIX-MARSEILLE;FEMININ;SCOLAIRE;BAC PROFESSIONNEL;BAC PRO SERV;BAC PRO 32303 ART.& MET.ART:COM.VIS.VIS.PLURI-M;33;33;25;8;0;0;0;25;0;2;4;12;7;8
17061.0;2023;02;AIX-MARSEILLE;FEMININ;SCOLAIRE;BAC PROFESSIONNEL;BAC PRO SERV;BAC PRO 33003 ACC.SOINS-S.PERS. OPT.A DOMICILE;96;95;72;17;6;4;2;76;0;2;17;25;32;19
17062.0;2023;02;AIX-MARSEILLE;FEMININ;SCOLAIRE;BAC PROFESSIONNEL;BAC PRO SERV;BAC PRO 33004 ACC.SOINS-S.PERS. OPT.EN STRUCTUR;574;573;459;86;28;23;5;482;0;20;96;177;189;91
17070.0;2023;02;AIX-MARSEILLE;FEMININ;SCOLAIRE;BAC PROFESSIONNEL;BAC PRO SERV;BAC PRO 34304 HYGIENE PROPRETE STERILISATION;9;9;7;2;0;0;0;7;0;1;1;2;3;2
17075.0;2023;02;AIX-MARSEILLE;FEMININ;SCOLAIRE;BAC TECHNOLOGIQUE;BAC STD2A;BAC STD2A SCIENCES & TECHNO. DESIGN-ARTS APPLIQUES;158;158;146;2;10;9;1;155;1;10;30;65;49;3
17079.0;2023;02;AIX-MARSEILLE;FEMININ;SCOLAIRE;BAC TECHNOLOGIQUE;BAC STI2D;BAC STI2D INNOVATION TECHNO.  ET ECO CONCEPTION;25;25;19;1;5;4;1;23;0;0;2;9;12;2
17080.0;2023;02;AIX-MARSEILLE;FEMININ;SCOLAIRE;BAC TECHNOLOGIQUE;BAC STI2D;BAC STI2D SYSTÈME D'INFORMATION  ET NUMERIQUE;16;16;15;0;1;1;0;16;0;1;3;6;6;0
17081.0;2023;02;AIX-MARSEILLE;FEMININ;SCOLAIRE;BAC TECHNOLOGIQUE;BAC STL;BAC STL BIOCHIM.-BIOLOGIE-BIOTECHNOL.;94;94;81;0;13;9;4;90;0;2;23;26;39;4
17083.0;2023;02;AIX-MARSEILLE;FEMININ;SCOLAIRE;BAC TECHNOLOGIQUE;BAC STMG;BAC STMG GESTION ET FINANCE;340;340;293;12;35;23;12;316;0;14;64;113;125;24
17085.0;2023;02;AIX-MARSEILLE;FEMININ;SCOLAIRE;BAC TECHNOLOGIQUE;BAC STMG;BAC STMG RESSOURCES HUMAINES ET COMMUNICATION;666;666;517;34;115;80;35;597;0;4;55;175;363;69
17102.0;2023;02;AIX-MARSEILLE;MASCULIN;APPRENTISSAGE;BAC PROFESSIONNEL;BAC PRO PROD;BAC PRO 25009 MAINTENANCE NAUTIQUE;5;5;2;3;0;0;0;2;0;0;1;1;0;3
17104.0;2023;02;AIX-MARSEILLE;MASCULIN;APPRENTISSAGE;BAC PROFESSIONNEL;BAC PRO PROD;BAC PRO 25214 MAINT.VEHIC.OPTA VOIT.PARTICUL.;125;121;91;16;14;9;5;100;0;11;21;36;32;21
17110.0;2023;02;AIX-MARSEILLE;MASCULIN;APPRENTISSAGE;BAC PROFESSIONNEL;BAC PRO PROD;BAC PRO 25408 REPARATION DES CARROSSERIES;15;15;10;3;2;2;0;12;0;0;1;3;8;3
17112.0;2023;02;AIX-MARSEILLE;MASCULIN;APPRENTISSAGE;BAC PROFESSIONNEL;BAC PRO PROD;BAC PRO 25509 TECHNIC. FROID CONDITIONNEMT AIR;1;1;1;0;0;0;0;1;0;0;0;0;1;0
17116.0;2023;02;AIX-MARSEILLE;MASCULIN;APPRENTISSAGE;BAC PROFESSIONNEL;BAC PRO PROD;BAC PRO AG 21004 CGEA;5;5;5;0;0;0;0;5;0;0;1;2;2;0
17127.0;2023;02;AIX-MARSEILLE;MASCULIN;APPRENTISSAGE;BAC PROFESSIONNEL;BAC PRO SERV;BAC PRO 31212 METIERS DE L'ACCUEIL;1;1;0;1;0;0;0;0;0;0;0;0;0;1
17128.0;2023;02;AIX-MARSEILLE;MASCULIN;APPRENTISSAGE;BAC PROFESSIONNEL;BAC PRO SERV;BAC PRO 31213 MET.COM.VEN.OP.A ANI.GES.ESP.COM.;83;78;60;13;5;5;0;65;0;7;17;17;24;13
17129.0;2023;02;AIX-MARSEILLE;MASCULIN;APPRENTISSAGE;BAC PROFESSIONNEL;BAC PRO SERV;BAC PRO 31214 MET.COM.VEN.OP.B PR.CL.VA.OF.COM.;11;11;8;3;0;0;0;8;0;0;3;4;1;3
17136.0;2023;02;AIX-MARSEILLE;MASCULIN;APPRENTISSAGE;BAC PROFESSIONNEL;BAC PRO SERV;BAC PRO AG 33002 SERV PERS TERRIT;1;1;0;1;0;0;0;0;0;0;0;0;0;1
17139.0;2023;02;AIX-MARSEILLE;MASCULIN;ENSEIGNEMENT A DISTANCE;BAC PROFESSIONNEL;BAC PRO SERV;BAC PRO 31114 ORGANIS. TRANSPORT MARCHANDISES;1;0;0;0;0;0;0;0;0;0;0;0;0;0
17143.0;2023;02;AIX-MARSEILLE;MASCULIN;ENSEIGNEMENT A DISTANCE;BAC PROFESSIONNEL;BAC PRO SERV;BAC PRO 33101 OPTIQUE LUNETTERIE;1;0;0;0;0;0;0;0;0;0;0;0;0;0
17155.0;2023;02;AIX-MARSEILLE;MASCULIN;FORMATION CONTINUE;BAC PROFESSIONNEL;BAC PRO PROD;BAC PRO 25515 SYST.NUM.OPT.C RES.INF.SYST.COMM.;6;5;3;2;0;0;0;3;0;0;0;3;0;2
17157.0;2023;02;AIX-MARSEILLE;MASCULIN;FORMATION CONTINUE;BAC PROFESSIONNEL;BAC PRO SERV;BAC PRO 31212 METIERS DE L'ACCUEIL;3;3;2;1;0;0;0;2;0;1;0;0;1;1
17161.0;2023;02;AIX-MARSEILLE;MASCULIN;INDIVIDUEL;BAC GENERAL;BAC GENERAL;BAC GENE 10019 BAC GENERAL;133;131;44;70;17;11;6;55;2;3;8;11;31;76
17163.0;2023;02;AIX-MARSEILLE;MASCULIN;INDIVIDUEL;BAC PROFESSIONNEL;BAC PRO PROD;BAC PRO 22703 TECHN.INSTALL.SYST.ENERG.CLIMATI;2;1;1;0;0;0;0;1;0;1;0;0;0;0
17176.0;2023;02;AIX-MARSEILLE;MASCULIN;INDIVIDUEL;BAC PROFESSIONNEL;BAC PRO PROD;BAC PRO 25513 SYST.NUM.OPT.A SURETE SECURITE;1;1;1;0;0;0;0;1;0;0;0;0;1;0
17183.0;2023;02;AIX-MARSEILLE;MASCULIN;INDIVIDUEL;BAC PROFESSIONNEL;BAC PRO SERV;BAC PRO 30004 ASSISTANC.GEST.ORGANIS.ACTIVITES;5;2;2;0;0;0;0;2;0;0;0;0;2;0
17187.0;2023;02;AIX-MARSEILLE;MASCULIN;INDIVIDUEL;BAC PROFESSIONNEL;BAC PRO SERV;BAC PRO 31214 MET.COM.VEN.OP.B PR.CL.VA.OF.COM.;3;0;0;0;0;0;0;0;0;0;0;0;0;0
17189.0;2023;02;AIX-MARSEILLE;MASCULIN;INDIVIDUEL;BAC TECHNOLOGIQUE;BAC ST2S;BAC ST2S SCIENCES & TECHNO. SANTE & SOCIAL;6;6;0;5;1;1;0;1;0;0;0;0;1;5
17197.0;2023;02;AIX-MARSEILLE;MASCULIN;INDIVIDUEL;BAC TECHNOLOGIQUE;BAC STMG;BAC STMG MERCATIQUE (MARKETING);18;18;6;10;2;2;0;8;0;0;0;3;5;10
17200.0;2023;02;AIX-MARSEILLE;MASCULIN;SCOLAIRE;BAC GENERAL;BAC GENERAL;BAC GENE 10019 BAC GENERAL;7652;7652;7006;111;535;360;175;7366;166;948;1691;2201;2360;286
17201.0;2023;02;AIX-MARSEILLE;MASCULIN;SCOLAIRE;BAC PROFESSIONNEL;BAC PRO PROD;BACPRO 20002 ETUD.DEFINITION PRDTS INDUSTRIEL;32;32;22;8;2;2;0;24;0;0;4;13;7;8
17203.0;2023;02;AIX-MARSEILLE;MASCULIN;SCOLAIRE;BAC PROFESSIONNEL;BAC PRO PROD;BAC PRO 22003 BIO-INDUSTRIES DE TRANSFORMATION;3;3;2;1;0;0;0;2;0;0;0;1;1;1
17204.0;2023;02;AIX-MARSEILLE;MASCULIN;SCOLAIRE;BAC PROFESSIONNEL;BAC PRO PROD;BAC PRO 22004 PROC. CHIMIE EAU PAPIERS-CARTONS;34;33;19;11;3;1;2;20;0;1;3;3;13;13
17207.0;2023;02;AIX-MARSEILLE;MASCULIN;SCOLAIRE;BAC PROFESSIONNEL;BAC PRO PROD;BAC PRO 22403 ARTS.& MET.ART:MET.ENSEIGN SIGNA;5;5;3;1;1;0;1;3;0;0;2;1;0;2
17208.0;2023;02;AIX-MARSEILLE;MASCULIN;SCOLAIRE;BAC PROFESSIONNEL;BAC PRO PROD;BAC PRO 22503 PLASTIQUES ET COMPOSITES;5;5;2;3;0;0;0;2;0;0;0;1;1;3
17209.0;2023;02;AIX-MARSEILLE;MASCULIN;SCOLAIRE;BAC PROFESSIONNEL;BAC PRO PROD;BAC PRO 22703 TECHN.INSTALL.SYST.ENERG.CLIMATI;50;49;34;14;1;0;1;34;0;1;8;11;14;15
17220.0;2023;02;AIX-MARSEILLE;MASCULIN;SCOLAIRE;BAC PROFESSIONNEL;BAC PRO PROD;BAC PRO 23405 TECHNICIEN MENUISIER AGENCEUR;63;63;45;17;1;0;1;45;0;1;6;17;21;18
17223.0;2023;02;AIX-MARSEILLE;MASCULIN;SCOLAIRE;BAC PROFESSIONNEL;BAC PRO PROD;BAC PRO 25006 MICROTECHNIQUES;28;28;22;4;2;1;1;23;0;2;2;6;13;5
17227.0;2023;02;AIX-MARSEILLE;MASCULIN;SCOLAIRE;BAC PROFESSIONNEL;BAC PRO PROD;BAC PRO 25107 TECHNICIEN OUTILLEUR;9;9;7;2;0;0;0;7;0;0;0;6;1;2
17234.0;2023;02;AIX-MARSEILLE;MASCULIN;SCOLAIRE;BAC PROFESSIONNEL;BAC PRO PROD;BAC PRO 25302 AERONAUTIQUE OPTION AVIONIQUE;12;12;10;0;2;1;1;11;0;0;3;2;6;1
17235.0;2023;02;AIX-MARSEILLE;MASCULIN;SCOLAIRE;BAC PROFESSIONNEL;BAC PRO PROD;BAC PRO 25303 AERONAUTIQUE OPTION SYSTEMES;18;18;16;1;1;1;0;17;0;1;1;8;7;1
17244.0;2023;02;AIX-MARSEILLE;MASCULIN;SCOLAIRE;BAC PROFESSIONNEL;BAC PRO PROD;BAC PRO 25515 SYST.NUM.OPT.C RES.INF.SYST.COMM.;296;296;245;46;5;3;2;248;0;16;54;96;82;48
17246.0;2023;02;AIX-MARSEILLE;MASCULIN;SCOLAIRE;BAC PROFESSIONNEL;BAC PRO PROD;BAC PRO AG 21004 CGEA;21;20;19;1;0;0;0;19;0;1;2;7;9;1
17250.0;2023;02;AIX-MARSEILLE;MASCULIN;SCOLAIRE;BAC PROFESSIONNEL;BAC PRO PROD;BAC PRO AG 21210 COND GEST ENTR CANIN ET FELIN;8;8;6;2;0;0;0;6;0;0;0;2;4;2
17252.0;2023;02;AIX-MARSEILLE;MASCULIN;SCOLAIRE;BAC PROFESSIONNEL;BAC PRO PROD;BAC PRO AG 21302 GEST MILIEUX NATURELS FAUNE;62;61;54;7;0;0;0;54;0;4;6;16;28;7
17253.0;2023;02;AIX-MARSEILLE;MASCULIN;SCOLAIRE;BAC PROFESSIONNEL;BAC PRO PROD;BAC PRO AG 21303 FORET;10;10;9;1;0;0;0;9;0;0;0;4;5;1
17257.0;2023;02;AIX-MARSEILLE;MASCULIN;SCOLAIRE;BAC PROFESSIONNEL;BAC PRO SERV;BAC PRO 30004 ASSISTANC.GEST.ORGANIS.ACTIVITES;274;274;193;73;8;6;2;199;0;3;23;76;97;75
17266.0;2023;02;AIX-MARSEILLE;MASCULIN;SCOLAIRE;BAC PROFESSIONNEL;BAC PRO SERV;BAC PRO 32303 ART.& MET.ART:COM.VIS.VIS.PLURI-M;24;23;15;7;1;1;0;16;0;2;5;3;6;7
17272.0;2023;02;AIX-MARSEILLE;MASCULIN;SCOLAIRE;BAC PROFESSIONNEL;BAC PRO SERV;BAC PRO 33103 TECHNICIEN APPAREIL. ORTHOPEDIQUE;5;5;4;0;1;1;0;5;0;0;0;1;4;0
17275.0;2023;02;AIX-MARSEILLE;MASCULIN;SCOLAIRE;BAC PROFESSIONNEL;BAC PRO SERV;BAC PRO 33604 METIERS DE LA COIFFURE;5;5;3;2;0;0;0;3;0;0;1;1;1;2
17285.0;2023;02;AIX-MARSEILLE;MASCULIN;SCOLAIRE;BAC TECHNOLOGIQUE;BAC STI2D;BAC STI2D ENERGIES  ET ENVIRONNEMENT;201;201;164;7;30;19;11;183;0;6;29;72;76;18
17299.0;2023;20;AMIENS;FEMININ;APPRENTISSAGE;BAC PROFESSIONNEL;BAC PRO PROD;BAC PRO 25007 MAINTENANCE EQUIPEMENTS INDUST.;1;1;1;0;0;0;0;1;0;0;0;1;0;0
17302.0;2023;20;AMIENS;FEMININ;APPRENTISSAGE;BAC PROFESSIONNEL;BAC PRO PROD;BAC PRO 25408 REPARATION DES CARROSSERIES;2;2;2;0;0;0;0;2;0;1;1;0;0;0
17308.0;2023;20;AMIENS;FEMININ;APPRENTISSAGE;BAC PROFESSIONNEL;BAC PRO SERV;BAC PRO 30004 ASSISTANC.GEST.ORGANIS.ACTIVITES;21;21;21;0;0;0;0;21;0;5;6;5;5;0
17314.0;2023;20;AMIENS;FEMININ;ENSEIGNEMENT A DISTANCE;BAC GENERAL;BAC GENERAL;BAC GENE 10019 BAC GENERAL;49;49;23;17;9;7;2;30;0;1;8;9;12;19
17324.0;2023;20;AMIENS;FEMININ;INDIVIDUEL;BAC GENERAL;BAC GENERAL;BAC GENE 10019 BAC GENERAL;56;56;21;25;10;4;6;25;1;6;6;4;8;31
17334.0;2023;20;AMIENS;FEMININ;INDIVIDUEL;BAC PROFESSIONNEL;BAC PRO SERV;BAC PRO 31214 MET.COM.VEN.OP.B PR.CL.VA.OF.COM.;3;2;1;1;0;0;0;1;0;0;0;0;1;1
17336.0;2023;20;AMIENS;FEMININ;INDIVIDUEL;BAC PROFESSIONNEL;BAC PRO SERV;BAC PRO 33004 ACC.SOINS-S.PERS. OPT.EN STRUCTUR;6;2;2;0;0;0;0;2;0;0;0;1;1;0
17337.0;2023;20;AMIENS;FEMININ;INDIVIDUEL;BAC PROFESSIONNEL;BAC PRO SERV;BAC PRO 33101 OPTIQUE LUNETTERIE;2;2;1;1;0;0;0;1;0;0;0;0;1;1
17339.0;2023;20;AMIENS;FEMININ;INDIVIDUEL;BAC TECHNOLOGIQUE;BAC ST2S;BAC ST2S SCIENCES & TECHNO. SANTE & SOCIAL;12;12;3;9;0;0;0;3;0;0;0;1;2;9
17346.0;2023;20;AMIENS;FEMININ;INDIVIDUEL;BAC TECHNOLOGIQUE;BAC STMG;BAC STMG SYSTEMES D'INFORMATION DE GESTION;1;1;0;1;0;0;0;0;0;0;0;0;0;1
17350.0;2023;20;AMIENS;FEMININ;SCOLAIRE;BAC PROFESSIONNEL;BAC PRO PROD;BAC PRO 22004 PROC. CHIMIE EAU PAPIERS-CARTONS;4;4;3;0;1;1;0;4;0;0;2;1;1;0
17352.0;2023;20;AMIENS;FEMININ;SCOLAIRE;BAC PROFESSIONNEL;BAC PRO PROD;BAC PRO 22105 BOULANGER-PÂTISSIER;12;12;11;1;0;0;0;11;0;3;3;4;1;1
17357.0;2023;20;AMIENS;FEMININ;SCOLAIRE;BAC PROFESSIONNEL;BAC PRO PROD;BAC PRO 23005 TECHN. ETUDES BAT B ASSIST.ARCHI.;6;6;5;0;1;1;0;6;0;0;1;2;3;0
17360.0;2023;20;AMIENS;FEMININ;SCOLAIRE;BAC PROFESSIONNEL;BAC PRO PROD;BAC PRO 23405 TECHNICIEN MENUISIER AGENCEUR;5;5;4;1;0;0;0;4;0;0;1;0;3;1
17361.0;2023;20;AMIENS;FEMININ;SCOLAIRE;BAC PROFESSIONNEL;BAC PRO PROD;BAC PRO 24202 ARTIS.& MET.ART : TAPIS.D'AMEUBL;5;5;5;0;0;0;0;5;0;0;3;1;1;0
17368.0;2023;20;AMIENS;FEMININ;SCOLAIRE;BAC PROFESSIONNEL;BAC PRO PROD;BAC PRO 25216 MAINT.VEHIC.OPTC MOTOCYCLES;1;1;1;0;0;0;0;1;0;0;0;0;1;0
17370.0;2023;20;AMIENS;FEMININ;SCOLAIRE;BAC PROFESSIONNEL;BAC PRO PROD;BAC PRO 25303 AERONAUTIQUE OPTION SYSTEMES;1;1;1;0;0;0;0;1;0;0;1;0;0;0
17372.0;2023;20;AMIENS;FEMININ;SCOLAIRE;BAC PROFESSIONNEL;BAC PRO PROD;BAC PRO 25411 TECH.CHAUDRONNERIE INDUSTRIELLE;1;1;1;0;0;0;0;1;0;0;0;0;1;0
17389.0;2023;20;AMIENS;FEMININ;SCOLAIRE;BAC PROFESSIONNEL;BAC PRO SERV;BAC PRO 31114 ORGANIS. TRANSPORT MARCHANDISES;1;1;1;0;0;0;0;1;0;0;1;0;0;0
17393.0;2023;20;AMIENS;FEMININ;SCOLAIRE;BAC PROFESSIONNEL;BAC PRO SERV;BAC PRO 32207 REAL.PR.IMPR.PLURI.OPTA.PR.GRAPH.;5;5;4;1;0;0;0;4;0;0;1;2;1;1
17394.0;2023;20;AMIENS;FEMININ;SCOLAIRE;BAC PROFESSIONNEL;BAC PRO SERV;BAC PRO 32303 ART.& MET.ART:COM.VIS.VIS.PLURI-M;28;28;26;2;0;0;0;26;0;1;6;8;11;2
17396.0;2023;20;AMIENS;FEMININ;SCOLAIRE;BAC PROFESSIONNEL;BAC PRO SERV;BAC PRO 33004 ACC.SOINS-S.PERS. OPT.EN STRUCTUR;445;441;357;68;16;9;7;366;0;27;90;157;92;75
17397.0;2023;20;AMIENS;FEMININ;SCOLAIRE;BAC PROFESSIONNEL;BAC PRO SERV;BAC PRO 33006 ANIMAT. ENFANCE& PERSONNES AGEES;41;41;34;5;2;2;0;36;0;6;11;12;7;5
17401.0;2023;20;AMIENS;FEMININ;SCOLAIRE;BAC PROFESSIONNEL;BAC PRO SERV;BAC PRO 33604 METIERS DE LA COIFFURE;34;34;27;7;0;0;0;27;0;2;7;4;14;7
17413.0;2023;20;AMIENS;FEMININ;SCOLAIRE;BAC TECHNOLOGIQUE;BAC STL;BAC STL BIOCHIM.-BIOLOGIE-BIOTECHNOL.;74;74;55;3;16;10;6;65;0;5;11;19;30;9
17415.0;2023;20;AMIENS;FEMININ;SCOLAIRE;BAC TECHNOLOGIQUE;BAC STMG;BAC STMG GESTION ET FINANCE;199;199;163;11;25;19;6;182;0;9;24;47;102;17
17418.0;2023;20;AMIENS;FEMININ;SCOLAIRE;BAC TECHNOLOGIQUE;BAC STMG;BAC STMG SYSTEMES D'INFORMATION DE GESTION;11;11;6;0;5;3;2;9;0;0;0;1;8;2
17424.0;2023;20;AMIENS;MASCULIN;APPRENTISSAGE;BAC PROFESSIONNEL;BAC PRO PROD;BAC PRO 23005 TECHN. ETUDES BAT B ASSIST.ARCHI.;1;1;1;0;0;0;0;1;0;0;0;0;1;0
17425.0;2023;20;AMIENS;MASCULIN;APPRENTISSAGE;BAC PROFESSIONNEL;BAC PRO PROD;BAC PRO 23102 TRAVAUX PUBLICS;21;21;14;6;1;1;0;15;0;1;1;5;8;6
17428.0;2023;20;AMIENS;MASCULIN;APPRENTISSAGE;BAC PROFESSIONNEL;BAC PRO PROD;BAC PRO 23404 TECHNICIEN CONSTRUCTEUR BOIS;1;1;0;1;0;0;0;0;0;0;0;0;0;1
17441.0;2023;20;AMIENS;MASCULIN;APPRENTISSAGE;BAC PROFESSIONNEL;BAC PRO PROD;BAC PRO 25408 REPARATION DES CARROSSERIES;19;17;15;1;1;1;0;16;0;1;1;9;5;1
17445.0;2023;20;AMIENS;MASCULIN;APPRENTISSAGE;BAC PROFESSIONNEL;BAC PRO PROD;BAC PRO 25515 SYST.NUM.OPT.C RES.INF.SYST.COMM.;1;1;1;0;0;0;0;1;0;0;1;0;0;0
17446.0;2023;20;AMIENS;MASCULIN;APPRENTISSAGE;BAC PROFESSIONNEL;BAC PRO PROD;BAC PRO AG 21001 AGRO-EQUIPEMENT;20;20;19;1;0;0;0;19;0;0;3;4;12;1
17455.0;2023;20;AMIENS;MASCULIN;APPRENTISSAGE;BAC PROFESSIONNEL;BAC PRO SERV;BAC PRO 31213 MET.COM.VEN.OP.A ANI.GES.ESP.COM.;30;30;24;4;2;2;0;26;0;1;5;14;6;4
17465.0;2023;20;AMIENS;MASCULIN;FORMATION CONTINUE;BAC PROFESSIONNEL;BAC PRO PROD;BACPRO 23103 TECHNICIEN GEOMETRE-TOPOGRAPHE;1;1;1;0;0;0;0;1;0;0;1;0;0;0
17471.0;2023;20;AMIENS;MASCULIN;INDIVIDUEL;BAC PROFESSIONNEL;BAC PRO PROD;BAC PRO 25221 MAINT.MATERIELS OPT.C ESP. VERTS;1;0;0;0;0;0;0;0;0;0;0;0;0;0
17472.0;2023;20;AMIENS;MASCULIN;INDIVIDUEL;BAC PROFESSIONNEL;BAC PRO PROD;BAC PRO 25513 SYST.NUM.OPT.A SURETE SECURITE;1;1;1;0;0;0;0;1;0;0;0;0;1;0
17474.0;2023;20;AMIENS;MASCULIN;INDIVIDUEL;BAC PROFESSIONNEL;BAC PRO PROD;BAC PRO AG 21211 COND GEST ENTR HIPPIQUE;1;1;1;0;0;0;0;1;0;0;0;0;1;0
17477.0;2023;20;AMIENS;MASCULIN;INDIVIDUEL;BAC PROFESSIONNEL;BAC PRO SERV;BAC PRO 31212 METIERS DE L'ACCUEIL;1;0;0;0;0;0;0;0;0;0;0;0;0;0
17488.0;2023;20;AMIENS;MASCULIN;INDIVIDUEL;BAC TECHNOLOGIQUE;BAC STMG;BAC STMG RESSOURCES HUMAINES ET COMMUNICATION;2;2;0;1;1;1;0;1;0;0;0;0;1;1
17502.0;2023;20;AMIENS;MASCULIN;SCOLAIRE;BAC PROFESSIONNEL;BAC PRO PROD;BAC PRO 23005 TECHN. ETUDES BAT B ASSIST.ARCHI.;20;20;18;1;1;1;0;19;0;1;4;8;6;1
17509.0;2023;20;AMIENS;MASCULIN;SCOLAIRE;BAC PROFESSIONNEL;BAC PRO PROD;BAC PRO 23404 TECHNICIEN CONSTRUCTEUR BOIS;13;13;8;5;0;0;0;8;0;1;2;3;2;5
17515.0;2023;20;AMIENS;MASCULIN;SCOLAIRE;BAC PROFESSIONNEL;BAC PRO PROD;BAC PRO 25007 MAINTENANCE EQUIPEMENTS INDUST.;193;192;126;55;11;5;6;131;0;3;18;50;60;61
17516.0;2023;20;AMIENS;MASCULIN;SCOLAIRE;BAC PROFESSIONNEL;BAC PRO PROD;BAC PRO 25009 MAINTENANCE NAUTIQUE;2;2;1;1;0;0;0;1;0;0;0;1;0;1
17518.0;2023;20;AMIENS;MASCULIN;SCOLAIRE;BAC PROFESSIONNEL;BAC PRO PROD;BAC PRO 25108 TECHNICIEN MODELEUR;11;11;8;1;2;1;1;9;0;1;2;1;5;2
17525.0;2023;20;AMIENS;MASCULIN;SCOLAIRE;BAC PROFESSIONNEL;BAC PRO PROD;BAC PRO 25303 AERONAUTIQUE OPTION SYSTEMES;18;18;17;1;0;0;0;17;0;0;3;8;6;1
17536.0;2023;20;AMIENS;MASCULIN;SCOLAIRE;BAC PROFESSIONNEL;BAC PRO PROD;BAC PRO AG 21114 CONDUITE PRODUCTIONS HORTICOLES;5;5;3;2;0;0;0;3;0;0;1;1;1;2
17540.0;2023;20;AMIENS;MASCULIN;SCOLAIRE;BAC PROFESSIONNEL;BAC PRO PROD;BAC PRO AG 21302 GEST MILIEUX NATURELS FAUNE;59;59;55;4;0;0;0;55;0;3;10;18;24;4
17543.0;2023;20;AMIENS;MASCULIN;SCOLAIRE;BAC PROFESSIONNEL;BAC PRO PROD;BAC PRO AG 22108 TEC CONS VTE ALIMENTATION (PAB);8;8;7;1;0;0;0;7;0;0;1;2;4;1
17549.0;2023;20;AMIENS;MASCULIN;SCOLAIRE;BAC PROFESSIONNEL;BAC PRO SERV;BAC PRO 31213 MET.COM.VEN.OP.A ANI.GES.ESP.COM.;325;324;232;79;13;10;3;242;0;4;48;72;118;82
17552.0;2023;20;AMIENS;MASCULIN;SCOLAIRE;BAC PROFESSIONNEL;BAC PRO SERV;BAC PRO 32303 ART.& MET.ART:COM.VIS.VIS.PLURI-M;22;22;17;5;0;0;0;17;0;2;2;8;5;5
17554.0;2023;20;AMIENS;MASCULIN;SCOLAIRE;BAC PROFESSIONNEL;BAC PRO SERV;BAC PRO 33004 ACC.SOINS-S.PERS. OPT.EN STRUCTUR;28;27;24;3;0;0;0;24;0;4;7;9;4;3
17564.0;2023;20;AMIENS;MASCULIN;SCOLAIRE;BAC TECHNOLOGIQUE;BAC STD2A;BAC STD2A SCIENCES & TECHNO. DESIGN-ARTS APPLIQUES;18;18;18;0;0;0;0;18;0;1;6;6;5;0
17570.0;2023;20;AMIENS;MASCULIN;SCOLAIRE;BAC TECHNOLOGIQUE;BAC STL;BAC STL BIOCHIM.-BIOLOGIE-BIOTECHNOL.;25;25;20;2;3;0;3;20;0;1;7;7;5;5
17571.0;2023;20;AMIENS;MASCULIN;SCOLAIRE;BAC TECHNOLOGIQUE;BAC STL;BAC STL SCIENCES PHYSIQUES CHIMIQUES  EN LABORAT.;51;51;42;1;8;5;3;47;0;2;9;16;20;4
17572.0;2023;20;AMIENS;MASCULIN;SCOLAIRE;BAC TECHNOLOGIQUE;BAC STMG;BAC STMG GESTION ET FINANCE;251;251;170;18;63;46;17;216;0;1;13;49;153;35
17574.0;2023;20;AMIENS;MASCULIN;SCOLAIRE;BAC TECHNOLOGIQUE;BAC STMG;BAC STMG RESSOURCES HUMAINES ET COMMUNICATION;195;195;104;29;62;43;19;147;0;1;3;34;109;48
17585.0;2023;03;BESANCON;FEMININ;APPRENTISSAGE;BAC PROFESSIONNEL;BAC PRO PROD;BAC PRO AG 21114 CONDUITE PRODUCTIONS HORTICOLES;1;1;1;0;0;0;0;1;0;0;0;1;0;0
17587.0;2023;03;BESANCON;FEMININ;APPRENTISSAGE;BAC PROFESSIONNEL;BAC PRO PROD;BAC PRO AG 21211 COND GEST ENTR HIPPIQUE;12;12;11;1;0;0;0;11;0;0;2;3;6;1
17591.0;2023;03;BESANCON;FEMININ;APPRENTISSAGE;BAC PROFESSIONNEL;BAC PRO PROD;BAC PRO AG 21407 TEC CONS VTE UNIVERS JARDINERIE;3;3;2;1;0;0;0;2;0;0;0;0;2;1
17593.0;2023;03;BESANCON;FEMININ;APPRENTISSAGE;BAC PROFESSIONNEL;BAC PRO SERV;BAC PRO 30004 ASSISTANC.GEST.ORGANIS.ACTIVITES;17;17;14;3;0;0;0;14;0;2;5;6;1;3
17609.0;2023;03;BESANCON;FEMININ;ENSEIGNEMENT A DISTANCE;BAC PROFESSIONNEL;BAC PRO SERV;BAC PRO 33003 ACC.SOINS-S.PERS. OPT.A DOMICILE;2;2;0;2;0;0;0;0;0;0;0;0;0;2
17611.0;2023;03;BESANCON;FEMININ;ENSEIGNEMENT A DISTANCE;BAC TECHNOLOGIQUE;BAC ST2S;BAC ST2S SCIENCES & TECHNO. SANTE & SOCIAL;3;3;1;0;2;1;1;2;0;0;0;0;2;1
17612.0;2023;03;BESANCON;FEMININ;ENSEIGNEMENT A DISTANCE;BAC TECHNOLOGIQUE;BAC STMG;BAC STMG MERCATIQUE (MARKETING);1;1;1;0;0;0;0;1;0;0;1;0;0;0
17616.0;2023;03;BESANCON;FEMININ;INDIVIDUEL;BAC PROFESSIONNEL;BAC PRO PROD;BAC PRO AG 21004 CGEA;1;1;0;1;0;0;0;0;0;0;0;0;0;1
17622.0;2023;03;BESANCON;FEMININ;SCOLAIRE;BAC PROFESSIONNEL;BAC PRO PROD;BAC PRO 22004 PROC. CHIMIE EAU PAPIERS-CARTONS;9;9;7;2;0;0;0;7;0;0;1;2;4;2
17623.0;2023;03;BESANCON;FEMININ;SCOLAIRE;BAC PROFESSIONNEL;BAC PRO PROD;BAC PRO 22106 CUISINE;41;41;33;3;5;3;2;36;0;3;5;12;16;5
17624.0;2023;03;BESANCON;FEMININ;SCOLAIRE;BAC PROFESSIONNEL;BAC PRO PROD;BAC PRO 23004 TECHN. ETUDES BAT.A ETUDES & ECO.;3;3;1;2;0;0;0;1;0;0;0;0;1;2
17633.0;2023;03;BESANCON;FEMININ;SCOLAIRE;BAC PROFESSIONNEL;BAC PRO PROD;BAC PRO 24302 METIERS DU CUIR : MAROQUINERIE;13;13;13;0;0;0;0;13;0;1;7;2;3;0
17641.0;2023;03;BESANCON;FEMININ;SCOLAIRE;BAC PROFESSIONNEL;BAC PRO PROD;BAC PRO 25510 METIERS ELECT. ENVIRON. CONNECTES;1;1;0;1;0;0;0;0;0;0;0;0;0;1
17642.0;2023;03;BESANCON;FEMININ;SCOLAIRE;BAC PROFESSIONNEL;BAC PRO PROD;BAC PRO 25513 SYST.NUM.OPT.A SURETE SECURITE;1;1;1;0;0;0;0;1;0;0;0;0;1;0
17645.0;2023;03;BESANCON;FEMININ;SCOLAIRE;BAC PROFESSIONNEL;BAC PRO PROD;BAC PRO AG 21114 CONDUITE PRODUCTIONS HORTICOLES;2;2;2;0;0;0;0;2;0;0;0;2;0;0
17650.0;2023;03;BESANCON;FEMININ;SCOLAIRE;BAC PROFESSIONNEL;BAC PRO PROD;BAC PRO AG 21407 TEC CONS VTE UNIVERS JARDINERIE;6;6;5;1;0;0;0;5;0;1;0;1;3;1
17651.0;2023;03;BESANCON;FEMININ;SCOLAIRE;BAC PROFESSIONNEL;BAC PRO PROD;BAC PRO AG 22108 TEC CONS VTE ALIMENTATION (PAB);19;19;17;2;0;0;0;17;0;0;1;6;10;2
17654.0;2023;03;BESANCON;FEMININ;SCOLAIRE;BAC PROFESSIONNEL;BAC PRO SERV;BAC PRO 31107 CONDUCT. TRANSP.ROUT.MARCHANDISES;7;7;5;2;0;0;0;5;0;1;3;1;0;2
17658.0;2023;03;BESANCON;FEMININ;SCOLAIRE;BAC PROFESSIONNEL;BAC PRO SERV;BAC PRO 31214 MET.COM.VEN.OP.B PR.CL.VA.OF.COM.;61;61;48;9;4;4;0;52;0;2;10;20;20;9
17662.0;2023;03;BESANCON;FEMININ;SCOLAIRE;BAC PROFESSIONNEL;BAC PRO SERV;BAC PRO 33101 OPTIQUE LUNETTERIE;18;18;17;1;0;0;0;17;0;3;6;5;3;1
17670.0;2023;03;BESANCON;FEMININ;SCOLAIRE;BAC TECHNOLOGIQUE;BAC S2TMD;BAC S2TMD MUSIQUE;2;2;2;0;0;0;0;2;0;1;0;0;1;0
17673.0;2023;03;BESANCON;FEMININ;SCOLAIRE;BAC TECHNOLOGIQUE;BAC STD2A;BAC STD2A SCIENCES & TECHNO. DESIGN-ARTS APPLIQUES;38;38;38;0;0;0;0;38;0;5;11;15;7;0
17675.0;2023;03;BESANCON;FEMININ;SCOLAIRE;BAC TECHNOLOGIQUE;BAC STI2D;BAC STI2D ARCHITECTURE ET CONSTRUCTION;5;5;4;0;1;1;0;5;0;0;3;0;2;0
17679.0;2023;03;BESANCON;FEMININ;SCOLAIRE;BAC TECHNOLOGIQUE;BAC STL;BAC STL BIOCHIM.-BIOLOGIE-BIOTECHNOL.;48;48;40;1;7;6;1;46;0;2;8;12;24;2
17688.0;2023;03;BESANCON;MASCULIN;APPRENTISSAGE;BAC PROFESSIONNEL;BAC PRO PROD;BAC PRO 22703 TECHN.INSTALL.SYST.ENERG.CLIMATI;13;13;9;3;1;0;1;9;0;1;4;3;1;4
17697.0;2023;03;BESANCON;MASCULIN;APPRENTISSAGE;BAC PROFESSIONNEL;BAC PRO PROD;BAC PRO 23404 TECHNICIEN CONSTRUCTEUR BOIS;12;12;12;0;0;0;0;12;0;2;5;3;2;0
17704.0;2023;03;BESANCON;MASCULIN;APPRENTISSAGE;BAC PROFESSIONNEL;BAC PRO PROD;BAC PRO 25107 TECHNICIEN OUTILLEUR;8;8;7;1;0;0;0;7;0;0;1;2;4;1
17706.0;2023;03;BESANCON;MASCULIN;APPRENTISSAGE;BAC PROFESSIONNEL;BAC PRO PROD;BAC PRO 25215 MAINT.VEHIC.OPTB VEHIC.TRANS.ROUT;4;4;3;1;0;0;0;3;0;0;0;2;1;1
17707.0;2023;03;BESANCON;MASCULIN;APPRENTISSAGE;BAC PROFESSIONNEL;BAC PRO PROD;BAC PRO 25216 MAINT.VEHIC.OPTC MOTOCYCLES;4;4;4;0;0;0;0;4;0;0;1;2;1;0
17708.0;2023;03;BESANCON;MASCULIN;APPRENTISSAGE;BAC PROFESSIONNEL;BAC PRO PROD;BAC PRO 25219 MAINT.MATERIELS OPT.A AGRICOLES;24;24;23;1;0;0;0;23;0;0;3;12;8;1
17710.0;2023;03;BESANCON;MASCULIN;APPRENTISSAGE;BAC PROFESSIONNEL;BAC PRO PROD;BAC PRO 25221 MAINT.MATERIELS OPT.C ESP. VERTS;6;6;5;0;1;0;1;5;0;0;0;2;3;1
17712.0;2023;03;BESANCON;MASCULIN;APPRENTISSAGE;BAC PROFESSIONNEL;BAC PRO PROD;BAC PRO 25408 REPARATION DES CARROSSERIES;10;9;7;1;1;1;0;8;0;1;0;3;4;1
17713.0;2023;03;BESANCON;MASCULIN;APPRENTISSAGE;BAC PROFESSIONNEL;BAC PRO PROD;BAC PRO 25410 CONSTRUCTION DES CARROSSERIES;2;2;2;0;0;0;0;2;0;0;0;2;0;0
17716.0;2023;03;BESANCON;MASCULIN;APPRENTISSAGE;BAC PROFESSIONNEL;BAC PRO PROD;BAC PRO 25510 METIERS ELECT. ENVIRON. CONNECTES;42;41;39;2;0;0;0;39;0;4;6;16;13;2
17718.0;2023;03;BESANCON;MASCULIN;APPRENTISSAGE;BAC PROFESSIONNEL;BAC PRO PROD;BAC PRO AG 21001 AGRO-EQUIPEMENT;26;26;24;2;0;0;0;24;0;0;2;10;12;2
17730.0;2023;03;BESANCON;MASCULIN;APPRENTISSAGE;BAC PROFESSIONNEL;BAC PRO SERV;BAC PRO 31213 MET.COM.VEN.OP.A ANI.GES.ESP.COM.;45;45;33;9;3;2;1;35;0;0;6;20;9;10
17732.0;2023;03;BESANCON;MASCULIN;APPRENTISSAGE;BAC PROFESSIONNEL;BAC PRO SERV;BAC PRO 32303 ART.& MET.ART:COM.VIS.VIS.PLURI-M;3;3;3;0;0;0;0;3;0;1;0;2;0;0
17735.0;2023;03;BESANCON;MASCULIN;APPRENTISSAGE;BAC PROFESSIONNEL;BAC PRO SERV;BAC PRO 33403 COMMERC. SERVICES EN RESTAURATION;6;6;3;2;1;0;1;3;0;0;0;1;2;3
17740.0;2023;03;BESANCON;MASCULIN;ENSEIGNEMENT A DISTANCE;BAC PROFESSIONNEL;BAC PRO SERV;BAC PRO 32304 PHOTOGRAPHIE;1;1;1;0;0;0;0;1;0;0;0;1;0;0
17741.0;2023;03;BESANCON;MASCULIN;ENSEIGNEMENT A DISTANCE;BAC TECHNOLOGIQUE;BAC STMG;BAC STMG GESTION ET FINANCE;3;3;1;1;1;1;0;2;0;0;0;0;2;1
17758.0;2023;03;BESANCON;MASCULIN;INDIVIDUEL;BAC TECHNOLOGIQUE;BAC STHR;BAC STHR SC.&TEC. HOTELLERIE-RESTAURATION;1;1;1;0;0;0;0;1;0;0;0;0;1;0
17763.0;2023;03;BESANCON;MASCULIN;INDIVIDUEL;BAC TECHNOLOGIQUE;BAC STMG;BAC STMG RESSOURCES HUMAINES ET COMMUNICATION;3;3;0;2;1;1;0;1;0;0;0;0;1;2
17764.0;2023;03;BESANCON;MASCULIN;SCOLAIRE;BAC GENERAL;BAC GENERAL;BAC GENE 10019 BAC GENERAL;2641;2641;2395;42;204;138;66;2533;33;264;540;800;896;108
17773.0;2023;03;BESANCON;MASCULIN;SCOLAIRE;BAC PROFESSIONNEL;BAC PRO PROD;BACPRO 23103 TECHNICIEN GEOMETRE-TOPOGRAPHE;5;5;5;0;0;0;0;5;0;0;1;3;1;0
17774.0;2023;03;BESANCON;MASCULIN;SCOLAIRE;BAC PROFESSIONNEL;BAC PRO PROD;BAC PRO 23203 TECHNICIEN BAT. : ORG.REAL.GROS O;14;14;14;0;0;0;0;14;0;1;4;4;5;0
17780.0;2023;03;BESANCON;MASCULIN;SCOLAIRE;BAC PROFESSIONNEL;BAC PRO PROD;BAC PRO 23408 Etude et réalisation d'agencement;8;8;8;0;0;0;0;8;0;2;1;4;1;0
17787.0;2023;03;BESANCON;MASCULIN;SCOLAIRE;BAC PROFESSIONNEL;BAC PRO PROD;BAC PRO 25107 TECHNICIEN OUTILLEUR;4;4;4;0;0;0;0;4;0;0;0;2;2;0
17795.0;2023;03;BESANCON;MASCULIN;SCOLAIRE;BAC PROFESSIONNEL;BAC PRO PROD;BAC PRO 25510 METIERS ELECT. ENVIRON. CONNECTES;138;138;98;25;15;12;3;110;0;8;13;48;41;28
17796.0;2023;03;BESANCON;MASCULIN;SCOLAIRE;BAC PROFESSIONNEL;BAC PRO PROD;BAC PRO 25513 SYST.NUM.OPT.A SURETE SECURITE;39;39;31;5;3;3;0;34;0;1;3;12;18;5
17799.0;2023;03;BESANCON;MASCULIN;SCOLAIRE;BAC PROFESSIONNEL;BAC PRO PROD;BAC PRO AG 21001 AGRO-EQUIPEMENT;17;17;17;0;0;0;0;17;0;1;1;6;9;0
17803.0;2023;03;BESANCON;MASCULIN;SCOLAIRE;BAC PROFESSIONNEL;BAC PRO PROD;BAC PRO AG 21302 GEST MILIEUX NATURELS FAUNE;39;39;39;0;0;0;0;39;0;0;7;17;15;0
17811.0;2023;03;BESANCON;MASCULIN;SCOLAIRE;BAC PROFESSIONNEL;BAC PRO SERV;BAC PRO 31212 METIERS DE L'ACCUEIL;13;13;9;3;1;0;1;9;0;0;4;2;3;4
17819.0;2023;03;BESANCON;MASCULIN;SCOLAIRE;BAC PROFESSIONNEL;BAC PRO SERV;BAC PRO 33603 ESTHETIQUE COSMETIQUE PARFUMERIE;1;1;1;0;0;0;0;1;0;0;0;0;1;0
17828.0;2023;03;BESANCON;MASCULIN;SCOLAIRE;BAC TECHNOLOGIQUE;BAC STI2D;BAC STI2D ARCHITECTURE ET CONSTRUCTION;40;40;37;1;2;1;1;38;0;0;5;17;16;2
17835.0;2023;03;BESANCON;MASCULIN;SCOLAIRE;BAC TECHNOLOGIQUE;BAC STMG;BAC STMG MERCATIQUE (MARKETING);276;276;171;30;75;56;19;227;0;0;10;50;167;49
17842.0;2023;04;BORDEAUX;FEMININ;APPRENTISSAGE;BAC PROFESSIONNEL;BAC PRO PROD;BAC PRO 23205 INTERV. SUR PATRIMOINE BATI OPT.A;1;1;1;0;0;0;0;1;0;1;0;0;0;0
17845.0;2023;04;BORDEAUX;FEMININ;APPRENTISSAGE;BAC PROFESSIONNEL;BAC PRO PROD;BAC PRO 25007 MAINTENANCE EQUIPEMENTS INDUST.;2;2;1;1;0;0;0;1;0;1;0;0;0;1
17851.0;2023;04;BORDEAUX;FEMININ;APPRENTISSAGE;BAC PROFESSIONNEL;BAC PRO PROD;BAC PRO 25510 METIERS ELECT. ENVIRON. CONNECTES;1;1;1;0;0;0;0;1;0;0;0;1;0;0
17852.0;2023;04;BORDEAUX;FEMININ;APPRENTISSAGE;BAC PROFESSIONNEL;BAC PRO PROD;BAC PRO AG 21001 AGRO-EQUIPEMENT;3;3;1;2;0;0;0;1;0;0;0;0;1;2
17853.0;2023;04;BORDEAUX;FEMININ;APPRENTISSAGE;BAC PROFESSIONNEL;BAC PRO PROD;BAC PRO AG 21004 CGEA;14;13;13;0;0;0;0;13;0;0;0;5;8;0
17859.0;2023;04;BORDEAUX;FEMININ;APPRENTISSAGE;BAC PROFESSIONNEL;BAC PRO PROD;BAC PRO AG 22108 TEC CONS VTE ALIMENTATION (PAB);2;2;1;1;0;0;0;1;0;0;0;0;1;1
17863.0;2023;04;BORDEAUX;FEMININ;APPRENTISSAGE;BAC PROFESSIONNEL;BAC PRO SERV;BAC PRO 31212 METIERS DE L'ACCUEIL;11;11;10;1;0;0;0;10;0;1;1;5;3;1
17865.0;2023;04;BORDEAUX;FEMININ;APPRENTISSAGE;BAC PROFESSIONNEL;BAC PRO SERV;BAC PRO 31214 MET.COM.VEN.OP.B PR.CL.VA.OF.COM.;3;3;3;0;0;0;0;3;0;0;2;1;0;0
17871.0;2023;04;BORDEAUX;FEMININ;APPRENTISSAGE;BAC PROFESSIONNEL;BAC PRO SERV;BAC PRO 33603 ESTHETIQUE COSMETIQUE PARFUMERIE;1;1;1;0;0;0;0;1;0;0;0;0;1;0
17872.0;2023;04;BORDEAUX;FEMININ;APPRENTISSAGE;BAC PROFESSIONNEL;BAC PRO SERV;BAC PRO 33604 METIERS DE LA COIFFURE;6;6;4;2;0;0;0;4;0;1;0;1;2;2
17873.0;2023;04;BORDEAUX;FEMININ;APPRENTISSAGE;BAC PROFESSIONNEL;BAC PRO SERV;BAC PRO 34303 GEST. POLLUTIONS PROTEC. ENVIRON.;2;2;2;0;0;0;0;2;0;0;0;2;0;0
17874.0;2023;04;BORDEAUX;FEMININ;APPRENTISSAGE;BAC PROFESSIONNEL;BAC PRO SERV;BAC PRO 34304 HYGIENE PROPRETE STERILISATION;12;12;11;0;1;0;1;11;0;3;2;3;3;1
17875.0;2023;04;BORDEAUX;FEMININ;APPRENTISSAGE;BAC PROFESSIONNEL;BAC PRO SERV;BAC PRO AG 33002 SERV PERS TERRIT;17;16;14;2;0;0;0;14;0;0;0;4;10;2
17880.0;2023;04;BORDEAUX;FEMININ;ENSEIGNEMENT A DISTANCE;BAC PROFESSIONNEL;BAC PRO SERV;BAC PRO 32304 PHOTOGRAPHIE;2;1;1;0;0;0;0;1;0;1;0;0;0;0
17900.0;2023;04;BORDEAUX;FEMININ;INDIVIDUEL;BAC PROFESSIONNEL;BAC PRO PROD;BAC PRO AG 21113 CGEVV;1;1;1;0;0;0;0;1;0;0;0;0;1;0
17909.0;2023;04;BORDEAUX;FEMININ;INDIVIDUEL;BAC PROFESSIONNEL;BAC PRO SERV;BAC PRO 33403 COMMERC. SERVICES EN RESTAURATION;1;0;0;0;0;0;0;0;0;0;0;0;0;0
17911.0;2023;04;BORDEAUX;FEMININ;INDIVIDUEL;BAC PROFESSIONNEL;BAC PRO SERV;BAC PRO AG 33002 SERV PERS TERRIT;1;0;0;0;0;0;0;0;0;0;0;0;0;0
17912.0;2023;04;BORDEAUX;FEMININ;INDIVIDUEL;BAC TECHNOLOGIQUE;BAC ST2S;BAC ST2S SCIENCES & TECHNO. SANTE & SOCIAL;4;4;1;3;0;0;0;1;0;0;0;0;1;3
17916.0;2023;04;BORDEAUX;FEMININ;INDIVIDUEL;BAC TECHNOLOGIQUE;BAC STMG;BAC STMG MERCATIQUE (MARKETING);17;17;4;11;2;1;1;5;0;0;0;1;4;12
17918.0;2023;04;BORDEAUX;FEMININ;SCOLAIRE;BAC GENERAL;BAC GENERAL;BAC GENE 10019 BAC GENERAL;10455;10455;9700;139;616;452;164;10152;167;1262;2584;3413;2726;303
17922.0;2023;04;BORDEAUX;FEMININ;SCOLAIRE;BAC PROFESSIONNEL;BAC PRO PROD;BAC PRO 22004 PROC. CHIMIE EAU PAPIERS-CARTONS;4;4;4;0;0;0;0;4;0;0;1;2;1;0
17925.0;2023;04;BORDEAUX;FEMININ;SCOLAIRE;BAC PROFESSIONNEL;BAC PRO PROD;BAC PRO 22106 CUISINE;65;65;55;7;3;3;0;58;0;3;13;21;21;7
17939.0;2023;04;BORDEAUX;FEMININ;SCOLAIRE;BAC PROFESSIONNEL;BAC PRO PROD;BAC PRO 25009 MAINTENANCE NAUTIQUE;1;1;1;0;0;0;0;1;0;0;0;0;1;0
17941.0;2023;04;BORDEAUX;FEMININ;SCOLAIRE;BAC PROFESSIONNEL;BAC PRO PROD;BAC PRO 25107 TECHNICIEN OUTILLEUR;1;1;1;0;0;0;0;1;0;0;0;1;0;0
17944.0;2023;04;BORDEAUX;FEMININ;SCOLAIRE;BAC PROFESSIONNEL;BAC PRO PROD;BAC PRO 25216 MAINT.VEHIC.OPTC MOTOCYCLES;5;5;4;1;0;0;0;4;0;0;1;1;2;1
17947.0;2023;04;BORDEAUX;FEMININ;SCOLAIRE;BAC PROFESSIONNEL;BAC PRO PROD;BAC PRO 25303 AERONAUTIQUE OPTION SYSTEMES;5;5;5;0;0;0;0;5;0;1;2;2;0;0
17952.0;2023;04;BORDEAUX;FEMININ;SCOLAIRE;BAC PROFESSIONNEL;BAC PRO PROD;BAC PRO 25513 SYST.NUM.OPT.A SURETE SECURITE;1;1;1;0;0;0;0;1;0;0;0;0;1;0
17953.0;2023;04;BORDEAUX;FEMININ;SCOLAIRE;BAC PROFESSIONNEL;BAC PRO PROD;BAC PRO 25514 SYST.NUM.OPT.B AUD.RES.EQUIP.DOM.;4;4;3;0;1;1;0;4;0;0;1;1;2;0
17954.0;2023;04;BORDEAUX;FEMININ;SCOLAIRE;BAC PROFESSIONNEL;BAC PRO PROD;BAC PRO 25515 SYST.NUM.OPT.C RES.INF.SYST.COMM.;4;4;4;0;0;0;0;4;0;1;0;2;1;0
17956.0;2023;04;BORDEAUX;FEMININ;SCOLAIRE;BAC PROFESSIONNEL;BAC PRO PROD;BAC PRO AG 21113 CGEVV;3;3;3;0;0;0;0;3;0;1;0;2;0;0
17957.0;2023;04;BORDEAUX;FEMININ;SCOLAIRE;BAC PROFESSIONNEL;BAC PRO PROD;BAC PRO AG 21114 CONDUITE PRODUCTIONS HORTICOLES;13;12;10;2;0;0;0;10;0;0;2;2;6;2
17960.0;2023;04;BORDEAUX;FEMININ;SCOLAIRE;BAC PROFESSIONNEL;BAC PRO PROD;BAC PRO AG 21210 COND GEST ENTR CANIN ET FELIN;27;27;25;2;0;0;0;25;0;0;5;8;12;2
17967.0;2023;04;BORDEAUX;FEMININ;SCOLAIRE;BAC PROFESSIONNEL;BAC PRO SERV;BAC PRO 30004 ASSISTANC.GEST.ORGANIS.ACTIVITES;377;376;282;77;17;14;3;296;0;9;51;121;115;80
17972.0;2023;04;BORDEAUX;FEMININ;SCOLAIRE;BAC PROFESSIONNEL;BAC PRO SERV;BAC PRO 31213 MET.COM.VEN.OP.A ANI.GES.ESP.COM.;425;424;356;46;22;14;8;370;0;29;87;132;122;54
17977.0;2023;04;BORDEAUX;FEMININ;SCOLAIRE;BAC PROFESSIONNEL;BAC PRO SERV;BAC PRO 32304 PHOTOGRAPHIE;32;32;31;1;0;0;0;31;0;1;4;16;10;1
17978.0;2023;04;BORDEAUX;FEMININ;SCOLAIRE;BAC PROFESSIONNEL;BAC PRO SERV;BAC PRO 33003 ACC.SOINS-S.PERS. OPT.A DOMICILE;294;294;241;36;17;11;6;252;0;9;50;94;99;42
17982.0;2023;04;BORDEAUX;FEMININ;SCOLAIRE;BAC PROFESSIONNEL;BAC PRO SERV;BAC PRO 33104 TECHNICIEN EN PROTHESE DENTAIRE;11;11;11;0;0;0;0;11;0;2;2;2;5;0
17993.0;2023;04;BORDEAUX;FEMININ;SCOLAIRE;BAC TECHNOLOGIQUE;BAC STD2A;BAC STD2A SCIENCES & TECHNO. DESIGN-ARTS APPLIQUES;188;188;185;2;1;1;0;186;0;16;56;84;30;2
17994.0;2023;04;BORDEAUX;FEMININ;SCOLAIRE;BAC TECHNOLOGIQUE;BAC STHR;BAC STHR SC.&TEC. HOTELLERIE-RESTAURATION;50;50;43;0;7;4;3;47;0;1;8;18;20;3
18001.0;2023;04;BORDEAUX;FEMININ;SCOLAIRE;BAC TECHNOLOGIQUE;BAC STMG;BAC STMG GESTION ET FINANCE;320;320;273;10;37;26;11;299;0;4;44;131;120;21
18011.0;2023;04;BORDEAUX;MASCULIN;APPRENTISSAGE;BAC PROFESSIONNEL;BAC PRO PROD;BAC PRO 22704 TECHN. MAINT. SYST.ENERG.CLIMATI;18;18;14;4;0;0;0;14;0;4;2;4;4;4
18019.0;2023;04;BORDEAUX;MASCULIN;APPRENTISSAGE;BAC PROFESSIONNEL;BAC PRO PROD;BAC PRO 23405 TECHNICIEN MENUISIER AGENCEUR;8;8;5;2;1;1;0;6;0;1;1;1;3;2
18020.0;2023;04;BORDEAUX;MASCULIN;APPRENTISSAGE;BAC PROFESSIONNEL;BAC PRO PROD;BAC PRO 24303 MET. DU CUIR: SELLERIE GARNISSAGE;1;1;0;1;0;0;0;0;0;0;0;0;0;1
18024.0;2023;04;BORDEAUX;MASCULIN;APPRENTISSAGE;BAC PROFESSIONNEL;BAC PRO PROD;BAC PRO 25214 MAINT.VEHIC.OPTA VOIT.PARTICUL.;172;172;137;24;11;5;6;142;0;20;25;44;53;30
18026.0;2023;04;BORDEAUX;MASCULIN;APPRENTISSAGE;BAC PROFESSIONNEL;BAC PRO PROD;BAC PRO 25216 MAINT.VEHIC.OPTC MOTOCYCLES;1;1;1;0;0;0;0;1;0;0;0;1;0;0
18028.0;2023;04;BORDEAUX;MASCULIN;APPRENTISSAGE;BAC PROFESSIONNEL;BAC PRO PROD;BAC PRO 25221 MAINT.MATERIELS OPT.C ESP. VERTS;12;12;9;2;1;0;1;9;0;0;3;5;1;3
18040.0;2023;04;BORDEAUX;MASCULIN;APPRENTISSAGE;BAC PROFESSIONNEL;BAC PRO PROD;BAC PRO AG 21004 CGEA;44;43;37;6;0;0;0;37;0;0;3;8;26;6
18042.0;2023;04;BORDEAUX;MASCULIN;APPRENTISSAGE;BAC PROFESSIONNEL;BAC PRO PROD;BAC PRO AG 21114 CONDUITE PRODUCTIONS HORTICOLES;10;10;10;0;0;0;0;10;0;0;0;4;6;0
18044.0;2023;04;BORDEAUX;MASCULIN;APPRENTISSAGE;BAC PROFESSIONNEL;BAC PRO PROD;BAC PRO AG 21303 FORET;7;7;7;0;0;0;0;7;0;0;1;2;4;0
18050.0;2023;04;BORDEAUX;MASCULIN;APPRENTISSAGE;BAC PROFESSIONNEL;BAC PRO SERV;BAC PRO 31209 POISSONIER ECAILLER TRAITEUR;3;3;3;0;0;0;0;3;0;0;1;1;1;0
18053.0;2023;04;BORDEAUX;MASCULIN;APPRENTISSAGE;BAC PROFESSIONNEL;BAC PRO SERV;BAC PRO 31214 MET.COM.VEN.OP.B PR.CL.VA.OF.COM.;3;3;2;0;1;1;0;3;0;0;1;1;1;0
18054.0;2023;04;BORDEAUX;MASCULIN;APPRENTISSAGE;BAC PROFESSIONNEL;BAC PRO SERV;BAC PRO 32207 REAL.PR.IMPR.PLURI.OPTA.PR.GRAPH.;1;1;1;0;0;0;0;1;0;0;0;1;0;0
18057.0;2023;04;BORDEAUX;MASCULIN;APPRENTISSAGE;BAC PROFESSIONNEL;BAC PRO SERV;BAC PRO 33101 OPTIQUE LUNETTERIE;2;2;2;0;0;0;0;2;0;2;0;0;0;0
18062.0;2023;04;BORDEAUX;MASCULIN;APPRENTISSAGE;BAC PROFESSIONNEL;BAC PRO SERV;BAC PRO 34305 TECHN.D'INTERV.SUR INSTALL. NUCL.;1;1;1;0;0;0;0;1;0;1;0;0;0;0
18073.0;2023;04;BORDEAUX;MASCULIN;FORMATION CONTINUE;BAC PROFESSIONNEL;BAC PRO PROD;BAC PRO 25214 MAINT.VEHIC.OPTA VOIT.PARTICUL.;1;1;0;1;0;0;0;0;0;0;0;0;0;1
18081.0;2023;04;BORDEAUX;MASCULIN;INDIVIDUEL;BAC PROFESSIONNEL;BAC PRO PROD;BACPRO 20002 ETUD.DEFINITION PRDTS INDUSTRIEL;1;1;1;0;0;0;0;1;0;0;0;0;1;0
18090.0;2023;04;BORDEAUX;MASCULIN;INDIVIDUEL;BAC PROFESSIONNEL;BAC PRO PROD;BAC PRO AG 21114 CONDUITE PRODUCTIONS HORTICOLES;2;2;2;0;0;0;0;2;0;0;0;1;1;0
18094.0;2023;04;BORDEAUX;MASCULIN;INDIVIDUEL;BAC PROFESSIONNEL;BAC PRO SERV;BAC PRO 31213 MET.COM.VEN.OP.A ANI.GES.ESP.COM.;2;1;1;0;0;0;0;1;0;0;0;0;1;0
18097.0;2023;04;BORDEAUX;MASCULIN;INDIVIDUEL;BAC PROFESSIONNEL;BAC PRO SERV;BAC PRO 34304 HYGIENE PROPRETE STERILISATION;1;0;0;0;0;0;0;0;0;0;0;0;0;0
18102.0;2023;04;BORDEAUX;MASCULIN;INDIVIDUEL;BAC TECHNOLOGIQUE;BAC STL;BAC STL SCIENCES PHYSIQUES CHIMIQUES  EN LABORAT.;1;1;0;1;0;0;0;0;0;0;0;0;0;1
18104.0;2023;04;BORDEAUX;MASCULIN;INDIVIDUEL;BAC TECHNOLOGIQUE;BAC STMG;BAC STMG MERCATIQUE (MARKETING);30;30;14;7;9;6;3;20;0;0;0;9;11;10
18105.0;2023;04;BORDEAUX;MASCULIN;INDIVIDUEL;BAC TECHNOLOGIQUE;BAC STMG;BAC STMG RESSOURCES HUMAINES ET COMMUNICATION;5;5;0;3;2;2;0;2;0;0;0;0;2;3
18109.0;2023;04;BORDEAUX;MASCULIN;SCOLAIRE;BAC PROFESSIONNEL;BAC PRO PROD;BAC PRO 20102 PILOTE DE LIGNE DE PRODUCTION;17;17;13;4;0;0;0;13;0;2;4;2;5;4
18122.0;2023;04;BORDEAUX;MASCULIN;SCOLAIRE;BAC PROFESSIONNEL;BAC PRO PROD;BAC PRO 23102 TRAVAUX PUBLICS;42;42;34;4;4;3;1;37;0;2;10;12;13;5
18125.0;2023;04;BORDEAUX;MASCULIN;SCOLAIRE;BAC PROFESSIONNEL;BAC PRO PROD;BAC PRO 23208 METIERS ET ARTS DE LA PIERRE;7;7;4;2;1;1;0;5;0;0;1;1;3;2
18135.0;2023;04;BORDEAUX;MASCULIN;SCOLAIRE;BAC PROFESSIONNEL;BAC PRO PROD;BAC PRO 25009 MAINTENANCE NAUTIQUE;18;18;13;3;2;2;0;15;0;0;2;3;10;3
18138.0;2023;04;BORDEAUX;MASCULIN;SCOLAIRE;BAC PROFESSIONNEL;BAC PRO PROD;BAC PRO 25214 MAINT.VEHIC.OPTA VOIT.PARTICUL.;150;150;117;21;12;8;4;125;0;7;26;47;45;25
18144.0;2023;04;BORDEAUX;MASCULIN;SCOLAIRE;BAC PROFESSIONNEL;BAC PRO PROD;BAC PRO 25302 AERONAUTIQUE OPTION AVIONIQUE;23;23;23;0;0;0;0;23;0;0;8;12;3;0
18146.0;2023;04;BORDEAUX;MASCULIN;SCOLAIRE;BAC PROFESSIONNEL;BAC PRO PROD;BAC PRO 25304 AERONAUTIQUE OPTION STRUCTURE;26;26;21;3;2;2;0;23;0;0;5;3;15;3
18153.0;2023;04;BORDEAUX;MASCULIN;SCOLAIRE;BAC PROFESSIONNEL;BAC PRO PROD;BAC PRO 25514 SYST.NUM.OPT.B AUD.RES.EQUIP.DOM.;96;96;77;14;5;5;0;82;0;6;20;26;30;14
18157.0;2023;04;BORDEAUX;MASCULIN;SCOLAIRE;BAC PROFESSIONNEL;BAC PRO PROD;BAC PRO AG 21113 CGEVV;19;18;15;3;0;0;0;15;0;1;2;5;7;3
18166.0;2023;04;BORDEAUX;MASCULIN;SCOLAIRE;BAC PROFESSIONNEL;BAC PRO PROD;BAC PRO AG 21407 TEC CONS VTE UNIVERS JARDINERIE;10;10;8;2;0;0;0;8;0;0;0;3;5;2
18171.0;2023;04;BORDEAUX;MASCULIN;SCOLAIRE;BAC PROFESSIONNEL;BAC PRO SERV;BAC PRO 31107 CONDUCT. TRANSP.ROUT.MARCHANDISES;61;61;57;3;1;1;0;58;0;5;19;25;9;3
18179.0;2023;04;BORDEAUX;MASCULIN;SCOLAIRE;BAC PROFESSIONNEL;BAC PRO SERV;BAC PRO 32304 PHOTOGRAPHIE;10;10;9;1;0;0;0;9;0;0;0;4;5;1
18180.0;2023;04;BORDEAUX;MASCULIN;SCOLAIRE;BAC PROFESSIONNEL;BAC PRO SERV;BAC PRO 33003 ACC.SOINS-S.PERS. OPT.A DOMICILE;22;22;15;5;2;1;1;16;0;0;1;9;6;6
18182.0;2023;04;BORDEAUX;MASCULIN;SCOLAIRE;BAC PROFESSIONNEL;BAC PRO SERV;BAC PRO 33006 ANIMAT. ENFANCE& PERSONNES AGEES;86;86;68;18;0;0;0;68;0;10;17;23;18;18
18188.0;2023;04;BORDEAUX;MASCULIN;SCOLAIRE;BAC PROFESSIONNEL;BAC PRO SERV;BAC PRO 34304 HYGIENE PROPRETE STERILISATION;2;2;2;0;0;0;0;2;0;0;1;1;0;0
18190.0;2023;04;BORDEAUX;MASCULIN;SCOLAIRE;BAC PROFESSIONNEL;BAC PRO SERV;BAC PRO 34403 METIERS DE LA SECURITE;57;57;55;0;2;2;0;57;0;3;17;23;14;0
18194.0;2023;04;BORDEAUX;MASCULIN;SCOLAIRE;BAC TECHNOLOGIQUE;BAC ST2S;BAC ST2S SCIENCES & TECHNO. SANTE & SOCIAL;111;111;96;2;13;10;3;106;0;1;13;37;55;5
18198.0;2023;04;BORDEAUX;MASCULIN;SCOLAIRE;BAC TECHNOLOGIQUE;BAC STI2D;BAC STI2D ARCHITECTURE ET CONSTRUCTION;206;206;191;4;11;10;1;201;0;3;33;81;84;5
18202.0;2023;04;BORDEAUX;MASCULIN;SCOLAIRE;BAC TECHNOLOGIQUE;BAC STL;BAC STL BIOCHIM.-BIOLOGIE-BIOTECHNOL.;73;73;61;1;11;6;5;67;0;3;14;28;22;6
18206.0;2023;04;BORDEAUX;MASCULIN;SCOLAIRE;BAC TECHNOLOGIQUE;BAC STMG;BAC STMG RESSOURCES HUMAINES ET COMMUNICATION;283;283;182;37;64;43;21;225;0;0;8;43;174;58
18209.0;2023;06;CLERMONT-FERRAND;FEMININ;APPRENTISSAGE;BAC PROFESSIONNEL;BAC PRO PROD;BAC PRO 22106 CUISINE;4;4;4;0;0;0;0;4;0;0;2;1;1;0
18212.0;2023;06;CLERMONT-FERRAND;FEMININ;APPRENTISSAGE;BAC PROFESSIONNEL;BAC PRO PROD;BAC PRO 25106 TECHNICIEN D'USINAGE;3;3;2;0;1;1;0;3;0;1;0;1;1;0
18214.0;2023;06;CLERMONT-FERRAND;FEMININ;APPRENTISSAGE;BAC PROFESSIONNEL;BAC PRO PROD;BAC PRO 25302 AERONAUTIQUE OPTION AVIONIQUE;2;2;2;0;0;0;0;2;0;1;0;1;0;0
18216.0;2023;06;CLERMONT-FERRAND;FEMININ;APPRENTISSAGE;BAC PROFESSIONNEL;BAC PRO PROD;BAC PRO AG 21004 CGEA;10;10;9;1;0;0;0;9;0;1;0;4;4;1
18226.0;2023;06;CLERMONT-FERRAND;FEMININ;APPRENTISSAGE;BAC PROFESSIONNEL;BAC PRO SERV;BAC PRO 31214 MET.COM.VEN.OP.B PR.CL.VA.OF.COM.;1;1;1;0;0;0;0;1;0;0;1;0;0;0
18227.0;2023;06;CLERMONT-FERRAND;FEMININ;APPRENTISSAGE;BAC PROFESSIONNEL;BAC PRO SERV;BAC PRO 33004 ACC.SOINS-S.PERS. OPT.EN STRUCTUR;6;6;6;0;0;0;0;6;0;0;4;2;0;0
18231.0;2023;06;CLERMONT-FERRAND;FEMININ;ENSEIGNEMENT A DISTANCE;BAC PROFESSIONNEL;BAC PRO PROD;BAC PRO AG 21004 CGEA;8;7;6;1;0;0;0;6;0;0;0;0;6;1
18235.0;2023;06;CLERMONT-FERRAND;FEMININ;ENSEIGNEMENT A DISTANCE;BAC TECHNOLOGIQUE;BAC ST2S;BAC ST2S SCIENCES & TECHNO. SANTE & SOCIAL;2;2;2;0;0;0;0;2;0;0;0;0;2;0
18241.0;2023;06;CLERMONT-FERRAND;FEMININ;FORMATION CONTINUE;BAC PROFESSIONNEL;BAC PRO SERV;BAC PRO 30004 ASSISTANC.GEST.ORGANIS.ACTIVITES;3;3;3;0;0;0;0;3;0;0;2;1;0;0
18242.0;2023;06;CLERMONT-FERRAND;FEMININ;FORMATION CONTINUE;BAC PROFESSIONNEL;BAC PRO SERV;BAC PRO 32208 REAL.PR.IMPR.PLURI.OPTB.PR.IMPR.;1;1;1;0;0;0;0;1;0;1;0;0;0;0
18251.0;2023;06;CLERMONT-FERRAND;FEMININ;INDIVIDUEL;BAC PROFESSIONNEL;BAC PRO SERV;BAC PRO 30004 ASSISTANC.GEST.ORGANIS.ACTIVITES;1;1;0;0;1;0;1;0;0;0;0;0;0;1
18252.0;2023;06;CLERMONT-FERRAND;FEMININ;INDIVIDUEL;BAC PROFESSIONNEL;BAC PRO SERV;BAC PRO 31213 MET.COM.VEN.OP.A ANI.GES.ESP.COM.;1;0;0;0;0;0;0;0;0;0;0;0;0;0
18255.0;2023;06;CLERMONT-FERRAND;FEMININ;INDIVIDUEL;BAC PROFESSIONNEL;BAC PRO SERV;BAC PRO AG 33002 SERV PERS TERRIT;1;1;1;0;0;0;0;1;0;0;0;0;1;0
18259.0;2023;06;CLERMONT-FERRAND;FEMININ;INDIVIDUEL;BAC TECHNOLOGIQUE;BAC STMG;BAC STMG RESSOURCES HUMAINES ET COMMUNICATION;6;6;2;4;0;0;0;2;0;0;0;0;2;4
18269.0;2023;06;CLERMONT-FERRAND;FEMININ;SCOLAIRE;BAC PROFESSIONNEL;BAC PRO PROD;BAC PRO 23203 TECHNICIEN BAT. : ORG.REAL.GROS O;1;1;1;0;0;0;0;1;0;0;0;1;0;0
18274.0;2023;06;CLERMONT-FERRAND;FEMININ;SCOLAIRE;BAC PROFESSIONNEL;BAC PRO PROD;BAC PRO 25007 MAINTENANCE EQUIPEMENTS INDUST.;3;3;2;1;0;0;0;2;0;0;1;0;1;1
18275.0;2023;06;CLERMONT-FERRAND;FEMININ;SCOLAIRE;BAC PROFESSIONNEL;BAC PRO PROD;BAC PRO 25214 MAINT.VEHIC.OPTA VOIT.PARTICUL.;3;3;2;1;0;0;0;2;0;0;0;2;0;1
18276.0;2023;06;CLERMONT-FERRAND;FEMININ;SCOLAIRE;BAC PROFESSIONNEL;BAC PRO PROD;BAC PRO 25221 MAINT.MATERIELS OPT.C ESP. VERTS;1;1;1;0;0;0;0;1;0;0;0;0;1;0
18283.0;2023;06;CLERMONT-FERRAND;FEMININ;SCOLAIRE;BAC PROFESSIONNEL;BAC PRO PROD;BAC PRO AG 21001 AGRO-EQUIPEMENT;1;1;0;1;0;0;0;0;0;0;0;0;0;1
18287.0;2023;06;CLERMONT-FERRAND;FEMININ;SCOLAIRE;BAC PROFESSIONNEL;BAC PRO PROD;BAC PRO AG 21203 TECHN CONSEIL DE VENTE ANIMAL;15;15;13;2;0;0;0;13;0;0;0;8;5;2
18288.0;2023;06;CLERMONT-FERRAND;FEMININ;SCOLAIRE;BAC PROFESSIONNEL;BAC PRO PROD;BAC PRO AG 21210 COND GEST ENTR CANIN ET FELIN;24;24;23;1;0;0;0;23;0;1;5;12;5;1
18291.0;2023;06;CLERMONT-FERRAND;FEMININ;SCOLAIRE;BAC PROFESSIONNEL;BAC PRO PROD;BAC PRO AG 21303 FORET;2;2;2;0;0;0;0;2;0;0;0;0;2;0
18302.0;2023;06;CLERMONT-FERRAND;FEMININ;SCOLAIRE;BAC PROFESSIONNEL;BAC PRO SERV;BAC PRO 31214 MET.COM.VEN.OP.B PR.CL.VA.OF.COM.;58;57;51;6;0;0;0;51;0;6;11;18;16;6
18303.0;2023;06;CLERMONT-FERRAND;FEMININ;SCOLAIRE;BAC PROFESSIONNEL;BAC PRO SERV;BAC PRO 32207 REAL.PR.IMPR.PLURI.OPTA.PR.GRAPH.;6;6;6;0;0;0;0;6;0;0;4;1;1;0
18304.0;2023;06;CLERMONT-FERRAND;FEMININ;SCOLAIRE;BAC PROFESSIONNEL;BAC PRO SERV;BAC PRO 32208 REAL.PR.IMPR.PLURI.OPTB.PR.IMPR.;4;4;4;0;0;0;0;4;0;0;3;1;0;0
18329.0;2023;06;CLERMONT-FERRAND;FEMININ;SCOLAIRE;BAC TECHNOLOGIQUE;BAC STMG;BAC STMG MERCATIQUE (MARKETING);298;298;222;11;65;50;15;272;0;1;17;81;173;26
18330.0;2023;06;CLERMONT-FERRAND;FEMININ;SCOLAIRE;BAC TECHNOLOGIQUE;BAC STMG;BAC STMG RESSOURCES HUMAINES ET COMMUNICATION;221;221;156;14;51;36;15;192;0;2;9;44;137;29
18331.0;2023;06;CLERMONT-FERRAND;FEMININ;SCOLAIRE;BAC TECHNOLOGIQUE;BAC STMG;BAC STMG SYSTEMES D'INFORMATION DE GESTION;5;5;5;0;0;0;0;5;0;0;1;0;4;0
18332.0;2023;06;CLERMONT-FERRAND;MASCULIN;APPRENTISSAGE;BAC PROFESSIONNEL;BAC PRO PROD;BAC PRO 20102 PILOTE DE LIGNE DE PRODUCTION;18;18;18;0;0;0;0;18;0;2;5;9;2;0
18335.0;2023;06;CLERMONT-FERRAND;MASCULIN;APPRENTISSAGE;BAC PROFESSIONNEL;BAC PRO PROD;BAC PRO 22503 PLASTIQUES ET COMPOSITES;2;2;1;0;1;0;1;1;0;0;1;0;0;1
18336.0;2023;06;CLERMONT-FERRAND;MASCULIN;APPRENTISSAGE;BAC PROFESSIONNEL;BAC PRO PROD;BAC PRO 22703 TECHN.INSTALL.SYST.ENERG.CLIMATI;13;13;9;2;2;2;0;11;0;1;4;1;5;2
18337.0;2023;06;CLERMONT-FERRAND;MASCULIN;APPRENTISSAGE;BAC PROFESSIONNEL;BAC PRO PROD;BAC PRO 22704 TECHN. MAINT. SYST.ENERG.CLIMATI;1;1;1;0;0;0;0;1;0;0;0;0;1;0
18338.0;2023;06;CLERMONT-FERRAND;MASCULIN;APPRENTISSAGE;BAC PROFESSIONNEL;BAC PRO PROD;BAC PRO 22705 TECHNICIEN GAZ;5;5;5;0;0;0;0;5;0;1;1;2;1;0
18342.0;2023;06;CLERMONT-FERRAND;MASCULIN;APPRENTISSAGE;BAC PROFESSIONNEL;BAC PRO PROD;BAC PRO 23405 TECHNICIEN MENUISIER AGENCEUR;16;16;12;4;0;0;0;12;0;2;4;5;1;4
18344.0;2023;06;CLERMONT-FERRAND;MASCULIN;APPRENTISSAGE;BAC PROFESSIONNEL;BAC PRO PROD;BAC PRO 25106 TECHNICIEN D'USINAGE;31;31;23;5;3;3;0;26;0;3;2;6;15;5
18346.0;2023;06;CLERMONT-FERRAND;MASCULIN;APPRENTISSAGE;BAC PROFESSIONNEL;BAC PRO PROD;BAC PRO 25215 MAINT.VEHIC.OPTB VEHIC.TRANS.ROUT;16;16;9;6;1;0;1;9;0;0;0;3;6;7
18347.0;2023;06;CLERMONT-FERRAND;MASCULIN;APPRENTISSAGE;BAC PROFESSIONNEL;BAC PRO PROD;BAC PRO 25216 MAINT.VEHIC.OPTC MOTOCYCLES;5;5;4;1;0;0;0;4;0;0;3;0;1;1
18353.0;2023;06;CLERMONT-FERRAND;MASCULIN;APPRENTISSAGE;BAC PROFESSIONNEL;BAC PRO PROD;BAC PRO 25304 AERONAUTIQUE OPTION STRUCTURE;3;3;3;0;0;0;0;3;0;0;0;0;3;0
18357.0;2023;06;CLERMONT-FERRAND;MASCULIN;APPRENTISSAGE;BAC PROFESSIONNEL;BAC PRO PROD;BAC PRO 25510 METIERS ELECT. ENVIRON. CONNECTES;67;67;52;10;5;4;1;56;0;4;6;23;23;11
18368.0;2023;06;CLERMONT-FERRAND;MASCULIN;APPRENTISSAGE;BAC PROFESSIONNEL;BAC PRO SERV;BAC PRO 30004 ASSISTANC.GEST.ORGANIS.ACTIVITES;1;1;1;0;0;0;0;1;0;1;0;0;0;0
18370.0;2023;06;CLERMONT-FERRAND;MASCULIN;APPRENTISSAGE;BAC PROFESSIONNEL;BAC PRO SERV;BAC PRO 31212 METIERS DE L'ACCUEIL;2;2;2;0;0;0;0;2;0;1;1;0;0;0
18376.0;2023;06;CLERMONT-FERRAND;MASCULIN;ENSEIGNEMENT A DISTANCE;BAC PROFESSIONNEL;BAC PRO SERV;BAC PRO 31213 MET.COM.VEN.OP.A ANI.GES.ESP.COM.;1;0;0;0;0;0;0;0;0;0;0;0;0;0
18377.0;2023;06;CLERMONT-FERRAND;MASCULIN;FORMATION CONTINUE;BAC PROFESSIONNEL;BAC PRO PROD;BAC PRO 22704 TECHN. MAINT. SYST.ENERG.CLIMATI;2;2;2;0;0;0;0;2;0;2;0;0;0;0
18378.0;2023;06;CLERMONT-FERRAND;MASCULIN;FORMATION CONTINUE;BAC PROFESSIONNEL;BAC PRO PROD;BAC PRO 23404 TECHNICIEN CONSTRUCTEUR BOIS;1;1;1;0;0;0;0;1;0;1;0;0;0;0
18387.0;2023;06;CLERMONT-FERRAND;MASCULIN;INDIVIDUEL;BAC PROFESSIONNEL;BAC PRO PROD;BAC PRO 25007 MAINTENANCE EQUIPEMENTS INDUST.;1;1;0;1;0;0;0;0;0;0;0;0;0;1
18390.0;2023;06;CLERMONT-FERRAND;MASCULIN;INDIVIDUEL;BAC PROFESSIONNEL;BAC PRO PROD;BAC PRO 25510 METIERS ELECT. ENVIRON. CONNECTES;2;1;0;1;0;0;0;0;0;0;0;0;0;1
18391.0;2023;06;CLERMONT-FERRAND;MASCULIN;INDIVIDUEL;BAC PROFESSIONNEL;BAC PRO PROD;BAC PRO 25514 SYST.NUM.OPT.B AUD.RES.EQUIP.DOM.;2;2;2;0;0;0;0;2;0;0;0;1;1;0
18401.0;2023;06;CLERMONT-FERRAND;MASCULIN;INDIVIDUEL;BAC TECHNOLOGIQUE;BAC ST2S;BAC ST2S SCIENCES & TECHNO. SANTE & SOCIAL;6;6;1;4;1;1;0;2;0;0;0;0;2;4
18403.0;2023;06;CLERMONT-FERRAND;MASCULIN;INDIVIDUEL;BAC TECHNOLOGIQUE;BAC STI2D;BAC STI2D INNOVATION TECHNO.  ET ECO CONCEPTION;1;1;0;0;1;0;1;0;0;0;0;0;0;1
18407.0;2023;06;CLERMONT-FERRAND;MASCULIN;INDIVIDUEL;BAC TECHNOLOGIQUE;BAC STMG;BAC STMG SYSTEMES D'INFORMATION DE GESTION;1;1;1;0;0;0;0;1;0;0;1;0;0;0
18410.0;2023;06;CLERMONT-FERRAND;MASCULIN;SCOLAIRE;BAC PROFESSIONNEL;BAC PRO PROD;BAC PRO 20102 PILOTE DE LIGNE DE PRODUCTION;2;2;2;0;0;0;0;2;0;1;1;0;0;0
18411.0;2023;06;CLERMONT-FERRAND;MASCULIN;SCOLAIRE;BAC PROFESSIONNEL;BAC PRO PROD;BAC PRO 22003 BIO-INDUSTRIES DE TRANSFORMATION;12;12;10;2;0;0;0;10;0;0;3;3;4;2
18424.0;2023;06;CLERMONT-FERRAND;MASCULIN;SCOLAIRE;BAC PROFESSIONNEL;BAC PRO PROD;BAC PRO 23404 TECHNICIEN CONSTRUCTEUR BOIS;19;19;15;4;0;0;0;15;0;2;1;3;9;4
18429.0;2023;06;CLERMONT-FERRAND;MASCULIN;SCOLAIRE;BAC PROFESSIONNEL;BAC PRO PROD;BAC PRO 25106 TECHNICIEN D'USINAGE;20;20;17;2;1;0;1;17;0;0;2;9;6;3
18434.0;2023;06;CLERMONT-FERRAND;MASCULIN;SCOLAIRE;BAC PROFESSIONNEL;BAC PRO PROD;BAC PRO 25221 MAINT.MATERIELS OPT.C ESP. VERTS;8;8;5;3;0;0;0;5;0;0;2;0;3;3
18438.0;2023;06;CLERMONT-FERRAND;MASCULIN;SCOLAIRE;BAC PROFESSIONNEL;BAC PRO PROD;BAC PRO 25408 REPARATION DES CARROSSERIES;16;16;10;6;0;0;0;10;0;0;1;4;5;6
18445.0;2023;06;CLERMONT-FERRAND;MASCULIN;SCOLAIRE;BAC PROFESSIONNEL;BAC PRO PROD;BAC PRO 25515 SYST.NUM.OPT.C RES.INF.SYST.COMM.;57;57;52;4;1;1;0;53;0;1;13;26;13;4
18452.0;2023;06;CLERMONT-FERRAND;MASCULIN;SCOLAIRE;BAC PROFESSIONNEL;BAC PRO PROD;BAC PRO AG 21302 GEST MILIEUX NATURELS FAUNE;29;29;27;2;0;0;0;27;0;0;8;15;4;2
18458.0;2023;06;CLERMONT-FERRAND;MASCULIN;SCOLAIRE;BAC PROFESSIONNEL;BAC PRO SERV;BAC PRO 31106 LOGISTIQUE;29;29;23;4;2;1;1;24;0;0;1;8;15;5
18469.0;2023;06;CLERMONT-FERRAND;MASCULIN;SCOLAIRE;BAC PROFESSIONNEL;BAC PRO SERV;BAC PRO 33004 ACC.SOINS-S.PERS. OPT.EN STRUCTUR;19;19;16;2;1;1;0;17;0;0;3;7;7;2
18476.0;2023;06;CLERMONT-FERRAND;MASCULIN;SCOLAIRE;BAC PROFESSIONNEL;BAC PRO SERV;BAC PRO 34403 METIERS DE LA SECURITE;23;23;16;5;2;1;1;17;0;2;5;4;6;6
18479.0;2023;06;CLERMONT-FERRAND;MASCULIN;SCOLAIRE;BAC TECHNOLOGIQUE;BAC STAV;BAC STAV AGRONOMIE ALIM ENV TERRITOI;114;113;112;1;0;0;0;112;0;1;10;38;63;1
18487.0;2023;06;CLERMONT-FERRAND;MASCULIN;SCOLAIRE;BAC TECHNOLOGIQUE;BAC STL;BAC STL SCIENCES PHYSIQUES CHIMIQUES  EN LABORAT.;26;26;24;0;2;0;2;24;0;2;10;8;4;2
18491.0;2023;06;CLERMONT-FERRAND;MASCULIN;SCOLAIRE;BAC TECHNOLOGIQUE;BAC STMG;BAC STMG SYSTEMES D'INFORMATION DE GESTION;5;5;4;0;1;0;1;4;0;0;0;1;3;1
18492.0;2023;27;CORSE;FEMININ;APPRENTISSAGE;BAC PROFESSIONNEL;BAC PRO PROD;BAC PRO 22106 CUISINE;1;1;1;0;0;0;0;1;0;0;0;0;1;0
18493.0;2023;27;CORSE;FEMININ;APPRENTISSAGE;BAC PROFESSIONNEL;BAC PRO SERV;BAC PRO 30004 ASSISTANC.GEST.ORGANIS.ACTIVITES;15;15;13;1;1;1;0;14;0;1;4;3;6;1
18496.0;2023;27;CORSE;FEMININ;APPRENTISSAGE;BAC PROFESSIONNEL;BAC PRO SERV;BAC PRO 31214 MET.COM.VEN.OP.B PR.CL.VA.OF.COM.;1;1;0;0;1;1;0;1;0;0;0;0;1;0
18498.0;2023;27;CORSE;FEMININ;ENSEIGNEMENT A DISTANCE;BAC GENERAL;BAC GENERAL;BAC GENE 10019 BAC GENERAL;10;10;6;1;3;2;1;8;0;0;2;3;3;2
18502.0;2023;27;CORSE;FEMININ;INDIVIDUEL;BAC GENERAL;BAC GENERAL;BAC GENE 10019 BAC GENERAL;3;3;2;1;0;0;0;2;0;0;0;0;2;1
18507.0;2023;27;CORSE;FEMININ;INDIVIDUEL;BAC TECHNOLOGIQUE;BAC STMG;BAC STMG RESSOURCES HUMAINES ET COMMUNICATION;2;2;0;0;2;1;1;1;0;0;0;0;1;1
18511.0;2023;27;CORSE;FEMININ;SCOLAIRE;BAC PROFESSIONNEL;BAC PRO PROD;BAC PRO 23005 TECHN. ETUDES BAT B ASSIST.ARCHI.;5;5;5;0;0;0;0;5;0;0;2;2;1;0
18516.0;2023;27;CORSE;FEMININ;SCOLAIRE;BAC PROFESSIONNEL;BAC PRO PROD;BAC PRO AG 21211 COND GEST ENTR HIPPIQUE;3;3;2;1;0;0;0;2;0;0;0;0;2;1
18518.0;2023;27;CORSE;FEMININ;SCOLAIRE;BAC PROFESSIONNEL;BAC PRO PROD;BAC PRO AG 21303 FORET;1;1;0;1;0;0;0;0;0;0;0;0;0;1
18519.0;2023;27;CORSE;FEMININ;SCOLAIRE;BAC PROFESSIONNEL;BAC PRO PROD;BAC PRO AG 21405 AMENAGEMENTS PAYSAGERS;1;1;1;0;0;0;0;1;0;0;0;1;0;0
18521.0;2023;27;CORSE;FEMININ;SCOLAIRE;BAC PROFESSIONNEL;BAC PRO SERV;BAC PRO 31106 LOGISTIQUE;1;1;1;0;0;0;0;1;0;0;1;0;0;0
18532.0;2023;27;CORSE;FEMININ;SCOLAIRE;BAC TECHNOLOGIQUE;BAC ST2S;BAC ST2S SCIENCES & TECHNO. SANTE & SOCIAL;84;84;73;1;10;8;2;81;0;5;12;30;34;3
18542.0;2023;27;CORSE;MASCULIN;APPRENTISSAGE;BAC PROFESSIONNEL;BAC PRO PROD;BAC PRO 22703 TECHN.INSTALL.SYST.ENERG.CLIMATI;3;3;3;0;0;0;0;3;0;0;1;0;2;0
18543.0;2023;27;CORSE;MASCULIN;APPRENTISSAGE;BAC PROFESSIONNEL;BAC PRO PROD;BAC PRO 23004 TECHN. ETUDES BAT.A ETUDES & ECO.;1;1;1;0;0;0;0;1;0;0;0;0;1;0
18544.0;2023;27;CORSE;MASCULIN;APPRENTISSAGE;BAC PROFESSIONNEL;BAC PRO PROD;BAC PRO 25007 MAINTENANCE EQUIPEMENTS INDUST.;2;2;2;0;0;0;0;2;0;0;0;1;1;0
18545.0;2023;27;CORSE;MASCULIN;APPRENTISSAGE;BAC PROFESSIONNEL;BAC PRO PROD;BAC PRO 25009 MAINTENANCE NAUTIQUE;1;1;1;0;0;0;0;1;0;0;0;0;1;0
18550.0;2023;27;CORSE;MASCULIN;APPRENTISSAGE;BAC PROFESSIONNEL;BAC PRO SERV;BAC PRO 31106 LOGISTIQUE;2;2;0;1;1;0;1;0;0;0;0;0;0;2
18551.0;2023;27;CORSE;MASCULIN;APPRENTISSAGE;BAC PROFESSIONNEL;BAC PRO SERV;BAC PRO 31107 CONDUCT. TRANSP.ROUT.MARCHANDISES;1;1;1;0;0;0;0;1;0;0;0;0;1;0
18556.0;2023;27;CORSE;MASCULIN;ENSEIGNEMENT A DISTANCE;BAC PROFESSIONNEL;BAC PRO SERV;BAC PRO 30004 ASSISTANC.GEST.ORGANIS.ACTIVITES;1;1;0;1;0;0;0;0;0;0;0;0;0;1
18561.0;2023;27;CORSE;MASCULIN;INDIVIDUEL;BAC PROFESSIONNEL;BAC PRO PROD;BAC PRO AG 21004 CGEA;4;3;3;0;0;0;0;3;0;0;0;0;3;0
18565.0;2023;27;CORSE;MASCULIN;SCOLAIRE;BAC GENERAL;BAC GENERAL;BAC GENE 10019 BAC GENERAL;726;726;654;12;60;52;8;706;18;89;136;218;245;20
18566.0;2023;27;CORSE;MASCULIN;SCOLAIRE;BAC PROFESSIONNEL;BAC PRO PROD;BAC PRO 22106 CUISINE;29;29;22;7;0;0;0;22;0;2;8;6;6;7
18578.0;2023;27;CORSE;MASCULIN;SCOLAIRE;BAC PROFESSIONNEL;BAC PRO PROD;BAC PRO 25515 SYST.NUM.OPT.C RES.INF.SYST.COMM.;21;21;20;1;0;0;0;20;0;1;6;7;6;1
18604.0;2023;27;CORSE;MASCULIN;SCOLAIRE;BAC TECHNOLOGIQUE;BAC STMG;BAC STMG MERCATIQUE (MARKETING);96;96;70;5;21;16;5;86;0;0;2;27;57;10
18605.0;2023;27;CORSE;MASCULIN;SCOLAIRE;BAC TECHNOLOGIQUE;BAC STMG;BAC STMG RESSOURCES HUMAINES ET COMMUNICATION;49;49;37;3;9;8;1;45;0;1;1;14;29;4
18609.0;2023;24;CRETEIL;FEMININ;APPRENTISSAGE;BAC PROFESSIONNEL;BAC PRO PROD;BAC PRO 23304 AMENAGEMENT FINITION BATIMENT;1;1;0;0;1;0;1;0;0;0;0;0;0;1
18610.0;2023;24;CRETEIL;FEMININ;APPRENTISSAGE;BAC PROFESSIONNEL;BAC PRO PROD;BAC PRO 24202 ARTIS.& MET.ART : TAPIS.D'AMEUBL;8;8;7;1;0;0;0;7;0;5;1;1;0;1
18612.0;2023;24;CRETEIL;FEMININ;APPRENTISSAGE;BAC PROFESSIONNEL;BAC PRO PROD;BAC PRO 24303 MET. DU CUIR: SELLERIE GARNISSAGE;21;21;21;0;0;0;0;21;0;6;8;5;2;0
18614.0;2023;24;CRETEIL;FEMININ;APPRENTISSAGE;BAC PROFESSIONNEL;BAC PRO PROD;BAC PRO 25214 MAINT.VEHIC.OPTA VOIT.PARTICUL.;4;4;4;0;0;0;0;4;0;1;2;1;0;0
18618.0;2023;24;CRETEIL;FEMININ;APPRENTISSAGE;BAC PROFESSIONNEL;BAC PRO PROD;BAC PRO AG 21004 CGEA;1;1;0;1;0;0;0;0;0;0;0;0;0;1
18619.0;2023;24;CRETEIL;FEMININ;APPRENTISSAGE;BAC PROFESSIONNEL;BAC PRO PROD;BAC PRO AG 21211 COND GEST ENTR HIPPIQUE;22;21;18;3;0;0;0;18;0;0;2;5;11;3
18621.0;2023;24;CRETEIL;FEMININ;APPRENTISSAGE;BAC PROFESSIONNEL;BAC PRO SERV;BAC PRO 31106 LOGISTIQUE;2;2;2;0;0;0;0;2;0;0;0;1;1;0
18625.0;2023;24;CRETEIL;FEMININ;APPRENTISSAGE;BAC PROFESSIONNEL;BAC PRO SERV;BAC PRO 32303 ART.& MET.ART:COM.VIS.VIS.PLURI-M;6;6;6;0;0;0;0;6;0;1;3;2;0;0
18628.0;2023;24;CRETEIL;FEMININ;APPRENTISSAGE;BAC PROFESSIONNEL;BAC PRO SERV;BAC PRO 33603 ESTHETIQUE COSMETIQUE PARFUMERIE;16;16;6;10;0;0;0;6;0;0;0;0;6;10
18629.0;2023;24;CRETEIL;FEMININ;APPRENTISSAGE;BAC PROFESSIONNEL;BAC PRO SERV;BAC PRO 34304 HYGIENE PROPRETE STERILISATION;10;10;9;1;0;0;0;9;0;0;0;3;6;1
18631.0;2023;24;CRETEIL;FEMININ;ENSEIGNEMENT A DISTANCE;BAC GENERAL;BAC GENERAL;BAC GENE 10019 BAC GENERAL;111;110;70;25;15;10;5;80;0;3;14;24;39;30
18635.0;2023;24;CRETEIL;FEMININ;ENSEIGNEMENT A DISTANCE;BAC PROFESSIONNEL;BAC PRO SERV;BAC PRO 32304 PHOTOGRAPHIE;1;0;0;0;0;0;0;0;0;0;0;0;0;0
18639.0;2023;24;CRETEIL;FEMININ;ENSEIGNEMENT A DISTANCE;BAC TECHNOLOGIQUE;BAC STMG;BAC STMG GESTION ET FINANCE;1;1;1;0;0;0;0;1;0;0;0;0;1;0
18641.0;2023;24;CRETEIL;FEMININ;ENSEIGNEMENT A DISTANCE;BAC TECHNOLOGIQUE;BAC STMG;BAC STMG RESSOURCES HUMAINES ET COMMUNICATION;12;12;8;4;0;0;0;8;0;0;2;4;2;4
18642.0;2023;24;CRETEIL;FEMININ;FORMATION CONTINUE;BAC PROFESSIONNEL;BAC PRO PROD;BAC PRO 22704 TECHN. MAINT. SYST.ENERG.CLIMATI;1;1;1;0;0;0;0;1;0;0;0;1;0;0
18643.0;2023;24;CRETEIL;FEMININ;FORMATION CONTINUE;BAC PROFESSIONNEL;BAC PRO PROD;BAC PRO 24301 METIERS DU CUIR : CHAUSSURES;2;1;0;1;0;0;0;0;0;0;0;0;0;1
18646.0;2023;24;CRETEIL;FEMININ;FORMATION CONTINUE;BAC PROFESSIONNEL;BAC PRO PROD;BAC PRO 25106 TECHNICIEN D'USINAGE;1;1;1;0;0;0;0;1;0;0;0;1;0;0
18655.0;2023;24;CRETEIL;FEMININ;INDIVIDUEL;BAC PROFESSIONNEL;BAC PRO PROD;BAC PRO 23003 ARTIS. & M.ART:MARCHANDISAGE VIS.;2;1;1;0;0;0;0;1;0;0;0;0;1;0
18659.0;2023;24;CRETEIL;FEMININ;INDIVIDUEL;BAC PROFESSIONNEL;BAC PRO PROD;BAC PRO AG 21004 CGEA;1;1;1;0;0;0;0;1;0;0;0;0;1;0
18691.0;2023;24;CRETEIL;FEMININ;SCOLAIRE;BAC PROFESSIONNEL;BAC PRO PROD;BAC PRO 23203 TECHNICIEN BAT. : ORG.REAL.GROS O;2;2;2;0;0;0;0;2;0;1;0;1;0;0
18695.0;2023;24;CRETEIL;FEMININ;SCOLAIRE;BAC PROFESSIONNEL;BAC PRO PROD;BAC PRO 23408 Etude et réalisation d'agencement;7;7;1;6;0;0;0;1;0;0;0;1;0;6
18701.0;2023;24;CRETEIL;FEMININ;SCOLAIRE;BAC PROFESSIONNEL;BAC PRO PROD;BAC PRO 25106 TECHNICIEN D'USINAGE;2;2;1;0;1;0;1;1;0;0;0;1;0;1
18702.0;2023;24;CRETEIL;FEMININ;SCOLAIRE;BAC PROFESSIONNEL;BAC PRO PROD;BAC PRO 25214 MAINT.VEHIC.OPTA VOIT.PARTICUL.;3;3;3;0;0;0;0;3;0;0;0;1;2;0
18709.0;2023;24;CRETEIL;FEMININ;SCOLAIRE;BAC PROFESSIONNEL;BAC PRO PROD;BAC PRO 25515 SYST.NUM.OPT.C RES.INF.SYST.COMM.;10;10;8;2;0;0;0;8;0;1;0;4;3;2
18710.0;2023;24;CRETEIL;FEMININ;SCOLAIRE;BAC PROFESSIONNEL;BAC PRO PROD;BAC PRO AG 21004 CGEA;23;21;13;8;0;0;0;13;0;0;0;3;10;8
18721.0;2023;24;CRETEIL;FEMININ;SCOLAIRE;BAC PROFESSIONNEL;BAC PRO SERV;BAC PRO 31213 MET.COM.VEN.OP.A ANI.GES.ESP.COM.;735;734;579;119;36;24;12;603;0;33;119;210;241;131
18724.0;2023;24;CRETEIL;FEMININ;SCOLAIRE;BAC PROFESSIONNEL;BAC PRO SERV;BAC PRO 32207 REAL.PR.IMPR.PLURI.OPTA.PR.GRAPH.;16;16;11;4;1;1;0;12;0;0;1;4;7;4
18726.0;2023;24;CRETEIL;FEMININ;SCOLAIRE;BAC PROFESSIONNEL;BAC PRO SERV;BAC PRO 32303 ART.& MET.ART:COM.VIS.VIS.PLURI-M;105;105;97;7;1;1;0;98;0;10;24;35;29;7
18728.0;2023;24;CRETEIL;FEMININ;SCOLAIRE;BAC PROFESSIONNEL;BAC PRO SERV;BAC PRO 33004 ACC.SOINS-S.PERS. OPT.EN STRUCTUR;1371;1371;1141;132;98;75;23;1216;0;56;258;430;472;155
18729.0;2023;24;CRETEIL;FEMININ;SCOLAIRE;BAC PROFESSIONNEL;BAC PRO SERV;BAC PRO 33006 ANIMAT. ENFANCE& PERSONNES AGEES;173;173;141;24;8;3;5;144;0;20;37;54;33;29
18731.0;2023;24;CRETEIL;FEMININ;SCOLAIRE;BAC PROFESSIONNEL;BAC PRO SERV;BAC PRO 33104 TECHNICIEN EN PROTHESE DENTAIRE;9;9;7;2;0;0;0;7;0;0;3;2;2;2
18733.0;2023;24;CRETEIL;FEMININ;SCOLAIRE;BAC PROFESSIONNEL;BAC PRO SERV;BAC PRO 33603 ESTHETIQUE COSMETIQUE PARFUMERIE;132;130;108;19;3;1;2;109;0;3;14;47;45;21
18737.0;2023;24;CRETEIL;FEMININ;SCOLAIRE;BAC PROFESSIONNEL;BAC PRO SERV;BAC PRO 34403 METIERS DE LA SECURITE;51;51;47;2;2;1;1;48;0;6;13;18;11;3
18742.0;2023;24;CRETEIL;FEMININ;SCOLAIRE;BAC TECHNOLOGIQUE;BAC STHR;BAC STHR SC.&TEC. HOTELLERIE-RESTAURATION;48;48;42;1;5;3;2;45;0;2;11;16;16;3
18752.0;2023;24;CRETEIL;FEMININ;SCOLAIRE;BAC TECHNOLOGIQUE;BAC STMG;BAC STMG SYSTEMES D'INFORMATION DE GESTION;93;93;69;6;18;16;2;85;1;0;4;19;61;8
18753.0;2023;24;CRETEIL;MASCULIN;APPRENTISSAGE;BAC PROFESSIONNEL;BAC PRO PROD;BAC PRO 22105 BOULANGER-PÂTISSIER;9;9;7;1;1;0;1;7;0;1;4;2;0;2
18755.0;2023;24;CRETEIL;MASCULIN;APPRENTISSAGE;BAC PROFESSIONNEL;BAC PRO PROD;BAC PRO 22703 TECHN.INSTALL.SYST.ENERG.CLIMATI;43;42;28;13;1;0;1;28;0;2;5;6;15;14
18757.0;2023;24;CRETEIL;MASCULIN;APPRENTISSAGE;BAC PROFESSIONNEL;BAC PRO PROD;BAC PRO 23203 TECHNICIEN BAT. : ORG.REAL.GROS O;49;49;30;15;4;4;0;34;0;3;7;9;15;15
18758.0;2023;24;CRETEIL;MASCULIN;APPRENTISSAGE;BAC PROFESSIONNEL;BAC PRO PROD;BAC PRO 23304 AMENAGEMENT FINITION BATIMENT;14;14;10;2;2;2;0;12;0;1;0;3;8;2
18762.0;2023;24;CRETEIL;MASCULIN;APPRENTISSAGE;BAC PROFESSIONNEL;BAC PRO PROD;BAC PRO 25106 TECHNICIEN D'USINAGE;2;2;2;0;0;0;0;2;0;0;1;0;1;0
18774.0;2023;24;CRETEIL;MASCULIN;APPRENTISSAGE;BAC PROFESSIONNEL;BAC PRO PROD;BAC PRO 25513 SYST.NUM.OPT.A SURETE SECURITE;1;1;1;0;0;0;0;1;0;0;0;1;0;0
18782.0;2023;24;CRETEIL;MASCULIN;APPRENTISSAGE;BAC PROFESSIONNEL;BAC PRO SERV;BAC PRO 31213 MET.COM.VEN.OP.A ANI.GES.ESP.COM.;43;43;31;9;3;2;1;33;0;1;3;13;16;10
18783.0;2023;24;CRETEIL;MASCULIN;APPRENTISSAGE;BAC PROFESSIONNEL;BAC PRO SERV;BAC PRO 31214 MET.COM.VEN.OP.B PR.CL.VA.OF.COM.;13;13;9;4;0;0;0;9;0;0;0;6;3;4
18788.0;2023;24;CRETEIL;MASCULIN;APPRENTISSAGE;BAC PROFESSIONNEL;BAC PRO SERV;BAC PRO 34304 HYGIENE PROPRETE STERILISATION;24;22;11;9;2;2;0;13;0;1;1;4;7;9
18789.0;2023;24;CRETEIL;MASCULIN;APPRENTISSAGE;BAC PROFESSIONNEL;BAC PRO SERV;BAC PRO AG 33002 SERV PERS TERRIT;1;1;1;0;0;0;0;1;0;0;0;0;1;0
18790.0;2023;24;CRETEIL;MASCULIN;ENSEIGNEMENT A DISTANCE;BAC GENERAL;BAC GENERAL;BAC GENE 10019 BAC GENERAL;48;48;27;18;3;1;2;28;0;1;3;7;17;20
18805.0;2023;24;CRETEIL;MASCULIN;FORMATION CONTINUE;BAC PROFESSIONNEL;BAC PRO PROD;BAC PRO 25303 AERONAUTIQUE OPTION SYSTEMES;6;6;4;2;0;0;0;4;0;1;2;1;0;2
18806.0;2023;24;CRETEIL;MASCULIN;FORMATION CONTINUE;BAC PROFESSIONNEL;BAC PRO PROD;BAC PRO 25510 METIERS ELECT. ENVIRON. CONNECTES;55;51;42;9;0;0;0;42;0;5;20;11;6;9
18807.0;2023;24;CRETEIL;MASCULIN;FORMATION CONTINUE;BAC PROFESSIONNEL;BAC PRO SERV;BAC PRO 30004 ASSISTANC.GEST.ORGANIS.ACTIVITES;2;2;2;0;0;0;0;2;0;0;2;0;0;0
18808.0;2023;24;CRETEIL;MASCULIN;FORMATION CONTINUE;BAC PROFESSIONNEL;BAC PRO SERV;BAC PRO 31213 MET.COM.VEN.OP.A ANI.GES.ESP.COM.;1;1;0;1;0;0;0;0;0;0;0;0;0;1
18811.0;2023;24;CRETEIL;MASCULIN;FORMATION CONTINUE;BAC PROFESSIONNEL;BAC PRO SERV;BAC PRO 33604 METIERS DE LA COIFFURE;2;2;2;0;0;0;0;2;0;0;1;0;1;0
18819.0;2023;24;CRETEIL;MASCULIN;INDIVIDUEL;BAC PROFESSIONNEL;BAC PRO PROD;BAC PRO 23408 Etude et réalisation d'agencement;1;1;0;1;0;0;0;0;0;0;0;0;0;1
18831.0;2023;24;CRETEIL;MASCULIN;INDIVIDUEL;BAC PROFESSIONNEL;BAC PRO PROD;BAC PRO AG 21114 CONDUITE PRODUCTIONS HORTICOLES;2;2;2;0;0;0;0;2;0;0;0;0;2;0
18833.0;2023;24;CRETEIL;MASCULIN;INDIVIDUEL;BAC PROFESSIONNEL;BAC PRO SERV;BAC PRO 30004 ASSISTANC.GEST.ORGANIS.ACTIVITES;12;8;6;2;0;0;0;6;0;0;0;0;6;2
18835.0;2023;24;CRETEIL;MASCULIN;INDIVIDUEL;BAC PROFESSIONNEL;BAC PRO SERV;BAC PRO 31212 METIERS DE L'ACCUEIL;3;2;1;1;0;0;0;1;0;0;0;0;1;1
18839.0;2023;24;CRETEIL;MASCULIN;INDIVIDUEL;BAC PROFESSIONNEL;BAC PRO SERV;BAC PRO 33002 SERVICES DE PROXIMITE  VIE LOCAL;1;1;0;0;1;0;1;0;0;0;0;0;0;1
18844.0;2023;24;CRETEIL;MASCULIN;INDIVIDUEL;BAC TECHNOLOGIQUE;BAC STD2A;BAC STD2A SCIENCES & TECHNO. DESIGN-ARTS APPLIQUES;3;3;0;2;1;0;1;0;0;0;0;0;0;3
18848.0;2023;24;CRETEIL;MASCULIN;INDIVIDUEL;BAC TECHNOLOGIQUE;BAC STI2D;BAC STI2D INNOVATION TECHNO.  ET ECO CONCEPTION;6;6;1;3;2;2;0;3;0;0;0;0;3;3
18851.0;2023;24;CRETEIL;MASCULIN;INDIVIDUEL;BAC TECHNOLOGIQUE;BAC STL;BAC STL SCIENCES PHYSIQUES CHIMIQUES  EN LABORAT.;2;2;0;2;0;0;0;0;0;0;0;0;0;2
18852.0;2023;24;CRETEIL;MASCULIN;INDIVIDUEL;BAC TECHNOLOGIQUE;BAC STMG;BAC STMG GESTION ET FINANCE;17;17;2;12;3;3;0;5;0;0;0;0;5;12
18858.0;2023;24;CRETEIL;MASCULIN;SCOLAIRE;BAC PROFESSIONNEL;BAC PRO PROD;BAC PRO 22004 PROC. CHIMIE EAU PAPIERS-CARTONS;9;9;9;0;0;0;0;9;0;0;1;2;6;0
18859.0;2023;24;CRETEIL;MASCULIN;SCOLAIRE;BAC PROFESSIONNEL;BAC PRO PROD;BAC PRO 22106 CUISINE;123;123;94;25;4;3;1;97;0;5;14;37;41;26
18860.0;2023;24;CRETEIL;MASCULIN;SCOLAIRE;BAC PROFESSIONNEL;BAC PRO PROD;BAC PRO 22302 Traitement des matériaux;3;3;3;0;0;0;0;3;0;0;0;0;3;0
18862.0;2023;24;CRETEIL;MASCULIN;SCOLAIRE;BAC PROFESSIONNEL;BAC PRO PROD;BAC PRO 22704 TECHN. MAINT. SYST.ENERG.CLIMATI;94;94;50;38;6;6;0;56;0;1;3;18;34;38
18868.0;2023;24;CRETEIL;MASCULIN;SCOLAIRE;BAC PROFESSIONNEL;BAC PRO PROD;BAC PRO 23203 TECHNICIEN BAT. : ORG.REAL.GROS O;55;55;43;10;2;1;1;44;0;2;9;13;20;11
18870.0;2023;24;CRETEIL;MASCULIN;SCOLAIRE;BAC PROFESSIONNEL;BAC PRO PROD;BAC PRO 23304 AMENAGEMENT FINITION BATIMENT;38;38;24;12;2;2;0;26;0;1;4;6;15;12
18878.0;2023;24;CRETEIL;MASCULIN;SCOLAIRE;BAC PROFESSIONNEL;BAC PRO PROD;BAC PRO 25006 MICROTECHNIQUES;83;83;61;16;6;3;3;64;0;1;9;21;33;19
18881.0;2023;24;CRETEIL;MASCULIN;SCOLAIRE;BAC PROFESSIONNEL;BAC PRO PROD;BAC PRO 25107 TECHNICIEN OUTILLEUR;8;8;7;1;0;0;0;7;0;0;2;3;2;1
18911.0;2023;24;CRETEIL;MASCULIN;SCOLAIRE;BAC PROFESSIONNEL;BAC PRO SERV;BAC PRO 31213 MET.COM.VEN.OP.A ANI.GES.ESP.COM.;1040;1038;710;258;70;50;20;760;0;19;92;258;391;278
18915.0;2023;24;CRETEIL;MASCULIN;SCOLAIRE;BAC PROFESSIONNEL;BAC PRO SERV;BAC PRO 32208 REAL.PR.IMPR.PLURI.OPTB.PR.IMPR.;13;13;11;2;0;0;0;11;0;0;2;3;6;2
18916.0;2023;24;CRETEIL;MASCULIN;SCOLAIRE;BAC PROFESSIONNEL;BAC PRO SERV;BAC PRO 32303 ART.& MET.ART:COM.VIS.VIS.PLURI-M;109;109;92;14;3;3;0;95;0;4;15;37;39;14
18917.0;2023;24;CRETEIL;MASCULIN;SCOLAIRE;BAC PROFESSIONNEL;BAC PRO SERV;BAC PRO 32304 PHOTOGRAPHIE;18;18;16;2;0;0;0;16;0;1;2;6;7;2
18919.0;2023;24;CRETEIL;MASCULIN;SCOLAIRE;BAC PROFESSIONNEL;BAC PRO SERV;BAC PRO 33004 ACC.SOINS-S.PERS. OPT.EN STRUCTUR;121;121;89;21;11;11;0;100;0;5;20;29;46;21
18920.0;2023;24;CRETEIL;MASCULIN;SCOLAIRE;BAC PROFESSIONNEL;BAC PRO SERV;BAC PRO 33006 ANIMAT. ENFANCE& PERSONNES AGEES;108;108;93;9;6;6;0;99;0;5;26;37;31;9
18927.0;2023;24;CRETEIL;MASCULIN;SCOLAIRE;BAC PROFESSIONNEL;BAC PRO SERV;BAC PRO 34403 METIERS DE LA SECURITE;151;151;122;23;6;6;0;128;0;4;32;54;38;23
18932.0;2023;24;CRETEIL;MASCULIN;SCOLAIRE;BAC TECHNOLOGIQUE;BAC STHR;BAC STHR SC.&TEC. HOTELLERIE-RESTAURATION;38;38;33;1;4;4;0;37;0;1;3;19;14;1
18934.0;2023;24;CRETEIL;MASCULIN;SCOLAIRE;BAC TECHNOLOGIQUE;BAC STI2D;BAC STI2D ENERGIES  ET ENVIRONNEMENT;353;353;245;36;72;58;14;303;0;5;31;72;195;50
18937.0;2023;24;CRETEIL;MASCULIN;SCOLAIRE;BAC TECHNOLOGIQUE;BAC STL;BAC STL BIOCHIM.-BIOLOGIE-BIOTECHNOL.;90;90;72;9;9;5;4;77;0;2;14;17;44;13
18939.0;2023;24;CRETEIL;MASCULIN;SCOLAIRE;BAC TECHNOLOGIQUE;BAC STMG;BAC STMG GESTION ET FINANCE;1070;1070;754;116;200;162;38;916;0;10;73;242;591;154
18940.0;2023;24;CRETEIL;MASCULIN;SCOLAIRE;BAC TECHNOLOGIQUE;BAC STMG;BAC STMG MERCATIQUE (MARKETING);1714;1714;1094;199;421;358;63;1452;0;6;54;288;1104;262
18945.0;2023;07;DIJON;FEMININ;APPRENTISSAGE;BAC PROFESSIONNEL;BAC PRO PROD;BAC PRO 23208 METIERS ET ARTS DE LA PIERRE;2;2;2;0;0;0;0;2;0;1;0;1;0;0
18949.0;2023;07;DIJON;FEMININ;APPRENTISSAGE;BAC PROFESSIONNEL;BAC PRO PROD;BAC PRO 25106 TECHNICIEN D'USINAGE;1;1;1;0;0;0;0;1;0;0;0;0;1;0
18954.0;2023;07;DIJON;FEMININ;APPRENTISSAGE;BAC PROFESSIONNEL;BAC PRO PROD;BAC PRO AG 21004 CGEA;7;6;5;1;0;0;0;5;0;0;1;1;3;1
18957.0;2023;07;DIJON;FEMININ;APPRENTISSAGE;BAC PROFESSIONNEL;BAC PRO PROD;BAC PRO AG 21211 COND GEST ENTR HIPPIQUE;19;19;15;4;0;0;0;15;0;0;0;5;10;4
18958.0;2023;07;DIJON;FEMININ;APPRENTISSAGE;BAC PROFESSIONNEL;BAC PRO PROD;BAC PRO AG 21405 AMENAGEMENTS PAYSAGERS;4;4;3;1;0;0;0;3;0;0;0;1;2;1
18965.0;2023;07;DIJON;FEMININ;APPRENTISSAGE;BAC PROFESSIONNEL;BAC PRO SERV;BAC PRO 33403 COMMERC. SERVICES EN RESTAURATION;13;12;11;0;1;0;1;11;0;2;0;5;4;1
18970.0;2023;07;DIJON;FEMININ;ENSEIGNEMENT A DISTANCE;BAC PROFESSIONNEL;BAC PRO SERV;BAC PRO 31213 MET.COM.VEN.OP.A ANI.GES.ESP.COM.;1;1;1;0;0;0;0;1;0;0;1;0;0;0
18980.0;2023;07;DIJON;FEMININ;FORMATION CONTINUE;BAC PROFESSIONNEL;BAC PRO SERV;BAC PRO 33104 TECHNICIEN EN PROTHESE DENTAIRE;1;1;1;0;0;0;0;1;0;0;0;1;0;0
18981.0;2023;07;DIJON;FEMININ;INDIVIDUEL;BAC GENERAL;BAC GENERAL;BAC GENE 10019 BAC GENERAL;45;45;16;23;6;4;2;20;0;3;4;4;9;25
18984.0;2023;07;DIJON;FEMININ;INDIVIDUEL;BAC PROFESSIONNEL;BAC PRO PROD;BAC PRO AG 21211 COND GEST ENTR HIPPIQUE;2;2;2;0;0;0;0;2;0;0;0;0;2;0
18999.0;2023;07;DIJON;FEMININ;SCOLAIRE;BAC PROFESSIONNEL;BAC PRO PROD;BAC PRO 22105 BOULANGER-PÂTISSIER;27;27;24;2;1;1;0;25;0;3;12;6;4;2
19001.0;2023;07;DIJON;FEMININ;SCOLAIRE;BAC PROFESSIONNEL;BAC PRO PROD;BAC PRO 23004 TECHN. ETUDES BAT.A ETUDES & ECO.;1;1;0;1;0;0;0;0;0;0;0;0;0;1
19007.0;2023;07;DIJON;FEMININ;SCOLAIRE;BAC PROFESSIONNEL;BAC PRO PROD;BAC PRO 23408 Etude et réalisation d'agencement;9;9;9;0;0;0;0;9;0;0;2;3;4;0
19016.0;2023;07;DIJON;FEMININ;SCOLAIRE;BAC PROFESSIONNEL;BAC PRO PROD;BAC PRO 25408 REPARATION DES CARROSSERIES;2;2;2;0;0;0;0;2;0;0;1;0;1;0
19022.0;2023;07;DIJON;FEMININ;SCOLAIRE;BAC PROFESSIONNEL;BAC PRO PROD;BAC PRO AG 21004 CGEA;28;27;23;4;0;0;0;23;0;1;5;6;11;4
19025.0;2023;07;DIJON;FEMININ;SCOLAIRE;BAC PROFESSIONNEL;BAC PRO PROD;BAC PRO AG 21203 TECHN CONSEIL DE VENTE ANIMAL;11;11;10;1;0;0;0;10;0;0;1;1;8;1
19026.0;2023;07;DIJON;FEMININ;SCOLAIRE;BAC PROFESSIONNEL;BAC PRO PROD;BAC PRO AG 21210 COND GEST ENTR CANIN ET FELIN;19;19;18;1;0;0;0;18;0;0;3;1;14;1
19040.0;2023;07;DIJON;FEMININ;SCOLAIRE;BAC PROFESSIONNEL;BAC PRO SERV;BAC PRO 33101 OPTIQUE LUNETTERIE;6;6;6;0;0;0;0;6;0;1;1;3;1;0
19043.0;2023;07;DIJON;FEMININ;SCOLAIRE;BAC PROFESSIONNEL;BAC PRO SERV;BAC PRO 33403 COMMERC. SERVICES EN RESTAURATION;39;39;31;5;3;2;1;33;0;0;7;11;15;6
19048.0;2023;07;DIJON;FEMININ;SCOLAIRE;BAC PROFESSIONNEL;BAC PRO SERV;BAC PRO 34403 METIERS DE LA SECURITE;31;31;30;1;0;0;0;30;0;3;11;11;5;1
19053.0;2023;07;DIJON;FEMININ;SCOLAIRE;BAC TECHNOLOGIQUE;BAC STAV;BAC STAV AGRONOMIE ALIM ENV TERRITOI;96;93;86;7;0;0;0;86;0;1;12;21;52;7
19055.0;2023;07;DIJON;FEMININ;SCOLAIRE;BAC TECHNOLOGIQUE;BAC STHR;BAC STHR SC.&TEC. HOTELLERIE-RESTAURATION;30;30;27;0;3;1;2;28;0;4;4;8;12;2
19061.0;2023;07;DIJON;FEMININ;SCOLAIRE;BAC TECHNOLOGIQUE;BAC STL;BAC STL SCIENCES PHYSIQUES CHIMIQUES  EN LABORAT.;27;27;23;1;3;3;0;26;0;3;3;8;12;1
19062.0;2023;07;DIJON;FEMININ;SCOLAIRE;BAC TECHNOLOGIQUE;BAC STMG;BAC STMG GESTION ET FINANCE;147;147;123;5;19;16;3;139;0;2;26;42;69;8
19065.0;2023;07;DIJON;FEMININ;SCOLAIRE;BAC TECHNOLOGIQUE;BAC STMG;BAC STMG SYSTEMES D'INFORMATION DE GESTION;9;9;7;0;2;2;0;9;0;0;0;5;4;0
19067.0;2023;07;DIJON;MASCULIN;APPRENTISSAGE;BAC PROFESSIONNEL;BAC PRO PROD;BAC PRO 22106 CUISINE;14;13;11;2;0;0;0;11;0;0;2;5;4;2
19075.0;2023;07;DIJON;MASCULIN;APPRENTISSAGE;BAC PROFESSIONNEL;BAC PRO PROD;BAC PRO 23405 TECHNICIEN MENUISIER AGENCEUR;3;3;3;0;0;0;0;3;0;0;0;1;2;0
19077.0;2023;07;DIJON;MASCULIN;APPRENTISSAGE;BAC PROFESSIONNEL;BAC PRO PROD;BAC PRO 25007 MAINTENANCE EQUIPEMENTS INDUST.;34;34;30;3;1;1;0;31;0;2;7;10;12;3
19078.0;2023;07;DIJON;MASCULIN;APPRENTISSAGE;BAC PROFESSIONNEL;BAC PRO PROD;BAC PRO 25009 MAINTENANCE NAUTIQUE;3;3;2;0;1;1;0;3;0;0;1;1;1;0
19079.0;2023;07;DIJON;MASCULIN;APPRENTISSAGE;BAC PROFESSIONNEL;BAC PRO PROD;BAC PRO 25106 TECHNICIEN D'USINAGE;14;14;10;2;2;1;1;11;0;0;2;1;8;3
19081.0;2023;07;DIJON;MASCULIN;APPRENTISSAGE;BAC PROFESSIONNEL;BAC PRO PROD;BAC PRO 25214 MAINT.VEHIC.OPTA VOIT.PARTICUL.;102;99;79;10;10;8;2;87;0;6;9;28;44;12
19082.0;2023;07;DIJON;MASCULIN;APPRENTISSAGE;BAC PROFESSIONNEL;BAC PRO PROD;BAC PRO 25215 MAINT.VEHIC.OPTB VEHIC.TRANS.ROUT;15;15;10;5;0;0;0;10;0;0;2;5;3;5
19097.0;2023;07;DIJON;MASCULIN;APPRENTISSAGE;BAC PROFESSIONNEL;BAC PRO PROD;BAC PRO AG 22108 TEC CONS VTE ALIMENTATION (PAB);3;3;2;1;0;0;0;2;0;0;0;0;2;1
19105.0;2023;07;DIJON;MASCULIN;ENSEIGNEMENT A DISTANCE;BAC TECHNOLOGIQUE;BAC ST2S;BAC ST2S SCIENCES & TECHNO. SANTE & SOCIAL;2;2;1;1;0;0;0;1;0;0;0;0;1;1
19108.0;2023;07;DIJON;MASCULIN;ENSEIGNEMENT A DISTANCE;BAC TECHNOLOGIQUE;BAC STMG;BAC STMG RESSOURCES HUMAINES ET COMMUNICATION;3;3;1;2;0;0;0;1;0;0;0;1;0;2
19122.0;2023;07;DIJON;MASCULIN;INDIVIDUEL;BAC PROFESSIONNEL;BAC PRO PROD;BAC PRO AG 21113 CGEVV;1;1;1;0;0;0;0;1;0;0;0;0;1;0
19133.0;2023;07;DIJON;MASCULIN;SCOLAIRE;BAC GENERAL;BAC GENERAL;BAC GENE 10019 BAC GENERAL;3479;3479;3121;53;305;205;100;3326;42;308;679;1102;1195;153
19135.0;2023;07;DIJON;MASCULIN;SCOLAIRE;BAC PROFESSIONNEL;BAC PRO PROD;BAC PRO 20102 PILOTE DE LIGNE DE PRODUCTION;7;7;4;1;2;2;0;6;0;0;1;3;2;1
19136.0;2023;07;DIJON;MASCULIN;SCOLAIRE;BAC PROFESSIONNEL;BAC PRO PROD;BAC PRO 22003 BIO-INDUSTRIES DE TRANSFORMATION;8;8;7;0;1;1;0;8;0;0;0;3;5;0
19140.0;2023;07;DIJON;MASCULIN;SCOLAIRE;BAC PROFESSIONNEL;BAC PRO PROD;BAC PRO 22503 PLASTIQUES ET COMPOSITES;17;17;7;9;1;0;1;7;0;1;2;2;2;10
19150.0;2023;07;DIJON;MASCULIN;SCOLAIRE;BAC PROFESSIONNEL;BAC PRO PROD;BAC PRO 23404 TECHNICIEN CONSTRUCTEUR BOIS;16;16;15;1;0;0;0;15;0;0;3;5;7;1
19153.0;2023;07;DIJON;MASCULIN;SCOLAIRE;BAC PROFESSIONNEL;BAC PRO PROD;BAC PRO 24202 ARTIS.& MET.ART : TAPIS.D'AMEUBL;1;1;0;1;0;0;0;0;0;0;0;0;0;1
19162.0;2023;07;DIJON;MASCULIN;SCOLAIRE;BAC PROFESSIONNEL;BAC PRO PROD;BAC PRO 25219 MAINT.MATERIELS OPT.A AGRICOLES;13;13;13;0;0;0;0;13;0;5;3;4;1;0
19167.0;2023;07;DIJON;MASCULIN;SCOLAIRE;BAC PROFESSIONNEL;BAC PRO PROD;BAC PRO 25406 OUVRAGES DU BATIMENT METALLERIE;21;20;19;1;0;0;0;19;0;0;6;6;7;1
19169.0;2023;07;DIJON;MASCULIN;SCOLAIRE;BAC PROFESSIONNEL;BAC PRO PROD;BAC PRO 25411 TECH.CHAUDRONNERIE INDUSTRIELLE;48;48;41;5;2;1;1;42;0;3;10;11;18;6
19172.0;2023;07;DIJON;MASCULIN;SCOLAIRE;BAC PROFESSIONNEL;BAC PRO PROD;BAC PRO 25513 SYST.NUM.OPT.A SURETE SECURITE;26;26;19;6;1;0;1;19;0;1;5;5;8;7
19175.0;2023;07;DIJON;MASCULIN;SCOLAIRE;BAC PROFESSIONNEL;BAC PRO PROD;BAC PRO AG 21001 AGRO-EQUIPEMENT;2;2;2;0;0;0;0;2;0;0;0;1;1;0
19182.0;2023;07;DIJON;MASCULIN;SCOLAIRE;BAC PROFESSIONNEL;BAC PRO PROD;BAC PRO AG 21211 COND GEST ENTR HIPPIQUE;2;2;2;0;0;0;0;2;0;0;0;2;0;0
19184.0;2023;07;DIJON;MASCULIN;SCOLAIRE;BAC PROFESSIONNEL;BAC PRO PROD;BAC PRO AG 21303 FORET;9;9;9;0;0;0;0;9;0;1;1;1;6;0
19185.0;2023;07;DIJON;MASCULIN;SCOLAIRE;BAC PROFESSIONNEL;BAC PRO PROD;BAC PRO AG 21405 AMENAGEMENTS PAYSAGERS;41;41;36;5;0;0;0;36;0;0;5;13;18;5
19187.0;2023;07;DIJON;MASCULIN;SCOLAIRE;BAC PROFESSIONNEL;BAC PRO SERV;BAC PRO 30004 ASSISTANC.GEST.ORGANIS.ACTIVITES;78;78;49;19;10;8;2;57;0;3;13;11;30;21
19190.0;2023;07;DIJON;MASCULIN;SCOLAIRE;BAC PROFESSIONNEL;BAC PRO SERV;BAC PRO 31114 ORGANIS. TRANSPORT MARCHANDISES;8;8;4;2;2;1;1;5;0;0;2;2;1;3
19196.0;2023;07;DIJON;MASCULIN;SCOLAIRE;BAC PROFESSIONNEL;BAC PRO SERV;BAC PRO 33002 SERVICES DE PROXIMITE  VIE LOCAL;1;1;1;0;0;0;0;1;0;0;0;0;1;0
19197.0;2023;07;DIJON;MASCULIN;SCOLAIRE;BAC PROFESSIONNEL;BAC PRO SERV;BAC PRO 33003 ACC.SOINS-S.PERS. OPT.A DOMICILE;12;12;12;0;0;0;0;12;0;0;0;8;4;0
19208.0;2023;07;DIJON;MASCULIN;SCOLAIRE;BAC PROFESSIONNEL;BAC PRO SERV;BAC PRO 34403 METIERS DE LA SECURITE;59;59;53;4;2;1;1;54;0;3;19;22;10;5
19216.0;2023;07;DIJON;MASCULIN;SCOLAIRE;BAC TECHNOLOGIQUE;BAC STI2D;BAC STI2D ARCHITECTURE ET CONSTRUCTION;62;62;50;1;11;5;6;55;0;1;6;18;30;7
19217.0;2023;07;DIJON;MASCULIN;SCOLAIRE;BAC TECHNOLOGIQUE;BAC STI2D;BAC STI2D ENERGIES  ET ENVIRONNEMENT;79;79;63;2;14;8;6;71;0;3;10;24;34;8
19218.0;2023;07;DIJON;MASCULIN;SCOLAIRE;BAC TECHNOLOGIQUE;BAC STI2D;BAC STI2D INNOVATION TECHNO.  ET ECO CONCEPTION;253;253;217;6;30;18;12;235;0;2;38;79;116;18
19219.0;2023;07;DIJON;MASCULIN;SCOLAIRE;BAC TECHNOLOGIQUE;BAC STI2D;BAC STI2D SYSTÈME D'INFORMATION  ET NUMERIQUE;142;142;131;0;11;7;4;138;0;7;31;56;44;4
19226.0;2023;08;GRENOBLE;FEMININ;APPRENTISSAGE;BAC PROFESSIONNEL;BAC PRO PROD;BAC PRO 20102 PILOTE DE LIGNE DE PRODUCTION;3;3;3;0;0;0;0;3;0;0;1;2;0;0
19232.0;2023;08;GRENOBLE;FEMININ;APPRENTISSAGE;BAC PROFESSIONNEL;BAC PRO PROD;BAC PRO 23203 TECHNICIEN BAT. : ORG.REAL.GROS O;1;1;1;0;0;0;0;1;0;0;1;0;0;0
19237.0;2023;08;GRENOBLE;FEMININ;APPRENTISSAGE;BAC PROFESSIONNEL;BAC PRO PROD;BAC PRO 24302 METIERS DU CUIR : MAROQUINERIE;5;5;5;0;0;0;0;5;0;1;2;1;1;0
19241.0;2023;08;GRENOBLE;FEMININ;APPRENTISSAGE;BAC PROFESSIONNEL;BAC PRO PROD;BAC PRO 25215 MAINT.VEHIC.OPTB VEHIC.TRANS.ROUT;2;2;2;0;0;0;0;2;0;1;0;1;0;0
19244.0;2023;08;GRENOBLE;FEMININ;APPRENTISSAGE;BAC PROFESSIONNEL;BAC PRO PROD;BAC PRO 25408 REPARATION DES CARROSSERIES;1;1;1;0;0;0;0;1;0;1;0;0;0;0
19245.0;2023;08;GRENOBLE;FEMININ;APPRENTISSAGE;BAC PROFESSIONNEL;BAC PRO PROD;BAC PRO 25411 TECH.CHAUDRONNERIE INDUSTRIELLE;1;1;0;0;1;1;0;1;0;0;0;0;1;0
19247.0;2023;08;GRENOBLE;FEMININ;APPRENTISSAGE;BAC PROFESSIONNEL;BAC PRO PROD;BAC PRO AG 21004 CGEA;3;3;2;1;0;0;0;2;0;1;0;0;1;1
19251.0;2023;08;GRENOBLE;FEMININ;APPRENTISSAGE;BAC PROFESSIONNEL;BAC PRO PROD;BAC PRO AG 22108 TEC CONS VTE ALIMENTATION (PAB);13;13;11;2;0;0;0;11;0;1;0;5;5;2
19252.0;2023;08;GRENOBLE;FEMININ;APPRENTISSAGE;BAC PROFESSIONNEL;BAC PRO SERV;BAC PRO 30004 ASSISTANC.GEST.ORGANIS.ACTIVITES;45;45;37;6;2;2;0;39;0;9;12;8;10;6
19253.0;2023;08;GRENOBLE;FEMININ;APPRENTISSAGE;BAC PROFESSIONNEL;BAC PRO SERV;BAC PRO 31106 LOGISTIQUE;4;4;4;0;0;0;0;4;0;1;1;2;0;0
19254.0;2023;08;GRENOBLE;FEMININ;APPRENTISSAGE;BAC PROFESSIONNEL;BAC PRO SERV;BAC PRO 31114 ORGANIS. TRANSPORT MARCHANDISES;1;1;1;0;0;0;0;1;0;0;1;0;0;0
19255.0;2023;08;GRENOBLE;FEMININ;APPRENTISSAGE;BAC PROFESSIONNEL;BAC PRO SERV;BAC PRO 31212 METIERS DE L'ACCUEIL;28;28;23;5;0;0;0;23;0;4;6;12;1;5
19256.0;2023;08;GRENOBLE;FEMININ;APPRENTISSAGE;BAC PROFESSIONNEL;BAC PRO SERV;BAC PRO 31213 MET.COM.VEN.OP.A ANI.GES.ESP.COM.;175;173;143;21;9;5;4;148;0;12;30;64;42;25
19271.0;2023;08;GRENOBLE;FEMININ;ENSEIGNEMENT A DISTANCE;BAC TECHNOLOGIQUE;BAC STMG;BAC STMG RESSOURCES HUMAINES ET COMMUNICATION;7;7;3;2;2;2;0;5;0;0;1;0;4;2
19273.0;2023;08;GRENOBLE;FEMININ;INDIVIDUEL;BAC GENERAL;BAC GENERAL;BAC GENE 10019 BAC GENERAL;86;86;33;36;17;8;9;41;0;3;3;4;31;45
19277.0;2023;08;GRENOBLE;FEMININ;INDIVIDUEL;BAC PROFESSIONNEL;BAC PRO SERV;BAC PRO 30004 ASSISTANC.GEST.ORGANIS.ACTIVITES;7;5;2;2;1;0;1;2;0;0;0;1;1;3
19280.0;2023;08;GRENOBLE;FEMININ;INDIVIDUEL;BAC PROFESSIONNEL;BAC PRO SERV;BAC PRO 31213 MET.COM.VEN.OP.A ANI.GES.ESP.COM.;2;2;0;1;1;0;1;0;0;0;0;0;0;2
19283.0;2023;08;GRENOBLE;FEMININ;INDIVIDUEL;BAC PROFESSIONNEL;BAC PRO SERV;BAC PRO 33003 ACC.SOINS-S.PERS. OPT.A DOMICILE;2;0;0;0;0;0;0;0;0;0;0;0;0;0
19288.0;2023;08;GRENOBLE;FEMININ;INDIVIDUEL;BAC PROFESSIONNEL;BAC PRO SERV;BAC PRO AG 33002 SERV PERS TERRIT;2;2;1;1;0;0;0;1;0;0;0;0;1;1
19289.0;2023;08;GRENOBLE;FEMININ;INDIVIDUEL;BAC TECHNOLOGIQUE;BAC ST2S;BAC ST2S SCIENCES & TECHNO. SANTE & SOCIAL;12;12;4;6;2;2;0;6;0;0;1;0;5;6
19291.0;2023;08;GRENOBLE;FEMININ;INDIVIDUEL;BAC TECHNOLOGIQUE;BAC STI2D;BAC STI2D ARCHITECTURE ET CONSTRUCTION;2;2;0;1;1;0;1;0;0;0;0;0;0;2
19292.0;2023;08;GRENOBLE;FEMININ;INDIVIDUEL;BAC TECHNOLOGIQUE;BAC STI2D;BAC STI2D INNOVATION TECHNO.  ET ECO CONCEPTION;1;1;0;1;0;0;0;0;0;0;0;0;0;1
19295.0;2023;08;GRENOBLE;FEMININ;INDIVIDUEL;BAC TECHNOLOGIQUE;BAC STMG;BAC STMG MERCATIQUE (MARKETING);9;9;0;6;3;1;2;1;0;0;0;0;1;8
19299.0;2023;08;GRENOBLE;FEMININ;SCOLAIRE;BAC PROFESSIONNEL;BAC PRO PROD;BAC PRO 22003 BIO-INDUSTRIES DE TRANSFORMATION;1;1;1;0;0;0;0;1;0;0;1;0;0;0
19305.0;2023;08;GRENOBLE;FEMININ;SCOLAIRE;BAC PROFESSIONNEL;BAC PRO PROD;BAC PRO 23004 TECHN. ETUDES BAT.A ETUDES & ECO.;11;11;4;4;3;2;1;6;0;1;1;0;4;5
19307.0;2023;08;GRENOBLE;FEMININ;SCOLAIRE;BAC PROFESSIONNEL;BAC PRO PROD;BACPRO 23103 TECHNICIEN GEOMETRE-TOPOGRAPHE;2;2;2;0;0;0;0;2;0;0;1;1;0;0
19309.0;2023;08;GRENOBLE;FEMININ;SCOLAIRE;BAC PROFESSIONNEL;BAC PRO PROD;BAC PRO 23304 AMENAGEMENT FINITION BATIMENT;2;2;2;0;0;0;0;2;0;0;0;2;0;0
19310.0;2023;08;GRENOBLE;FEMININ;SCOLAIRE;BAC PROFESSIONNEL;BAC PRO PROD;BAC PRO 23404 TECHNICIEN CONSTRUCTEUR BOIS;1;1;1;0;0;0;0;1;0;0;1;0;0;0
19314.0;2023;08;GRENOBLE;FEMININ;SCOLAIRE;BAC PROFESSIONNEL;BAC PRO PROD;BAC PRO 24203 METIERS DE LA MODE - VÊTEMENT;108;108;95;9;4;3;1;98;0;16;20;31;31;10
19320.0;2023;08;GRENOBLE;FEMININ;SCOLAIRE;BAC PROFESSIONNEL;BAC PRO PROD;BAC PRO 25106 TECHNICIEN D'USINAGE;1;1;1;0;0;0;0;1;0;0;0;0;1;0
19324.0;2023;08;GRENOBLE;FEMININ;SCOLAIRE;BAC PROFESSIONNEL;BAC PRO PROD;BAC PRO 25513 SYST.NUM.OPT.A SURETE SECURITE;1;1;0;1;0;0;0;0;0;0;0;0;0;1
19326.0;2023;08;GRENOBLE;FEMININ;SCOLAIRE;BAC PROFESSIONNEL;BAC PRO PROD;BAC PRO AG 21004 CGEA;64;64;49;15;0;0;0;49;0;1;8;11;29;15
19329.0;2023;08;GRENOBLE;FEMININ;SCOLAIRE;BAC PROFESSIONNEL;BAC PRO PROD;BAC PRO AG 21204 PROD-AQUACOLES;1;1;1;0;0;0;0;1;0;0;1;0;0;0
19331.0;2023;08;GRENOBLE;FEMININ;SCOLAIRE;BAC PROFESSIONNEL;BAC PRO PROD;BAC PRO AG 21211 COND GEST ENTR HIPPIQUE;93;92;82;10;0;0;0;82;0;2;14;22;44;10
19341.0;2023;08;GRENOBLE;FEMININ;SCOLAIRE;BAC PROFESSIONNEL;BAC PRO SERV;BAC PRO 31114 ORGANIS. TRANSPORT MARCHANDISES;15;15;10;5;0;0;0;10;0;0;3;2;5;5
19346.0;2023;08;GRENOBLE;FEMININ;SCOLAIRE;BAC PROFESSIONNEL;BAC PRO SERV;BAC PRO 32208 REAL.PR.IMPR.PLURI.OPTB.PR.IMPR.;4;4;4;0;0;0;0;4;0;1;2;1;0;0
19348.0;2023;08;GRENOBLE;FEMININ;SCOLAIRE;BAC PROFESSIONNEL;BAC PRO SERV;BAC PRO 33003 ACC.SOINS-S.PERS. OPT.A DOMICILE;121;121;109;11;1;1;0;110;0;8;27;40;35;11
19355.0;2023;08;GRENOBLE;FEMININ;SCOLAIRE;BAC PROFESSIONNEL;BAC PRO SERV;BAC PRO 34305 TECHN.D'INTERV.SUR INSTALL. NUCL.;1;1;1;0;0;0;0;1;0;0;0;1;0;0
19357.0;2023;08;GRENOBLE;FEMININ;SCOLAIRE;BAC PROFESSIONNEL;BAC PRO SERV;BAC PRO AG 33002 SERV PERS TERRIT;420;416;368;48;0;0;0;368;0;5;44;141;178;48
19370.0;2023;08;GRENOBLE;FEMININ;SCOLAIRE;BAC TECHNOLOGIQUE;BAC STMG;BAC STMG GESTION ET FINANCE;450;450;384;12;54;38;16;422;0;11;68;157;186;28
19373.0;2023;08;GRENOBLE;FEMININ;SCOLAIRE;BAC TECHNOLOGIQUE;BAC STMG;BAC STMG SYSTEMES D'INFORMATION DE GESTION;37;37;30;0;7;5;2;35;0;0;1;11;23;2
19375.0;2023;08;GRENOBLE;MASCULIN;APPRENTISSAGE;BAC PROFESSIONNEL;BAC PRO PROD;BAC PRO 20102 PILOTE DE LIGNE DE PRODUCTION;13;13;10;3;0;0;0;10;0;2;2;1;5;3
19376.0;2023;08;GRENOBLE;MASCULIN;APPRENTISSAGE;BAC PROFESSIONNEL;BAC PRO PROD;BAC PRO 22003 BIO-INDUSTRIES DE TRANSFORMATION;5;5;5;0;0;0;0;5;0;0;2;1;2;0
19389.0;2023;08;GRENOBLE;MASCULIN;APPRENTISSAGE;BAC PROFESSIONNEL;BAC PRO PROD;BAC PRO 24302 METIERS DU CUIR : MAROQUINERIE;2;2;2;0;0;0;0;2;0;0;1;0;1;0
19398.0;2023;08;GRENOBLE;MASCULIN;APPRENTISSAGE;BAC PROFESSIONNEL;BAC PRO PROD;BAC PRO 25219 MAINT.MATERIELS OPT.A AGRICOLES;9;9;9;0;0;0;0;9;0;1;3;3;2;0
19401.0;2023;08;GRENOBLE;MASCULIN;APPRENTISSAGE;BAC PROFESSIONNEL;BAC PRO PROD;BAC PRO 25302 AERONAUTIQUE OPTION AVIONIQUE;3;3;3;0;0;0;0;3;0;0;1;2;0;0
19412.0;2023;08;GRENOBLE;MASCULIN;APPRENTISSAGE;BAC PROFESSIONNEL;BAC PRO PROD;BAC PRO AG 21114 CONDUITE PRODUCTIONS HORTICOLES;6;6;5;1;0;0;0;5;0;0;1;2;2;1
19417.0;2023;08;GRENOBLE;MASCULIN;APPRENTISSAGE;BAC PROFESSIONNEL;BAC PRO SERV;BAC PRO 30004 ASSISTANC.GEST.ORGANIS.ACTIVITES;5;5;5;0;0;0;0;5;0;0;2;1;2;0
19418.0;2023;08;GRENOBLE;MASCULIN;APPRENTISSAGE;BAC PROFESSIONNEL;BAC PRO SERV;BAC PRO 31106 LOGISTIQUE;26;26;24;2;0;0;0;24;0;3;6;10;5;2
19424.0;2023;08;GRENOBLE;MASCULIN;APPRENTISSAGE;BAC PROFESSIONNEL;BAC PRO SERV;BAC PRO 34403 METIERS DE LA SECURITE;5;5;5;0;0;0;0;5;0;0;0;2;3;0
19432.0;2023;08;GRENOBLE;MASCULIN;ENSEIGNEMENT A DISTANCE;BAC TECHNOLOGIQUE;BAC STMG;BAC STMG GESTION ET FINANCE;2;2;1;1;0;0;0;1;0;0;0;0;1;1
19437.0;2023;08;GRENOBLE;MASCULIN;FORMATION CONTINUE;BAC PROFESSIONNEL;BAC PRO PROD;BAC PRO 25007 MAINTENANCE EQUIPEMENTS INDUST.;2;2;2;0;0;0;0;2;0;0;0;2;0;0
19438.0;2023;08;GRENOBLE;MASCULIN;FORMATION CONTINUE;BAC PROFESSIONNEL;BAC PRO PROD;BAC PRO 25106 TECHNICIEN D'USINAGE;1;1;1;0;0;0;0;1;0;0;0;0;1;0
19444.0;2023;08;GRENOBLE;MASCULIN;INDIVIDUEL;BAC PROFESSIONNEL;BAC PRO PROD;BAC PRO 22703 TECHN.INSTALL.SYST.ENERG.CLIMATI;1;1;1;0;0;0;0;1;0;0;0;0;1;0
19449.0;2023;08;GRENOBLE;MASCULIN;INDIVIDUEL;BAC PROFESSIONNEL;BAC PRO PROD;BAC PRO 25006 MICROTECHNIQUES;1;1;1;0;0;0;0;1;0;0;0;0;1;0
19459.0;2023;08;GRENOBLE;MASCULIN;INDIVIDUEL;BAC PROFESSIONNEL;BAC PRO PROD;BAC PRO AG 21113 CGEVV;1;1;1;0;0;0;0;1;0;0;0;0;1;0
19460.0;2023;08;GRENOBLE;MASCULIN;INDIVIDUEL;BAC PROFESSIONNEL;BAC PRO PROD;BAC PRO AG 21114 CONDUITE PRODUCTIONS HORTICOLES;1;1;1;0;0;0;0;1;0;0;0;0;1;0
19462.0;2023;08;GRENOBLE;MASCULIN;INDIVIDUEL;BAC PROFESSIONNEL;BAC PRO SERV;BAC PRO 31106 LOGISTIQUE;3;1;0;0;1;1;0;1;0;0;0;0;1;0
19471.0;2023;08;GRENOBLE;MASCULIN;INDIVIDUEL;BAC TECHNOLOGIQUE;BAC STI2D;BAC STI2D ENERGIES  ET ENVIRONNEMENT;1;1;0;1;0;0;0;0;0;0;0;0;0;1
19474.0;2023;08;GRENOBLE;MASCULIN;INDIVIDUEL;BAC TECHNOLOGIQUE;BAC STMG;BAC STMG GESTION ET FINANCE;3;3;0;3;0;0;0;0;0;0;0;0;0;3
19479.0;2023;08;GRENOBLE;MASCULIN;SCOLAIRE;BAC PROFESSIONNEL;BAC PRO PROD;BAC PRO 20102 PILOTE DE LIGNE DE PRODUCTION;18;18;12;4;2;2;0;14;0;1;2;5;6;4
19482.0;2023;08;GRENOBLE;MASCULIN;SCOLAIRE;BAC PROFESSIONNEL;BAC PRO PROD;BAC PRO 22105 BOULANGER-PÂTISSIER;15;15;13;2;0;0;0;13;0;1;6;3;3;2
19485.0;2023;08;GRENOBLE;MASCULIN;SCOLAIRE;BAC PROFESSIONNEL;BAC PRO PROD;BAC PRO 22703 TECHN.INSTALL.SYST.ENERG.CLIMATI;105;105;77;15;13;12;1;89;0;2;20;31;36;16
19486.0;2023;08;GRENOBLE;MASCULIN;SCOLAIRE;BAC PROFESSIONNEL;BAC PRO PROD;BAC PRO 22704 TECHN. MAINT. SYST.ENERG.CLIMATI;38;38;36;2;0;0;0;36;0;2;7;9;18;2
19488.0;2023;08;GRENOBLE;MASCULIN;SCOLAIRE;BAC PROFESSIONNEL;BAC PRO PROD;BAC PRO 23004 TECHN. ETUDES BAT.A ETUDES & ECO.;44;44;28;15;1;1;0;29;0;0;2;8;19;15
19503.0;2023;08;GRENOBLE;MASCULIN;SCOLAIRE;BAC PROFESSIONNEL;BAC PRO PROD;BAC PRO 25007 MAINTENANCE EQUIPEMENTS INDUST.;349;348;248;86;14;11;3;259;0;11;38;93;117;89
19511.0;2023;08;GRENOBLE;MASCULIN;SCOLAIRE;BAC PROFESSIONNEL;BAC PRO PROD;BAC PRO 25408 REPARATION DES CARROSSERIES;52;52;37;12;3;1;2;38;0;1;6;8;23;14
19512.0;2023;08;GRENOBLE;MASCULIN;SCOLAIRE;BAC PROFESSIONNEL;BAC PRO PROD;BAC PRO 25411 TECH.CHAUDRONNERIE INDUSTRIELLE;67;67;43;22;2;2;0;45;0;4;10;16;15;22
19519.0;2023;08;GRENOBLE;MASCULIN;SCOLAIRE;BAC PROFESSIONNEL;BAC PRO PROD;BAC PRO AG 21004 CGEA;108;108;98;10;0;0;0;98;0;7;20;35;36;10
19522.0;2023;08;GRENOBLE;MASCULIN;SCOLAIRE;BAC PROFESSIONNEL;BAC PRO PROD;BAC PRO AG 21204 PROD-AQUACOLES;11;11;9;2;0;0;0;9;0;0;1;4;4;2
19525.0;2023;08;GRENOBLE;MASCULIN;SCOLAIRE;BAC PROFESSIONNEL;BAC PRO PROD;BAC PRO AG 21302 GEST MILIEUX NATURELS FAUNE;68;68;63;5;0;0;0;63;0;3;11;27;22;5
19544.0;2023;08;GRENOBLE;MASCULIN;SCOLAIRE;BAC PROFESSIONNEL;BAC PRO SERV;BAC PRO 33006 ANIMAT. ENFANCE& PERSONNES AGEES;23;23;20;3;0;0;0;20;0;0;8;9;3;3
19548.0;2023;08;GRENOBLE;MASCULIN;SCOLAIRE;BAC PROFESSIONNEL;BAC PRO SERV;BAC PRO 34305 TECHN.D'INTERV.SUR INSTALL. NUCL.;21;21;16;3;2;2;0;18;0;0;3;6;9;3
19553.0;2023;08;GRENOBLE;MASCULIN;SCOLAIRE;BAC TECHNOLOGIQUE;BAC ST2S;BAC ST2S SCIENCES & TECHNO. SANTE & SOCIAL;124;124;108;0;16;10;6;118;0;1;5;39;73;6
19554.0;2023;08;GRENOBLE;MASCULIN;SCOLAIRE;BAC TECHNOLOGIQUE;BAC STAV;BAC STAV AGRONOMIE ALIM ENV TERRITOI;177;177;175;2;0;0;0;175;0;1;18;73;83;2
19556.0;2023;08;GRENOBLE;MASCULIN;SCOLAIRE;BAC TECHNOLOGIQUE;BAC STHR;BAC STHR SC.&TEC. HOTELLERIE-RESTAURATION;74;74;70;0;4;4;0;74;0;5;22;24;23;0
19574.0;2023;32;GUADELOUPE;FEMININ;ENSEIGNEMENT A DISTANCE;BAC GENERAL;BAC GENERAL;BAC GENE 10019 BAC GENERAL;9;9;9;0;0;0;0;9;1;0;1;4;3;0
19576.0;2023;32;GUADELOUPE;FEMININ;ENSEIGNEMENT A DISTANCE;BAC PROFESSIONNEL;BAC PRO SERV;BAC PRO 33003 ACC.SOINS-S.PERS. OPT.A DOMICILE;1;1;0;1;0;0;0;0;0;0;0;0;0;1
19593.0;2023;32;GUADELOUPE;FEMININ;INDIVIDUEL;BAC PROFESSIONNEL;BAC PRO SERV;BAC PRO 33004 ACC.SOINS-S.PERS. OPT.EN STRUCTUR;1;0;0;0;0;0;0;0;0;0;0;0;0;0
19597.0;2023;32;GUADELOUPE;FEMININ;INDIVIDUEL;BAC TECHNOLOGIQUE;BAC ST2S;BAC ST2S SCIENCES & TECHNO. SANTE & SOCIAL;1;1;0;1;0;0;0;0;0;0;0;0;0;1
19598.0;2023;32;GUADELOUPE;FEMININ;INDIVIDUEL;BAC TECHNOLOGIQUE;BAC STL;BAC STL BIOCHIM.-BIOLOGIE-BIOTECHNOL.;1;1;0;0;1;1;0;1;0;0;0;0;1;0
19605.0;2023;32;GUADELOUPE;FEMININ;SCOLAIRE;BAC PROFESSIONNEL;BAC PRO PROD;BAC PRO 22106 CUISINE;17;17;16;1;0;0;0;16;0;1;6;4;5;1
19607.0;2023;32;GUADELOUPE;FEMININ;SCOLAIRE;BAC PROFESSIONNEL;BAC PRO PROD;BAC PRO 23004 TECHN. ETUDES BAT.A ETUDES & ECO.;4;4;4;0;0;0;0;4;0;0;0;1;3;0
19609.0;2023;32;GUADELOUPE;FEMININ;SCOLAIRE;BAC PROFESSIONNEL;BAC PRO PROD;BAC PRO 23203 TECHNICIEN BAT. : ORG.REAL.GROS O;1;1;0;0;1;1;0;1;0;0;0;0;1;0
19612.0;2023;32;GUADELOUPE;FEMININ;SCOLAIRE;BAC PROFESSIONNEL;BAC PRO PROD;BAC PRO 23405 TECHNICIEN MENUISIER AGENCEUR;6;6;4;1;1;1;0;5;0;0;0;1;4;1
19617.0;2023;32;GUADELOUPE;FEMININ;SCOLAIRE;BAC PROFESSIONNEL;BAC PRO PROD;BAC PRO 25215 MAINT.VEHIC.OPTB VEHIC.TRANS.ROUT;1;1;1;0;0;0;0;1;0;0;1;0;0;0
19633.0;2023;32;GUADELOUPE;FEMININ;SCOLAIRE;BAC PROFESSIONNEL;BAC PRO SERV;BAC PRO 31214 MET.COM.VEN.OP.B PR.CL.VA.OF.COM.;46;46;38;5;3;2;1;40;0;2;7;13;18;6
19642.0;2023;32;GUADELOUPE;FEMININ;SCOLAIRE;BAC PROFESSIONNEL;BAC PRO SERV;BAC PRO 34304 HYGIENE PROPRETE STERILISATION;16;16;13;2;1;0;1;13;0;1;2;2;8;3
19643.0;2023;32;GUADELOUPE;FEMININ;SCOLAIRE;BAC PROFESSIONNEL;BAC PRO SERV;BAC PRO 34403 METIERS DE LA SECURITE;12;12;10;2;0;0;0;10;0;1;4;3;2;2
19644.0;2023;32;GUADELOUPE;FEMININ;SCOLAIRE;BAC PROFESSIONNEL;BAC PRO SERV;BAC PRO AG 33002 SERV PERS TERRIT;73;72;65;7;0;0;0;65;0;0;9;26;30;7
19645.0;2023;32;GUADELOUPE;FEMININ;SCOLAIRE;BAC TECHNOLOGIQUE;BAC S2TMD;BAC S2TMD DANSE;4;4;4;0;0;0;0;4;1;0;2;1;0;0
19648.0;2023;32;GUADELOUPE;FEMININ;SCOLAIRE;BAC TECHNOLOGIQUE;BAC STAV;BAC STAV AGRONOMIE ALIM ENV TERRITOI;7;7;7;0;0;0;0;7;0;0;1;1;5;0
19654.0;2023;32;GUADELOUPE;FEMININ;SCOLAIRE;BAC TECHNOLOGIQUE;BAC STI2D;BAC STI2D SYSTÈME D'INFORMATION  ET NUMERIQUE;6;6;2;0;4;4;0;6;0;0;0;1;5;0
19661.0;2023;32;GUADELOUPE;MASCULIN;APPRENTISSAGE;BAC PROFESSIONNEL;BAC PRO PROD;BAC PRO 22106 CUISINE;1;1;1;0;0;0;0;1;0;0;0;0;1;0
19663.0;2023;32;GUADELOUPE;MASCULIN;APPRENTISSAGE;BAC PROFESSIONNEL;BAC PRO PROD;BAC PRO 25408 REPARATION DES CARROSSERIES;2;2;1;0;1;1;0;2;0;0;0;1;1;0
19667.0;2023;32;GUADELOUPE;MASCULIN;APPRENTISSAGE;BAC PROFESSIONNEL;BAC PRO SERV;BAC PRO 31214 MET.COM.VEN.OP.B PR.CL.VA.OF.COM.;5;4;2;2;0;0;0;2;0;0;0;1;1;2
19671.0;2023;32;GUADELOUPE;MASCULIN;FORMATION CONTINUE;BAC PROFESSIONNEL;BAC PRO PROD;BAC PRO 25510 METIERS ELECT. ENVIRON. CONNECTES;3;2;2;0;0;0;0;2;0;0;1;1;0;0
19672.0;2023;32;GUADELOUPE;MASCULIN;FORMATION CONTINUE;BAC PROFESSIONNEL;BAC PRO PROD;BAC PRO AG 21004 CGEA;1;1;1;0;0;0;0;1;0;0;0;0;1;0
19673.0;2023;32;GUADELOUPE;MASCULIN;FORMATION CONTINUE;BAC PROFESSIONNEL;BAC PRO SERV;BAC PRO 31213 MET.COM.VEN.OP.A ANI.GES.ESP.COM.;5;3;2;1;0;0;0;2;0;0;0;1;1;1
19674.0;2023;32;GUADELOUPE;MASCULIN;FORMATION CONTINUE;BAC PROFESSIONNEL;BAC PRO SERV;BAC PRO 31214 MET.COM.VEN.OP.B PR.CL.VA.OF.COM.;2;2;2;0;0;0;0;2;0;0;0;1;1;0
19688.0;2023;32;GUADELOUPE;MASCULIN;SCOLAIRE;BAC GENERAL;BAC GENERAL;BAC GENE 10019 BAC GENERAL;1209;1209;957;50;202;165;37;1122;16;66;180;289;571;87
19690.0;2023;32;GUADELOUPE;MASCULIN;SCOLAIRE;BAC PROFESSIONNEL;BAC PRO PROD;BAC PRO 22105 BOULANGER-PÂTISSIER;6;6;6;0;0;0;0;6;0;0;2;3;1;0
19694.0;2023;32;GUADELOUPE;MASCULIN;SCOLAIRE;BAC PROFESSIONNEL;BAC PRO PROD;BAC PRO 23004 TECHN. ETUDES BAT.A ETUDES & ECO.;2;2;1;0;1;0;1;1;0;0;0;0;1;1
19697.0;2023;32;GUADELOUPE;MASCULIN;SCOLAIRE;BAC PROFESSIONNEL;BAC PRO PROD;BAC PRO 23303 MENUISERIE ALUMINIUM-VERRE;25;25;11;11;3;2;1;13;0;0;0;2;11;12
19702.0;2023;32;GUADELOUPE;MASCULIN;SCOLAIRE;BAC PROFESSIONNEL;BAC PRO PROD;BAC PRO 24203 METIERS DE LA MODE - VÊTEMENT;1;1;1;0;0;0;0;1;0;1;0;0;0;0
19703.0;2023;32;GUADELOUPE;MASCULIN;SCOLAIRE;BAC PROFESSIONNEL;BAC PRO PROD;BAC PRO 25007 MAINTENANCE EQUIPEMENTS INDUST.;49;49;29;13;7;7;0;36;0;0;2;11;23;13
19709.0;2023;32;GUADELOUPE;MASCULIN;SCOLAIRE;BAC PROFESSIONNEL;BAC PRO PROD;BAC PRO 25220 MAINT.MATERIELS OPT.B TP MANUT.;10;10;6;2;2;1;1;7;0;0;2;1;4;3
19719.0;2023;32;GUADELOUPE;MASCULIN;SCOLAIRE;BAC PROFESSIONNEL;BAC PRO PROD;BAC PRO AG 21004 CGEA;21;21;15;6;0;0;0;15;0;0;2;3;10;6
19722.0;2023;32;GUADELOUPE;MASCULIN;SCOLAIRE;BAC PROFESSIONNEL;BAC PRO PROD;BAC PRO AG 22108 TEC CONS VTE ALIMENTATION (PAB);6;6;6;0;0;0;0;6;0;0;0;0;6;0
19726.0;2023;32;GUADELOUPE;MASCULIN;SCOLAIRE;BAC PROFESSIONNEL;BAC PRO SERV;BAC PRO 31212 METIERS DE L'ACCUEIL;18;18;11;6;1;0;1;11;0;0;3;5;3;7
19742.0;2023;32;GUADELOUPE;MASCULIN;SCOLAIRE;BAC TECHNOLOGIQUE;BAC STAV;BAC STAV AGRONOMIE ALIM ENV TERRITOI;11;11;11;0;0;0;0;11;0;0;1;3;7;0
19744.0;2023;32;GUADELOUPE;MASCULIN;SCOLAIRE;BAC TECHNOLOGIQUE;BAC STHR;BAC STHR SC.&TEC. HOTELLERIE-RESTAURATION;10;10;9;0;1;0;1;9;0;1;2;5;1;1
19746.0;2023;32;GUADELOUPE;MASCULIN;SCOLAIRE;BAC TECHNOLOGIQUE;BAC STI2D;BAC STI2D ENERGIES  ET ENVIRONNEMENT;43;43;22;4;17;16;1;38;0;1;2;6;29;5
19748.0;2023;32;GUADELOUPE;MASCULIN;SCOLAIRE;BAC TECHNOLOGIQUE;BAC STI2D;BAC STI2D SYSTÈME D'INFORMATION  ET NUMERIQUE;60;60;42;4;14;13;1;55;0;2;2;14;37;5
19768.0;2023;33;GUYANE;FEMININ;INDIVIDUEL;BAC PROFESSIONNEL;BAC PRO SERV;BAC PRO 30004 ASSISTANC.GEST.ORGANIS.ACTIVITES;3;3;0;2;1;1;0;1;0;0;0;0;1;2
19773.0;2023;33;GUYANE;FEMININ;INDIVIDUEL;BAC PROFESSIONNEL;BAC PRO SERV;BAC PRO 33002 SERVICES DE PROXIMITE  VIE LOCAL;3;3;0;1;2;0;2;0;0;0;0;0;0;3
19777.0;2023;33;GUYANE;FEMININ;INDIVIDUEL;BAC TECHNOLOGIQUE;BAC STMG;BAC STMG RESSOURCES HUMAINES ET COMMUNICATION;1;1;0;0;1;1;0;1;0;0;0;0;1;0
19787.0;2023;33;GUYANE;FEMININ;SCOLAIRE;BAC PROFESSIONNEL;BAC PRO PROD;BAC PRO 23303 MENUISERIE ALUMINIUM-VERRE;2;2;1;0;1;1;0;2;0;0;0;0;2;0
19794.0;2023;33;GUYANE;FEMININ;SCOLAIRE;BAC PROFESSIONNEL;BAC PRO PROD;BAC PRO 25215 MAINT.VEHIC.OPTB VEHIC.TRANS.ROUT;1;0;0;0;0;0;0;0;0;0;0;0;0;0
19800.0;2023;33;GUYANE;FEMININ;SCOLAIRE;BAC PROFESSIONNEL;BAC PRO PROD;BAC PRO AG 21405 AMENAGEMENTS PAYSAGERS;1;1;1;0;0;0;0;1;0;0;0;0;1;0
19810.0;2023;33;GUYANE;FEMININ;SCOLAIRE;BAC PROFESSIONNEL;BAC PRO SERV;BAC PRO 33003 ACC.SOINS-S.PERS. OPT.A DOMICILE;37;37;22;13;2;2;0;24;0;1;3;9;11;13
19813.0;2023;33;GUYANE;FEMININ;SCOLAIRE;BAC PROFESSIONNEL;BAC PRO SERV;BAC PRO 33403 COMMERC. SERVICES EN RESTAURATION;17;17;15;2;0;0;0;15;0;1;2;2;10;2
19826.0;2023;33;GUYANE;FEMININ;SCOLAIRE;BAC TECHNOLOGIQUE;BAC STL;BAC STL SCIENCES PHYSIQUES CHIMIQUES  EN LABORAT.;19;19;12;2;5;3;2;15;0;1;2;3;9;4
19832.0;2023;33;GUYANE;MASCULIN;APPRENTISSAGE;BAC PROFESSIONNEL;BAC PRO PROD;BAC PRO 23405 TECHNICIEN MENUISIER AGENCEUR;3;3;3;0;0;0;0;3;0;0;0;2;1;0
19835.0;2023;33;GUYANE;MASCULIN;ENSEIGNEMENT A DISTANCE;BAC GENERAL;BAC GENERAL;BAC GENE 10019 BAC GENERAL;3;3;3;0;0;0;0;3;0;2;0;0;1;0
19837.0;2023;33;GUYANE;MASCULIN;INDIVIDUEL;BAC GENERAL;BAC GENERAL;BAC GENE 10019 BAC GENERAL;5;5;0;3;2;2;0;2;0;0;0;0;2;3
19838.0;2023;33;GUYANE;MASCULIN;INDIVIDUEL;BAC PROFESSIONNEL;BAC PRO PROD;BAC PRO 22106 CUISINE;1;1;1;0;0;0;0;1;0;0;0;1;0;0
19848.0;2023;33;GUYANE;MASCULIN;INDIVIDUEL;BAC PROFESSIONNEL;BAC PRO SERV;BAC PRO 31214 MET.COM.VEN.OP.B PR.CL.VA.OF.COM.;1;1;0;0;1;0;1;0;0;0;0;0;0;1
19859.0;2023;33;GUYANE;MASCULIN;SCOLAIRE;BAC PROFESSIONNEL;BAC PRO PROD;BAC PRO 23003 ARTIS. & M.ART:MARCHANDISAGE VIS.;6;6;4;0;2;1;1;5;0;0;0;3;2;1
19863.0;2023;33;GUYANE;MASCULIN;SCOLAIRE;BAC PROFESSIONNEL;BAC PRO PROD;BAC PRO 23203 TECHNICIEN BAT. : ORG.REAL.GROS O;28;28;14;11;3;2;1;16;0;0;0;4;12;12
19866.0;2023;33;GUYANE;MASCULIN;SCOLAIRE;BAC PROFESSIONNEL;BAC PRO PROD;BAC PRO 23304 AMENAGEMENT FINITION BATIMENT;34;34;21;8;5;2;3;23;0;0;1;6;16;11
19872.0;2023;33;GUYANE;MASCULIN;SCOLAIRE;BAC PROFESSIONNEL;BAC PRO PROD;BAC PRO 25215 MAINT.VEHIC.OPTB VEHIC.TRANS.ROUT;17;17;9;6;2;2;0;11;0;1;0;3;7;6
19878.0;2023;33;GUYANE;MASCULIN;SCOLAIRE;BAC PROFESSIONNEL;BAC PRO PROD;BAC PRO AG 21004 CGEA;16;16;13;3;0;0;0;13;0;0;3;4;6;3
19879.0;2023;33;GUYANE;MASCULIN;SCOLAIRE;BAC PROFESSIONNEL;BAC PRO PROD;BAC PRO AG 21114 CONDUITE PRODUCTIONS HORTICOLES;8;8;8;0;0;0;0;8;0;0;1;2;5;0
19880.0;2023;33;GUYANE;MASCULIN;SCOLAIRE;BAC PROFESSIONNEL;BAC PRO PROD;BAC PRO AG 21405 AMENAGEMENTS PAYSAGERS;5;5;4;1;0;0;0;4;0;0;0;1;3;1
19889.0;2023;33;GUYANE;MASCULIN;SCOLAIRE;BAC PROFESSIONNEL;BAC PRO SERV;BAC PRO 33002 SERVICES DE PROXIMITE  VIE LOCAL;1;1;1;0;0;0;0;1;0;0;0;0;1;0
19899.0;2023;33;GUYANE;MASCULIN;SCOLAIRE;BAC TECHNOLOGIQUE;BAC STAV;BAC STAV AGRONOMIE ALIM ENV TERRITOI;6;6;6;0;0;0;0;6;0;0;2;1;3;0
19903.0;2023;33;GUYANE;MASCULIN;SCOLAIRE;BAC TECHNOLOGIQUE;BAC STI2D;BAC STI2D INNOVATION TECHNO.  ET ECO CONCEPTION;21;21;10;3;8;4;4;14;0;0;3;4;7;7
19904.0;2023;33;GUYANE;MASCULIN;SCOLAIRE;BAC TECHNOLOGIQUE;BAC STI2D;BAC STI2D SYSTÈME D'INFORMATION  ET NUMERIQUE;24;24;18;0;6;6;0;24;0;1;2;6;15;0
19905.0;2023;33;GUYANE;MASCULIN;SCOLAIRE;BAC TECHNOLOGIQUE;BAC STL;BAC STL BIOCHIM.-BIOLOGIE-BIOTECHNOL.;10;10;4;3;3;2;1;6;0;0;0;2;4;4
19909.0;2023;33;GUYANE;MASCULIN;SCOLAIRE;BAC TECHNOLOGIQUE;BAC STMG;BAC STMG RESSOURCES HUMAINES ET COMMUNICATION;27;27;14;5;8;7;1;21;0;0;1;2;18;6
19912.0;2023;28;LA REUNION;FEMININ;APPRENTISSAGE;BAC PROFESSIONNEL;BAC PRO PROD;BAC PRO 25214 MAINT.VEHIC.OPTA VOIT.PARTICUL.;1;1;1;0;0;0;0;1;0;0;0;1;0;0
19919.0;2023;28;LA REUNION;FEMININ;ENSEIGNEMENT A DISTANCE;BAC TECHNOLOGIQUE;BAC STMG;BAC STMG MERCATIQUE (MARKETING);1;1;0;0;1;1;0;1;0;0;0;0;1;0
19920.0;2023;28;LA REUNION;FEMININ;FORMATION CONTINUE;BAC PROFESSIONNEL;BAC PRO PROD;BAC PRO AG 21203 TECHN CONSEIL DE VENTE ANIMAL;1;1;1;0;0;0;0;1;0;0;1;0;0;0
19922.0;2023;28;LA REUNION;FEMININ;INDIVIDUEL;BAC PROFESSIONNEL;BAC PRO PROD;BAC PRO AG 21004 CGEA;7;6;4;2;0;0;0;4;0;0;0;0;4;2
19936.0;2023;28;LA REUNION;FEMININ;SCOLAIRE;BAC PROFESSIONNEL;BAC PRO PROD;BAC PRO 20102 PILOTE DE LIGNE DE PRODUCTION;1;1;0;1;0;0;0;0;0;0;0;0;0;1
19938.0;2023;28;LA REUNION;FEMININ;SCOLAIRE;BAC PROFESSIONNEL;BAC PRO PROD;BAC PRO 22004 PROC. CHIMIE EAU PAPIERS-CARTONS;2;2;1;1;0;0;0;1;0;0;0;1;0;1
19945.0;2023;28;LA REUNION;FEMININ;SCOLAIRE;BAC PROFESSIONNEL;BAC PRO PROD;BAC PRO 23005 TECHN. ETUDES BAT B ASSIST.ARCHI.;10;10;10;0;0;0;0;10;0;1;4;4;1;0
19947.0;2023;28;LA REUNION;FEMININ;SCOLAIRE;BAC PROFESSIONNEL;BAC PRO PROD;BACPRO 23103 TECHNICIEN GEOMETRE-TOPOGRAPHE;5;5;2;1;2;1;1;3;0;0;0;0;3;2
19948.0;2023;28;LA REUNION;FEMININ;SCOLAIRE;BAC PROFESSIONNEL;BAC PRO PROD;BAC PRO 23203 TECHNICIEN BAT. : ORG.REAL.GROS O;2;2;2;0;0;0;0;2;0;0;0;2;0;0
19953.0;2023;28;LA REUNION;FEMININ;SCOLAIRE;BAC PROFESSIONNEL;BAC PRO PROD;BAC PRO 23408 Etude et réalisation d'agencement;5;5;5;0;0;0;0;5;0;0;2;2;1;0
19954.0;2023;28;LA REUNION;FEMININ;SCOLAIRE;BAC PROFESSIONNEL;BAC PRO PROD;BAC PRO 24203 METIERS DE LA MODE - VÊTEMENT;31;31;26;4;1;0;1;26;0;1;7;10;8;5
19957.0;2023;28;LA REUNION;FEMININ;SCOLAIRE;BAC PROFESSIONNEL;BAC PRO PROD;BAC PRO 25214 MAINT.VEHIC.OPTA VOIT.PARTICUL.;6;6;4;2;0;0;0;4;0;2;1;0;1;2
19961.0;2023;28;LA REUNION;FEMININ;SCOLAIRE;BAC PROFESSIONNEL;BAC PRO PROD;BAC PRO 25510 METIERS ELECT. ENVIRON. CONNECTES;3;3;3;0;0;0;0;3;0;0;0;3;0;0
19969.0;2023;28;LA REUNION;FEMININ;SCOLAIRE;BAC PROFESSIONNEL;BAC PRO PROD;BAC PRO AG 22108 TEC CONS VTE ALIMENTATION (PAB);7;7;6;1;0;0;0;6;0;0;0;2;4;1
19974.0;2023;28;LA REUNION;FEMININ;SCOLAIRE;BAC PROFESSIONNEL;BAC PRO SERV;BAC PRO 31213 MET.COM.VEN.OP.A ANI.GES.ESP.COM.;243;242;195;28;19;14;5;209;0;8;45;57;99;33
19981.0;2023;28;LA REUNION;FEMININ;SCOLAIRE;BAC PROFESSIONNEL;BAC PRO SERV;BAC PRO 33006 ANIMAT. ENFANCE& PERSONNES AGEES;40;40;32;6;2;1;1;33;0;1;12;10;10;7
19983.0;2023;28;LA REUNION;FEMININ;SCOLAIRE;BAC PROFESSIONNEL;BAC PRO SERV;BAC PRO 33403 COMMERC. SERVICES EN RESTAURATION;10;10;9;1;0;0;0;9;0;0;2;1;6;1
19986.0;2023;28;LA REUNION;FEMININ;SCOLAIRE;BAC PROFESSIONNEL;BAC PRO SERV;BAC PRO 34304 HYGIENE PROPRETE STERILISATION;18;18;15;3;0;0;0;15;0;0;2;5;8;3
19988.0;2023;28;LA REUNION;FEMININ;SCOLAIRE;BAC PROFESSIONNEL;BAC PRO SERV;BAC PRO AG 33002 SERV PERS TERRIT;45;45;37;8;0;0;0;37;0;1;2;9;25;8
19989.0;2023;28;LA REUNION;FEMININ;SCOLAIRE;BAC TECHNOLOGIQUE;BAC ST2S;BAC ST2S SCIENCES & TECHNO. SANTE & SOCIAL;395;395;326;10;59;42;17;368;1;12;64;123;168;27
19993.0;2023;28;LA REUNION;FEMININ;SCOLAIRE;BAC TECHNOLOGIQUE;BAC STI2D;BAC STI2D ARCHITECTURE ET CONSTRUCTION;39;39;33;3;3;3;0;36;0;5;3;13;15;3
19999.0;2023;28;LA REUNION;FEMININ;SCOLAIRE;BAC TECHNOLOGIQUE;BAC STMG;BAC STMG GESTION ET FINANCE;199;199;157;11;31;25;6;182;0;4;28;59;91;17
20000.0;2023;28;LA REUNION;FEMININ;SCOLAIRE;BAC TECHNOLOGIQUE;BAC STMG;BAC STMG MERCATIQUE (MARKETING);292;292;223;18;51;47;4;270;0;3;42;75;150;22
3.0;2021;02;AIX-MARSEILLE;FEMININ;APPRENTISSAGE;BAC PROFESSIONNEL;BAC PRO PROD;BAC PRO 25106 TECHNICIEN D'USINAGE;1;1;1;0;0;0;0;1;0;0;0;1;0;0
4.0;2021;02;AIX-MARSEILLE;FEMININ;APPRENTISSAGE;BAC PROFESSIONNEL;BAC PRO PROD;BAC PRO 25214 MAINT.VEHIC.OPTA VOIT.PARTICUL.;3;2;1;1;0;0;0;1;0;1;0;0;0;1
10.0;2021;02;AIX-MARSEILLE;FEMININ;APPRENTISSAGE;BAC PROFESSIONNEL;BAC PRO PROD;BAC PRO AG 21211 COND GEST ENTR HIPPIQUE;38;36;29;7;0;0;0;29;0;2;1;8;18;7
22.0;2021;02;AIX-MARSEILLE;FEMININ;APPRENTISSAGE;BAC PROFESSIONNEL;BAC PRO SERV;BAC PRO 33403 COMMERC. SERVICES EN RESTAURATION;5;5;4;1;0;0;0;4;0;0;1;1;2;1
25.0;2021;02;AIX-MARSEILLE;FEMININ;APPRENTISSAGE;BAC PROFESSIONNEL;BAC PRO SERV;BAC PRO AG 33002 SERV PERS TERRIT;9;9;9;0;0;0;0;9;0;0;0;5;4;0
28.0;2021;02;AIX-MARSEILLE;FEMININ;ENSEIGNEMENT A DISTANCE;BAC PROFESSIONNEL;BAC PRO SERV;BAC PRO 31202 COMMERCE;3;2;1;0;1;1;0;2;0;0;0;1;1;0
36.0;2021;02;AIX-MARSEILLE;FEMININ;ENSEIGNEMENT A DISTANCE;BAC TECHNOLOGIQUE;BAC STMG;BAC STMG RESSOURCES HUMAINES ET COMMUNICATION;3;3;3;0;0;0;0;3;0;0;2;0;1;0
38.0;2021;02;AIX-MARSEILLE;FEMININ;FORMATION CONTINUE;BAC PROFESSIONNEL;BAC PRO PROD;BAC PRO 25007 MAINTENANCE EQUIPEMENTS INDUST.;1;0;0;0;0;0;0;0;0;0;0;0;0;0
40.0;2021;02;AIX-MARSEILLE;FEMININ;FORMATION CONTINUE;BAC PROFESSIONNEL;BAC PRO SERV;BAC PRO 30001 GESTION-ADMINISTRATION;29;26;24;1;1;1;0;25;0;0;5;11;9;1
45.0;2021;02;AIX-MARSEILLE;FEMININ;FORMATION CONTINUE;BAC PROFESSIONNEL;BAC PRO SERV;BAC PRO 33603 ESTHETIQUE COSMETIQUE PARFUMERIE;21;21;21;0;0;0;0;21;0;0;4;8;9;0
53.0;2021;02;AIX-MARSEILLE;FEMININ;INDIVIDUEL;BAC PROFESSIONNEL;BAC PRO PROD;BAC PRO AG 21114 CONDUITE PRODUCTIONS HORTICOLES;4;4;3;1;0;0;0;3;0;0;0;0;3;1
59.0;2021;02;AIX-MARSEILLE;FEMININ;INDIVIDUEL;BAC PROFESSIONNEL;BAC PRO SERV;BAC PRO 32303 ART.& MET.ART:COM.VIS.VIS.PLURI-M;1;0;0;0;0;0;0;0;0;0;0;0;0;0
66.0;2021;02;AIX-MARSEILLE;FEMININ;INDIVIDUEL;BAC TECHNOLOGIQUE;BAC ST2S;BAC ST2S SCIENCES & TECHNO. SANTE & SOCIAL;15;7;2;2;3;3;0;5;0;0;0;1;4;2
69.0;2021;02;AIX-MARSEILLE;FEMININ;INDIVIDUEL;BAC TECHNOLOGIQUE;BAC STHR;BAC STHR SC.&TEC. HOTELLERIE-RESTAURATION;2;2;2;0;0;0;0;2;0;0;1;1;0;0
72.0;2021;02;AIX-MARSEILLE;FEMININ;INDIVIDUEL;BAC TECHNOLOGIQUE;BAC STMG;BAC STMG MERCATIQUE (MARKETING);15;9;4;4;1;1;0;5;0;1;0;0;4;4
74.0;2021;02;AIX-MARSEILLE;FEMININ;INDIVIDUEL;BAC TECHNOLOGIQUE;BAC STMG;BAC STMG SYSTEMES D'INFORMATION DE GESTION;1;0;0;0;0;0;0;0;0;0;0;0;0;0
83.0;2021;02;AIX-MARSEILLE;FEMININ;SCOLAIRE;BAC PROFESSIONNEL;BAC PRO PROD;BAC PRO 23005 TECHN. ETUDES BAT B ASSIST.ARCHI.;15;15;15;0;0;0;0;15;0;0;2;7;6;0
91.0;2021;02;AIX-MARSEILLE;FEMININ;SCOLAIRE;BAC PROFESSIONNEL;BAC PRO PROD;BAC PRO 25214 MAINT.VEHIC.OPTA VOIT.PARTICUL.;4;4;2;2;0;0;0;2;0;0;1;1;0;2
93.0;2021;02;AIX-MARSEILLE;FEMININ;SCOLAIRE;BAC PROFESSIONNEL;BAC PRO PROD;BAC PRO 25216 MAINT.VEHIC.OPTC MOTOCYCLES;3;3;3;0;0;0;0;3;0;0;1;1;1;0
94.0;2021;02;AIX-MARSEILLE;FEMININ;SCOLAIRE;BAC PROFESSIONNEL;BAC PRO PROD;BAC PRO 25302 AERONAUTIQUE OPTION AVIONIQUE;1;1;1;0;0;0;0;1;0;0;0;1;0;0
97.0;2021;02;AIX-MARSEILLE;FEMININ;SCOLAIRE;BAC PROFESSIONNEL;BAC PRO PROD;BAC PRO 25408 REPARATION DES CARROSSERIES;1;1;1;0;0;0;0;1;0;0;0;1;0;0
102.0;2021;02;AIX-MARSEILLE;FEMININ;SCOLAIRE;BAC PROFESSIONNEL;BAC PRO PROD;BAC PRO AG 21004 CGEA;14;13;11;2;0;0;0;11;0;1;1;3;6;2
105.0;2021;02;AIX-MARSEILLE;FEMININ;SCOLAIRE;BAC PROFESSIONNEL;BAC PRO PROD;BAC PRO AG 21203 TECHN CONSEIL DE VENTE ANIMAL;28;28;23;5;0;0;0;23;0;1;4;7;11;5
106.0;2021;02;AIX-MARSEILLE;FEMININ;SCOLAIRE;BAC PROFESSIONNEL;BAC PRO PROD;BAC PRO AG 21210 COND GEST ENTR CANIN ET FELIN;15;15;15;0;0;0;0;15;0;0;0;9;6;0
120.0;2021;02;AIX-MARSEILLE;FEMININ;SCOLAIRE;BAC PROFESSIONNEL;BAC PRO SERV;BAC PRO 32208 REAL.PR.IMPR.PLURI.OPTB.PR.IMPR.;4;4;4;0;0;0;0;4;0;2;0;1;1;0
128.0;2021;02;AIX-MARSEILLE;FEMININ;SCOLAIRE;BAC PROFESSIONNEL;BAC PRO SERV;BAC PRO 33103 TECHNICIEN APPAREIL. ORTHOPEDIQUE;7;7;6;0;1;1;0;7;0;0;0;2;5;0
131.0;2021;02;AIX-MARSEILLE;FEMININ;SCOLAIRE;BAC PROFESSIONNEL;BAC PRO SERV;BAC PRO 34304 HYGIENE PROPRETE STERILISATION;5;5;4;0;1;0;1;4;0;0;2;0;2;1
137.0;2021;02;AIX-MARSEILLE;FEMININ;SCOLAIRE;BAC TECHNOLOGIQUE;BAC STHR;BAC STHR SC.&TEC. HOTELLERIE-RESTAURATION;42;42;36;0;6;6;0;42;0;1;8;16;17;0
138.0;2021;02;AIX-MARSEILLE;FEMININ;SCOLAIRE;BAC TECHNOLOGIQUE;BAC STI2D;BAC STI2D ARCHITECTURE ET CONSTRUCTION;35;35;35;0;0;0;0;35;0;3;6;10;16;0
151.0;2021;02;AIX-MARSEILLE;MASCULIN;APPRENTISSAGE;BAC PROFESSIONNEL;BAC PRO PROD;BAC PRO 22704 TECHN. MAINT. SYST.ENERG.CLIMATI;7;6;6;0;0;0;0;6;0;1;1;1;3;0
164.0;2021;02;AIX-MARSEILLE;MASCULIN;APPRENTISSAGE;BAC PROFESSIONNEL;BAC PRO PROD;BAC PRO 25406 OUVRAGES DU BATIMENT METALLERIE;4;4;4;0;0;0;0;4;0;0;0;2;2;0
165.0;2021;02;AIX-MARSEILLE;MASCULIN;APPRENTISSAGE;BAC PROFESSIONNEL;BAC PRO PROD;BAC PRO 25408 REPARATION DES CARROSSERIES;2;1;1;0;0;0;0;1;0;0;0;0;1;0
170.0;2021;02;AIX-MARSEILLE;MASCULIN;APPRENTISSAGE;BAC PROFESSIONNEL;BAC PRO PROD;BAC PRO AG 21004 CGEA;2;2;2;0;0;0;0;2;0;0;0;0;2;0
180.0;2021;02;AIX-MARSEILLE;MASCULIN;APPRENTISSAGE;BAC PROFESSIONNEL;BAC PRO SERV;BAC PRO 31108 TRANSPORT;1;1;1;0;0;0;0;1;0;0;0;0;1;0
183.0;2021;02;AIX-MARSEILLE;MASCULIN;APPRENTISSAGE;BAC PROFESSIONNEL;BAC PRO SERV;BAC PRO 32207 REAL.PR.IMPR.PLURI.OPTA.PR.GRAPH.;1;1;1;0;0;0;0;1;0;0;0;1;0;0
197.0;2021;02;AIX-MARSEILLE;MASCULIN;ENSEIGNEMENT A DISTANCE;BAC TECHNOLOGIQUE;BAC STMG;BAC STMG MERCATIQUE (MARKETING);7;6;6;0;0;0;0;6;0;1;4;1;0;0
205.0;2021;02;AIX-MARSEILLE;MASCULIN;FORMATION CONTINUE;BAC PROFESSIONNEL;BAC PRO PROD;BAC PRO 25007 MAINTENANCE EQUIPEMENTS INDUST.;10;9;7;2;0;0;0;7;0;2;3;2;0;2
219.0;2021;02;AIX-MARSEILLE;MASCULIN;INDIVIDUEL;BAC PROFESSIONNEL;BAC PRO PROD;BAC PRO 23304 AMENAGEMENT FINITION BATIMENT;1;0;0;0;0;0;0;0;0;0;0;0;0;0
240.0;2021;02;AIX-MARSEILLE;MASCULIN;INDIVIDUEL;BAC PROFESSIONNEL;BAC PRO SERV;BAC PRO 33004 ACC.SOINS-S.PERS. OPT.EN STRUCTUR;1;1;1;0;0;0;0;1;0;0;0;1;0;0
246.0;2021;02;AIX-MARSEILLE;MASCULIN;INDIVIDUEL;BAC TECHNOLOGIQUE;BAC STI2D;BAC STI2D INNOVATION TECHNO.  ET ECO CONCEPTION;2;0;0;0;0;0;0;0;0;0;0;0;0;0
247.0;2021;02;AIX-MARSEILLE;MASCULIN;INDIVIDUEL;BAC TECHNOLOGIQUE;BAC STI2D;BAC STI2D SYSTÈME D'INFORMATION  ET NUMERIQUE;2;1;0;1;0;0;0;0;0;0;0;0;0;1
248.0;2021;02;AIX-MARSEILLE;MASCULIN;INDIVIDUEL;BAC TECHNOLOGIQUE;BAC STL;BAC STL SCIENCES PHYSIQUES CHIMIQUES  EN LABORAT.;1;0;0;0;0;0;0;0;0;0;0;0;0;0
263.0;2021;02;AIX-MARSEILLE;MASCULIN;SCOLAIRE;BAC PROFESSIONNEL;BAC PRO PROD;BAC PRO 22704 TECHN. MAINT. SYST.ENERG.CLIMATI;57;57;47;7;3;2;1;49;0;0;9;18;22;8
268.0;2021;02;AIX-MARSEILLE;MASCULIN;SCOLAIRE;BAC PROFESSIONNEL;BAC PRO PROD;BAC PRO 23203 TECHNICIEN BAT. : ORG.REAL.GROS O;27;27;21;5;1;1;0;22;0;2;5;8;7;5
269.0;2021;02;AIX-MARSEILLE;MASCULIN;SCOLAIRE;BAC PROFESSIONNEL;BAC PRO PROD;BAC PRO 23205 INTERV. SUR PATRIMOINE BATI OPT.A;3;3;3;0;0;0;0;3;0;0;0;2;1;0
280.0;2021;02;AIX-MARSEILLE;MASCULIN;SCOLAIRE;BAC PROFESSIONNEL;BAC PRO PROD;BAC PRO 25107 TECHNICIEN OUTILLEUR;6;6;3;3;0;0;0;3;0;0;1;1;1;3
282.0;2021;02;AIX-MARSEILLE;MASCULIN;SCOLAIRE;BAC PROFESSIONNEL;BAC PRO PROD;BAC PRO 25215 MAINT.VEHIC.OPTB VEHIC.TRANS.ROUT;44;44;35;5;4;1;3;36;0;5;5;11;15;8
284.0;2021;02;AIX-MARSEILLE;MASCULIN;SCOLAIRE;BAC PROFESSIONNEL;BAC PRO PROD;BAC PRO 25219 MAINT.MATERIELS OPT.A AGRICOLES;11;11;11;0;0;0;0;11;0;0;7;3;1;0
285.0;2021;02;AIX-MARSEILLE;MASCULIN;SCOLAIRE;BAC PROFESSIONNEL;BAC PRO PROD;BAC PRO 25220 MAINT.MATERIELS OPT.B TP MANUT.;21;21;20;1;0;0;0;20;0;1;4;7;8;1
289.0;2021;02;AIX-MARSEILLE;MASCULIN;SCOLAIRE;BAC PROFESSIONNEL;BAC PRO PROD;BAC PRO 25304 AERONAUTIQUE OPTION STRUCTURE;9;9;7;0;2;2;0;9;0;0;3;3;3;0
290.0;2021;02;AIX-MARSEILLE;MASCULIN;SCOLAIRE;BAC PROFESSIONNEL;BAC PRO PROD;BAC PRO 25406 OUVRAGES DU BATIMENT METALLERIE;31;31;22;8;1;1;0;23;0;1;4;9;9;8
291.0;2021;02;AIX-MARSEILLE;MASCULIN;SCOLAIRE;BAC PROFESSIONNEL;BAC PRO PROD;BAC PRO 25408 REPARATION DES CARROSSERIES;33;33;28;4;1;0;1;28;0;0;4;8;16;5
293.0;2021;02;AIX-MARSEILLE;MASCULIN;SCOLAIRE;BAC PROFESSIONNEL;BAC PRO PROD;BAC PRO 25509 TECHNIC. FROID CONDITIONNEMT AIR;61;59;31;20;8;4;4;35;0;1;8;8;18;24
296.0;2021;02;AIX-MARSEILLE;MASCULIN;SCOLAIRE;BAC PROFESSIONNEL;BAC PRO PROD;BAC PRO 25514 SYST.NUM.OPT.B AUD.RES.EQUIP.DOM.;126;125;109;7;9;6;3;115;0;9;31;39;36;10
300.0;2021;02;AIX-MARSEILLE;MASCULIN;SCOLAIRE;BAC PROFESSIONNEL;BAC PRO PROD;BAC PRO AG 21113 CGEVV;39;38;33;5;0;0;0;33;0;0;1;11;21;5
303.0;2021;02;AIX-MARSEILLE;MASCULIN;SCOLAIRE;BAC PROFESSIONNEL;BAC PRO PROD;BAC PRO AG 21210 COND GEST ENTR CANIN ET FELIN;7;6;2;4;0;0;0;2;0;0;0;1;1;4
307.0;2021;02;AIX-MARSEILLE;MASCULIN;SCOLAIRE;BAC PROFESSIONNEL;BAC PRO PROD;BAC PRO AG 22105 LABORATOIRE CONTROLE QUALITE;5;5;5;0;0;0;0;5;0;0;0;5;0;0
323.0;2021;02;AIX-MARSEILLE;MASCULIN;SCOLAIRE;BAC PROFESSIONNEL;BAC PRO SERV;BAC PRO 33004 ACC.SOINS-S.PERS. OPT.EN STRUCTUR;49;49;43;4;2;1;1;44;0;3;11;18;12;5
325.0;2021;02;AIX-MARSEILLE;MASCULIN;SCOLAIRE;BAC PROFESSIONNEL;BAC PRO SERV;BAC PRO 33102 PROTHESE DENTAIRE;4;4;2;0;2;2;0;4;0;0;0;2;2;0
336.0;2021;02;AIX-MARSEILLE;MASCULIN;SCOLAIRE;BAC TECHNOLOGIQUE;BAC STI2D;BAC STI2D ENERGIES  ET ENVIRONNEMENT;199;199;185;2;12;8;4;193;0;4;28;90;71;6
340.0;2021;02;AIX-MARSEILLE;MASCULIN;SCOLAIRE;BAC TECHNOLOGIQUE;BAC STL;BAC STL SCIENCES PHYSIQUES CHIMIQUES  EN LABORAT.;85;85;76;2;7;5;2;81;0;2;12;34;33;4
341.0;2021;02;AIX-MARSEILLE;MASCULIN;SCOLAIRE;BAC TECHNOLOGIQUE;BAC STMG;BAC STMG GESTION ET FINANCE;404;404;353;14;37;26;11;379;0;6;51;155;167;25
348.0;2021;20;AMIENS;FEMININ;APPRENTISSAGE;BAC PROFESSIONNEL;BAC PRO PROD;BAC PRO 25106 TECHNICIEN D'USINAGE;1;1;1;0;0;0;0;1;0;0;0;1;0;0
359.0;2021;20;AMIENS;FEMININ;APPRENTISSAGE;BAC PROFESSIONNEL;BAC PRO SERV;BAC PRO 31210 ACCUEIL -RELATION CLIENTS USAGERS;4;4;4;0;0;0;0;4;0;0;2;2;0;0
360.0;2021;20;AMIENS;FEMININ;APPRENTISSAGE;BAC PROFESSIONNEL;BAC PRO SERV;BAC PRO 33403 COMMERC. SERVICES EN RESTAURATION;12;11;9;1;1;1;0;10;0;0;3;1;6;1
364.0;2021;20;AMIENS;FEMININ;ENSEIGNEMENT A DISTANCE;BAC TECHNOLOGIQUE;BAC STMG;BAC STMG GESTION ET FINANCE;1;1;1;0;0;0;0;1;0;0;0;1;0;0
369.0;2021;20;AMIENS;FEMININ;FORMATION CONTINUE;BAC PROFESSIONNEL;BAC PRO SERV;BAC PRO 30001 GESTION-ADMINISTRATION;1;0;0;0;0;0;0;0;0;0;0;0;0;0
374.0;2021;20;AMIENS;FEMININ;INDIVIDUEL;BAC PROFESSIONNEL;BAC PRO PROD;BAC PRO AG 21004 CGEA;6;5;5;0;0;0;0;5;0;0;0;0;5;0
376.0;2021;20;AMIENS;FEMININ;INDIVIDUEL;BAC PROFESSIONNEL;BAC PRO PROD;BAC PRO AG 21203 TECHN CONSEIL DE VENTE ANIMAL;1;0;0;0;0;0;0;0;0;0;0;0;0;0
385.0;2021;20;AMIENS;FEMININ;INDIVIDUEL;BAC PROFESSIONNEL;BAC PRO SERV;BAC PRO 33003 ACC.SOINS-S.PERS. OPT.A DOMICILE;3;0;0;0;0;0;0;0;0;0;0;0;0;0
386.0;2021;20;AMIENS;FEMININ;INDIVIDUEL;BAC PROFESSIONNEL;BAC PRO SERV;BAC PRO 33004 ACC.SOINS-S.PERS. OPT.EN STRUCTUR;5;3;2;1;0;0;0;2;0;0;1;1;0;1
405.0;2021;20;AMIENS;FEMININ;SCOLAIRE;BAC PROFESSIONNEL;BAC PRO PROD;BAC PRO 23208 METIERS ET ARTS DE LA PIERRE;2;2;2;0;0;0;0;2;0;0;1;1;0;0
412.0;2021;20;AMIENS;FEMININ;SCOLAIRE;BAC PROFESSIONNEL;BAC PRO PROD;BAC PRO 25108 TECHNICIEN MODELEUR;4;4;4;0;0;0;0;4;0;0;0;3;1;0
417.0;2021;20;AMIENS;FEMININ;SCOLAIRE;BAC PROFESSIONNEL;BAC PRO PROD;BAC PRO 25510 METIERS ELECT. ENVIRON. CONNECTES;3;3;2;1;0;0;0;2;0;1;0;0;1;1
421.0;2021;20;AMIENS;FEMININ;SCOLAIRE;BAC PROFESSIONNEL;BAC PRO PROD;BAC PRO AG 21004 CGEA;63;63;49;14;0;0;0;49;0;1;4;13;31;14
423.0;2021;20;AMIENS;FEMININ;SCOLAIRE;BAC PROFESSIONNEL;BAC PRO PROD;BAC PRO AG 21203 TECHN CONSEIL DE VENTE ANIMAL;18;18;15;3;0;0;0;15;0;1;3;7;4;3
424.0;2021;20;AMIENS;FEMININ;SCOLAIRE;BAC PROFESSIONNEL;BAC PRO PROD;BAC PRO AG 21211 COND GEST ENTR HIPPIQUE;51;51;43;8;0;0;0;43;0;0;4;13;26;8
427.0;2021;20;AMIENS;FEMININ;SCOLAIRE;BAC PROFESSIONNEL;BAC PRO PROD;BAC PRO AG 22105 LABORATOIRE CONTROLE QUALITE;5;5;5;0;0;0;0;5;0;0;2;1;2;0
429.0;2021;20;AMIENS;FEMININ;SCOLAIRE;BAC PROFESSIONNEL;BAC PRO SERV;BAC PRO 30001 GESTION-ADMINISTRATION;474;472;374;72;26;22;4;396;0;22;84;143;147;76
433.0;2021;20;AMIENS;FEMININ;SCOLAIRE;BAC PROFESSIONNEL;BAC PRO SERV;BAC PRO 31206 VENTE (PROSPECT.NEGO.SUIV.CLIENT;97;95;81;8;6;3;3;84;0;4;16;39;25;11
436.0;2021;20;AMIENS;FEMININ;SCOLAIRE;BAC PROFESSIONNEL;BAC PRO SERV;BAC PRO 32303 ART.& MET.ART:COM.VIS.VIS.PLURI-M;20;20;17;3;0;0;0;17;0;1;6;7;3;3
439.0;2021;20;AMIENS;FEMININ;SCOLAIRE;BAC PROFESSIONNEL;BAC PRO SERV;BAC PRO 33004 ACC.SOINS-S.PERS. OPT.EN STRUCTUR;488;486;445;24;17;13;4;458;0;22;121;184;131;28
440.0;2021;20;AMIENS;FEMININ;SCOLAIRE;BAC PROFESSIONNEL;BAC PRO SERV;BAC PRO 33101 OPTIQUE LUNETTERIE;13;13;11;2;0;0;0;11;0;0;2;5;4;2
445.0;2021;20;AMIENS;FEMININ;SCOLAIRE;BAC PROFESSIONNEL;BAC PRO SERV;BAC PRO AG 33002 SERV PERS TERRIT;193;187;176;11;0;0;0;176;0;3;31;62;80;11
459.0;2021;20;AMIENS;FEMININ;SCOLAIRE;BAC TECHNOLOGIQUE;BAC STMG;BAC STMG SYSTEMES D'INFORMATION DE GESTION;14;14;12;0;2;2;0;14;0;0;2;4;8;0
462.0;2021;20;AMIENS;MASCULIN;APPRENTISSAGE;BAC PROFESSIONNEL;BAC PRO PROD;BAC PRO 22303 FONDERIE;1;1;1;0;0;0;0;1;0;0;0;0;1;0
465.0;2021;20;AMIENS;MASCULIN;APPRENTISSAGE;BAC PROFESSIONNEL;BAC PRO PROD;BAC PRO 25007 MAINTENANCE EQUIPEMENTS INDUST.;40;40;33;5;2;0;2;33;0;2;7;12;12;7
486.0;2021;20;AMIENS;MASCULIN;APPRENTISSAGE;BAC PROFESSIONNEL;BAC PRO SERV;BAC PRO 31202 COMMERCE;28;26;23;1;2;1;1;24;0;2;5;11;6;2
490.0;2021;20;AMIENS;MASCULIN;ENSEIGNEMENT A DISTANCE;BAC GENERAL;BAC GENERAL;BAC GENE 10019 BAC GENERAL;14;14;13;1;0;0;0;13;0;3;6;0;4;1
492.0;2021;20;AMIENS;MASCULIN;ENSEIGNEMENT A DISTANCE;BAC TECHNOLOGIQUE;BAC STMG;BAC STMG RESSOURCES HUMAINES ET COMMUNICATION;1;1;1;0;0;0;0;1;0;0;0;1;0;0
497.0;2021;20;AMIENS;MASCULIN;FORMATION CONTINUE;BAC PROFESSIONNEL;BAC PRO PROD;BAC PRO 25408 REPARATION DES CARROSSERIES;12;10;5;5;0;0;0;5;0;2;3;0;0;5
506.0;2021;20;AMIENS;MASCULIN;INDIVIDUEL;BAC PROFESSIONNEL;BAC PRO PROD;BAC PRO 23304 AMENAGEMENT FINITION BATIMENT;1;0;0;0;0;0;0;0;0;0;0;0;0;0
509.0;2021;20;AMIENS;MASCULIN;INDIVIDUEL;BAC PROFESSIONNEL;BAC PRO PROD;BAC PRO 25214 MAINT.VEHIC.OPTA VOIT.PARTICUL.;2;1;0;1;0;0;0;0;0;0;0;0;0;1
518.0;2021;20;AMIENS;MASCULIN;INDIVIDUEL;BAC PROFESSIONNEL;BAC PRO SERV;BAC PRO 31202 COMMERCE;8;5;1;4;0;0;0;1;0;0;0;0;1;4
522.0;2021;20;AMIENS;MASCULIN;INDIVIDUEL;BAC PROFESSIONNEL;BAC PRO SERV;BAC PRO 33403 COMMERC. SERVICES EN RESTAURATION;1;1;1;0;0;0;0;1;0;0;0;0;1;0
538.0;2021;20;AMIENS;MASCULIN;SCOLAIRE;BAC PROFESSIONNEL;BAC PRO PROD;BAC PRO 22105 BOULANGER-PÂTISSIER;9;9;9;0;0;0;0;9;0;2;4;2;1;0
542.0;2021;20;AMIENS;MASCULIN;SCOLAIRE;BAC PROFESSIONNEL;BAC PRO PROD;BAC PRO 22703 TECHN.INSTALL.SYST.ENERG.CLIMATI;48;45;32;8;5;3;2;35;0;0;5;9;21;10
543.0;2021;20;AMIENS;MASCULIN;SCOLAIRE;BAC PROFESSIONNEL;BAC PRO PROD;BAC PRO 22704 TECHN. MAINT. SYST.ENERG.CLIMATI;25;25;19;4;2;2;0;21;0;2;3;9;7;4
544.0;2021;20;AMIENS;MASCULIN;SCOLAIRE;BAC PROFESSIONNEL;BAC PRO PROD;BAC PRO 23004 TECHN. ETUDES BAT.A ETUDES & ECO.;9;9;6;3;0;0;0;6;0;1;0;2;3;3
548.0;2021;20;AMIENS;MASCULIN;SCOLAIRE;BAC PROFESSIONNEL;BAC PRO PROD;BAC PRO 23203 TECHNICIEN BAT. : ORG.REAL.GROS O;19;19;9;8;2;1;1;10;0;0;2;4;4;9
554.0;2021;20;AMIENS;MASCULIN;SCOLAIRE;BAC PROFESSIONNEL;BAC PRO PROD;BAC PRO 23407 TECHNIC.FAB.BOIS ET MATERX ASSOC;3;3;2;0;1;1;0;3;0;0;0;1;2;0
557.0;2021;20;AMIENS;MASCULIN;SCOLAIRE;BAC PROFESSIONNEL;BAC PRO PROD;BAC PRO 25005 PRODUCTIQ.MECA. OPT.DECOLLETAGE;4;4;2;2;0;0;0;2;0;0;0;2;0;2
560.0;2021;20;AMIENS;MASCULIN;SCOLAIRE;BAC PROFESSIONNEL;BAC PRO PROD;BAC PRO 25009 MAINTENANCE NAUTIQUE;6;6;6;0;0;0;0;6;0;1;1;2;2;0
562.0;2021;20;AMIENS;MASCULIN;SCOLAIRE;BAC PROFESSIONNEL;BAC PRO PROD;BAC PRO 25108 TECHNICIEN MODELEUR;9;9;8;0;1;1;0;9;0;0;2;2;5;0
574.0;2021;20;AMIENS;MASCULIN;SCOLAIRE;BAC PROFESSIONNEL;BAC PRO PROD;BAC PRO 25510 METIERS ELECT. ENVIRON. CONNECTES;484;482;376;83;23;14;9;390;0;21;76;146;147;92
585.0;2021;20;AMIENS;MASCULIN;SCOLAIRE;BAC PROFESSIONNEL;BAC PRO PROD;BAC PRO AG 21302 GEST MILIEUX NATURELS FAUNE;46;42;40;2;0;0;0;40;0;0;12;14;14;2
586.0;2021;20;AMIENS;MASCULIN;SCOLAIRE;BAC PROFESSIONNEL;BAC PRO PROD;BAC PRO AG 21405 AMENAGEMENTS PAYSAGERS;31;30;26;4;0;0;0;26;0;1;1;12;12;4
588.0;2021;20;AMIENS;MASCULIN;SCOLAIRE;BAC PROFESSIONNEL;BAC PRO PROD;BAC PRO AG 22107 TEC CONS VTE ALIMENTATION P.ALIM;9;9;6;3;0;0;0;6;0;0;3;2;1;3
593.0;2021;20;AMIENS;MASCULIN;SCOLAIRE;BAC PROFESSIONNEL;BAC PRO SERV;BAC PRO 31202 COMMERCE;371;367;276;53;38;30;8;306;0;12;67;101;126;61
595.0;2021;20;AMIENS;MASCULIN;SCOLAIRE;BAC PROFESSIONNEL;BAC PRO SERV;BAC PRO 31210 ACCUEIL -RELATION CLIENTS USAGERS;54;54;44;6;4;2;2;46;0;2;4;15;25;8
596.0;2021;20;AMIENS;MASCULIN;SCOLAIRE;BAC PROFESSIONNEL;BAC PRO SERV;BAC PRO 32207 REAL.PR.IMPR.PLURI.OPTA.PR.GRAPH.;9;9;5;3;1;1;0;6;0;0;1;2;3;3
605.0;2021;20;AMIENS;MASCULIN;SCOLAIRE;BAC PROFESSIONNEL;BAC PRO SERV;BAC PRO AG 33002 SERV PERS TERRIT;21;21;19;2;0;0;0;19;0;0;2;3;14;2
612.0;2021;20;AMIENS;MASCULIN;SCOLAIRE;BAC TECHNOLOGIQUE;BAC STI2D;BAC STI2D INNOVATION TECHNO.  ET ECO CONCEPTION;204;204;185;2;17;9;8;194;0;4;33;84;73;10
613.0;2021;20;AMIENS;MASCULIN;SCOLAIRE;BAC TECHNOLOGIQUE;BAC STI2D;BAC STI2D SYSTÈME D'INFORMATION  ET NUMERIQUE;262;262;236;8;18;12;6;248;0;16;44;98;90;14
614.0;2021;20;AMIENS;MASCULIN;SCOLAIRE;BAC TECHNOLOGIQUE;BAC STL;BAC STL BIOCHIM.-BIOLOGIE-BIOTECHNOL.;30;30;27;0;3;1;2;28;0;6;2;9;11;2
617.0;2021;20;AMIENS;MASCULIN;SCOLAIRE;BAC TECHNOLOGIQUE;BAC STMG;BAC STMG MERCATIQUE (MARKETING);485;485;396;22;67;38;29;434;0;5;39;152;238;51
619.0;2021;20;AMIENS;MASCULIN;SCOLAIRE;BAC TECHNOLOGIQUE;BAC STMG;BAC STMG SYSTEMES D'INFORMATION DE GESTION;35;35;32;1;2;1;1;33;0;1;0;9;23;2
623.0;2021;03;BESANCON;FEMININ;APPRENTISSAGE;BAC PROFESSIONNEL;BAC PRO PROD;BAC PRO 25006 MICROTECHNIQUES;1;1;1;0;0;0;0;1;0;0;0;0;1;0
624.0;2021;03;BESANCON;FEMININ;APPRENTISSAGE;BAC PROFESSIONNEL;BAC PRO PROD;BAC PRO 25106 TECHNICIEN D'USINAGE;1;1;0;0;1;0;1;0;0;0;0;0;0;1
639.0;2021;03;BESANCON;FEMININ;APPRENTISSAGE;BAC PROFESSIONNEL;BAC PRO SERV;BAC PRO 33403 COMMERC. SERVICES EN RESTAURATION;2;2;2;0;0;0;0;2;0;0;1;0;1;0
640.0;2021;03;BESANCON;FEMININ;APPRENTISSAGE;BAC PROFESSIONNEL;BAC PRO SERV;BAC PRO AG 33002 SERV PERS TERRIT;2;2;2;0;0;0;0;2;0;0;0;0;2;0
650.0;2021;03;BESANCON;FEMININ;INDIVIDUEL;BAC PROFESSIONNEL;BAC PRO PROD;BAC PRO AG 21211 COND GEST ENTR HIPPIQUE;1;1;1;0;0;0;0;1;0;0;0;0;1;0
652.0;2021;03;BESANCON;FEMININ;INDIVIDUEL;BAC PROFESSIONNEL;BAC PRO SERV;BAC PRO 31202 COMMERCE;1;1;1;0;0;0;0;1;0;1;0;0;0;0
654.0;2021;03;BESANCON;FEMININ;INDIVIDUEL;BAC PROFESSIONNEL;BAC PRO SERV;BAC PRO 33004 ACC.SOINS-S.PERS. OPT.EN STRUCTUR;4;4;2;1;1;1;0;3;0;0;0;1;2;1
657.0;2021;03;BESANCON;FEMININ;INDIVIDUEL;BAC TECHNOLOGIQUE;BAC ST2S;BAC ST2S SCIENCES & TECHNO. SANTE & SOCIAL;2;1;0;0;1;1;0;1;0;0;0;0;1;0
658.0;2021;03;BESANCON;FEMININ;INDIVIDUEL;BAC TECHNOLOGIQUE;BAC STMG;BAC STMG GESTION ET FINANCE;1;1;1;0;0;0;0;1;0;0;1;0;0;0
665.0;2021;03;BESANCON;FEMININ;SCOLAIRE;BAC PROFESSIONNEL;BAC PRO PROD;BAC PRO 23005 TECHN. ETUDES BAT B ASSIST.ARCHI.;6;6;6;0;0;0;0;6;0;2;0;3;1;0
667.0;2021;03;BESANCON;FEMININ;SCOLAIRE;BAC PROFESSIONNEL;BAC PRO PROD;BAC PRO 23304 AMENAGEMENT FINITION BATIMENT;2;2;1;1;0;0;0;1;0;0;0;0;1;1
669.0;2021;03;BESANCON;FEMININ;SCOLAIRE;BAC PROFESSIONNEL;BAC PRO PROD;BAC PRO 23405 TECHNICIEN MENUISIER AGENCEUR;5;5;5;0;0;0;0;5;0;2;2;1;0;0
671.0;2021;03;BESANCON;FEMININ;SCOLAIRE;BAC PROFESSIONNEL;BAC PRO PROD;BAC PRO 23408 Etude et réalisation d'agencement;19;19;18;0;1;1;0;19;0;0;6;7;6;0
672.0;2021;03;BESANCON;FEMININ;SCOLAIRE;BAC PROFESSIONNEL;BAC PRO PROD;BAC PRO 24002 METIERS PRESSING BLANCHISSERIE;1;1;1;0;0;0;0;1;0;0;0;0;1;0
676.0;2021;03;BESANCON;FEMININ;SCOLAIRE;BAC PROFESSIONNEL;BAC PRO PROD;BAC PRO 25007 MAINTENANCE EQUIPEMENTS INDUST.;2;2;2;0;0;0;0;2;0;1;1;0;0;0
691.0;2021;03;BESANCON;FEMININ;SCOLAIRE;BAC PROFESSIONNEL;BAC PRO PROD;BAC PRO AG 22107 TEC CONS VTE ALIMENTATION P.ALIM;13;13;11;2;0;0;0;11;0;1;1;4;5;2
692.0;2021;03;BESANCON;FEMININ;SCOLAIRE;BAC PROFESSIONNEL;BAC PRO SERV;BAC PRO 30001 GESTION-ADMINISTRATION;238;238;173;47;18;11;7;184;0;10;36;59;79;54
700.0;2021;03;BESANCON;FEMININ;SCOLAIRE;BAC PROFESSIONNEL;BAC PRO SERV;BAC PRO 33004 ACC.SOINS-S.PERS. OPT.EN STRUCTUR;276;274;257;8;9;8;1;265;0;16;77;100;72;9
705.0;2021;03;BESANCON;FEMININ;SCOLAIRE;BAC PROFESSIONNEL;BAC PRO SERV;BAC PRO 34403 METIERS DE LA SECURITE;29;29;27;1;1;1;0;28;0;2;9;10;7;1
713.0;2021;03;BESANCON;FEMININ;SCOLAIRE;BAC TECHNOLOGIQUE;BAC STI2D;BAC STI2D ARCHITECTURE ET CONSTRUCTION;5;5;4;0;1;0;1;4;0;0;0;3;1;1
715.0;2021;03;BESANCON;FEMININ;SCOLAIRE;BAC TECHNOLOGIQUE;BAC STI2D;BAC STI2D INNOVATION TECHNO.  ET ECO CONCEPTION;20;20;19;0;1;0;1;19;0;1;3;8;7;1
723.0;2021;03;BESANCON;MASCULIN;APPRENTISSAGE;BAC PROFESSIONNEL;BAC PRO PROD;BAC PRO 22106 CUISINE;5;5;4;0;1;1;0;5;0;0;1;0;4;0
726.0;2021;03;BESANCON;MASCULIN;APPRENTISSAGE;BAC PROFESSIONNEL;BAC PRO PROD;BAC PRO 23102 TRAVAUX PUBLICS;20;19;19;0;0;0;0;19;0;4;6;7;2;0
740.0;2021;03;BESANCON;MASCULIN;APPRENTISSAGE;BAC PROFESSIONNEL;BAC PRO PROD;BAC PRO 25216 MAINT.VEHIC.OPTC MOTOCYCLES;1;1;1;0;0;0;0;1;0;1;0;0;0;0
741.0;2021;03;BESANCON;MASCULIN;APPRENTISSAGE;BAC PROFESSIONNEL;BAC PRO PROD;BAC PRO 25219 MAINT.MATERIELS OPT.A AGRICOLES;21;21;19;1;1;1;0;20;0;0;4;11;5;1
745.0;2021;03;BESANCON;MASCULIN;APPRENTISSAGE;BAC PROFESSIONNEL;BAC PRO PROD;BAC PRO 25408 REPARATION DES CARROSSERIES;3;3;2;0;1;1;0;3;0;1;0;1;1;0
752.0;2021;03;BESANCON;MASCULIN;APPRENTISSAGE;BAC PROFESSIONNEL;BAC PRO PROD;BAC PRO AG 21114 CONDUITE PRODUCTIONS HORTICOLES;3;3;3;0;0;0;0;3;0;0;0;3;0;0
761.0;2021;03;BESANCON;MASCULIN;APPRENTISSAGE;BAC PROFESSIONNEL;BAC PRO SERV;BAC PRO 32303 ART.& MET.ART:COM.VIS.VIS.PLURI-M;6;6;3;3;0;0;0;3;0;0;0;1;2;3
768.0;2021;03;BESANCON;MASCULIN;ENSEIGNEMENT A DISTANCE;BAC PROFESSIONNEL;BAC PRO SERV;BAC PRO 30001 GESTION-ADMINISTRATION;1;1;1;0;0;0;0;1;0;0;0;0;1;0
778.0;2021;03;BESANCON;MASCULIN;INDIVIDUEL;BAC PROFESSIONNEL;BAC PRO PROD;BAC PRO 25510 METIERS ELECT. ENVIRON. CONNECTES;1;1;1;0;0;0;0;1;0;0;0;1;0;0
784.0;2021;03;BESANCON;MASCULIN;INDIVIDUEL;BAC PROFESSIONNEL;BAC PRO SERV;BAC PRO 30001 GESTION-ADMINISTRATION;2;2;1;1;0;0;0;1;0;0;0;0;1;1
788.0;2021;03;BESANCON;MASCULIN;INDIVIDUEL;BAC TECHNOLOGIQUE;BAC STI2D;BAC STI2D SYSTÈME D'INFORMATION  ET NUMERIQUE;2;2;0;2;0;0;0;0;0;0;0;0;0;2
789.0;2021;03;BESANCON;MASCULIN;INDIVIDUEL;BAC TECHNOLOGIQUE;BAC STMG;BAC STMG GESTION ET FINANCE;1;1;1;0;0;0;0;1;0;0;0;0;1;0
790.0;2021;03;BESANCON;MASCULIN;INDIVIDUEL;BAC TECHNOLOGIQUE;BAC STMG;BAC STMG MERCATIQUE (MARKETING);6;5;4;0;1;0;1;4;0;0;0;1;3;1
792.0;2021;03;BESANCON;MASCULIN;SCOLAIRE;BAC GENERAL;BAC GENERAL;BAC GENE 10019 BAC GENERAL;2475;2475;2283;23;169;103;66;2386;26;196;462;820;882;89
818.0;2021;03;BESANCON;MASCULIN;SCOLAIRE;BAC PROFESSIONNEL;BAC PRO PROD;BAC PRO 25408 REPARATION DES CARROSSERIES;29;29;22;6;1;1;0;23;0;2;4;11;6;6
821.0;2021;03;BESANCON;MASCULIN;SCOLAIRE;BAC PROFESSIONNEL;BAC PRO PROD;BAC PRO 25509 TECHNIC. FROID CONDITIONNEMT AIR;13;13;11;2;0;0;0;11;0;1;1;4;5;2
822.0;2021;03;BESANCON;MASCULIN;SCOLAIRE;BAC PROFESSIONNEL;BAC PRO PROD;BAC PRO 25510 METIERS ELECT. ENVIRON. CONNECTES;158;158;136;19;3;2;1;138;0;5;37;44;52;20
829.0;2021;03;BESANCON;MASCULIN;SCOLAIRE;BAC PROFESSIONNEL;BAC PRO PROD;BAC PRO AG 21203 TECHN CONSEIL DE VENTE ANIMAL;4;4;4;0;0;0;0;4;0;0;0;3;1;0
843.0;2021;03;BESANCON;MASCULIN;SCOLAIRE;BAC PROFESSIONNEL;BAC PRO SERV;BAC PRO 33003 ACC.SOINS-S.PERS. OPT.A DOMICILE;1;1;1;0;0;0;0;1;0;0;1;0;0;0
848.0;2021;03;BESANCON;MASCULIN;SCOLAIRE;BAC PROFESSIONNEL;BAC PRO SERV;BAC PRO AG 33002 SERV PERS TERRIT;20;20;20;0;0;0;0;20;0;0;3;11;6;0
855.0;2021;03;BESANCON;MASCULIN;SCOLAIRE;BAC TECHNOLOGIQUE;BAC STI2D;BAC STI2D ENERGIES  ET ENVIRONNEMENT;84;84;78;0;6;4;2;82;0;1;11;31;39;2
861.0;2021;03;BESANCON;MASCULIN;SCOLAIRE;BAC TECHNOLOGIQUE;BAC STMG;BAC STMG MERCATIQUE (MARKETING);221;221;192;5;24;16;8;208;0;1;13;73;121;13
863.0;2021;03;BESANCON;MASCULIN;SCOLAIRE;BAC TECHNOLOGIQUE;BAC STMG;BAC STMG SYSTEMES D'INFORMATION DE GESTION;5;5;4;0;1;1;0;5;0;0;0;4;1;0
866.0;2021;04;BORDEAUX;FEMININ;APPRENTISSAGE;BAC PROFESSIONNEL;BAC PRO PROD;BAC PRO 24302 METIERS DU CUIR : MAROQUINERIE;2;2;1;1;0;0;0;1;0;1;0;0;0;1
868.0;2021;04;BORDEAUX;FEMININ;APPRENTISSAGE;BAC PROFESSIONNEL;BAC PRO PROD;BAC PRO 25106 TECHNICIEN D'USINAGE;4;4;4;0;0;0;0;4;0;0;1;3;0;0
875.0;2021;04;BORDEAUX;FEMININ;APPRENTISSAGE;BAC PROFESSIONNEL;BAC PRO PROD;BAC PRO 25510 METIERS ELECT. ENVIRON. CONNECTES;2;2;2;0;0;0;0;2;0;0;1;1;0;0
877.0;2021;04;BORDEAUX;FEMININ;APPRENTISSAGE;BAC PROFESSIONNEL;BAC PRO PROD;BAC PRO AG 21004 CGEA;2;2;1;1;0;0;0;1;0;0;0;1;0;1
879.0;2021;04;BORDEAUX;FEMININ;APPRENTISSAGE;BAC PROFESSIONNEL;BAC PRO PROD;BAC PRO AG 21114 CONDUITE PRODUCTIONS HORTICOLES;5;5;5;0;0;0;0;5;0;0;0;0;5;0
880.0;2021;04;BORDEAUX;FEMININ;APPRENTISSAGE;BAC PROFESSIONNEL;BAC PRO PROD;BAC PRO AG 21211 COND GEST ENTR HIPPIQUE;14;13;11;2;0;0;0;11;0;0;3;3;5;2
882.0;2021;04;BORDEAUX;FEMININ;APPRENTISSAGE;BAC PROFESSIONNEL;BAC PRO PROD;BAC PRO AG 22107 TEC CONS VTE ALIMENTATION P.ALIM;1;1;1;0;0;0;0;1;0;0;0;0;1;0
884.0;2021;04;BORDEAUX;FEMININ;APPRENTISSAGE;BAC PROFESSIONNEL;BAC PRO SERV;BAC PRO 31106 LOGISTIQUE;5;5;4;0;1;1;0;5;0;2;2;0;1;0
886.0;2021;04;BORDEAUX;FEMININ;APPRENTISSAGE;BAC PROFESSIONNEL;BAC PRO SERV;BAC PRO 31206 VENTE (PROSPECT.NEGO.SUIV.CLIENT;1;1;1;0;0;0;0;1;0;0;1;0;0;0
889.0;2021;04;BORDEAUX;FEMININ;APPRENTISSAGE;BAC PROFESSIONNEL;BAC PRO SERV;BAC PRO 33003 ACC.SOINS-S.PERS. OPT.A DOMICILE;1;1;1;0;0;0;0;1;0;0;0;0;1;0
916.0;2021;04;BORDEAUX;FEMININ;INDIVIDUEL;BAC GENERAL;BAC GENERAL;BAC GENE 10019 BAC GENERAL;106;74;43;19;12;8;4;51;0;2;7;14;28;23
924.0;2021;04;BORDEAUX;FEMININ;INDIVIDUEL;BAC PROFESSIONNEL;BAC PRO SERV;BAC PRO 31108 TRANSPORT;1;0;0;0;0;0;0;0;0;0;0;0;0;0
926.0;2021;04;BORDEAUX;FEMININ;INDIVIDUEL;BAC PROFESSIONNEL;BAC PRO SERV;BAC PRO 31206 VENTE (PROSPECT.NEGO.SUIV.CLIENT;1;1;1;0;0;0;0;1;0;0;0;0;1;0
934.0;2021;04;BORDEAUX;FEMININ;INDIVIDUEL;BAC TECHNOLOGIQUE;BAC ST2S;BAC ST2S SCIENCES & TECHNO. SANTE & SOCIAL;11;7;5;2;0;0;0;5;0;0;0;4;1;2
939.0;2021;04;BORDEAUX;FEMININ;INDIVIDUEL;BAC TECHNOLOGIQUE;BAC STMG;BAC STMG RESSOURCES HUMAINES ET COMMUNICATION;4;2;0;2;0;0;0;0;0;0;0;0;0;2
942.0;2021;04;BORDEAUX;FEMININ;SCOLAIRE;BAC PROFESSIONNEL;BAC PRO PROD;BACPRO 20002 ETUD.DEFINITION PRDTS INDUSTRIEL;4;4;4;0;0;0;0;4;0;1;0;3;0;0
943.0;2021;04;BORDEAUX;FEMININ;SCOLAIRE;BAC PROFESSIONNEL;BAC PRO PROD;BAC PRO 20102 PILOTE DE LIGNE DE PRODUCTION;1;1;1;0;0;0;0;1;0;0;0;0;1;0
945.0;2021;04;BORDEAUX;FEMININ;SCOLAIRE;BAC PROFESSIONNEL;BAC PRO PROD;BAC PRO 22004 PROC. CHIMIE EAU PAPIERS-CARTONS;3;3;3;0;0;0;0;3;0;0;0;3;0;0
946.0;2021;04;BORDEAUX;FEMININ;SCOLAIRE;BAC PROFESSIONNEL;BAC PRO PROD;BAC PRO 22104 BOUCHER CHARCUTIER TRAITEUR;2;2;2;0;0;0;0;2;0;0;1;0;1;0
951.0;2021;04;BORDEAUX;FEMININ;SCOLAIRE;BAC PROFESSIONNEL;BAC PRO PROD;BAC PRO 23003 ARTIS. & M.ART:MARCHANDISAGE VIS.;13;13;13;0;0;0;0;13;0;0;4;7;2;0
952.0;2021;04;BORDEAUX;FEMININ;SCOLAIRE;BAC PROFESSIONNEL;BAC PRO PROD;BAC PRO 23004 TECHN. ETUDES BAT.A ETUDES & ECO.;10;10;4;2;4;4;0;8;0;0;1;2;5;2
967.0;2021;04;BORDEAUX;FEMININ;SCOLAIRE;BAC PROFESSIONNEL;BAC PRO PROD;BAC PRO 25216 MAINT.VEHIC.OPTC MOTOCYCLES;2;2;2;0;0;0;0;2;0;0;1;0;1;0
972.0;2021;04;BORDEAUX;FEMININ;SCOLAIRE;BAC PROFESSIONNEL;BAC PRO PROD;BAC PRO 25509 TECHNIC. FROID CONDITIONNEMT AIR;1;1;0;1;0;0;0;0;0;0;0;0;0;1
974.0;2021;04;BORDEAUX;FEMININ;SCOLAIRE;BAC PROFESSIONNEL;BAC PRO PROD;BAC PRO 25514 SYST.NUM.OPT.B AUD.RES.EQUIP.DOM.;4;4;3;1;0;0;0;3;0;1;1;1;0;1
975.0;2021;04;BORDEAUX;FEMININ;SCOLAIRE;BAC PROFESSIONNEL;BAC PRO PROD;BAC PRO 25515 SYST.NUM.OPT.C RES.INF.SYST.COMM.;6;6;6;0;0;0;0;6;0;0;1;3;2;0
980.0;2021;04;BORDEAUX;FEMININ;SCOLAIRE;BAC PROFESSIONNEL;BAC PRO PROD;BAC PRO AG 21203 TECHN CONSEIL DE VENTE ANIMAL;36;36;34;2;0;0;0;34;0;3;8;15;8;2
994.0;2021;04;BORDEAUX;FEMININ;SCOLAIRE;BAC PROFESSIONNEL;BAC PRO SERV;BAC PRO 31202 COMMERCE;414;413;355;26;32;23;9;378;0;28;81;136;133;35
1002.0;2021;04;BORDEAUX;FEMININ;SCOLAIRE;BAC PROFESSIONNEL;BAC PRO SERV;BAC PRO 33003 ACC.SOINS-S.PERS. OPT.A DOMICILE;309;308;270;16;22;10;12;280;0;22;75;105;78;28
1003.0;2021;04;BORDEAUX;FEMININ;SCOLAIRE;BAC PROFESSIONNEL;BAC PRO SERV;BAC PRO 33004 ACC.SOINS-S.PERS. OPT.EN STRUCTUR;471;470;449;13;8;4;4;453;0;29;164;170;90;17
1018.0;2021;04;BORDEAUX;FEMININ;SCOLAIRE;BAC TECHNOLOGIQUE;BAC STI2D;BAC STI2D ENERGIES  ET ENVIRONNEMENT;10;10;10;0;0;0;0;10;0;0;4;3;3;0
1019.0;2021;04;BORDEAUX;FEMININ;SCOLAIRE;BAC TECHNOLOGIQUE;BAC STI2D;BAC STI2D INNOVATION TECHNO.  ET ECO CONCEPTION;24;24;24;0;0;0;0;24;0;1;11;8;4;0
1031.0;2021;04;BORDEAUX;MASCULIN;APPRENTISSAGE;BAC PROFESSIONNEL;BAC PRO PROD;BAC PRO 22704 TECHN. MAINT. SYST.ENERG.CLIMATI;5;5;5;0;0;0;0;5;0;1;2;1;1;0
1035.0;2021;04;BORDEAUX;MASCULIN;APPRENTISSAGE;BAC PROFESSIONNEL;BAC PRO PROD;BAC PRO 23303 MENUISERIE ALUMINIUM-VERRE;1;1;1;0;0;0;0;1;0;0;0;0;1;0
1036.0;2021;04;BORDEAUX;MASCULIN;APPRENTISSAGE;BAC PROFESSIONNEL;BAC PRO PROD;BAC PRO 23304 AMENAGEMENT FINITION BATIMENT;2;2;1;0;1;0;1;1;0;0;1;0;0;1
1037.0;2021;04;BORDEAUX;MASCULIN;APPRENTISSAGE;BAC PROFESSIONNEL;BAC PRO PROD;BAC PRO 23404 TECHNICIEN CONSTRUCTEUR BOIS;7;6;4;2;0;0;0;4;0;0;0;3;1;2
1045.0;2021;04;BORDEAUX;MASCULIN;APPRENTISSAGE;BAC PROFESSIONNEL;BAC PRO PROD;BAC PRO 25107 TECHNICIEN OUTILLEUR;2;2;1;1;0;0;0;1;0;1;0;0;0;1
1046.0;2021;04;BORDEAUX;MASCULIN;APPRENTISSAGE;BAC PROFESSIONNEL;BAC PRO PROD;BAC PRO 25214 MAINT.VEHIC.OPTA VOIT.PARTICUL.;114;109;80;25;4;1;3;81;0;7;20;24;30;28
1049.0;2021;04;BORDEAUX;MASCULIN;APPRENTISSAGE;BAC PROFESSIONNEL;BAC PRO PROD;BAC PRO 25221 MAINT.MATERIELS OPT.C ESP. VERTS;6;6;5;1;0;0;0;5;0;0;2;2;1;1
1051.0;2021;04;BORDEAUX;MASCULIN;APPRENTISSAGE;BAC PROFESSIONNEL;BAC PRO PROD;BAC PRO 25303 AERONAUTIQUE OPTION SYSTEMES;30;30;28;2;0;0;0;28;0;10;13;5;0;2
1052.0;2021;04;BORDEAUX;MASCULIN;APPRENTISSAGE;BAC PROFESSIONNEL;BAC PRO PROD;BAC PRO 25304 AERONAUTIQUE OPTION STRUCTURE;9;9;8;1;0;0;0;8;0;1;3;3;1;1
1056.0;2021;04;BORDEAUX;MASCULIN;APPRENTISSAGE;BAC PROFESSIONNEL;BAC PRO PROD;BAC PRO 25513 SYST.NUM.OPT.A SURETE SECURITE;3;3;3;0;0;0;0;3;0;0;0;1;2;0
1058.0;2021;04;BORDEAUX;MASCULIN;APPRENTISSAGE;BAC PROFESSIONNEL;BAC PRO PROD;BAC PRO 25515 SYST.NUM.OPT.C RES.INF.SYST.COMM.;5;5;5;0;0;0;0;5;0;0;2;2;1;0
1059.0;2021;04;BORDEAUX;MASCULIN;APPRENTISSAGE;BAC PROFESSIONNEL;BAC PRO PROD;BAC PRO AG 21001 AGRO-EQUIPEMENT;31;30;25;5;0;0;0;25;0;0;2;7;16;5
1060.0;2021;04;BORDEAUX;MASCULIN;APPRENTISSAGE;BAC PROFESSIONNEL;BAC PRO PROD;BAC PRO AG 21004 CGEA;28;27;20;7;0;0;0;20;0;1;2;7;10;7
1062.0;2021;04;BORDEAUX;MASCULIN;APPRENTISSAGE;BAC PROFESSIONNEL;BAC PRO PROD;BAC PRO AG 21114 CONDUITE PRODUCTIONS HORTICOLES;3;3;3;0;0;0;0;3;0;0;0;0;3;0
1075.0;2021;04;BORDEAUX;MASCULIN;APPRENTISSAGE;BAC PROFESSIONNEL;BAC PRO SERV;BAC PRO 33101 OPTIQUE LUNETTERIE;2;2;2;0;0;0;0;2;0;0;0;2;0;0
1076.0;2021;04;BORDEAUX;MASCULIN;APPRENTISSAGE;BAC PROFESSIONNEL;BAC PRO SERV;BAC PRO 33102 PROTHESE DENTAIRE;5;5;5;0;0;0;0;5;0;1;3;1;0;0
1078.0;2021;04;BORDEAUX;MASCULIN;APPRENTISSAGE;BAC PROFESSIONNEL;BAC PRO SERV;BAC PRO 34303 GEST. POLLUTIONS PROTEC. ENVIRON.;6;6;5;1;0;0;0;5;0;0;2;3;0;1
1079.0;2021;04;BORDEAUX;MASCULIN;APPRENTISSAGE;BAC PROFESSIONNEL;BAC PRO SERV;BAC PRO 34304 HYGIENE PROPRETE STERILISATION;13;13;10;3;0;0;0;10;0;1;3;3;3;3
1082.0;2021;04;BORDEAUX;MASCULIN;ENSEIGNEMENT A DISTANCE;BAC PROFESSIONNEL;BAC PRO PROD;BAC PRO 23404 TECHNICIEN CONSTRUCTEUR BOIS;1;0;0;0;0;0;0;0;0;0;0;0;0;0
1083.0;2021;04;BORDEAUX;MASCULIN;ENSEIGNEMENT A DISTANCE;BAC PROFESSIONNEL;BAC PRO PROD;BAC PRO 25106 TECHNICIEN D'USINAGE;1;0;0;0;0;0;0;0;0;0;0;0;0;0
1085.0;2021;04;BORDEAUX;MASCULIN;ENSEIGNEMENT A DISTANCE;BAC PROFESSIONNEL;BAC PRO SERV;BAC PRO 31206 VENTE (PROSPECT.NEGO.SUIV.CLIENT;2;2;1;1;0;0;0;1;0;0;0;1;0;1
1086.0;2021;04;BORDEAUX;MASCULIN;ENSEIGNEMENT A DISTANCE;BAC PROFESSIONNEL;BAC PRO SERV;BAC PRO 33603 ESTHETIQUE COSMETIQUE PARFUMERIE;1;1;1;0;0;0;0;1;0;0;0;0;1;0
1092.0;2021;04;BORDEAUX;MASCULIN;FORMATION CONTINUE;BAC PROFESSIONNEL;BAC PRO PROD;BAC PRO 22004 PROC. CHIMIE EAU PAPIERS-CARTONS;15;15;15;0;0;0;0;15;0;8;4;2;1;0
1094.0;2021;04;BORDEAUX;MASCULIN;FORMATION CONTINUE;BAC PROFESSIONNEL;BAC PRO PROD;BAC PRO 25509 TECHNIC. FROID CONDITIONNEMT AIR;1;1;1;0;0;0;0;1;0;0;1;0;0;0
1103.0;2021;04;BORDEAUX;MASCULIN;INDIVIDUEL;BAC GENERAL;BAC GENERAL;BAC GENE 10019 BAC GENERAL;115;84;53;17;14;9;5;62;0;2;4;12;44;22
1108.0;2021;04;BORDEAUX;MASCULIN;INDIVIDUEL;BAC PROFESSIONNEL;BAC PRO PROD;BAC PRO 23405 TECHNICIEN MENUISIER AGENCEUR;1;0;0;0;0;0;0;0;0;0;0;0;0;0
1112.0;2021;04;BORDEAUX;MASCULIN;INDIVIDUEL;BAC PROFESSIONNEL;BAC PRO PROD;BAC PRO 25510 METIERS ELECT. ENVIRON. CONNECTES;3;2;0;1;1;1;0;1;0;0;0;0;1;1
1126.0;2021;04;BORDEAUX;MASCULIN;INDIVIDUEL;BAC PROFESSIONNEL;BAC PRO SERV;BAC PRO 34403 METIERS DE LA SECURITE;2;1;1;0;0;0;0;1;0;0;0;0;1;0
1128.0;2021;04;BORDEAUX;MASCULIN;INDIVIDUEL;BAC TECHNOLOGIQUE;BAC ST2S;BAC ST2S SCIENCES & TECHNO. SANTE & SOCIAL;4;3;0;2;1;1;0;1;0;0;0;0;1;2
1132.0;2021;04;BORDEAUX;MASCULIN;INDIVIDUEL;BAC TECHNOLOGIQUE;BAC STMG;BAC STMG MERCATIQUE (MARKETING);16;12;7;1;4;4;0;11;0;0;0;3;8;1
1133.0;2021;04;BORDEAUX;MASCULIN;INDIVIDUEL;BAC TECHNOLOGIQUE;BAC STMG;BAC STMG RESSOURCES HUMAINES ET COMMUNICATION;9;9;5;4;0;0;0;5;0;0;0;1;4;4
1137.0;2021;04;BORDEAUX;MASCULIN;SCOLAIRE;BAC PROFESSIONNEL;BAC PRO PROD;BAC PRO 20102 PILOTE DE LIGNE DE PRODUCTION;13;13;9;4;0;0;0;9;0;1;3;2;3;4
1138.0;2021;04;BORDEAUX;MASCULIN;SCOLAIRE;BAC PROFESSIONNEL;BAC PRO PROD;BAC PRO 22003 BIO-INDUSTRIES DE TRANSFORMATION;16;16;16;0;0;0;0;16;0;1;3;8;4;0
1139.0;2021;04;BORDEAUX;MASCULIN;SCOLAIRE;BAC PROFESSIONNEL;BAC PRO PROD;BAC PRO 22004 PROC. CHIMIE EAU PAPIERS-CARTONS;30;30;25;4;1;0;1;25;0;6;8;9;2;5
1145.0;2021;04;BORDEAUX;MASCULIN;SCOLAIRE;BAC PROFESSIONNEL;BAC PRO PROD;BAC PRO 22704 TECHN. MAINT. SYST.ENERG.CLIMATI;17;17;15;0;2;0;2;15;0;0;5;7;3;2
1150.0;2021;04;BORDEAUX;MASCULIN;SCOLAIRE;BAC PROFESSIONNEL;BAC PRO PROD;BAC PRO 23203 TECHNICIEN BAT. : ORG.REAL.GROS O;26;26;22;3;1;1;0;23;0;2;3;11;7;3
1151.0;2021;04;BORDEAUX;MASCULIN;SCOLAIRE;BAC PROFESSIONNEL;BAC PRO PROD;BAC PRO 23208 METIERS ET ARTS DE LA PIERRE;5;5;2;3;0;0;0;2;0;0;0;2;0;3
1155.0;2021;04;BORDEAUX;MASCULIN;SCOLAIRE;BAC PROFESSIONNEL;BAC PRO PROD;BAC PRO 23405 TECHNICIEN MENUISIER AGENCEUR;118;118;86;18;14;11;3;97;0;1;19;32;45;21
1158.0;2021;04;BORDEAUX;MASCULIN;SCOLAIRE;BAC PROFESSIONNEL;BAC PRO PROD;BAC PRO 24202 ARTIS.& MET.ART : TAPIS.D'AMEUBL;3;3;2;1;0;0;0;2;0;0;0;0;2;1
1163.0;2021;04;BORDEAUX;MASCULIN;SCOLAIRE;BAC PROFESSIONNEL;BAC PRO PROD;BAC PRO 25107 TECHNICIEN OUTILLEUR;32;32;28;3;1;0;1;28;0;1;7;12;8;4
1164.0;2021;04;BORDEAUX;MASCULIN;SCOLAIRE;BAC PROFESSIONNEL;BAC PRO PROD;BAC PRO 25214 MAINT.VEHIC.OPTA VOIT.PARTICUL.;140;140;112;27;1;0;1;112;0;2;17;49;44;28
1165.0;2021;04;BORDEAUX;MASCULIN;SCOLAIRE;BAC PROFESSIONNEL;BAC PRO PROD;BAC PRO 25215 MAINT.VEHIC.OPTB VEHIC.TRANS.ROUT;33;33;29;3;1;1;0;30;0;2;6;8;14;3
1167.0;2021;04;BORDEAUX;MASCULIN;SCOLAIRE;BAC PROFESSIONNEL;BAC PRO PROD;BAC PRO 25219 MAINT.MATERIELS OPT.A AGRICOLES;44;44;37;4;3;3;0;40;0;5;10;13;12;4
1173.0;2021;04;BORDEAUX;MASCULIN;SCOLAIRE;BAC PROFESSIONNEL;BAC PRO PROD;BAC PRO 25406 OUVRAGES DU BATIMENT METALLERIE;7;7;6;0;1;1;0;7;0;0;0;3;4;0
1180.0;2021;04;BORDEAUX;MASCULIN;SCOLAIRE;BAC PROFESSIONNEL;BAC PRO PROD;BAC PRO 25515 SYST.NUM.OPT.C RES.INF.SYST.COMM.;244;242;197;36;9;5;4;202;0;8;56;78;60;40
1196.0;2021;04;BORDEAUX;MASCULIN;SCOLAIRE;BAC PROFESSIONNEL;BAC PRO SERV;BAC PRO 30001 GESTION-ADMINISTRATION;266;266;209;46;11;6;5;215;0;12;26;81;96;51
1197.0;2021;04;BORDEAUX;MASCULIN;SCOLAIRE;BAC PROFESSIONNEL;BAC PRO SERV;BAC PRO 31106 LOGISTIQUE;92;92;66;10;16;13;3;79;0;1;12;24;42;13
1199.0;2021;04;BORDEAUX;MASCULIN;SCOLAIRE;BAC PROFESSIONNEL;BAC PRO SERV;BAC PRO 31108 TRANSPORT;23;23;17;5;1;1;0;18;0;1;3;4;10;5
1207.0;2021;04;BORDEAUX;MASCULIN;SCOLAIRE;BAC PROFESSIONNEL;BAC PRO SERV;BAC PRO 33002 SERVICES DE PROXIMITE  VIE LOCAL;75;75;63;7;5;2;3;65;0;1;14;26;24;10
1216.0;2021;04;BORDEAUX;MASCULIN;SCOLAIRE;BAC PROFESSIONNEL;BAC PRO SERV;BAC PRO AG 33002 SERV PERS TERRIT;74;74;71;3;0;0;0;71;0;1;8;33;29;3
1217.0;2021;04;BORDEAUX;MASCULIN;SCOLAIRE;BAC TECHNOLOGIQUE;BAC S2TMD;BAC S2TMD MUSIQUE;3;3;3;0;0;0;0;3;0;1;2;0;0;0
1218.0;2021;04;BORDEAUX;MASCULIN;SCOLAIRE;BAC TECHNOLOGIQUE;BAC ST2S;BAC ST2S SCIENCES & TECHNO. SANTE & SOCIAL;91;91;85;3;3;2;1;87;0;2;15;32;38;4
1225.0;2021;04;BORDEAUX;MASCULIN;SCOLAIRE;BAC TECHNOLOGIQUE;BAC STI2D;BAC STI2D SYSTÈME D'INFORMATION  ET NUMERIQUE;432;431;394;10;27;18;9;412;0;9;50;178;175;19
1228.0;2021;04;BORDEAUX;MASCULIN;SCOLAIRE;BAC TECHNOLOGIQUE;BAC STMG;BAC STMG GESTION ET FINANCE;358;358;318;8;32;21;11;339;0;4;34;130;171;19
1230.0;2021;04;BORDEAUX;MASCULIN;SCOLAIRE;BAC TECHNOLOGIQUE;BAC STMG;BAC STMG RESSOURCES HUMAINES ET COMMUNICATION;295;293;241;16;36;21;15;262;0;3;17;87;155;31
1238.0;2021;06;CLERMONT-FERRAND;FEMININ;APPRENTISSAGE;BAC PROFESSIONNEL;BAC PRO PROD;BAC PRO 23404 TECHNICIEN CONSTRUCTEUR BOIS;1;1;1;0;0;0;0;1;0;0;0;0;1;0
1244.0;2021;06;CLERMONT-FERRAND;FEMININ;APPRENTISSAGE;BAC PROFESSIONNEL;BAC PRO PROD;BAC PRO 25408 REPARATION DES CARROSSERIES;1;1;1;0;0;0;0;1;0;1;0;0;0;0
1245.0;2021;06;CLERMONT-FERRAND;FEMININ;APPRENTISSAGE;BAC PROFESSIONNEL;BAC PRO PROD;BAC PRO 25510 METIERS ELECT. ENVIRON. CONNECTES;1;1;1;0;0;0;0;1;0;0;1;0;0;0
1248.0;2021;06;CLERMONT-FERRAND;FEMININ;APPRENTISSAGE;BAC PROFESSIONNEL;BAC PRO SERV;BAC PRO 30001 GESTION-ADMINISTRATION;3;3;3;0;0;0;0;3;0;0;2;1;0;0
1251.0;2021;06;CLERMONT-FERRAND;FEMININ;APPRENTISSAGE;BAC PROFESSIONNEL;BAC PRO SERV;BAC PRO 33004 ACC.SOINS-S.PERS. OPT.EN STRUCTUR;8;8;8;0;0;0;0;8;0;1;2;3;2;0
1256.0;2021;06;CLERMONT-FERRAND;FEMININ;ENSEIGNEMENT A DISTANCE;BAC PROFESSIONNEL;BAC PRO SERV;BAC PRO 31202 COMMERCE;1;1;1;0;0;0;0;1;0;0;0;0;1;0
1264.0;2021;06;CLERMONT-FERRAND;FEMININ;FORMATION CONTINUE;BAC PROFESSIONNEL;BAC PRO SERV;BAC PRO 30001 GESTION-ADMINISTRATION;6;6;6;0;0;0;0;6;0;2;1;2;1;0
1265.0;2021;06;CLERMONT-FERRAND;FEMININ;FORMATION CONTINUE;BAC PROFESSIONNEL;BAC PRO SERV;BAC PRO 31202 COMMERCE;2;2;2;0;0;0;0;2;0;0;0;2;0;0
1286.0;2021;06;CLERMONT-FERRAND;FEMININ;SCOLAIRE;BAC PROFESSIONNEL;BAC PRO PROD;BAC PRO 20102 PILOTE DE LIGNE DE PRODUCTION;1;1;1;0;0;0;0;1;0;0;0;0;1;0
1287.0;2021;06;CLERMONT-FERRAND;FEMININ;SCOLAIRE;BAC PROFESSIONNEL;BAC PRO PROD;BAC PRO 22003 BIO-INDUSTRIES DE TRANSFORMATION;19;19;17;1;1;0;1;17;0;1;4;7;5;2
1302.0;2021;06;CLERMONT-FERRAND;FEMININ;SCOLAIRE;BAC PROFESSIONNEL;BAC PRO PROD;BAC PRO 25408 REPARATION DES CARROSSERIES;1;1;0;1;0;0;0;0;0;0;0;0;0;1
1316.0;2021;06;CLERMONT-FERRAND;FEMININ;SCOLAIRE;BAC PROFESSIONNEL;BAC PRO PROD;BAC PRO AG 21405 AMENAGEMENTS PAYSAGERS;10;10;10;0;0;0;0;10;0;0;0;2;8;0
1320.0;2021;06;CLERMONT-FERRAND;FEMININ;SCOLAIRE;BAC PROFESSIONNEL;BAC PRO SERV;BAC PRO 30001 GESTION-ADMINISTRATION;230;230;194;18;18;10;8;204;0;2;33;82;87;26
1322.0;2021;06;CLERMONT-FERRAND;FEMININ;SCOLAIRE;BAC PROFESSIONNEL;BAC PRO SERV;BAC PRO 31108 TRANSPORT;3;3;3;0;0;0;0;3;0;0;0;0;3;0
1329.0;2021;06;CLERMONT-FERRAND;FEMININ;SCOLAIRE;BAC PROFESSIONNEL;BAC PRO SERV;BAC PRO 32304 PHOTOGRAPHIE;11;11;11;0;0;0;0;11;0;1;3;5;2;0
1335.0;2021;06;CLERMONT-FERRAND;FEMININ;SCOLAIRE;BAC PROFESSIONNEL;BAC PRO SERV;BAC PRO 33403 COMMERC. SERVICES EN RESTAURATION;50;49;42;2;5;3;2;45;0;1;13;19;12;4
1336.0;2021;06;CLERMONT-FERRAND;FEMININ;SCOLAIRE;BAC PROFESSIONNEL;BAC PRO SERV;BAC PRO 33603 ESTHETIQUE COSMETIQUE PARFUMERIE;74;73;68;5;0;0;0;68;0;1;13;35;19;5
1340.0;2021;06;CLERMONT-FERRAND;FEMININ;SCOLAIRE;BAC TECHNOLOGIQUE;BAC ST2S;BAC ST2S SCIENCES & TECHNO. SANTE & SOCIAL;405;405;375;4;26;11;15;386;0;7;49;153;177;19
1346.0;2021;06;CLERMONT-FERRAND;FEMININ;SCOLAIRE;BAC TECHNOLOGIQUE;BAC STI2D;BAC STI2D INNOVATION TECHNO.  ET ECO CONCEPTION;7;7;7;0;0;0;0;7;0;0;1;4;2;0
1349.0;2021;06;CLERMONT-FERRAND;FEMININ;SCOLAIRE;BAC TECHNOLOGIQUE;BAC STL;BAC STL SCIENCES PHYSIQUES CHIMIQUES  EN LABORAT.;14;14;12;0;2;0;2;12;0;0;4;3;5;2
1362.0;2021;06;CLERMONT-FERRAND;MASCULIN;APPRENTISSAGE;BAC PROFESSIONNEL;BAC PRO PROD;BAC PRO 23304 AMENAGEMENT FINITION BATIMENT;1;1;1;0;0;0;0;1;0;0;0;1;0;0
1364.0;2021;06;CLERMONT-FERRAND;MASCULIN;APPRENTISSAGE;BAC PROFESSIONNEL;BAC PRO PROD;BAC PRO 23405 TECHNICIEN MENUISIER AGENCEUR;9;9;7;2;0;0;0;7;0;0;2;2;3;2
1377.0;2021;06;CLERMONT-FERRAND;MASCULIN;APPRENTISSAGE;BAC PROFESSIONNEL;BAC PRO PROD;BAC PRO 25304 AERONAUTIQUE OPTION STRUCTURE;7;7;7;0;0;0;0;7;0;0;0;5;2;0
1384.0;2021;06;CLERMONT-FERRAND;MASCULIN;APPRENTISSAGE;BAC PROFESSIONNEL;BAC PRO PROD;BAC PRO AG 21303 FORET;11;11;11;0;0;0;0;11;0;0;0;6;5;0
1388.0;2021;06;CLERMONT-FERRAND;MASCULIN;APPRENTISSAGE;BAC PROFESSIONNEL;BAC PRO SERV;BAC PRO 31106 LOGISTIQUE;10;10;7;1;2;1;1;8;0;0;1;5;2;2
1392.0;2021;06;CLERMONT-FERRAND;MASCULIN;APPRENTISSAGE;BAC PROFESSIONNEL;BAC PRO SERV;BAC PRO 31210 ACCUEIL -RELATION CLIENTS USAGERS;1;1;1;0;0;0;0;1;0;0;1;0;0;0
1393.0;2021;06;CLERMONT-FERRAND;MASCULIN;APPRENTISSAGE;BAC PROFESSIONNEL;BAC PRO SERV;BAC PRO 32208 REAL.PR.IMPR.PLURI.OPTB.PR.IMPR.;1;1;1;0;0;0;0;1;0;0;1;0;0;0
1394.0;2021;06;CLERMONT-FERRAND;MASCULIN;APPRENTISSAGE;BAC PROFESSIONNEL;BAC PRO SERV;BAC PRO 33403 COMMERC. SERVICES EN RESTAURATION;3;3;3;0;0;0;0;3;0;0;0;1;2;0
1400.0;2021;06;CLERMONT-FERRAND;MASCULIN;ENSEIGNEMENT A DISTANCE;BAC TECHNOLOGIQUE;BAC STMG;BAC STMG MERCATIQUE (MARKETING);3;3;2;1;0;0;0;2;0;0;0;2;0;1
1419.0;2021;06;CLERMONT-FERRAND;MASCULIN;INDIVIDUEL;BAC TECHNOLOGIQUE;BAC STMG;BAC STMG GESTION ET FINANCE;1;1;0;1;0;0;0;0;0;0;0;0;0;1
1423.0;2021;06;CLERMONT-FERRAND;MASCULIN;SCOLAIRE;BAC PROFESSIONNEL;BAC PRO PROD;BACPRO 20002 ETUD.DEFINITION PRDTS INDUSTRIEL;11;11;5;5;1;0;1;5;0;1;0;4;0;6
1434.0;2021;06;CLERMONT-FERRAND;MASCULIN;SCOLAIRE;BAC PROFESSIONNEL;BAC PRO PROD;BAC PRO 23102 TRAVAUX PUBLICS;9;9;7;2;0;0;0;7;0;0;1;2;4;2
1437.0;2021;06;CLERMONT-FERRAND;MASCULIN;SCOLAIRE;BAC PROFESSIONNEL;BAC PRO PROD;BAC PRO 23304 AMENAGEMENT FINITION BATIMENT;9;9;9;0;0;0;0;9;0;1;3;3;2;0
1441.0;2021;06;CLERMONT-FERRAND;MASCULIN;SCOLAIRE;BAC PROFESSIONNEL;BAC PRO PROD;BAC PRO 24203 METIERS DE LA MODE - VÊTEMENT;6;6;4;2;0;0;0;4;0;0;1;1;2;2
1448.0;2021;06;CLERMONT-FERRAND;MASCULIN;SCOLAIRE;BAC PROFESSIONNEL;BAC PRO PROD;BAC PRO 25220 MAINT.MATERIELS OPT.B TP MANUT.;15;15;14;1;0;0;0;14;0;0;2;4;8;1
1452.0;2021;06;CLERMONT-FERRAND;MASCULIN;SCOLAIRE;BAC PROFESSIONNEL;BAC PRO PROD;BAC PRO 25304 AERONAUTIQUE OPTION STRUCTURE;20;20;20;0;0;0;0;20;0;0;2;11;7;0
1455.0;2021;06;CLERMONT-FERRAND;MASCULIN;SCOLAIRE;BAC PROFESSIONNEL;BAC PRO PROD;BAC PRO 25411 TECH.CHAUDRONNERIE INDUSTRIELLE;79;79;60;12;7;2;5;62;0;2;17;27;16;17
1456.0;2021;06;CLERMONT-FERRAND;MASCULIN;SCOLAIRE;BAC PROFESSIONNEL;BAC PRO PROD;BAC PRO 25509 TECHNIC. FROID CONDITIONNEMT AIR;17;17;12;5;0;0;0;12;0;1;0;9;2;5
1461.0;2021;06;CLERMONT-FERRAND;MASCULIN;SCOLAIRE;BAC PROFESSIONNEL;BAC PRO PROD;BAC PRO AG 21001 AGRO-EQUIPEMENT;20;20;17;3;0;0;0;17;0;0;3;5;9;3
1464.0;2021;06;CLERMONT-FERRAND;MASCULIN;SCOLAIRE;BAC PROFESSIONNEL;BAC PRO PROD;BAC PRO AG 21114 CONDUITE PRODUCTIONS HORTICOLES;4;4;2;2;0;0;0;2;0;1;0;0;1;2
1467.0;2021;06;CLERMONT-FERRAND;MASCULIN;SCOLAIRE;BAC PROFESSIONNEL;BAC PRO PROD;BAC PRO AG 21211 COND GEST ENTR HIPPIQUE;3;3;3;0;0;0;0;3;0;0;2;0;1;0
1474.0;2021;06;CLERMONT-FERRAND;MASCULIN;SCOLAIRE;BAC PROFESSIONNEL;BAC PRO SERV;BAC PRO 30001 GESTION-ADMINISTRATION;86;86;69;13;4;2;2;71;0;3;9;32;27;15
1478.0;2021;06;CLERMONT-FERRAND;MASCULIN;SCOLAIRE;BAC PROFESSIONNEL;BAC PRO SERV;BAC PRO 31202 COMMERCE;173;173;147;10;16;11;5;158;0;9;36;60;53;15
1483.0;2021;06;CLERMONT-FERRAND;MASCULIN;SCOLAIRE;BAC PROFESSIONNEL;BAC PRO SERV;BAC PRO 32303 ART.& MET.ART:COM.VIS.VIS.PLURI-M;39;39;35;3;1;1;0;36;0;1;4;21;10;3
1484.0;2021;06;CLERMONT-FERRAND;MASCULIN;SCOLAIRE;BAC PROFESSIONNEL;BAC PRO SERV;BAC PRO 32304 PHOTOGRAPHIE;3;3;3;0;0;0;0;3;0;0;0;2;1;0
1486.0;2021;06;CLERMONT-FERRAND;MASCULIN;SCOLAIRE;BAC PROFESSIONNEL;BAC PRO SERV;BAC PRO 33003 ACC.SOINS-S.PERS. OPT.A DOMICILE;1;1;1;0;0;0;0;1;0;0;0;1;0;0
1487.0;2021;06;CLERMONT-FERRAND;MASCULIN;SCOLAIRE;BAC PROFESSIONNEL;BAC PRO SERV;BAC PRO 33004 ACC.SOINS-S.PERS. OPT.EN STRUCTUR;20;20;17;3;0;0;0;17;0;0;2;8;7;3
1500.0;2021;06;CLERMONT-FERRAND;MASCULIN;SCOLAIRE;BAC TECHNOLOGIQUE;BAC STI2D;BAC STI2D INNOVATION TECHNO.  ET ECO CONCEPTION;137;137;133;0;4;2;2;135;0;4;19;66;46;2
1504.0;2021;06;CLERMONT-FERRAND;MASCULIN;SCOLAIRE;BAC TECHNOLOGIQUE;BAC STMG;BAC STMG GESTION ET FINANCE;132;132;119;1;12;9;3;128;0;1;10;54;63;4
1510.0;2021;27;CORSE;FEMININ;APPRENTISSAGE;BAC PROFESSIONNEL;BAC PRO SERV;BAC PRO 31202 COMMERCE;8;8;8;0;0;0;0;8;0;0;3;1;4;0
1511.0;2021;27;CORSE;FEMININ;APPRENTISSAGE;BAC PROFESSIONNEL;BAC PRO SERV;BAC PRO 31210 ACCUEIL -RELATION CLIENTS USAGERS;1;1;1;0;0;0;0;1;0;0;0;1;0;0
1514.0;2021;27;CORSE;FEMININ;ENSEIGNEMENT A DISTANCE;BAC PROFESSIONNEL;BAC PRO SERV;BAC PRO 30001 GESTION-ADMINISTRATION;1;1;1;0;0;0;0;1;0;0;0;0;1;0
1515.0;2021;27;CORSE;FEMININ;ENSEIGNEMENT A DISTANCE;BAC PROFESSIONNEL;BAC PRO SERV;BAC PRO 31202 COMMERCE;1;1;1;0;0;0;0;1;0;0;0;0;1;0
1527.0;2021;27;CORSE;FEMININ;INDIVIDUEL;BAC TECHNOLOGIQUE;BAC STMG;BAC STMG RESSOURCES HUMAINES ET COMMUNICATION;2;1;1;0;0;0;0;1;0;0;0;0;1;0
1533.0;2021;27;CORSE;FEMININ;SCOLAIRE;BAC PROFESSIONNEL;BAC PRO PROD;BAC PRO 25510 METIERS ELECT. ENVIRON. CONNECTES;1;1;1;0;0;0;0;1;0;0;0;0;1;0
1536.0;2021;27;CORSE;FEMININ;SCOLAIRE;BAC PROFESSIONNEL;BAC PRO PROD;BAC PRO AG 21004 CGEA;3;3;3;0;0;0;0;3;0;0;1;1;1;0
1537.0;2021;27;CORSE;FEMININ;SCOLAIRE;BAC PROFESSIONNEL;BAC PRO PROD;BAC PRO AG 21211 COND GEST ENTR HIPPIQUE;4;4;4;0;0;0;0;4;0;0;0;3;1;0
1538.0;2021;27;CORSE;FEMININ;SCOLAIRE;BAC PROFESSIONNEL;BAC PRO PROD;BAC PRO AG 21302 GEST MILIEUX NATURELS FAUNE;1;1;1;0;0;0;0;1;0;0;0;1;0;0
1541.0;2021;27;CORSE;FEMININ;SCOLAIRE;BAC PROFESSIONNEL;BAC PRO SERV;BAC PRO 31202 COMMERCE;21;21;19;0;2;2;0;21;0;1;3;5;12;0
1553.0;2021;27;CORSE;FEMININ;SCOLAIRE;BAC TECHNOLOGIQUE;BAC STI2D;BAC STI2D SYSTÈME D'INFORMATION  ET NUMERIQUE;8;8;8;0;0;0;0;8;0;0;4;4;0;0
1559.0;2021;27;CORSE;MASCULIN;APPRENTISSAGE;BAC PROFESSIONNEL;BAC PRO PROD;BAC PRO 23004 TECHN. ETUDES BAT.A ETUDES & ECO.;2;2;1;1;0;0;0;1;0;0;0;1;0;1
1562.0;2021;27;CORSE;MASCULIN;APPRENTISSAGE;BAC PROFESSIONNEL;BAC PRO SERV;BAC PRO 30001 GESTION-ADMINISTRATION;1;1;1;0;0;0;0;1;0;0;0;1;0;0
1563.0;2021;27;CORSE;MASCULIN;APPRENTISSAGE;BAC PROFESSIONNEL;BAC PRO SERV;BAC PRO 31106 LOGISTIQUE;3;3;2;0;1;1;0;3;0;0;1;0;2;0
1565.0;2021;27;CORSE;MASCULIN;APPRENTISSAGE;BAC PROFESSIONNEL;BAC PRO SERV;BAC PRO 31202 COMMERCE;7;6;5;1;0;0;0;5;0;1;0;1;3;1
1568.0;2021;27;CORSE;MASCULIN;FORMATION CONTINUE;BAC PROFESSIONNEL;BAC PRO PROD;BAC PRO 25515 SYST.NUM.OPT.C RES.INF.SYST.COMM.;1;1;1;0;0;0;0;1;0;0;1;0;0;0
1577.0;2021;27;CORSE;MASCULIN;INDIVIDUEL;BAC PROFESSIONNEL;BAC PRO PROD;BAC PRO AG 21405 AMENAGEMENTS PAYSAGERS;2;0;0;0;0;0;0;0;0;0;0;0;0;0
1583.0;2021;27;CORSE;MASCULIN;INDIVIDUEL;BAC TECHNOLOGIQUE;BAC STMG;BAC STMG RESSOURCES HUMAINES ET COMMUNICATION;1;0;0;0;0;0;0;0;0;0;0;0;0;0
1587.0;2021;27;CORSE;MASCULIN;SCOLAIRE;BAC PROFESSIONNEL;BAC PRO PROD;BAC PRO 23004 TECHN. ETUDES BAT.A ETUDES & ECO.;7;7;7;0;0;0;0;7;0;0;1;4;2;0
1597.0;2021;27;CORSE;MASCULIN;SCOLAIRE;BAC PROFESSIONNEL;BAC PRO PROD;BAC PRO 25514 SYST.NUM.OPT.B AUD.RES.EQUIP.DOM.;10;10;9;0;1;1;0;10;0;0;0;5;5;0
1599.0;2021;27;CORSE;MASCULIN;SCOLAIRE;BAC PROFESSIONNEL;BAC PRO PROD;BAC PRO AG 21004 CGEA;6;6;6;0;0;0;0;6;0;0;0;5;1;0
1602.0;2021;27;CORSE;MASCULIN;SCOLAIRE;BAC PROFESSIONNEL;BAC PRO PROD;BAC PRO AG 21405 AMENAGEMENTS PAYSAGERS;8;8;8;0;0;0;0;8;0;0;0;3;5;0
1603.0;2021;27;CORSE;MASCULIN;SCOLAIRE;BAC PROFESSIONNEL;BAC PRO SERV;BAC PRO 30001 GESTION-ADMINISTRATION;15;15;10;5;0;0;0;10;0;0;2;2;6;5
1614.0;2021;27;CORSE;MASCULIN;SCOLAIRE;BAC TECHNOLOGIQUE;BAC STAV;BAC STAV AGRONOMIE ALIM ENV TERRITOI;9;9;7;2;0;0;0;7;0;0;2;1;4;2
1624.0;2021;24;CRETEIL;FEMININ;APPRENTISSAGE;BAC PROFESSIONNEL;BAC PRO PROD;BAC PRO 22105 BOULANGER-PÂTISSIER;3;3;3;0;0;0;0;3;0;3;0;0;0;0
1630.0;2021;24;CRETEIL;FEMININ;APPRENTISSAGE;BAC PROFESSIONNEL;BAC PRO PROD;BAC PRO 25510 METIERS ELECT. ENVIRON. CONNECTES;6;6;5;1;0;0;0;5;0;0;2;2;1;1
1631.0;2021;24;CRETEIL;FEMININ;APPRENTISSAGE;BAC PROFESSIONNEL;BAC PRO PROD;BAC PRO AG 21001 AGRO-EQUIPEMENT;1;1;1;0;0;0;0;1;0;0;0;0;1;0
1634.0;2021;24;CRETEIL;FEMININ;APPRENTISSAGE;BAC PROFESSIONNEL;BAC PRO PROD;BAC PRO AG 21405 AMENAGEMENTS PAYSAGERS;6;6;5;1;0;0;0;5;0;0;1;1;3;1
1640.0;2021;24;CRETEIL;FEMININ;APPRENTISSAGE;BAC PROFESSIONNEL;BAC PRO SERV;BAC PRO 32303 ART.& MET.ART:COM.VIS.VIS.PLURI-M;5;5;5;0;0;0;0;5;0;0;0;3;2;0
1646.0;2021;24;CRETEIL;FEMININ;ENSEIGNEMENT A DISTANCE;BAC PROFESSIONNEL;BAC PRO SERV;BAC PRO 30001 GESTION-ADMINISTRATION;7;5;4;0;1;0;1;4;0;0;0;2;2;1
1673.0;2021;24;CRETEIL;FEMININ;INDIVIDUEL;BAC PROFESSIONNEL;BAC PRO SERV;BAC PRO 30001 GESTION-ADMINISTRATION;29;18;11;7;0;0;0;11;0;1;1;4;5;7
1675.0;2021;24;CRETEIL;FEMININ;INDIVIDUEL;BAC PROFESSIONNEL;BAC PRO SERV;BAC PRO 31206 VENTE (PROSPECT.NEGO.SUIV.CLIENT;3;2;0;2;0;0;0;0;0;0;0;0;0;2
1677.0;2021;24;CRETEIL;FEMININ;INDIVIDUEL;BAC PROFESSIONNEL;BAC PRO SERV;BAC PRO 32303 ART.& MET.ART:COM.VIS.VIS.PLURI-M;1;1;0;1;0;0;0;0;0;0;0;0;0;1
1678.0;2021;24;CRETEIL;FEMININ;INDIVIDUEL;BAC PROFESSIONNEL;BAC PRO SERV;BAC PRO 32304 PHOTOGRAPHIE;2;2;0;2;0;0;0;0;0;0;0;0;0;2
1682.0;2021;24;CRETEIL;FEMININ;INDIVIDUEL;BAC PROFESSIONNEL;BAC PRO SERV;BAC PRO 33603 ESTHETIQUE COSMETIQUE PARFUMERIE;1;1;0;1;0;0;0;0;0;0;0;0;0;1
1683.0;2021;24;CRETEIL;FEMININ;INDIVIDUEL;BAC PROFESSIONNEL;BAC PRO SERV;BAC PRO 34304 HYGIENE PROPRETE STERILISATION;1;0;0;0;0;0;0;0;0;0;0;0;0;0
1684.0;2021;24;CRETEIL;FEMININ;INDIVIDUEL;BAC PROFESSIONNEL;BAC PRO SERV;BAC PRO 34403 METIERS DE LA SECURITE;1;1;0;1;0;0;0;0;0;0;0;0;0;1
1685.0;2021;24;CRETEIL;FEMININ;INDIVIDUEL;BAC TECHNOLOGIQUE;BAC ST2S;BAC ST2S SCIENCES & TECHNO. SANTE & SOCIAL;29;18;6;9;3;1;2;7;0;0;0;1;6;11
1687.0;2021;24;CRETEIL;FEMININ;INDIVIDUEL;BAC TECHNOLOGIQUE;BAC STD2A;BAC STD2A SCIENCES & TECHNO. DESIGN-ARTS APPLIQUES;2;2;0;1;1;0;1;0;0;0;0;0;0;2
1701.0;2021;24;CRETEIL;FEMININ;SCOLAIRE;BAC PROFESSIONNEL;BAC PRO PROD;BAC PRO 23304 AMENAGEMENT FINITION BATIMENT;8;8;6;1;1;1;0;7;0;1;2;0;4;1
1716.0;2021;24;CRETEIL;FEMININ;SCOLAIRE;BAC PROFESSIONNEL;BAC PRO PROD;BAC PRO 25513 SYST.NUM.OPT.A SURETE SECURITE;1;1;1;0;0;0;0;1;0;0;0;0;1;0
1717.0;2021;24;CRETEIL;FEMININ;SCOLAIRE;BAC PROFESSIONNEL;BAC PRO PROD;BAC PRO 25514 SYST.NUM.OPT.B AUD.RES.EQUIP.DOM.;2;2;2;0;0;0;0;2;0;0;2;0;0;0
1721.0;2021;24;CRETEIL;FEMININ;SCOLAIRE;BAC PROFESSIONNEL;BAC PRO PROD;BAC PRO AG 21405 AMENAGEMENTS PAYSAGERS;2;2;2;0;0;0;0;2;0;0;0;1;1;0
1722.0;2021;24;CRETEIL;FEMININ;SCOLAIRE;BAC PROFESSIONNEL;BAC PRO PROD;BAC PRO AG 21406 TEC CONS VTE PROD DES JARDINS;6;5;3;2;0;0;0;3;0;0;0;0;3;2
1727.0;2021;24;CRETEIL;FEMININ;SCOLAIRE;BAC PROFESSIONNEL;BAC PRO SERV;BAC PRO 31107 CONDUCT. TRANSP.ROUT.MARCHANDISES;2;2;2;0;0;0;0;2;0;0;1;1;0;0
1728.0;2021;24;CRETEIL;FEMININ;SCOLAIRE;BAC PROFESSIONNEL;BAC PRO SERV;BAC PRO 31108 TRANSPORT;2;2;2;0;0;0;0;2;0;0;0;0;2;0
1729.0;2021;24;CRETEIL;FEMININ;SCOLAIRE;BAC PROFESSIONNEL;BAC PRO SERV;BAC PRO 31202 COMMERCE;692;689;587;63;39;24;15;611;0;15;114;198;284;78
1735.0;2021;24;CRETEIL;FEMININ;SCOLAIRE;BAC PROFESSIONNEL;BAC PRO SERV;BAC PRO 32303 ART.& MET.ART:COM.VIS.VIS.PLURI-M;91;89;82;5;2;2;0;84;0;6;25;29;24;5
1746.0;2021;24;CRETEIL;FEMININ;SCOLAIRE;BAC PROFESSIONNEL;BAC PRO SERV;BAC PRO AG 33002 SERV PERS TERRIT;37;36;34;2;0;0;0;34;0;2;6;15;11;2
1749.0;2021;24;CRETEIL;FEMININ;SCOLAIRE;BAC TECHNOLOGIQUE;BAC STD2A;BAC STD2A SCIENCES & TECHNO. DESIGN-ARTS APPLIQUES;222;222;212;7;3;1;2;213;1;14;46;81;71;9
1750.0;2021;24;CRETEIL;FEMININ;SCOLAIRE;BAC TECHNOLOGIQUE;BAC STHR;BAC STHR SC.&TEC. HOTELLERIE-RESTAURATION;49;49;46;1;2;2;0;48;1;3;10;15;19;1
1754.0;2021;24;CRETEIL;FEMININ;SCOLAIRE;BAC TECHNOLOGIQUE;BAC STI2D;BAC STI2D SYSTÈME D'INFORMATION  ET NUMERIQUE;49;49;46;0;3;2;1;48;0;3;7;18;20;1
1755.0;2021;24;CRETEIL;FEMININ;SCOLAIRE;BAC TECHNOLOGIQUE;BAC STL;BAC STL BIOCHIM.-BIOLOGIE-BIOTECHNOL.;124;124;112;4;8;3;5;115;0;5;16;50;44;9
1758.0;2021;24;CRETEIL;FEMININ;SCOLAIRE;BAC TECHNOLOGIQUE;BAC STMG;BAC STMG MERCATIQUE (MARKETING);1653;1650;1523;33;94;49;45;1572;0;28;299;702;543;78
1760.0;2021;24;CRETEIL;FEMININ;SCOLAIRE;BAC TECHNOLOGIQUE;BAC STMG;BAC STMG SYSTEMES D'INFORMATION DE GESTION;59;59;58;0;1;1;0;59;0;2;7;25;25;0
1763.0;2021;24;CRETEIL;MASCULIN;APPRENTISSAGE;BAC PROFESSIONNEL;BAC PRO PROD;BAC PRO 22703 TECHN.INSTALL.SYST.ENERG.CLIMATI;36;33;24;4;5;0;5;24;0;1;1;11;11;9
1764.0;2021;24;CRETEIL;MASCULIN;APPRENTISSAGE;BAC PROFESSIONNEL;BAC PRO PROD;BAC PRO 22704 TECHN. MAINT. SYST.ENERG.CLIMATI;32;27;14;9;4;0;4;14;0;1;5;5;3;13
1765.0;2021;24;CRETEIL;MASCULIN;APPRENTISSAGE;BAC PROFESSIONNEL;BAC PRO PROD;BAC PRO 23203 TECHNICIEN BAT. : ORG.REAL.GROS O;24;23;17;5;1;1;0;18;0;2;2;10;4;5
1770.0;2021;24;CRETEIL;MASCULIN;APPRENTISSAGE;BAC PROFESSIONNEL;BAC PRO PROD;BAC PRO 25106 TECHNICIEN D'USINAGE;9;9;9;0;0;0;0;9;0;1;1;2;5;0
1775.0;2021;24;CRETEIL;MASCULIN;APPRENTISSAGE;BAC PROFESSIONNEL;BAC PRO PROD;BAC PRO 25220 MAINT.MATERIELS OPT.B TP MANUT.;12;12;8;1;3;3;0;11;0;0;0;3;8;1
1777.0;2021;24;CRETEIL;MASCULIN;APPRENTISSAGE;BAC PROFESSIONNEL;BAC PRO PROD;BAC PRO 25411 TECH.CHAUDRONNERIE INDUSTRIELLE;19;19;13;3;3;2;1;15;0;1;2;5;7;4
1779.0;2021;24;CRETEIL;MASCULIN;APPRENTISSAGE;BAC PROFESSIONNEL;BAC PRO PROD;BAC PRO 25510 METIERS ELECT. ENVIRON. CONNECTES;137;128;110;9;9;4;5;114;0;15;26;30;43;14
1783.0;2021;24;CRETEIL;MASCULIN;APPRENTISSAGE;BAC PROFESSIONNEL;BAC PRO PROD;BAC PRO AG 21211 COND GEST ENTR HIPPIQUE;8;8;5;3;0;0;0;5;0;0;0;2;3;3
1790.0;2021;24;CRETEIL;MASCULIN;APPRENTISSAGE;BAC PROFESSIONNEL;BAC PRO SERV;BAC PRO 33102 PROTHESE DENTAIRE;4;4;4;0;0;0;0;4;0;0;0;2;2;0
1801.0;2021;24;CRETEIL;MASCULIN;ENSEIGNEMENT A DISTANCE;BAC TECHNOLOGIQUE;BAC STMG;BAC STMG MERCATIQUE (MARKETING);8;8;7;1;0;0;0;7;0;1;1;3;2;1
1812.0;2021;24;CRETEIL;MASCULIN;FORMATION CONTINUE;BAC PROFESSIONNEL;BAC PRO PROD;BAC PRO AG 21405 AMENAGEMENTS PAYSAGERS;4;4;4;0;0;0;0;4;0;0;0;0;4;0
1814.0;2021;24;CRETEIL;MASCULIN;INDIVIDUEL;BAC GENERAL;BAC GENERAL;BAC GENE 10019 BAC GENERAL;233;138;65;43;30;17;13;82;0;2;5;17;58;56
1816.0;2021;24;CRETEIL;MASCULIN;INDIVIDUEL;BAC PROFESSIONNEL;BAC PRO PROD;BAC PRO 22106 CUISINE;1;1;1;0;0;0;0;1;0;0;0;0;1;0
1818.0;2021;24;CRETEIL;MASCULIN;INDIVIDUEL;BAC PROFESSIONNEL;BAC PRO PROD;BAC PRO 23005 TECHN. ETUDES BAT B ASSIST.ARCHI.;1;1;0;1;0;0;0;0;0;0;0;0;0;1
1821.0;2021;24;CRETEIL;MASCULIN;INDIVIDUEL;BAC PROFESSIONNEL;BAC PRO PROD;BAC PRO 25007 MAINTENANCE EQUIPEMENTS INDUST.;2;1;0;1;0;0;0;0;0;0;0;0;0;1
1824.0;2021;24;CRETEIL;MASCULIN;INDIVIDUEL;BAC PROFESSIONNEL;BAC PRO PROD;BAC PRO 25303 AERONAUTIQUE OPTION SYSTEMES;1;1;0;0;1;0;1;0;0;0;0;0;0;1
1826.0;2021;24;CRETEIL;MASCULIN;INDIVIDUEL;BAC PROFESSIONNEL;BAC PRO PROD;BAC PRO 25411 TECH.CHAUDRONNERIE INDUSTRIELLE;1;0;0;0;0;0;0;0;0;0;0;0;0;0
1827.0;2021;24;CRETEIL;MASCULIN;INDIVIDUEL;BAC PROFESSIONNEL;BAC PRO PROD;BAC PRO 25509 TECHNIC. FROID CONDITIONNEMT AIR;4;2;1;1;0;0;0;1;0;0;0;0;1;1
1836.0;2021;24;CRETEIL;MASCULIN;INDIVIDUEL;BAC PROFESSIONNEL;BAC PRO SERV;BAC PRO 31106 LOGISTIQUE;2;2;0;2;0;0;0;0;0;0;0;0;0;2
1846.0;2021;24;CRETEIL;MASCULIN;INDIVIDUEL;BAC PROFESSIONNEL;BAC PRO SERV;BAC PRO 34304 HYGIENE PROPRETE STERILISATION;2;1;0;1;0;0;0;0;0;0;0;0;0;1
1849.0;2021;24;CRETEIL;MASCULIN;INDIVIDUEL;BAC TECHNOLOGIQUE;BAC S2TMD;BAC S2TMD MUSIQUE;1;1;1;0;0;0;0;1;0;0;0;0;1;0
1850.0;2021;24;CRETEIL;MASCULIN;INDIVIDUEL;BAC TECHNOLOGIQUE;BAC ST2S;BAC ST2S SCIENCES & TECHNO. SANTE & SOCIAL;5;1;0;1;0;0;0;0;0;0;0;0;0;1
1852.0;2021;24;CRETEIL;MASCULIN;INDIVIDUEL;BAC TECHNOLOGIQUE;BAC STI2D;BAC STI2D INNOVATION TECHNO.  ET ECO CONCEPTION;4;3;2;0;1;1;0;3;0;0;0;0;3;0
1853.0;2021;24;CRETEIL;MASCULIN;INDIVIDUEL;BAC TECHNOLOGIQUE;BAC STI2D;BAC STI2D SYSTÈME D'INFORMATION  ET NUMERIQUE;8;5;1;1;3;3;0;4;0;0;0;0;4;1
1855.0;2021;24;CRETEIL;MASCULIN;INDIVIDUEL;BAC TECHNOLOGIQUE;BAC STMG;BAC STMG MERCATIQUE (MARKETING);41;28;18;6;4;3;1;21;0;0;1;5;15;7
1857.0;2021;24;CRETEIL;MASCULIN;INDIVIDUEL;BAC TECHNOLOGIQUE;BAC STMG;BAC STMG SYSTEMES D'INFORMATION DE GESTION;7;5;1;4;0;0;0;1;0;0;0;1;0;4
1861.0;2021;24;CRETEIL;MASCULIN;SCOLAIRE;BAC PROFESSIONNEL;BAC PRO PROD;BAC PRO 22106 CUISINE;100;99;74;16;9;3;6;77;0;6;20;30;21;22
1862.0;2021;24;CRETEIL;MASCULIN;SCOLAIRE;BAC PROFESSIONNEL;BAC PRO PROD;BAC PRO 22302 Traitement des matériaux;10;10;8;2;0;0;0;8;0;0;0;4;4;2
1868.0;2021;24;CRETEIL;MASCULIN;SCOLAIRE;BAC PROFESSIONNEL;BAC PRO PROD;BAC PRO 23102 TRAVAUX PUBLICS;24;24;20;3;1;0;1;20;0;2;8;4;6;4
1869.0;2021;24;CRETEIL;MASCULIN;SCOLAIRE;BAC PROFESSIONNEL;BAC PRO PROD;BACPRO 23103 TECHNICIEN GEOMETRE-TOPOGRAPHE;19;18;15;2;1;0;1;15;0;0;5;5;5;3
1871.0;2021;24;CRETEIL;MASCULIN;SCOLAIRE;BAC PROFESSIONNEL;BAC PRO PROD;BAC PRO 23303 MENUISERIE ALUMINIUM-VERRE;7;7;4;2;1;0;1;4;0;0;1;1;2;3
1884.0;2021;24;CRETEIL;MASCULIN;SCOLAIRE;BAC PROFESSIONNEL;BAC PRO PROD;BAC PRO 25215 MAINT.VEHIC.OPTB VEHIC.TRANS.ROUT;7;7;7;0;0;0;0;7;0;1;0;2;4;0
1893.0;2021;24;CRETEIL;MASCULIN;SCOLAIRE;BAC PROFESSIONNEL;BAC PRO PROD;BAC PRO 25410 CONSTRUCTION DES CARROSSERIES;17;17;14;1;2;2;0;16;0;2;3;4;7;1
1899.0;2021;24;CRETEIL;MASCULIN;SCOLAIRE;BAC PROFESSIONNEL;BAC PRO PROD;BAC PRO 25515 SYST.NUM.OPT.C RES.INF.SYST.COMM.;474;474;384;71;19;14;5;398;0;20;88;142;148;76
1914.0;2021;24;CRETEIL;MASCULIN;SCOLAIRE;BAC PROFESSIONNEL;BAC PRO SERV;BAC PRO 32207 REAL.PR.IMPR.PLURI.OPTA.PR.GRAPH.;33;33;28;5;0;0;0;28;0;3;4;16;5;5
1916.0;2021;24;CRETEIL;MASCULIN;SCOLAIRE;BAC PROFESSIONNEL;BAC PRO SERV;BAC PRO 32303 ART.& MET.ART:COM.VIS.VIS.PLURI-M;116;115;103;12;0;0;0;103;0;3;14;50;36;12
1918.0;2021;24;CRETEIL;MASCULIN;SCOLAIRE;BAC PROFESSIONNEL;BAC PRO SERV;BAC PRO 33002 SERVICES DE PROXIMITE  VIE LOCAL;117;114;83;20;11;6;5;89;0;0;9;33;47;25
1925.0;2021;24;CRETEIL;MASCULIN;SCOLAIRE;BAC PROFESSIONNEL;BAC PRO SERV;BAC PRO 34403 METIERS DE LA SECURITE;139;139;120;13;6;3;3;123;0;3;28;54;38;16
1931.0;2021;24;CRETEIL;MASCULIN;SCOLAIRE;BAC TECHNOLOGIQUE;BAC STI2D;BAC STI2D ARCHITECTURE ET CONSTRUCTION;182;182;157;10;15;12;3;169;0;2;23;67;77;13
1936.0;2021;24;CRETEIL;MASCULIN;SCOLAIRE;BAC TECHNOLOGIQUE;BAC STL;BAC STL SCIENCES PHYSIQUES CHIMIQUES  EN LABORAT.;86;86;67;7;12;7;5;74;0;1;2;24;47;12
1951.0;2021;07;DIJON;FEMININ;APPRENTISSAGE;BAC PROFESSIONNEL;BAC PRO PROD;BAC PRO 25411 TECH.CHAUDRONNERIE INDUSTRIELLE;1;1;1;0;0;0;0;1;0;0;1;0;0;0
1953.0;2021;07;DIJON;FEMININ;APPRENTISSAGE;BAC PROFESSIONNEL;BAC PRO PROD;BAC PRO AG 21113 CGEVV;2;2;2;0;0;0;0;2;0;0;0;0;2;0
1956.0;2021;07;DIJON;FEMININ;APPRENTISSAGE;BAC PROFESSIONNEL;BAC PRO PROD;BAC PRO AG 21211 COND GEST ENTR HIPPIQUE;11;11;9;2;0;0;0;9;0;0;0;6;3;2
1961.0;2021;07;DIJON;FEMININ;APPRENTISSAGE;BAC PROFESSIONNEL;BAC PRO SERV;BAC PRO 31106 LOGISTIQUE;2;2;1;0;1;1;0;2;0;0;0;0;2;0
1967.0;2021;07;DIJON;FEMININ;ENSEIGNEMENT A DISTANCE;BAC GENERAL;BAC GENERAL;BAC GENE 10019 BAC GENERAL;21;19;16;1;2;0;2;16;0;4;7;2;3;3
1974.0;2021;07;DIJON;FEMININ;FORMATION CONTINUE;BAC PROFESSIONNEL;BAC PRO PROD;BAC PRO 22105 BOULANGER-PÂTISSIER;1;1;1;0;0;0;0;1;0;1;0;0;0;0
1977.0;2021;07;DIJON;FEMININ;FORMATION CONTINUE;BAC PROFESSIONNEL;BAC PRO SERV;BAC PRO 30001 GESTION-ADMINISTRATION;9;9;9;0;0;0;0;9;0;4;2;2;1;0
1987.0;2021;07;DIJON;FEMININ;INDIVIDUEL;BAC PROFESSIONNEL;BAC PRO SERV;BAC PRO 31206 VENTE (PROSPECT.NEGO.SUIV.CLIENT;1;1;0;0;1;1;0;1;0;0;0;0;1;0
1988.0;2021;07;DIJON;FEMININ;INDIVIDUEL;BAC PROFESSIONNEL;BAC PRO SERV;BAC PRO 31210 ACCUEIL -RELATION CLIENTS USAGERS;1;1;1;0;0;0;0;1;0;0;0;0;1;0
1993.0;2021;07;DIJON;FEMININ;INDIVIDUEL;BAC TECHNOLOGIQUE;BAC STMG;BAC STMG GESTION ET FINANCE;3;3;2;1;0;0;0;2;0;0;1;0;1;1
2003.0;2021;07;DIJON;FEMININ;SCOLAIRE;BAC PROFESSIONNEL;BAC PRO PROD;BAC PRO 22503 PLASTIQUES ET COMPOSITES;1;1;1;0;0;0;0;1;0;0;0;1;0;0
2022.0;2021;07;DIJON;FEMININ;SCOLAIRE;BAC PROFESSIONNEL;BAC PRO PROD;BAC PRO 25408 REPARATION DES CARROSSERIES;1;1;1;0;0;0;0;1;0;0;0;1;0;0
2026.0;2021;07;DIJON;FEMININ;SCOLAIRE;BAC PROFESSIONNEL;BAC PRO PROD;BAC PRO 25514 SYST.NUM.OPT.B AUD.RES.EQUIP.DOM.;1;1;1;0;0;0;0;1;0;0;0;0;1;0
2029.0;2021;07;DIJON;FEMININ;SCOLAIRE;BAC PROFESSIONNEL;BAC PRO PROD;BAC PRO AG 21113 CGEVV;6;6;4;2;0;0;0;4;0;0;0;1;3;2
2037.0;2021;07;DIJON;FEMININ;SCOLAIRE;BAC PROFESSIONNEL;BAC PRO PROD;BAC PRO AG 22106 TEC CONS VTE ALIMENTATION VINS SP;9;9;7;2;0;0;0;7;0;0;2;2;3;2
2042.0;2021;07;DIJON;FEMININ;SCOLAIRE;BAC PROFESSIONNEL;BAC PRO SERV;BAC PRO 31108 TRANSPORT;2;2;2;0;0;0;0;2;0;0;1;0;1;0
2046.0;2021;07;DIJON;FEMININ;SCOLAIRE;BAC PROFESSIONNEL;BAC PRO SERV;BAC PRO 32207 REAL.PR.IMPR.PLURI.OPTA.PR.GRAPH.;2;2;2;0;0;0;0;2;0;0;2;0;0;0
2065.0;2021;07;DIJON;FEMININ;SCOLAIRE;BAC TECHNOLOGIQUE;BAC STI2D;BAC STI2D ARCHITECTURE ET CONSTRUCTION;14;14;14;0;0;0;0;14;0;1;3;7;3;0
2067.0;2021;07;DIJON;FEMININ;SCOLAIRE;BAC TECHNOLOGIQUE;BAC STI2D;BAC STI2D INNOVATION TECHNO.  ET ECO CONCEPTION;7;7;6;0;1;1;0;7;0;0;2;2;3;0
2070.0;2021;07;DIJON;FEMININ;SCOLAIRE;BAC TECHNOLOGIQUE;BAC STL;BAC STL SCIENCES PHYSIQUES CHIMIQUES  EN LABORAT.;32;32;28;1;3;1;2;29;0;1;8;10;10;3
2072.0;2021;07;DIJON;FEMININ;SCOLAIRE;BAC TECHNOLOGIQUE;BAC STMG;BAC STMG MERCATIQUE (MARKETING);270;269;241;5;23;12;11;253;0;1;29;106;117;16
2074.0;2021;07;DIJON;FEMININ;SCOLAIRE;BAC TECHNOLOGIQUE;BAC STMG;BAC STMG SYSTEMES D'INFORMATION DE GESTION;1;1;1;0;0;0;0;1;0;0;0;1;0;0
2081.0;2021;07;DIJON;MASCULIN;APPRENTISSAGE;BAC PROFESSIONNEL;BAC PRO PROD;BAC PRO 23208 METIERS ET ARTS DE LA PIERRE;1;1;1;0;0;0;0;1;0;0;1;0;0;0
2087.0;2021;07;DIJON;MASCULIN;APPRENTISSAGE;BAC PROFESSIONNEL;BAC PRO PROD;BAC PRO 25107 TECHNICIEN OUTILLEUR;1;1;0;0;1;1;0;1;0;0;0;0;1;0
2089.0;2021;07;DIJON;MASCULIN;APPRENTISSAGE;BAC PROFESSIONNEL;BAC PRO PROD;BAC PRO 25214 MAINT.VEHIC.OPTA VOIT.PARTICUL.;87;84;58;22;4;3;1;61;0;2;4;21;34;23
2094.0;2021;07;DIJON;MASCULIN;APPRENTISSAGE;BAC PROFESSIONNEL;BAC PRO PROD;BAC PRO 25411 TECH.CHAUDRONNERIE INDUSTRIELLE;44;44;42;2;0;0;0;42;0;4;12;20;6;2
2095.0;2021;07;DIJON;MASCULIN;APPRENTISSAGE;BAC PROFESSIONNEL;BAC PRO PROD;BAC PRO 25509 TECHNIC. FROID CONDITIONNEMT AIR;2;2;1;1;0;0;0;1;0;0;1;0;0;1
2115.0;2021;07;DIJON;MASCULIN;ENSEIGNEMENT A DISTANCE;BAC TECHNOLOGIQUE;BAC STMG;BAC STMG MERCATIQUE (MARKETING);1;1;1;0;0;0;0;1;0;0;0;0;1;0
2135.0;2021;07;DIJON;MASCULIN;INDIVIDUEL;BAC PROFESSIONNEL;BAC PRO SERV;BAC PRO 31210 ACCUEIL -RELATION CLIENTS USAGERS;1;0;0;0;0;0;0;0;0;0;0;0;0;0
2143.0;2021;07;DIJON;MASCULIN;INDIVIDUEL;BAC TECHNOLOGIQUE;BAC STMG;BAC STMG MERCATIQUE (MARKETING);13;13;7;5;1;0;1;7;0;0;0;3;4;6
2147.0;2021;07;DIJON;MASCULIN;SCOLAIRE;BAC PROFESSIONNEL;BAC PRO PROD;BAC PRO 20102 PILOTE DE LIGNE DE PRODUCTION;6;6;4;2;0;0;0;4;0;0;0;4;0;2
2149.0;2021;07;DIJON;MASCULIN;SCOLAIRE;BAC PROFESSIONNEL;BAC PRO PROD;BAC PRO 22004 PROC. CHIMIE EAU PAPIERS-CARTONS;4;4;4;0;0;0;0;4;0;0;2;2;0;0
2154.0;2021;07;DIJON;MASCULIN;SCOLAIRE;BAC PROFESSIONNEL;BAC PRO PROD;BAC PRO 22704 TECHN. MAINT. SYST.ENERG.CLIMATI;28;28;14;11;3;2;1;16;0;0;2;5;9;12
2161.0;2021;07;DIJON;MASCULIN;SCOLAIRE;BAC PROFESSIONNEL;BAC PRO PROD;BAC PRO 23208 METIERS ET ARTS DE LA PIERRE;6;6;6;0;0;0;0;6;0;0;1;1;4;0
2171.0;2021;07;DIJON;MASCULIN;SCOLAIRE;BAC PROFESSIONNEL;BAC PRO PROD;BAC PRO 25106 TECHNICIEN D'USINAGE;48;48;41;2;5;5;0;46;0;3;7;14;22;2
2184.0;2021;07;DIJON;MASCULIN;SCOLAIRE;BAC PROFESSIONNEL;BAC PRO PROD;BAC PRO 25509 TECHNIC. FROID CONDITIONNEMT AIR;21;21;17;1;3;2;1;19;0;0;1;3;15;2
2197.0;2021;07;DIJON;MASCULIN;SCOLAIRE;BAC PROFESSIONNEL;BAC PRO PROD;BAC PRO AG 21303 FORET;11;11;10;1;0;0;0;10;0;0;0;5;5;1
2205.0;2021;07;DIJON;MASCULIN;SCOLAIRE;BAC PROFESSIONNEL;BAC PRO SERV;BAC PRO 31202 COMMERCE;223;223;184;15;24;14;10;198;0;7;38;70;83;25
2208.0;2021;07;DIJON;MASCULIN;SCOLAIRE;BAC PROFESSIONNEL;BAC PRO SERV;BAC PRO 32207 REAL.PR.IMPR.PLURI.OPTA.PR.GRAPH.;3;3;3;0;0;0;0;3;0;1;1;0;1;0
2210.0;2021;07;DIJON;MASCULIN;SCOLAIRE;BAC PROFESSIONNEL;BAC PRO SERV;BAC PRO 33002 SERVICES DE PROXIMITE  VIE LOCAL;25;25;15;7;3;3;0;18;0;0;1;6;11;7
2212.0;2021;07;DIJON;MASCULIN;SCOLAIRE;BAC PROFESSIONNEL;BAC PRO SERV;BAC PRO 33004 ACC.SOINS-S.PERS. OPT.EN STRUCTUR;18;18;17;0;1;1;0;18;0;0;1;9;8;0
2213.0;2021;07;DIJON;MASCULIN;SCOLAIRE;BAC PROFESSIONNEL;BAC PRO SERV;BAC PRO 33101 OPTIQUE LUNETTERIE;1;1;1;0;0;0;0;1;0;0;1;0;0;0
2220.0;2021;07;DIJON;MASCULIN;SCOLAIRE;BAC PROFESSIONNEL;BAC PRO SERV;BAC PRO AG 33002 SERV PERS TERRIT;27;25;22;3;0;0;0;22;0;0;6;10;6;3
2223.0;2021;07;DIJON;MASCULIN;SCOLAIRE;BAC TECHNOLOGIQUE;BAC STAV;BAC STAV AGRONOMIE ALIM ENV TERRITOI;125;124;121;3;0;0;0;121;0;4;16;51;50;3
2224.0;2021;07;DIJON;MASCULIN;SCOLAIRE;BAC TECHNOLOGIQUE;BAC STD2A;BAC STD2A SCIENCES & TECHNO. DESIGN-ARTS APPLIQUES;10;10;10;0;0;0;0;10;0;1;5;4;0;0
2225.0;2021;07;DIJON;MASCULIN;SCOLAIRE;BAC TECHNOLOGIQUE;BAC STHR;BAC STHR SC.&TEC. HOTELLERIE-RESTAURATION;24;24;21;0;3;2;1;23;0;1;5;7;10;1
2249.0;2021;08;GRENOBLE;FEMININ;APPRENTISSAGE;BAC PROFESSIONNEL;BAC PRO PROD;BAC PRO 25303 AERONAUTIQUE OPTION SYSTEMES;3;2;2;0;0;0;0;2;0;0;0;1;1;0
2255.0;2021;08;GRENOBLE;FEMININ;APPRENTISSAGE;BAC PROFESSIONNEL;BAC PRO PROD;BAC PRO AG 21114 CONDUITE PRODUCTIONS HORTICOLES;1;1;1;0;0;0;0;1;0;0;0;1;0;0
2257.0;2021;08;GRENOBLE;FEMININ;APPRENTISSAGE;BAC PROFESSIONNEL;BAC PRO PROD;BAC PRO AG 22107 TEC CONS VTE ALIMENTATION P.ALIM;4;4;4;0;0;0;0;4;0;1;2;0;1;0
2266.0;2021;08;GRENOBLE;FEMININ;ENSEIGNEMENT A DISTANCE;BAC PROFESSIONNEL;BAC PRO SERV;BAC PRO 31202 COMMERCE;3;2;2;0;0;0;0;2;0;0;1;0;1;0
2277.0;2021;08;GRENOBLE;FEMININ;INDIVIDUEL;BAC GENERAL;BAC GENERAL;BAC GENE 10019 BAC GENERAL;75;60;30;14;16;8;8;38;2;2;5;8;21;22
2278.0;2021;08;GRENOBLE;FEMININ;INDIVIDUEL;BAC PROFESSIONNEL;BAC PRO PROD;BAC PRO 22106 CUISINE;2;2;1;1;0;0;0;1;0;0;1;0;0;1
2279.0;2021;08;GRENOBLE;FEMININ;INDIVIDUEL;BAC PROFESSIONNEL;BAC PRO PROD;BAC PRO 23003 ARTIS. & M.ART:MARCHANDISAGE VIS.;1;1;1;0;0;0;0;1;0;0;0;1;0;0
2283.0;2021;08;GRENOBLE;FEMININ;INDIVIDUEL;BAC PROFESSIONNEL;BAC PRO PROD;BAC PRO AG 21114 CONDUITE PRODUCTIONS HORTICOLES;4;2;1;1;0;0;0;1;0;0;0;0;1;1
2288.0;2021;08;GRENOBLE;FEMININ;INDIVIDUEL;BAC PROFESSIONNEL;BAC PRO SERV;BAC PRO 31202 COMMERCE;2;2;1;1;0;0;0;1;0;0;0;1;0;1
2291.0;2021;08;GRENOBLE;FEMININ;INDIVIDUEL;BAC PROFESSIONNEL;BAC PRO SERV;BAC PRO 33004 ACC.SOINS-S.PERS. OPT.EN STRUCTUR;5;1;1;0;0;0;0;1;0;0;0;0;1;0
2294.0;2021;08;GRENOBLE;FEMININ;INDIVIDUEL;BAC TECHNOLOGIQUE;BAC ST2S;BAC ST2S SCIENCES & TECHNO. SANTE & SOCIAL;13;7;4;0;3;3;0;7;0;1;0;1;5;0
2314.0;2021;08;GRENOBLE;FEMININ;SCOLAIRE;BAC PROFESSIONNEL;BAC PRO PROD;BAC PRO 23404 TECHNICIEN CONSTRUCTEUR BOIS;1;1;1;0;0;0;0;1;0;0;1;0;0;0
2318.0;2021;08;GRENOBLE;FEMININ;SCOLAIRE;BAC PROFESSIONNEL;BAC PRO PROD;BAC PRO 24203 METIERS DE LA MODE - VÊTEMENT;131;131;107;14;10;5;5;112;0;11;24;40;37;19
2337.0;2021;08;GRENOBLE;FEMININ;SCOLAIRE;BAC PROFESSIONNEL;BAC PRO PROD;BAC PRO AG 21210 COND GEST ENTR CANIN ET FELIN;25;25;22;3;0;0;0;22;0;0;4;12;6;3
2343.0;2021;08;GRENOBLE;FEMININ;SCOLAIRE;BAC PROFESSIONNEL;BAC PRO PROD;BAC PRO AG 22105 LABORATOIRE CONTROLE QUALITE;17;16;13;3;0;0;0;13;0;0;0;6;7;3
2345.0;2021;08;GRENOBLE;FEMININ;SCOLAIRE;BAC PROFESSIONNEL;BAC PRO SERV;BAC PRO 30001 GESTION-ADMINISTRATION;746;744;589;109;46;35;11;624;0;22;103;224;275;120
2352.0;2021;08;GRENOBLE;FEMININ;SCOLAIRE;BAC PROFESSIONNEL;BAC PRO SERV;BAC PRO 32207 REAL.PR.IMPR.PLURI.OPTA.PR.GRAPH.;7;7;5;2;0;0;0;5;0;1;2;2;0;2
2366.0;2021;08;GRENOBLE;FEMININ;SCOLAIRE;BAC TECHNOLOGIQUE;BAC STAV;BAC STAV AGRONOMIE ALIM ENV TERRITOI;158;157;156;1;0;0;0;156;0;6;33;76;41;1
2371.0;2021;08;GRENOBLE;FEMININ;SCOLAIRE;BAC TECHNOLOGIQUE;BAC STI2D;BAC STI2D INNOVATION TECHNO.  ET ECO CONCEPTION;36;36;34;1;1;0;1;34;2;5;9;14;4;2
2373.0;2021;08;GRENOBLE;FEMININ;SCOLAIRE;BAC TECHNOLOGIQUE;BAC STL;BAC STL BIOCHIM.-BIOLOGIE-BIOTECHNOL.;126;126;115;2;9;5;4;120;0;6;24;58;32;6
2378.0;2021;08;GRENOBLE;FEMININ;SCOLAIRE;BAC TECHNOLOGIQUE;BAC STMG;BAC STMG SYSTEMES D'INFORMATION DE GESTION;19;19;18;1;0;0;0;18;0;1;3;4;10;1
2385.0;2021;08;GRENOBLE;MASCULIN;APPRENTISSAGE;BAC PROFESSIONNEL;BAC PRO PROD;BAC PRO 22703 TECHN.INSTALL.SYST.ENERG.CLIMATI;12;12;10;2;0;0;0;10;0;0;2;3;5;2
2386.0;2021;08;GRENOBLE;MASCULIN;APPRENTISSAGE;BAC PROFESSIONNEL;BAC PRO PROD;BAC PRO 22704 TECHN. MAINT. SYST.ENERG.CLIMATI;15;15;12;3;0;0;0;12;0;0;3;4;5;3
2392.0;2021;08;GRENOBLE;MASCULIN;APPRENTISSAGE;BAC PROFESSIONNEL;BAC PRO PROD;BAC PRO 23208 METIERS ET ARTS DE LA PIERRE;2;2;2;0;0;0;0;2;0;0;1;1;0;0
2395.0;2021;08;GRENOBLE;MASCULIN;APPRENTISSAGE;BAC PROFESSIONNEL;BAC PRO PROD;BAC PRO 23404 TECHNICIEN CONSTRUCTEUR BOIS;20;20;20;0;0;0;0;20;0;0;3;8;9;0
2400.0;2021;08;GRENOBLE;MASCULIN;APPRENTISSAGE;BAC PROFESSIONNEL;BAC PRO PROD;BAC PRO 25107 TECHNICIEN OUTILLEUR;5;5;4;1;0;0;0;4;0;0;1;1;2;1
2405.0;2021;08;GRENOBLE;MASCULIN;APPRENTISSAGE;BAC PROFESSIONNEL;BAC PRO PROD;BAC PRO 25220 MAINT.MATERIELS OPT.B TP MANUT.;25;25;20;5;0;0;0;20;0;2;5;7;6;5
2412.0;2021;08;GRENOBLE;MASCULIN;APPRENTISSAGE;BAC PROFESSIONNEL;BAC PRO PROD;BAC PRO 25509 TECHNIC. FROID CONDITIONNEMT AIR;1;1;1;0;0;0;0;1;0;1;0;0;0;0
2419.0;2021;08;GRENOBLE;MASCULIN;APPRENTISSAGE;BAC PROFESSIONNEL;BAC PRO SERV;BAC PRO 30001 GESTION-ADMINISTRATION;6;6;4;2;0;0;0;4;0;2;2;0;0;2
2430.0;2021;08;GRENOBLE;MASCULIN;ENSEIGNEMENT A DISTANCE;BAC PROFESSIONNEL;BAC PRO SERV;BAC PRO 31202 COMMERCE;6;4;3;1;0;0;0;3;0;0;1;0;2;1
2431.0;2021;08;GRENOBLE;MASCULIN;ENSEIGNEMENT A DISTANCE;BAC PROFESSIONNEL;BAC PRO SERV;BAC PRO 31206 VENTE (PROSPECT.NEGO.SUIV.CLIENT;2;1;1;0;0;0;0;1;0;0;0;1;0;0
2447.0;2021;08;GRENOBLE;MASCULIN;INDIVIDUEL;BAC PROFESSIONNEL;BAC PRO PROD;BAC PRO 23005 TECHN. ETUDES BAT B ASSIST.ARCHI.;1;1;1;0;0;0;0;1;0;0;0;1;0;0
2450.0;2021;08;GRENOBLE;MASCULIN;INDIVIDUEL;BAC PROFESSIONNEL;BAC PRO PROD;BAC PRO 25219 MAINT.MATERIELS OPT.A AGRICOLES;1;0;0;0;0;0;0;0;0;0;0;0;0;0
2451.0;2021;08;GRENOBLE;MASCULIN;INDIVIDUEL;BAC PROFESSIONNEL;BAC PRO PROD;BAC PRO 25220 MAINT.MATERIELS OPT.B TP MANUT.;1;1;1;0;0;0;0;1;0;0;0;0;1;0
2456.0;2021;08;GRENOBLE;MASCULIN;INDIVIDUEL;BAC PROFESSIONNEL;BAC PRO PROD;BAC PRO 25515 SYST.NUM.OPT.C RES.INF.SYST.COMM.;1;0;0;0;0;0;0;0;0;0;0;0;0;0
2458.0;2021;08;GRENOBLE;MASCULIN;INDIVIDUEL;BAC PROFESSIONNEL;BAC PRO PROD;BAC PRO AG 21004 CGEA;4;4;3;1;0;0;0;3;0;0;0;0;3;1
2459.0;2021;08;GRENOBLE;MASCULIN;INDIVIDUEL;BAC PROFESSIONNEL;BAC PRO PROD;BAC PRO AG 21114 CONDUITE PRODUCTIONS HORTICOLES;7;7;7;0;0;0;0;7;0;1;0;0;6;0
2463.0;2021;08;GRENOBLE;MASCULIN;INDIVIDUEL;BAC PROFESSIONNEL;BAC PRO SERV;BAC PRO 30001 GESTION-ADMINISTRATION;5;2;1;1;0;0;0;1;0;0;0;0;1;1
2469.0;2021;08;GRENOBLE;MASCULIN;INDIVIDUEL;BAC PROFESSIONNEL;BAC PRO SERV;BAC PRO AG 33002 SERV PERS TERRIT;2;0;0;0;0;0;0;0;0;0;0;0;0;0
2470.0;2021;08;GRENOBLE;MASCULIN;INDIVIDUEL;BAC TECHNOLOGIQUE;BAC S2TMD;BAC S2TMD MUSIQUE;2;1;1;0;0;0;0;1;0;0;1;0;0;0
2474.0;2021;08;GRENOBLE;MASCULIN;INDIVIDUEL;BAC TECHNOLOGIQUE;BAC STI2D;BAC STI2D ENERGIES  ET ENVIRONNEMENT;16;16;16;0;0;0;0;16;0;0;3;6;7;0
2475.0;2021;08;GRENOBLE;MASCULIN;INDIVIDUEL;BAC TECHNOLOGIQUE;BAC STI2D;BAC STI2D INNOVATION TECHNO.  ET ECO CONCEPTION;4;3;1;0;2;1;1;2;0;0;0;0;2;1
2479.0;2021;08;GRENOBLE;MASCULIN;INDIVIDUEL;BAC TECHNOLOGIQUE;BAC STMG;BAC STMG MERCATIQUE (MARKETING);22;9;4;2;3;3;0;7;0;0;0;0;7;2
2486.0;2021;08;GRENOBLE;MASCULIN;SCOLAIRE;BAC PROFESSIONNEL;BAC PRO PROD;BAC PRO 22004 PROC. CHIMIE EAU PAPIERS-CARTONS;49;49;35;11;3;2;1;37;0;0;6;11;20;12
2488.0;2021;08;GRENOBLE;MASCULIN;SCOLAIRE;BAC PROFESSIONNEL;BAC PRO PROD;BAC PRO 22106 CUISINE;149;149;137;7;5;4;1;141;0;10;39;52;40;8
2492.0;2021;08;GRENOBLE;MASCULIN;SCOLAIRE;BAC PROFESSIONNEL;BAC PRO PROD;BAC PRO 23003 ARTIS. & M.ART:MARCHANDISAGE VIS.;2;2;0;2;0;0;0;0;0;0;0;0;0;2
2495.0;2021;08;GRENOBLE;MASCULIN;SCOLAIRE;BAC PROFESSIONNEL;BAC PRO PROD;BAC PRO 23102 TRAVAUX PUBLICS;7;7;7;0;0;0;0;7;0;0;2;4;1;0
2500.0;2021;08;GRENOBLE;MASCULIN;SCOLAIRE;BAC PROFESSIONNEL;BAC PRO PROD;BAC PRO 23304 AMENAGEMENT FINITION BATIMENT;13;13;10;2;1;0;1;10;0;0;0;3;7;3
2501.0;2021;08;GRENOBLE;MASCULIN;SCOLAIRE;BAC PROFESSIONNEL;BAC PRO PROD;BAC PRO 23404 TECHNICIEN CONSTRUCTEUR BOIS;48;48;33;9;6;3;3;36;0;0;6;11;19;12
2507.0;2021;08;GRENOBLE;MASCULIN;SCOLAIRE;BAC PROFESSIONNEL;BAC PRO PROD;BAC PRO 24302 METIERS DU CUIR : MAROQUINERIE;1;1;1;0;0;0;0;1;0;0;1;0;0;0
2515.0;2021;08;GRENOBLE;MASCULIN;SCOLAIRE;BAC PROFESSIONNEL;BAC PRO PROD;BAC PRO 25216 MAINT.VEHIC.OPTC MOTOCYCLES;9;9;8;0;1;1;0;9;0;0;2;4;3;0
2521.0;2021;08;GRENOBLE;MASCULIN;SCOLAIRE;BAC PROFESSIONNEL;BAC PRO PROD;BAC PRO 25509 TECHNIC. FROID CONDITIONNEMT AIR;35;35;21;7;7;1;6;22;0;0;3;7;12;13
2529.0;2021;08;GRENOBLE;MASCULIN;SCOLAIRE;BAC PROFESSIONNEL;BAC PRO PROD;BAC PRO AG 21203 TECHN CONSEIL DE VENTE ANIMAL;15;15;13;2;0;0;0;13;0;1;1;4;7;2
2536.0;2021;08;GRENOBLE;MASCULIN;SCOLAIRE;BAC PROFESSIONNEL;BAC PRO PROD;BAC PRO AG 21406 TEC CONS VTE PROD DES JARDINS;11;11;10;1;0;0;0;10;0;0;2;4;4;1
2540.0;2021;08;GRENOBLE;MASCULIN;SCOLAIRE;BAC PROFESSIONNEL;BAC PRO SERV;BAC PRO 31106 LOGISTIQUE;94;94;67;16;11;6;5;73;0;3;7;24;39;21
2541.0;2021;08;GRENOBLE;MASCULIN;SCOLAIRE;BAC PROFESSIONNEL;BAC PRO SERV;BAC PRO 31107 CONDUCT. TRANSP.ROUT.MARCHANDISES;40;40;35;3;2;2;0;37;0;0;9;19;9;3
2545.0;2021;08;GRENOBLE;MASCULIN;SCOLAIRE;BAC PROFESSIONNEL;BAC PRO SERV;BAC PRO 31206 VENTE (PROSPECT.NEGO.SUIV.CLIENT;220;220;181;28;11;9;2;190;0;7;29;80;74;30
2546.0;2021;08;GRENOBLE;MASCULIN;SCOLAIRE;BAC PROFESSIONNEL;BAC PRO SERV;BAC PRO 31210 ACCUEIL -RELATION CLIENTS USAGERS;81;81;67;9;5;3;2;70;0;2;10;33;25;11
2556.0;2021;08;GRENOBLE;MASCULIN;SCOLAIRE;BAC PROFESSIONNEL;BAC PRO SERV;BAC PRO 34305 TECHN.D'INTERV.SUR INSTALL. NUCL.;19;19;13;3;3;3;0;16;0;0;1;7;8;3
2563.0;2021;08;GRENOBLE;MASCULIN;SCOLAIRE;BAC TECHNOLOGIQUE;BAC STHR;BAC STHR SC.&TEC. HOTELLERIE-RESTAURATION;64;64;62;0;2;2;0;64;0;3;5;27;29;0
2567.0;2021;08;GRENOBLE;MASCULIN;SCOLAIRE;BAC TECHNOLOGIQUE;BAC STI2D;BAC STI2D SYSTÈME D'INFORMATION  ET NUMERIQUE;461;461;431;7;23;14;9;445;0;18;91;213;123;16
2568.0;2021;08;GRENOBLE;MASCULIN;SCOLAIRE;BAC TECHNOLOGIQUE;BAC STL;BAC STL BIOCHIM.-BIOLOGIE-BIOTECHNOL.;61;61;50;0;11;3;8;53;0;0;4;24;25;8
2574.0;2021;32;GUADELOUPE;FEMININ;APPRENTISSAGE;BAC PROFESSIONNEL;BAC PRO PROD;BAC PRO AG 21004 CGEA;2;2;2;0;0;0;0;2;0;0;0;0;2;0
2577.0;2021;32;GUADELOUPE;FEMININ;APPRENTISSAGE;BAC PROFESSIONNEL;BAC PRO SERV;BAC PRO AG 33002 SERV PERS TERRIT;13;12;12;0;0;0;0;12;0;0;1;5;6;0
2582.0;2021;32;GUADELOUPE;FEMININ;FORMATION CONTINUE;BAC PROFESSIONNEL;BAC PRO SERV;BAC PRO 30001 GESTION-ADMINISTRATION;3;2;1;0;1;1;0;2;0;0;0;0;2;0
2588.0;2021;32;GUADELOUPE;FEMININ;INDIVIDUEL;BAC PROFESSIONNEL;BAC PRO PROD;BAC PRO AG 21114 CONDUITE PRODUCTIONS HORTICOLES;1;0;0;0;0;0;0;0;0;0;0;0;0;0
2590.0;2021;32;GUADELOUPE;FEMININ;INDIVIDUEL;BAC PROFESSIONNEL;BAC PRO SERV;BAC PRO 31202 COMMERCE;4;4;0;3;1;1;0;1;0;0;0;0;1;3
2591.0;2021;32;GUADELOUPE;FEMININ;INDIVIDUEL;BAC PROFESSIONNEL;BAC PRO SERV;BAC PRO 31210 ACCUEIL -RELATION CLIENTS USAGERS;2;1;1;0;0;0;0;1;0;0;0;0;1;0
2593.0;2021;32;GUADELOUPE;FEMININ;INDIVIDUEL;BAC PROFESSIONNEL;BAC PRO SERV;BAC PRO AG 33002 SERV PERS TERRIT;1;1;1;0;0;0;0;1;0;0;0;0;1;0
2599.0;2021;32;GUADELOUPE;FEMININ;SCOLAIRE;BAC GENERAL;BAC GENERAL;BAC GENE 10019 BAC GENERAL;1582;1582;1515;10;57;42;15;1557;25;198;388;526;420;25
2604.0;2021;32;GUADELOUPE;FEMININ;SCOLAIRE;BAC PROFESSIONNEL;BAC PRO PROD;BAC PRO 23004 TECHN. ETUDES BAT.A ETUDES & ECO.;2;2;2;0;0;0;0;2;0;0;1;1;0;0
2612.0;2021;32;GUADELOUPE;FEMININ;SCOLAIRE;BAC PROFESSIONNEL;BAC PRO PROD;BAC PRO 25007 MAINTENANCE EQUIPEMENTS INDUST.;2;2;1;0;1;1;0;2;0;0;0;0;2;0
2613.0;2021;32;GUADELOUPE;FEMININ;SCOLAIRE;BAC PROFESSIONNEL;BAC PRO PROD;BAC PRO 25214 MAINT.VEHIC.OPTA VOIT.PARTICUL.;1;1;1;0;0;0;0;1;0;0;0;1;0;0
2626.0;2021;32;GUADELOUPE;FEMININ;SCOLAIRE;BAC PROFESSIONNEL;BAC PRO SERV;BAC PRO 31206 VENTE (PROSPECT.NEGO.SUIV.CLIENT;27;27;24;1;2;1;1;25;0;1;5;7;12;2
2635.0;2021;32;GUADELOUPE;FEMININ;SCOLAIRE;BAC PROFESSIONNEL;BAC PRO SERV;BAC PRO 34304 HYGIENE PROPRETE STERILISATION;19;19;12;1;6;2;4;14;0;0;2;2;10;5
2637.0;2021;32;GUADELOUPE;FEMININ;SCOLAIRE;BAC PROFESSIONNEL;BAC PRO SERV;BAC PRO AG 33002 SERV PERS TERRIT;57;54;54;0;0;0;0;54;0;1;7;23;23;0
2641.0;2021;32;GUADELOUPE;FEMININ;SCOLAIRE;BAC TECHNOLOGIQUE;BAC STAV;BAC STAV AGRONOMIE ALIM ENV TERRITOI;5;5;5;0;0;0;0;5;0;1;1;2;1;0
2646.0;2021;32;GUADELOUPE;FEMININ;SCOLAIRE;BAC TECHNOLOGIQUE;BAC STI2D;BAC STI2D INNOVATION TECHNO.  ET ECO CONCEPTION;3;3;2;0;1;1;0;3;0;0;0;1;2;0
2648.0;2021;32;GUADELOUPE;FEMININ;SCOLAIRE;BAC TECHNOLOGIQUE;BAC STL;BAC STL BIOCHIM.-BIOLOGIE-BIOTECHNOL.;20;20;17;1;2;2;0;19;0;0;1;6;12;1
2653.0;2021;32;GUADELOUPE;FEMININ;SCOLAIRE;BAC TECHNOLOGIQUE;BAC STMG;BAC STMG SYSTEMES D'INFORMATION DE GESTION;5;5;1;0;4;3;1;4;0;0;0;1;3;1
2659.0;2021;32;GUADELOUPE;MASCULIN;ENSEIGNEMENT A DISTANCE;BAC GENERAL;BAC GENERAL;BAC GENE 10019 BAC GENERAL;2;2;2;0;0;0;0;2;0;0;1;1;0;0
2670.0;2021;32;GUADELOUPE;MASCULIN;INDIVIDUEL;BAC PROFESSIONNEL;BAC PRO PROD;BAC PRO 25406 OUVRAGES DU BATIMENT METALLERIE;1;1;1;0;0;0;0;1;0;0;0;0;1;0
2688.0;2021;32;GUADELOUPE;MASCULIN;SCOLAIRE;BAC PROFESSIONNEL;BAC PRO PROD;BAC PRO 23004 TECHN. ETUDES BAT.A ETUDES & ECO.;4;4;1;1;2;2;0;3;0;0;0;0;3;1
2694.0;2021;32;GUADELOUPE;MASCULIN;SCOLAIRE;BAC PROFESSIONNEL;BAC PRO PROD;BAC PRO 23405 TECHNICIEN MENUISIER AGENCEUR;25;25;19;4;2;2;0;21;0;1;2;6;12;4
2695.0;2021;32;GUADELOUPE;MASCULIN;SCOLAIRE;BAC PROFESSIONNEL;BAC PRO PROD;BAC PRO 23407 TECHNIC.FAB.BOIS ET MATERX ASSOC;14;14;6;5;3;3;0;9;0;0;2;0;7;5
2713.0;2021;32;GUADELOUPE;MASCULIN;SCOLAIRE;BAC PROFESSIONNEL;BAC PRO PROD;BAC PRO AG 21004 CGEA;18;17;16;1;0;0;0;16;0;0;0;5;11;1
2716.0;2021;32;GUADELOUPE;MASCULIN;SCOLAIRE;BAC PROFESSIONNEL;BAC PRO SERV;BAC PRO 30001 GESTION-ADMINISTRATION;70;70;48;11;11;9;2;57;0;0;2;16;39;13
2718.0;2021;32;GUADELOUPE;MASCULIN;SCOLAIRE;BAC PROFESSIONNEL;BAC PRO SERV;BAC PRO 31108 TRANSPORT;18;18;16;0;2;2;0;18;0;0;1;6;11;0
2721.0;2021;32;GUADELOUPE;MASCULIN;SCOLAIRE;BAC PROFESSIONNEL;BAC PRO SERV;BAC PRO 31210 ACCUEIL -RELATION CLIENTS USAGERS;24;24;18;5;1;1;0;19;0;0;5;5;9;5
2732.0;2021;32;GUADELOUPE;MASCULIN;SCOLAIRE;BAC TECHNOLOGIQUE;BAC S2TMD;BAC S2TMD THEATRE;2;2;2;0;0;0;0;2;0;1;0;1;0;0
2735.0;2021;32;GUADELOUPE;MASCULIN;SCOLAIRE;BAC TECHNOLOGIQUE;BAC STD2A;BAC STD2A SCIENCES & TECHNO. DESIGN-ARTS APPLIQUES;6;6;6;0;0;0;0;6;0;0;1;2;3;0
2740.0;2021;32;GUADELOUPE;MASCULIN;SCOLAIRE;BAC TECHNOLOGIQUE;BAC STI2D;BAC STI2D SYSTÈME D'INFORMATION  ET NUMERIQUE;76;76;69;1;6;5;1;74;0;0;9;28;37;2
2743.0;2021;32;GUADELOUPE;MASCULIN;SCOLAIRE;BAC TECHNOLOGIQUE;BAC STMG;BAC STMG MERCATIQUE (MARKETING);114;114;99;2;13;11;2;110;0;1;11;32;66;4
2746.0;2021;33;GUYANE;FEMININ;APPRENTISSAGE;BAC PROFESSIONNEL;BAC PRO PROD;BAC PRO AG 22107 TEC CONS VTE ALIMENTATION P.ALIM;1;1;1;0;0;0;0;1;0;0;0;0;1;0
2749.0;2021;33;GUYANE;FEMININ;FORMATION CONTINUE;BAC PROFESSIONNEL;BAC PRO PROD;BAC PRO AG 21114 CONDUITE PRODUCTIONS HORTICOLES;1;1;0;1;0;0;0;0;0;0;0;0;0;1
2752.0;2021;33;GUYANE;FEMININ;INDIVIDUEL;BAC PROFESSIONNEL;BAC PRO PROD;BAC PRO 24203 METIERS DE LA MODE - VÊTEMENT;1;1;0;1;0;0;0;0;0;0;0;0;0;1
2759.0;2021;33;GUYANE;FEMININ;INDIVIDUEL;BAC PROFESSIONNEL;BAC PRO SERV;BAC PRO 33004 ACC.SOINS-S.PERS. OPT.EN STRUCTUR;1;1;1;0;0;0;0;1;0;0;0;0;1;0
2767.0;2021;33;GUYANE;FEMININ;SCOLAIRE;BAC PROFESSIONNEL;BAC PRO PROD;BAC PRO 22704 TECHN. MAINT. SYST.ENERG.CLIMATI;3;3;2;1;0;0;0;2;0;0;0;0;2;1
2769.0;2021;33;GUYANE;FEMININ;SCOLAIRE;BAC PROFESSIONNEL;BAC PRO PROD;BAC PRO 23005 TECHN. ETUDES BAT B ASSIST.ARCHI.;5;5;3;0;2;1;1;4;0;0;0;0;4;1
2774.0;2021;33;GUYANE;FEMININ;SCOLAIRE;BAC PROFESSIONNEL;BAC PRO PROD;BAC PRO 23304 AMENAGEMENT FINITION BATIMENT;12;12;12;0;0;0;0;12;0;0;1;3;8;0
2787.0;2021;33;GUYANE;FEMININ;SCOLAIRE;BAC PROFESSIONNEL;BAC PRO SERV;BAC PRO 31202 COMMERCE;59;59;49;2;8;5;3;54;0;2;5;12;35;5
2791.0;2021;33;GUYANE;FEMININ;SCOLAIRE;BAC PROFESSIONNEL;BAC PRO SERV;BAC PRO 32303 ART.& MET.ART:COM.VIS.VIS.PLURI-M;4;4;3;1;0;0;0;3;0;0;0;0;3;1
2805.0;2021;33;GUYANE;FEMININ;SCOLAIRE;BAC TECHNOLOGIQUE;BAC STI2D;BAC STI2D SYSTÈME D'INFORMATION  ET NUMERIQUE;2;2;2;0;0;0;0;2;0;0;0;0;2;0
2815.0;2021;33;GUYANE;MASCULIN;ENSEIGNEMENT A DISTANCE;BAC GENERAL;BAC GENERAL;BAC GENE 10019 BAC GENERAL;3;3;2;0;1;1;0;3;0;0;1;0;2;0
2832.0;2021;33;GUYANE;MASCULIN;SCOLAIRE;BAC PROFESSIONNEL;BAC PRO PROD;BAC PRO 22104 BOUCHER CHARCUTIER TRAITEUR;10;10;9;1;0;0;0;9;0;1;1;1;6;1
2835.0;2021;33;GUYANE;MASCULIN;SCOLAIRE;BAC PROFESSIONNEL;BAC PRO PROD;BAC PRO 23004 TECHN. ETUDES BAT.A ETUDES & ECO.;32;32;20;10;2;2;0;22;0;0;2;3;17;10
2836.0;2021;33;GUYANE;MASCULIN;SCOLAIRE;BAC PROFESSIONNEL;BAC PRO PROD;BAC PRO 23005 TECHN. ETUDES BAT B ASSIST.ARCHI.;5;5;3;2;0;0;0;3;0;0;1;1;1;2
2838.0;2021;33;GUYANE;MASCULIN;SCOLAIRE;BAC PROFESSIONNEL;BAC PRO PROD;BAC PRO 23203 TECHNICIEN BAT. : ORG.REAL.GROS O;33;33;23;4;6;4;2;27;0;0;0;4;23;6
2840.0;2021;33;GUYANE;MASCULIN;SCOLAIRE;BAC PROFESSIONNEL;BAC PRO PROD;BAC PRO 23303 MENUISERIE ALUMINIUM-VERRE;9;9;6;2;1;1;0;7;0;0;0;0;7;2
2844.0;2021;33;GUYANE;MASCULIN;SCOLAIRE;BAC PROFESSIONNEL;BAC PRO PROD;BAC PRO 24203 METIERS DE LA MODE - VÊTEMENT;4;4;2;2;0;0;0;2;0;0;0;0;2;2
2847.0;2021;33;GUYANE;MASCULIN;SCOLAIRE;BAC PROFESSIONNEL;BAC PRO PROD;BAC PRO 25215 MAINT.VEHIC.OPTB VEHIC.TRANS.ROUT;18;17;11;5;1;1;0;12;0;0;1;4;7;5
2848.0;2021;33;GUYANE;MASCULIN;SCOLAIRE;BAC PROFESSIONNEL;BAC PRO PROD;BAC PRO 25411 TECH.CHAUDRONNERIE INDUSTRIELLE;19;19;12;6;1;1;0;13;0;1;0;2;10;6
2852.0;2021;33;GUYANE;MASCULIN;SCOLAIRE;BAC PROFESSIONNEL;BAC PRO PROD;BAC PRO 25515 SYST.NUM.OPT.C RES.INF.SYST.COMM.;11;11;10;0;1;1;0;11;0;0;2;2;7;0
2856.0;2021;33;GUYANE;MASCULIN;SCOLAIRE;BAC PROFESSIONNEL;BAC PRO SERV;BAC PRO 30001 GESTION-ADMINISTRATION;71;70;46;16;8;6;2;52;0;1;3;20;28;18
2860.0;2021;33;GUYANE;MASCULIN;SCOLAIRE;BAC PROFESSIONNEL;BAC PRO SERV;BAC PRO 31209 POISSONIER ECAILLER TRAITEUR;11;11;6;2;3;0;3;6;0;0;0;1;5;5
2865.0;2021;33;GUYANE;MASCULIN;SCOLAIRE;BAC PROFESSIONNEL;BAC PRO SERV;BAC PRO 33004 ACC.SOINS-S.PERS. OPT.EN STRUCTUR;6;6;5;1;0;0;0;5;0;0;2;2;1;1
2869.0;2021;33;GUYANE;MASCULIN;SCOLAIRE;BAC PROFESSIONNEL;BAC PRO SERV;BAC PRO AG 33002 SERV PERS TERRIT;4;4;4;0;0;0;0;4;0;0;0;2;2;0
2871.0;2021;33;GUYANE;MASCULIN;SCOLAIRE;BAC TECHNOLOGIQUE;BAC STAV;BAC STAV AGRONOMIE ALIM ENV TERRITOI;10;9;9;0;0;0;0;9;0;1;1;3;4;0
2875.0;2021;33;GUYANE;MASCULIN;SCOLAIRE;BAC TECHNOLOGIQUE;BAC STI2D;BAC STI2D INNOVATION TECHNO.  ET ECO CONCEPTION;36;36;30;2;4;3;1;33;0;0;1;12;20;3
2877.0;2021;33;GUYANE;MASCULIN;SCOLAIRE;BAC TECHNOLOGIQUE;BAC STL;BAC STL BIOCHIM.-BIOLOGIE-BIOTECHNOL.;9;9;4;3;2;0;2;4;0;0;0;1;3;5
2889.0;2021;28;LA REUNION;FEMININ;FORMATION CONTINUE;BAC PROFESSIONNEL;BAC PRO SERV;BAC PRO 31202 COMMERCE;9;5;4;1;0;0;0;4;0;0;1;2;1;1
2891.0;2021;28;LA REUNION;FEMININ;INDIVIDUEL;BAC PROFESSIONNEL;BAC PRO PROD;BAC PRO 23003 ARTIS. & M.ART:MARCHANDISAGE VIS.;1;1;0;1;0;0;0;0;0;0;0;0;0;1
2896.0;2021;28;LA REUNION;FEMININ;INDIVIDUEL;BAC TECHNOLOGIQUE;BAC ST2S;BAC ST2S SCIENCES & TECHNO. SANTE & SOCIAL;4;4;1;2;1;1;0;2;0;0;0;1;1;2
2897.0;2021;28;LA REUNION;FEMININ;INDIVIDUEL;BAC TECHNOLOGIQUE;BAC STI2D;BAC STI2D SYSTÈME D'INFORMATION  ET NUMERIQUE;1;1;0;1;0;0;0;0;0;0;0;0;0;1
2901.0;2021;28;LA REUNION;FEMININ;SCOLAIRE;BAC GENERAL;BAC GENERAL;BAC GENE 10019 BAC GENERAL;3105;3104;2989;16;99;82;17;3071;117;404;823;1006;721;33
2904.0;2021;28;LA REUNION;FEMININ;SCOLAIRE;BAC PROFESSIONNEL;BAC PRO PROD;BAC PRO 22105 BOULANGER-PÂTISSIER;16;16;16;0;0;0;0;16;0;4;6;3;3;0
2907.0;2021;28;LA REUNION;FEMININ;SCOLAIRE;BAC PROFESSIONNEL;BAC PRO PROD;BAC PRO 23004 TECHN. ETUDES BAT.A ETUDES & ECO.;8;8;4;4;0;0;0;4;0;0;1;0;3;4
2908.0;2021;28;LA REUNION;FEMININ;SCOLAIRE;BAC PROFESSIONNEL;BAC PRO PROD;BAC PRO 23005 TECHN. ETUDES BAT B ASSIST.ARCHI.;16;16;14;1;1;1;0;15;0;1;1;11;2;1
2914.0;2021;28;LA REUNION;FEMININ;SCOLAIRE;BAC PROFESSIONNEL;BAC PRO PROD;BAC PRO 23408 Etude et réalisation d'agencement;1;1;1;0;0;0;0;1;0;0;1;0;0;0
2915.0;2021;28;LA REUNION;FEMININ;SCOLAIRE;BAC PROFESSIONNEL;BAC PRO PROD;BAC PRO 24203 METIERS DE LA MODE - VÊTEMENT;23;23;22;1;0;0;0;22;0;5;5;10;2;1
2917.0;2021;28;LA REUNION;FEMININ;SCOLAIRE;BAC PROFESSIONNEL;BAC PRO PROD;BAC PRO 25106 TECHNICIEN D'USINAGE;1;1;1;0;0;0;0;1;0;0;0;1;0;0
2937.0;2021;28;LA REUNION;FEMININ;SCOLAIRE;BAC PROFESSIONNEL;BAC PRO SERV;BAC PRO 32208 REAL.PR.IMPR.PLURI.OPTB.PR.IMPR.;7;7;7;0;0;0;0;7;0;1;2;2;2;0
2940.0;2021;28;LA REUNION;FEMININ;SCOLAIRE;BAC PROFESSIONNEL;BAC PRO SERV;BAC PRO 33003 ACC.SOINS-S.PERS. OPT.A DOMICILE;27;27;24;2;1;1;0;25;0;3;3;12;7;2
2942.0;2021;28;LA REUNION;FEMININ;SCOLAIRE;BAC PROFESSIONNEL;BAC PRO SERV;BAC PRO 33101 OPTIQUE LUNETTERIE;8;8;8;0;0;0;0;8;0;0;0;5;3;0
2943.0;2021;28;LA REUNION;FEMININ;SCOLAIRE;BAC PROFESSIONNEL;BAC PRO SERV;BAC PRO 33403 COMMERC. SERVICES EN RESTAURATION;12;12;12;0;0;0;0;12;0;1;1;5;5;0
2947.0;2021;28;LA REUNION;FEMININ;SCOLAIRE;BAC PROFESSIONNEL;BAC PRO SERV;BAC PRO 34403 METIERS DE LA SECURITE;25;25;21;3;1;0;1;21;0;1;6;5;9;4
2949.0;2021;28;LA REUNION;FEMININ;SCOLAIRE;BAC TECHNOLOGIQUE;BAC ST2S;BAC ST2S SCIENCES & TECHNO. SANTE & SOCIAL;381;381;350;11;20;14;6;364;0;18;56;135;155;17
2950.0;2021;28;LA REUNION;FEMININ;SCOLAIRE;BAC TECHNOLOGIQUE;BAC STAV;BAC STAV AGRONOMIE ALIM ENV TERRITOI;6;6;6;0;0;0;0;6;0;0;0;1;5;0
2952.0;2021;28;LA REUNION;FEMININ;SCOLAIRE;BAC TECHNOLOGIQUE;BAC STHR;BAC STHR SC.&TEC. HOTELLERIE-RESTAURATION;17;17;14;2;1;0;1;14;0;1;2;6;5;3
2956.0;2021;28;LA REUNION;FEMININ;SCOLAIRE;BAC TECHNOLOGIQUE;BAC STI2D;BAC STI2D SYSTÈME D'INFORMATION  ET NUMERIQUE;9;9;7;1;1;0;1;7;0;0;1;1;5;2
2958.0;2021;28;LA REUNION;FEMININ;SCOLAIRE;BAC TECHNOLOGIQUE;BAC STL;BAC STL SCIENCES PHYSIQUES CHIMIQUES  EN LABORAT.;15;15;14;0;1;1;0;15;1;0;2;6;6;0
2962.0;2021;28;LA REUNION;FEMININ;SCOLAIRE;BAC TECHNOLOGIQUE;BAC STMG;BAC STMG SYSTEMES D'INFORMATION DE GESTION;12;12;6;0;6;4;2;10;0;0;0;2;8;2
2964.0;2021;28;LA REUNION;MASCULIN;APPRENTISSAGE;BAC PROFESSIONNEL;BAC PRO PROD;BAC PRO 22003 BIO-INDUSTRIES DE TRANSFORMATION;3;3;2;0;1;1;0;3;0;0;1;0;2;0
2966.0;2021;28;LA REUNION;MASCULIN;APPRENTISSAGE;BAC PROFESSIONNEL;BAC PRO PROD;BAC PRO 25214 MAINT.VEHIC.OPTA VOIT.PARTICUL.;12;12;6;4;2;0;2;6;0;1;4;1;0;6
2969.0;2021;28;LA REUNION;MASCULIN;APPRENTISSAGE;BAC PROFESSIONNEL;BAC PRO PROD;BAC PRO 25408 REPARATION DES CARROSSERIES;3;3;2;0;1;0;1;2;0;0;1;0;1;1
2970.0;2021;28;LA REUNION;MASCULIN;APPRENTISSAGE;BAC PROFESSIONNEL;BAC PRO PROD;BAC PRO 25510 METIERS ELECT. ENVIRON. CONNECTES;5;5;4;1;0;0;0;4;0;1;2;0;1;1
2972.0;2021;28;LA REUNION;MASCULIN;APPRENTISSAGE;BAC PROFESSIONNEL;BAC PRO SERV;BAC PRO 30001 GESTION-ADMINISTRATION;1;1;1;0;0;0;0;1;0;0;0;1;0;0
2975.0;2021;28;LA REUNION;MASCULIN;ENSEIGNEMENT A DISTANCE;BAC GENERAL;BAC GENERAL;BAC GENE 10019 BAC GENERAL;6;5;5;0;0;0;0;5;0;1;2;2;0;0
2977.0;2021;28;LA REUNION;MASCULIN;ENSEIGNEMENT A DISTANCE;BAC TECHNOLOGIQUE;BAC STMG;BAC STMG MERCATIQUE (MARKETING);1;1;1;0;0;0;0;1;0;0;0;1;0;0
2980.0;2021;28;LA REUNION;MASCULIN;INDIVIDUEL;BAC PROFESSIONNEL;BAC PRO PROD;BAC PRO 25411 TECH.CHAUDRONNERIE INDUSTRIELLE;1;1;0;0;1;0;1;0;0;0;0;0;0;1
2984.0;2021;28;LA REUNION;MASCULIN;INDIVIDUEL;BAC PROFESSIONNEL;BAC PRO PROD;BAC PRO AG 21406 TEC CONS VTE PROD DES JARDINS;1;1;1;0;0;0;0;1;0;0;0;0;1;0
2985.0;2021;28;LA REUNION;MASCULIN;INDIVIDUEL;BAC PROFESSIONNEL;BAC PRO SERV;BAC PRO 31202 COMMERCE;1;1;0;0;1;0;1;0;0;0;0;0;0;1
2988.0;2021;28;LA REUNION;MASCULIN;INDIVIDUEL;BAC TECHNOLOGIQUE;BAC STAV;BAC STAV AGRONOMIE ALIM ENV TERRITOI;3;1;1;0;0;0;0;1;0;0;0;0;1;0
3004.0;2021;28;LA REUNION;MASCULIN;SCOLAIRE;BAC PROFESSIONNEL;BAC PRO PROD;BAC PRO 23004 TECHN. ETUDES BAT.A ETUDES & ECO.;34;34;16;17;1;0;1;16;0;0;0;7;9;18
3005.0;2021;28;LA REUNION;MASCULIN;SCOLAIRE;BAC PROFESSIONNEL;BAC PRO PROD;BAC PRO 23005 TECHN. ETUDES BAT B ASSIST.ARCHI.;35;35;30;4;1;1;0;31;0;1;5;11;14;4
3010.0;2021;28;LA REUNION;MASCULIN;SCOLAIRE;BAC PROFESSIONNEL;BAC PRO PROD;BAC PRO 23206 INTERV. SUR PATRIMOINE BATI OPT.B;2;2;1;1;0;0;0;1;0;0;0;1;0;1
3020.0;2021;28;LA REUNION;MASCULIN;SCOLAIRE;BAC PROFESSIONNEL;BAC PRO PROD;BAC PRO 25106 TECHNICIEN D'USINAGE;11;11;8;1;2;1;1;9;0;1;1;3;4;2
3029.0;2021;28;LA REUNION;MASCULIN;SCOLAIRE;BAC PROFESSIONNEL;BAC PRO PROD;BAC PRO 25411 TECH.CHAUDRONNERIE INDUSTRIELLE;27;27;17;3;7;3;4;20;0;1;8;5;6;7
3030.0;2021;28;LA REUNION;MASCULIN;SCOLAIRE;BAC PROFESSIONNEL;BAC PRO PROD;BAC PRO 25509 TECHNIC. FROID CONDITIONNEMT AIR;28;28;20;6;2;2;0;22;0;1;3;6;12;6
3040.0;2021;28;LA REUNION;MASCULIN;SCOLAIRE;BAC PROFESSIONNEL;BAC PRO PROD;BAC PRO AG 21406 TEC CONS VTE PROD DES JARDINS;5;5;3;2;0;0;0;3;0;0;0;0;3;2
3044.0;2021;28;LA REUNION;MASCULIN;SCOLAIRE;BAC PROFESSIONNEL;BAC PRO SERV;BAC PRO 31108 TRANSPORT;24;24;19;2;3;3;0;22;0;3;2;3;14;2
3045.0;2021;28;LA REUNION;MASCULIN;SCOLAIRE;BAC PROFESSIONNEL;BAC PRO SERV;BAC PRO 31202 COMMERCE;227;227;164;31;32;29;3;193;0;7;40;47;99;34
3048.0;2021;28;LA REUNION;MASCULIN;SCOLAIRE;BAC PROFESSIONNEL;BAC PRO SERV;BAC PRO 32207 REAL.PR.IMPR.PLURI.OPTA.PR.GRAPH.;7;7;5;0;2;2;0;7;0;0;2;1;4;0
3054.0;2021;28;LA REUNION;MASCULIN;SCOLAIRE;BAC PROFESSIONNEL;BAC PRO SERV;BAC PRO 33101 OPTIQUE LUNETTERIE;6;6;6;0;0;0;0;6;0;0;1;5;0;0
3056.0;2021;28;LA REUNION;MASCULIN;SCOLAIRE;BAC PROFESSIONNEL;BAC PRO SERV;BAC PRO 34303 GEST. POLLUTIONS PROTEC. ENVIRON.;4;4;3;1;0;0;0;3;0;0;0;1;2;1
3059.0;2021;28;LA REUNION;MASCULIN;SCOLAIRE;BAC PROFESSIONNEL;BAC PRO SERV;BAC PRO AG 33002 SERV PERS TERRIT;10;9;6;3;0;0;0;6;0;0;0;2;4;3
3060.0;2021;28;LA REUNION;MASCULIN;SCOLAIRE;BAC TECHNOLOGIQUE;BAC ST2S;BAC ST2S SCIENCES & TECHNO. SANTE & SOCIAL;84;84;73;3;8;5;3;78;0;2;11;27;38;6
3061.0;2021;28;LA REUNION;MASCULIN;SCOLAIRE;BAC TECHNOLOGIQUE;BAC STAV;BAC STAV AGRONOMIE ALIM ENV TERRITOI;6;6;5;1;0;0;0;5;0;0;0;1;4;1
3077.0;2021;09;LILLE;FEMININ;APPRENTISSAGE;BAC PROFESSIONNEL;BAC PRO PROD;BAC PRO 22705 TECHNICIEN GAZ;1;1;1;0;0;0;0;1;0;1;0;0;0;0
3088.0;2021;09;LILLE;FEMININ;APPRENTISSAGE;BAC PROFESSIONNEL;BAC PRO PROD;BAC PRO 25406 OUVRAGES DU BATIMENT METALLERIE;1;1;1;0;0;0;0;1;0;0;0;1;0;0
3089.0;2021;09;LILLE;FEMININ;APPRENTISSAGE;BAC PROFESSIONNEL;BAC PRO PROD;BAC PRO 25411 TECH.CHAUDRONNERIE INDUSTRIELLE;1;1;1;0;0;0;0;1;0;0;1;0;0;0
3092.0;2021;09;LILLE;FEMININ;APPRENTISSAGE;BAC PROFESSIONNEL;BAC PRO PROD;BAC PRO AG 21203 TECHN CONSEIL DE VENTE ANIMAL;3;3;3;0;0;0;0;3;0;0;2;1;0;0
3098.0;2021;09;LILLE;FEMININ;APPRENTISSAGE;BAC PROFESSIONNEL;BAC PRO SERV;BAC PRO 31206 VENTE (PROSPECT.NEGO.SUIV.CLIENT;1;1;1;0;0;0;0;1;0;0;1;0;0;0
3099.0;2021;09;LILLE;FEMININ;APPRENTISSAGE;BAC PROFESSIONNEL;BAC PRO SERV;BAC PRO 31210 ACCUEIL -RELATION CLIENTS USAGERS;8;8;7;1;0;0;0;7;0;2;0;4;1;1
3101.0;2021;09;LILLE;FEMININ;APPRENTISSAGE;BAC PROFESSIONNEL;BAC PRO SERV;BAC PRO 33403 COMMERC. SERVICES EN RESTAURATION;12;10;10;0;0;0;0;10;0;0;3;1;6;0
3104.0;2021;09;LILLE;FEMININ;ENSEIGNEMENT A DISTANCE;BAC GENERAL;BAC GENERAL;BAC GENE 10019 BAC GENERAL;51;48;47;1;0;0;0;47;3;10;23;4;7;1
3109.0;2021;09;LILLE;FEMININ;ENSEIGNEMENT A DISTANCE;BAC TECHNOLOGIQUE;BAC ST2S;BAC ST2S SCIENCES & TECHNO. SANTE & SOCIAL;2;2;2;0;0;0;0;2;0;0;1;1;0;0
3113.0;2021;09;LILLE;FEMININ;FORMATION CONTINUE;BAC PROFESSIONNEL;BAC PRO PROD;BAC PRO 20102 PILOTE DE LIGNE DE PRODUCTION;3;3;3;0;0;0;0;3;0;1;2;0;0;0
3130.0;2021;09;LILLE;FEMININ;INDIVIDUEL;BAC PROFESSIONNEL;BAC PRO PROD;BAC PRO AG 21113 CGEVV;1;1;1;0;0;0;0;1;0;0;0;0;1;0
3131.0;2021;09;LILLE;FEMININ;INDIVIDUEL;BAC PROFESSIONNEL;BAC PRO PROD;BAC PRO AG 21114 CONDUITE PRODUCTIONS HORTICOLES;2;2;2;0;0;0;0;2;0;0;0;0;2;0
3132.0;2021;09;LILLE;FEMININ;INDIVIDUEL;BAC PROFESSIONNEL;BAC PRO PROD;BAC PRO AG 21211 COND GEST ENTR HIPPIQUE;5;4;3;1;0;0;0;3;0;0;0;0;3;1
3133.0;2021;09;LILLE;FEMININ;INDIVIDUEL;BAC PROFESSIONNEL;BAC PRO SERV;BAC PRO 30001 GESTION-ADMINISTRATION;10;7;3;4;0;0;0;3;0;0;1;0;2;4
3138.0;2021;09;LILLE;FEMININ;INDIVIDUEL;BAC PROFESSIONNEL;BAC PRO SERV;BAC PRO 33003 ACC.SOINS-S.PERS. OPT.A DOMICILE;2;1;1;0;0;0;0;1;0;0;0;0;1;0
3142.0;2021;09;LILLE;FEMININ;INDIVIDUEL;BAC TECHNOLOGIQUE;BAC STMG;BAC STMG GESTION ET FINANCE;5;3;2;1;0;0;0;2;0;0;0;1;1;1
3144.0;2021;09;LILLE;FEMININ;INDIVIDUEL;BAC TECHNOLOGIQUE;BAC STMG;BAC STMG RESSOURCES HUMAINES ET COMMUNICATION;10;4;3;0;1;1;0;4;0;1;0;0;3;0
3149.0;2021;09;LILLE;FEMININ;SCOLAIRE;BAC PROFESSIONNEL;BAC PRO PROD;BAC PRO 22106 CUISINE;136;135;108;16;11;3;8;111;0;6;23;43;39;24
3157.0;2021;09;LILLE;FEMININ;SCOLAIRE;BAC PROFESSIONNEL;BAC PRO PROD;BAC PRO 23304 AMENAGEMENT FINITION BATIMENT;9;9;8;1;0;0;0;8;0;1;3;2;2;1
3165.0;2021;09;LILLE;FEMININ;SCOLAIRE;BAC PROFESSIONNEL;BAC PRO PROD;BAC PRO 25214 MAINT.VEHIC.OPTA VOIT.PARTICUL.;18;18;14;3;1;1;0;15;0;0;3;6;6;3
3166.0;2021;09;LILLE;FEMININ;SCOLAIRE;BAC PROFESSIONNEL;BAC PRO PROD;BAC PRO 25215 MAINT.VEHIC.OPTB VEHIC.TRANS.ROUT;3;2;2;0;0;0;0;2;0;0;0;2;0;0
3171.0;2021;09;LILLE;FEMININ;SCOLAIRE;BAC PROFESSIONNEL;BAC PRO PROD;BAC PRO 25410 CONSTRUCTION DES CARROSSERIES;1;1;1;0;0;0;0;1;0;0;0;1;0;0
3179.0;2021;09;LILLE;FEMININ;SCOLAIRE;BAC PROFESSIONNEL;BAC PRO PROD;BAC PRO AG 21114 CONDUITE PRODUCTIONS HORTICOLES;5;5;5;0;0;0;0;5;0;0;1;4;0;0
3180.0;2021;09;LILLE;FEMININ;SCOLAIRE;BAC PROFESSIONNEL;BAC PRO PROD;BAC PRO AG 21203 TECHN CONSEIL DE VENTE ANIMAL;31;31;26;5;0;0;0;26;0;0;3;8;15;5
3183.0;2021;09;LILLE;FEMININ;SCOLAIRE;BAC PROFESSIONNEL;BAC PRO PROD;BAC PRO AG 21211 COND GEST ENTR HIPPIQUE;27;27;27;0;0;0;0;27;0;1;5;11;10;0
3184.0;2021;09;LILLE;FEMININ;SCOLAIRE;BAC PROFESSIONNEL;BAC PRO PROD;BAC PRO AG 21302 GEST MILIEUX NATURELS FAUNE;5;5;5;0;0;0;0;5;0;0;0;5;0;0
3188.0;2021;09;LILLE;FEMININ;SCOLAIRE;BAC PROFESSIONNEL;BAC PRO PROD;BAC PRO AG 22107 TEC CONS VTE ALIMENTATION P.ALIM;6;6;6;0;0;0;0;6;0;0;3;3;0;0
3190.0;2021;09;LILLE;FEMININ;SCOLAIRE;BAC PROFESSIONNEL;BAC PRO SERV;BAC PRO 31106 LOGISTIQUE;18;18;15;3;0;0;0;15;0;2;2;6;5;3
3192.0;2021;09;LILLE;FEMININ;SCOLAIRE;BAC PROFESSIONNEL;BAC PRO SERV;BAC PRO 31108 TRANSPORT;9;9;7;0;2;1;1;8;0;0;1;2;5;1
3208.0;2021;09;LILLE;FEMININ;SCOLAIRE;BAC PROFESSIONNEL;BAC PRO SERV;BAC PRO 33603 ESTHETIQUE COSMETIQUE PARFUMERIE;195;190;176;13;1;1;0;177;0;5;41;77;54;13
3211.0;2021;09;LILLE;FEMININ;SCOLAIRE;BAC PROFESSIONNEL;BAC PRO SERV;BAC PRO AG 33002 SERV PERS TERRIT;175;170;162;8;0;0;0;162;0;5;25;69;63;8
3214.0;2021;09;LILLE;FEMININ;SCOLAIRE;BAC TECHNOLOGIQUE;BAC ST2S;BAC ST2S SCIENCES & TECHNO. SANTE & SOCIAL;1734;1732;1567;41;124;74;50;1641;4;54;308;640;635;91
3222.0;2021;09;LILLE;FEMININ;SCOLAIRE;BAC TECHNOLOGIQUE;BAC STL;BAC STL BIOCHIM.-BIOLOGIE-BIOTECHNOL.;172;172;160;2;10;7;3;167;1;2;37;61;66;5
3224.0;2021;09;LILLE;FEMININ;SCOLAIRE;BAC TECHNOLOGIQUE;BAC STMG;BAC STMG GESTION ET FINANCE;319;319;295;9;15;6;9;301;1;18;63;131;88;18
3225.0;2021;09;LILLE;FEMININ;SCOLAIRE;BAC TECHNOLOGIQUE;BAC STMG;BAC STMG MERCATIQUE (MARKETING);736;736;646;23;67;38;29;684;0;20;120;282;262;52
3231.0;2021;09;LILLE;MASCULIN;APPRENTISSAGE;BAC PROFESSIONNEL;BAC PRO PROD;BAC PRO 22106 CUISINE;35;33;27;4;2;1;1;28;0;1;6;10;11;5
3232.0;2021;09;LILLE;MASCULIN;APPRENTISSAGE;BAC PROFESSIONNEL;BAC PRO PROD;BAC PRO 22403 ARTS.& MET.ART:MET.ENSEIGN SIGNA;2;2;2;0;0;0;0;2;0;0;1;1;0;0
3233.0;2021;09;LILLE;MASCULIN;APPRENTISSAGE;BAC PROFESSIONNEL;BAC PRO PROD;BAC PRO 22703 TECHN.INSTALL.SYST.ENERG.CLIMATI;20;20;15;2;3;2;1;17;0;1;2;4;10;3
3235.0;2021;09;LILLE;MASCULIN;APPRENTISSAGE;BAC PROFESSIONNEL;BAC PRO PROD;BAC PRO 22705 TECHNICIEN GAZ;4;4;4;0;0;0;0;4;0;1;1;2;0;0
3240.0;2021;09;LILLE;MASCULIN;APPRENTISSAGE;BAC PROFESSIONNEL;BAC PRO PROD;BAC PRO 23405 TECHNICIEN MENUISIER AGENCEUR;21;21;15;2;4;2;2;17;0;2;2;6;7;4
3249.0;2021;09;LILLE;MASCULIN;APPRENTISSAGE;BAC PROFESSIONNEL;BAC PRO PROD;BAC PRO 25303 AERONAUTIQUE OPTION SYSTEMES;4;4;4;0;0;0;0;4;0;2;1;1;0;0
3251.0;2021;09;LILLE;MASCULIN;APPRENTISSAGE;BAC PROFESSIONNEL;BAC PRO PROD;BAC PRO 25408 REPARATION DES CARROSSERIES;26;26;11;14;1;1;0;12;0;1;2;3;6;14
3260.0;2021;09;LILLE;MASCULIN;APPRENTISSAGE;BAC PROFESSIONNEL;BAC PRO PROD;BAC PRO AG 21405 AMENAGEMENTS PAYSAGERS;55;52;50;2;0;0;0;50;0;1;4;23;22;2
3274.0;2021;09;LILLE;MASCULIN;ENSEIGNEMENT A DISTANCE;BAC PROFESSIONNEL;BAC PRO SERV;BAC PRO 33004 ACC.SOINS-S.PERS. OPT.EN STRUCTUR;1;1;1;0;0;0;0;1;0;0;0;1;0;0
3275.0;2021;09;LILLE;MASCULIN;ENSEIGNEMENT A DISTANCE;BAC TECHNOLOGIQUE;BAC ST2S;BAC ST2S SCIENCES & TECHNO. SANTE & SOCIAL;2;1;1;0;0;0;0;1;0;0;0;0;1;0
3283.0;2021;09;LILLE;MASCULIN;FORMATION CONTINUE;BAC PROFESSIONNEL;BAC PRO PROD;BAC PRO 22705 TECHNICIEN GAZ;1;1;1;0;0;0;0;1;0;0;1;0;0;0
3288.0;2021;09;LILLE;MASCULIN;FORMATION CONTINUE;BAC PROFESSIONNEL;BAC PRO PROD;BAC PRO 25106 TECHNICIEN D'USINAGE;2;2;1;1;0;0;0;1;0;0;0;0;1;1
3291.0;2021;09;LILLE;MASCULIN;FORMATION CONTINUE;BAC PROFESSIONNEL;BAC PRO PROD;BAC PRO 25411 TECH.CHAUDRONNERIE INDUSTRIELLE;1;1;1;0;0;0;0;1;0;0;1;0;0;0
3300.0;2021;09;LILLE;MASCULIN;INDIVIDUEL;BAC PROFESSIONNEL;BAC PRO PROD;BAC PRO 22106 CUISINE;1;0;0;0;0;0;0;0;0;0;0;0;0;0
3314.0;2021;09;LILLE;MASCULIN;INDIVIDUEL;BAC PROFESSIONNEL;BAC PRO SERV;BAC PRO 34403 METIERS DE LA SECURITE;3;1;1;0;0;0;0;1;0;0;0;0;1;0
3316.0;2021;09;LILLE;MASCULIN;INDIVIDUEL;BAC TECHNOLOGIQUE;BAC STD2A;BAC STD2A SCIENCES & TECHNO. DESIGN-ARTS APPLIQUES;1;1;1;0;0;0;0;1;0;0;0;1;0;0
3317.0;2021;09;LILLE;MASCULIN;INDIVIDUEL;BAC TECHNOLOGIQUE;BAC STI2D;BAC STI2D ARCHITECTURE ET CONSTRUCTION;1;1;1;0;0;0;0;1;0;0;0;0;1;0
3325.0;2021;09;LILLE;MASCULIN;SCOLAIRE;BAC PROFESSIONNEL;BAC PRO PROD;BACPRO 20002 ETUD.DEFINITION PRDTS INDUSTRIEL;36;35;33;1;1;1;0;34;0;2;4;17;11;1
3329.0;2021;09;LILLE;MASCULIN;SCOLAIRE;BAC PROFESSIONNEL;BAC PRO PROD;BAC PRO 22106 CUISINE;218;217;187;20;10;5;5;192;0;12;35;70;75;25
3341.0;2021;09;LILLE;MASCULIN;SCOLAIRE;BAC PROFESSIONNEL;BAC PRO PROD;BAC PRO 23303 MENUISERIE ALUMINIUM-VERRE;17;17;16;1;0;0;0;16;0;0;1;5;10;1
3347.0;2021;09;LILLE;MASCULIN;SCOLAIRE;BAC PROFESSIONNEL;BAC PRO PROD;BAC PRO 24203 METIERS DE LA MODE - VÊTEMENT;18;18;12;6;0;0;0;12;0;2;3;3;4;6
3349.0;2021;09;LILLE;MASCULIN;SCOLAIRE;BAC PROFESSIONNEL;BAC PRO PROD;BAC PRO 25106 TECHNICIEN D'USINAGE;123;122;80;39;3;3;0;83;0;9;25;27;22;39
3357.0;2021;09;LILLE;MASCULIN;SCOLAIRE;BAC PROFESSIONNEL;BAC PRO PROD;BAC PRO 25406 OUVRAGES DU BATIMENT METALLERIE;46;46;34;8;4;2;2;36;0;1;12;13;10;10
3373.0;2021;09;LILLE;MASCULIN;SCOLAIRE;BAC PROFESSIONNEL;BAC PRO PROD;BAC PRO AG 21302 GEST MILIEUX NATURELS FAUNE;33;32;30;2;0;0;0;30;0;1;4;13;12;2
3376.0;2021;09;LILLE;MASCULIN;SCOLAIRE;BAC PROFESSIONNEL;BAC PRO PROD;BAC PRO AG 21406 TEC CONS VTE PROD DES JARDINS;15;15;15;0;0;0;0;15;0;1;1;8;5;0
3378.0;2021;09;LILLE;MASCULIN;SCOLAIRE;BAC PROFESSIONNEL;BAC PRO PROD;BAC PRO AG 22107 TEC CONS VTE ALIMENTATION P.ALIM;5;5;5;0;0;0;0;5;0;0;2;3;0;0
3380.0;2021;09;LILLE;MASCULIN;SCOLAIRE;BAC PROFESSIONNEL;BAC PRO SERV;BAC PRO 31106 LOGISTIQUE;161;161;106;38;17;14;3;120;0;9;16;35;60;41
3388.0;2021;09;LILLE;MASCULIN;SCOLAIRE;BAC PROFESSIONNEL;BAC PRO SERV;BAC PRO 32303 ART.& MET.ART:COM.VIS.VIS.PLURI-M;68;67;60;7;0;0;0;60;0;3;17;25;15;7
3390.0;2021;09;LILLE;MASCULIN;SCOLAIRE;BAC PROFESSIONNEL;BAC PRO SERV;BAC PRO 33002 SERVICES DE PROXIMITE  VIE LOCAL;57;57;49;5;3;3;0;52;0;0;12;19;21;5
3399.0;2021;09;LILLE;MASCULIN;SCOLAIRE;BAC PROFESSIONNEL;BAC PRO SERV;BAC PRO 34403 METIERS DE LA SECURITE;181;181;167;14;0;0;0;167;0;5;44;69;49;14
3411.0;2021;09;LILLE;MASCULIN;SCOLAIRE;BAC TECHNOLOGIQUE;BAC STL;BAC STL SCIENCES PHYSIQUES CHIMIQUES  EN LABORAT.;95;95;90;2;3;2;1;92;0;7;8;46;31;3
3421.0;2021;22;LIMOGES;FEMININ;APPRENTISSAGE;BAC PROFESSIONNEL;BAC PRO PROD;BAC PRO AG 21004 CGEA;2;2;2;0;0;0;0;2;0;1;0;0;1;0
3429.0;2021;22;LIMOGES;FEMININ;ENSEIGNEMENT A DISTANCE;BAC PROFESSIONNEL;BAC PRO SERV;BAC PRO 33603 ESTHETIQUE COSMETIQUE PARFUMERIE;1;0;0;0;0;0;0;0;0;0;0;0;0;0
3436.0;2021;22;LIMOGES;FEMININ;INDIVIDUEL;BAC PROFESSIONNEL;BAC PRO PROD;BAC PRO AG 21113 CGEVV;1;0;0;0;0;0;0;0;0;0;0;0;0;0
3451.0;2021;22;LIMOGES;FEMININ;SCOLAIRE;BAC PROFESSIONNEL;BAC PRO PROD;BAC PRO 22105 BOULANGER-PÂTISSIER;6;6;6;0;0;0;0;6;0;0;0;4;2;0
3458.0;2021;22;LIMOGES;FEMININ;SCOLAIRE;BAC PROFESSIONNEL;BAC PRO PROD;BAC PRO 23407 TECHNIC.FAB.BOIS ET MATERX ASSOC;3;3;3;0;0;0;0;3;0;0;2;0;1;0
3467.0;2021;22;LIMOGES;FEMININ;SCOLAIRE;BAC PROFESSIONNEL;BAC PRO PROD;BAC PRO 25509 TECHNIC. FROID CONDITIONNEMT AIR;3;3;2;1;0;0;0;2;0;0;0;0;2;1
3468.0;2021;22;LIMOGES;FEMININ;SCOLAIRE;BAC PROFESSIONNEL;BAC PRO PROD;BAC PRO 25510 METIERS ELECT. ENVIRON. CONNECTES;3;3;1;1;1;0;1;1;0;0;0;0;1;2
3472.0;2021;22;LIMOGES;FEMININ;SCOLAIRE;BAC PROFESSIONNEL;BAC PRO PROD;BAC PRO AG 21203 TECHN CONSEIL DE VENTE ANIMAL;32;30;27;3;0;0;0;27;0;2;5;5;15;3
3479.0;2021;22;LIMOGES;FEMININ;SCOLAIRE;BAC PROFESSIONNEL;BAC PRO SERV;BAC PRO 31108 TRANSPORT;4;4;2;1;1;1;0;3;0;0;0;1;2;1
3483.0;2021;22;LIMOGES;FEMININ;SCOLAIRE;BAC PROFESSIONNEL;BAC PRO SERV;BAC PRO 32207 REAL.PR.IMPR.PLURI.OPTA.PR.GRAPH.;3;3;3;0;0;0;0;3;0;1;1;0;1;0
3485.0;2021;22;LIMOGES;FEMININ;SCOLAIRE;BAC PROFESSIONNEL;BAC PRO SERV;BAC PRO 32303 ART.& MET.ART:COM.VIS.VIS.PLURI-M;7;7;2;5;0;0;0;2;0;0;1;1;0;5
3490.0;2021;22;LIMOGES;FEMININ;SCOLAIRE;BAC PROFESSIONNEL;BAC PRO SERV;BAC PRO 33403 COMMERC. SERVICES EN RESTAURATION;17;17;14;0;3;1;2;15;0;0;3;4;8;2
3494.0;2021;22;LIMOGES;FEMININ;SCOLAIRE;BAC PROFESSIONNEL;BAC PRO SERV;BAC PRO AG 33002 SERV PERS TERRIT;98;97;95;2;0;0;0;95;0;1;8;46;40;2
3497.0;2021;22;LIMOGES;FEMININ;SCOLAIRE;BAC TECHNOLOGIQUE;BAC STD2A;BAC STD2A SCIENCES & TECHNO. DESIGN-ARTS APPLIQUES;31;31;30;0;1;0;1;30;0;0;6;19;5;1
3498.0;2021;22;LIMOGES;FEMININ;SCOLAIRE;BAC TECHNOLOGIQUE;BAC STHR;BAC STHR SC.&TEC. HOTELLERIE-RESTAURATION;7;7;7;0;0;0;0;7;0;1;1;2;3;0
3500.0;2021;22;LIMOGES;FEMININ;SCOLAIRE;BAC TECHNOLOGIQUE;BAC STI2D;BAC STI2D ENERGIES  ET ENVIRONNEMENT;7;7;6;1;0;0;0;6;0;0;0;6;0;1
3504.0;2021;22;LIMOGES;FEMININ;SCOLAIRE;BAC TECHNOLOGIQUE;BAC STL;BAC STL SCIENCES PHYSIQUES CHIMIQUES  EN LABORAT.;22;22;21;0;1;1;0;22;0;2;4;10;6;0
3506.0;2021;22;LIMOGES;FEMININ;SCOLAIRE;BAC TECHNOLOGIQUE;BAC STMG;BAC STMG MERCATIQUE (MARKETING);120;120;113;2;5;2;3;115;0;3;16;45;51;5
3510.0;2021;22;LIMOGES;MASCULIN;APPRENTISSAGE;BAC PROFESSIONNEL;BAC PRO PROD;BAC PRO 22704 TECHN. MAINT. SYST.ENERG.CLIMATI;3;3;3;0;0;0;0;3;0;0;0;3;0;0
3512.0;2021;22;LIMOGES;MASCULIN;APPRENTISSAGE;BAC PROFESSIONNEL;BAC PRO PROD;BAC PRO 23203 TECHNICIEN BAT. : ORG.REAL.GROS O;1;1;0;1;0;0;0;0;0;0;0;0;0;1
3514.0;2021;22;LIMOGES;MASCULIN;APPRENTISSAGE;BAC PROFESSIONNEL;BAC PRO PROD;BAC PRO 23206 INTERV. SUR PATRIMOINE BATI OPT.B;1;1;1;0;0;0;0;1;0;0;0;1;0;0
3515.0;2021;22;LIMOGES;MASCULIN;APPRENTISSAGE;BAC PROFESSIONNEL;BAC PRO PROD;BAC PRO 23207 INTERV. SUR PATRIMOINE BATI OPT.C;1;1;1;0;0;0;0;1;0;0;1;0;0;0
3516.0;2021;22;LIMOGES;MASCULIN;APPRENTISSAGE;BAC PROFESSIONNEL;BAC PRO PROD;BAC PRO 23208 METIERS ET ARTS DE LA PIERRE;3;3;3;0;0;0;0;3;0;1;1;1;0;0
3517.0;2021;22;LIMOGES;MASCULIN;APPRENTISSAGE;BAC PROFESSIONNEL;BAC PRO PROD;BAC PRO 23304 AMENAGEMENT FINITION BATIMENT;1;1;1;0;0;0;0;1;0;0;0;0;1;0
3518.0;2021;22;LIMOGES;MASCULIN;APPRENTISSAGE;BAC PROFESSIONNEL;BAC PRO PROD;BAC PRO 23407 TECHNIC.FAB.BOIS ET MATERX ASSOC;1;1;1;0;0;0;0;1;0;0;1;0;0;0
3529.0;2021;22;LIMOGES;MASCULIN;APPRENTISSAGE;BAC PROFESSIONNEL;BAC PRO PROD;BAC PRO 25509 TECHNIC. FROID CONDITIONNEMT AIR;2;2;1;1;0;0;0;1;0;0;1;0;0;1
3533.0;2021;22;LIMOGES;MASCULIN;APPRENTISSAGE;BAC PROFESSIONNEL;BAC PRO SERV;BAC PRO 30001 GESTION-ADMINISTRATION;1;1;1;0;0;0;0;1;0;0;0;0;1;0
3537.0;2021;22;LIMOGES;MASCULIN;ENSEIGNEMENT A DISTANCE;BAC GENERAL;BAC GENERAL;BAC GENE 10019 BAC GENERAL;3;2;2;0;0;0;0;2;0;1;0;1;0;0
3539.0;2021;22;LIMOGES;MASCULIN;FORMATION CONTINUE;BAC PROFESSIONNEL;BAC PRO PROD;BAC PRO 23102 TRAVAUX PUBLICS;65;65;65;0;0;0;0;65;0;5;32;24;4;0
3543.0;2021;22;LIMOGES;MASCULIN;INDIVIDUEL;BAC GENERAL;BAC GENERAL;BAC GENE 10019 BAC GENERAL;11;7;1;4;2;2;0;3;0;0;0;1;2;4
3549.0;2021;22;LIMOGES;MASCULIN;INDIVIDUEL;BAC PROFESSIONNEL;BAC PRO SERV;BAC PRO 30001 GESTION-ADMINISTRATION;3;2;1;1;0;0;0;1;0;0;0;0;1;1
3552.0;2021;22;LIMOGES;MASCULIN;INDIVIDUEL;BAC TECHNOLOGIQUE;BAC STHR;BAC STHR SC.&TEC. HOTELLERIE-RESTAURATION;1;1;1;0;0;0;0;1;0;0;0;0;1;0
3559.0;2021;22;LIMOGES;MASCULIN;SCOLAIRE;BAC PROFESSIONNEL;BAC PRO PROD;BAC PRO 22104 BOUCHER CHARCUTIER TRAITEUR;13;13;10;3;0;0;0;10;0;0;0;2;8;3
3565.0;2021;22;LIMOGES;MASCULIN;SCOLAIRE;BAC PROFESSIONNEL;BAC PRO PROD;BAC PRO 23102 TRAVAUX PUBLICS;106;106;104;1;1;1;0;105;0;18;48;33;6;1
3567.0;2021;22;LIMOGES;MASCULIN;SCOLAIRE;BAC PROFESSIONNEL;BAC PRO PROD;BAC PRO 23304 AMENAGEMENT FINITION BATIMENT;6;6;5;1;0;0;0;5;0;0;0;5;0;1
3569.0;2021;22;LIMOGES;MASCULIN;SCOLAIRE;BAC PROFESSIONNEL;BAC PRO PROD;BAC PRO 23405 TECHNICIEN MENUISIER AGENCEUR;16;16;11;2;3;1;2;12;0;0;3;4;5;4
3576.0;2021;22;LIMOGES;MASCULIN;SCOLAIRE;BAC PROFESSIONNEL;BAC PRO PROD;BAC PRO 25108 TECHNICIEN MODELEUR;11;10;9;1;0;0;0;9;0;0;3;5;1;1
3577.0;2021;22;LIMOGES;MASCULIN;SCOLAIRE;BAC PROFESSIONNEL;BAC PRO PROD;BAC PRO 25214 MAINT.VEHIC.OPTA VOIT.PARTICUL.;36;36;30;5;1;1;0;31;0;1;10;10;10;5
3578.0;2021;22;LIMOGES;MASCULIN;SCOLAIRE;BAC PROFESSIONNEL;BAC PRO PROD;BAC PRO 25215 MAINT.VEHIC.OPTB VEHIC.TRANS.ROUT;5;5;3;2;0;0;0;3;0;0;1;1;1;2
3582.0;2021;22;LIMOGES;MASCULIN;SCOLAIRE;BAC PROFESSIONNEL;BAC PRO PROD;BAC PRO 25221 MAINT.MATERIELS OPT.C ESP. VERTS;4;4;3;1;0;0;0;3;0;0;0;1;2;1
3585.0;2021;22;LIMOGES;MASCULIN;SCOLAIRE;BAC PROFESSIONNEL;BAC PRO PROD;BAC PRO 25411 TECH.CHAUDRONNERIE INDUSTRIELLE;26;26;22;3;1;1;0;23;0;6;4;6;7;3
3595.0;2021;22;LIMOGES;MASCULIN;SCOLAIRE;BAC PROFESSIONNEL;BAC PRO PROD;BAC PRO AG 21211 COND GEST ENTR HIPPIQUE;1;1;1;0;0;0;0;1;0;0;0;0;1;0
3597.0;2021;22;LIMOGES;MASCULIN;SCOLAIRE;BAC PROFESSIONNEL;BAC PRO PROD;BAC PRO AG 21303 FORET;21;21;18;3;0;0;0;18;0;0;3;8;7;3
3601.0;2021;22;LIMOGES;MASCULIN;SCOLAIRE;BAC PROFESSIONNEL;BAC PRO SERV;BAC PRO 30001 GESTION-ADMINISTRATION;58;58;38;18;2;1;1;39;0;0;6;13;20;19
3605.0;2021;22;LIMOGES;MASCULIN;SCOLAIRE;BAC PROFESSIONNEL;BAC PRO SERV;BAC PRO 31202 COMMERCE;70;70;64;4;2;2;0;66;0;4;21;19;22;4
3607.0;2021;22;LIMOGES;MASCULIN;SCOLAIRE;BAC PROFESSIONNEL;BAC PRO SERV;BAC PRO 31210 ACCUEIL -RELATION CLIENTS USAGERS;3;3;1;0;2;1;1;2;0;0;0;1;1;1
3609.0;2021;22;LIMOGES;MASCULIN;SCOLAIRE;BAC PROFESSIONNEL;BAC PRO SERV;BAC PRO 32208 REAL.PR.IMPR.PLURI.OPTB.PR.IMPR.;8;8;8;0;0;0;0;8;0;3;3;1;1;0
3613.0;2021;22;LIMOGES;MASCULIN;SCOLAIRE;BAC PROFESSIONNEL;BAC PRO SERV;BAC PRO 33004 ACC.SOINS-S.PERS. OPT.EN STRUCTUR;9;9;7;1;1;0;1;7;0;0;3;2;2;2
3622.0;2021;22;LIMOGES;MASCULIN;SCOLAIRE;BAC TECHNOLOGIQUE;BAC STHR;BAC STHR SC.&TEC. HOTELLERIE-RESTAURATION;7;7;7;0;0;0;0;7;0;0;2;2;3;0
3631.0;2021;22;LIMOGES;MASCULIN;SCOLAIRE;BAC TECHNOLOGIQUE;BAC STMG;BAC STMG RESSOURCES HUMAINES ET COMMUNICATION;49;49;39;1;9;6;3;45;0;0;2;13;30;4
3632.0;2021;22;LIMOGES;MASCULIN;SCOLAIRE;BAC TECHNOLOGIQUE;BAC STMG;BAC STMG SYSTEMES D'INFORMATION DE GESTION;25;25;24;0;1;1;0;25;0;0;2;10;13;0
3633.0;2021;10;LYON;FEMININ;APPRENTISSAGE;BAC PROFESSIONNEL;BAC PRO PROD;BAC PRO 20102 PILOTE DE LIGNE DE PRODUCTION;1;1;1;0;0;0;0;1;0;0;1;0;0;0
3637.0;2021;10;LYON;FEMININ;APPRENTISSAGE;BAC PROFESSIONNEL;BAC PRO PROD;BAC PRO 22106 CUISINE;2;2;2;0;0;0;0;2;0;0;1;0;1;0
3638.0;2021;10;LYON;FEMININ;APPRENTISSAGE;BAC PROFESSIONNEL;BAC PRO PROD;BAC PRO 22403 ARTS.& MET.ART:MET.ENSEIGN SIGNA;1;1;1;0;0;0;0;1;0;0;1;0;0;0
3647.0;2021;10;LYON;FEMININ;APPRENTISSAGE;BAC PROFESSIONNEL;BAC PRO PROD;BAC PRO 25219 MAINT.MATERIELS OPT.A AGRICOLES;1;1;1;0;0;0;0;1;0;0;1;0;0;0
3655.0;2021;10;LYON;FEMININ;APPRENTISSAGE;BAC PROFESSIONNEL;BAC PRO PROD;BAC PRO AG 21210 COND GEST ENTR CANIN ET FELIN;5;5;4;1;0;0;0;4;0;0;2;2;0;1
3656.0;2021;10;LYON;FEMININ;APPRENTISSAGE;BAC PROFESSIONNEL;BAC PRO PROD;BAC PRO AG 21211 COND GEST ENTR HIPPIQUE;3;2;1;1;0;0;0;1;0;0;0;0;1;1
3659.0;2021;10;LYON;FEMININ;APPRENTISSAGE;BAC PROFESSIONNEL;BAC PRO PROD;BAC PRO AG 22107 TEC CONS VTE ALIMENTATION P.ALIM;1;1;1;0;0;0;0;1;0;1;0;0;0;0
3663.0;2021;10;LYON;FEMININ;APPRENTISSAGE;BAC PROFESSIONNEL;BAC PRO SERV;BAC PRO 31206 VENTE (PROSPECT.NEGO.SUIV.CLIENT;3;3;2;1;0;0;0;2;0;1;0;0;1;1
3666.0;2021;10;LYON;FEMININ;APPRENTISSAGE;BAC PROFESSIONNEL;BAC PRO SERV;BAC PRO 32303 ART.& MET.ART:COM.VIS.VIS.PLURI-M;3;3;3;0;0;0;0;3;0;0;1;0;2;0
3669.0;2021;10;LYON;FEMININ;APPRENTISSAGE;BAC PROFESSIONNEL;BAC PRO SERV;BAC PRO 34304 HYGIENE PROPRETE STERILISATION;10;9;8;1;0;0;0;8;0;1;1;2;4;1
3680.0;2021;10;LYON;FEMININ;FORMATION CONTINUE;BAC PROFESSIONNEL;BAC PRO SERV;BAC PRO 31202 COMMERCE;24;24;19;2;3;1;2;20;0;1;3;8;8;4
3682.0;2021;10;LYON;FEMININ;FORMATION CONTINUE;BAC PROFESSIONNEL;BAC PRO SERV;BAC PRO 33102 PROTHESE DENTAIRE;9;9;5;4;0;0;0;5;0;0;1;0;4;4
3686.0;2021;10;LYON;FEMININ;INDIVIDUEL;BAC PROFESSIONNEL;BAC PRO PROD;BAC PRO AG 21210 COND GEST ENTR CANIN ET FELIN;1;0;0;0;0;0;0;0;0;0;0;0;0;0
3689.0;2021;10;LYON;FEMININ;INDIVIDUEL;BAC PROFESSIONNEL;BAC PRO SERV;BAC PRO 31202 COMMERCE;8;6;2;2;2;1;1;3;0;0;1;0;2;3
3696.0;2021;10;LYON;FEMININ;INDIVIDUEL;BAC PROFESSIONNEL;BAC PRO SERV;BAC PRO 33603 ESTHETIQUE COSMETIQUE PARFUMERIE;2;2;2;0;0;0;0;2;0;0;0;1;1;0
3698.0;2021;10;LYON;FEMININ;INDIVIDUEL;BAC TECHNOLOGIQUE;BAC S2TMD;BAC S2TMD DANSE;1;1;1;0;0;0;0;1;0;0;0;1;0;0
3700.0;2021;10;LYON;FEMININ;INDIVIDUEL;BAC TECHNOLOGIQUE;BAC STD2A;BAC STD2A SCIENCES & TECHNO. DESIGN-ARTS APPLIQUES;11;10;7;0;3;2;1;9;0;0;0;5;4;1
3702.0;2021;10;LYON;FEMININ;INDIVIDUEL;BAC TECHNOLOGIQUE;BAC STL;BAC STL BIOCHIM.-BIOLOGIE-BIOTECHNOL.;2;0;0;0;0;0;0;0;0;0;0;0;0;0
3704.0;2021;10;LYON;FEMININ;INDIVIDUEL;BAC TECHNOLOGIQUE;BAC STMG;BAC STMG GESTION ET FINANCE;7;7;2;4;1;1;0;3;0;0;0;0;3;4
3706.0;2021;10;LYON;FEMININ;INDIVIDUEL;BAC TECHNOLOGIQUE;BAC STMG;BAC STMG RESSOURCES HUMAINES ET COMMUNICATION;10;6;2;1;3;0;3;2;0;0;0;0;2;4
3708.0;2021;10;LYON;FEMININ;SCOLAIRE;BAC PROFESSIONNEL;BAC PRO PROD;BAC PRO 22003 BIO-INDUSTRIES DE TRANSFORMATION;17;17;15;2;0;0;0;15;0;0;3;3;9;2
3709.0;2021;10;LYON;FEMININ;SCOLAIRE;BAC PROFESSIONNEL;BAC PRO PROD;BAC PRO 22004 PROC. CHIMIE EAU PAPIERS-CARTONS;6;6;2;3;1;1;0;3;0;0;0;0;3;3
3714.0;2021;10;LYON;FEMININ;SCOLAIRE;BAC PROFESSIONNEL;BAC PRO PROD;BAC PRO 23004 TECHN. ETUDES BAT.A ETUDES & ECO.;5;5;2;1;2;1;1;3;0;0;0;0;3;2
3715.0;2021;10;LYON;FEMININ;SCOLAIRE;BAC PROFESSIONNEL;BAC PRO PROD;BAC PRO 23005 TECHN. ETUDES BAT B ASSIST.ARCHI.;17;17;16;1;0;0;0;16;0;1;9;5;1;1
3716.0;2021;10;LYON;FEMININ;SCOLAIRE;BAC PROFESSIONNEL;BAC PRO PROD;BACPRO 23103 TECHNICIEN GEOMETRE-TOPOGRAPHE;1;1;1;0;0;0;0;1;0;0;1;0;0;0
3725.0;2021;10;LYON;FEMININ;SCOLAIRE;BAC PROFESSIONNEL;BAC PRO PROD;BAC PRO 25006 MICROTECHNIQUES;1;1;0;1;0;0;0;0;0;0;0;0;0;1
3733.0;2021;10;LYON;FEMININ;SCOLAIRE;BAC PROFESSIONNEL;BAC PRO PROD;BAC PRO 25408 REPARATION DES CARROSSERIES;1;1;1;0;0;0;0;1;0;0;0;1;0;0
3741.0;2021;10;LYON;FEMININ;SCOLAIRE;BAC PROFESSIONNEL;BAC PRO PROD;BAC PRO AG 21210 COND GEST ENTR CANIN ET FELIN;21;21;18;3;0;0;0;18;0;1;2;9;6;3
3743.0;2021;10;LYON;FEMININ;SCOLAIRE;BAC PROFESSIONNEL;BAC PRO PROD;BAC PRO AG 21212 TECH EXPE ANIMALE;18;18;16;2;0;0;0;16;0;0;1;10;5;2
3744.0;2021;10;LYON;FEMININ;SCOLAIRE;BAC PROFESSIONNEL;BAC PRO PROD;BAC PRO AG 21302 GEST MILIEUX NATURELS FAUNE;11;11;10;1;0;0;0;10;0;1;0;7;2;1
3746.0;2021;10;LYON;FEMININ;SCOLAIRE;BAC PROFESSIONNEL;BAC PRO PROD;BAC PRO AG 21405 AMENAGEMENTS PAYSAGERS;14;14;14;0;0;0;0;14;0;0;0;6;8;0
3750.0;2021;10;LYON;FEMININ;SCOLAIRE;BAC PROFESSIONNEL;BAC PRO SERV;BAC PRO 30001 GESTION-ADMINISTRATION;818;815;669;89;57;21;36;690;0;17;130;266;277;125
3755.0;2021;10;LYON;FEMININ;SCOLAIRE;BAC PROFESSIONNEL;BAC PRO SERV;BAC PRO 31206 VENTE (PROSPECT.NEGO.SUIV.CLIENT;90;88;78;7;3;3;0;81;0;4;20;39;18;7
3758.0;2021;10;LYON;FEMININ;SCOLAIRE;BAC PROFESSIONNEL;BAC PRO SERV;BAC PRO 32208 REAL.PR.IMPR.PLURI.OPTB.PR.IMPR.;5;5;4;0;1;0;1;4;0;0;1;2;1;1
3766.0;2021;10;LYON;FEMININ;SCOLAIRE;BAC PROFESSIONNEL;BAC PRO SERV;BAC PRO 33403 COMMERC. SERVICES EN RESTAURATION;45;43;41;2;0;0;0;41;0;4;10;18;9;2
3781.0;2021;10;LYON;FEMININ;SCOLAIRE;BAC TECHNOLOGIQUE;BAC STI2D;BAC STI2D SYSTÈME D'INFORMATION  ET NUMERIQUE;23;23;22;0;1;1;0;23;0;1;4;11;7;0
3791.0;2021;10;LYON;MASCULIN;APPRENTISSAGE;BAC PROFESSIONNEL;BAC PRO PROD;BAC PRO 22105 BOULANGER-PÂTISSIER;2;2;2;0;0;0;0;2;0;0;0;1;1;0
3794.0;2021;10;LYON;MASCULIN;APPRENTISSAGE;BAC PROFESSIONNEL;BAC PRO PROD;BAC PRO 22503 PLASTIQUES ET COMPOSITES;6;6;6;0;0;0;0;6;0;0;3;2;1;0
3795.0;2021;10;LYON;MASCULIN;APPRENTISSAGE;BAC PROFESSIONNEL;BAC PRO PROD;BAC PRO 22703 TECHN.INSTALL.SYST.ENERG.CLIMATI;31;31;24;5;2;2;0;26;0;0;10;6;10;5
3797.0;2021;10;LYON;MASCULIN;APPRENTISSAGE;BAC PROFESSIONNEL;BAC PRO PROD;BAC PRO 22705 TECHNICIEN GAZ;12;12;10;2;0;0;0;10;0;3;6;1;0;2
3798.0;2021;10;LYON;MASCULIN;APPRENTISSAGE;BAC PROFESSIONNEL;BAC PRO PROD;BAC PRO 23102 TRAVAUX PUBLICS;30;30;29;1;0;0;0;29;0;0;8;15;6;1
3799.0;2021;10;LYON;MASCULIN;APPRENTISSAGE;BAC PROFESSIONNEL;BAC PRO PROD;BACPRO 23103 TECHNICIEN GEOMETRE-TOPOGRAPHE;11;10;5;5;0;0;0;5;0;0;1;3;1;5
3807.0;2021;10;LYON;MASCULIN;APPRENTISSAGE;BAC PROFESSIONNEL;BAC PRO PROD;BAC PRO 25007 MAINTENANCE EQUIPEMENTS INDUST.;61;61;56;4;1;1;0;57;0;7;18;18;14;4
3815.0;2021;10;LYON;MASCULIN;APPRENTISSAGE;BAC PROFESSIONNEL;BAC PRO PROD;BAC PRO 25221 MAINT.MATERIELS OPT.C ESP. VERTS;12;12;10;2;0;0;0;10;0;0;0;6;4;2
3817.0;2021;10;LYON;MASCULIN;APPRENTISSAGE;BAC PROFESSIONNEL;BAC PRO PROD;BAC PRO 25408 REPARATION DES CARROSSERIES;33;33;25;7;1;1;0;26;0;0;5;10;11;7
3820.0;2021;10;LYON;MASCULIN;APPRENTISSAGE;BAC PROFESSIONNEL;BAC PRO PROD;BAC PRO 25509 TECHNIC. FROID CONDITIONNEMT AIR;29;27;23;3;1;1;0;24;0;1;6;10;7;3
3824.0;2021;10;LYON;MASCULIN;APPRENTISSAGE;BAC PROFESSIONNEL;BAC PRO PROD;BAC PRO AG 21004 CGEA;31;30;28;2;0;0;0;28;0;0;3;10;15;2
3826.0;2021;10;LYON;MASCULIN;APPRENTISSAGE;BAC PROFESSIONNEL;BAC PRO PROD;BAC PRO AG 21114 CONDUITE PRODUCTIONS HORTICOLES;3;3;3;0;0;0;0;3;0;0;0;0;3;0
3833.0;2021;10;LYON;MASCULIN;APPRENTISSAGE;BAC PROFESSIONNEL;BAC PRO SERV;BAC PRO 31106 LOGISTIQUE;21;21;15;3;3;3;0;18;0;2;1;4;11;3
3843.0;2021;10;LYON;MASCULIN;ENSEIGNEMENT A DISTANCE;BAC GENERAL;BAC GENERAL;BAC GENE 10019 BAC GENERAL;22;21;21;0;0;0;0;21;0;1;10;5;5;0
3844.0;2021;10;LYON;MASCULIN;ENSEIGNEMENT A DISTANCE;BAC TECHNOLOGIQUE;BAC ST2S;BAC ST2S SCIENCES & TECHNO. SANTE & SOCIAL;2;2;2;0;0;0;0;2;0;0;0;0;2;0
3845.0;2021;10;LYON;MASCULIN;ENSEIGNEMENT A DISTANCE;BAC TECHNOLOGIQUE;BAC STMG;BAC STMG GESTION ET FINANCE;3;3;3;0;0;0;0;3;0;0;0;1;2;0
3850.0;2021;10;LYON;MASCULIN;FORMATION CONTINUE;BAC PROFESSIONNEL;BAC PRO PROD;BAC PRO 22704 TECHN. MAINT. SYST.ENERG.CLIMATI;16;16;15;1;0;0;0;15;0;4;5;2;4;1
3851.0;2021;10;LYON;MASCULIN;FORMATION CONTINUE;BAC PROFESSIONNEL;BAC PRO PROD;BAC PRO 22705 TECHNICIEN GAZ;3;3;3;0;0;0;0;3;0;2;0;1;0;0
3853.0;2021;10;LYON;MASCULIN;FORMATION CONTINUE;BAC PROFESSIONNEL;BAC PRO PROD;BAC PRO 24302 METIERS DU CUIR : MAROQUINERIE;1;1;0;1;0;0;0;0;0;0;0;0;0;1
3860.0;2021;10;LYON;MASCULIN;INDIVIDUEL;BAC GENERAL;BAC GENERAL;BAC GENE 10019 BAC GENERAL;167;102;53;24;25;15;10;68;0;3;8;19;38;34
3863.0;2021;10;LYON;MASCULIN;INDIVIDUEL;BAC PROFESSIONNEL;BAC PRO PROD;BAC PRO 22703 TECHN.INSTALL.SYST.ENERG.CLIMATI;2;1;0;1;0;0;0;0;0;0;0;0;0;1
3873.0;2021;10;LYON;MASCULIN;INDIVIDUEL;BAC PROFESSIONNEL;BAC PRO PROD;BAC PRO AG 21001 AGRO-EQUIPEMENT;1;0;0;0;0;0;0;0;0;0;0;0;0;0
3876.0;2021;10;LYON;MASCULIN;INDIVIDUEL;BAC PROFESSIONNEL;BAC PRO PROD;BAC PRO AG 21211 COND GEST ENTR HIPPIQUE;1;1;1;0;0;0;0;1;0;0;0;1;0;0
3881.0;2021;10;LYON;MASCULIN;INDIVIDUEL;BAC PROFESSIONNEL;BAC PRO SERV;BAC PRO 31106 LOGISTIQUE;1;1;1;0;0;0;0;1;0;0;0;0;1;0
3885.0;2021;10;LYON;MASCULIN;INDIVIDUEL;BAC PROFESSIONNEL;BAC PRO SERV;BAC PRO 31210 ACCUEIL -RELATION CLIENTS USAGERS;3;2;2;0;0;0;0;2;0;0;1;0;1;0
3890.0;2021;10;LYON;MASCULIN;INDIVIDUEL;BAC PROFESSIONNEL;BAC PRO SERV;BAC PRO 34403 METIERS DE LA SECURITE;1;0;0;0;0;0;0;0;0;0;0;0;0;0
3896.0;2021;10;LYON;MASCULIN;INDIVIDUEL;BAC TECHNOLOGIQUE;BAC STI2D;BAC STI2D ENERGIES  ET ENVIRONNEMENT;5;1;0;1;0;0;0;0;0;0;0;0;0;1
3900.0;2021;10;LYON;MASCULIN;INDIVIDUEL;BAC TECHNOLOGIQUE;BAC STL;BAC STL SCIENCES PHYSIQUES CHIMIQUES  EN LABORAT.;1;0;0;0;0;0;0;0;0;0;0;0;0;0
3902.0;2021;10;LYON;MASCULIN;INDIVIDUEL;BAC TECHNOLOGIQUE;BAC STMG;BAC STMG MERCATIQUE (MARKETING);27;17;9;2;6;5;1;14;0;0;0;2;12;3
3925.0;2021;10;LYON;MASCULIN;SCOLAIRE;BAC PROFESSIONNEL;BAC PRO PROD;BAC PRO 23404 TECHNICIEN CONSTRUCTEUR BOIS;26;26;21;2;3;1;2;22;0;0;5;5;12;4
3928.0;2021;10;LYON;MASCULIN;SCOLAIRE;BAC PROFESSIONNEL;BAC PRO PROD;BAC PRO 23407 TECHNIC.FAB.BOIS ET MATERX ASSOC;18;17;14;2;1;1;0;15;0;1;1;5;8;2
3930.0;2021;10;LYON;MASCULIN;SCOLAIRE;BAC PROFESSIONNEL;BAC PRO PROD;BAC PRO 24002 METIERS PRESSING BLANCHISSERIE;1;1;0;1;0;0;0;0;0;0;0;0;0;1
3936.0;2021;10;LYON;MASCULIN;SCOLAIRE;BAC PROFESSIONNEL;BAC PRO PROD;BAC PRO 25106 TECHNICIEN D'USINAGE;163;162;127;25;10;5;5;132;0;3;27;50;52;30
3943.0;2021;10;LYON;MASCULIN;SCOLAIRE;BAC PROFESSIONNEL;BAC PRO PROD;BAC PRO 25220 MAINT.MATERIELS OPT.B TP MANUT.;14;14;9;5;0;0;0;9;0;1;2;4;2;5
3952.0;2021;10;LYON;MASCULIN;SCOLAIRE;BAC PROFESSIONNEL;BAC PRO PROD;BAC PRO 25515 SYST.NUM.OPT.C RES.INF.SYST.COMM.;297;297;270;18;9;9;0;279;0;16;79;112;72;18
3957.0;2021;10;LYON;MASCULIN;SCOLAIRE;BAC PROFESSIONNEL;BAC PRO PROD;BAC PRO AG 21203 TECHN CONSEIL DE VENTE ANIMAL;26;26;25;1;0;0;0;25;0;1;5;6;13;1
3959.0;2021;10;LYON;MASCULIN;SCOLAIRE;BAC PROFESSIONNEL;BAC PRO PROD;BAC PRO AG 21210 COND GEST ENTR CANIN ET FELIN;20;20;14;6;0;0;0;14;0;0;1;4;9;6
3962.0;2021;10;LYON;MASCULIN;SCOLAIRE;BAC PROFESSIONNEL;BAC PRO PROD;BAC PRO AG 21302 GEST MILIEUX NATURELS FAUNE;39;39;38;1;0;0;0;38;0;2;7;14;15;1
3965.0;2021;10;LYON;MASCULIN;SCOLAIRE;BAC PROFESSIONNEL;BAC PRO PROD;BAC PRO AG 21406 TEC CONS VTE PROD DES JARDINS;4;3;3;0;0;0;0;3;0;0;2;0;1;0
3975.0;2021;10;LYON;MASCULIN;SCOLAIRE;BAC PROFESSIONNEL;BAC PRO SERV;BAC PRO 32207 REAL.PR.IMPR.PLURI.OPTA.PR.GRAPH.;28;28;27;1;0;0;0;27;0;3;5;14;5;1
3980.0;2021;10;LYON;MASCULIN;SCOLAIRE;BAC PROFESSIONNEL;BAC PRO SERV;BAC PRO 33003 ACC.SOINS-S.PERS. OPT.A DOMICILE;11;11;7;0;4;1;3;8;0;0;2;1;5;3
3985.0;2021;10;LYON;MASCULIN;SCOLAIRE;BAC PROFESSIONNEL;BAC PRO SERV;BAC PRO 33602 PERRUQUIER POSTICHEUR;2;2;2;0;0;0;0;2;0;1;0;1;0;0
3992.0;2021;10;LYON;MASCULIN;SCOLAIRE;BAC TECHNOLOGIQUE;BAC ST2S;BAC ST2S SCIENCES & TECHNO. SANTE & SOCIAL;157;155;124;12;19;14;5;138;0;2;11;43;82;17
4001.0;2021;10;LYON;MASCULIN;SCOLAIRE;BAC TECHNOLOGIQUE;BAC STL;BAC STL SCIENCES PHYSIQUES CHIMIQUES  EN LABORAT.;66;66;59;1;6;3;3;62;0;0;12;28;22;4
4007.0;2021;31;MARTINIQUE;FEMININ;APPRENTISSAGE;BAC PROFESSIONNEL;BAC PRO PROD;BAC PRO 22106 CUISINE;4;4;2;1;1;1;0;3;0;0;0;0;3;1
4008.0;2021;31;MARTINIQUE;FEMININ;APPRENTISSAGE;BAC PROFESSIONNEL;BAC PRO PROD;BAC PRO 25408 REPARATION DES CARROSSERIES;1;1;1;0;0;0;0;1;0;0;0;1;0;0
4010.0;2021;31;MARTINIQUE;FEMININ;APPRENTISSAGE;BAC PROFESSIONNEL;BAC PRO SERV;BAC PRO 31202 COMMERCE;4;4;3;1;0;0;0;3;0;0;2;1;0;1
4012.0;2021;31;MARTINIQUE;FEMININ;APPRENTISSAGE;BAC PROFESSIONNEL;BAC PRO SERV;BAC PRO 33403 COMMERC. SERVICES EN RESTAURATION;2;2;1;0;1;1;0;2;0;0;0;1;1;0
4017.0;2021;31;MARTINIQUE;FEMININ;INDIVIDUEL;BAC PROFESSIONNEL;BAC PRO SERV;BAC PRO 31202 COMMERCE;2;1;0;1;0;0;0;0;0;0;0;0;0;1
4020.0;2021;31;MARTINIQUE;FEMININ;INDIVIDUEL;BAC TECHNOLOGIQUE;BAC ST2S;BAC ST2S SCIENCES & TECHNO. SANTE & SOCIAL;7;5;1;3;1;1;0;2;0;0;0;0;2;3
4030.0;2021;31;MARTINIQUE;FEMININ;SCOLAIRE;BAC PROFESSIONNEL;BAC PRO PROD;BAC PRO 23005 TECHN. ETUDES BAT B ASSIST.ARCHI.;5;5;4;0;1;1;0;5;0;0;0;1;4;0
4038.0;2021;31;MARTINIQUE;FEMININ;SCOLAIRE;BAC PROFESSIONNEL;BAC PRO PROD;BAC PRO 25106 TECHNICIEN D'USINAGE;1;1;1;0;0;0;0;1;0;0;0;1;0;0
4045.0;2021;31;MARTINIQUE;FEMININ;SCOLAIRE;BAC PROFESSIONNEL;BAC PRO PROD;BAC PRO AG 21114 CONDUITE PRODUCTIONS HORTICOLES;2;2;2;0;0;0;0;2;0;0;0;0;2;0
4051.0;2021;31;MARTINIQUE;FEMININ;SCOLAIRE;BAC PROFESSIONNEL;BAC PRO SERV;BAC PRO 31202 COMMERCE;51;51;39;8;4;3;1;42;0;1;6;22;13;9
4052.0;2021;31;MARTINIQUE;FEMININ;SCOLAIRE;BAC PROFESSIONNEL;BAC PRO SERV;BAC PRO 31206 VENTE (PROSPECT.NEGO.SUIV.CLIENT;29;29;22;5;2;1;1;23;0;2;3;6;12;6
4058.0;2021;31;MARTINIQUE;FEMININ;SCOLAIRE;BAC PROFESSIONNEL;BAC PRO SERV;BAC PRO 33403 COMMERC. SERVICES EN RESTAURATION;16;15;14;1;0;0;0;14;0;0;6;6;2;1
4062.0;2021;31;MARTINIQUE;FEMININ;SCOLAIRE;BAC PROFESSIONNEL;BAC PRO SERV;BAC PRO AG 33002 SERV PERS TERRIT;46;45;42;3;0;0;0;42;0;0;4;10;28;3
4065.0;2021;31;MARTINIQUE;FEMININ;SCOLAIRE;BAC TECHNOLOGIQUE;BAC STD2A;BAC STD2A SCIENCES & TECHNO. DESIGN-ARTS APPLIQUES;21;21;21;0;0;0;0;21;0;0;5;7;9;0
4066.0;2021;31;MARTINIQUE;FEMININ;SCOLAIRE;BAC TECHNOLOGIQUE;BAC STHR;BAC STHR SC.&TEC. HOTELLERIE-RESTAURATION;10;10;9;0;1;0;1;9;0;0;1;3;5;1
4072.0;2021;31;MARTINIQUE;FEMININ;SCOLAIRE;BAC TECHNOLOGIQUE;BAC STMG;BAC STMG GESTION ET FINANCE;58;58;55;0;3;3;0;58;0;2;10;16;30;0
4082.0;2021;31;MARTINIQUE;MASCULIN;APPRENTISSAGE;BAC PROFESSIONNEL;BAC PRO PROD;BAC PRO 23404 TECHNICIEN CONSTRUCTEUR BOIS;2;1;0;1;0;0;0;0;0;0;0;0;0;1
4085.0;2021;31;MARTINIQUE;MASCULIN;APPRENTISSAGE;BAC PROFESSIONNEL;BAC PRO PROD;BAC PRO 25408 REPARATION DES CARROSSERIES;3;3;2;1;0;0;0;2;0;0;0;0;2;1
4090.0;2021;31;MARTINIQUE;MASCULIN;ENSEIGNEMENT A DISTANCE;BAC GENERAL;BAC GENERAL;BAC GENE 10019 BAC GENERAL;3;3;3;0;0;0;0;3;0;1;1;1;0;0
4091.0;2021;31;MARTINIQUE;MASCULIN;ENSEIGNEMENT A DISTANCE;BAC PROFESSIONNEL;BAC PRO SERV;BAC PRO 30001 GESTION-ADMINISTRATION;1;1;1;0;0;0;0;1;0;0;0;0;1;0
4099.0;2021;31;MARTINIQUE;MASCULIN;INDIVIDUEL;BAC PROFESSIONNEL;BAC PRO PROD;BAC PRO 25510 METIERS ELECT. ENVIRON. CONNECTES;1;0;0;0;0;0;0;0;0;0;0;0;0;0
4105.0;2021;31;MARTINIQUE;MASCULIN;INDIVIDUEL;BAC TECHNOLOGIQUE;BAC STI2D;BAC STI2D ENERGIES  ET ENVIRONNEMENT;1;1;0;1;0;0;0;0;0;0;0;0;0;1
4107.0;2021;31;MARTINIQUE;MASCULIN;INDIVIDUEL;BAC TECHNOLOGIQUE;BAC STMG;BAC STMG GESTION ET FINANCE;2;1;0;0;1;1;0;1;0;0;0;0;1;0
4109.0;2021;31;MARTINIQUE;MASCULIN;SCOLAIRE;BAC PROFESSIONNEL;BAC PRO PROD;BAC PRO 22003 BIO-INDUSTRIES DE TRANSFORMATION;15;15;11;1;3;3;0;14;0;0;0;3;11;1
4115.0;2021;31;MARTINIQUE;MASCULIN;SCOLAIRE;BAC PROFESSIONNEL;BAC PRO PROD;BAC PRO 23003 ARTIS. & M.ART:MARCHANDISAGE VIS.;8;8;7;1;0;0;0;7;0;0;0;5;2;1
4116.0;2021;31;MARTINIQUE;MASCULIN;SCOLAIRE;BAC PROFESSIONNEL;BAC PRO PROD;BAC PRO 23004 TECHN. ETUDES BAT.A ETUDES & ECO.;1;1;1;0;0;0;0;1;0;0;0;1;0;0
4121.0;2021;31;MARTINIQUE;MASCULIN;SCOLAIRE;BAC PROFESSIONNEL;BAC PRO PROD;BAC PRO 23303 MENUISERIE ALUMINIUM-VERRE;13;13;11;0;2;2;0;13;0;0;0;5;8;0
4122.0;2021;31;MARTINIQUE;MASCULIN;SCOLAIRE;BAC PROFESSIONNEL;BAC PRO PROD;BAC PRO 23304 AMENAGEMENT FINITION BATIMENT;6;6;5;1;0;0;0;5;0;0;0;2;3;1
4126.0;2021;31;MARTINIQUE;MASCULIN;SCOLAIRE;BAC PROFESSIONNEL;BAC PRO PROD;BAC PRO 24203 METIERS DE LA MODE - VÊTEMENT;1;1;1;0;0;0;0;1;0;0;0;0;1;0
4128.0;2021;31;MARTINIQUE;MASCULIN;SCOLAIRE;BAC PROFESSIONNEL;BAC PRO PROD;BAC PRO 25009 MAINTENANCE NAUTIQUE;21;21;19;1;1;0;1;19;0;0;3;6;10;2
4135.0;2021;31;MARTINIQUE;MASCULIN;SCOLAIRE;BAC PROFESSIONNEL;BAC PRO PROD;BAC PRO 25411 TECH.CHAUDRONNERIE INDUSTRIELLE;8;8;6;2;0;0;0;6;0;0;0;2;4;2
4139.0;2021;31;MARTINIQUE;MASCULIN;SCOLAIRE;BAC PROFESSIONNEL;BAC PRO PROD;BAC PRO 25514 SYST.NUM.OPT.B AUD.RES.EQUIP.DOM.;29;29;26;1;2;2;0;28;0;0;6;15;7;1
4140.0;2021;31;MARTINIQUE;MASCULIN;SCOLAIRE;BAC PROFESSIONNEL;BAC PRO PROD;BAC PRO 25515 SYST.NUM.OPT.C RES.INF.SYST.COMM.;18;18;16;2;0;0;0;16;0;0;6;7;3;2
4143.0;2021;31;MARTINIQUE;MASCULIN;SCOLAIRE;BAC PROFESSIONNEL;BAC PRO PROD;BAC PRO AG 21114 CONDUITE PRODUCTIONS HORTICOLES;3;3;3;0;0;0;0;3;0;0;1;0;2;0
4146.0;2021;31;MARTINIQUE;MASCULIN;SCOLAIRE;BAC PROFESSIONNEL;BAC PRO SERV;BAC PRO 30001 GESTION-ADMINISTRATION;29;29;15;10;4;3;1;18;0;0;1;5;12;11
4151.0;2021;31;MARTINIQUE;MASCULIN;SCOLAIRE;BAC PROFESSIONNEL;BAC PRO SERV;BAC PRO 31210 ACCUEIL -RELATION CLIENTS USAGERS;10;10;10;0;0;0;0;10;0;1;1;4;4;0
4152.0;2021;31;MARTINIQUE;MASCULIN;SCOLAIRE;BAC PROFESSIONNEL;BAC PRO SERV;BAC PRO 32303 ART.& MET.ART:COM.VIS.VIS.PLURI-M;7;7;6;1;0;0;0;6;0;0;2;4;0;1
4154.0;2021;31;MARTINIQUE;MASCULIN;SCOLAIRE;BAC PROFESSIONNEL;BAC PRO SERV;BAC PRO 33003 ACC.SOINS-S.PERS. OPT.A DOMICILE;5;5;5;0;0;0;0;5;0;0;1;3;1;0
4158.0;2021;31;MARTINIQUE;MASCULIN;SCOLAIRE;BAC PROFESSIONNEL;BAC PRO SERV;BAC PRO 34304 HYGIENE PROPRETE STERILISATION;7;7;6;0;1;1;0;7;0;0;0;4;3;0
4161.0;2021;31;MARTINIQUE;MASCULIN;SCOLAIRE;BAC TECHNOLOGIQUE;BAC STAV;BAC STAV AGRONOMIE ALIM ENV TERRITOI;6;6;5;1;0;0;0;5;0;0;0;2;3;1
4164.0;2021;31;MARTINIQUE;MASCULIN;SCOLAIRE;BAC TECHNOLOGIQUE;BAC STI2D;BAC STI2D ARCHITECTURE ET CONSTRUCTION;26;26;23;1;2;0;2;23;0;0;2;8;13;3
4165.0;2021;31;MARTINIQUE;MASCULIN;SCOLAIRE;BAC TECHNOLOGIQUE;BAC STI2D;BAC STI2D ENERGIES  ET ENVIRONNEMENT;19;19;15;1;3;2;1;17;0;0;0;7;10;2
4166.0;2021;31;MARTINIQUE;MASCULIN;SCOLAIRE;BAC TECHNOLOGIQUE;BAC STI2D;BAC STI2D INNOVATION TECHNO.  ET ECO CONCEPTION;26;26;23;0;3;2;1;25;0;0;2;12;11;1
4167.0;2021;31;MARTINIQUE;MASCULIN;SCOLAIRE;BAC TECHNOLOGIQUE;BAC STI2D;BAC STI2D SYSTÈME D'INFORMATION  ET NUMERIQUE;40;40;36;1;3;3;0;39;0;0;3;16;20;1
4168.0;2021;31;MARTINIQUE;MASCULIN;SCOLAIRE;BAC TECHNOLOGIQUE;BAC STL;BAC STL BIOCHIM.-BIOLOGIE-BIOTECHNOL.;15;15;15;0;0;0;0;15;0;0;3;5;7;0
4169.0;2021;31;MARTINIQUE;MASCULIN;SCOLAIRE;BAC TECHNOLOGIQUE;BAC STMG;BAC STMG GESTION ET FINANCE;81;81;65;4;12;11;1;76;0;0;4;29;43;5
4173.0;2021;43;MAYOTTE;FEMININ;APPRENTISSAGE;BAC PROFESSIONNEL;BAC PRO PROD;BAC PRO 25215 MAINT.VEHIC.OPTB VEHIC.TRANS.ROUT;1;1;1;0;0;0;0;1;0;0;0;0;1;0
4179.0;2021;43;MAYOTTE;FEMININ;INDIVIDUEL;BAC PROFESSIONNEL;BAC PRO SERV;BAC PRO 31206 VENTE (PROSPECT.NEGO.SUIV.CLIENT;2;2;1;0;1;1;0;2;0;0;0;0;2;0
4182.0;2021;43;MAYOTTE;FEMININ;INDIVIDUEL;BAC TECHNOLOGIQUE;BAC ST2S;BAC ST2S SCIENCES & TECHNO. SANTE & SOCIAL;2;2;0;2;0;0;0;0;0;0;0;0;0;2
4183.0;2021;43;MAYOTTE;FEMININ;INDIVIDUEL;BAC TECHNOLOGIQUE;BAC STHR;BAC STHR SC.&TEC. HOTELLERIE-RESTAURATION;2;2;0;2;0;0;0;0;0;0;0;0;0;2
4184.0;2021;43;MAYOTTE;FEMININ;INDIVIDUEL;BAC TECHNOLOGIQUE;BAC STI2D;BAC STI2D INNOVATION TECHNO.  ET ECO CONCEPTION;1;1;0;1;0;0;0;0;0;0;0;0;0;1
4186.0;2021;43;MAYOTTE;FEMININ;INDIVIDUEL;BAC TECHNOLOGIQUE;BAC STMG;BAC STMG MERCATIQUE (MARKETING);9;8;0;8;0;0;0;0;0;0;0;0;0;8
4187.0;2021;43;MAYOTTE;FEMININ;INDIVIDUEL;BAC TECHNOLOGIQUE;BAC STMG;BAC STMG RESSOURCES HUMAINES ET COMMUNICATION;12;9;0;8;1;1;0;1;0;0;0;0;1;8
4191.0;2021;43;MAYOTTE;FEMININ;SCOLAIRE;BAC PROFESSIONNEL;BAC PRO PROD;BAC PRO 23004 TECHN. ETUDES BAT.A ETUDES & ECO.;3;3;1;0;2;2;0;3;0;0;1;0;2;0
4196.0;2021;43;MAYOTTE;FEMININ;SCOLAIRE;BAC PROFESSIONNEL;BAC PRO PROD;BAC PRO 25515 SYST.NUM.OPT.C RES.INF.SYST.COMM.;2;2;2;0;0;0;0;2;0;0;1;0;1;0
4202.0;2021;43;MAYOTTE;FEMININ;SCOLAIRE;BAC PROFESSIONNEL;BAC PRO SERV;BAC PRO 31206 VENTE (PROSPECT.NEGO.SUIV.CLIENT;34;34;18;10;6;6;0;24;0;0;2;7;15;10
4206.0;2021;43;MAYOTTE;FEMININ;SCOLAIRE;BAC PROFESSIONNEL;BAC PRO SERV;BAC PRO 33003 ACC.SOINS-S.PERS. OPT.A DOMICILE;61;61;32;9;20;16;4;48;0;0;3;11;34;13
4211.0;2021;43;MAYOTTE;FEMININ;SCOLAIRE;BAC TECHNOLOGIQUE;BAC ST2S;BAC ST2S SCIENCES & TECHNO. SANTE & SOCIAL;58;58;45;0;13;4;9;49;0;0;1;17;31;9
4217.0;2021;43;MAYOTTE;FEMININ;SCOLAIRE;BAC TECHNOLOGIQUE;BAC STI2D;BAC STI2D SYSTÈME D'INFORMATION  ET NUMERIQUE;16;16;13;0;3;2;1;15;0;0;2;4;9;1
4241.0;2021;43;MAYOTTE;MASCULIN;SCOLAIRE;BAC PROFESSIONNEL;BAC PRO PROD;BAC PRO 22106 CUISINE;5;5;4;1;0;0;0;4;0;0;0;2;2;1
4242.0;2021;43;MAYOTTE;MASCULIN;SCOLAIRE;BAC PROFESSIONNEL;BAC PRO PROD;BAC PRO 23004 TECHN. ETUDES BAT.A ETUDES & ECO.;27;27;16;3;8;7;1;23;0;0;0;1;22;4
4243.0;2021;43;MAYOTTE;MASCULIN;SCOLAIRE;BAC PROFESSIONNEL;BAC PRO PROD;BAC PRO 23005 TECHN. ETUDES BAT B ASSIST.ARCHI.;13;13;8;5;0;0;0;8;0;0;3;2;3;5
4244.0;2021;43;MAYOTTE;MASCULIN;SCOLAIRE;BAC PROFESSIONNEL;BAC PRO PROD;BAC PRO 23102 TRAVAUX PUBLICS;27;27;8;12;7;6;1;14;0;0;0;2;12;13
4248.0;2021;43;MAYOTTE;MASCULIN;SCOLAIRE;BAC PROFESSIONNEL;BAC PRO PROD;BAC PRO 23404 TECHNICIEN CONSTRUCTEUR BOIS;13;13;1;6;6;5;1;6;0;0;0;0;6;7
4251.0;2021;43;MAYOTTE;MASCULIN;SCOLAIRE;BAC PROFESSIONNEL;BAC PRO PROD;BAC PRO 25007 MAINTENANCE EQUIPEMENTS INDUST.;14;14;6;2;6;0;6;6;0;0;0;2;4;8
4254.0;2021;43;MAYOTTE;MASCULIN;SCOLAIRE;BAC PROFESSIONNEL;BAC PRO PROD;BAC PRO 25216 MAINT.VEHIC.OPTC MOTOCYCLES;9;9;6;2;1;1;0;7;0;0;1;1;5;2
4257.0;2021;43;MAYOTTE;MASCULIN;SCOLAIRE;BAC PROFESSIONNEL;BAC PRO PROD;BAC PRO 25510 METIERS ELECT. ENVIRON. CONNECTES;104;103;90;5;8;4;4;94;0;3;13;37;41;9
4263.0;2021;43;MAYOTTE;MASCULIN;SCOLAIRE;BAC PROFESSIONNEL;BAC PRO SERV;BAC PRO 30001 GESTION-ADMINISTRATION;68;68;41;16;11;6;5;47;0;1;7;9;30;21
4266.0;2021;43;MAYOTTE;MASCULIN;SCOLAIRE;BAC PROFESSIONNEL;BAC PRO SERV;BAC PRO 31202 COMMERCE;62;62;36;11;15;13;2;49;0;0;2;14;33;13
4269.0;2021;43;MAYOTTE;MASCULIN;SCOLAIRE;BAC PROFESSIONNEL;BAC PRO SERV;BAC PRO 32303 ART.& MET.ART:COM.VIS.VIS.PLURI-M;12;12;9;1;2;2;0;11;0;0;1;3;7;1
4274.0;2021;43;MAYOTTE;MASCULIN;SCOLAIRE;BAC PROFESSIONNEL;BAC PRO SERV;BAC PRO 34403 METIERS DE LA SECURITE;37;37;29;3;5;4;1;33;0;0;3;9;21;4
4281.0;2021;43;MAYOTTE;MASCULIN;SCOLAIRE;BAC TECHNOLOGIQUE;BAC STI2D;BAC STI2D INNOVATION TECHNO.  ET ECO CONCEPTION;25;25;12;3;10;8;2;20;0;0;1;2;17;5
4284.0;2021;43;MAYOTTE;MASCULIN;SCOLAIRE;BAC TECHNOLOGIQUE;BAC STMG;BAC STMG GESTION ET FINANCE;122;122;63;15;44;26;18;89;0;0;3;13;73;33
4304.0;2021;11;MONTPELLIER;FEMININ;APPRENTISSAGE;BAC PROFESSIONNEL;BAC PRO SERV;BAC PRO 33403 COMMERC. SERVICES EN RESTAURATION;8;8;6;2;0;0;0;6;0;0;0;2;4;2
4307.0;2021;11;MONTPELLIER;FEMININ;ENSEIGNEMENT A DISTANCE;BAC GENERAL;BAC GENERAL;BAC GENE 10019 BAC GENERAL;63;63;61;2;0;0;0;61;1;13;20;21;6;2
4311.0;2021;11;MONTPELLIER;FEMININ;ENSEIGNEMENT A DISTANCE;BAC PROFESSIONNEL;BAC PRO SERV;BAC PRO 33004 ACC.SOINS-S.PERS. OPT.EN STRUCTUR;5;4;3;1;0;0;0;3;0;0;0;0;3;1
4320.0;2021;11;MONTPELLIER;FEMININ;FORMATION CONTINUE;BAC PROFESSIONNEL;BAC PRO SERV;BAC PRO 31202 COMMERCE;14;13;12;1;0;0;0;12;0;4;3;3;2;1
4323.0;2021;11;MONTPELLIER;FEMININ;FORMATION CONTINUE;BAC PROFESSIONNEL;BAC PRO SERV;BAC PRO 33102 PROTHESE DENTAIRE;1;1;1;0;0;0;0;1;0;0;0;1;0;0
4324.0;2021;11;MONTPELLIER;FEMININ;FORMATION CONTINUE;BAC PROFESSIONNEL;BAC PRO SERV;BAC PRO 33603 ESTHETIQUE COSMETIQUE PARFUMERIE;1;1;1;0;0;0;0;1;0;0;0;1;0;0
4327.0;2021;11;MONTPELLIER;FEMININ;INDIVIDUEL;BAC PROFESSIONNEL;BAC PRO PROD;BAC PRO AG 21004 CGEA;3;2;2;0;0;0;0;2;0;0;0;0;2;0
4333.0;2021;11;MONTPELLIER;FEMININ;INDIVIDUEL;BAC PROFESSIONNEL;BAC PRO SERV;BAC PRO 31202 COMMERCE;6;1;1;0;0;0;0;1;0;0;0;0;1;0
4346.0;2021;11;MONTPELLIER;FEMININ;SCOLAIRE;BAC GENERAL;BAC GENERAL;BAC GENE 10019 BAC GENERAL;7990;7990;7785;51;154;72;82;7857;171;1088;2380;2775;1443;133
4354.0;2021;11;MONTPELLIER;FEMININ;SCOLAIRE;BAC PROFESSIONNEL;BAC PRO PROD;BAC PRO 23004 TECHN. ETUDES BAT.A ETUDES & ECO.;12;12;12;0;0;0;0;12;0;0;0;3;9;0
4368.0;2021;11;MONTPELLIER;FEMININ;SCOLAIRE;BAC PROFESSIONNEL;BAC PRO PROD;BAC PRO 25009 MAINTENANCE NAUTIQUE;1;1;1;0;0;0;0;1;0;0;1;0;0;0
4370.0;2021;11;MONTPELLIER;FEMININ;SCOLAIRE;BAC PROFESSIONNEL;BAC PRO PROD;BAC PRO 25214 MAINT.VEHIC.OPTA VOIT.PARTICUL.;7;7;7;0;0;0;0;7;0;1;0;3;3;0
4372.0;2021;11;MONTPELLIER;FEMININ;SCOLAIRE;BAC PROFESSIONNEL;BAC PRO PROD;BAC PRO 25220 MAINT.MATERIELS OPT.B TP MANUT.;1;1;1;0;0;0;0;1;0;0;0;0;1;0
4392.0;2021;11;MONTPELLIER;FEMININ;SCOLAIRE;BAC PROFESSIONNEL;BAC PRO SERV;BAC PRO 31106 LOGISTIQUE;6;6;5;1;0;0;0;5;0;0;0;1;4;1
4408.0;2021;11;MONTPELLIER;FEMININ;SCOLAIRE;BAC PROFESSIONNEL;BAC PRO SERV;BAC PRO 33603 ESTHETIQUE COSMETIQUE PARFUMERIE;153;152;138;10;4;1;3;139;0;5;28;51;55;13
4410.0;2021;11;MONTPELLIER;FEMININ;SCOLAIRE;BAC PROFESSIONNEL;BAC PRO SERV;BAC PRO 34403 METIERS DE LA SECURITE;43;43;41;1;1;1;0;42;0;3;12;16;11;1
4412.0;2021;11;MONTPELLIER;FEMININ;SCOLAIRE;BAC TECHNOLOGIQUE;BAC S2TMD;BAC S2TMD DANSE;2;2;2;0;0;0;0;2;0;0;2;0;0;0
4421.0;2021;11;MONTPELLIER;FEMININ;SCOLAIRE;BAC TECHNOLOGIQUE;BAC STI2D;BAC STI2D SYSTÈME D'INFORMATION  ET NUMERIQUE;9;9;8;1;0;0;0;8;0;0;1;5;2;1
4436.0;2021;11;MONTPELLIER;MASCULIN;APPRENTISSAGE;BAC PROFESSIONNEL;BAC PRO PROD;BAC PRO 25007 MAINTENANCE EQUIPEMENTS INDUST.;16;15;13;1;1;0;1;13;0;3;2;5;3;2
4437.0;2021;11;MONTPELLIER;MASCULIN;APPRENTISSAGE;BAC PROFESSIONNEL;BAC PRO PROD;BAC PRO 25009 MAINTENANCE NAUTIQUE;9;9;7;1;1;0;1;7;0;1;3;3;0;2
4450.0;2021;11;MONTPELLIER;MASCULIN;APPRENTISSAGE;BAC PROFESSIONNEL;BAC PRO PROD;BAC PRO AG 21004 CGEA;1;1;1;0;0;0;0;1;0;0;0;0;1;0
4454.0;2021;11;MONTPELLIER;MASCULIN;APPRENTISSAGE;BAC PROFESSIONNEL;BAC PRO PROD;BAC PRO AG 21211 COND GEST ENTR HIPPIQUE;4;3;3;0;0;0;0;3;0;1;0;2;0;0
4455.0;2021;11;MONTPELLIER;MASCULIN;APPRENTISSAGE;BAC PROFESSIONNEL;BAC PRO PROD;BAC PRO AG 21303 FORET;2;2;2;0;0;0;0;2;0;0;0;1;1;0
4456.0;2021;11;MONTPELLIER;MASCULIN;APPRENTISSAGE;BAC PROFESSIONNEL;BAC PRO PROD;BAC PRO AG 21405 AMENAGEMENTS PAYSAGERS;40;37;35;2;0;0;0;35;0;1;4;12;18;2
4464.0;2021;11;MONTPELLIER;MASCULIN;APPRENTISSAGE;BAC PROFESSIONNEL;BAC PRO SERV;BAC PRO AG 33002 SERV PERS TERRIT;3;3;3;0;0;0;0;3;0;0;1;2;0;0
4472.0;2021;11;MONTPELLIER;MASCULIN;ENSEIGNEMENT A DISTANCE;BAC TECHNOLOGIQUE;BAC STMG;BAC STMG MERCATIQUE (MARKETING);35;35;34;0;1;0;1;34;0;2;7;8;17;1
4478.0;2021;11;MONTPELLIER;MASCULIN;FORMATION CONTINUE;BAC PROFESSIONNEL;BAC PRO PROD;BAC PRO 25007 MAINTENANCE EQUIPEMENTS INDUST.;6;6;6;0;0;0;0;6;0;3;1;2;0;0
4490.0;2021;11;MONTPELLIER;MASCULIN;INDIVIDUEL;BAC PROFESSIONNEL;BAC PRO PROD;BAC PRO 22703 TECHN.INSTALL.SYST.ENERG.CLIMATI;2;1;1;0;0;0;0;1;0;0;0;0;1;0
4497.0;2021;11;MONTPELLIER;MASCULIN;INDIVIDUEL;BAC PROFESSIONNEL;BAC PRO PROD;BAC PRO 25509 TECHNIC. FROID CONDITIONNEMT AIR;2;2;0;2;0;0;0;0;0;0;0;0;0;2
4504.0;2021;11;MONTPELLIER;MASCULIN;INDIVIDUEL;BAC PROFESSIONNEL;BAC PRO SERV;BAC PRO 31206 VENTE (PROSPECT.NEGO.SUIV.CLIENT;2;0;0;0;0;0;0;0;0;0;0;0;0;0
4510.0;2021;11;MONTPELLIER;MASCULIN;INDIVIDUEL;BAC TECHNOLOGIQUE;BAC ST2S;BAC ST2S SCIENCES & TECHNO. SANTE & SOCIAL;4;1;1;0;0;0;0;1;0;0;0;0;1;0
4512.0;2021;11;MONTPELLIER;MASCULIN;INDIVIDUEL;BAC TECHNOLOGIQUE;BAC STI2D;BAC STI2D ARCHITECTURE ET CONSTRUCTION;1;0;0;0;0;0;0;0;0;0;0;0;0;0
4520.0;2021;11;MONTPELLIER;MASCULIN;SCOLAIRE;BAC GENERAL;BAC GENERAL;BAC GENE 10019 BAC GENERAL;6341;6341;5939;79;323;184;139;6123;92;625;1444;2143;1819;218
4522.0;2021;11;MONTPELLIER;MASCULIN;SCOLAIRE;BAC PROFESSIONNEL;BAC PRO PROD;BAC PRO 20102 PILOTE DE LIGNE DE PRODUCTION;10;8;6;0;2;1;1;7;0;0;0;2;5;1
4526.0;2021;11;MONTPELLIER;MASCULIN;SCOLAIRE;BAC PROFESSIONNEL;BAC PRO PROD;BAC PRO 22106 CUISINE;155;154;136;11;7;5;2;141;0;3;33;51;54;13
4528.0;2021;11;MONTPELLIER;MASCULIN;SCOLAIRE;BAC PROFESSIONNEL;BAC PRO PROD;BAC PRO 22503 PLASTIQUES ET COMPOSITES;24;24;20;2;2;0;2;20;0;1;3;8;8;4
4532.0;2021;11;MONTPELLIER;MASCULIN;SCOLAIRE;BAC PROFESSIONNEL;BAC PRO PROD;BAC PRO 23004 TECHN. ETUDES BAT.A ETUDES & ECO.;35;33;25;4;4;3;1;28;0;0;2;11;15;5
4533.0;2021;11;MONTPELLIER;MASCULIN;SCOLAIRE;BAC PROFESSIONNEL;BAC PRO PROD;BAC PRO 23005 TECHN. ETUDES BAT B ASSIST.ARCHI.;43;42;28;13;1;1;0;29;0;1;4;11;13;13
4535.0;2021;11;MONTPELLIER;MASCULIN;SCOLAIRE;BAC PROFESSIONNEL;BAC PRO PROD;BACPRO 23103 TECHNICIEN GEOMETRE-TOPOGRAPHE;24;24;20;3;1;1;0;21;0;0;3;7;11;3
4538.0;2021;11;MONTPELLIER;MASCULIN;SCOLAIRE;BAC PROFESSIONNEL;BAC PRO PROD;BAC PRO 23208 METIERS ET ARTS DE LA PIERRE;9;9;8;1;0;0;0;8;0;0;0;3;5;1
4543.0;2021;11;MONTPELLIER;MASCULIN;SCOLAIRE;BAC PROFESSIONNEL;BAC PRO PROD;BAC PRO 23408 Etude et réalisation d'agencement;2;2;2;0;0;0;0;2;0;0;2;0;0;0
4545.0;2021;11;MONTPELLIER;MASCULIN;SCOLAIRE;BAC PROFESSIONNEL;BAC PRO PROD;BAC PRO 24203 METIERS DE LA MODE - VÊTEMENT;6;6;3;3;0;0;0;3;0;0;0;2;1;3
4550.0;2021;11;MONTPELLIER;MASCULIN;SCOLAIRE;BAC PROFESSIONNEL;BAC PRO PROD;BAC PRO 25009 MAINTENANCE NAUTIQUE;40;40;31;7;2;2;0;33;0;1;2;14;16;7
4551.0;2021;11;MONTPELLIER;MASCULIN;SCOLAIRE;BAC PROFESSIONNEL;BAC PRO PROD;BAC PRO 25106 TECHNICIEN D'USINAGE;47;46;36;6;4;1;3;37;0;1;9;14;13;9
4563.0;2021;11;MONTPELLIER;MASCULIN;SCOLAIRE;BAC PROFESSIONNEL;BAC PRO PROD;BAC PRO 25510 METIERS ELECT. ENVIRON. CONNECTES;383;381;313;56;12;9;3;322;0;22;83;100;117;59
4564.0;2021;11;MONTPELLIER;MASCULIN;SCOLAIRE;BAC PROFESSIONNEL;BAC PRO PROD;BAC PRO 25513 SYST.NUM.OPT.A SURETE SECURITE;16;16;14;1;1;0;1;14;0;1;3;8;2;2
4569.0;2021;11;MONTPELLIER;MASCULIN;SCOLAIRE;BAC PROFESSIONNEL;BAC PRO PROD;BAC PRO AG 21113 CGEVV;43;43;40;3;0;0;0;40;0;0;2;8;30;3
4574.0;2021;11;MONTPELLIER;MASCULIN;SCOLAIRE;BAC PROFESSIONNEL;BAC PRO PROD;BAC PRO AG 21211 COND GEST ENTR HIPPIQUE;1;1;1;0;0;0;0;1;0;0;0;1;0;0
4575.0;2021;11;MONTPELLIER;MASCULIN;SCOLAIRE;BAC PROFESSIONNEL;BAC PRO PROD;BAC PRO AG 21302 GEST MILIEUX NATURELS FAUNE;24;23;23;0;0;0;0;23;0;1;1;11;10;0
4576.0;2021;11;MONTPELLIER;MASCULIN;SCOLAIRE;BAC PROFESSIONNEL;BAC PRO PROD;BAC PRO AG 21303 FORET;14;14;14;0;0;0;0;14;0;0;1;7;6;0
4577.0;2021;11;MONTPELLIER;MASCULIN;SCOLAIRE;BAC PROFESSIONNEL;BAC PRO PROD;BAC PRO AG 21405 AMENAGEMENTS PAYSAGERS;78;77;72;5;0;0;0;72;0;1;18;24;29;5
4578.0;2021;11;MONTPELLIER;MASCULIN;SCOLAIRE;BAC PROFESSIONNEL;BAC PRO PROD;BAC PRO AG 21406 TEC CONS VTE PROD DES JARDINS;6;6;6;0;0;0;0;6;0;1;0;3;2;0
4579.0;2021;11;MONTPELLIER;MASCULIN;SCOLAIRE;BAC PROFESSIONNEL;BAC PRO PROD;BAC PRO AG 22105 LABORATOIRE CONTROLE QUALITE;12;11;10;1;0;0;0;10;0;0;2;3;5;1
4581.0;2021;11;MONTPELLIER;MASCULIN;SCOLAIRE;BAC PROFESSIONNEL;BAC PRO SERV;BAC PRO 30001 GESTION-ADMINISTRATION;277;277;201;52;24;12;12;213;0;12;37;68;96;64
4582.0;2021;11;MONTPELLIER;MASCULIN;SCOLAIRE;BAC PROFESSIONNEL;BAC PRO SERV;BAC PRO 31106 LOGISTIQUE;117;117;79;24;14;10;4;89;0;7;17;32;33;28
4585.0;2021;11;MONTPELLIER;MASCULIN;SCOLAIRE;BAC PROFESSIONNEL;BAC PRO SERV;BAC PRO 31202 COMMERCE;475;473;392;39;42;35;7;427;0;16;101;130;180;46
4586.0;2021;11;MONTPELLIER;MASCULIN;SCOLAIRE;BAC PROFESSIONNEL;BAC PRO SERV;BAC PRO 31206 VENTE (PROSPECT.NEGO.SUIV.CLIENT;127;126;108;11;7;7;0;115;0;2;17;54;42;11
4592.0;2021;11;MONTPELLIER;MASCULIN;SCOLAIRE;BAC PROFESSIONNEL;BAC PRO SERV;BAC PRO 33002 SERVICES DE PROXIMITE  VIE LOCAL;27;27;24;0;3;1;2;25;0;2;6;12;5;2
4597.0;2021;11;MONTPELLIER;MASCULIN;SCOLAIRE;BAC PROFESSIONNEL;BAC PRO SERV;BAC PRO 33403 COMMERC. SERVICES EN RESTAURATION;79;78;59;11;8;3;5;62;0;1;12;23;26;16
4605.0;2021;11;MONTPELLIER;MASCULIN;SCOLAIRE;BAC TECHNOLOGIQUE;BAC STHR;BAC STHR SC.&TEC. HOTELLERIE-RESTAURATION;48;48;45;1;2;2;0;47;0;1;11;23;12;1
4610.0;2021;11;MONTPELLIER;MASCULIN;SCOLAIRE;BAC TECHNOLOGIQUE;BAC STL;BAC STL BIOCHIM.-BIOLOGIE-BIOTECHNOL.;73;73;65;1;7;4;3;69;0;1;9;28;31;4
4617.0;2021;12;NANCY-METZ;FEMININ;APPRENTISSAGE;BAC PROFESSIONNEL;BAC PRO PROD;BAC PRO 22503 PLASTIQUES ET COMPOSITES;1;1;1;0;0;0;0;1;0;0;0;0;1;0
4618.0;2021;12;NANCY-METZ;FEMININ;APPRENTISSAGE;BAC PROFESSIONNEL;BAC PRO PROD;BAC PRO 25007 MAINTENANCE EQUIPEMENTS INDUST.;2;2;2;0;0;0;0;2;0;0;0;0;2;0
4619.0;2021;12;NANCY-METZ;FEMININ;APPRENTISSAGE;BAC PROFESSIONNEL;BAC PRO PROD;BAC PRO 25106 TECHNICIEN D'USINAGE;1;1;1;0;0;0;0;1;0;0;0;1;0;0
4621.0;2021;12;NANCY-METZ;FEMININ;APPRENTISSAGE;BAC PROFESSIONNEL;BAC PRO PROD;BAC PRO 25214 MAINT.VEHIC.OPTA VOIT.PARTICUL.;2;2;2;0;0;0;0;2;0;2;0;0;0;0
4623.0;2021;12;NANCY-METZ;FEMININ;APPRENTISSAGE;BAC PROFESSIONNEL;BAC PRO PROD;BAC PRO 25303 AERONAUTIQUE OPTION SYSTEMES;2;2;2;0;0;0;0;2;0;2;0;0;0;0
4625.0;2021;12;NANCY-METZ;FEMININ;APPRENTISSAGE;BAC PROFESSIONNEL;BAC PRO PROD;BAC PRO 25411 TECH.CHAUDRONNERIE INDUSTRIELLE;1;1;1;0;0;0;0;1;0;0;1;0;0;0
4629.0;2021;12;NANCY-METZ;FEMININ;APPRENTISSAGE;BAC PROFESSIONNEL;BAC PRO PROD;BAC PRO AG 21211 COND GEST ENTR HIPPIQUE;9;8;8;0;0;0;0;8;0;0;1;1;6;0
4631.0;2021;12;NANCY-METZ;FEMININ;APPRENTISSAGE;BAC PROFESSIONNEL;BAC PRO PROD;BAC PRO AG 21405 AMENAGEMENTS PAYSAGERS;3;3;3;0;0;0;0;3;0;0;0;1;2;0
4633.0;2021;12;NANCY-METZ;FEMININ;APPRENTISSAGE;BAC PROFESSIONNEL;BAC PRO SERV;BAC PRO 30001 GESTION-ADMINISTRATION;23;23;21;1;1;1;0;22;0;3;5;9;5;1
4635.0;2021;12;NANCY-METZ;FEMININ;APPRENTISSAGE;BAC PROFESSIONNEL;BAC PRO SERV;BAC PRO 31202 COMMERCE;76;75;60;11;4;2;2;62;0;7;16;17;22;13
4636.0;2021;12;NANCY-METZ;FEMININ;APPRENTISSAGE;BAC PROFESSIONNEL;BAC PRO SERV;BAC PRO 31210 ACCUEIL -RELATION CLIENTS USAGERS;2;2;2;0;0;0;0;2;0;1;1;0;0;0
4638.0;2021;12;NANCY-METZ;FEMININ;ENSEIGNEMENT A DISTANCE;BAC GENERAL;BAC GENERAL;BAC GENE 10019 BAC GENERAL;26;22;20;1;1;0;1;20;0;1;8;9;2;2
4644.0;2021;12;NANCY-METZ;FEMININ;FORMATION CONTINUE;BAC PROFESSIONNEL;BAC PRO PROD;BAC PRO 23407 TECHNIC.FAB.BOIS ET MATERX ASSOC;1;1;1;0;0;0;0;1;0;0;0;1;0;0
4654.0;2021;12;NANCY-METZ;FEMININ;FORMATION CONTINUE;BAC PROFESSIONNEL;BAC PRO SERV;BAC PRO 31206 VENTE (PROSPECT.NEGO.SUIV.CLIENT;12;11;11;0;0;0;0;11;0;2;5;3;1;0
4673.0;2021;12;NANCY-METZ;FEMININ;INDIVIDUEL;BAC TECHNOLOGIQUE;BAC ST2S;BAC ST2S SCIENCES & TECHNO. SANTE & SOCIAL;12;6;2;2;2;1;1;3;0;0;0;0;3;3
4692.0;2021;12;NANCY-METZ;FEMININ;SCOLAIRE;BAC PROFESSIONNEL;BAC PRO PROD;BAC PRO 23405 TECHNICIEN MENUISIER AGENCEUR;4;4;4;0;0;0;0;4;0;0;0;1;3;0
4694.0;2021;12;NANCY-METZ;FEMININ;SCOLAIRE;BAC PROFESSIONNEL;BAC PRO PROD;BAC PRO 24202 ARTIS.& MET.ART : TAPIS.D'AMEUBL;4;4;4;0;0;0;0;4;0;0;0;2;2;0
4701.0;2021;12;NANCY-METZ;FEMININ;SCOLAIRE;BAC PROFESSIONNEL;BAC PRO PROD;BAC PRO 25303 AERONAUTIQUE OPTION SYSTEMES;1;1;1;0;0;0;0;1;0;0;0;1;0;0
4705.0;2021;12;NANCY-METZ;FEMININ;SCOLAIRE;BAC PROFESSIONNEL;BAC PRO PROD;BAC PRO 25513 SYST.NUM.OPT.A SURETE SECURITE;2;2;1;1;0;0;0;1;0;0;0;1;0;1
4707.0;2021;12;NANCY-METZ;FEMININ;SCOLAIRE;BAC PROFESSIONNEL;BAC PRO PROD;BAC PRO 25515 SYST.NUM.OPT.C RES.INF.SYST.COMM.;3;3;3;0;0;0;0;3;0;0;1;1;1;0
4714.0;2021;12;NANCY-METZ;FEMININ;SCOLAIRE;BAC PROFESSIONNEL;BAC PRO PROD;BAC PRO AG 21303 FORET;1;1;1;0;0;0;0;1;0;0;0;1;0;0
4719.0;2021;12;NANCY-METZ;FEMININ;SCOLAIRE;BAC PROFESSIONNEL;BAC PRO SERV;BAC PRO 31107 CONDUCT. TRANSP.ROUT.MARCHANDISES;5;5;4;1;0;0;0;4;0;0;2;0;2;1
4721.0;2021;12;NANCY-METZ;FEMININ;SCOLAIRE;BAC PROFESSIONNEL;BAC PRO SERV;BAC PRO 31202 COMMERCE;413;413;345;30;38;15;23;360;0;22;96;119;123;53
4728.0;2021;12;NANCY-METZ;FEMININ;SCOLAIRE;BAC PROFESSIONNEL;BAC PRO SERV;BAC PRO 33002 SERVICES DE PROXIMITE  VIE LOCAL;83;83;74;5;4;1;3;75;0;2;16;39;18;8
4733.0;2021;12;NANCY-METZ;FEMININ;SCOLAIRE;BAC PROFESSIONNEL;BAC PRO SERV;BAC PRO 33403 COMMERC. SERVICES EN RESTAURATION;89;89;72;9;8;5;3;77;0;3;18;26;30;12
4736.0;2021;12;NANCY-METZ;FEMININ;SCOLAIRE;BAC PROFESSIONNEL;BAC PRO SERV;BAC PRO 34403 METIERS DE LA SECURITE;28;28;26;0;2;2;0;28;0;0;6;12;10;0
4737.0;2021;12;NANCY-METZ;FEMININ;SCOLAIRE;BAC PROFESSIONNEL;BAC PRO SERV;BAC PRO AG 33002 SERV PERS TERRIT;78;76;66;10;0;0;0;66;0;2;6;26;32;10
4738.0;2021;12;NANCY-METZ;FEMININ;SCOLAIRE;BAC TECHNOLOGIQUE;BAC S2TMD;BAC S2TMD DANSE;9;9;9;0;0;0;0;9;0;3;3;3;0;0
4740.0;2021;12;NANCY-METZ;FEMININ;SCOLAIRE;BAC TECHNOLOGIQUE;BAC ST2S;BAC ST2S SCIENCES & TECHNO. SANTE & SOCIAL;643;642;573;9;60;29;31;602;1;14;92;231;264;40
4744.0;2021;12;NANCY-METZ;FEMININ;SCOLAIRE;BAC TECHNOLOGIQUE;BAC STI2D;BAC STI2D ARCHITECTURE ET CONSTRUCTION;19;19;17;0;2;1;1;18;0;1;5;8;4;1
4747.0;2021;12;NANCY-METZ;FEMININ;SCOLAIRE;BAC TECHNOLOGIQUE;BAC STI2D;BAC STI2D SYSTÈME D'INFORMATION  ET NUMERIQUE;17;17;14;0;3;2;1;16;0;1;4;7;4;1
4753.0;2021;12;NANCY-METZ;FEMININ;SCOLAIRE;BAC TECHNOLOGIQUE;BAC STMG;BAC STMG SYSTEMES D'INFORMATION DE GESTION;3;3;2;1;0;0;0;2;0;0;0;0;2;1
4755.0;2021;12;NANCY-METZ;MASCULIN;APPRENTISSAGE;BAC PROFESSIONNEL;BAC PRO PROD;BAC PRO 22004 PROC. CHIMIE EAU PAPIERS-CARTONS;5;5;5;0;0;0;0;5;0;1;1;2;1;0
4757.0;2021;12;NANCY-METZ;MASCULIN;APPRENTISSAGE;BAC PROFESSIONNEL;BAC PRO PROD;BAC PRO 22503 PLASTIQUES ET COMPOSITES;1;1;1;0;0;0;0;1;0;0;1;0;0;0
4767.0;2021;12;NANCY-METZ;MASCULIN;APPRENTISSAGE;BAC PROFESSIONNEL;BAC PRO PROD;BAC PRO 25007 MAINTENANCE EQUIPEMENTS INDUST.;32;31;25;6;0;0;0;25;0;0;9;8;8;6
4780.0;2021;12;NANCY-METZ;MASCULIN;APPRENTISSAGE;BAC PROFESSIONNEL;BAC PRO PROD;BAC PRO 25411 TECH.CHAUDRONNERIE INDUSTRIELLE;43;43;39;0;4;0;4;39;0;3;15;12;9;4
4792.0;2021;12;NANCY-METZ;MASCULIN;APPRENTISSAGE;BAC PROFESSIONNEL;BAC PRO SERV;BAC PRO 31202 COMMERCE;42;42;30;9;3;1;2;31;0;2;3;16;10;11
4797.0;2021;12;NANCY-METZ;MASCULIN;APPRENTISSAGE;BAC PROFESSIONNEL;BAC PRO SERV;BAC PRO AG 33002 SERV PERS TERRIT;1;1;1;0;0;0;0;1;0;0;0;0;1;0
4806.0;2021;12;NANCY-METZ;MASCULIN;FORMATION CONTINUE;BAC PROFESSIONNEL;BAC PRO PROD;BAC PRO 25007 MAINTENANCE EQUIPEMENTS INDUST.;15;14;12;2;0;0;0;12;0;2;5;2;3;2
4817.0;2021;12;NANCY-METZ;MASCULIN;FORMATION CONTINUE;BAC PROFESSIONNEL;BAC PRO SERV;BAC PRO 31202 COMMERCE;5;3;3;0;0;0;0;3;0;2;1;0;0;0
4818.0;2021;12;NANCY-METZ;MASCULIN;FORMATION CONTINUE;BAC PROFESSIONNEL;BAC PRO SERV;BAC PRO 31206 VENTE (PROSPECT.NEGO.SUIV.CLIENT;6;6;4;2;0;0;0;4;0;0;2;1;1;2
4821.0;2021;12;NANCY-METZ;MASCULIN;INDIVIDUEL;BAC GENERAL;BAC GENERAL;BAC GENE 10019 BAC GENERAL;71;50;37;9;4;4;0;41;0;3;9;8;21;9
4824.0;2021;12;NANCY-METZ;MASCULIN;INDIVIDUEL;BAC PROFESSIONNEL;BAC PRO PROD;BAC PRO 22704 TECHN. MAINT. SYST.ENERG.CLIMATI;1;0;0;0;0;0;0;0;0;0;0;0;0;0
4828.0;2021;12;NANCY-METZ;MASCULIN;INDIVIDUEL;BAC PROFESSIONNEL;BAC PRO PROD;BAC PRO 25214 MAINT.VEHIC.OPTA VOIT.PARTICUL.;2;1;1;0;0;0;0;1;0;1;0;0;0;0
4837.0;2021;12;NANCY-METZ;MASCULIN;INDIVIDUEL;BAC PROFESSIONNEL;BAC PRO SERV;BAC PRO 31206 VENTE (PROSPECT.NEGO.SUIV.CLIENT;2;1;1;0;0;0;0;1;0;0;0;0;1;0
4838.0;2021;12;NANCY-METZ;MASCULIN;INDIVIDUEL;BAC PROFESSIONNEL;BAC PRO SERV;BAC PRO 34403 METIERS DE LA SECURITE;1;0;0;0;0;0;0;0;0;0;0;0;0;0
4841.0;2021;12;NANCY-METZ;MASCULIN;INDIVIDUEL;BAC TECHNOLOGIQUE;BAC STAV;BAC STAV AGRONOMIE ALIM ENV TERRITOI;1;1;1;0;0;0;0;1;0;0;0;0;1;0
4843.0;2021;12;NANCY-METZ;MASCULIN;INDIVIDUEL;BAC TECHNOLOGIQUE;BAC STI2D;BAC STI2D INNOVATION TECHNO.  ET ECO CONCEPTION;1;0;0;0;0;0;0;0;0;0;0;0;0;0
4849.0;2021;12;NANCY-METZ;MASCULIN;SCOLAIRE;BAC PROFESSIONNEL;BAC PRO PROD;BAC PRO 20102 PILOTE DE LIGNE DE PRODUCTION;25;25;20;2;3;1;2;21;0;0;0;12;9;4
4851.0;2021;12;NANCY-METZ;MASCULIN;SCOLAIRE;BAC PROFESSIONNEL;BAC PRO PROD;BAC PRO 22004 PROC. CHIMIE EAU PAPIERS-CARTONS;21;21;17;3;1;1;0;18;0;0;7;6;5;3
4867.0;2021;12;NANCY-METZ;MASCULIN;SCOLAIRE;BAC PROFESSIONNEL;BAC PRO PROD;BAC PRO 23404 TECHNICIEN CONSTRUCTEUR BOIS;10;9;6;1;2;2;0;8;0;0;0;4;4;1
4879.0;2021;12;NANCY-METZ;MASCULIN;SCOLAIRE;BAC PROFESSIONNEL;BAC PRO PROD;BAC PRO 25219 MAINT.MATERIELS OPT.A AGRICOLES;3;3;2;0;1;1;0;3;0;0;0;0;3;0
4883.0;2021;12;NANCY-METZ;MASCULIN;SCOLAIRE;BAC PROFESSIONNEL;BAC PRO PROD;BAC PRO 25303 AERONAUTIQUE OPTION SYSTEMES;8;8;8;0;0;0;0;8;0;1;2;5;0;0
4885.0;2021;12;NANCY-METZ;MASCULIN;SCOLAIRE;BAC PROFESSIONNEL;BAC PRO PROD;BAC PRO 25408 REPARATION DES CARROSSERIES;52;52;39;10;3;3;0;42;0;1;8;21;12;10
4889.0;2021;12;NANCY-METZ;MASCULIN;SCOLAIRE;BAC PROFESSIONNEL;BAC PRO PROD;BAC PRO 25510 METIERS ELECT. ENVIRON. CONNECTES;510;507;426;64;17;6;11;432;0;37;105;161;129;75
4901.0;2021;12;NANCY-METZ;MASCULIN;SCOLAIRE;BAC PROFESSIONNEL;BAC PRO PROD;BAC PRO AG 22107 TEC CONS VTE ALIMENTATION P.ALIM;4;3;1;2;0;0;0;1;0;0;0;0;1;2
4915.0;2021;12;NANCY-METZ;MASCULIN;SCOLAIRE;BAC PROFESSIONNEL;BAC PRO SERV;BAC PRO 33004 ACC.SOINS-S.PERS. OPT.EN STRUCTUR;41;41;39;1;1;1;0;40;0;4;8;15;13;1
4923.0;2021;12;NANCY-METZ;MASCULIN;SCOLAIRE;BAC TECHNOLOGIQUE;BAC S2TMD;BAC S2TMD MUSIQUE;8;8;8;0;0;0;0;8;1;3;2;1;1;0
4925.0;2021;12;NANCY-METZ;MASCULIN;SCOLAIRE;BAC TECHNOLOGIQUE;BAC STAV;BAC STAV AGRONOMIE ALIM ENV TERRITOI;71;70;67;3;0;0;0;67;0;0;10;28;29;3
4928.0;2021;12;NANCY-METZ;MASCULIN;SCOLAIRE;BAC TECHNOLOGIQUE;BAC STI2D;BAC STI2D ARCHITECTURE ET CONSTRUCTION;52;52;48;1;3;1;2;49;0;2;8;15;24;3
4935.0;2021;12;NANCY-METZ;MASCULIN;SCOLAIRE;BAC TECHNOLOGIQUE;BAC STMG;BAC STMG MERCATIQUE (MARKETING);446;446;361;18;67;39;28;400;0;0;30;152;218;46
4938.0;2021;17;NANTES;FEMININ;APPRENTISSAGE;BAC PROFESSIONNEL;BAC PRO PROD;BAC PRO 22105 BOULANGER-PÂTISSIER;6;6;6;0;0;0;0;6;0;0;3;2;1;0
4939.0;2021;17;NANTES;FEMININ;APPRENTISSAGE;BAC PROFESSIONNEL;BAC PRO PROD;BAC PRO 22106 CUISINE;23;22;21;0;1;1;0;22;0;1;5;3;13;0
4940.0;2021;17;NANTES;FEMININ;APPRENTISSAGE;BAC PROFESSIONNEL;BAC PRO PROD;BAC PRO 22503 PLASTIQUES ET COMPOSITES;2;2;2;0;0;0;0;2;0;1;1;0;0;0
4943.0;2021;17;NANTES;FEMININ;APPRENTISSAGE;BAC PROFESSIONNEL;BAC PRO PROD;BAC PRO 23304 AMENAGEMENT FINITION BATIMENT;1;1;0;1;0;0;0;0;0;0;0;0;0;1
4952.0;2021;17;NANTES;FEMININ;APPRENTISSAGE;BAC PROFESSIONNEL;BAC PRO PROD;BAC PRO 25303 AERONAUTIQUE OPTION SYSTEMES;4;4;4;0;0;0;0;4;0;1;1;2;0;0
4958.0;2021;17;NANTES;FEMININ;APPRENTISSAGE;BAC PROFESSIONNEL;BAC PRO PROD;BAC PRO AG 21001 AGRO-EQUIPEMENT;1;1;1;0;0;0;0;1;0;0;0;1;0;0
4959.0;2021;17;NANTES;FEMININ;APPRENTISSAGE;BAC PROFESSIONNEL;BAC PRO PROD;BAC PRO AG 21004 CGEA;14;14;14;0;0;0;0;14;0;0;1;4;9;0
4960.0;2021;17;NANTES;FEMININ;APPRENTISSAGE;BAC PROFESSIONNEL;BAC PRO PROD;BAC PRO AG 21113 CGEVV;2;2;2;0;0;0;0;2;0;0;0;0;2;0
4964.0;2021;17;NANTES;FEMININ;APPRENTISSAGE;BAC PROFESSIONNEL;BAC PRO PROD;BAC PRO AG 21405 AMENAGEMENTS PAYSAGERS;2;2;2;0;0;0;0;2;0;0;0;1;1;0
4969.0;2021;17;NANTES;FEMININ;APPRENTISSAGE;BAC PROFESSIONNEL;BAC PRO SERV;BAC PRO 31209 POISSONIER ECAILLER TRAITEUR;1;1;1;0;0;0;0;1;0;0;0;0;1;0
4979.0;2021;17;NANTES;FEMININ;ENSEIGNEMENT A DISTANCE;BAC PROFESSIONNEL;BAC PRO PROD;BAC PRO AG 21114 CONDUITE PRODUCTIONS HORTICOLES;11;9;9;0;0;0;0;9;0;0;0;0;9;0
4982.0;2021;17;NANTES;FEMININ;ENSEIGNEMENT A DISTANCE;BAC TECHNOLOGIQUE;BAC STMG;BAC STMG RESSOURCES HUMAINES ET COMMUNICATION;5;5;5;0;0;0;0;5;0;0;1;3;1;0
4983.0;2021;17;NANTES;FEMININ;FORMATION CONTINUE;BAC PROFESSIONNEL;BAC PRO PROD;BAC PRO 20102 PILOTE DE LIGNE DE PRODUCTION;5;5;4;1;0;0;0;4;0;0;1;2;1;1
4985.0;2021;17;NANTES;FEMININ;FORMATION CONTINUE;BAC PROFESSIONNEL;BAC PRO PROD;BAC PRO 23004 TECHN. ETUDES BAT.A ETUDES & ECO.;6;6;4;0;2;1;1;5;0;0;3;1;1;1
4990.0;2021;17;NANTES;FEMININ;FORMATION CONTINUE;BAC PROFESSIONNEL;BAC PRO PROD;BAC PRO AG 21113 CGEVV;1;0;0;0;0;0;0;0;0;0;0;0;0;0
4992.0;2021;17;NANTES;FEMININ;FORMATION CONTINUE;BAC PROFESSIONNEL;BAC PRO SERV;BAC PRO 31108 TRANSPORT;2;2;2;0;0;0;0;2;0;0;0;2;0;0
4997.0;2021;17;NANTES;FEMININ;INDIVIDUEL;BAC PROFESSIONNEL;BAC PRO PROD;BAC PRO 24302 METIERS DU CUIR : MAROQUINERIE;1;1;1;0;0;0;0;1;0;0;1;0;0;0
5008.0;2021;17;NANTES;FEMININ;INDIVIDUEL;BAC PROFESSIONNEL;BAC PRO SERV;BAC PRO 33003 ACC.SOINS-S.PERS. OPT.A DOMICILE;1;1;1;0;0;0;0;1;0;0;0;1;0;0
5010.0;2021;17;NANTES;FEMININ;INDIVIDUEL;BAC PROFESSIONNEL;BAC PRO SERV;BAC PRO 33603 ESTHETIQUE COSMETIQUE PARFUMERIE;1;1;1;0;0;0;0;1;0;0;0;1;0;0
5013.0;2021;17;NANTES;FEMININ;INDIVIDUEL;BAC TECHNOLOGIQUE;BAC STI2D;BAC STI2D INNOVATION TECHNO.  ET ECO CONCEPTION;1;0;0;0;0;0;0;0;0;0;0;0;0;0
5015.0;2021;17;NANTES;FEMININ;INDIVIDUEL;BAC TECHNOLOGIQUE;BAC STMG;BAC STMG RESSOURCES HUMAINES ET COMMUNICATION;16;13;5;3;5;4;1;9;0;0;0;0;9;4
5016.0;2021;17;NANTES;FEMININ;SCOLAIRE;BAC GENERAL;BAC GENERAL;BAC GENE 10019 BAC GENERAL;11993;11992;11758;34;200;114;86;11872;185;1455;3588;4413;2231;120
5026.0;2021;17;NANTES;FEMININ;SCOLAIRE;BAC PROFESSIONNEL;BAC PRO PROD;BAC PRO 23005 TECHN. ETUDES BAT B ASSIST.ARCHI.;37;37;36;1;0;0;0;36;0;4;20;9;3;1
5033.0;2021;17;NANTES;FEMININ;SCOLAIRE;BAC PROFESSIONNEL;BAC PRO PROD;BAC PRO 24202 ARTIS.& MET.ART : TAPIS.D'AMEUBL;14;14;14;0;0;0;0;14;0;3;6;4;1;0
5040.0;2021;17;NANTES;FEMININ;SCOLAIRE;BAC PROFESSIONNEL;BAC PRO PROD;BAC PRO 25215 MAINT.VEHIC.OPTB VEHIC.TRANS.ROUT;1;1;1;0;0;0;0;1;0;0;0;0;1;0
5049.0;2021;17;NANTES;FEMININ;SCOLAIRE;BAC PROFESSIONNEL;BAC PRO PROD;BAC PRO AG 21004 CGEA;117;117;103;14;0;0;0;103;0;0;13;48;42;14
5050.0;2021;17;NANTES;FEMININ;SCOLAIRE;BAC PROFESSIONNEL;BAC PRO PROD;BAC PRO AG 21113 CGEVV;2;2;2;0;0;0;0;2;0;0;1;0;1;0
5055.0;2021;17;NANTES;FEMININ;SCOLAIRE;BAC PROFESSIONNEL;BAC PRO PROD;BAC PRO AG 21302 GEST MILIEUX NATURELS FAUNE;14;14;14;0;0;0;0;14;0;0;3;7;4;0
5061.0;2021;17;NANTES;FEMININ;SCOLAIRE;BAC PROFESSIONNEL;BAC PRO SERV;BAC PRO 31106 LOGISTIQUE;6;6;5;0;1;1;0;6;0;0;1;2;3;0
5062.0;2021;17;NANTES;FEMININ;SCOLAIRE;BAC PROFESSIONNEL;BAC PRO SERV;BAC PRO 31107 CONDUCT. TRANSP.ROUT.MARCHANDISES;14;14;11;3;0;0;0;11;0;0;3;7;1;3
5064.0;2021;17;NANTES;FEMININ;SCOLAIRE;BAC PROFESSIONNEL;BAC PRO SERV;BAC PRO 31202 COMMERCE;655;655;577;43;35;16;19;593;0;41;138;248;166;62
5067.0;2021;17;NANTES;FEMININ;SCOLAIRE;BAC PROFESSIONNEL;BAC PRO SERV;BAC PRO 32207 REAL.PR.IMPR.PLURI.OPTA.PR.GRAPH.;6;6;6;0;0;0;0;6;0;1;1;4;0;0
5068.0;2021;17;NANTES;FEMININ;SCOLAIRE;BAC PROFESSIONNEL;BAC PRO SERV;BAC PRO 32208 REAL.PR.IMPR.PLURI.OPTB.PR.IMPR.;6;6;6;0;0;0;0;6;0;0;0;2;4;0
5070.0;2021;17;NANTES;FEMININ;SCOLAIRE;BAC PROFESSIONNEL;BAC PRO SERV;BAC PRO 32304 PHOTOGRAPHIE;20;20;19;1;0;0;0;19;0;5;5;9;0;1
5076.0;2021;17;NANTES;FEMININ;SCOLAIRE;BAC PROFESSIONNEL;BAC PRO SERV;BAC PRO 33103 TECHNICIEN APPAREIL. ORTHOPEDIQUE;6;6;6;0;0;0;0;6;0;0;3;3;0;0
5081.0;2021;17;NANTES;FEMININ;SCOLAIRE;BAC PROFESSIONNEL;BAC PRO SERV;BAC PRO AG 33002 SERV PERS TERRIT;862;854;821;33;0;0;0;821;0;9;123;375;314;33
5082.0;2021;17;NANTES;FEMININ;SCOLAIRE;BAC TECHNOLOGIQUE;BAC S2TMD;BAC S2TMD DANSE;17;17;17;0;0;0;0;17;1;5;9;2;0;0
5089.0;2021;17;NANTES;FEMININ;SCOLAIRE;BAC TECHNOLOGIQUE;BAC STI2D;BAC STI2D ENERGIES  ET ENVIRONNEMENT;15;15;14;0;1;0;1;14;0;3;3;4;4;1
5093.0;2021;17;NANTES;FEMININ;SCOLAIRE;BAC TECHNOLOGIQUE;BAC STL;BAC STL SCIENCES PHYSIQUES CHIMIQUES  EN LABORAT.;93;93;86;1;6;2;4;88;0;3;18;33;34;5
5095.0;2021;17;NANTES;FEMININ;SCOLAIRE;BAC TECHNOLOGIQUE;BAC STMG;BAC STMG MERCATIQUE (MARKETING);969;968;895;11;62;29;33;924;0;20;147;414;343;44
5103.0;2021;17;NANTES;MASCULIN;APPRENTISSAGE;BAC PROFESSIONNEL;BAC PRO PROD;BAC PRO 22703 TECHN.INSTALL.SYST.ENERG.CLIMATI;43;43;35;2;6;5;1;40;0;1;6;18;15;3
5106.0;2021;17;NANTES;MASCULIN;APPRENTISSAGE;BAC PROFESSIONNEL;BAC PRO PROD;BAC PRO 23004 TECHN. ETUDES BAT.A ETUDES & ECO.;3;3;3;0;0;0;0;3;0;0;0;2;1;0
5109.0;2021;17;NANTES;MASCULIN;APPRENTISSAGE;BAC PROFESSIONNEL;BAC PRO PROD;BAC PRO 23205 INTERV. SUR PATRIMOINE BATI OPT.A;1;1;1;0;0;0;0;1;0;0;0;1;0;0
5112.0;2021;17;NANTES;MASCULIN;APPRENTISSAGE;BAC PROFESSIONNEL;BAC PRO PROD;BAC PRO 23405 TECHNICIEN MENUISIER AGENCEUR;7;7;5;1;1;1;0;6;0;0;1;2;3;1
5114.0;2021;17;NANTES;MASCULIN;APPRENTISSAGE;BAC PROFESSIONNEL;BAC PRO PROD;BAC PRO 24302 METIERS DU CUIR : MAROQUINERIE;1;1;1;0;0;0;0;1;0;1;0;0;0;0
5119.0;2021;17;NANTES;MASCULIN;APPRENTISSAGE;BAC PROFESSIONNEL;BAC PRO PROD;BAC PRO 25215 MAINT.VEHIC.OPTB VEHIC.TRANS.ROUT;59;58;48;5;5;4;1;52;0;4;6;17;25;6
5128.0;2021;17;NANTES;MASCULIN;APPRENTISSAGE;BAC PROFESSIONNEL;BAC PRO PROD;BAC PRO 25408 REPARATION DES CARROSSERIES;36;36;30;4;2;1;1;31;0;1;5;5;20;5
5140.0;2021;17;NANTES;MASCULIN;APPRENTISSAGE;BAC PROFESSIONNEL;BAC PRO PROD;BAC PRO AG 21204 PROD-AQUACOLES;1;1;1;0;0;0;0;1;0;0;0;0;1;0
5147.0;2021;17;NANTES;MASCULIN;APPRENTISSAGE;BAC PROFESSIONNEL;BAC PRO SERV;BAC PRO 31202 COMMERCE;188;184;146;22;16;11;5;157;0;10;25;58;64;27
5148.0;2021;17;NANTES;MASCULIN;APPRENTISSAGE;BAC PROFESSIONNEL;BAC PRO SERV;BAC PRO 31206 VENTE (PROSPECT.NEGO.SUIV.CLIENT;1;1;1;0;0;0;0;1;0;0;0;1;0;0
5150.0;2021;17;NANTES;MASCULIN;APPRENTISSAGE;BAC PROFESSIONNEL;BAC PRO SERV;BAC PRO 32206 FACONNAGE PRODTS IMPRIMES ROUTAGE;2;2;1;1;0;0;0;1;0;1;0;0;0;1
5156.0;2021;17;NANTES;MASCULIN;ENSEIGNEMENT A DISTANCE;BAC GENERAL;BAC GENERAL;BAC GENE 10019 BAC GENERAL;35;34;33;1;0;0;0;33;0;7;15;8;3;1
5163.0;2021;17;NANTES;MASCULIN;FORMATION CONTINUE;BAC PROFESSIONNEL;BAC PRO PROD;BAC PRO 20102 PILOTE DE LIGNE DE PRODUCTION;14;14;10;2;2;0;2;10;0;1;3;2;4;4
5170.0;2021;17;NANTES;MASCULIN;FORMATION CONTINUE;BAC PROFESSIONNEL;BAC PRO PROD;BAC PRO 24302 METIERS DU CUIR : MAROQUINERIE;1;0;0;0;0;0;0;0;0;0;0;0;0;0
5171.0;2021;17;NANTES;MASCULIN;FORMATION CONTINUE;BAC PROFESSIONNEL;BAC PRO PROD;BAC PRO 25007 MAINTENANCE EQUIPEMENTS INDUST.;14;13;10;3;0;0;0;10;0;5;1;2;2;3
5172.0;2021;17;NANTES;MASCULIN;FORMATION CONTINUE;BAC PROFESSIONNEL;BAC PRO PROD;BAC PRO 25214 MAINT.VEHIC.OPTA VOIT.PARTICUL.;4;4;4;0;0;0;0;4;0;4;0;0;0;0
5177.0;2021;17;NANTES;MASCULIN;FORMATION CONTINUE;BAC PROFESSIONNEL;BAC PRO PROD;BAC PRO 25515 SYST.NUM.OPT.C RES.INF.SYST.COMM.;9;9;9;0;0;0;0;9;0;1;4;2;2;0
5178.0;2021;17;NANTES;MASCULIN;FORMATION CONTINUE;BAC PROFESSIONNEL;BAC PRO PROD;BAC PRO AG 21113 CGEVV;9;9;9;0;0;0;0;9;0;0;0;1;8;0
5180.0;2021;17;NANTES;MASCULIN;FORMATION CONTINUE;BAC PROFESSIONNEL;BAC PRO SERV;BAC PRO 31106 LOGISTIQUE;16;16;15;1;0;0;0;15;0;2;0;4;9;1
5188.0;2021;17;NANTES;MASCULIN;INDIVIDUEL;BAC PROFESSIONNEL;BAC PRO PROD;BAC PRO 25214 MAINT.VEHIC.OPTA VOIT.PARTICUL.;3;1;1;0;0;0;0;1;0;0;0;0;1;0
5189.0;2021;17;NANTES;MASCULIN;INDIVIDUEL;BAC PROFESSIONNEL;BAC PRO PROD;BAC PRO 25509 TECHNIC. FROID CONDITIONNEMT AIR;1;1;0;1;0;0;0;0;0;0;0;0;0;1
5193.0;2021;17;NANTES;MASCULIN;INDIVIDUEL;BAC PROFESSIONNEL;BAC PRO PROD;BAC PRO AG 21004 CGEA;5;4;4;0;0;0;0;4;0;0;0;0;4;0
5194.0;2021;17;NANTES;MASCULIN;INDIVIDUEL;BAC PROFESSIONNEL;BAC PRO PROD;BAC PRO AG 21113 CGEVV;3;3;3;0;0;0;0;3;0;0;0;0;3;0
5198.0;2021;17;NANTES;MASCULIN;INDIVIDUEL;BAC PROFESSIONNEL;BAC PRO SERV;BAC PRO 30001 GESTION-ADMINISTRATION;5;4;1;2;1;1;0;2;0;0;0;0;2;2
5199.0;2021;17;NANTES;MASCULIN;INDIVIDUEL;BAC PROFESSIONNEL;BAC PRO SERV;BAC PRO 31202 COMMERCE;15;12;10;2;0;0;0;10;0;0;1;1;8;2
5205.0;2021;17;NANTES;MASCULIN;INDIVIDUEL;BAC PROFESSIONNEL;BAC PRO SERV;BAC PRO 34304 HYGIENE PROPRETE STERILISATION;1;1;0;0;1;0;1;0;0;0;0;0;0;1
5208.0;2021;17;NANTES;MASCULIN;INDIVIDUEL;BAC TECHNOLOGIQUE;BAC STHR;BAC STHR SC.&TEC. HOTELLERIE-RESTAURATION;1;1;0;1;0;0;0;0;0;0;0;0;0;1
5213.0;2021;17;NANTES;MASCULIN;INDIVIDUEL;BAC TECHNOLOGIQUE;BAC STMG;BAC STMG RESSOURCES HUMAINES ET COMMUNICATION;10;5;1;1;3;2;1;3;0;0;0;0;3;2
5218.0;2021;17;NANTES;MASCULIN;SCOLAIRE;BAC PROFESSIONNEL;BAC PRO PROD;BAC PRO 22004 PROC. CHIMIE EAU PAPIERS-CARTONS;24;23;21;1;1;1;0;22;0;0;5;9;8;1
5222.0;2021;17;NANTES;MASCULIN;SCOLAIRE;BAC PROFESSIONNEL;BAC PRO PROD;BAC PRO 22503 PLASTIQUES ET COMPOSITES;30;30;28;0;2;0;2;28;0;1;4;7;16;2
5227.0;2021;17;NANTES;MASCULIN;SCOLAIRE;BAC PROFESSIONNEL;BAC PRO PROD;BAC PRO 23005 TECHN. ETUDES BAT B ASSIST.ARCHI.;49;49;47;2;0;0;0;47;0;3;15;18;11;2
5230.0;2021;17;NANTES;MASCULIN;SCOLAIRE;BAC PROFESSIONNEL;BAC PRO PROD;BAC PRO 23203 TECHNICIEN BAT. : ORG.REAL.GROS O;16;16;11;5;0;0;0;11;0;0;2;6;3;5
5232.0;2021;17;NANTES;MASCULIN;SCOLAIRE;BAC PROFESSIONNEL;BAC PRO PROD;BAC PRO 23303 MENUISERIE ALUMINIUM-VERRE;19;19;15;3;1;1;0;16;0;0;0;7;9;3
5242.0;2021;17;NANTES;MASCULIN;SCOLAIRE;BAC PROFESSIONNEL;BAC PRO PROD;BAC PRO 25007 MAINTENANCE EQUIPEMENTS INDUST.;271;271;215;41;15;6;9;221;0;15;54;82;70;50
5243.0;2021;17;NANTES;MASCULIN;SCOLAIRE;BAC PROFESSIONNEL;BAC PRO PROD;BAC PRO 25009 MAINTENANCE NAUTIQUE;19;19;15;4;0;0;0;15;0;1;5;6;3;4
5250.0;2021;17;NANTES;MASCULIN;SCOLAIRE;BAC PROFESSIONNEL;BAC PRO PROD;BAC PRO 25220 MAINT.MATERIELS OPT.B TP MANUT.;21;20;15;5;0;0;0;15;0;1;3;6;5;5
5253.0;2021;17;NANTES;MASCULIN;SCOLAIRE;BAC PROFESSIONNEL;BAC PRO PROD;BAC PRO 25408 REPARATION DES CARROSSERIES;46;46;42;3;1;1;0;43;0;0;7;21;15;3
5268.0;2021;17;NANTES;MASCULIN;SCOLAIRE;BAC PROFESSIONNEL;BAC PRO PROD;BAC PRO AG 21211 COND GEST ENTR HIPPIQUE;10;10;10;0;0;0;0;10;0;0;0;1;9;0
5275.0;2021;17;NANTES;MASCULIN;SCOLAIRE;BAC PROFESSIONNEL;BAC PRO SERV;BAC PRO 30001 GESTION-ADMINISTRATION;254;254;203;38;13;10;3;213;0;4;28;74;107;41
5279.0;2021;17;NANTES;MASCULIN;SCOLAIRE;BAC PROFESSIONNEL;BAC PRO SERV;BAC PRO 31202 COMMERCE;586;583;511;37;35;17;18;528;0;17;110;213;188;55
5290.0;2021;17;NANTES;MASCULIN;SCOLAIRE;BAC PROFESSIONNEL;BAC PRO SERV;BAC PRO 33102 PROTHESE DENTAIRE;12;12;7;4;1;1;0;8;0;0;1;4;3;4
5295.0;2021;17;NANTES;MASCULIN;SCOLAIRE;BAC PROFESSIONNEL;BAC PRO SERV;BAC PRO 34304 HYGIENE PROPRETE STERILISATION;2;2;1;1;0;0;0;1;0;0;1;0;0;1
5297.0;2021;17;NANTES;MASCULIN;SCOLAIRE;BAC PROFESSIONNEL;BAC PRO SERV;BAC PRO AG 33002 SERV PERS TERRIT;125;124;120;4;0;0;0;120;0;1;14;42;63;4
5312.0;2021;17;NANTES;MASCULIN;SCOLAIRE;BAC TECHNOLOGIQUE;BAC STMG;BAC STMG RESSOURCES HUMAINES ET COMMUNICATION;348;348;291;14;43;20;23;311;0;1;26;115;169;37
5314.0;2021;23;NICE;FEMININ;APPRENTISSAGE;BAC PROFESSIONNEL;BAC PRO PROD;BAC PRO 25007 MAINTENANCE EQUIPEMENTS INDUST.;1;1;1;0;0;0;0;1;0;0;1;0;0;0
5317.0;2021;23;NICE;FEMININ;APPRENTISSAGE;BAC PROFESSIONNEL;BAC PRO PROD;BAC PRO 25510 METIERS ELECT. ENVIRON. CONNECTES;2;2;2;0;0;0;0;2;0;0;1;0;1;0
5323.0;2021;23;NICE;FEMININ;APPRENTISSAGE;BAC PROFESSIONNEL;BAC PRO SERV;BAC PRO 31206 VENTE (PROSPECT.NEGO.SUIV.CLIENT;1;1;0;0;1;1;0;1;0;0;0;0;1;0
5324.0;2021;23;NICE;FEMININ;APPRENTISSAGE;BAC PROFESSIONNEL;BAC PRO SERV;BAC PRO 31210 ACCUEIL -RELATION CLIENTS USAGERS;2;2;2;0;0;0;0;2;0;0;1;0;1;0
5326.0;2021;23;NICE;FEMININ;APPRENTISSAGE;BAC PROFESSIONNEL;BAC PRO SERV;BAC PRO 33102 PROTHESE DENTAIRE;2;2;2;0;0;0;0;2;0;0;0;2;0;0
5328.0;2021;23;NICE;FEMININ;ENSEIGNEMENT A DISTANCE;BAC GENERAL;BAC GENERAL;BAC GENE 10019 BAC GENERAL;58;56;50;2;4;0;4;50;0;13;20;8;9;6
5331.0;2021;23;NICE;FEMININ;ENSEIGNEMENT A DISTANCE;BAC PROFESSIONNEL;BAC PRO SERV;BAC PRO 31202 COMMERCE;3;3;3;0;0;0;0;3;0;0;1;0;2;0
5341.0;2021;23;NICE;FEMININ;FORMATION CONTINUE;BAC PROFESSIONNEL;BAC PRO SERV;BAC PRO 30001 GESTION-ADMINISTRATION;2;0;0;0;0;0;0;0;0;0;0;0;0;0
5345.0;2021;23;NICE;FEMININ;FORMATION CONTINUE;BAC PROFESSIONNEL;BAC PRO SERV;BAC PRO 33603 ESTHETIQUE COSMETIQUE PARFUMERIE;10;9;9;0;0;0;0;9;0;0;1;8;0;0
5351.0;2021;23;NICE;FEMININ;INDIVIDUEL;BAC PROFESSIONNEL;BAC PRO SERV;BAC PRO 30001 GESTION-ADMINISTRATION;5;1;0;1;0;0;0;0;0;0;0;0;0;1
5357.0;2021;23;NICE;FEMININ;INDIVIDUEL;BAC PROFESSIONNEL;BAC PRO SERV;BAC PRO AG 33002 SERV PERS TERRIT;2;1;0;1;0;0;0;0;0;0;0;0;0;1
5367.0;2021;23;NICE;FEMININ;SCOLAIRE;BAC PROFESSIONNEL;BAC PRO PROD;BAC PRO 23003 ARTIS. & M.ART:MARCHANDISAGE VIS.;8;8;7;1;0;0;0;7;0;1;3;1;2;1
5369.0;2021;23;NICE;FEMININ;SCOLAIRE;BAC PROFESSIONNEL;BAC PRO PROD;BAC PRO 23005 TECHN. ETUDES BAT B ASSIST.ARCHI.;8;8;7;1;0;0;0;7;0;1;0;5;1;1
5376.0;2021;23;NICE;FEMININ;SCOLAIRE;BAC PROFESSIONNEL;BAC PRO PROD;BAC PRO 24202 ARTIS.& MET.ART : TAPIS.D'AMEUBL;7;7;6;0;1;1;0;7;0;0;2;3;2;0
5379.0;2021;23;NICE;FEMININ;SCOLAIRE;BAC PROFESSIONNEL;BAC PRO PROD;BAC PRO 25006 MICROTECHNIQUES;3;3;2;0;1;1;0;3;0;0;0;0;3;0
5382.0;2021;23;NICE;FEMININ;SCOLAIRE;BAC PROFESSIONNEL;BAC PRO PROD;BAC PRO 25214 MAINT.VEHIC.OPTA VOIT.PARTICUL.;6;6;6;0;0;0;0;6;0;1;1;4;0;0
5385.0;2021;23;NICE;FEMININ;SCOLAIRE;BAC PROFESSIONNEL;BAC PRO PROD;BAC PRO 25408 REPARATION DES CARROSSERIES;1;1;1;0;0;0;0;1;0;0;0;1;0;0
5387.0;2021;23;NICE;FEMININ;SCOLAIRE;BAC PROFESSIONNEL;BAC PRO PROD;BAC PRO 25510 METIERS ELECT. ENVIRON. CONNECTES;4;4;4;0;0;0;0;4;0;0;0;4;0;0
5388.0;2021;23;NICE;FEMININ;SCOLAIRE;BAC PROFESSIONNEL;BAC PRO PROD;BAC PRO 25513 SYST.NUM.OPT.A SURETE SECURITE;1;1;1;0;0;0;0;1;0;0;1;0;0;0
5389.0;2021;23;NICE;FEMININ;SCOLAIRE;BAC PROFESSIONNEL;BAC PRO PROD;BAC PRO 25514 SYST.NUM.OPT.B AUD.RES.EQUIP.DOM.;5;4;4;0;0;0;0;4;0;2;0;0;2;0
5391.0;2021;23;NICE;FEMININ;SCOLAIRE;BAC PROFESSIONNEL;BAC PRO PROD;BAC PRO AG 21004 CGEA;25;23;18;5;0;0;0;18;0;0;2;7;9;5
5395.0;2021;23;NICE;FEMININ;SCOLAIRE;BAC PROFESSIONNEL;BAC PRO PROD;BAC PRO AG 21405 AMENAGEMENTS PAYSAGERS;8;8;8;0;0;0;0;8;0;0;1;4;3;0
5403.0;2021;23;NICE;FEMININ;SCOLAIRE;BAC PROFESSIONNEL;BAC PRO SERV;BAC PRO 31210 ACCUEIL -RELATION CLIENTS USAGERS;218;218;186;22;10;6;4;192;0;6;32;58;96;26
5410.0;2021;23;NICE;FEMININ;SCOLAIRE;BAC PROFESSIONNEL;BAC PRO SERV;BAC PRO 33101 OPTIQUE LUNETTERIE;11;11;10;1;0;0;0;10;0;1;1;5;3;1
5412.0;2021;23;NICE;FEMININ;SCOLAIRE;BAC PROFESSIONNEL;BAC PRO SERV;BAC PRO 33603 ESTHETIQUE COSMETIQUE PARFUMERIE;94;92;86;5;1;0;1;86;0;7;10;37;32;6
5415.0;2021;23;NICE;FEMININ;SCOLAIRE;BAC PROFESSIONNEL;BAC PRO SERV;BAC PRO AG 33002 SERV PERS TERRIT;88;88;86;2;0;0;0;86;0;5;22;40;19;2
5417.0;2021;23;NICE;FEMININ;SCOLAIRE;BAC TECHNOLOGIQUE;BAC S2TMD;BAC S2TMD MUSIQUE;4;4;4;0;0;0;0;4;0;1;1;2;0;0
5420.0;2021;23;NICE;FEMININ;SCOLAIRE;BAC TECHNOLOGIQUE;BAC STD2A;BAC STD2A SCIENCES & TECHNO. DESIGN-ARTS APPLIQUES;90;90;88;1;1;0;1;88;0;23;30;21;14;2
5429.0;2021;23;NICE;FEMININ;SCOLAIRE;BAC TECHNOLOGIQUE;BAC STMG;BAC STMG MERCATIQUE (MARKETING);512;511;475;9;27;15;12;490;1;11;83;218;177;21
5431.0;2021;23;NICE;FEMININ;SCOLAIRE;BAC TECHNOLOGIQUE;BAC STMG;BAC STMG SYSTEMES D'INFORMATION DE GESTION;3;3;2;1;0;0;0;2;0;0;1;0;1;1
5432.0;2021;23;NICE;MASCULIN;APPRENTISSAGE;BAC PROFESSIONNEL;BAC PRO PROD;BAC PRO 22106 CUISINE;8;8;8;0;0;0;0;8;0;0;2;3;3;0
5436.0;2021;23;NICE;MASCULIN;APPRENTISSAGE;BAC PROFESSIONNEL;BAC PRO PROD;BAC PRO 23102 TRAVAUX PUBLICS;1;1;1;0;0;0;0;1;0;0;0;1;0;0
5437.0;2021;23;NICE;MASCULIN;APPRENTISSAGE;BAC PROFESSIONNEL;BAC PRO PROD;BAC PRO 23303 MENUISERIE ALUMINIUM-VERRE;9;7;5;0;2;1;1;6;0;0;2;1;3;1
5438.0;2021;23;NICE;MASCULIN;APPRENTISSAGE;BAC PROFESSIONNEL;BAC PRO PROD;BAC PRO 23304 AMENAGEMENT FINITION BATIMENT;1;1;1;0;0;0;0;1;0;0;0;0;1;0
5439.0;2021;23;NICE;MASCULIN;APPRENTISSAGE;BAC PROFESSIONNEL;BAC PRO PROD;BAC PRO 23405 TECHNICIEN MENUISIER AGENCEUR;2;2;1;1;0;0;0;1;0;0;0;0;1;1
5455.0;2021;23;NICE;MASCULIN;APPRENTISSAGE;BAC PROFESSIONNEL;BAC PRO SERV;BAC PRO 31202 COMMERCE;36;36;24;9;3;1;2;25;0;1;4;14;6;11
5475.0;2021;23;NICE;MASCULIN;FORMATION CONTINUE;BAC PROFESSIONNEL;BAC PRO SERV;BAC PRO 31210 ACCUEIL -RELATION CLIENTS USAGERS;3;3;3;0;0;0;0;3;0;0;2;1;0;0
5477.0;2021;23;NICE;MASCULIN;FORMATION CONTINUE;BAC PROFESSIONNEL;BAC PRO SERV;BAC PRO AG 33002 SERV PERS TERRIT;1;1;0;1;0;0;0;0;0;0;0;0;0;1
5479.0;2021;23;NICE;MASCULIN;INDIVIDUEL;BAC PROFESSIONNEL;BAC PRO PROD;BAC PRO 22105 BOULANGER-PÂTISSIER;1;1;1;0;0;0;0;1;0;0;0;1;0;0
5482.0;2021;23;NICE;MASCULIN;INDIVIDUEL;BAC PROFESSIONNEL;BAC PRO PROD;BAC PRO 25007 MAINTENANCE EQUIPEMENTS INDUST.;1;1;1;0;0;0;0;1;0;0;0;0;1;0
5489.0;2021;23;NICE;MASCULIN;INDIVIDUEL;BAC PROFESSIONNEL;BAC PRO PROD;BAC PRO AG 21113 CGEVV;2;1;1;0;0;0;0;1;0;0;0;0;1;0
5490.0;2021;23;NICE;MASCULIN;INDIVIDUEL;BAC PROFESSIONNEL;BAC PRO SERV;BAC PRO 30001 GESTION-ADMINISTRATION;6;4;3;0;1;1;0;4;0;0;0;1;3;0
5492.0;2021;23;NICE;MASCULIN;INDIVIDUEL;BAC PROFESSIONNEL;BAC PRO SERV;BAC PRO 31202 COMMERCE;6;2;2;0;0;0;0;2;0;1;0;0;1;0
5511.0;2021;23;NICE;MASCULIN;SCOLAIRE;BAC PROFESSIONNEL;BAC PRO PROD;BAC PRO 22403 ARTS.& MET.ART:MET.ENSEIGN SIGNA;8;8;7;0;1;1;0;8;0;0;6;1;1;0
5518.0;2021;23;NICE;MASCULIN;SCOLAIRE;BAC PROFESSIONNEL;BAC PRO PROD;BACPRO 23103 TECHNICIEN GEOMETRE-TOPOGRAPHE;15;15;12;2;1;1;0;13;0;0;2;6;5;2
5523.0;2021;23;NICE;MASCULIN;SCOLAIRE;BAC PROFESSIONNEL;BAC PRO PROD;BAC PRO 23405 TECHNICIEN MENUISIER AGENCEUR;29;29;21;5;3;3;0;24;0;1;8;6;9;5
5524.0;2021;23;NICE;MASCULIN;SCOLAIRE;BAC PROFESSIONNEL;BAC PRO PROD;BAC PRO 23408 Etude et réalisation d'agencement;9;9;6;3;0;0;0;6;0;0;0;4;2;3
5534.0;2021;23;NICE;MASCULIN;SCOLAIRE;BAC PROFESSIONNEL;BAC PRO PROD;BAC PRO 25215 MAINT.VEHIC.OPTB VEHIC.TRANS.ROUT;26;26;21;2;3;2;1;23;0;0;2;9;12;3
5537.0;2021;23;NICE;MASCULIN;SCOLAIRE;BAC PROFESSIONNEL;BAC PRO PROD;BAC PRO 25406 OUVRAGES DU BATIMENT METALLERIE;15;13;10;1;2;2;0;12;0;0;1;5;6;1
5543.0;2021;23;NICE;MASCULIN;SCOLAIRE;BAC PROFESSIONNEL;BAC PRO PROD;BAC PRO 25514 SYST.NUM.OPT.B AUD.RES.EQUIP.DOM.;69;69;57;9;3;1;2;58;0;4;14;24;16;11
5544.0;2021;23;NICE;MASCULIN;SCOLAIRE;BAC PROFESSIONNEL;BAC PRO PROD;BAC PRO 25515 SYST.NUM.OPT.C RES.INF.SYST.COMM.;107;107;98;5;4;1;3;99;0;8;17;35;39;8
5547.0;2021;23;NICE;MASCULIN;SCOLAIRE;BAC PROFESSIONNEL;BAC PRO PROD;BAC PRO AG 21114 CONDUITE PRODUCTIONS HORTICOLES;12;12;11;1;0;0;0;11;0;0;1;4;6;1
5553.0;2021;23;NICE;MASCULIN;SCOLAIRE;BAC PROFESSIONNEL;BAC PRO SERV;BAC PRO 31107 CONDUCT. TRANSP.ROUT.MARCHANDISES;15;15;10;5;0;0;0;10;0;0;2;3;5;5
5554.0;2021;23;NICE;MASCULIN;SCOLAIRE;BAC PROFESSIONNEL;BAC PRO SERV;BAC PRO 31108 TRANSPORT;15;14;11;3;0;0;0;11;0;0;3;3;5;3
5556.0;2021;23;NICE;MASCULIN;SCOLAIRE;BAC PROFESSIONNEL;BAC PRO SERV;BAC PRO 31206 VENTE (PROSPECT.NEGO.SUIV.CLIENT;176;176;133;31;12;8;4;141;0;3;19;55;64;35
5570.0;2021;23;NICE;MASCULIN;SCOLAIRE;BAC TECHNOLOGIQUE;BAC S2TMD;BAC S2TMD MUSIQUE;6;6;6;0;0;0;0;6;0;0;3;2;1;0
5573.0;2021;23;NICE;MASCULIN;SCOLAIRE;BAC TECHNOLOGIQUE;BAC STD2A;BAC STD2A SCIENCES & TECHNO. DESIGN-ARTS APPLIQUES;28;28;28;0;0;0;0;28;0;2;9;9;8;0
5576.0;2021;23;NICE;MASCULIN;SCOLAIRE;BAC TECHNOLOGIQUE;BAC STI2D;BAC STI2D ENERGIES  ET ENVIRONNEMENT;132;132;118;6;8;5;3;123;0;0;20;61;42;9
5585.0;2021;70;NORMANDIE;FEMININ;APPRENTISSAGE;BAC PROFESSIONNEL;BAC PRO PROD;BAC PRO 20102 PILOTE DE LIGNE DE PRODUCTION;1;1;1;0;0;0;0;1;0;0;1;0;0;0
5590.0;2021;70;NORMANDIE;FEMININ;APPRENTISSAGE;BAC PROFESSIONNEL;BAC PRO PROD;BAC PRO 24203 METIERS DE LA MODE - VÊTEMENT;2;2;2;0;0;0;0;2;0;0;1;1;0;0
5593.0;2021;70;NORMANDIE;FEMININ;APPRENTISSAGE;BAC PROFESSIONNEL;BAC PRO PROD;BAC PRO 25214 MAINT.VEHIC.OPTA VOIT.PARTICUL.;4;4;3;0;1;1;0;4;0;0;0;1;3;0
5595.0;2021;70;NORMANDIE;FEMININ;APPRENTISSAGE;BAC PROFESSIONNEL;BAC PRO PROD;BAC PRO 25216 MAINT.VEHIC.OPTC MOTOCYCLES;1;1;1;0;0;0;0;1;0;0;0;1;0;0
5597.0;2021;70;NORMANDIE;FEMININ;APPRENTISSAGE;BAC PROFESSIONNEL;BAC PRO PROD;BAC PRO 25411 TECH.CHAUDRONNERIE INDUSTRIELLE;2;2;2;0;0;0;0;2;0;0;0;0;2;0
5613.0;2021;70;NORMANDIE;FEMININ;APPRENTISSAGE;BAC PROFESSIONNEL;BAC PRO SERV;BAC PRO 34304 HYGIENE PROPRETE STERILISATION;1;1;1;0;0;0;0;1;0;0;1;0;0;0
5614.0;2021;70;NORMANDIE;FEMININ;APPRENTISSAGE;BAC PROFESSIONNEL;BAC PRO SERV;BAC PRO 34305 TECHN.D'INTERV.SUR INSTALL. NUCL.;1;1;1;0;0;0;0;1;0;0;0;1;0;0
5617.0;2021;70;NORMANDIE;FEMININ;ENSEIGNEMENT A DISTANCE;BAC PROFESSIONNEL;BAC PRO SERV;BAC PRO 30001 GESTION-ADMINISTRATION;7;5;4;1;0;0;0;4;0;0;0;1;3;1
5618.0;2021;70;NORMANDIE;FEMININ;ENSEIGNEMENT A DISTANCE;BAC PROFESSIONNEL;BAC PRO SERV;BAC PRO 31202 COMMERCE;1;1;1;0;0;0;0;1;0;0;0;1;0;0
5621.0;2021;70;NORMANDIE;FEMININ;ENSEIGNEMENT A DISTANCE;BAC TECHNOLOGIQUE;BAC ST2S;BAC ST2S SCIENCES & TECHNO. SANTE & SOCIAL;5;4;4;0;0;0;0;4;0;0;1;2;1;0
5627.0;2021;70;NORMANDIE;FEMININ;FORMATION CONTINUE;BAC PROFESSIONNEL;BAC PRO PROD;BAC PRO 22704 TECHN. MAINT. SYST.ENERG.CLIMATI;2;2;2;0;0;0;0;2;0;2;0;0;0;0
5632.0;2021;70;NORMANDIE;FEMININ;FORMATION CONTINUE;BAC PROFESSIONNEL;BAC PRO SERV;BAC PRO 31106 LOGISTIQUE;1;1;1;0;0;0;0;1;0;0;0;1;0;0
5634.0;2021;70;NORMANDIE;FEMININ;FORMATION CONTINUE;BAC PROFESSIONNEL;BAC PRO SERV;BAC PRO 31210 ACCUEIL -RELATION CLIENTS USAGERS;8;8;7;1;0;0;0;7;0;2;3;2;0;1
5643.0;2021;70;NORMANDIE;FEMININ;INDIVIDUEL;BAC PROFESSIONNEL;BAC PRO SERV;BAC PRO 31202 COMMERCE;1;1;1;0;0;0;0;1;0;0;0;0;1;0
5650.0;2021;70;NORMANDIE;FEMININ;INDIVIDUEL;BAC TECHNOLOGIQUE;BAC ST2S;BAC ST2S SCIENCES & TECHNO. SANTE & SOCIAL;6;5;4;0;1;1;0;5;0;0;0;1;4;0
5655.0;2021;70;NORMANDIE;FEMININ;INDIVIDUEL;BAC TECHNOLOGIQUE;BAC STMG;BAC STMG RESSOURCES HUMAINES ET COMMUNICATION;6;4;0;2;2;2;0;2;0;0;0;0;2;2
5665.0;2021;70;NORMANDIE;FEMININ;SCOLAIRE;BAC PROFESSIONNEL;BAC PRO PROD;BAC PRO 23003 ARTIS. & M.ART:MARCHANDISAGE VIS.;8;8;8;0;0;0;0;8;0;0;1;5;2;0
5666.0;2021;70;NORMANDIE;FEMININ;SCOLAIRE;BAC PROFESSIONNEL;BAC PRO PROD;BAC PRO 23004 TECHN. ETUDES BAT.A ETUDES & ECO.;18;17;16;0;1;0;1;16;0;3;4;4;5;1
5667.0;2021;70;NORMANDIE;FEMININ;SCOLAIRE;BAC PROFESSIONNEL;BAC PRO PROD;BAC PRO 23005 TECHN. ETUDES BAT B ASSIST.ARCHI.;13;13;13;0;0;0;0;13;0;1;8;3;1;0
5668.0;2021;70;NORMANDIE;FEMININ;SCOLAIRE;BAC PROFESSIONNEL;BAC PRO PROD;BACPRO 23103 TECHNICIEN GEOMETRE-TOPOGRAPHE;1;1;1;0;0;0;0;1;0;0;0;1;0;0
5670.0;2021;70;NORMANDIE;FEMININ;SCOLAIRE;BAC PROFESSIONNEL;BAC PRO PROD;BAC PRO 23304 AMENAGEMENT FINITION BATIMENT;8;8;5;3;0;0;0;5;0;0;2;1;2;3
5673.0;2021;70;NORMANDIE;FEMININ;SCOLAIRE;BAC PROFESSIONNEL;BAC PRO PROD;BAC PRO 23408 Etude et réalisation d'agencement;18;18;18;0;0;0;0;18;0;4;5;7;2;0
5675.0;2021;70;NORMANDIE;FEMININ;SCOLAIRE;BAC PROFESSIONNEL;BAC PRO PROD;BAC PRO 24203 METIERS DE LA MODE - VÊTEMENT;161;160;132;21;7;5;2;137;0;19;43;38;37;23
5678.0;2021;70;NORMANDIE;FEMININ;SCOLAIRE;BAC PROFESSIONNEL;BAC PRO PROD;BAC PRO 25007 MAINTENANCE EQUIPEMENTS INDUST.;12;12;10;2;0;0;0;10;0;0;4;4;2;2
5682.0;2021;70;NORMANDIE;FEMININ;SCOLAIRE;BAC PROFESSIONNEL;BAC PRO PROD;BAC PRO 25216 MAINT.VEHIC.OPTC MOTOCYCLES;1;1;1;0;0;0;0;1;0;0;0;0;1;0
5683.0;2021;70;NORMANDIE;FEMININ;SCOLAIRE;BAC PROFESSIONNEL;BAC PRO PROD;BAC PRO 25408 REPARATION DES CARROSSERIES;1;1;0;1;0;0;0;0;0;0;0;0;0;1
5690.0;2021;70;NORMANDIE;FEMININ;SCOLAIRE;BAC PROFESSIONNEL;BAC PRO PROD;BAC PRO AG 21004 CGEA;103;101;86;15;0;0;0;86;0;1;12;26;47;15
5691.0;2021;70;NORMANDIE;FEMININ;SCOLAIRE;BAC PROFESSIONNEL;BAC PRO PROD;BAC PRO AG 21114 CONDUITE PRODUCTIONS HORTICOLES;26;26;22;4;0;0;0;22;0;0;6;7;9;4
5693.0;2021;70;NORMANDIE;FEMININ;SCOLAIRE;BAC PROFESSIONNEL;BAC PRO PROD;BAC PRO AG 21210 COND GEST ENTR CANIN ET FELIN;52;52;48;4;0;0;0;48;0;0;5;20;23;4
5699.0;2021;70;NORMANDIE;FEMININ;SCOLAIRE;BAC PROFESSIONNEL;BAC PRO PROD;BAC PRO AG 22105 LABORATOIRE CONTROLE QUALITE;19;19;19;0;0;0;0;19;0;0;6;6;7;0
5725.0;2021;70;NORMANDIE;FEMININ;SCOLAIRE;BAC TECHNOLOGIQUE;BAC S2TMD;BAC S2TMD MUSIQUE;7;7;6;1;0;0;0;6;0;2;3;1;0;1
5727.0;2021;70;NORMANDIE;FEMININ;SCOLAIRE;BAC TECHNOLOGIQUE;BAC STAV;BAC STAV AGRONOMIE ALIM ENV TERRITOI;137;137;133;4;0;0;0;133;0;5;19;57;52;4
5730.0;2021;70;NORMANDIE;FEMININ;SCOLAIRE;BAC TECHNOLOGIQUE;BAC STI2D;BAC STI2D ARCHITECTURE ET CONSTRUCTION;22;22;21;0;1;1;0;22;0;2;2;12;6;0
5733.0;2021;70;NORMANDIE;FEMININ;SCOLAIRE;BAC TECHNOLOGIQUE;BAC STI2D;BAC STI2D SYSTÈME D'INFORMATION  ET NUMERIQUE;21;21;20;0;1;0;1;20;0;1;6;4;9;1
5752.0;2021;70;NORMANDIE;MASCULIN;APPRENTISSAGE;BAC PROFESSIONNEL;BAC PRO PROD;BAC PRO 23404 TECHNICIEN CONSTRUCTEUR BOIS;13;13;10;1;2;0;2;10;0;1;1;3;5;3
5761.0;2021;70;NORMANDIE;MASCULIN;APPRENTISSAGE;BAC PROFESSIONNEL;BAC PRO PROD;BAC PRO 25216 MAINT.VEHIC.OPTC MOTOCYCLES;18;18;17;1;0;0;0;17;0;2;7;4;4;1
5766.0;2021;70;NORMANDIE;MASCULIN;APPRENTISSAGE;BAC PROFESSIONNEL;BAC PRO PROD;BAC PRO 25509 TECHNIC. FROID CONDITIONNEMT AIR;6;6;4;1;1;0;1;4;0;1;2;0;1;2
5777.0;2021;70;NORMANDIE;MASCULIN;APPRENTISSAGE;BAC PROFESSIONNEL;BAC PRO PROD;BAC PRO AG 21303 FORET;6;6;6;0;0;0;0;6;0;0;1;3;2;0
5786.0;2021;70;NORMANDIE;MASCULIN;APPRENTISSAGE;BAC PROFESSIONNEL;BAC PRO SERV;BAC PRO 32207 REAL.PR.IMPR.PLURI.OPTA.PR.GRAPH.;2;2;2;0;0;0;0;2;0;0;1;1;0;0
5788.0;2021;70;NORMANDIE;MASCULIN;APPRENTISSAGE;BAC PROFESSIONNEL;BAC PRO SERV;BAC PRO 33403 COMMERC. SERVICES EN RESTAURATION;6;6;4;1;1;1;0;5;0;0;0;3;2;1
5799.0;2021;70;NORMANDIE;MASCULIN;FORMATION CONTINUE;BAC PROFESSIONNEL;BAC PRO PROD;BAC PRO 22004 PROC. CHIMIE EAU PAPIERS-CARTONS;12;11;11;0;0;0;0;11;0;7;4;0;0;0
5803.0;2021;70;NORMANDIE;MASCULIN;FORMATION CONTINUE;BAC PROFESSIONNEL;BAC PRO PROD;BAC PRO 23404 TECHNICIEN CONSTRUCTEUR BOIS;1;1;1;0;0;0;0;1;0;0;1;0;0;0
5814.0;2021;70;NORMANDIE;MASCULIN;FORMATION CONTINUE;BAC PROFESSIONNEL;BAC PRO SERV;BAC PRO 30001 GESTION-ADMINISTRATION;5;5;5;0;0;0;0;5;0;1;2;2;0;0
5816.0;2021;70;NORMANDIE;MASCULIN;FORMATION CONTINUE;BAC PROFESSIONNEL;BAC PRO SERV;BAC PRO 31210 ACCUEIL -RELATION CLIENTS USAGERS;1;1;1;0;0;0;0;1;0;0;1;0;0;0
5818.0;2021;70;NORMANDIE;MASCULIN;FORMATION CONTINUE;BAC PROFESSIONNEL;BAC PRO SERV;BAC PRO 34303 GEST. POLLUTIONS PROTEC. ENVIRON.;1;0;0;0;0;0;0;0;0;0;0;0;0;0
5821.0;2021;70;NORMANDIE;MASCULIN;INDIVIDUEL;BAC PROFESSIONNEL;BAC PRO PROD;BAC PRO 22105 BOULANGER-PÂTISSIER;1;0;0;0;0;0;0;0;0;0;0;0;0;0
5822.0;2021;70;NORMANDIE;MASCULIN;INDIVIDUEL;BAC PROFESSIONNEL;BAC PRO PROD;BAC PRO 22106 CUISINE;1;0;0;0;0;0;0;0;0;0;0;0;0;0
5825.0;2021;70;NORMANDIE;MASCULIN;INDIVIDUEL;BAC PROFESSIONNEL;BAC PRO PROD;BAC PRO 25214 MAINT.VEHIC.OPTA VOIT.PARTICUL.;2;2;0;0;2;0;2;0;0;0;0;0;0;2
5827.0;2021;70;NORMANDIE;MASCULIN;INDIVIDUEL;BAC PROFESSIONNEL;BAC PRO PROD;BAC PRO 25216 MAINT.VEHIC.OPTC MOTOCYCLES;1;0;0;0;0;0;0;0;0;0;0;0;0;0
5831.0;2021;70;NORMANDIE;MASCULIN;INDIVIDUEL;BAC PROFESSIONNEL;BAC PRO PROD;BAC PRO 25515 SYST.NUM.OPT.C RES.INF.SYST.COMM.;1;1;0;1;0;0;0;0;0;0;0;0;0;1
5832.0;2021;70;NORMANDIE;MASCULIN;INDIVIDUEL;BAC PROFESSIONNEL;BAC PRO PROD;BAC PRO AG 21004 CGEA;9;7;6;1;0;0;0;6;0;0;0;0;6;1
5839.0;2021;70;NORMANDIE;MASCULIN;INDIVIDUEL;BAC PROFESSIONNEL;BAC PRO SERV;BAC PRO 31206 VENTE (PROSPECT.NEGO.SUIV.CLIENT;1;1;1;0;0;0;0;1;0;0;0;0;1;0
5842.0;2021;70;NORMANDIE;MASCULIN;INDIVIDUEL;BAC TECHNOLOGIQUE;BAC STHR;BAC STHR SC.&TEC. HOTELLERIE-RESTAURATION;1;1;0;0;1;0;1;0;0;0;0;0;0;1
5843.0;2021;70;NORMANDIE;MASCULIN;INDIVIDUEL;BAC TECHNOLOGIQUE;BAC STI2D;BAC STI2D INNOVATION TECHNO.  ET ECO CONCEPTION;2;1;0;1;0;0;0;0;0;0;0;0;0;1
5846.0;2021;70;NORMANDIE;MASCULIN;INDIVIDUEL;BAC TECHNOLOGIQUE;BAC STMG;BAC STMG MERCATIQUE (MARKETING);22;20;10;9;1;1;0;11;0;0;1;2;8;9
5854.0;2021;70;NORMANDIE;MASCULIN;SCOLAIRE;BAC PROFESSIONNEL;BAC PRO PROD;BAC PRO 22105 BOULANGER-PÂTISSIER;35;35;33;0;2;1;1;34;0;4;16;11;3;1
5855.0;2021;70;NORMANDIE;MASCULIN;SCOLAIRE;BAC PROFESSIONNEL;BAC PRO PROD;BAC PRO 22106 CUISINE;160;158;140;9;9;6;3;146;0;9;43;51;43;12
5857.0;2021;70;NORMANDIE;MASCULIN;SCOLAIRE;BAC PROFESSIONNEL;BAC PRO PROD;BAC PRO 22503 PLASTIQUES ET COMPOSITES;23;23;17;6;0;0;0;17;0;0;6;6;5;6
5859.0;2021;70;NORMANDIE;MASCULIN;SCOLAIRE;BAC PROFESSIONNEL;BAC PRO PROD;BAC PRO 22704 TECHN. MAINT. SYST.ENERG.CLIMATI;45;45;34;8;3;2;1;36;0;2;5;15;14;9
5864.0;2021;70;NORMANDIE;MASCULIN;SCOLAIRE;BAC PROFESSIONNEL;BAC PRO PROD;BACPRO 23103 TECHNICIEN GEOMETRE-TOPOGRAPHE;19;19;17;1;1;1;0;18;0;1;3;9;5;1
5866.0;2021;70;NORMANDIE;MASCULIN;SCOLAIRE;BAC PROFESSIONNEL;BAC PRO PROD;BAC PRO 23205 INTERV. SUR PATRIMOINE BATI OPT.A;5;5;3;1;1;1;0;4;0;0;1;1;2;1
5869.0;2021;70;NORMANDIE;MASCULIN;SCOLAIRE;BAC PROFESSIONNEL;BAC PRO PROD;BAC PRO 23404 TECHNICIEN CONSTRUCTEUR BOIS;51;51;42;6;3;2;1;44;0;0;3;17;24;7
5873.0;2021;70;NORMANDIE;MASCULIN;SCOLAIRE;BAC PROFESSIONNEL;BAC PRO PROD;BAC PRO 23408 Etude et réalisation d'agencement;3;3;3;0;0;0;0;3;0;0;1;2;0;0
5878.0;2021;70;NORMANDIE;MASCULIN;SCOLAIRE;BAC PROFESSIONNEL;BAC PRO PROD;BAC PRO 25009 MAINTENANCE NAUTIQUE;16;16;10;5;1;1;0;11;0;2;2;4;3;5
5887.0;2021;70;NORMANDIE;MASCULIN;SCOLAIRE;BAC PROFESSIONNEL;BAC PRO PROD;BAC PRO 25406 OUVRAGES DU BATIMENT METALLERIE;34;34;26;2;6;1;5;27;0;1;3;13;10;7
5889.0;2021;70;NORMANDIE;MASCULIN;SCOLAIRE;BAC PROFESSIONNEL;BAC PRO PROD;BAC PRO 25411 TECH.CHAUDRONNERIE INDUSTRIELLE;223;223;186;30;7;5;2;191;0;23;32;73;63;32
5893.0;2021;70;NORMANDIE;MASCULIN;SCOLAIRE;BAC PROFESSIONNEL;BAC PRO PROD;BAC PRO 25514 SYST.NUM.OPT.B AUD.RES.EQUIP.DOM.;70;70;65;3;2;2;0;67;0;2;17;33;15;3
5894.0;2021;70;NORMANDIE;MASCULIN;SCOLAIRE;BAC PROFESSIONNEL;BAC PRO PROD;BAC PRO 25515 SYST.NUM.OPT.C RES.INF.SYST.COMM.;176;176;156;17;3;2;1;158;0;13;42;59;44;18
5895.0;2021;70;NORMANDIE;MASCULIN;SCOLAIRE;BAC PROFESSIONNEL;BAC PRO PROD;BAC PRO AG 21001 AGRO-EQUIPEMENT;72;72;64;8;0;0;0;64;0;1;3;18;42;8
5914.0;2021;70;NORMANDIE;MASCULIN;SCOLAIRE;BAC PROFESSIONNEL;BAC PRO SERV;BAC PRO 31210 ACCUEIL -RELATION CLIENTS USAGERS;48;48;38;8;2;1;1;39;0;1;8;15;15;9
5918.0;2021;70;NORMANDIE;MASCULIN;SCOLAIRE;BAC PROFESSIONNEL;BAC PRO SERV;BAC PRO 32304 PHOTOGRAPHIE;7;7;7;0;0;0;0;7;0;1;3;1;2;0
5928.0;2021;70;NORMANDIE;MASCULIN;SCOLAIRE;BAC PROFESSIONNEL;BAC PRO SERV;BAC PRO 34403 METIERS DE LA SECURITE;71;71;66;3;2;2;0;68;0;5;21;26;16;3
5933.0;2021;70;NORMANDIE;MASCULIN;SCOLAIRE;BAC TECHNOLOGIQUE;BAC STAV;BAC STAV AGRONOMIE ALIM ENV TERRITOI;163;163;160;3;0;0;0;160;0;3;27;90;40;3
5936.0;2021;70;NORMANDIE;MASCULIN;SCOLAIRE;BAC TECHNOLOGIQUE;BAC STI2D;BAC STI2D ARCHITECTURE ET CONSTRUCTION;144;143;133;2;8;3;5;136;0;3;17;54;62;7
5939.0;2021;70;NORMANDIE;MASCULIN;SCOLAIRE;BAC TECHNOLOGIQUE;BAC STI2D;BAC STI2D SYSTÈME D'INFORMATION  ET NUMERIQUE;378;378;341;7;30;23;7;364;0;7;60;141;156;14
5950.0;2021;18;ORLEANS-TOURS;FEMININ;APPRENTISSAGE;BAC PROFESSIONNEL;BAC PRO PROD;BAC PRO 25107 TECHNICIEN OUTILLEUR;1;1;1;0;0;0;0;1;0;0;0;1;0;0
5954.0;2021;18;ORLEANS-TOURS;FEMININ;APPRENTISSAGE;BAC PROFESSIONNEL;BAC PRO PROD;BAC PRO 25411 TECH.CHAUDRONNERIE INDUSTRIELLE;1;1;1;0;0;0;0;1;0;0;0;0;1;0
5962.0;2021;18;ORLEANS-TOURS;FEMININ;APPRENTISSAGE;BAC PROFESSIONNEL;BAC PRO PROD;BAC PRO AG 21406 TEC CONS VTE PROD DES JARDINS;2;2;2;0;0;0;0;2;0;1;0;1;0;0
5964.0;2021;18;ORLEANS-TOURS;FEMININ;APPRENTISSAGE;BAC PROFESSIONNEL;BAC PRO SERV;BAC PRO 31106 LOGISTIQUE;1;1;1;0;0;0;0;1;0;0;0;1;0;0
5967.0;2021;18;ORLEANS-TOURS;FEMININ;APPRENTISSAGE;BAC PROFESSIONNEL;BAC PRO SERV;BAC PRO 31210 ACCUEIL -RELATION CLIENTS USAGERS;7;7;7;0;0;0;0;7;0;2;1;2;2;0
5968.0;2021;18;ORLEANS-TOURS;FEMININ;APPRENTISSAGE;BAC PROFESSIONNEL;BAC PRO SERV;BAC PRO 33002 SERVICES DE PROXIMITE  VIE LOCAL;1;1;1;0;0;0;0;1;0;0;0;1;0;0
5972.0;2021;18;ORLEANS-TOURS;FEMININ;ENSEIGNEMENT A DISTANCE;BAC GENERAL;BAC GENERAL;BAC GENE 10019 BAC GENERAL;47;45;39;3;3;0;3;39;1;11;10;11;6;6
5975.0;2021;18;ORLEANS-TOURS;FEMININ;ENSEIGNEMENT A DISTANCE;BAC TECHNOLOGIQUE;BAC STMG;BAC STMG MERCATIQUE (MARKETING);5;4;4;0;0;0;0;4;0;0;1;1;2;0
5977.0;2021;18;ORLEANS-TOURS;FEMININ;FORMATION CONTINUE;BAC PROFESSIONNEL;BAC PRO PROD;BAC PRO 25007 MAINTENANCE EQUIPEMENTS INDUST.;1;1;1;0;0;0;0;1;0;0;1;0;0;0
5980.0;2021;18;ORLEANS-TOURS;FEMININ;FORMATION CONTINUE;BAC PROFESSIONNEL;BAC PRO PROD;BAC PRO AG 21113 CGEVV;6;6;6;0;0;0;0;6;0;0;0;0;6;0
5981.0;2021;18;ORLEANS-TOURS;FEMININ;FORMATION CONTINUE;BAC PROFESSIONNEL;BAC PRO PROD;BAC PRO AG 21405 AMENAGEMENTS PAYSAGERS;3;3;3;0;0;0;0;3;0;0;0;1;2;0
5984.0;2021;18;ORLEANS-TOURS;FEMININ;INDIVIDUEL;BAC GENERAL;BAC GENERAL;BAC GENE 10019 BAC GENERAL;57;40;13;15;12;5;7;18;0;0;2;4;12;22
5985.0;2021;18;ORLEANS-TOURS;FEMININ;INDIVIDUEL;BAC PROFESSIONNEL;BAC PRO PROD;BAC PRO 24203 METIERS DE LA MODE - VÊTEMENT;1;1;0;0;1;1;0;1;0;0;0;0;1;0
6009.0;2021;18;ORLEANS-TOURS;FEMININ;SCOLAIRE;BAC PROFESSIONNEL;BAC PRO PROD;BAC PRO 22105 BOULANGER-PÂTISSIER;17;16;16;0;0;0;0;16;0;4;4;7;1;0
6012.0;2021;18;ORLEANS-TOURS;FEMININ;SCOLAIRE;BAC PROFESSIONNEL;BAC PRO PROD;BAC PRO 22503 PLASTIQUES ET COMPOSITES;2;2;1;1;0;0;0;1;0;0;0;0;1;1
6025.0;2021;18;ORLEANS-TOURS;FEMININ;SCOLAIRE;BAC PROFESSIONNEL;BAC PRO PROD;BAC PRO 25108 TECHNICIEN MODELEUR;5;5;5;0;0;0;0;5;0;0;1;3;1;0
6030.0;2021;18;ORLEANS-TOURS;FEMININ;SCOLAIRE;BAC PROFESSIONNEL;BAC PRO PROD;BAC PRO 25408 REPARATION DES CARROSSERIES;3;3;3;0;0;0;0;3;0;0;1;2;0;0
6033.0;2021;18;ORLEANS-TOURS;FEMININ;SCOLAIRE;BAC PROFESSIONNEL;BAC PRO PROD;BAC PRO 25510 METIERS ELECT. ENVIRON. CONNECTES;9;9;8;1;0;0;0;8;0;2;0;4;2;1
6037.0;2021;18;ORLEANS-TOURS;FEMININ;SCOLAIRE;BAC PROFESSIONNEL;BAC PRO PROD;BAC PRO AG 21113 CGEVV;5;5;5;0;0;0;0;5;0;0;1;2;2;0
6041.0;2021;18;ORLEANS-TOURS;FEMININ;SCOLAIRE;BAC PROFESSIONNEL;BAC PRO PROD;BAC PRO AG 21212 TECH EXPE ANIMALE;9;9;9;0;0;0;0;9;0;0;1;5;3;0
6051.0;2021;18;ORLEANS-TOURS;FEMININ;SCOLAIRE;BAC PROFESSIONNEL;BAC PRO SERV;BAC PRO 31108 TRANSPORT;4;4;3;1;0;0;0;3;0;0;2;1;0;1
6058.0;2021;18;ORLEANS-TOURS;FEMININ;SCOLAIRE;BAC PROFESSIONNEL;BAC PRO SERV;BAC PRO 32304 PHOTOGRAPHIE;15;15;13;2;0;0;0;13;0;0;4;3;6;2
6060.0;2021;18;ORLEANS-TOURS;FEMININ;SCOLAIRE;BAC PROFESSIONNEL;BAC PRO SERV;BAC PRO 33003 ACC.SOINS-S.PERS. OPT.A DOMICILE;204;204;175;18;11;8;3;183;0;5;46;77;55;21
6064.0;2021;18;ORLEANS-TOURS;FEMININ;SCOLAIRE;BAC PROFESSIONNEL;BAC PRO SERV;BAC PRO 33603 ESTHETIQUE COSMETIQUE PARFUMERIE;122;122;116;6;0;0;0;116;0;6;40;46;24;6
6071.0;2021;18;ORLEANS-TOURS;FEMININ;SCOLAIRE;BAC TECHNOLOGIQUE;BAC ST2S;BAC ST2S SCIENCES & TECHNO. SANTE & SOCIAL;597;596;567;3;26;13;13;580;1;19;135;247;178;16
6073.0;2021;18;ORLEANS-TOURS;FEMININ;SCOLAIRE;BAC TECHNOLOGIQUE;BAC STD2A;BAC STD2A SCIENCES & TECHNO. DESIGN-ARTS APPLIQUES;175;175;172;1;2;1;1;173;2;18;58;67;28;2
6074.0;2021;18;ORLEANS-TOURS;FEMININ;SCOLAIRE;BAC TECHNOLOGIQUE;BAC STHR;BAC STHR SC.&TEC. HOTELLERIE-RESTAURATION;59;59;59;0;0;0;0;59;0;3;13;26;17;0
6075.0;2021;18;ORLEANS-TOURS;FEMININ;SCOLAIRE;BAC TECHNOLOGIQUE;BAC STI2D;BAC STI2D ARCHITECTURE ET CONSTRUCTION;18;18;18;0;0;0;0;18;0;1;6;6;5;0
6077.0;2021;18;ORLEANS-TOURS;FEMININ;SCOLAIRE;BAC TECHNOLOGIQUE;BAC STI2D;BAC STI2D INNOVATION TECHNO.  ET ECO CONCEPTION;19;19;16;0;3;1;2;17;0;0;3;9;5;2
6078.0;2021;18;ORLEANS-TOURS;FEMININ;SCOLAIRE;BAC TECHNOLOGIQUE;BAC STI2D;BAC STI2D SYSTÈME D'INFORMATION  ET NUMERIQUE;15;15;13;0;2;1;1;14;0;1;5;4;4;1
6090.0;2021;18;ORLEANS-TOURS;MASCULIN;APPRENTISSAGE;BAC PROFESSIONNEL;BAC PRO PROD;BAC PRO 23205 INTERV. SUR PATRIMOINE BATI OPT.A;6;6;3;2;1;1;0;4;0;0;0;1;3;2
6108.0;2021;18;ORLEANS-TOURS;MASCULIN;APPRENTISSAGE;BAC PROFESSIONNEL;BAC PRO PROD;BAC PRO 25510 METIERS ELECT. ENVIRON. CONNECTES;65;64;52;10;2;1;1;53;0;3;17;16;17;11
6111.0;2021;18;ORLEANS-TOURS;MASCULIN;APPRENTISSAGE;BAC PROFESSIONNEL;BAC PRO PROD;BAC PRO 25515 SYST.NUM.OPT.C RES.INF.SYST.COMM.;8;8;7;1;0;0;0;7;0;0;5;1;1;1
6112.0;2021;18;ORLEANS-TOURS;MASCULIN;APPRENTISSAGE;BAC PROFESSIONNEL;BAC PRO PROD;BAC PRO AG 21001 AGRO-EQUIPEMENT;4;3;3;0;0;0;0;3;0;0;0;1;2;0
6115.0;2021;18;ORLEANS-TOURS;MASCULIN;APPRENTISSAGE;BAC PROFESSIONNEL;BAC PRO PROD;BAC PRO AG 21203 TECHN CONSEIL DE VENTE ANIMAL;2;2;2;0;0;0;0;2;0;0;0;1;1;0
6116.0;2021;18;ORLEANS-TOURS;MASCULIN;APPRENTISSAGE;BAC PROFESSIONNEL;BAC PRO PROD;BAC PRO AG 21303 FORET;12;12;12;0;0;0;0;12;0;0;1;4;7;0
6119.0;2021;18;ORLEANS-TOURS;MASCULIN;APPRENTISSAGE;BAC PROFESSIONNEL;BAC PRO SERV;BAC PRO 31106 LOGISTIQUE;19;19;11;3;5;3;2;14;0;0;0;3;11;5
6124.0;2021;18;ORLEANS-TOURS;MASCULIN;APPRENTISSAGE;BAC PROFESSIONNEL;BAC PRO SERV;BAC PRO 32208 REAL.PR.IMPR.PLURI.OPTB.PR.IMPR.;6;6;5;1;0;0;0;5;0;0;0;4;1;1
6126.0;2021;18;ORLEANS-TOURS;MASCULIN;APPRENTISSAGE;BAC PROFESSIONNEL;BAC PRO SERV;BAC PRO 33403 COMMERC. SERVICES EN RESTAURATION;3;3;2;1;0;0;0;2;0;0;0;1;1;1
6133.0;2021;18;ORLEANS-TOURS;MASCULIN;FORMATION CONTINUE;BAC PROFESSIONNEL;BAC PRO PROD;BAC PRO 22303 FONDERIE;1;1;1;0;0;0;0;1;0;0;1;0;0;0
6137.0;2021;18;ORLEANS-TOURS;MASCULIN;FORMATION CONTINUE;BAC PROFESSIONNEL;BAC PRO PROD;BACPRO 23103 TECHNICIEN GEOMETRE-TOPOGRAPHE;1;1;1;0;0;0;0;1;0;0;0;1;0;0
6142.0;2021;18;ORLEANS-TOURS;MASCULIN;FORMATION CONTINUE;BAC PROFESSIONNEL;BAC PRO PROD;BAC PRO 25219 MAINT.MATERIELS OPT.A AGRICOLES;1;1;1;0;0;0;0;1;0;1;0;0;0;0
6145.0;2021;18;ORLEANS-TOURS;MASCULIN;FORMATION CONTINUE;BAC PROFESSIONNEL;BAC PRO PROD;BAC PRO 25410 CONSTRUCTION DES CARROSSERIES;2;2;2;0;0;0;0;2;0;1;0;1;0;0
6148.0;2021;18;ORLEANS-TOURS;MASCULIN;FORMATION CONTINUE;BAC PROFESSIONNEL;BAC PRO PROD;BAC PRO 25510 METIERS ELECT. ENVIRON. CONNECTES;1;1;1;0;0;0;0;1;0;1;0;0;0;0
6152.0;2021;18;ORLEANS-TOURS;MASCULIN;FORMATION CONTINUE;BAC PROFESSIONNEL;BAC PRO SERV;BAC PRO 31106 LOGISTIQUE;1;1;1;0;0;0;0;1;0;1;0;0;0;0
6154.0;2021;18;ORLEANS-TOURS;MASCULIN;INDIVIDUEL;BAC GENERAL;BAC GENERAL;BAC GENE 10019 BAC GENERAL;56;41;22;14;5;4;1;26;1;3;5;8;9;15
6158.0;2021;18;ORLEANS-TOURS;MASCULIN;INDIVIDUEL;BAC PROFESSIONNEL;BAC PRO PROD;BAC PRO 25007 MAINTENANCE EQUIPEMENTS INDUST.;1;1;0;1;0;0;0;0;0;0;0;0;0;1
6171.0;2021;18;ORLEANS-TOURS;MASCULIN;INDIVIDUEL;BAC PROFESSIONNEL;BAC PRO SERV;BAC PRO 31106 LOGISTIQUE;2;1;1;0;0;0;0;1;0;0;0;1;0;0
6181.0;2021;18;ORLEANS-TOURS;MASCULIN;INDIVIDUEL;BAC TECHNOLOGIQUE;BAC STI2D;BAC STI2D SYSTÈME D'INFORMATION  ET NUMERIQUE;1;1;1;0;0;0;0;1;0;0;0;0;1;0
6182.0;2021;18;ORLEANS-TOURS;MASCULIN;INDIVIDUEL;BAC TECHNOLOGIQUE;BAC STL;BAC STL BIOCHIM.-BIOLOGIE-BIOTECHNOL.;1;1;0;1;0;0;0;0;0;0;0;0;0;1
6189.0;2021;18;ORLEANS-TOURS;MASCULIN;SCOLAIRE;BAC PROFESSIONNEL;BAC PRO PROD;BAC PRO 22003 BIO-INDUSTRIES DE TRANSFORMATION;14;14;11;2;1;0;1;11;0;0;1;5;5;3
6194.0;2021;18;ORLEANS-TOURS;MASCULIN;SCOLAIRE;BAC PROFESSIONNEL;BAC PRO PROD;BAC PRO 22503 PLASTIQUES ET COMPOSITES;18;18;15;2;1;0;1;15;0;0;3;8;4;3
6199.0;2021;18;ORLEANS-TOURS;MASCULIN;SCOLAIRE;BAC PROFESSIONNEL;BAC PRO PROD;BAC PRO 23005 TECHN. ETUDES BAT B ASSIST.ARCHI.;40;40;31;7;2;1;1;32;0;0;1;20;11;8
6204.0;2021;18;ORLEANS-TOURS;MASCULIN;SCOLAIRE;BAC PROFESSIONNEL;BAC PRO PROD;BAC PRO 23208 METIERS ET ARTS DE LA PIERRE;5;5;3;2;0;0;0;3;0;0;2;0;1;2
6207.0;2021;18;ORLEANS-TOURS;MASCULIN;SCOLAIRE;BAC PROFESSIONNEL;BAC PRO PROD;BAC PRO 23404 TECHNICIEN CONSTRUCTEUR BOIS;17;17;7;8;2;1;1;8;0;1;2;2;3;9
6210.0;2021;18;ORLEANS-TOURS;MASCULIN;SCOLAIRE;BAC PROFESSIONNEL;BAC PRO PROD;BAC PRO 24202 ARTIS.& MET.ART : TAPIS.D'AMEUBL;1;0;0;0;0;0;0;0;0;0;0;0;0;0
6215.0;2021;18;ORLEANS-TOURS;MASCULIN;SCOLAIRE;BAC PROFESSIONNEL;BAC PRO PROD;BAC PRO 25007 MAINTENANCE EQUIPEMENTS INDUST.;225;225;179;33;13;10;3;189;0;11;38;68;72;36
6222.0;2021;18;ORLEANS-TOURS;MASCULIN;SCOLAIRE;BAC PROFESSIONNEL;BAC PRO PROD;BAC PRO 25219 MAINT.MATERIELS OPT.A AGRICOLES;11;11;8;3;0;0;0;8;0;0;4;2;2;3
6223.0;2021;18;ORLEANS-TOURS;MASCULIN;SCOLAIRE;BAC PROFESSIONNEL;BAC PRO PROD;BAC PRO 25220 MAINT.MATERIELS OPT.B TP MANUT.;8;8;6;1;1;1;0;7;0;0;2;2;3;1
6226.0;2021;18;ORLEANS-TOURS;MASCULIN;SCOLAIRE;BAC PROFESSIONNEL;BAC PRO PROD;BAC PRO 25408 REPARATION DES CARROSSERIES;52;52;39;8;5;3;2;42;0;1;5;20;16;10
6230.0;2021;18;ORLEANS-TOURS;MASCULIN;SCOLAIRE;BAC PROFESSIONNEL;BAC PRO PROD;BAC PRO 25510 METIERS ELECT. ENVIRON. CONNECTES;444;444;358;75;11;5;6;363;0;28;73;134;128;81
6231.0;2021;18;ORLEANS-TOURS;MASCULIN;SCOLAIRE;BAC PROFESSIONNEL;BAC PRO PROD;BAC PRO 25513 SYST.NUM.OPT.A SURETE SECURITE;33;33;30;2;1;0;1;30;0;0;8;8;14;3
6232.0;2021;18;ORLEANS-TOURS;MASCULIN;SCOLAIRE;BAC PROFESSIONNEL;BAC PRO PROD;BAC PRO 25514 SYST.NUM.OPT.B AUD.RES.EQUIP.DOM.;68;68;63;5;0;0;0;63;0;9;18;27;9;5
6233.0;2021;18;ORLEANS-TOURS;MASCULIN;SCOLAIRE;BAC PROFESSIONNEL;BAC PRO PROD;BAC PRO 25515 SYST.NUM.OPT.C RES.INF.SYST.COMM.;188;188;166;15;7;5;2;171;0;9;34;70;58;17
6235.0;2021;18;ORLEANS-TOURS;MASCULIN;SCOLAIRE;BAC PROFESSIONNEL;BAC PRO PROD;BAC PRO AG 21004 CGEA;154;146;129;17;0;0;0;129;0;3;21;40;65;17
6243.0;2021;18;ORLEANS-TOURS;MASCULIN;SCOLAIRE;BAC PROFESSIONNEL;BAC PRO PROD;BAC PRO AG 21405 AMENAGEMENTS PAYSAGERS;57;57;53;4;0;0;0;53;0;3;4;22;24;4
6261.0;2021;18;ORLEANS-TOURS;MASCULIN;SCOLAIRE;BAC PROFESSIONNEL;BAC PRO SERV;BAC PRO 33004 ACC.SOINS-S.PERS. OPT.EN STRUCTUR;33;33;31;2;0;0;0;31;0;3;1;19;8;2
6263.0;2021;18;ORLEANS-TOURS;MASCULIN;SCOLAIRE;BAC PROFESSIONNEL;BAC PRO SERV;BAC PRO 33403 COMMERC. SERVICES EN RESTAURATION;76;76;58;11;7;3;4;61;0;3;11;26;21;15
6266.0;2021;18;ORLEANS-TOURS;MASCULIN;SCOLAIRE;BAC PROFESSIONNEL;BAC PRO SERV;BAC PRO 34403 METIERS DE LA SECURITE;49;49;48;1;0;0;0;48;0;2;9;29;8;1
6278.0;2021;18;ORLEANS-TOURS;MASCULIN;SCOLAIRE;BAC TECHNOLOGIQUE;BAC STL;BAC STL SCIENCES PHYSIQUES CHIMIQUES  EN LABORAT.;59;58;50;1;7;3;4;53;0;1;7;24;21;5
6281.0;2021;18;ORLEANS-TOURS;MASCULIN;SCOLAIRE;BAC TECHNOLOGIQUE;BAC STMG;BAC STMG RESSOURCES HUMAINES ET COMMUNICATION;234;234;206;8;20;12;8;218;0;1;19;77;121;16
6286.0;2021;01;PARIS;FEMININ;APPRENTISSAGE;BAC PROFESSIONNEL;BAC PRO PROD;BAC PRO 22704 TECHN. MAINT. SYST.ENERG.CLIMATI;1;1;1;0;0;0;0;1;0;0;0;1;0;0
6299.0;2021;01;PARIS;FEMININ;APPRENTISSAGE;BAC PROFESSIONNEL;BAC PRO SERV;BAC PRO 32303 ART.& MET.ART:COM.VIS.VIS.PLURI-M;6;6;5;1;0;0;0;5;0;1;2;2;0;1
6311.0;2021;01;PARIS;FEMININ;FORMATION CONTINUE;BAC PROFESSIONNEL;BAC PRO PROD;BAC PRO 24203 METIERS DE LA MODE - VÊTEMENT;11;11;11;0;0;0;0;11;0;4;4;2;1;0
6316.0;2021;01;PARIS;FEMININ;FORMATION CONTINUE;BAC PROFESSIONNEL;BAC PRO SERV;BAC PRO 33003 ACC.SOINS-S.PERS. OPT.A DOMICILE;15;15;5;7;3;3;0;8;0;0;0;3;5;7
6328.0;2021;01;PARIS;FEMININ;INDIVIDUEL;BAC PROFESSIONNEL;BAC PRO SERV;BAC PRO 31210 ACCUEIL -RELATION CLIENTS USAGERS;1;1;0;0;1;1;0;1;0;0;0;0;1;0
6341.0;2021;01;PARIS;FEMININ;SCOLAIRE;BAC PROFESSIONNEL;BAC PRO PROD;BAC PRO 22003 BIO-INDUSTRIES DE TRANSFORMATION;16;16;10;5;1;1;0;11;0;1;3;3;4;5
6345.0;2021;01;PARIS;FEMININ;SCOLAIRE;BAC PROFESSIONNEL;BAC PRO PROD;BAC PRO 23003 ARTIS. & M.ART:MARCHANDISAGE VIS.;20;20;20;0;0;0;0;20;0;4;7;6;3;0
6347.0;2021;01;PARIS;FEMININ;SCOLAIRE;BAC PROFESSIONNEL;BAC PRO PROD;BAC PRO 23005 TECHN. ETUDES BAT B ASSIST.ARCHI.;8;8;7;0;1;1;0;8;0;1;1;4;2;0
6355.0;2021;01;PARIS;FEMININ;SCOLAIRE;BAC PROFESSIONNEL;BAC PRO PROD;BAC PRO 25007 MAINTENANCE EQUIPEMENTS INDUST.;1;1;0;1;0;0;0;0;0;0;0;0;0;1
6358.0;2021;01;PARIS;FEMININ;SCOLAIRE;BAC PROFESSIONNEL;BAC PRO PROD;BAC PRO AG 21405 AMENAGEMENTS PAYSAGERS;5;5;5;0;0;0;0;5;0;0;2;2;1;0
6364.0;2021;01;PARIS;FEMININ;SCOLAIRE;BAC PROFESSIONNEL;BAC PRO SERV;BAC PRO 31206 VENTE (PROSPECT.NEGO.SUIV.CLIENT;32;32;28;0;4;4;0;32;0;2;5;9;16;0
6371.0;2021;01;PARIS;FEMININ;SCOLAIRE;BAC PROFESSIONNEL;BAC PRO SERV;BAC PRO 33002 SERVICES DE PROXIMITE  VIE LOCAL;72;72;59;6;7;4;3;63;0;3;16;18;26;9
6373.0;2021;01;PARIS;FEMININ;SCOLAIRE;BAC PROFESSIONNEL;BAC PRO SERV;BAC PRO 33004 ACC.SOINS-S.PERS. OPT.EN STRUCTUR;223;222;205;8;9;7;2;212;0;5;50;89;68;10
6375.0;2021;01;PARIS;FEMININ;SCOLAIRE;BAC PROFESSIONNEL;BAC PRO SERV;BAC PRO 33102 PROTHESE DENTAIRE;15;15;15;0;0;0;0;15;0;0;1;7;7;0
6377.0;2021;01;PARIS;FEMININ;SCOLAIRE;BAC PROFESSIONNEL;BAC PRO SERV;BAC PRO 33403 COMMERC. SERVICES EN RESTAURATION;29;29;26;1;2;0;2;26;0;1;7;11;7;3
6381.0;2021;01;PARIS;FEMININ;SCOLAIRE;BAC PROFESSIONNEL;BAC PRO SERV;BAC PRO 34403 METIERS DE LA SECURITE;16;16;14;1;1;0;1;14;0;1;3;4;6;2
6393.0;2021;01;PARIS;FEMININ;SCOLAIRE;BAC TECHNOLOGIQUE;BAC STMG;BAC STMG GESTION ET FINANCE;197;197;184;6;7;7;0;191;0;6;44;78;63;6
6395.0;2021;01;PARIS;FEMININ;SCOLAIRE;BAC TECHNOLOGIQUE;BAC STMG;BAC STMG RESSOURCES HUMAINES ET COMMUNICATION;356;356;340;15;1;1;0;341;0;7;65;161;108;15
6398.0;2021;01;PARIS;MASCULIN;APPRENTISSAGE;BAC PROFESSIONNEL;BAC PRO PROD;BAC PRO 22105 BOULANGER-PÂTISSIER;44;43;37;1;5;2;3;39;0;2;10;15;12;4
6403.0;2021;01;PARIS;MASCULIN;APPRENTISSAGE;BAC PROFESSIONNEL;BAC PRO PROD;BAC PRO 23005 TECHN. ETUDES BAT B ASSIST.ARCHI.;3;3;2;1;0;0;0;2;0;0;0;1;1;1
6411.0;2021;01;PARIS;MASCULIN;APPRENTISSAGE;BAC PROFESSIONNEL;BAC PRO SERV;BAC PRO 31202 COMMERCE;65;57;37;14;6;5;1;42;0;2;7;15;18;15
6413.0;2021;01;PARIS;MASCULIN;APPRENTISSAGE;BAC PROFESSIONNEL;BAC PRO SERV;BAC PRO 31210 ACCUEIL -RELATION CLIENTS USAGERS;18;18;17;0;1;1;0;18;0;2;5;7;4;0
6423.0;2021;01;PARIS;MASCULIN;ENSEIGNEMENT A DISTANCE;BAC PROFESSIONNEL;BAC PRO SERV;BAC PRO 31206 VENTE (PROSPECT.NEGO.SUIV.CLIENT;1;0;0;0;0;0;0;0;0;0;0;0;0;0
6426.0;2021;01;PARIS;MASCULIN;ENSEIGNEMENT A DISTANCE;BAC TECHNOLOGIQUE;BAC STMG;BAC STMG RESSOURCES HUMAINES ET COMMUNICATION;4;4;4;0;0;0;0;4;0;0;1;0;3;0
6428.0;2021;01;PARIS;MASCULIN;FORMATION CONTINUE;BAC PROFESSIONNEL;BAC PRO PROD;BAC PRO 22704 TECHN. MAINT. SYST.ENERG.CLIMATI;8;8;6;1;1;0;1;6;0;1;1;1;3;2
6430.0;2021;01;PARIS;MASCULIN;FORMATION CONTINUE;BAC PROFESSIONNEL;BAC PRO PROD;BAC PRO 25007 MAINTENANCE EQUIPEMENTS INDUST.;11;11;11;0;0;0;0;11;0;1;3;5;2;0
6445.0;2021;01;PARIS;MASCULIN;INDIVIDUEL;BAC PROFESSIONNEL;BAC PRO PROD;BAC PRO 25007 MAINTENANCE EQUIPEMENTS INDUST.;9;7;4;1;2;2;0;6;0;0;1;2;3;1
6448.0;2021;01;PARIS;MASCULIN;INDIVIDUEL;BAC PROFESSIONNEL;BAC PRO PROD;BAC PRO 25515 SYST.NUM.OPT.C RES.INF.SYST.COMM.;1;1;1;0;0;0;0;1;0;0;0;0;1;0
6451.0;2021;01;PARIS;MASCULIN;INDIVIDUEL;BAC PROFESSIONNEL;BAC PRO PROD;BAC PRO AG 21114 CONDUITE PRODUCTIONS HORTICOLES;4;3;3;0;0;0;0;3;0;0;0;0;3;0
6452.0;2021;01;PARIS;MASCULIN;INDIVIDUEL;BAC PROFESSIONNEL;BAC PRO PROD;BAC PRO AG 21211 COND GEST ENTR HIPPIQUE;1;1;1;0;0;0;0;1;0;0;0;0;1;0
6454.0;2021;01;PARIS;MASCULIN;INDIVIDUEL;BAC PROFESSIONNEL;BAC PRO SERV;BAC PRO 30001 GESTION-ADMINISTRATION;9;4;2;2;0;0;0;2;0;0;0;0;2;2
6461.0;2021;01;PARIS;MASCULIN;INDIVIDUEL;BAC PROFESSIONNEL;BAC PRO SERV;BAC PRO 33403 COMMERC. SERVICES EN RESTAURATION;2;2;0;1;1;0;1;0;0;0;0;0;0;2
6470.0;2021;01;PARIS;MASCULIN;INDIVIDUEL;BAC TECHNOLOGIQUE;BAC STMG;BAC STMG SYSTEMES D'INFORMATION DE GESTION;15;14;11;1;2;2;0;13;0;0;2;2;9;1
6474.0;2021;01;PARIS;MASCULIN;SCOLAIRE;BAC PROFESSIONNEL;BAC PRO PROD;BAC PRO 22003 BIO-INDUSTRIES DE TRANSFORMATION;8;8;7;0;1;1;0;8;0;0;3;2;3;0
6475.0;2021;01;PARIS;MASCULIN;SCOLAIRE;BAC PROFESSIONNEL;BAC PRO PROD;BAC PRO 22004 PROC. CHIMIE EAU PAPIERS-CARTONS;16;16;12;1;3;3;0;15;0;0;1;4;10;1
6476.0;2021;01;PARIS;MASCULIN;SCOLAIRE;BAC PROFESSIONNEL;BAC PRO PROD;BAC PRO 22106 CUISINE;63;63;57;5;1;0;1;57;0;5;23;17;12;6
6477.0;2021;01;PARIS;MASCULIN;SCOLAIRE;BAC PROFESSIONNEL;BAC PRO PROD;BAC PRO 22402 ARTIS.& MET.ART:VERR.SCIENT.TECH;8;8;7;1;0;0;0;7;0;0;3;4;0;1
6479.0;2021;01;PARIS;MASCULIN;SCOLAIRE;BAC PROFESSIONNEL;BAC PRO PROD;BAC PRO 22703 TECHN.INSTALL.SYST.ENERG.CLIMATI;16;16;7;4;5;3;2;10;0;0;1;4;5;6
6483.0;2021;01;PARIS;MASCULIN;SCOLAIRE;BAC PROFESSIONNEL;BAC PRO PROD;BAC PRO 23005 TECHN. ETUDES BAT B ASSIST.ARCHI.;10;10;10;0;0;0;0;10;0;0;4;4;2;0
6490.0;2021;01;PARIS;MASCULIN;SCOLAIRE;BAC PROFESSIONNEL;BAC PRO PROD;BAC PRO 23408 Etude et réalisation d'agencement;4;4;3;1;0;0;0;3;0;0;0;0;3;1
6499.0;2021;01;PARIS;MASCULIN;SCOLAIRE;BAC PROFESSIONNEL;BAC PRO PROD;BAC PRO 25214 MAINT.VEHIC.OPTA VOIT.PARTICUL.;39;39;35;3;1;1;0;36;0;2;5;15;14;3
6509.0;2021;01;PARIS;MASCULIN;SCOLAIRE;BAC PROFESSIONNEL;BAC PRO PROD;BAC PRO AG 22105 LABORATOIRE CONTROLE QUALITE;3;3;2;1;0;0;0;2;0;0;0;0;2;1
6527.0;2021;01;PARIS;MASCULIN;SCOLAIRE;BAC PROFESSIONNEL;BAC PRO SERV;BAC PRO 33403 COMMERC. SERVICES EN RESTAURATION;45;43;34;8;1;0;1;34;0;3;2;15;14;9
6534.0;2021;01;PARIS;MASCULIN;SCOLAIRE;BAC TECHNOLOGIQUE;BAC STHR;BAC STHR SC.&TEC. HOTELLERIE-RESTAURATION;39;39;38;1;0;0;0;38;0;1;8;16;13;1
6548.0;2021;13;POITIERS;FEMININ;APPRENTISSAGE;BAC PROFESSIONNEL;BAC PRO PROD;BAC PRO 25007 MAINTENANCE EQUIPEMENTS INDUST.;2;2;2;0;0;0;0;2;0;0;1;0;1;0
6554.0;2021;13;POITIERS;FEMININ;APPRENTISSAGE;BAC PROFESSIONNEL;BAC PRO PROD;BAC PRO 25515 SYST.NUM.OPT.C RES.INF.SYST.COMM.;1;1;1;0;0;0;0;1;0;0;1;0;0;0
6561.0;2021;13;POITIERS;FEMININ;APPRENTISSAGE;BAC PROFESSIONNEL;BAC PRO SERV;BAC PRO 31210 ACCUEIL -RELATION CLIENTS USAGERS;1;1;1;0;0;0;0;1;0;0;0;0;1;0
6565.0;2021;13;POITIERS;FEMININ;APPRENTISSAGE;BAC PROFESSIONNEL;BAC PRO SERV;BAC PRO 33101 OPTIQUE LUNETTERIE;5;5;5;0;0;0;0;5;0;0;0;2;3;0
6566.0;2021;13;POITIERS;FEMININ;APPRENTISSAGE;BAC PROFESSIONNEL;BAC PRO SERV;BAC PRO 33403 COMMERC. SERVICES EN RESTAURATION;8;8;7;1;0;0;0;7;0;0;1;4;2;1
6571.0;2021;13;POITIERS;FEMININ;ENSEIGNEMENT A DISTANCE;BAC PROFESSIONNEL;BAC PRO SERV;BAC PRO 30001 GESTION-ADMINISTRATION;5;3;2;1;0;0;0;2;0;0;0;2;0;1
6581.0;2021;13;POITIERS;FEMININ;FORMATION CONTINUE;BAC PROFESSIONNEL;BAC PRO SERV;BAC PRO 31202 COMMERCE;9;9;6;1;2;1;1;7;0;0;0;6;1;2
6585.0;2021;13;POITIERS;FEMININ;INDIVIDUEL;BAC PROFESSIONNEL;BAC PRO PROD;BAC PRO AG 21211 COND GEST ENTR HIPPIQUE;4;3;2;1;0;0;0;2;0;0;0;1;1;1
6586.0;2021;13;POITIERS;FEMININ;INDIVIDUEL;BAC PROFESSIONNEL;BAC PRO SERV;BAC PRO 30001 GESTION-ADMINISTRATION;5;0;0;0;0;0;0;0;0;0;0;0;0;0
6590.0;2021;13;POITIERS;FEMININ;INDIVIDUEL;BAC PROFESSIONNEL;BAC PRO SERV;BAC PRO 33002 SERVICES DE PROXIMITE  VIE LOCAL;1;0;0;0;0;0;0;0;0;0;0;0;0;0
6591.0;2021;13;POITIERS;FEMININ;INDIVIDUEL;BAC PROFESSIONNEL;BAC PRO SERV;BAC PRO 33003 ACC.SOINS-S.PERS. OPT.A DOMICILE;1;1;1;0;0;0;0;1;0;0;0;1;0;0
6592.0;2021;13;POITIERS;FEMININ;INDIVIDUEL;BAC PROFESSIONNEL;BAC PRO SERV;BAC PRO 33004 ACC.SOINS-S.PERS. OPT.EN STRUCTUR;1;0;0;0;0;0;0;0;0;0;0;0;0;0
6615.0;2021;13;POITIERS;FEMININ;SCOLAIRE;BAC PROFESSIONNEL;BAC PRO PROD;BAC PRO 25214 MAINT.VEHIC.OPTA VOIT.PARTICUL.;7;7;4;2;1;0;1;4;0;0;1;3;0;3
6625.0;2021;13;POITIERS;FEMININ;SCOLAIRE;BAC PROFESSIONNEL;BAC PRO PROD;BAC PRO 25515 SYST.NUM.OPT.C RES.INF.SYST.COMM.;1;1;1;0;0;0;0;1;0;0;0;1;0;0
6634.0;2021;13;POITIERS;FEMININ;SCOLAIRE;BAC PROFESSIONNEL;BAC PRO PROD;BAC PRO AG 21303 FORET;1;1;1;0;0;0;0;1;0;0;0;1;0;0
6635.0;2021;13;POITIERS;FEMININ;SCOLAIRE;BAC PROFESSIONNEL;BAC PRO PROD;BAC PRO AG 21405 AMENAGEMENTS PAYSAGERS;13;13;11;2;0;0;0;11;0;1;2;4;4;2
6637.0;2021;13;POITIERS;FEMININ;SCOLAIRE;BAC PROFESSIONNEL;BAC PRO PROD;BAC PRO AG 22105 LABORATOIRE CONTROLE QUALITE;18;18;12;6;0;0;0;12;0;1;2;6;3;6
6638.0;2021;13;POITIERS;FEMININ;SCOLAIRE;BAC PROFESSIONNEL;BAC PRO PROD;BAC PRO AG 22106 TEC CONS VTE ALIMENTATION VINS SP;4;4;4;0;0;0;0;4;0;0;0;0;4;0
6643.0;2021;13;POITIERS;FEMININ;SCOLAIRE;BAC PROFESSIONNEL;BAC PRO SERV;BAC PRO 31108 TRANSPORT;5;5;4;1;0;0;0;4;0;0;2;0;2;1
6649.0;2021;13;POITIERS;FEMININ;SCOLAIRE;BAC PROFESSIONNEL;BAC PRO SERV;BAC PRO 32303 ART.& MET.ART:COM.VIS.VIS.PLURI-M;16;16;14;2;0;0;0;14;0;0;6;5;3;2
6658.0;2021;13;POITIERS;FEMININ;SCOLAIRE;BAC PROFESSIONNEL;BAC PRO SERV;BAC PRO AG 33002 SERV PERS TERRIT;282;275;263;12;0;0;0;263;0;7;52;118;86;12
6661.0;2021;13;POITIERS;FEMININ;SCOLAIRE;BAC TECHNOLOGIQUE;BAC STD2A;BAC STD2A SCIENCES & TECHNO. DESIGN-ARTS APPLIQUES;98;98;98;0;0;0;0;98;1;4;41;39;13;0
6662.0;2021;13;POITIERS;FEMININ;SCOLAIRE;BAC TECHNOLOGIQUE;BAC STHR;BAC STHR SC.&TEC. HOTELLERIE-RESTAURATION;44;44;40;0;4;1;3;41;0;2;10;12;17;3
6667.0;2021;13;POITIERS;FEMININ;SCOLAIRE;BAC TECHNOLOGIQUE;BAC STL;BAC STL BIOCHIM.-BIOLOGIE-BIOTECHNOL.;73;73;67;0;6;5;1;72;0;2;18;28;24;1
6668.0;2021;13;POITIERS;FEMININ;SCOLAIRE;BAC TECHNOLOGIQUE;BAC STL;BAC STL SCIENCES PHYSIQUES CHIMIQUES  EN LABORAT.;7;7;4;0;3;2;1;6;0;0;0;2;4;1
6670.0;2021;13;POITIERS;FEMININ;SCOLAIRE;BAC TECHNOLOGIQUE;BAC STMG;BAC STMG MERCATIQUE (MARKETING);400;400;362;12;26;18;8;380;0;9;62;156;153;20
6675.0;2021;13;POITIERS;MASCULIN;APPRENTISSAGE;BAC PROFESSIONNEL;BAC PRO PROD;BAC PRO 22106 CUISINE;15;15;12;1;2;2;0;14;0;0;2;2;10;1
6682.0;2021;13;POITIERS;MASCULIN;APPRENTISSAGE;BAC PROFESSIONNEL;BAC PRO PROD;BAC PRO 23407 TECHNIC.FAB.BOIS ET MATERX ASSOC;4;4;3;1;0;0;0;3;0;1;0;2;0;1
6685.0;2021;13;POITIERS;MASCULIN;APPRENTISSAGE;BAC PROFESSIONNEL;BAC PRO PROD;BAC PRO 25009 MAINTENANCE NAUTIQUE;7;7;6;1;0;0;0;6;0;0;1;4;1;1
6686.0;2021;13;POITIERS;MASCULIN;APPRENTISSAGE;BAC PROFESSIONNEL;BAC PRO PROD;BAC PRO 25106 TECHNICIEN D'USINAGE;9;9;7;0;2;0;2;7;0;1;0;1;5;2
6687.0;2021;13;POITIERS;MASCULIN;APPRENTISSAGE;BAC PROFESSIONNEL;BAC PRO PROD;BAC PRO 25214 MAINT.VEHIC.OPTA VOIT.PARTICUL.;72;72;56;12;4;2;2;58;0;0;8;32;18;14
6690.0;2021;13;POITIERS;MASCULIN;APPRENTISSAGE;BAC PROFESSIONNEL;BAC PRO PROD;BAC PRO 25220 MAINT.MATERIELS OPT.B TP MANUT.;2;2;2;0;0;0;0;2;0;0;1;0;1;0
6691.0;2021;13;POITIERS;MASCULIN;APPRENTISSAGE;BAC PROFESSIONNEL;BAC PRO PROD;BAC PRO 25221 MAINT.MATERIELS OPT.C ESP. VERTS;9;9;8;0;1;0;1;8;0;0;1;4;3;1
6700.0;2021;13;POITIERS;MASCULIN;APPRENTISSAGE;BAC PROFESSIONNEL;BAC PRO PROD;BAC PRO AG 21001 AGRO-EQUIPEMENT;17;16;10;6;0;0;0;10;0;0;1;5;4;6
6703.0;2021;13;POITIERS;MASCULIN;APPRENTISSAGE;BAC PROFESSIONNEL;BAC PRO PROD;BAC PRO AG 21303 FORET;6;5;4;1;0;0;0;4;0;1;0;1;2;1
6707.0;2021;13;POITIERS;MASCULIN;APPRENTISSAGE;BAC PROFESSIONNEL;BAC PRO SERV;BAC PRO 31106 LOGISTIQUE;17;17;16;1;0;0;0;16;0;1;7;5;3;1
6709.0;2021;13;POITIERS;MASCULIN;APPRENTISSAGE;BAC PROFESSIONNEL;BAC PRO SERV;BAC PRO 31210 ACCUEIL -RELATION CLIENTS USAGERS;1;1;1;0;0;0;0;1;0;0;0;0;1;0
6718.0;2021;13;POITIERS;MASCULIN;ENSEIGNEMENT A DISTANCE;BAC PROFESSIONNEL;BAC PRO SERV;BAC PRO 31210 ACCUEIL -RELATION CLIENTS USAGERS;1;1;1;0;0;0;0;1;0;0;1;0;0;0
6720.0;2021;13;POITIERS;MASCULIN;FORMATION CONTINUE;BAC PROFESSIONNEL;BAC PRO PROD;BAC PRO 22704 TECHN. MAINT. SYST.ENERG.CLIMATI;7;7;7;0;0;0;0;7;0;0;4;3;0;0
6723.0;2021;13;POITIERS;MASCULIN;FORMATION CONTINUE;BAC PROFESSIONNEL;BAC PRO SERV;BAC PRO 31202 COMMERCE;6;6;5;1;0;0;0;5;0;0;2;2;1;1
6725.0;2021;13;POITIERS;MASCULIN;INDIVIDUEL;BAC PROFESSIONNEL;BAC PRO PROD;BAC PRO 22104 BOUCHER CHARCUTIER TRAITEUR;1;0;0;0;0;0;0;0;0;0;0;0;0;0
6726.0;2021;13;POITIERS;MASCULIN;INDIVIDUEL;BAC PROFESSIONNEL;BAC PRO PROD;BAC PRO 25214 MAINT.VEHIC.OPTA VOIT.PARTICUL.;1;1;0;1;0;0;0;0;0;0;0;0;0;1
6728.0;2021;13;POITIERS;MASCULIN;INDIVIDUEL;BAC PROFESSIONNEL;BAC PRO PROD;BAC PRO 25515 SYST.NUM.OPT.C RES.INF.SYST.COMM.;1;1;1;0;0;0;0;1;0;0;0;0;1;0
6737.0;2021;13;POITIERS;MASCULIN;INDIVIDUEL;BAC TECHNOLOGIQUE;BAC STMG;BAC STMG MERCATIQUE (MARKETING);7;5;2;3;0;0;0;2;0;0;0;1;1;3
6747.0;2021;13;POITIERS;MASCULIN;SCOLAIRE;BAC PROFESSIONNEL;BAC PRO PROD;BAC PRO 22503 PLASTIQUES ET COMPOSITES;19;19;19;0;0;0;0;19;0;0;5;11;3;0
6749.0;2021;13;POITIERS;MASCULIN;SCOLAIRE;BAC PROFESSIONNEL;BAC PRO PROD;BAC PRO 22704 TECHN. MAINT. SYST.ENERG.CLIMATI;16;16;12;3;1;1;0;13;0;0;2;8;3;3
6751.0;2021;13;POITIERS;MASCULIN;SCOLAIRE;BAC PROFESSIONNEL;BAC PRO PROD;BAC PRO 23005 TECHN. ETUDES BAT B ASSIST.ARCHI.;18;18;14;3;1;1;0;15;0;1;3;6;5;3
6752.0;2021;13;POITIERS;MASCULIN;SCOLAIRE;BAC PROFESSIONNEL;BAC PRO PROD;BAC PRO 23102 TRAVAUX PUBLICS;7;7;4;0;3;2;1;6;0;0;0;2;4;1
6762.0;2021;13;POITIERS;MASCULIN;SCOLAIRE;BAC PROFESSIONNEL;BAC PRO PROD;BAC PRO 24302 METIERS DU CUIR : MAROQUINERIE;1;1;1;0;0;0;0;1;0;0;0;0;1;0
6778.0;2021;13;POITIERS;MASCULIN;SCOLAIRE;BAC PROFESSIONNEL;BAC PRO PROD;BAC PRO 25411 TECH.CHAUDRONNERIE INDUSTRIELLE;56;56;51;3;2;1;1;52;0;2;17;22;11;4
6782.0;2021;13;POITIERS;MASCULIN;SCOLAIRE;BAC PROFESSIONNEL;BAC PRO PROD;BAC PRO 25514 SYST.NUM.OPT.B AUD.RES.EQUIP.DOM.;40;40;33;6;1;1;0;34;0;2;4;17;11;6
6784.0;2021;13;POITIERS;MASCULIN;SCOLAIRE;BAC PROFESSIONNEL;BAC PRO PROD;BAC PRO AG 21001 AGRO-EQUIPEMENT;12;12;11;1;0;0;0;11;0;0;0;3;8;1
6785.0;2021;13;POITIERS;MASCULIN;SCOLAIRE;BAC PROFESSIONNEL;BAC PRO PROD;BAC PRO AG 21004 CGEA;139;133;117;16;0;0;0;117;0;1;24;36;56;16
6789.0;2021;13;POITIERS;MASCULIN;SCOLAIRE;BAC PROFESSIONNEL;BAC PRO PROD;BAC PRO AG 21204 PROD-AQUACOLES;20;18;14;4;0;0;0;14;0;0;2;3;9;4
6796.0;2021;13;POITIERS;MASCULIN;SCOLAIRE;BAC PROFESSIONNEL;BAC PRO PROD;BAC PRO AG 22105 LABORATOIRE CONTROLE QUALITE;10;10;7;3;0;0;0;7;0;0;0;3;4;3
6800.0;2021;13;POITIERS;MASCULIN;SCOLAIRE;BAC PROFESSIONNEL;BAC PRO SERV;BAC PRO 31106 LOGISTIQUE;61;60;40;10;10;5;5;45;0;2;5;16;22;15
6806.0;2021;13;POITIERS;MASCULIN;SCOLAIRE;BAC PROFESSIONNEL;BAC PRO SERV;BAC PRO 32207 REAL.PR.IMPR.PLURI.OPTA.PR.GRAPH.;8;8;8;0;0;0;0;8;0;3;1;3;1;0
6811.0;2021;13;POITIERS;MASCULIN;SCOLAIRE;BAC PROFESSIONNEL;BAC PRO SERV;BAC PRO 33101 OPTIQUE LUNETTERIE;2;2;1;1;0;0;0;1;0;0;0;1;0;1
6816.0;2021;13;POITIERS;MASCULIN;SCOLAIRE;BAC TECHNOLOGIQUE;BAC ST2S;BAC ST2S SCIENCES & TECHNO. SANTE & SOCIAL;50;50;43;2;5;2;3;45;0;0;6;21;18;5
6817.0;2021;13;POITIERS;MASCULIN;SCOLAIRE;BAC TECHNOLOGIQUE;BAC STAV;BAC STAV AGRONOMIE ALIM ENV TERRITOI;93;93;92;1;0;0;0;92;0;2;13;42;35;1
6825.0;2021;13;POITIERS;MASCULIN;SCOLAIRE;BAC TECHNOLOGIQUE;BAC STL;BAC STL SCIENCES PHYSIQUES CHIMIQUES  EN LABORAT.;15;15;13;1;1;1;0;14;0;0;4;7;3;1
6843.0;2021;19;REIMS;FEMININ;APPRENTISSAGE;BAC PROFESSIONNEL;BAC PRO SERV;BAC PRO 33102 PROTHESE DENTAIRE;4;4;4;0;0;0;0;4;0;1;2;1;0;0
6847.0;2021;19;REIMS;FEMININ;ENSEIGNEMENT A DISTANCE;BAC PROFESSIONNEL;BAC PRO SERV;BAC PRO 30001 GESTION-ADMINISTRATION;3;3;3;0;0;0;0;3;0;0;0;1;2;0
6849.0;2021;19;REIMS;FEMININ;ENSEIGNEMENT A DISTANCE;BAC PROFESSIONNEL;BAC PRO SERV;BAC PRO 33003 ACC.SOINS-S.PERS. OPT.A DOMICILE;1;1;1;0;0;0;0;1;0;1;0;0;0;0
6850.0;2021;19;REIMS;FEMININ;ENSEIGNEMENT A DISTANCE;BAC PROFESSIONNEL;BAC PRO SERV;BAC PRO 33004 ACC.SOINS-S.PERS. OPT.EN STRUCTUR;2;0;0;0;0;0;0;0;0;0;0;0;0;0
6855.0;2021;19;REIMS;FEMININ;FORMATION CONTINUE;BAC PROFESSIONNEL;BAC PRO PROD;BAC PRO 23205 INTERV. SUR PATRIMOINE BATI OPT.A;1;1;1;0;0;0;0;1;0;0;0;1;0;0
6862.0;2021;19;REIMS;FEMININ;FORMATION CONTINUE;BAC PROFESSIONNEL;BAC PRO SERV;BAC PRO 31202 COMMERCE;2;2;2;0;0;0;0;2;0;0;0;1;1;0
6865.0;2021;19;REIMS;FEMININ;INDIVIDUEL;BAC GENERAL;BAC GENERAL;BAC GENE 10019 BAC GENERAL;23;20;6;10;4;3;1;9;0;0;0;1;8;11
6870.0;2021;19;REIMS;FEMININ;INDIVIDUEL;BAC PROFESSIONNEL;BAC PRO SERV;BAC PRO 33003 ACC.SOINS-S.PERS. OPT.A DOMICILE;1;1;1;0;0;0;0;1;0;0;0;0;1;0
6872.0;2021;19;REIMS;FEMININ;INDIVIDUEL;BAC PROFESSIONNEL;BAC PRO SERV;BAC PRO 33101 OPTIQUE LUNETTERIE;1;1;1;0;0;0;0;1;0;0;0;0;1;0
6875.0;2021;19;REIMS;FEMININ;INDIVIDUEL;BAC TECHNOLOGIQUE;BAC STAV;BAC STAV AGRONOMIE ALIM ENV TERRITOI;1;0;0;0;0;0;0;0;0;0;0;0;0;0
6886.0;2021;19;REIMS;FEMININ;SCOLAIRE;BAC PROFESSIONNEL;BAC PRO PROD;BAC PRO 23004 TECHN. ETUDES BAT.A ETUDES & ECO.;3;3;3;0;0;0;0;3;0;0;0;0;3;0
6887.0;2021;19;REIMS;FEMININ;SCOLAIRE;BAC PROFESSIONNEL;BAC PRO PROD;BAC PRO 23005 TECHN. ETUDES BAT B ASSIST.ARCHI.;4;4;4;0;0;0;0;4;0;1;1;2;0;0
6891.0;2021;19;REIMS;FEMININ;SCOLAIRE;BAC PROFESSIONNEL;BAC PRO PROD;BAC PRO 23405 TECHNICIEN MENUISIER AGENCEUR;4;4;3;1;0;0;0;3;0;0;0;2;1;1
6894.0;2021;19;REIMS;FEMININ;SCOLAIRE;BAC PROFESSIONNEL;BAC PRO PROD;BAC PRO 25007 MAINTENANCE EQUIPEMENTS INDUST.;5;5;4;0;1;1;0;5;0;1;1;1;2;0
6903.0;2021;19;REIMS;FEMININ;SCOLAIRE;BAC PROFESSIONNEL;BAC PRO PROD;BAC PRO 25513 SYST.NUM.OPT.A SURETE SECURITE;1;1;0;1;0;0;0;0;0;0;0;0;0;1
6906.0;2021;19;REIMS;FEMININ;SCOLAIRE;BAC PROFESSIONNEL;BAC PRO PROD;BAC PRO AG 21004 CGEA;29;29;26;3;0;0;0;26;0;1;3;10;12;3
6910.0;2021;19;REIMS;FEMININ;SCOLAIRE;BAC PROFESSIONNEL;BAC PRO PROD;BAC PRO AG 21210 COND GEST ENTR CANIN ET FELIN;10;10;10;0;0;0;0;10;0;0;0;6;4;0
6918.0;2021;19;REIMS;FEMININ;SCOLAIRE;BAC PROFESSIONNEL;BAC PRO SERV;BAC PRO 31106 LOGISTIQUE;5;5;3;2;0;0;0;3;0;0;1;2;0;2
6924.0;2021;19;REIMS;FEMININ;SCOLAIRE;BAC PROFESSIONNEL;BAC PRO SERV;BAC PRO 32207 REAL.PR.IMPR.PLURI.OPTA.PR.GRAPH.;9;9;7;2;0;0;0;7;0;0;2;1;4;2
6925.0;2021;19;REIMS;FEMININ;SCOLAIRE;BAC PROFESSIONNEL;BAC PRO SERV;BAC PRO 32208 REAL.PR.IMPR.PLURI.OPTB.PR.IMPR.;3;3;2;1;0;0;0;2;0;0;0;1;1;1
6926.0;2021;19;REIMS;FEMININ;SCOLAIRE;BAC PROFESSIONNEL;BAC PRO SERV;BAC PRO 32303 ART.& MET.ART:COM.VIS.VIS.PLURI-M;21;21;19;2;0;0;0;19;0;2;8;4;5;2
6927.0;2021;19;REIMS;FEMININ;SCOLAIRE;BAC PROFESSIONNEL;BAC PRO SERV;BAC PRO 33002 SERVICES DE PROXIMITE  VIE LOCAL;12;12;10;1;1;1;0;11;0;0;4;5;2;1
6929.0;2021;19;REIMS;FEMININ;SCOLAIRE;BAC PROFESSIONNEL;BAC PRO SERV;BAC PRO 33004 ACC.SOINS-S.PERS. OPT.EN STRUCTUR;244;243;223;10;10;7;3;230;0;17;57;92;64;13
6930.0;2021;19;REIMS;FEMININ;SCOLAIRE;BAC PROFESSIONNEL;BAC PRO SERV;BAC PRO 33101 OPTIQUE LUNETTERIE;9;9;9;0;0;0;0;9;0;2;3;4;0;0
6936.0;2021;19;REIMS;FEMININ;SCOLAIRE;BAC PROFESSIONNEL;BAC PRO SERV;BAC PRO 34403 METIERS DE LA SECURITE;35;35;34;1;0;0;0;34;0;0;7;12;15;1
6949.0;2021;19;REIMS;FEMININ;SCOLAIRE;BAC TECHNOLOGIQUE;BAC STL;BAC STL SCIENCES PHYSIQUES CHIMIQUES  EN LABORAT.;16;16;15;0;1;0;1;15;0;0;2;8;5;1
6969.0;2021;19;REIMS;MASCULIN;APPRENTISSAGE;BAC PROFESSIONNEL;BAC PRO PROD;BAC PRO 25215 MAINT.VEHIC.OPTB VEHIC.TRANS.ROUT;12;12;6;1;5;4;1;10;0;0;1;4;5;2
6970.0;2021;19;REIMS;MASCULIN;APPRENTISSAGE;BAC PROFESSIONNEL;BAC PRO PROD;BAC PRO 25216 MAINT.VEHIC.OPTC MOTOCYCLES;4;4;4;0;0;0;0;4;0;0;1;2;1;0
6978.0;2021;19;REIMS;MASCULIN;APPRENTISSAGE;BAC PROFESSIONNEL;BAC PRO PROD;BAC PRO 25515 SYST.NUM.OPT.C RES.INF.SYST.COMM.;2;2;1;1;0;0;0;1;0;0;1;0;0;1
6980.0;2021;19;REIMS;MASCULIN;APPRENTISSAGE;BAC PROFESSIONNEL;BAC PRO PROD;BAC PRO AG 21113 CGEVV;23;22;19;3;0;0;0;19;0;0;0;3;16;3
6981.0;2021;19;REIMS;MASCULIN;APPRENTISSAGE;BAC PROFESSIONNEL;BAC PRO PROD;BAC PRO AG 21211 COND GEST ENTR HIPPIQUE;1;0;0;0;0;0;0;0;0;0;0;0;0;0
6985.0;2021;19;REIMS;MASCULIN;APPRENTISSAGE;BAC PROFESSIONNEL;BAC PRO SERV;BAC PRO 33102 PROTHESE DENTAIRE;4;4;4;0;0;0;0;4;0;1;1;1;1;0
6988.0;2021;19;REIMS;MASCULIN;ENSEIGNEMENT A DISTANCE;BAC PROFESSIONNEL;BAC PRO SERV;BAC PRO 31202 COMMERCE;3;1;0;0;1;1;0;1;0;0;0;0;1;0
7006.0;2021;19;REIMS;MASCULIN;INDIVIDUEL;BAC PROFESSIONNEL;BAC PRO PROD;BAC PRO AG 21004 CGEA;3;3;2;1;0;0;0;2;0;0;0;0;2;1
7007.0;2021;19;REIMS;MASCULIN;INDIVIDUEL;BAC PROFESSIONNEL;BAC PRO SERV;BAC PRO 30001 GESTION-ADMINISTRATION;3;1;1;0;0;0;0;1;0;0;0;1;0;0
7008.0;2021;19;REIMS;MASCULIN;INDIVIDUEL;BAC PROFESSIONNEL;BAC PRO SERV;BAC PRO 31107 CONDUCT. TRANSP.ROUT.MARCHANDISES;1;1;1;0;0;0;0;1;0;0;0;0;1;0
7017.0;2021;19;REIMS;MASCULIN;SCOLAIRE;BAC PROFESSIONNEL;BAC PRO PROD;BAC PRO 20102 PILOTE DE LIGNE DE PRODUCTION;12;12;10;1;1;1;0;11;0;0;1;3;7;1
7021.0;2021;19;REIMS;MASCULIN;SCOLAIRE;BAC PROFESSIONNEL;BAC PRO PROD;BAC PRO 22302 Traitement des matériaux;4;4;2;2;0;0;0;2;0;0;0;1;1;2
7022.0;2021;19;REIMS;MASCULIN;SCOLAIRE;BAC PROFESSIONNEL;BAC PRO PROD;BAC PRO 22303 FONDERIE;3;3;2;0;1;0;1;2;0;0;1;0;1;1
7023.0;2021;19;REIMS;MASCULIN;SCOLAIRE;BAC PROFESSIONNEL;BAC PRO PROD;BAC PRO 22503 PLASTIQUES ET COMPOSITES;24;23;12;8;3;0;3;12;0;0;4;4;4;11
7028.0;2021;19;REIMS;MASCULIN;SCOLAIRE;BAC PROFESSIONNEL;BAC PRO PROD;BAC PRO 23102 TRAVAUX PUBLICS;19;19;17;2;0;0;0;17;0;2;2;7;6;2
7032.0;2021;19;REIMS;MASCULIN;SCOLAIRE;BAC PROFESSIONNEL;BAC PRO PROD;BAC PRO 23304 AMENAGEMENT FINITION BATIMENT;12;12;8;2;2;1;1;9;0;0;4;3;2;3
7040.0;2021;19;REIMS;MASCULIN;SCOLAIRE;BAC PROFESSIONNEL;BAC PRO PROD;BAC PRO 25215 MAINT.VEHIC.OPTB VEHIC.TRANS.ROUT;14;14;8;5;1;0;1;8;0;0;1;5;2;6
7043.0;2021;19;REIMS;MASCULIN;SCOLAIRE;BAC PROFESSIONNEL;BAC PRO PROD;BAC PRO 25220 MAINT.MATERIELS OPT.B TP MANUT.;8;8;7;1;0;0;0;7;0;0;0;4;3;1
7053.0;2021;19;REIMS;MASCULIN;SCOLAIRE;BAC PROFESSIONNEL;BAC PRO PROD;BAC PRO AG 21004 CGEA;102;100;86;14;0;0;0;86;0;2;7;26;51;14
7060.0;2021;19;REIMS;MASCULIN;SCOLAIRE;BAC PROFESSIONNEL;BAC PRO PROD;BAC PRO AG 21405 AMENAGEMENTS PAYSAGERS;18;16;16;0;0;0;0;16;0;0;3;7;6;0
7067.0;2021;19;REIMS;MASCULIN;SCOLAIRE;BAC PROFESSIONNEL;BAC PRO SERV;BAC PRO 31108 TRANSPORT;7;7;5;1;1;0;1;5;0;0;2;0;3;2
7068.0;2021;19;REIMS;MASCULIN;SCOLAIRE;BAC PROFESSIONNEL;BAC PRO SERV;BAC PRO 31202 COMMERCE;223;222;170;26;26;16;10;186;0;9;35;47;95;36
7076.0;2021;19;REIMS;MASCULIN;SCOLAIRE;BAC PROFESSIONNEL;BAC PRO SERV;BAC PRO 33004 ACC.SOINS-S.PERS. OPT.EN STRUCTUR;11;11;11;0;0;0;0;11;0;0;3;5;3;0
7077.0;2021;19;REIMS;MASCULIN;SCOLAIRE;BAC PROFESSIONNEL;BAC PRO SERV;BAC PRO 33101 OPTIQUE LUNETTERIE;2;2;2;0;0;0;0;2;0;0;1;1;0;0
7078.0;2021;19;REIMS;MASCULIN;SCOLAIRE;BAC PROFESSIONNEL;BAC PRO SERV;BAC PRO 33102 PROTHESE DENTAIRE;2;2;2;0;0;0;0;2;0;0;0;2;0;0
7086.0;2021;19;REIMS;MASCULIN;SCOLAIRE;BAC TECHNOLOGIQUE;BAC STAV;BAC STAV AGRONOMIE ALIM ENV TERRITOI;85;85;83;2;0;0;0;83;0;0;13;44;26;2
7089.0;2021;19;REIMS;MASCULIN;SCOLAIRE;BAC TECHNOLOGIQUE;BAC STI2D;BAC STI2D ARCHITECTURE ET CONSTRUCTION;105;105;92;0;13;4;9;96;0;4;13;36;43;9
7097.0;2021;19;REIMS;MASCULIN;SCOLAIRE;BAC TECHNOLOGIQUE;BAC STMG;BAC STMG RESSOURCES HUMAINES ET COMMUNICATION;158;158;119;16;23;12;11;131;0;1;11;53;66;27
7099.0;2021;14;RENNES;FEMININ;APPRENTISSAGE;BAC PROFESSIONNEL;BAC PRO PROD;BAC PRO 22104 BOUCHER CHARCUTIER TRAITEUR;2;2;2;0;0;0;0;2;0;0;0;0;2;0
7113.0;2021;14;RENNES;FEMININ;APPRENTISSAGE;BAC PROFESSIONNEL;BAC PRO PROD;BAC PRO AG 21211 COND GEST ENTR HIPPIQUE;6;6;6;0;0;0;0;6;0;0;1;2;3;0
7119.0;2021;14;RENNES;FEMININ;APPRENTISSAGE;BAC PROFESSIONNEL;BAC PRO SERV;BAC PRO 31202 COMMERCE;76;75;64;8;3;2;1;66;0;1;14;22;29;9
7120.0;2021;14;RENNES;FEMININ;APPRENTISSAGE;BAC PROFESSIONNEL;BAC PRO SERV;BAC PRO 31209 POISSONIER ECAILLER TRAITEUR;2;2;2;0;0;0;0;2;0;0;1;0;1;0
7130.0;2021;14;RENNES;FEMININ;ENSEIGNEMENT A DISTANCE;BAC PROFESSIONNEL;BAC PRO SERV;BAC PRO 33603 ESTHETIQUE COSMETIQUE PARFUMERIE;1;1;1;0;0;0;0;1;0;0;0;1;0;0
7133.0;2021;14;RENNES;FEMININ;ENSEIGNEMENT A DISTANCE;BAC TECHNOLOGIQUE;BAC STMG;BAC STMG MERCATIQUE (MARKETING);2;2;2;0;0;0;0;2;0;0;1;0;1;0
7138.0;2021;14;RENNES;FEMININ;FORMATION CONTINUE;BAC PROFESSIONNEL;BAC PRO PROD;BAC PRO 25406 OUVRAGES DU BATIMENT METALLERIE;1;1;1;0;0;0;0;1;0;1;0;0;0;0
7141.0;2021;14;RENNES;FEMININ;FORMATION CONTINUE;BAC PROFESSIONNEL;BAC PRO SERV;BAC PRO 33004 ACC.SOINS-S.PERS. OPT.EN STRUCTUR;1;1;1;0;0;0;0;1;0;1;0;0;0;0
7148.0;2021;14;RENNES;FEMININ;INDIVIDUEL;BAC PROFESSIONNEL;BAC PRO PROD;BAC PRO AG 21302 GEST MILIEUX NATURELS FAUNE;1;1;1;0;0;0;0;1;0;0;0;1;0;0
7150.0;2021;14;RENNES;FEMININ;INDIVIDUEL;BAC PROFESSIONNEL;BAC PRO PROD;BAC PRO AG 22107 TEC CONS VTE ALIMENTATION P.ALIM;1;0;0;0;0;0;0;0;0;0;0;0;0;0
7151.0;2021;14;RENNES;FEMININ;INDIVIDUEL;BAC PROFESSIONNEL;BAC PRO SERV;BAC PRO 30001 GESTION-ADMINISTRATION;5;4;3;1;0;0;0;3;0;1;0;1;1;1
7153.0;2021;14;RENNES;FEMININ;INDIVIDUEL;BAC PROFESSIONNEL;BAC PRO SERV;BAC PRO 31206 VENTE (PROSPECT.NEGO.SUIV.CLIENT;2;2;1;1;0;0;0;1;0;0;0;0;1;1
7162.0;2021;14;RENNES;FEMININ;INDIVIDUEL;BAC TECHNOLOGIQUE;BAC STL;BAC STL BIOCHIM.-BIOLOGIE-BIOTECHNOL.;1;0;0;0;0;0;0;0;0;0;0;0;0;0
7163.0;2021;14;RENNES;FEMININ;INDIVIDUEL;BAC TECHNOLOGIQUE;BAC STMG;BAC STMG GESTION ET FINANCE;4;4;2;1;1;0;1;2;0;0;0;0;2;2
7164.0;2021;14;RENNES;FEMININ;INDIVIDUEL;BAC TECHNOLOGIQUE;BAC STMG;BAC STMG MERCATIQUE (MARKETING);6;2;1;0;1;0;1;1;0;0;0;1;0;1
7168.0;2021;14;RENNES;FEMININ;SCOLAIRE;BAC PROFESSIONNEL;BAC PRO PROD;BAC PRO 22106 CUISINE;96;96;94;1;1;1;0;95;0;8;32;34;21;1
7175.0;2021;14;RENNES;FEMININ;SCOLAIRE;BAC PROFESSIONNEL;BAC PRO PROD;BACPRO 23103 TECHNICIEN GEOMETRE-TOPOGRAPHE;2;2;2;0;0;0;0;2;0;0;0;2;0;0
7185.0;2021;14;RENNES;FEMININ;SCOLAIRE;BAC PROFESSIONNEL;BAC PRO PROD;BAC PRO 25009 MAINTENANCE NAUTIQUE;3;3;3;0;0;0;0;3;0;0;0;1;2;0
7207.0;2021;14;RENNES;FEMININ;SCOLAIRE;BAC PROFESSIONNEL;BAC PRO PROD;BAC PRO AG 21302 GEST MILIEUX NATURELS FAUNE;22;22;21;1;0;0;0;21;0;1;2;7;11;1
7214.0;2021;14;RENNES;FEMININ;SCOLAIRE;BAC PROFESSIONNEL;BAC PRO SERV;BAC PRO 31107 CONDUCT. TRANSP.ROUT.MARCHANDISES;10;10;8;2;0;0;0;8;0;0;3;3;2;2
7224.0;2021;14;RENNES;FEMININ;SCOLAIRE;BAC PROFESSIONNEL;BAC PRO SERV;BAC PRO 33004 ACC.SOINS-S.PERS. OPT.EN STRUCTUR;590;588;564;16;8;5;3;569;0;29;183;245;112;19
7233.0;2021;14;RENNES;FEMININ;SCOLAIRE;BAC TECHNOLOGIQUE;BAC ST2S;BAC ST2S SCIENCES & TECHNO. SANTE & SOCIAL;939;939;894;7;38;25;13;919;0;24;175;406;314;20
7236.0;2021;14;RENNES;FEMININ;SCOLAIRE;BAC TECHNOLOGIQUE;BAC STHR;BAC STHR SC.&TEC. HOTELLERIE-RESTAURATION;54;54;54;0;0;0;0;54;0;5;21;18;10;0
7238.0;2021;14;RENNES;FEMININ;SCOLAIRE;BAC TECHNOLOGIQUE;BAC STI2D;BAC STI2D ENERGIES  ET ENVIRONNEMENT;24;24;24;0;0;0;0;24;0;0;5;12;7;0
7245.0;2021;14;RENNES;FEMININ;SCOLAIRE;BAC TECHNOLOGIQUE;BAC STMG;BAC STMG RESSOURCES HUMAINES ET COMMUNICATION;691;691;658;6;27;16;11;674;0;5;82;309;278;17
7248.0;2021;14;RENNES;MASCULIN;APPRENTISSAGE;BAC PROFESSIONNEL;BAC PRO PROD;BAC PRO 22105 BOULANGER-PÂTISSIER;7;7;6;0;1;1;0;7;0;0;1;3;3;0
7253.0;2021;14;RENNES;MASCULIN;APPRENTISSAGE;BAC PROFESSIONNEL;BAC PRO PROD;BAC PRO 23203 TECHNICIEN BAT. : ORG.REAL.GROS O;11;11;5;5;1;0;1;5;0;0;0;4;1;6
7259.0;2021;14;RENNES;MASCULIN;APPRENTISSAGE;BAC PROFESSIONNEL;BAC PRO PROD;BAC PRO 25009 MAINTENANCE NAUTIQUE;9;9;7;1;1;0;1;7;0;0;1;3;3;2
7263.0;2021;14;RENNES;MASCULIN;APPRENTISSAGE;BAC PROFESSIONNEL;BAC PRO PROD;BAC PRO 25215 MAINT.VEHIC.OPTB VEHIC.TRANS.ROUT;30;30;23;4;3;2;1;25;0;0;5;8;12;5
7268.0;2021;14;RENNES;MASCULIN;APPRENTISSAGE;BAC PROFESSIONNEL;BAC PRO PROD;BAC PRO 25406 OUVRAGES DU BATIMENT METALLERIE;2;2;2;0;0;0;0;2;0;1;0;0;1;0
7269.0;2021;14;RENNES;MASCULIN;APPRENTISSAGE;BAC PROFESSIONNEL;BAC PRO PROD;BAC PRO 25408 REPARATION DES CARROSSERIES;23;23;15;6;2;1;1;16;0;1;2;7;6;7
7275.0;2021;14;RENNES;MASCULIN;APPRENTISSAGE;BAC PROFESSIONNEL;BAC PRO PROD;BAC PRO AG 21001 AGRO-EQUIPEMENT;66;66;53;13;0;0;0;53;0;0;1;19;33;13
7278.0;2021;14;RENNES;MASCULIN;APPRENTISSAGE;BAC PROFESSIONNEL;BAC PRO PROD;BAC PRO AG 21203 TECHN CONSEIL DE VENTE ANIMAL;4;4;4;0;0;0;0;4;0;1;0;0;3;0
7280.0;2021;14;RENNES;MASCULIN;APPRENTISSAGE;BAC PROFESSIONNEL;BAC PRO PROD;BAC PRO AG 21211 COND GEST ENTR HIPPIQUE;4;4;4;0;0;0;0;4;0;0;1;1;2;0
7282.0;2021;14;RENNES;MASCULIN;APPRENTISSAGE;BAC PROFESSIONNEL;BAC PRO PROD;BAC PRO AG 21405 AMENAGEMENTS PAYSAGERS;40;40;36;4;0;0;0;36;0;1;4;9;22;4
7286.0;2021;14;RENNES;MASCULIN;APPRENTISSAGE;BAC PROFESSIONNEL;BAC PRO SERV;BAC PRO 31107 CONDUCT. TRANSP.ROUT.MARCHANDISES;6;6;6;0;0;0;0;6;0;0;1;4;1;0
7287.0;2021;14;RENNES;MASCULIN;APPRENTISSAGE;BAC PROFESSIONNEL;BAC PRO SERV;BAC PRO 31202 COMMERCE;88;87;63;13;11;8;3;71;0;1;10;31;29;16
7291.0;2021;14;RENNES;MASCULIN;ENSEIGNEMENT A DISTANCE;BAC PROFESSIONNEL;BAC PRO SERV;BAC PRO 31202 COMMERCE;4;4;1;2;1;0;1;1;0;0;0;1;0;3
7296.0;2021;14;RENNES;MASCULIN;ENSEIGNEMENT A DISTANCE;BAC TECHNOLOGIQUE;BAC STMG;BAC STMG MERCATIQUE (MARKETING);2;2;2;0;0;0;0;2;0;1;0;1;0;0
7297.0;2021;14;RENNES;MASCULIN;ENSEIGNEMENT A DISTANCE;BAC TECHNOLOGIQUE;BAC STMG;BAC STMG RESSOURCES HUMAINES ET COMMUNICATION;2;2;2;0;0;0;0;2;0;0;0;0;2;0
7302.0;2021;14;RENNES;MASCULIN;FORMATION CONTINUE;BAC PROFESSIONNEL;BAC PRO PROD;BAC PRO 25303 AERONAUTIQUE OPTION SYSTEMES;10;10;10;0;0;0;0;10;0;4;2;4;0;0
7312.0;2021;14;RENNES;MASCULIN;INDIVIDUEL;BAC PROFESSIONNEL;BAC PRO PROD;BAC PRO 25007 MAINTENANCE EQUIPEMENTS INDUST.;1;1;1;0;0;0;0;1;0;0;0;1;0;0
7330.0;2021;14;RENNES;MASCULIN;INDIVIDUEL;BAC TECHNOLOGIQUE;BAC STAV;BAC STAV AGRONOMIE ALIM ENV TERRITOI;2;2;2;0;0;0;0;2;0;0;0;0;2;0
7331.0;2021;14;RENNES;MASCULIN;INDIVIDUEL;BAC TECHNOLOGIQUE;BAC STD2A;BAC STD2A SCIENCES & TECHNO. DESIGN-ARTS APPLIQUES;1;0;0;0;0;0;0;0;0;0;0;0;0;0
7335.0;2021;14;RENNES;MASCULIN;INDIVIDUEL;BAC TECHNOLOGIQUE;BAC STMG;BAC STMG GESTION ET FINANCE;8;2;2;0;0;0;0;2;0;0;0;0;2;0
7337.0;2021;14;RENNES;MASCULIN;INDIVIDUEL;BAC TECHNOLOGIQUE;BAC STMG;BAC STMG RESSOURCES HUMAINES ET COMMUNICATION;3;0;0;0;0;0;0;0;0;0;0;0;0;0
7338.0;2021;14;RENNES;MASCULIN;INDIVIDUEL;BAC TECHNOLOGIQUE;BAC STMG;BAC STMG SYSTEMES D'INFORMATION DE GESTION;5;3;0;3;0;0;0;0;0;0;0;0;0;3
7344.0;2021;14;RENNES;MASCULIN;SCOLAIRE;BAC PROFESSIONNEL;BAC PRO PROD;BAC PRO 22503 PLASTIQUES ET COMPOSITES;23;23;18;4;1;0;1;18;0;0;3;8;7;5
7351.0;2021;14;RENNES;MASCULIN;SCOLAIRE;BAC PROFESSIONNEL;BAC PRO PROD;BACPRO 23103 TECHNICIEN GEOMETRE-TOPOGRAPHE;24;24;22;2;0;0;0;22;0;1;8;9;4;2
7352.0;2021;14;RENNES;MASCULIN;SCOLAIRE;BAC PROFESSIONNEL;BAC PRO PROD;BAC PRO 23203 TECHNICIEN BAT. : ORG.REAL.GROS O;28;28;19;7;2;0;2;19;0;1;3;6;9;9
7353.0;2021;14;RENNES;MASCULIN;SCOLAIRE;BAC PROFESSIONNEL;BAC PRO PROD;BAC PRO 23303 MENUISERIE ALUMINIUM-VERRE;5;5;3;2;0;0;0;3;0;0;1;1;1;2
7356.0;2021;14;RENNES;MASCULIN;SCOLAIRE;BAC PROFESSIONNEL;BAC PRO PROD;BAC PRO 23405 TECHNICIEN MENUISIER AGENCEUR;234;230;203;14;13;9;4;212;0;10;52;79;71;18
7367.0;2021;14;RENNES;MASCULIN;SCOLAIRE;BAC PROFESSIONNEL;BAC PRO PROD;BAC PRO 25214 MAINT.VEHIC.OPTA VOIT.PARTICUL.;265;264;246;15;3;2;1;248;0;18;52;111;67;16
7370.0;2021;14;RENNES;MASCULIN;SCOLAIRE;BAC PROFESSIONNEL;BAC PRO PROD;BAC PRO 25219 MAINT.MATERIELS OPT.A AGRICOLES;46;46;41;4;1;1;0;42;0;1;10;22;9;4
7374.0;2021;14;RENNES;MASCULIN;SCOLAIRE;BAC PROFESSIONNEL;BAC PRO PROD;BAC PRO 25303 AERONAUTIQUE OPTION SYSTEMES;27;27;26;0;1;1;0;27;0;1;11;11;4;0
7375.0;2021;14;RENNES;MASCULIN;SCOLAIRE;BAC PROFESSIONNEL;BAC PRO PROD;BAC PRO 25304 AERONAUTIQUE OPTION STRUCTURE;29;29;28;0;1;1;0;29;0;2;12;9;6;0
7380.0;2021;14;RENNES;MASCULIN;SCOLAIRE;BAC PROFESSIONNEL;BAC PRO PROD;BAC PRO 25510 METIERS ELECT. ENVIRON. CONNECTES;505;505;437;54;14;6;8;443;0;34;130;167;112;62
7388.0;2021;14;RENNES;MASCULIN;SCOLAIRE;BAC PROFESSIONNEL;BAC PRO PROD;BAC PRO AG 21204 PROD-AQUACOLES;12;12;10;2;0;0;0;10;0;0;3;1;6;2
7389.0;2021;14;RENNES;MASCULIN;SCOLAIRE;BAC PROFESSIONNEL;BAC PRO PROD;BAC PRO AG 21210 COND GEST ENTR CANIN ET FELIN;15;15;15;0;0;0;0;15;0;0;3;3;9;0
7393.0;2021;14;RENNES;MASCULIN;SCOLAIRE;BAC PROFESSIONNEL;BAC PRO PROD;BAC PRO AG 21405 AMENAGEMENTS PAYSAGERS;207;204;195;9;0;0;0;195;0;1;35;79;80;9
7398.0;2021;14;RENNES;MASCULIN;SCOLAIRE;BAC PROFESSIONNEL;BAC PRO SERV;BAC PRO 31106 LOGISTIQUE;109;108;89;9;10;6;4;95;0;3;24;29;39;13
7404.0;2021;14;RENNES;MASCULIN;SCOLAIRE;BAC PROFESSIONNEL;BAC PRO SERV;BAC PRO 32207 REAL.PR.IMPR.PLURI.OPTA.PR.GRAPH.;23;23;21;2;0;0;0;21;0;0;8;6;7;2
7414.0;2021;14;RENNES;MASCULIN;SCOLAIRE;BAC TECHNOLOGIQUE;BAC S2TMD;BAC S2TMD DANSE;2;2;2;0;0;0;0;2;0;1;0;0;1;0
7420.0;2021;14;RENNES;MASCULIN;SCOLAIRE;BAC TECHNOLOGIQUE;BAC STI2D;BAC STI2D ARCHITECTURE ET CONSTRUCTION;209;209;203;0;6;4;2;207;0;1;37;103;66;2
7428.0;2021;14;RENNES;MASCULIN;SCOLAIRE;BAC TECHNOLOGIQUE;BAC STMG;BAC STMG RESSOURCES HUMAINES ET COMMUNICATION;279;279;257;3;19;10;9;267;0;0;21;106;140;12
7431.0;2021;15;STRASBOURG;FEMININ;APPRENTISSAGE;BAC PROFESSIONNEL;BAC PRO PROD;BAC PRO 22106 CUISINE;6;6;6;0;0;0;0;6;0;1;2;3;0;0
7434.0;2021;15;STRASBOURG;FEMININ;APPRENTISSAGE;BAC PROFESSIONNEL;BAC PRO PROD;BAC PRO 25007 MAINTENANCE EQUIPEMENTS INDUST.;6;6;6;0;0;0;0;6;0;1;1;3;1;0
7440.0;2021;15;STRASBOURG;FEMININ;APPRENTISSAGE;BAC PROFESSIONNEL;BAC PRO PROD;BAC PRO AG 21113 CGEVV;1;1;1;0;0;0;0;1;0;0;0;0;1;0
7449.0;2021;15;STRASBOURG;FEMININ;APPRENTISSAGE;BAC PROFESSIONNEL;BAC PRO SERV;BAC PRO 31210 ACCUEIL -RELATION CLIENTS USAGERS;1;1;0;1;0;0;0;0;0;0;0;0;0;1
7456.0;2021;15;STRASBOURG;FEMININ;ENSEIGNEMENT A DISTANCE;BAC PROFESSIONNEL;BAC PRO SERV;BAC PRO 33004 ACC.SOINS-S.PERS. OPT.EN STRUCTUR;2;2;1;1;0;0;0;1;0;0;0;0;1;1
7459.0;2021;15;STRASBOURG;FEMININ;ENSEIGNEMENT A DISTANCE;BAC TECHNOLOGIQUE;BAC STMG;BAC STMG MERCATIQUE (MARKETING);1;1;1;0;0;0;0;1;0;0;0;1;0;0
7462.0;2021;15;STRASBOURG;FEMININ;FORMATION CONTINUE;BAC PROFESSIONNEL;BAC PRO PROD;BAC PRO 25408 REPARATION DES CARROSSERIES;1;1;1;0;0;0;0;1;0;0;0;0;1;0
7465.0;2021;15;STRASBOURG;FEMININ;FORMATION CONTINUE;BAC PROFESSIONNEL;BAC PRO SERV;BAC PRO 31202 COMMERCE;7;7;7;0;0;0;0;7;0;0;3;2;2;0
7470.0;2021;15;STRASBOURG;FEMININ;INDIVIDUEL;BAC PROFESSIONNEL;BAC PRO SERV;BAC PRO 30001 GESTION-ADMINISTRATION;9;4;2;1;1;1;0;3;0;0;1;0;2;1
7479.0;2021;15;STRASBOURG;FEMININ;INDIVIDUEL;BAC TECHNOLOGIQUE;BAC STL;BAC STL SCIENCES PHYSIQUES CHIMIQUES  EN LABORAT.;1;0;0;0;0;0;0;0;0;0;0;0;0;0
7483.0;2021;15;STRASBOURG;FEMININ;SCOLAIRE;BAC GENERAL;BAC GENERAL;BAC GENE 10019 BAC GENERAL;5509;5507;5366;35;106;47;59;5413;210;977;1686;1708;832;94
7485.0;2021;15;STRASBOURG;FEMININ;SCOLAIRE;BAC PROFESSIONNEL;BAC PRO PROD;BAC PRO 22004 PROC. CHIMIE EAU PAPIERS-CARTONS;4;4;4;0;0;0;0;4;0;0;1;3;0;0
7487.0;2021;15;STRASBOURG;FEMININ;SCOLAIRE;BAC PROFESSIONNEL;BAC PRO PROD;BAC PRO 22106 CUISINE;25;25;20;5;0;0;0;20;0;4;1;10;5;5
7489.0;2021;15;STRASBOURG;FEMININ;SCOLAIRE;BAC PROFESSIONNEL;BAC PRO PROD;BAC PRO 23004 TECHN. ETUDES BAT.A ETUDES & ECO.;9;9;7;0;2;2;0;9;0;0;0;5;4;0
7503.0;2021;15;STRASBOURG;FEMININ;SCOLAIRE;BAC PROFESSIONNEL;BAC PRO PROD;BAC PRO 25510 METIERS ELECT. ENVIRON. CONNECTES;3;3;3;0;0;0;0;3;0;0;0;2;1;0
7504.0;2021;15;STRASBOURG;FEMININ;SCOLAIRE;BAC PROFESSIONNEL;BAC PRO PROD;BAC PRO 25514 SYST.NUM.OPT.B AUD.RES.EQUIP.DOM.;3;3;3;0;0;0;0;3;0;0;1;2;0;0
7509.0;2021;15;STRASBOURG;FEMININ;SCOLAIRE;BAC PROFESSIONNEL;BAC PRO PROD;BAC PRO AG 21302 GEST MILIEUX NATURELS FAUNE;6;6;5;1;0;0;0;5;0;0;1;4;0;1
7516.0;2021;15;STRASBOURG;FEMININ;SCOLAIRE;BAC PROFESSIONNEL;BAC PRO SERV;BAC PRO 31202 COMMERCE;337;336;289;12;35;21;14;310;0;20;74;106;110;26
7517.0;2021;15;STRASBOURG;FEMININ;SCOLAIRE;BAC PROFESSIONNEL;BAC PRO SERV;BAC PRO 31206 VENTE (PROSPECT.NEGO.SUIV.CLIENT;35;35;24;6;5;5;0;29;0;1;3;15;10;6
7527.0;2021;15;STRASBOURG;FEMININ;SCOLAIRE;BAC PROFESSIONNEL;BAC PRO SERV;BAC PRO 33603 ESTHETIQUE COSMETIQUE PARFUMERIE;71;70;62;7;1;0;1;62;0;1;23;23;15;8
7536.0;2021;15;STRASBOURG;FEMININ;SCOLAIRE;BAC TECHNOLOGIQUE;BAC STI2D;BAC STI2D ENERGIES  ET ENVIRONNEMENT;6;6;5;0;1;0;1;5;0;1;0;1;3;1
7538.0;2021;15;STRASBOURG;FEMININ;SCOLAIRE;BAC TECHNOLOGIQUE;BAC STI2D;BAC STI2D SYSTÈME D'INFORMATION  ET NUMERIQUE;11;11;11;0;0;0;0;11;0;1;3;3;4;0
7540.0;2021;15;STRASBOURG;FEMININ;SCOLAIRE;BAC TECHNOLOGIQUE;BAC STL;BAC STL SCIENCES PHYSIQUES CHIMIQUES  EN LABORAT.;33;33;29;0;4;0;4;29;0;3;5;6;15;4
7548.0;2021;15;STRASBOURG;MASCULIN;APPRENTISSAGE;BAC PROFESSIONNEL;BAC PRO PROD;BAC PRO 22403 ARTS.& MET.ART:MET.ENSEIGN SIGNA;5;5;5;0;0;0;0;5;0;1;2;1;1;0
7555.0;2021;15;STRASBOURG;MASCULIN;APPRENTISSAGE;BAC PROFESSIONNEL;BAC PRO PROD;BAC PRO 23405 TECHNICIEN MENUISIER AGENCEUR;15;15;12;2;1;0;1;12;0;1;3;3;5;3
7557.0;2021;15;STRASBOURG;MASCULIN;APPRENTISSAGE;BAC PROFESSIONNEL;BAC PRO PROD;BAC PRO 25007 MAINTENANCE EQUIPEMENTS INDUST.;48;48;46;1;1;1;0;47;0;2;16;14;15;1
7559.0;2021;15;STRASBOURG;MASCULIN;APPRENTISSAGE;BAC PROFESSIONNEL;BAC PRO PROD;BAC PRO 25107 TECHNICIEN OUTILLEUR;4;4;4;0;0;0;0;4;0;0;0;2;2;0
7560.0;2021;15;STRASBOURG;MASCULIN;APPRENTISSAGE;BAC PROFESSIONNEL;BAC PRO PROD;BAC PRO 25214 MAINT.VEHIC.OPTA VOIT.PARTICUL.;87;86;78;7;1;0;1;78;0;7;25;35;11;8
7562.0;2021;15;STRASBOURG;MASCULIN;APPRENTISSAGE;BAC PROFESSIONNEL;BAC PRO PROD;BAC PRO 25216 MAINT.VEHIC.OPTC MOTOCYCLES;2;2;2;0;0;0;0;2;0;0;2;0;0;0
7568.0;2021;15;STRASBOURG;MASCULIN;APPRENTISSAGE;BAC PROFESSIONNEL;BAC PRO PROD;BAC PRO 25410 CONSTRUCTION DES CARROSSERIES;1;1;1;0;0;0;0;1;0;0;0;0;1;0
7574.0;2021;15;STRASBOURG;MASCULIN;APPRENTISSAGE;BAC PROFESSIONNEL;BAC PRO PROD;BAC PRO AG 21001 AGRO-EQUIPEMENT;16;15;15;0;0;0;0;15;0;1;2;5;7;0
7580.0;2021;15;STRASBOURG;MASCULIN;APPRENTISSAGE;BAC PROFESSIONNEL;BAC PRO PROD;BAC PRO AG 21406 TEC CONS VTE PROD DES JARDINS;1;1;1;0;0;0;0;1;0;0;0;1;0;0
7591.0;2021;15;STRASBOURG;MASCULIN;ENSEIGNEMENT A DISTANCE;BAC TECHNOLOGIQUE;BAC STMG;BAC STMG RESSOURCES HUMAINES ET COMMUNICATION;2;2;2;0;0;0;0;2;0;0;1;0;1;0
7595.0;2021;15;STRASBOURG;MASCULIN;FORMATION CONTINUE;BAC PROFESSIONNEL;BAC PRO PROD;BAC PRO 22704 TECHN. MAINT. SYST.ENERG.CLIMATI;23;23;21;1;1;1;0;22;0;9;5;5;3;1
7603.0;2021;15;STRASBOURG;MASCULIN;FORMATION CONTINUE;BAC PROFESSIONNEL;BAC PRO PROD;BAC PRO 25510 METIERS ELECT. ENVIRON. CONNECTES;13;13;13;0;0;0;0;13;0;2;5;4;2;0
7605.0;2021;15;STRASBOURG;MASCULIN;FORMATION CONTINUE;BAC PROFESSIONNEL;BAC PRO SERV;BAC PRO 31202 COMMERCE;8;8;8;0;0;0;0;8;0;1;3;1;3;0
7609.0;2021;15;STRASBOURG;MASCULIN;INDIVIDUEL;BAC PROFESSIONNEL;BAC PRO PROD;BAC PRO 22703 TECHN.INSTALL.SYST.ENERG.CLIMATI;1;0;0;0;0;0;0;0;0;0;0;0;0;0
7625.0;2021;15;STRASBOURG;MASCULIN;INDIVIDUEL;BAC TECHNOLOGIQUE;BAC STAV;BAC STAV AGRONOMIE ALIM ENV TERRITOI;1;0;0;0;0;0;0;0;0;0;0;0;0;0
7627.0;2021;15;STRASBOURG;MASCULIN;INDIVIDUEL;BAC TECHNOLOGIQUE;BAC STI2D;BAC STI2D SYSTÈME D'INFORMATION  ET NUMERIQUE;1;0;0;0;0;0;0;0;0;0;0;0;0;0
7629.0;2021;15;STRASBOURG;MASCULIN;INDIVIDUEL;BAC TECHNOLOGIQUE;BAC STMG;BAC STMG MERCATIQUE (MARKETING);17;14;8;5;1;0;1;8;0;0;1;1;6;6
7632.0;2021;15;STRASBOURG;MASCULIN;SCOLAIRE;BAC GENERAL;BAC GENERAL;BAC GENE 10019 BAC GENERAL;4420;4420;4232;32;156;79;77;4311;85;582;1061;1483;1100;109
7633.0;2021;15;STRASBOURG;MASCULIN;SCOLAIRE;BAC PROFESSIONNEL;BAC PRO PROD;BAC PRO 22003 BIO-INDUSTRIES DE TRANSFORMATION;14;14;10;4;0;0;0;10;0;1;0;2;7;4
7634.0;2021;15;STRASBOURG;MASCULIN;SCOLAIRE;BAC PROFESSIONNEL;BAC PRO PROD;BAC PRO 22004 PROC. CHIMIE EAU PAPIERS-CARTONS;27;27;20;5;2;1;1;21;0;0;3;8;10;6
7638.0;2021;15;STRASBOURG;MASCULIN;SCOLAIRE;BAC PROFESSIONNEL;BAC PRO PROD;BAC PRO 22703 TECHN.INSTALL.SYST.ENERG.CLIMATI;32;32;20;4;8;7;1;27;0;0;2;6;19;5
7640.0;2021;15;STRASBOURG;MASCULIN;SCOLAIRE;BAC PROFESSIONNEL;BAC PRO PROD;BAC PRO 23004 TECHN. ETUDES BAT.A ETUDES & ECO.;17;17;11;5;1;1;0;12;0;0;1;8;3;5
7641.0;2021;15;STRASBOURG;MASCULIN;SCOLAIRE;BAC PROFESSIONNEL;BAC PRO PROD;BAC PRO 23005 TECHN. ETUDES BAT B ASSIST.ARCHI.;19;19;17;1;1;1;0;18;0;0;7;6;5;1
7648.0;2021;15;STRASBOURG;MASCULIN;SCOLAIRE;BAC PROFESSIONNEL;BAC PRO PROD;BAC PRO 23407 TECHNIC.FAB.BOIS ET MATERX ASSOC;15;15;11;1;3;2;1;13;0;1;1;1;10;2
7650.0;2021;15;STRASBOURG;MASCULIN;SCOLAIRE;BAC PROFESSIONNEL;BAC PRO PROD;BAC PRO 25006 MICROTECHNIQUES;19;19;13;5;1;1;0;14;0;0;3;3;8;5
7655.0;2021;15;STRASBOURG;MASCULIN;SCOLAIRE;BAC PROFESSIONNEL;BAC PRO PROD;BAC PRO 25215 MAINT.VEHIC.OPTB VEHIC.TRANS.ROUT;18;18;14;4;0;0;0;14;0;1;2;7;4;4
7658.0;2021;15;STRASBOURG;MASCULIN;SCOLAIRE;BAC PROFESSIONNEL;BAC PRO PROD;BAC PRO 25220 MAINT.MATERIELS OPT.B TP MANUT.;12;12;9;2;1;0;1;9;0;1;3;5;0;3
7659.0;2021;15;STRASBOURG;MASCULIN;SCOLAIRE;BAC PROFESSIONNEL;BAC PRO PROD;BAC PRO 25221 MAINT.MATERIELS OPT.C ESP. VERTS;5;5;4;1;0;0;0;4;0;0;0;1;3;1
7661.0;2021;15;STRASBOURG;MASCULIN;SCOLAIRE;BAC PROFESSIONNEL;BAC PRO PROD;BAC PRO 25408 REPARATION DES CARROSSERIES;20;19;14;5;0;0;0;14;0;0;1;9;4;5
7664.0;2021;15;STRASBOURG;MASCULIN;SCOLAIRE;BAC PROFESSIONNEL;BAC PRO PROD;BAC PRO 25510 METIERS ELECT. ENVIRON. CONNECTES;326;326;256;55;15;9;6;265;0;17;53;96;99;61
7666.0;2021;15;STRASBOURG;MASCULIN;SCOLAIRE;BAC PROFESSIONNEL;BAC PRO PROD;BAC PRO 25514 SYST.NUM.OPT.B AUD.RES.EQUIP.DOM.;37;37;34;2;1;0;1;34;0;1;8;15;10;3
7669.0;2021;15;STRASBOURG;MASCULIN;SCOLAIRE;BAC PROFESSIONNEL;BAC PRO PROD;BAC PRO AG 21113 CGEVV;12;12;11;1;0;0;0;11;0;0;1;5;5;1
7687.0;2021;15;STRASBOURG;MASCULIN;SCOLAIRE;BAC PROFESSIONNEL;BAC PRO SERV;BAC PRO 33002 SERVICES DE PROXIMITE  VIE LOCAL;31;31;21;5;5;1;4;22;0;1;3;8;10;9
7690.0;2021;15;STRASBOURG;MASCULIN;SCOLAIRE;BAC PROFESSIONNEL;BAC PRO SERV;BAC PRO 33102 PROTHESE DENTAIRE;6;6;4;2;0;0;0;4;0;0;0;0;4;2
7694.0;2021;15;STRASBOURG;MASCULIN;SCOLAIRE;BAC PROFESSIONNEL;BAC PRO SERV;BAC PRO AG 33002 SERV PERS TERRIT;4;4;3;1;0;0;0;3;0;0;1;1;1;1
7697.0;2021;15;STRASBOURG;MASCULIN;SCOLAIRE;BAC TECHNOLOGIQUE;BAC STD2A;BAC STD2A SCIENCES & TECHNO. DESIGN-ARTS APPLIQUES;22;22;22;0;0;0;0;22;1;3;9;9;0;0
7722.0;2021;16;TOULOUSE;FEMININ;APPRENTISSAGE;BAC PROFESSIONNEL;BAC PRO PROD;BAC PRO 25219 MAINT.MATERIELS OPT.A AGRICOLES;1;1;1;0;0;0;0;1;0;0;1;0;0;0
7728.0;2021;16;TOULOUSE;FEMININ;APPRENTISSAGE;BAC PROFESSIONNEL;BAC PRO PROD;BAC PRO AG 21004 CGEA;2;2;2;0;0;0;0;2;0;0;0;0;2;0
7736.0;2021;16;TOULOUSE;FEMININ;APPRENTISSAGE;BAC PROFESSIONNEL;BAC PRO SERV;BAC PRO 32304 PHOTOGRAPHIE;3;3;3;0;0;0;0;3;0;0;1;1;1;0
7743.0;2021;16;TOULOUSE;FEMININ;ENSEIGNEMENT A DISTANCE;BAC GENERAL;BAC GENERAL;BAC GENE 10019 BAC GENERAL;61;61;56;3;2;1;1;57;1;13;24;10;9;4
7748.0;2021;16;TOULOUSE;FEMININ;ENSEIGNEMENT A DISTANCE;BAC PROFESSIONNEL;BAC PRO SERV;BAC PRO 33603 ESTHETIQUE COSMETIQUE PARFUMERIE;1;0;0;0;0;0;0;0;0;0;0;0;0;0
7752.0;2021;16;TOULOUSE;FEMININ;ENSEIGNEMENT A DISTANCE;BAC TECHNOLOGIQUE;BAC STMG;BAC STMG RESSOURCES HUMAINES ET COMMUNICATION;5;5;5;0;0;0;0;5;0;0;3;0;2;0
7756.0;2021;16;TOULOUSE;FEMININ;FORMATION CONTINUE;BAC PROFESSIONNEL;BAC PRO PROD;BAC PRO AG 21004 CGEA;1;1;1;0;0;0;0;1;0;0;0;1;0;0
7758.0;2021;16;TOULOUSE;FEMININ;FORMATION CONTINUE;BAC PROFESSIONNEL;BAC PRO SERV;BAC PRO 31202 COMMERCE;3;3;3;0;0;0;0;3;0;0;1;0;2;0
7766.0;2021;16;TOULOUSE;FEMININ;INDIVIDUEL;BAC PROFESSIONNEL;BAC PRO PROD;BAC PRO AG 21211 COND GEST ENTR HIPPIQUE;6;6;5;1;0;0;0;5;0;0;1;1;3;1
7768.0;2021;16;TOULOUSE;FEMININ;INDIVIDUEL;BAC PROFESSIONNEL;BAC PRO PROD;BAC PRO AG 21405 AMENAGEMENTS PAYSAGERS;1;1;1;0;0;0;0;1;0;0;0;0;1;0
7769.0;2021;16;TOULOUSE;FEMININ;INDIVIDUEL;BAC PROFESSIONNEL;BAC PRO SERV;BAC PRO 30001 GESTION-ADMINISTRATION;4;1;1;0;0;0;0;1;0;0;0;0;1;0
7771.0;2021;16;TOULOUSE;FEMININ;INDIVIDUEL;BAC PROFESSIONNEL;BAC PRO SERV;BAC PRO 31206 VENTE (PROSPECT.NEGO.SUIV.CLIENT;3;3;1;1;1;1;0;2;0;0;0;1;1;1
7773.0;2021;16;TOULOUSE;FEMININ;INDIVIDUEL;BAC PROFESSIONNEL;BAC PRO SERV;BAC PRO 33003 ACC.SOINS-S.PERS. OPT.A DOMICILE;3;2;0;2;0;0;0;0;0;0;0;0;0;2
7775.0;2021;16;TOULOUSE;FEMININ;INDIVIDUEL;BAC PROFESSIONNEL;BAC PRO SERV;BAC PRO 33603 ESTHETIQUE COSMETIQUE PARFUMERIE;1;0;0;0;0;0;0;0;0;0;0;0;0;0
7780.0;2021;16;TOULOUSE;FEMININ;INDIVIDUEL;BAC TECHNOLOGIQUE;BAC STMG;BAC STMG MERCATIQUE (MARKETING);9;2;1;1;0;0;0;1;0;0;0;0;1;1
7782.0;2021;16;TOULOUSE;FEMININ;INDIVIDUEL;BAC TECHNOLOGIQUE;BAC STMG;BAC STMG SYSTEMES D'INFORMATION DE GESTION;1;0;0;0;0;0;0;0;0;0;0;0;0;0
7785.0;2021;16;TOULOUSE;FEMININ;SCOLAIRE;BAC PROFESSIONNEL;BAC PRO PROD;BAC PRO 22003 BIO-INDUSTRIES DE TRANSFORMATION;16;16;5;2;9;4;5;9;0;0;3;1;5;7
7791.0;2021;16;TOULOUSE;FEMININ;SCOLAIRE;BAC PROFESSIONNEL;BAC PRO PROD;BAC PRO 22703 TECHN.INSTALL.SYST.ENERG.CLIMATI;1;1;1;0;0;0;0;1;0;0;1;0;0;0
7793.0;2021;16;TOULOUSE;FEMININ;SCOLAIRE;BAC PROFESSIONNEL;BAC PRO PROD;BAC PRO 23004 TECHN. ETUDES BAT.A ETUDES & ECO.;12;12;8;3;1;1;0;9;0;0;1;2;6;3
7796.0;2021;16;TOULOUSE;FEMININ;SCOLAIRE;BAC PROFESSIONNEL;BAC PRO PROD;BAC PRO 23206 INTERV. SUR PATRIMOINE BATI OPT.B;1;1;1;0;0;0;0;1;0;1;0;0;0;0
7809.0;2021;16;TOULOUSE;FEMININ;SCOLAIRE;BAC PROFESSIONNEL;BAC PRO PROD;BAC PRO 25220 MAINT.MATERIELS OPT.B TP MANUT.;1;1;0;0;1;1;0;1;0;0;0;0;1;0
7811.0;2021;16;TOULOUSE;FEMININ;SCOLAIRE;BAC PROFESSIONNEL;BAC PRO PROD;BAC PRO 25302 AERONAUTIQUE OPTION AVIONIQUE;12;12;12;0;0;0;0;12;0;5;4;3;0;0
7812.0;2021;16;TOULOUSE;FEMININ;SCOLAIRE;BAC PROFESSIONNEL;BAC PRO PROD;BAC PRO 25303 AERONAUTIQUE OPTION SYSTEMES;1;1;1;0;0;0;0;1;0;0;1;0;0;0
7819.0;2021;16;TOULOUSE;FEMININ;SCOLAIRE;BAC PROFESSIONNEL;BAC PRO PROD;BAC PRO 25515 SYST.NUM.OPT.C RES.INF.SYST.COMM.;8;8;8;0;0;0;0;8;0;0;2;4;2;0
7836.0;2021;16;TOULOUSE;FEMININ;SCOLAIRE;BAC PROFESSIONNEL;BAC PRO SERV;BAC PRO 31202 COMMERCE;413;413;353;25;35;27;8;380;0;20;80;143;137;33
7837.0;2021;16;TOULOUSE;FEMININ;SCOLAIRE;BAC PROFESSIONNEL;BAC PRO SERV;BAC PRO 31206 VENTE (PROSPECT.NEGO.SUIV.CLIENT;101;101;79;16;6;4;2;83;0;5;20;32;26;18
7841.0;2021;16;TOULOUSE;FEMININ;SCOLAIRE;BAC PROFESSIONNEL;BAC PRO SERV;BAC PRO 32303 ART.& MET.ART:COM.VIS.VIS.PLURI-M;41;41;39;2;0;0;0;39;0;7;12;10;10;2
7846.0;2021;16;TOULOUSE;FEMININ;SCOLAIRE;BAC PROFESSIONNEL;BAC PRO SERV;BAC PRO 33101 OPTIQUE LUNETTERIE;12;12;12;0;0;0;0;12;0;3;6;3;0;0
7847.0;2021;16;TOULOUSE;FEMININ;SCOLAIRE;BAC PROFESSIONNEL;BAC PRO SERV;BAC PRO 33102 PROTHESE DENTAIRE;26;25;25;0;0;0;0;25;0;0;9;12;4;0
7848.0;2021;16;TOULOUSE;FEMININ;SCOLAIRE;BAC PROFESSIONNEL;BAC PRO SERV;BAC PRO 33103 TECHNICIEN APPAREIL. ORTHOPEDIQUE;10;10;10;0;0;0;0;10;0;0;2;3;5;0
7849.0;2021;16;TOULOUSE;FEMININ;SCOLAIRE;BAC PROFESSIONNEL;BAC PRO SERV;BAC PRO 33403 COMMERC. SERVICES EN RESTAURATION;79;79;68;4;7;4;3;72;0;5;14;24;29;7
7850.0;2021;16;TOULOUSE;FEMININ;SCOLAIRE;BAC PROFESSIONNEL;BAC PRO SERV;BAC PRO 33602 PERRUQUIER POSTICHEUR;6;6;6;0;0;0;0;6;0;1;2;3;0;0
7857.0;2021;16;TOULOUSE;FEMININ;SCOLAIRE;BAC TECHNOLOGIQUE;BAC STAV;BAC STAV AGRONOMIE ALIM ENV TERRITOI;160;159;157;2;0;0;0;157;0;2;30;78;47;2
7859.0;2021;16;TOULOUSE;FEMININ;SCOLAIRE;BAC TECHNOLOGIQUE;BAC STHR;BAC STHR SC.&TEC. HOTELLERIE-RESTAURATION;57;57;53;0;4;3;1;56;0;5;9;22;20;1
7860.0;2021;16;TOULOUSE;FEMININ;SCOLAIRE;BAC TECHNOLOGIQUE;BAC STI2D;BAC STI2D ARCHITECTURE ET CONSTRUCTION;42;42;39;2;1;1;0;40;1;2;8;21;8;2
7864.0;2021;16;TOULOUSE;FEMININ;SCOLAIRE;BAC TECHNOLOGIQUE;BAC STL;BAC STL BIOCHIM.-BIOLOGIE-BIOTECHNOL.;139;139;136;1;2;0;2;136;1;12;25;64;34;3
7874.0;2021;16;TOULOUSE;MASCULIN;APPRENTISSAGE;BAC PROFESSIONNEL;BAC PRO PROD;BAC PRO 22503 PLASTIQUES ET COMPOSITES;1;1;1;0;0;0;0;1;0;0;0;1;0;0
7880.0;2021;16;TOULOUSE;MASCULIN;APPRENTISSAGE;BAC PROFESSIONNEL;BAC PRO PROD;BAC PRO 23102 TRAVAUX PUBLICS;16;16;15;1;0;0;0;15;0;1;1;8;5;1
7881.0;2021;16;TOULOUSE;MASCULIN;APPRENTISSAGE;BAC PROFESSIONNEL;BAC PRO PROD;BAC PRO 23203 TECHNICIEN BAT. : ORG.REAL.GROS O;4;4;3;0;1;0;1;3;0;0;1;0;2;1
7886.0;2021;16;TOULOUSE;MASCULIN;APPRENTISSAGE;BAC PROFESSIONNEL;BAC PRO PROD;BAC PRO 23404 TECHNICIEN CONSTRUCTEUR BOIS;3;3;3;0;0;0;0;3;0;0;0;2;1;0
7905.0;2021;16;TOULOUSE;MASCULIN;APPRENTISSAGE;BAC PROFESSIONNEL;BAC PRO PROD;BAC PRO 25515 SYST.NUM.OPT.C RES.INF.SYST.COMM.;7;7;3;3;1;0;1;3;0;0;1;0;2;4
7906.0;2021;16;TOULOUSE;MASCULIN;APPRENTISSAGE;BAC PROFESSIONNEL;BAC PRO PROD;BAC PRO AG 21004 CGEA;30;29;24;5;0;0;0;24;0;0;4;7;13;5
7916.0;2021;16;TOULOUSE;MASCULIN;APPRENTISSAGE;BAC PROFESSIONNEL;BAC PRO SERV;BAC PRO 33403 COMMERC. SERVICES EN RESTAURATION;7;7;5;2;0;0;0;5;0;0;0;5;0;2
7921.0;2021;16;TOULOUSE;MASCULIN;ENSEIGNEMENT A DISTANCE;BAC PROFESSIONNEL;BAC PRO SERV;BAC PRO 30001 GESTION-ADMINISTRATION;3;2;2;0;0;0;0;2;0;0;0;1;1;0
7922.0;2021;16;TOULOUSE;MASCULIN;ENSEIGNEMENT A DISTANCE;BAC PROFESSIONNEL;BAC PRO SERV;BAC PRO 31202 COMMERCE;3;3;1;2;0;0;0;1;0;0;0;0;1;2
7924.0;2021;16;TOULOUSE;MASCULIN;ENSEIGNEMENT A DISTANCE;BAC PROFESSIONNEL;BAC PRO SERV;BAC PRO 31210 ACCUEIL -RELATION CLIENTS USAGERS;1;0;0;0;0;0;0;0;0;0;0;0;0;0
7927.0;2021;16;TOULOUSE;MASCULIN;ENSEIGNEMENT A DISTANCE;BAC TECHNOLOGIQUE;BAC STMG;BAC STMG RESSOURCES HUMAINES ET COMMUNICATION;2;2;2;0;0;0;0;2;0;0;2;0;0;0
7947.0;2021;16;TOULOUSE;MASCULIN;INDIVIDUEL;BAC PROFESSIONNEL;BAC PRO PROD;BAC PRO 25515 SYST.NUM.OPT.C RES.INF.SYST.COMM.;2;2;2;0;0;0;0;2;0;0;0;0;2;0
7949.0;2021;16;TOULOUSE;MASCULIN;INDIVIDUEL;BAC PROFESSIONNEL;BAC PRO PROD;BAC PRO AG 21113 CGEVV;1;0;0;0;0;0;0;0;0;0;0;0;0;0
7950.0;2021;16;TOULOUSE;MASCULIN;INDIVIDUEL;BAC PROFESSIONNEL;BAC PRO PROD;BAC PRO AG 21114 CONDUITE PRODUCTIONS HORTICOLES;4;3;3;0;0;0;0;3;0;0;0;0;3;0
7956.0;2021;16;TOULOUSE;MASCULIN;INDIVIDUEL;BAC PROFESSIONNEL;BAC PRO SERV;BAC PRO 31210 ACCUEIL -RELATION CLIENTS USAGERS;1;1;0;1;0;0;0;0;0;0;0;0;0;1
7957.0;2021;16;TOULOUSE;MASCULIN;INDIVIDUEL;BAC PROFESSIONNEL;BAC PRO SERV;BAC PRO 33403 COMMERC. SERVICES EN RESTAURATION;1;1;0;1;0;0;0;0;0;0;0;0;0;1
7963.0;2021;16;TOULOUSE;MASCULIN;INDIVIDUEL;BAC TECHNOLOGIQUE;BAC STI2D;BAC STI2D ENERGIES  ET ENVIRONNEMENT;1;0;0;0;0;0;0;0;0;0;0;0;0;0
7966.0;2021;16;TOULOUSE;MASCULIN;INDIVIDUEL;BAC TECHNOLOGIQUE;BAC STL;BAC STL SCIENCES PHYSIQUES CHIMIQUES  EN LABORAT.;1;1;0;0;1;0;1;0;0;0;0;0;0;1
7970.0;2021;16;TOULOUSE;MASCULIN;SCOLAIRE;BAC GENERAL;BAC GENERAL;BAC GENE 10019 BAC GENERAL;6845;6844;6497;51;296;180;116;6677;105;718;1523;2384;1947;167
7976.0;2021;16;TOULOUSE;MASCULIN;SCOLAIRE;BAC PROFESSIONNEL;BAC PRO PROD;BAC PRO 22106 CUISINE;159;159;146;7;6;6;0;152;0;14;45;64;29;7
7984.0;2021;16;TOULOUSE;MASCULIN;SCOLAIRE;BAC PROFESSIONNEL;BAC PRO PROD;BAC PRO 23102 TRAVAUX PUBLICS;43;43;36;5;2;2;0;38;0;0;5;19;14;5
7985.0;2021;16;TOULOUSE;MASCULIN;SCOLAIRE;BAC PROFESSIONNEL;BAC PRO PROD;BACPRO 23103 TECHNICIEN GEOMETRE-TOPOGRAPHE;12;12;8;0;4;4;0;12;0;0;2;3;7;0
7992.0;2021;16;TOULOUSE;MASCULIN;SCOLAIRE;BAC PROFESSIONNEL;BAC PRO PROD;BAC PRO 23406 TECHNICIEN DE SCIERIE;4;4;4;0;0;0;0;4;0;0;3;1;0;0
7994.0;2021;16;TOULOUSE;MASCULIN;SCOLAIRE;BAC PROFESSIONNEL;BAC PRO PROD;BAC PRO 23408 Etude et réalisation d'agencement;2;2;2;0;0;0;0;2;0;0;1;1;0;0
7996.0;2021;16;TOULOUSE;MASCULIN;SCOLAIRE;BAC PROFESSIONNEL;BAC PRO PROD;BAC PRO 24203 METIERS DE LA MODE - VÊTEMENT;7;7;6;1;0;0;0;6;0;0;1;1;4;1
7998.0;2021;16;TOULOUSE;MASCULIN;SCOLAIRE;BAC PROFESSIONNEL;BAC PRO PROD;BAC PRO 25007 MAINTENANCE EQUIPEMENTS INDUST.;265;265;203;49;13;6;7;209;0;11;32;78;88;56
8011.0;2021;16;TOULOUSE;MASCULIN;SCOLAIRE;BAC PROFESSIONNEL;BAC PRO PROD;BAC PRO 25406 OUVRAGES DU BATIMENT METALLERIE;9;9;6;3;0;0;0;6;0;0;1;1;4;3
8031.0;2021;16;TOULOUSE;MASCULIN;SCOLAIRE;BAC PROFESSIONNEL;BAC PRO PROD;BAC PRO AG 22107 TEC CONS VTE ALIMENTATION P.ALIM;13;13;13;0;0;0;0;13;0;0;2;0;11;0
8040.0;2021;16;TOULOUSE;MASCULIN;SCOLAIRE;BAC PROFESSIONNEL;BAC PRO SERV;BAC PRO 32208 REAL.PR.IMPR.PLURI.OPTB.PR.IMPR.;6;5;3;2;0;0;0;3;0;0;1;0;2;2
8046.0;2021;16;TOULOUSE;MASCULIN;SCOLAIRE;BAC PROFESSIONNEL;BAC PRO SERV;BAC PRO 33101 OPTIQUE LUNETTERIE;4;4;4;0;0;0;0;4;0;1;0;2;1;0
8053.0;2021;16;TOULOUSE;MASCULIN;SCOLAIRE;BAC TECHNOLOGIQUE;BAC S2TMD;BAC S2TMD MUSIQUE;4;4;4;0;0;0;0;4;0;1;3;0;0;0
8063.0;2021;16;TOULOUSE;MASCULIN;SCOLAIRE;BAC TECHNOLOGIQUE;BAC STL;BAC STL SCIENCES PHYSIQUES CHIMIQUES  EN LABORAT.;83;83;71;1;11;9;2;80;0;2;5;32;41;3
8064.0;2021;16;TOULOUSE;MASCULIN;SCOLAIRE;BAC TECHNOLOGIQUE;BAC STMG;BAC STMG GESTION ET FINANCE;336;336;299;7;30;21;9;320;1;4;46;133;136;16
8070.0;2021;25;VERSAILLES;FEMININ;APPRENTISSAGE;BAC PROFESSIONNEL;BAC PRO PROD;BAC PRO 22703 TECHN.INSTALL.SYST.ENERG.CLIMATI;1;1;1;0;0;0;0;1;0;0;0;0;1;0
8073.0;2021;25;VERSAILLES;FEMININ;APPRENTISSAGE;BAC PROFESSIONNEL;BAC PRO PROD;BAC PRO 25215 MAINT.VEHIC.OPTB VEHIC.TRANS.ROUT;2;2;2;0;0;0;0;2;0;0;0;0;2;0
8078.0;2021;25;VERSAILLES;FEMININ;APPRENTISSAGE;BAC PROFESSIONNEL;BAC PRO PROD;BAC PRO 25408 REPARATION DES CARROSSERIES;3;3;3;0;0;0;0;3;0;1;0;1;1;0
8081.0;2021;25;VERSAILLES;FEMININ;APPRENTISSAGE;BAC PROFESSIONNEL;BAC PRO PROD;BAC PRO AG 21210 COND GEST ENTR CANIN ET FELIN;1;0;0;0;0;0;0;0;0;0;0;0;0;0
8094.0;2021;25;VERSAILLES;FEMININ;ENSEIGNEMENT A DISTANCE;BAC PROFESSIONNEL;BAC PRO SERV;BAC PRO 30001 GESTION-ADMINISTRATION;9;6;6;0;0;0;0;6;0;0;2;2;2;0
8113.0;2021;25;VERSAILLES;FEMININ;FORMATION CONTINUE;BAC PROFESSIONNEL;BAC PRO SERV;BAC PRO 34403 METIERS DE LA SECURITE;4;4;3;1;0;0;0;3;0;0;1;2;0;1
8123.0;2021;25;VERSAILLES;FEMININ;INDIVIDUEL;BAC PROFESSIONNEL;BAC PRO PROD;BAC PRO AG 21210 COND GEST ENTR CANIN ET FELIN;1;1;1;0;0;0;0;1;0;0;0;0;1;0
8125.0;2021;25;VERSAILLES;FEMININ;INDIVIDUEL;BAC PROFESSIONNEL;BAC PRO SERV;BAC PRO 30001 GESTION-ADMINISTRATION;45;30;13;10;7;3;4;16;0;0;1;0;15;14
8129.0;2021;25;VERSAILLES;FEMININ;INDIVIDUEL;BAC PROFESSIONNEL;BAC PRO SERV;BAC PRO 31210 ACCUEIL -RELATION CLIENTS USAGERS;16;11;6;2;3;3;0;9;0;0;0;1;8;2
8140.0;2021;25;VERSAILLES;FEMININ;INDIVIDUEL;BAC TECHNOLOGIQUE;BAC STL;BAC STL SCIENCES PHYSIQUES CHIMIQUES  EN LABORAT.;1;0;0;0;0;0;0;0;0;0;0;0;0;0
8144.0;2021;25;VERSAILLES;FEMININ;INDIVIDUEL;BAC TECHNOLOGIQUE;BAC STMG;BAC STMG SYSTEMES D'INFORMATION DE GESTION;6;3;0;2;1;0;1;0;0;0;0;0;0;3
8146.0;2021;25;VERSAILLES;FEMININ;SCOLAIRE;BAC PROFESSIONNEL;BAC PRO PROD;BACPRO 20002 ETUD.DEFINITION PRDTS INDUSTRIEL;2;2;1;1;0;0;0;1;0;0;0;0;1;1
8157.0;2021;25;VERSAILLES;FEMININ;SCOLAIRE;BAC PROFESSIONNEL;BAC PRO PROD;BAC PRO 23405 TECHNICIEN MENUISIER AGENCEUR;2;2;2;0;0;0;0;2;0;0;0;0;2;0
8162.0;2021;25;VERSAILLES;FEMININ;SCOLAIRE;BAC PROFESSIONNEL;BAC PRO PROD;BAC PRO 25006 MICROTECHNIQUES;5;5;5;0;0;0;0;5;0;0;0;4;1;0
8175.0;2021;25;VERSAILLES;FEMININ;SCOLAIRE;BAC PROFESSIONNEL;BAC PRO PROD;BAC PRO AG 21114 CONDUITE PRODUCTIONS HORTICOLES;4;4;3;1;0;0;0;3;0;0;0;2;1;1
8178.0;2021;25;VERSAILLES;FEMININ;SCOLAIRE;BAC PROFESSIONNEL;BAC PRO PROD;BAC PRO AG 21405 AMENAGEMENTS PAYSAGERS;6;6;6;0;0;0;0;6;0;0;0;4;2;0
8179.0;2021;25;VERSAILLES;FEMININ;SCOLAIRE;BAC PROFESSIONNEL;BAC PRO SERV;BAC PRO 30001 GESTION-ADMINISTRATION;1490;1486;1163;224;99;63;36;1226;0;43;210;447;526;260
8182.0;2021;25;VERSAILLES;FEMININ;SCOLAIRE;BAC PROFESSIONNEL;BAC PRO SERV;BAC PRO 31108 TRANSPORT;8;8;6;0;2;1;1;7;0;0;1;1;5;1
8201.0;2021;25;VERSAILLES;FEMININ;SCOLAIRE;BAC TECHNOLOGIQUE;BAC S2TMD;BAC S2TMD DANSE;5;5;5;0;0;0;0;5;0;0;3;2;0;0
8207.0;2021;25;VERSAILLES;FEMININ;SCOLAIRE;BAC TECHNOLOGIQUE;BAC STI2D;BAC STI2D ARCHITECTURE ET CONSTRUCTION;36;36;31;2;3;1;2;32;0;3;7;7;15;4
8213.0;2021;25;VERSAILLES;FEMININ;SCOLAIRE;BAC TECHNOLOGIQUE;BAC STMG;BAC STMG GESTION ET FINANCE;670;670;605;15;50;36;14;641;1;24;139;249;228;29
8218.0;2021;25;VERSAILLES;MASCULIN;APPRENTISSAGE;BAC PROFESSIONNEL;BAC PRO PROD;BAC PRO 22106 CUISINE;73;73;61;8;4;3;1;64;0;6;18;26;14;9
8219.0;2021;25;VERSAILLES;MASCULIN;APPRENTISSAGE;BAC PROFESSIONNEL;BAC PRO PROD;BAC PRO 22703 TECHN.INSTALL.SYST.ENERG.CLIMATI;37;33;20;5;8;3;5;23;0;3;3;10;7;10
8221.0;2021;25;VERSAILLES;MASCULIN;APPRENTISSAGE;BAC PROFESSIONNEL;BAC PRO PROD;BAC PRO 23102 TRAVAUX PUBLICS;30;29;24;1;4;2;2;26;0;1;5;9;11;3
8223.0;2021;25;VERSAILLES;MASCULIN;APPRENTISSAGE;BAC PROFESSIONNEL;BAC PRO PROD;BAC PRO 25007 MAINTENANCE EQUIPEMENTS INDUST.;21;21;16;3;2;2;0;18;0;1;1;4;12;3
8230.0;2021;25;VERSAILLES;MASCULIN;APPRENTISSAGE;BAC PROFESSIONNEL;BAC PRO PROD;BAC PRO 25302 AERONAUTIQUE OPTION AVIONIQUE;16;16;15;0;1;0;1;15;0;4;8;2;1;1
8233.0;2021;25;VERSAILLES;MASCULIN;APPRENTISSAGE;BAC PROFESSIONNEL;BAC PRO PROD;BAC PRO 25408 REPARATION DES CARROSSERIES;84;83;61;18;4;2;2;63;0;4;2;29;28;20
8247.0;2021;25;VERSAILLES;MASCULIN;APPRENTISSAGE;BAC PROFESSIONNEL;BAC PRO SERV;BAC PRO 31206 VENTE (PROSPECT.NEGO.SUIV.CLIENT;2;2;2;0;0;0;0;2;0;0;0;1;1;0
8254.0;2021;25;VERSAILLES;MASCULIN;ENSEIGNEMENT A DISTANCE;BAC PROFESSIONNEL;BAC PRO SERV;BAC PRO 31202 COMMERCE;5;4;1;3;0;0;0;1;0;0;0;1;0;3
8257.0;2021;25;VERSAILLES;MASCULIN;ENSEIGNEMENT A DISTANCE;BAC TECHNOLOGIQUE;BAC ST2S;BAC ST2S SCIENCES & TECHNO. SANTE & SOCIAL;2;2;2;0;0;0;0;2;0;0;1;1;0;0
8262.0;2021;25;VERSAILLES;MASCULIN;FORMATION CONTINUE;BAC PROFESSIONNEL;BAC PRO PROD;BAC PRO 20102 PILOTE DE LIGNE DE PRODUCTION;8;8;8;0;0;0;0;8;0;0;6;2;0;0
8264.0;2021;25;VERSAILLES;MASCULIN;FORMATION CONTINUE;BAC PROFESSIONNEL;BAC PRO PROD;BAC PRO 22703 TECHN.INSTALL.SYST.ENERG.CLIMATI;12;12;10;1;1;1;0;11;0;0;6;3;2;1
8266.0;2021;25;VERSAILLES;MASCULIN;FORMATION CONTINUE;BAC PROFESSIONNEL;BAC PRO PROD;BAC PRO 23005 TECHN. ETUDES BAT B ASSIST.ARCHI.;5;5;5;0;0;0;0;5;0;1;2;1;1;0
8268.0;2021;25;VERSAILLES;MASCULIN;FORMATION CONTINUE;BAC PROFESSIONNEL;BAC PRO PROD;BAC PRO 25510 METIERS ELECT. ENVIRON. CONNECTES;1;0;0;0;0;0;0;0;0;0;0;0;0;0
8277.0;2021;25;VERSAILLES;MASCULIN;INDIVIDUEL;BAC PROFESSIONNEL;BAC PRO PROD;BAC PRO 22105 BOULANGER-PÂTISSIER;1;1;0;1;0;0;0;0;0;0;0;0;0;1
8289.0;2021;25;VERSAILLES;MASCULIN;INDIVIDUEL;BAC PROFESSIONNEL;BAC PRO PROD;BAC PRO 25514 SYST.NUM.OPT.B AUD.RES.EQUIP.DOM.;4;3;3;0;0;0;0;3;0;0;0;2;1;0
8295.0;2021;25;VERSAILLES;MASCULIN;INDIVIDUEL;BAC PROFESSIONNEL;BAC PRO PROD;BAC PRO AG 21302 GEST MILIEUX NATURELS FAUNE;1;1;1;0;0;0;0;1;0;0;0;0;1;0
8300.0;2021;25;VERSAILLES;MASCULIN;INDIVIDUEL;BAC PROFESSIONNEL;BAC PRO SERV;BAC PRO 31202 COMMERCE;16;7;2;2;3;1;2;3;0;0;0;0;3;4
8302.0;2021;25;VERSAILLES;MASCULIN;INDIVIDUEL;BAC PROFESSIONNEL;BAC PRO SERV;BAC PRO 31210 ACCUEIL -RELATION CLIENTS USAGERS;3;3;0;2;1;1;0;1;0;0;0;0;1;2
8303.0;2021;25;VERSAILLES;MASCULIN;INDIVIDUEL;BAC PROFESSIONNEL;BAC PRO SERV;BAC PRO 32208 REAL.PR.IMPR.PLURI.OPTB.PR.IMPR.;1;0;0;0;0;0;0;0;0;0;0;0;0;0
8312.0;2021;25;VERSAILLES;MASCULIN;INDIVIDUEL;BAC TECHNOLOGIQUE;BAC STHR;BAC STHR SC.&TEC. HOTELLERIE-RESTAURATION;1;0;0;0;0;0;0;0;0;0;0;0;0;0
8315.0;2021;25;VERSAILLES;MASCULIN;INDIVIDUEL;BAC TECHNOLOGIQUE;BAC STI2D;BAC STI2D INNOVATION TECHNO.  ET ECO CONCEPTION;5;3;0;3;0;0;0;0;0;0;0;0;0;3
8321.0;2021;25;VERSAILLES;MASCULIN;SCOLAIRE;BAC GENERAL;BAC GENERAL;BAC GENE 10019 BAC GENERAL;17495;17488;16316;249;923;600;323;16916;213;1683;3989;5988;5043;572
8324.0;2021;25;VERSAILLES;MASCULIN;SCOLAIRE;BAC PROFESSIONNEL;BAC PRO PROD;BAC PRO 22004 PROC. CHIMIE EAU PAPIERS-CARTONS;6;6;6;0;0;0;0;6;0;0;1;3;2;0
8325.0;2021;25;VERSAILLES;MASCULIN;SCOLAIRE;BAC PROFESSIONNEL;BAC PRO PROD;BAC PRO 22105 BOULANGER-PÂTISSIER;60;59;49;9;1;0;1;49;0;4;18;16;11;10
8342.0;2021;25;VERSAILLES;MASCULIN;SCOLAIRE;BAC PROFESSIONNEL;BAC PRO PROD;BAC PRO 24302 METIERS DU CUIR : MAROQUINERIE;1;1;1;0;0;0;0;1;0;0;1;0;0;0
8345.0;2021;25;VERSAILLES;MASCULIN;SCOLAIRE;BAC PROFESSIONNEL;BAC PRO PROD;BAC PRO 25009 MAINTENANCE NAUTIQUE;19;19;11;4;4;3;1;14;0;0;2;5;7;5
8349.0;2021;25;VERSAILLES;MASCULIN;SCOLAIRE;BAC PROFESSIONNEL;BAC PRO PROD;BAC PRO 25215 MAINT.VEHIC.OPTB VEHIC.TRANS.ROUT;10;10;3;7;0;0;0;3;0;0;0;1;2;7
8354.0;2021;25;VERSAILLES;MASCULIN;SCOLAIRE;BAC PROFESSIONNEL;BAC PRO PROD;BAC PRO 25302 AERONAUTIQUE OPTION AVIONIQUE;20;20;18;1;1;0;1;18;0;1;4;7;6;2
8374.0;2021;25;VERSAILLES;MASCULIN;SCOLAIRE;BAC PROFESSIONNEL;BAC PRO SERV;BAC PRO 31107 CONDUCT. TRANSP.ROUT.MARCHANDISES;43;43;32;11;0;0;0;32;0;1;10;13;8;11
8375.0;2021;25;VERSAILLES;MASCULIN;SCOLAIRE;BAC PROFESSIONNEL;BAC PRO SERV;BAC PRO 31108 TRANSPORT;40;40;31;4;5;5;0;36;0;1;3;9;23;4
8386.0;2021;25;VERSAILLES;MASCULIN;SCOLAIRE;BAC PROFESSIONNEL;BAC PRO SERV;BAC PRO 33004 ACC.SOINS-S.PERS. OPT.EN STRUCTUR;64;64;51;7;6;3;3;54;0;2;13;21;18;10
8389.0;2021;25;VERSAILLES;MASCULIN;SCOLAIRE;BAC PROFESSIONNEL;BAC PRO SERV;BAC PRO 33403 COMMERC. SERVICES EN RESTAURATION;104;103;76;23;4;3;1;79;0;3;7;35;34;24
8390.0;2021;25;VERSAILLES;MASCULIN;SCOLAIRE;BAC PROFESSIONNEL;BAC PRO SERV;BAC PRO 34304 HYGIENE PROPRETE STERILISATION;6;6;5;0;1;0;1;5;0;0;1;2;2;1
8394.0;2021;25;VERSAILLES;MASCULIN;SCOLAIRE;BAC TECHNOLOGIQUE;BAC ST2S;BAC ST2S SCIENCES & TECHNO. SANTE & SOCIAL;218;218;179;11;28;18;10;197;0;2;20;75;100;21
8402.0;2021;25;VERSAILLES;MASCULIN;SCOLAIRE;BAC TECHNOLOGIQUE;BAC STL;BAC STL BIOCHIM.-BIOLOGIE-BIOTECHNOL.;201;201;166;5;30;12;18;178;0;2;31;63;82;23
8409.0;2022;02;AIX-MARSEILLE;FEMININ;APPRENTISSAGE;BAC PROFESSIONNEL;BAC PRO PROD;BAC PRO 23102 TRAVAUX PUBLICS;1;1;1;0;0;0;0;1;0;1;0;0;0;0
8414.0;2022;02;AIX-MARSEILLE;FEMININ;APPRENTISSAGE;BAC PROFESSIONNEL;BAC PRO PROD;BAC PRO 25406 OUVRAGES DU BATIMENT METALLERIE;1;1;1;0;0;0;0;1;0;0;0;0;1;0
8415.0;2022;02;AIX-MARSEILLE;FEMININ;APPRENTISSAGE;BAC PROFESSIONNEL;BAC PRO PROD;BAC PRO 25408 REPARATION DES CARROSSERIES;1;1;0;1;0;0;0;0;0;0;0;0;0;1
8416.0;2022;02;AIX-MARSEILLE;FEMININ;APPRENTISSAGE;BAC PROFESSIONNEL;BAC PRO PROD;BAC PRO 25510 METIERS ELECT. ENVIRON. CONNECTES;1;1;1;0;0;0;0;1;0;0;0;1;0;0
8421.0;2022;02;AIX-MARSEILLE;FEMININ;APPRENTISSAGE;BAC PROFESSIONNEL;BAC PRO PROD;BAC PRO AG 21210 COND GEST ENTR CANIN ET FELIN;4;3;3;0;0;0;0;3;0;0;0;0;3;0
8427.0;2022;02;AIX-MARSEILLE;FEMININ;APPRENTISSAGE;BAC PROFESSIONNEL;BAC PRO SERV;BAC PRO 30001 GESTION-ADMINISTRATION;20;19;15;4;0;0;0;15;0;1;7;4;3;4
8432.0;2022;02;AIX-MARSEILLE;FEMININ;APPRENTISSAGE;BAC PROFESSIONNEL;BAC PRO SERV;BAC PRO 33004 ACC.SOINS-S.PERS. OPT.EN STRUCTUR;2;2;2;0;0;0;0;2;0;1;1;0;0;0
8433.0;2022;02;AIX-MARSEILLE;FEMININ;APPRENTISSAGE;BAC PROFESSIONNEL;BAC PRO SERV;BAC PRO 33101 OPTIQUE LUNETTERIE;3;2;2;0;0;0;0;2;0;0;0;1;1;0
8449.0;2022;02;AIX-MARSEILLE;FEMININ;FORMATION CONTINUE;BAC PROFESSIONNEL;BAC PRO PROD;BAC PRO 22106 CUISINE;1;0;0;0;0;0;0;0;0;0;0;0;0;0
8450.0;2022;02;AIX-MARSEILLE;FEMININ;FORMATION CONTINUE;BAC PROFESSIONNEL;BAC PRO PROD;BAC PRO 22704 TECHN. MAINT. SYST.ENERG.CLIMATI;1;1;1;0;0;0;0;1;0;0;0;1;0;0
8462.0;2022;02;AIX-MARSEILLE;FEMININ;INDIVIDUEL;BAC PROFESSIONNEL;BAC PRO PROD;BAC PRO 25302 AERONAUTIQUE OPTION AVIONIQUE;1;1;1;0;0;0;0;1;0;1;0;0;0;0
8479.0;2022;02;AIX-MARSEILLE;FEMININ;INDIVIDUEL;BAC TECHNOLOGIQUE;BAC STMG;BAC STMG RESSOURCES HUMAINES ET COMMUNICATION;10;6;4;2;0;0;0;4;0;0;0;3;1;2
8488.0;2022;02;AIX-MARSEILLE;FEMININ;SCOLAIRE;BAC PROFESSIONNEL;BAC PRO PROD;BAC PRO 22403 ARTS.& MET.ART:MET.ENSEIGN SIGNA;1;1;0;1;0;0;0;0;0;0;0;0;0;1
8492.0;2022;02;AIX-MARSEILLE;FEMININ;SCOLAIRE;BAC PROFESSIONNEL;BAC PRO PROD;BAC PRO 23102 TRAVAUX PUBLICS;1;1;0;1;0;0;0;0;0;0;0;0;0;1
8497.0;2022;02;AIX-MARSEILLE;FEMININ;SCOLAIRE;BAC PROFESSIONNEL;BAC PRO PROD;BAC PRO 23408 Etude et réalisation d'agencement;8;8;6;2;0;0;0;6;0;1;2;2;1;2
8502.0;2022;02;AIX-MARSEILLE;FEMININ;SCOLAIRE;BAC PROFESSIONNEL;BAC PRO PROD;BAC PRO 25214 MAINT.VEHIC.OPTA VOIT.PARTICUL.;6;6;6;0;0;0;0;6;0;1;2;1;2;0
8504.0;2022;02;AIX-MARSEILLE;FEMININ;SCOLAIRE;BAC PROFESSIONNEL;BAC PRO PROD;BAC PRO 25219 MAINT.MATERIELS OPT.A AGRICOLES;1;1;1;0;0;0;0;1;0;0;1;0;0;0
8505.0;2022;02;AIX-MARSEILLE;FEMININ;SCOLAIRE;BAC PROFESSIONNEL;BAC PRO PROD;BAC PRO 25304 AERONAUTIQUE OPTION STRUCTURE;1;1;1;0;0;0;0;1;0;0;0;0;1;0
8508.0;2022;02;AIX-MARSEILLE;FEMININ;SCOLAIRE;BAC PROFESSIONNEL;BAC PRO PROD;BAC PRO 25510 METIERS ELECT. ENVIRON. CONNECTES;3;3;3;0;0;0;0;3;0;0;0;3;0;0
8512.0;2022;02;AIX-MARSEILLE;FEMININ;SCOLAIRE;BAC PROFESSIONNEL;BAC PRO PROD;BAC PRO AG 21001 AGRO-EQUIPEMENT;1;1;1;0;0;0;0;1;0;0;0;1;0;0
8515.0;2022;02;AIX-MARSEILLE;FEMININ;SCOLAIRE;BAC PROFESSIONNEL;BAC PRO PROD;BAC PRO AG 21114 CONDUITE PRODUCTIONS HORTICOLES;4;3;2;1;0;0;0;2;0;0;0;0;2;1
8517.0;2022;02;AIX-MARSEILLE;FEMININ;SCOLAIRE;BAC PROFESSIONNEL;BAC PRO PROD;BAC PRO AG 21210 COND GEST ENTR CANIN ET FELIN;18;17;12;5;0;0;0;12;0;0;0;1;11;5
8518.0;2022;02;AIX-MARSEILLE;FEMININ;SCOLAIRE;BAC PROFESSIONNEL;BAC PRO PROD;BAC PRO AG 21211 COND GEST ENTR HIPPIQUE;6;6;6;0;0;0;0;6;0;0;0;2;4;0
8523.0;2022;02;AIX-MARSEILLE;FEMININ;SCOLAIRE;BAC PROFESSIONNEL;BAC PRO PROD;BAC PRO AG 22106 TEC CONS VTE ALIMENTATION VINS SP;7;7;5;2;0;0;0;5;0;0;0;1;4;2
8526.0;2022;02;AIX-MARSEILLE;FEMININ;SCOLAIRE;BAC PROFESSIONNEL;BAC PRO SERV;BAC PRO 31106 LOGISTIQUE;7;6;6;0;0;0;0;6;0;0;2;1;3;0
8532.0;2022;02;AIX-MARSEILLE;FEMININ;SCOLAIRE;BAC PROFESSIONNEL;BAC PRO SERV;BAC PRO 32207 REAL.PR.IMPR.PLURI.OPTA.PR.GRAPH.;11;11;11;0;0;0;0;11;0;0;5;5;1;0
8538.0;2022;02;AIX-MARSEILLE;FEMININ;SCOLAIRE;BAC PROFESSIONNEL;BAC PRO SERV;BAC PRO 33004 ACC.SOINS-S.PERS. OPT.EN STRUCTUR;589;587;498;74;15;11;4;509;0;23;107;221;158;78
8540.0;2022;02;AIX-MARSEILLE;FEMININ;SCOLAIRE;BAC PROFESSIONNEL;BAC PRO SERV;BAC PRO 33102 PROTHESE DENTAIRE;3;3;3;0;0;0;0;3;0;0;0;0;3;0
8550.0;2022;02;AIX-MARSEILLE;FEMININ;SCOLAIRE;BAC TECHNOLOGIQUE;BAC STD2A;BAC STD2A SCIENCES & TECHNO. DESIGN-ARTS APPLIQUES;125;125;119;0;6;5;1;124;0;10;31;42;41;1
8557.0;2022;02;AIX-MARSEILLE;FEMININ;SCOLAIRE;BAC TECHNOLOGIQUE;BAC STL;BAC STL SCIENCES PHYSIQUES CHIMIQUES  EN LABORAT.;109;109;88;3;18;10;8;98;1;5;21;34;37;11
8566.0;2022;02;AIX-MARSEILLE;MASCULIN;APPRENTISSAGE;BAC PROFESSIONNEL;BAC PRO PROD;BAC PRO 22703 TECHN.INSTALL.SYST.ENERG.CLIMATI;30;25;18;7;0;0;0;18;0;0;3;6;9;7
8568.0;2022;02;AIX-MARSEILLE;MASCULIN;APPRENTISSAGE;BAC PROFESSIONNEL;BAC PRO PROD;BAC PRO 22705 TECHNICIEN GAZ;6;6;6;0;0;0;0;6;0;2;3;1;0;0
8575.0;2022;02;AIX-MARSEILLE;MASCULIN;APPRENTISSAGE;BAC PROFESSIONNEL;BAC PRO PROD;BAC PRO 25007 MAINTENANCE EQUIPEMENTS INDUST.;17;17;16;1;0;0;0;16;0;1;3;9;3;1
8577.0;2022;02;AIX-MARSEILLE;MASCULIN;APPRENTISSAGE;BAC PROFESSIONNEL;BAC PRO PROD;BAC PRO 25106 TECHNICIEN D'USINAGE;9;9;8;0;1;1;0;9;0;1;2;4;2;0
8579.0;2022;02;AIX-MARSEILLE;MASCULIN;APPRENTISSAGE;BAC PROFESSIONNEL;BAC PRO PROD;BAC PRO 25215 MAINT.VEHIC.OPTB VEHIC.TRANS.ROUT;29;28;21;1;6;5;1;26;0;0;4;7;15;2
8583.0;2022;02;AIX-MARSEILLE;MASCULIN;APPRENTISSAGE;BAC PROFESSIONNEL;BAC PRO PROD;BAC PRO 25303 AERONAUTIQUE OPTION SYSTEMES;18;18;15;3;0;0;0;15;0;1;4;5;5;3
8591.0;2022;02;AIX-MARSEILLE;MASCULIN;APPRENTISSAGE;BAC PROFESSIONNEL;BAC PRO PROD;BAC PRO AG 21113 CGEVV;14;14;12;2;0;0;0;12;0;0;0;3;9;2
8598.0;2022;02;AIX-MARSEILLE;MASCULIN;APPRENTISSAGE;BAC PROFESSIONNEL;BAC PRO PROD;BAC PRO AG 22107 TEC CONS VTE ALIMENTATION P.ALIM;1;1;1;0;0;0;0;1;0;0;0;0;1;0
8600.0;2022;02;AIX-MARSEILLE;MASCULIN;APPRENTISSAGE;BAC PROFESSIONNEL;BAC PRO SERV;BAC PRO 31106 LOGISTIQUE;20;20;14;3;3;2;1;16;0;2;2;5;7;4
8603.0;2022;02;AIX-MARSEILLE;MASCULIN;APPRENTISSAGE;BAC PROFESSIONNEL;BAC PRO SERV;BAC PRO 31214 MET.COM.VEN.OP.B PR.CL.VA.OF.COM.;8;7;5;2;0;0;0;5;0;1;1;1;2;2
8608.0;2022;02;AIX-MARSEILLE;MASCULIN;APPRENTISSAGE;BAC PROFESSIONNEL;BAC PRO SERV;BAC PRO 33102 PROTHESE DENTAIRE;15;13;7;6;0;0;0;7;0;0;1;5;1;6
8610.0;2022;02;AIX-MARSEILLE;MASCULIN;APPRENTISSAGE;BAC PROFESSIONNEL;BAC PRO SERV;BAC PRO 34304 HYGIENE PROPRETE STERILISATION;9;9;7;2;0;0;0;7;0;0;1;4;2;2
8615.0;2022;02;AIX-MARSEILLE;MASCULIN;ENSEIGNEMENT A DISTANCE;BAC TECHNOLOGIQUE;BAC ST2S;BAC ST2S SCIENCES & TECHNO. SANTE & SOCIAL;1;1;1;0;0;0;0;1;0;0;0;0;1;0
8625.0;2022;02;AIX-MARSEILLE;MASCULIN;FORMATION CONTINUE;BAC PROFESSIONNEL;BAC PRO PROD;BAC PRO 25510 METIERS ELECT. ENVIRON. CONNECTES;8;8;4;2;2;1;1;5;0;1;0;2;2;3
8636.0;2022;02;AIX-MARSEILLE;MASCULIN;INDIVIDUEL;BAC PROFESSIONNEL;BAC PRO PROD;BAC PRO 25510 METIERS ELECT. ENVIRON. CONNECTES;1;0;0;0;0;0;0;0;0;0;0;0;0;0
8644.0;2022;02;AIX-MARSEILLE;MASCULIN;INDIVIDUEL;BAC PROFESSIONNEL;BAC PRO PROD;BAC PRO AG 21302 GEST MILIEUX NATURELS FAUNE;1;1;1;0;0;0;0;1;0;0;0;0;1;0
8647.0;2022;02;AIX-MARSEILLE;MASCULIN;INDIVIDUEL;BAC PROFESSIONNEL;BAC PRO SERV;BAC PRO 31213 MET.COM.VEN.OP.A ANI.GES.ESP.COM.;2;1;1;0;0;0;0;1;0;0;0;0;1;0
8650.0;2022;02;AIX-MARSEILLE;MASCULIN;INDIVIDUEL;BAC PROFESSIONNEL;BAC PRO SERV;BAC PRO 33002 SERVICES DE PROXIMITE  VIE LOCAL;1;1;0;1;0;0;0;0;0;0;0;0;0;1
8653.0;2022;02;AIX-MARSEILLE;MASCULIN;INDIVIDUEL;BAC TECHNOLOGIQUE;BAC S2TMD;BAC S2TMD MUSIQUE;1;1;1;0;0;0;0;1;0;0;1;0;0;0
8661.0;2022;02;AIX-MARSEILLE;MASCULIN;INDIVIDUEL;BAC TECHNOLOGIQUE;BAC STMG;BAC STMG GESTION ET FINANCE;8;3;1;0;2;0;2;1;0;0;0;0;1;2
8676.0;2022;02;AIX-MARSEILLE;MASCULIN;SCOLAIRE;BAC PROFESSIONNEL;BAC PRO PROD;BAC PRO 23004 TECHN. ETUDES BAT.A ETUDES & ECO.;39;39;33;6;0;0;0;33;0;1;3;12;17;6
8683.0;2022;02;AIX-MARSEILLE;MASCULIN;SCOLAIRE;BAC PROFESSIONNEL;BAC PRO PROD;BAC PRO 23304 AMENAGEMENT FINITION BATIMENT;11;11;7;4;0;0;0;7;0;0;2;3;2;4
8686.0;2022;02;AIX-MARSEILLE;MASCULIN;SCOLAIRE;BAC PROFESSIONNEL;BAC PRO PROD;BAC PRO 23408 Etude et réalisation d'agencement;4;4;2;2;0;0;0;2;0;0;0;2;0;2
8700.0;2022;02;AIX-MARSEILLE;MASCULIN;SCOLAIRE;BAC PROFESSIONNEL;BAC PRO PROD;BAC PRO 25303 AERONAUTIQUE OPTION SYSTEMES;21;21;21;0;0;0;0;21;0;2;6;8;5;0
8704.0;2022;02;AIX-MARSEILLE;MASCULIN;SCOLAIRE;BAC PROFESSIONNEL;BAC PRO PROD;BAC PRO 25411 TECH.CHAUDRONNERIE INDUSTRIELLE;67;67;57;5;5;3;2;60;0;2;14;23;21;7
8706.0;2022;02;AIX-MARSEILLE;MASCULIN;SCOLAIRE;BAC PROFESSIONNEL;BAC PRO PROD;BAC PRO 25510 METIERS ELECT. ENVIRON. CONNECTES;506;503;393;68;42;28;14;421;0;22;73;152;174;82
8711.0;2022;02;AIX-MARSEILLE;MASCULIN;SCOLAIRE;BAC PROFESSIONNEL;BAC PRO PROD;BAC PRO AG 21004 CGEA;22;20;16;4;0;0;0;16;0;0;2;4;10;4
8715.0;2022;02;AIX-MARSEILLE;MASCULIN;SCOLAIRE;BAC PROFESSIONNEL;BAC PRO PROD;BAC PRO AG 21210 COND GEST ENTR CANIN ET FELIN;14;12;9;3;0;0;0;9;0;0;0;3;6;3
8716.0;2022;02;AIX-MARSEILLE;MASCULIN;SCOLAIRE;BAC PROFESSIONNEL;BAC PRO PROD;BAC PRO AG 21302 GEST MILIEUX NATURELS FAUNE;62;61;57;4;0;0;0;57;0;0;7;16;34;4
8720.0;2022;02;AIX-MARSEILLE;MASCULIN;SCOLAIRE;BAC PROFESSIONNEL;BAC PRO PROD;BAC PRO AG 22106 TEC CONS VTE ALIMENTATION VINS SP;9;9;5;4;0;0;0;5;0;0;0;1;4;4
8721.0;2022;02;AIX-MARSEILLE;MASCULIN;SCOLAIRE;BAC PROFESSIONNEL;BAC PRO PROD;BAC PRO AG 22107 TEC CONS VTE ALIMENTATION P.ALIM;22;21;18;3;0;0;0;18;0;1;1;5;11;3
8731.0;2022;02;AIX-MARSEILLE;MASCULIN;SCOLAIRE;BAC PROFESSIONNEL;BAC PRO SERV;BAC PRO 32303 ART.& MET.ART:COM.VIS.VIS.PLURI-M;29;29;22;7;0;0;0;22;0;0;4;9;9;7
8735.0;2022;02;AIX-MARSEILLE;MASCULIN;SCOLAIRE;BAC PROFESSIONNEL;BAC PRO SERV;BAC PRO 33004 ACC.SOINS-S.PERS. OPT.EN STRUCTUR;56;56;42;11;3;1;2;43;0;1;10;18;14;13
8736.0;2022;02;AIX-MARSEILLE;MASCULIN;SCOLAIRE;BAC PROFESSIONNEL;BAC PRO SERV;BAC PRO 33101 OPTIQUE LUNETTERIE;9;9;6;3;0;0;0;6;0;0;0;3;3;3
8740.0;2022;02;AIX-MARSEILLE;MASCULIN;SCOLAIRE;BAC PROFESSIONNEL;BAC PRO SERV;BAC PRO 34304 HYGIENE PROPRETE STERILISATION;4;4;4;0;0;0;0;4;0;1;3;0;0;0
8742.0;2022;02;AIX-MARSEILLE;MASCULIN;SCOLAIRE;BAC PROFESSIONNEL;BAC PRO SERV;BAC PRO AG 33002 SERV PERS TERRIT;27;21;18;3;0;0;0;18;0;0;3;8;7;3
8746.0;2022;02;AIX-MARSEILLE;MASCULIN;SCOLAIRE;BAC TECHNOLOGIQUE;BAC STD2A;BAC STD2A SCIENCES & TECHNO. DESIGN-ARTS APPLIQUES;41;41;37;0;4;4;0;41;0;3;4;15;19;0
8747.0;2022;02;AIX-MARSEILLE;MASCULIN;SCOLAIRE;BAC TECHNOLOGIQUE;BAC STHR;BAC STHR SC.&TEC. HOTELLERIE-RESTAURATION;41;41;35;0;6;5;1;40;0;1;7;12;20;1
8758.0;2022;20;AMIENS;FEMININ;APPRENTISSAGE;BAC PROFESSIONNEL;BAC PRO PROD;BAC PRO 22105 BOULANGER-PÂTISSIER;1;1;1;0;0;0;0;1;0;0;0;1;0;0
8780.0;2022;20;AMIENS;FEMININ;ENSEIGNEMENT A DISTANCE;BAC TECHNOLOGIQUE;BAC ST2S;BAC ST2S SCIENCES & TECHNO. SANTE & SOCIAL;6;6;3;2;1;1;0;4;0;0;0;1;3;2
8783.0;2022;20;AMIENS;FEMININ;FORMATION CONTINUE;BAC PROFESSIONNEL;BAC PRO PROD;BAC PRO 20102 PILOTE DE LIGNE DE PRODUCTION;3;2;2;0;0;0;0;2;0;0;2;0;0;0
8791.0;2022;20;AMIENS;FEMININ;INDIVIDUEL;BAC PROFESSIONNEL;BAC PRO SERV;BAC PRO 30001 GESTION-ADMINISTRATION;5;4;2;2;0;0;0;2;0;0;0;0;2;2
8802.0;2022;20;AMIENS;FEMININ;INDIVIDUEL;BAC TECHNOLOGIQUE;BAC STMG;BAC STMG MERCATIQUE (MARKETING);5;3;2;1;0;0;0;2;0;0;0;0;2;1
8804.0;2022;20;AMIENS;FEMININ;SCOLAIRE;BAC GENERAL;BAC GENERAL;BAC GENE 10019 BAC GENERAL;5670;5670;5193;101;376;243;133;5436;154;728;1432;1647;1475;234
8808.0;2022;20;AMIENS;FEMININ;SCOLAIRE;BAC PROFESSIONNEL;BAC PRO PROD;BAC PRO 22104 BOUCHER CHARCUTIER TRAITEUR;1;1;1;0;0;0;0;1;0;0;0;1;0;0
8810.0;2022;20;AMIENS;FEMININ;SCOLAIRE;BAC PROFESSIONNEL;BAC PRO PROD;BAC PRO 22106 CUISINE;52;52;50;1;1;0;1;50;0;6;15;17;12;2
8819.0;2022;20;AMIENS;FEMININ;SCOLAIRE;BAC PROFESSIONNEL;BAC PRO PROD;BAC PRO 24202 ARTIS.& MET.ART : TAPIS.D'AMEUBL;4;4;4;0;0;0;0;4;0;2;1;1;0;0
8833.0;2022;20;AMIENS;FEMININ;SCOLAIRE;BAC PROFESSIONNEL;BAC PRO PROD;BAC PRO AG 21004 CGEA;55;54;38;16;0;0;0;38;0;0;3;11;24;16
8837.0;2022;20;AMIENS;FEMININ;SCOLAIRE;BAC PROFESSIONNEL;BAC PRO PROD;BAC PRO AG 21211 COND GEST ENTR HIPPIQUE;40;39;30;9;0;0;0;30;0;0;6;8;16;9
8841.0;2022;20;AMIENS;FEMININ;SCOLAIRE;BAC PROFESSIONNEL;BAC PRO PROD;BAC PRO AG 22107 TEC CONS VTE ALIMENTATION P.ALIM;15;15;13;2;0;0;0;13;0;0;0;6;7;2
8851.0;2022;20;AMIENS;FEMININ;SCOLAIRE;BAC PROFESSIONNEL;BAC PRO SERV;BAC PRO 33002 SERVICES DE PROXIMITE  VIE LOCAL;48;48;36;10;2;1;1;37;0;2;6;22;7;11
8873.0;2022;20;AMIENS;FEMININ;SCOLAIRE;BAC TECHNOLOGIQUE;BAC STMG;BAC STMG SYSTEMES D'INFORMATION DE GESTION;14;14;11;0;3;3;0;14;0;0;3;5;6;0
8879.0;2022;20;AMIENS;MASCULIN;APPRENTISSAGE;BAC PROFESSIONNEL;BAC PRO PROD;BAC PRO 23004 TECHN. ETUDES BAT.A ETUDES & ECO.;1;1;0;0;1;1;0;1;0;0;0;0;1;0
8881.0;2022;20;AMIENS;MASCULIN;APPRENTISSAGE;BAC PROFESSIONNEL;BAC PRO PROD;BAC PRO 23203 TECHNICIEN BAT. : ORG.REAL.GROS O;5;5;2;3;0;0;0;2;0;0;1;0;1;3
8884.0;2022;20;AMIENS;MASCULIN;APPRENTISSAGE;BAC PROFESSIONNEL;BAC PRO PROD;BAC PRO 23304 AMENAGEMENT FINITION BATIMENT;3;3;2;1;0;0;0;2;0;1;0;0;1;1
8886.0;2022;20;AMIENS;MASCULIN;APPRENTISSAGE;BAC PROFESSIONNEL;BAC PRO PROD;BAC PRO 25007 MAINTENANCE EQUIPEMENTS INDUST.;29;29;25;4;0;0;0;25;0;2;9;4;10;4
8892.0;2022;20;AMIENS;MASCULIN;APPRENTISSAGE;BAC PROFESSIONNEL;BAC PRO PROD;BAC PRO 25220 MAINT.MATERIELS OPT.B TP MANUT.;1;1;1;0;0;0;0;1;0;0;0;1;0;0
8900.0;2022;20;AMIENS;MASCULIN;APPRENTISSAGE;BAC PROFESSIONNEL;BAC PRO PROD;BAC PRO AG 21001 AGRO-EQUIPEMENT;17;17;13;4;0;0;0;13;0;0;2;6;5;4
8909.0;2022;20;AMIENS;MASCULIN;APPRENTISSAGE;BAC PROFESSIONNEL;BAC PRO SERV;BAC PRO 33403 COMMERC. SERVICES EN RESTAURATION;5;5;3;2;0;0;0;3;0;0;1;1;1;2
8913.0;2022;20;AMIENS;MASCULIN;ENSEIGNEMENT A DISTANCE;BAC TECHNOLOGIQUE;BAC STMG;BAC STMG MERCATIQUE (MARKETING);1;1;0;0;1;0;1;0;0;0;0;0;0;1
8914.0;2022;20;AMIENS;MASCULIN;ENSEIGNEMENT A DISTANCE;BAC TECHNOLOGIQUE;BAC STMG;BAC STMG RESSOURCES HUMAINES ET COMMUNICATION;1;1;1;0;0;0;0;1;0;0;0;0;1;0
8915.0;2022;20;AMIENS;MASCULIN;FORMATION CONTINUE;BAC PROFESSIONNEL;BAC PRO PROD;BAC PRO 20102 PILOTE DE LIGNE DE PRODUCTION;2;2;1;1;0;0;0;1;0;0;0;0;1;1
8919.0;2022;20;AMIENS;MASCULIN;FORMATION CONTINUE;BAC PROFESSIONNEL;BAC PRO PROD;BAC PRO 23203 TECHNICIEN BAT. : ORG.REAL.GROS O;2;2;2;0;0;0;0;2;0;0;1;0;1;0
8920.0;2022;20;AMIENS;MASCULIN;FORMATION CONTINUE;BAC PROFESSIONNEL;BAC PRO PROD;BAC PRO 25411 TECH.CHAUDRONNERIE INDUSTRIELLE;1;1;1;0;0;0;0;1;0;1;0;0;0;0
8927.0;2022;20;AMIENS;MASCULIN;INDIVIDUEL;BAC PROFESSIONNEL;BAC PRO PROD;BAC PRO 25214 MAINT.VEHIC.OPTA VOIT.PARTICUL.;1;1;1;0;0;0;0;1;0;0;0;0;1;0
8930.0;2022;20;AMIENS;MASCULIN;INDIVIDUEL;BAC PROFESSIONNEL;BAC PRO PROD;BAC PRO 25510 METIERS ELECT. ENVIRON. CONNECTES;2;1;0;0;1;1;0;1;0;0;0;0;1;0
8934.0;2022;20;AMIENS;MASCULIN;INDIVIDUEL;BAC PROFESSIONNEL;BAC PRO SERV;BAC PRO 31212 METIERS DE L'ACCUEIL;1;1;1;0;0;0;0;1;0;0;0;0;1;0
8936.0;2022;20;AMIENS;MASCULIN;INDIVIDUEL;BAC PROFESSIONNEL;BAC PRO SERV;BAC PRO 32304 PHOTOGRAPHIE;1;1;0;1;0;0;0;0;0;0;0;0;0;1
8939.0;2022;20;AMIENS;MASCULIN;INDIVIDUEL;BAC TECHNOLOGIQUE;BAC STI2D;BAC STI2D INNOVATION TECHNO.  ET ECO CONCEPTION;1;1;1;0;0;0;0;1;0;0;0;0;1;0
8940.0;2022;20;AMIENS;MASCULIN;INDIVIDUEL;BAC TECHNOLOGIQUE;BAC STI2D;BAC STI2D SYSTÈME D'INFORMATION  ET NUMERIQUE;3;1;1;0;0;0;0;1;0;0;0;1;0;0
8950.0;2022;20;AMIENS;MASCULIN;SCOLAIRE;BAC PROFESSIONNEL;BAC PRO PROD;BAC PRO 22104 BOUCHER CHARCUTIER TRAITEUR;8;8;7;1;0;0;0;7;0;1;0;4;2;1
8952.0;2022;20;AMIENS;MASCULIN;SCOLAIRE;BAC PROFESSIONNEL;BAC PRO PROD;BAC PRO 22106 CUISINE;96;96;81;13;2;2;0;83;0;6;17;26;34;13
8954.0;2022;20;AMIENS;MASCULIN;SCOLAIRE;BAC PROFESSIONNEL;BAC PRO PROD;BAC PRO 22503 PLASTIQUES ET COMPOSITES;7;7;5;2;0;0;0;5;0;0;2;2;1;2
8959.0;2022;20;AMIENS;MASCULIN;SCOLAIRE;BAC PROFESSIONNEL;BAC PRO PROD;BAC PRO 23102 TRAVAUX PUBLICS;6;6;6;0;0;0;0;6;0;1;0;4;1;0
8963.0;2022;20;AMIENS;MASCULIN;SCOLAIRE;BAC PROFESSIONNEL;BAC PRO PROD;BAC PRO 23303 MENUISERIE ALUMINIUM-VERRE;2;2;0;1;1;1;0;1;0;0;0;0;1;1
8964.0;2022;20;AMIENS;MASCULIN;SCOLAIRE;BAC PROFESSIONNEL;BAC PRO PROD;BAC PRO 23304 AMENAGEMENT FINITION BATIMENT;22;22;14;7;1;1;0;15;0;1;2;5;7;7
8973.0;2022;20;AMIENS;MASCULIN;SCOLAIRE;BAC PROFESSIONNEL;BAC PRO PROD;BAC PRO 25009 MAINTENANCE NAUTIQUE;2;2;2;0;0;0;0;2;0;0;1;1;0;0
8974.0;2022;20;AMIENS;MASCULIN;SCOLAIRE;BAC PROFESSIONNEL;BAC PRO PROD;BAC PRO 25106 TECHNICIEN D'USINAGE;69;69;39;29;1;1;0;40;0;1;6;17;16;29
8977.0;2022;20;AMIENS;MASCULIN;SCOLAIRE;BAC PROFESSIONNEL;BAC PRO PROD;BAC PRO 25215 MAINT.VEHIC.OPTB VEHIC.TRANS.ROUT;22;22;16;5;1;1;0;17;0;2;1;10;4;5
8990.0;2022;20;AMIENS;MASCULIN;SCOLAIRE;BAC PROFESSIONNEL;BAC PRO PROD;BAC PRO 25515 SYST.NUM.OPT.C RES.INF.SYST.COMM.;80;80;69;11;0;0;0;69;0;9;20;27;13;11
9001.0;2022;20;AMIENS;MASCULIN;SCOLAIRE;BAC PROFESSIONNEL;BAC PRO PROD;BAC PRO AG 22107 TEC CONS VTE ALIMENTATION P.ALIM;5;5;4;1;0;0;0;4;0;0;0;1;3;1
9004.0;2022;20;AMIENS;MASCULIN;SCOLAIRE;BAC PROFESSIONNEL;BAC PRO SERV;BAC PRO 31107 CONDUCT. TRANSP.ROUT.MARCHANDISES;20;20;10;9;1;0;1;10;0;0;3;7;0;10
9008.0;2022;20;AMIENS;MASCULIN;SCOLAIRE;BAC PROFESSIONNEL;BAC PRO SERV;BAC PRO 31214 MET.COM.VEN.OP.B PR.CL.VA.OF.COM.;196;196;135;53;8;5;3;140;0;0;20;57;63;56
9012.0;2022;20;AMIENS;MASCULIN;SCOLAIRE;BAC PROFESSIONNEL;BAC PRO SERV;BAC PRO 33003 ACC.SOINS-S.PERS. OPT.A DOMICILE;13;13;11;2;0;0;0;11;0;1;2;4;4;2
9022.0;2022;20;AMIENS;MASCULIN;SCOLAIRE;BAC TECHNOLOGIQUE;BAC STD2A;BAC STD2A SCIENCES & TECHNO. DESIGN-ARTS APPLIQUES;26;26;25;0;1;1;0;26;1;2;7;8;8;0
9030.0;2022;20;AMIENS;MASCULIN;SCOLAIRE;BAC TECHNOLOGIQUE;BAC STMG;BAC STMG GESTION ET FINANCE;238;238;186;13;39;29;10;215;1;2;14;73;125;23
9035.0;2022;03;BESANCON;FEMININ;APPRENTISSAGE;BAC PROFESSIONNEL;BAC PRO PROD;BAC PRO 22004 PROC. CHIMIE EAU PAPIERS-CARTONS;1;1;1;0;0;0;0;1;0;0;0;1;0;0
9041.0;2022;03;BESANCON;FEMININ;APPRENTISSAGE;BAC PROFESSIONNEL;BAC PRO PROD;BAC PRO 23405 TECHNICIEN MENUISIER AGENCEUR;2;2;1;0;1;1;0;2;0;0;0;1;1;0
9044.0;2022;03;BESANCON;FEMININ;APPRENTISSAGE;BAC PROFESSIONNEL;BAC PRO PROD;BAC PRO 25106 TECHNICIEN D'USINAGE;2;2;2;0;0;0;0;2;0;0;0;1;1;0
9045.0;2022;03;BESANCON;FEMININ;APPRENTISSAGE;BAC PROFESSIONNEL;BAC PRO PROD;BAC PRO 25107 TECHNICIEN OUTILLEUR;2;2;2;0;0;0;0;2;0;0;1;0;1;0
9048.0;2022;03;BESANCON;FEMININ;APPRENTISSAGE;BAC PROFESSIONNEL;BAC PRO PROD;BAC PRO AG 21114 CONDUITE PRODUCTIONS HORTICOLES;3;3;3;0;0;0;0;3;0;1;0;1;1;0
9056.0;2022;03;BESANCON;FEMININ;APPRENTISSAGE;BAC PROFESSIONNEL;BAC PRO SERV;BAC PRO 31212 METIERS DE L'ACCUEIL;5;5;5;0;0;0;0;5;0;0;4;1;0;0
9067.0;2022;03;BESANCON;FEMININ;ENSEIGNEMENT A DISTANCE;BAC GENERAL;BAC GENERAL;BAC GENE 10019 BAC GENERAL;20;19;15;2;2;2;0;17;0;0;5;3;9;2
9069.0;2022;03;BESANCON;FEMININ;ENSEIGNEMENT A DISTANCE;BAC PROFESSIONNEL;BAC PRO SERV;BAC PRO 31213 MET.COM.VEN.OP.A ANI.GES.ESP.COM.;1;1;1;0;0;0;0;1;0;0;1;0;0;0
9079.0;2022;03;BESANCON;FEMININ;INDIVIDUEL;BAC PROFESSIONNEL;BAC PRO SERV;BAC PRO 33004 ACC.SOINS-S.PERS. OPT.EN STRUCTUR;2;1;1;0;0;0;0;1;0;0;0;0;1;0
9088.0;2022;03;BESANCON;FEMININ;SCOLAIRE;BAC PROFESSIONNEL;BAC PRO PROD;BAC PRO 23304 AMENAGEMENT FINITION BATIMENT;1;1;0;1;0;0;0;0;0;0;0;0;0;1
9093.0;2022;03;BESANCON;FEMININ;SCOLAIRE;BAC PROFESSIONNEL;BAC PRO PROD;BAC PRO 24302 METIERS DU CUIR : MAROQUINERIE;10;9;9;0;0;0;0;9;0;1;3;2;3;0
9096.0;2022;03;BESANCON;FEMININ;SCOLAIRE;BAC PROFESSIONNEL;BAC PRO PROD;BAC PRO 25106 TECHNICIEN D'USINAGE;4;4;3;1;0;0;0;3;0;1;0;1;1;1
9101.0;2022;03;BESANCON;FEMININ;SCOLAIRE;BAC PROFESSIONNEL;BAC PRO PROD;BAC PRO 25510 METIERS ELECT. ENVIRON. CONNECTES;6;6;5;1;0;0;0;5;0;1;1;2;1;1
9102.0;2022;03;BESANCON;FEMININ;SCOLAIRE;BAC PROFESSIONNEL;BAC PRO PROD;BAC PRO 25513 SYST.NUM.OPT.A SURETE SECURITE;2;2;2;0;0;0;0;2;0;0;0;0;2;0
9104.0;2022;03;BESANCON;FEMININ;SCOLAIRE;BAC PROFESSIONNEL;BAC PRO PROD;BAC PRO AG 21004 CGEA;20;20;16;4;0;0;0;16;0;0;1;7;8;4
9106.0;2022;03;BESANCON;FEMININ;SCOLAIRE;BAC PROFESSIONNEL;BAC PRO PROD;BAC PRO AG 21203 TECHN CONSEIL DE VENTE ANIMAL;17;17;14;3;0;0;0;14;0;0;4;2;8;3
9109.0;2022;03;BESANCON;FEMININ;SCOLAIRE;BAC PROFESSIONNEL;BAC PRO PROD;BAC PRO AG 21405 AMENAGEMENTS PAYSAGERS;1;1;1;0;0;0;0;1;0;0;0;0;1;0
9122.0;2022;03;BESANCON;FEMININ;SCOLAIRE;BAC PROFESSIONNEL;BAC PRO SERV;BAC PRO 33403 COMMERC. SERVICES EN RESTAURATION;34;34;30;4;0;0;0;30;0;1;7;7;15;4
9123.0;2022;03;BESANCON;FEMININ;SCOLAIRE;BAC PROFESSIONNEL;BAC PRO SERV;BAC PRO 33603 ESTHETIQUE COSMETIQUE PARFUMERIE;25;25;23;2;0;0;0;23;0;1;2;5;15;2
9125.0;2022;03;BESANCON;FEMININ;SCOLAIRE;BAC PROFESSIONNEL;BAC PRO SERV;BAC PRO 34403 METIERS DE LA SECURITE;24;24;23;1;0;0;0;23;0;1;5;9;8;1
9126.0;2022;03;BESANCON;FEMININ;SCOLAIRE;BAC PROFESSIONNEL;BAC PRO SERV;BAC PRO AG 33002 SERV PERS TERRIT;213;205;177;28;0;0;0;177;0;7;25;53;92;28
9128.0;2022;03;BESANCON;FEMININ;SCOLAIRE;BAC TECHNOLOGIQUE;BAC S2TMD;BAC S2TMD MUSIQUE;4;4;4;0;0;0;0;4;0;0;2;2;0;0
9135.0;2022;03;BESANCON;FEMININ;SCOLAIRE;BAC TECHNOLOGIQUE;BAC STI2D;BAC STI2D INNOVATION TECHNO.  ET ECO CONCEPTION;19;19;14;0;5;4;1;18;0;0;1;2;15;1
9143.0;2022;03;BESANCON;MASCULIN;APPRENTISSAGE;BAC PROFESSIONNEL;BAC PRO PROD;BAC PRO 22003 BIO-INDUSTRIES DE TRANSFORMATION;17;17;17;0;0;0;0;17;0;1;6;3;7;0
9147.0;2022;03;BESANCON;MASCULIN;APPRENTISSAGE;BAC PROFESSIONNEL;BAC PRO PROD;BAC PRO 22704 TECHN. MAINT. SYST.ENERG.CLIMATI;4;4;4;0;0;0;0;4;0;0;0;3;1;0
9148.0;2022;03;BESANCON;MASCULIN;APPRENTISSAGE;BAC PROFESSIONNEL;BAC PRO PROD;BAC PRO 23004 TECHN. ETUDES BAT.A ETUDES & ECO.;3;3;3;0;0;0;0;3;0;0;2;1;0;0
9151.0;2022;03;BESANCON;MASCULIN;APPRENTISSAGE;BAC PROFESSIONNEL;BAC PRO PROD;BAC PRO 23203 TECHNICIEN BAT. : ORG.REAL.GROS O;6;6;6;0;0;0;0;6;0;1;2;2;1;0
9153.0;2022;03;BESANCON;MASCULIN;APPRENTISSAGE;BAC PROFESSIONNEL;BAC PRO PROD;BAC PRO 23304 AMENAGEMENT FINITION BATIMENT;1;1;1;0;0;0;0;1;0;0;1;0;0;0
9154.0;2022;03;BESANCON;MASCULIN;APPRENTISSAGE;BAC PROFESSIONNEL;BAC PRO PROD;BAC PRO 23404 TECHNICIEN CONSTRUCTEUR BOIS;15;15;14;1;0;0;0;14;0;2;8;4;0;1
9162.0;2022;03;BESANCON;MASCULIN;APPRENTISSAGE;BAC PROFESSIONNEL;BAC PRO PROD;BAC PRO 25214 MAINT.VEHIC.OPTA VOIT.PARTICUL.;70;70;66;2;2;2;0;68;0;6;13;27;22;2
9166.0;2022;03;BESANCON;MASCULIN;APPRENTISSAGE;BAC PROFESSIONNEL;BAC PRO PROD;BAC PRO 25220 MAINT.MATERIELS OPT.B TP MANUT.;4;4;4;0;0;0;0;4;0;1;1;2;0;0
9167.0;2022;03;BESANCON;MASCULIN;APPRENTISSAGE;BAC PROFESSIONNEL;BAC PRO PROD;BAC PRO 25221 MAINT.MATERIELS OPT.C ESP. VERTS;2;2;2;0;0;0;0;2;0;0;0;1;1;0
9169.0;2022;03;BESANCON;MASCULIN;APPRENTISSAGE;BAC PROFESSIONNEL;BAC PRO PROD;BAC PRO 25408 REPARATION DES CARROSSERIES;1;1;1;0;0;0;0;1;0;0;0;1;0;0
9185.0;2022;03;BESANCON;MASCULIN;APPRENTISSAGE;BAC PROFESSIONNEL;BAC PRO SERV;BAC PRO 31213 MET.COM.VEN.OP.A ANI.GES.ESP.COM.;36;36;27;5;4;4;0;31;0;0;5;13;13;5
9188.0;2022;03;BESANCON;MASCULIN;APPRENTISSAGE;BAC PROFESSIONNEL;BAC PRO SERV;BAC PRO 33102 PROTHESE DENTAIRE;2;2;1;1;0;0;0;1;0;0;0;0;1;1
9190.0;2022;03;BESANCON;MASCULIN;APPRENTISSAGE;BAC PROFESSIONNEL;BAC PRO SERV;BAC PRO 34403 METIERS DE LA SECURITE;3;3;3;0;0;0;0;3;0;0;1;0;2;0
9199.0;2022;03;BESANCON;MASCULIN;INDIVIDUEL;BAC PROFESSIONNEL;BAC PRO PROD;BAC PRO 25006 MICROTECHNIQUES;1;0;0;0;0;0;0;0;0;0;0;0;0;0
9204.0;2022;03;BESANCON;MASCULIN;INDIVIDUEL;BAC PROFESSIONNEL;BAC PRO PROD;BAC PRO AG 21004 CGEA;1;1;1;0;0;0;0;1;0;0;0;0;1;0
9212.0;2022;03;BESANCON;MASCULIN;INDIVIDUEL;BAC TECHNOLOGIQUE;BAC STL;BAC STL SCIENCES PHYSIQUES CHIMIQUES  EN LABORAT.;1;1;0;1;0;0;0;0;0;0;0;0;0;1
9214.0;2022;03;BESANCON;MASCULIN;INDIVIDUEL;BAC TECHNOLOGIQUE;BAC STMG;BAC STMG MERCATIQUE (MARKETING);9;6;4;2;0;0;0;4;0;0;0;0;4;2
9231.0;2022;03;BESANCON;MASCULIN;SCOLAIRE;BAC PROFESSIONNEL;BAC PRO PROD;BAC PRO 23408 Etude et réalisation d'agencement;5;5;5;0;0;0;0;5;0;1;2;1;1;0
9232.0;2022;03;BESANCON;MASCULIN;SCOLAIRE;BAC PROFESSIONNEL;BAC PRO PROD;BAC PRO 24203 METIERS DE LA MODE - VÊTEMENT;6;6;6;0;0;0;0;6;0;2;2;2;0;0
9235.0;2022;03;BESANCON;MASCULIN;SCOLAIRE;BAC PROFESSIONNEL;BAC PRO PROD;BAC PRO 25006 MICROTECHNIQUES;81;81;68;12;1;0;1;68;0;6;24;19;19;13
9239.0;2022;03;BESANCON;MASCULIN;SCOLAIRE;BAC PROFESSIONNEL;BAC PRO PROD;BAC PRO 25214 MAINT.VEHIC.OPTA VOIT.PARTICUL.;68;68;49;14;5;3;2;52;0;3;6;21;22;16
9243.0;2022;03;BESANCON;MASCULIN;SCOLAIRE;BAC PROFESSIONNEL;BAC PRO PROD;BAC PRO 25410 CONSTRUCTION DES CARROSSERIES;5;5;1;4;0;0;0;1;0;0;0;0;1;4
9245.0;2022;03;BESANCON;MASCULIN;SCOLAIRE;BAC PROFESSIONNEL;BAC PRO PROD;BAC PRO 25509 TECHNIC. FROID CONDITIONNEMT AIR;11;11;7;4;0;0;0;7;0;0;1;2;4;4
9246.0;2022;03;BESANCON;MASCULIN;SCOLAIRE;BAC PROFESSIONNEL;BAC PRO PROD;BAC PRO 25510 METIERS ELECT. ENVIRON. CONNECTES;138;138;108;23;7;4;3;112;0;6;27;36;43;26
9250.0;2022;03;BESANCON;MASCULIN;SCOLAIRE;BAC PROFESSIONNEL;BAC PRO PROD;BAC PRO AG 21001 AGRO-EQUIPEMENT;28;27;26;1;0;0;0;26;0;1;3;6;16;1
9255.0;2022;03;BESANCON;MASCULIN;SCOLAIRE;BAC PROFESSIONNEL;BAC PRO PROD;BAC PRO AG 21303 FORET;5;5;5;0;0;0;0;5;0;0;1;2;2;0
9259.0;2022;03;BESANCON;MASCULIN;SCOLAIRE;BAC PROFESSIONNEL;BAC PRO SERV;BAC PRO 30001 GESTION-ADMINISTRATION;91;91;62;25;4;3;1;65;0;0;10;24;31;26
9263.0;2022;03;BESANCON;MASCULIN;SCOLAIRE;BAC PROFESSIONNEL;BAC PRO SERV;BAC PRO 31213 MET.COM.VEN.OP.A ANI.GES.ESP.COM.;142;142;109;23;10;6;4;115;0;1;16;44;54;27
9267.0;2022;03;BESANCON;MASCULIN;SCOLAIRE;BAC PROFESSIONNEL;BAC PRO SERV;BAC PRO 33004 ACC.SOINS-S.PERS. OPT.EN STRUCTUR;23;23;19;3;1;1;0;20;0;1;6;5;8;3
9269.0;2022;03;BESANCON;MASCULIN;SCOLAIRE;BAC PROFESSIONNEL;BAC PRO SERV;BAC PRO 33403 COMMERC. SERVICES EN RESTAURATION;27;27;23;3;1;1;0;24;0;1;1;14;8;3
9280.0;2022;03;BESANCON;MASCULIN;SCOLAIRE;BAC TECHNOLOGIQUE;BAC STI2D;BAC STI2D ENERGIES  ET ENVIRONNEMENT;103;103;69;6;28;17;11;86;0;0;7;17;62;17
9281.0;2022;03;BESANCON;MASCULIN;SCOLAIRE;BAC TECHNOLOGIQUE;BAC STI2D;BAC STI2D INNOVATION TECHNO.  ET ECO CONCEPTION;183;183;130;10;43;29;14;159;1;0;12;50;96;24
9285.0;2022;03;BESANCON;MASCULIN;SCOLAIRE;BAC TECHNOLOGIQUE;BAC STMG;BAC STMG GESTION ET FINANCE;101;101;74;6;21;16;5;90;0;1;12;23;54;11
9286.0;2022;03;BESANCON;MASCULIN;SCOLAIRE;BAC TECHNOLOGIQUE;BAC STMG;BAC STMG MERCATIQUE (MARKETING);244;244;185;13;46;32;14;217;0;1;12;82;122;27
9304.0;2022;04;BORDEAUX;FEMININ;APPRENTISSAGE;BAC PROFESSIONNEL;BAC PRO PROD;BAC PRO AG 21004 CGEA;11;10;8;2;0;0;0;8;0;0;0;3;5;2
9306.0;2022;04;BORDEAUX;FEMININ;APPRENTISSAGE;BAC PROFESSIONNEL;BAC PRO PROD;BAC PRO AG 21114 CONDUITE PRODUCTIONS HORTICOLES;6;6;6;0;0;0;0;6;0;1;0;1;4;0
9307.0;2022;04;BORDEAUX;FEMININ;APPRENTISSAGE;BAC PROFESSIONNEL;BAC PRO PROD;BAC PRO AG 21211 COND GEST ENTR HIPPIQUE;24;24;21;3;0;0;0;21;0;0;0;9;12;3
9310.0;2022;04;BORDEAUX;FEMININ;APPRENTISSAGE;BAC PROFESSIONNEL;BAC PRO PROD;BAC PRO AG 22107 TEC CONS VTE ALIMENTATION P.ALIM;2;2;2;0;0;0;0;2;0;0;0;0;2;0
9316.0;2022;04;BORDEAUX;FEMININ;APPRENTISSAGE;BAC PROFESSIONNEL;BAC PRO SERV;BAC PRO 31214 MET.COM.VEN.OP.B PR.CL.VA.OF.COM.;3;3;2;0;1;1;0;3;0;0;0;2;1;0
9320.0;2022;04;BORDEAUX;FEMININ;APPRENTISSAGE;BAC PROFESSIONNEL;BAC PRO SERV;BAC PRO 33403 COMMERC. SERVICES EN RESTAURATION;13;12;10;2;0;0;0;10;0;0;1;5;4;2
9323.0;2022;04;BORDEAUX;FEMININ;APPRENTISSAGE;BAC PROFESSIONNEL;BAC PRO SERV;BAC PRO AG 33002 SERV PERS TERRIT;16;16;14;2;0;0;0;14;0;0;4;1;9;2
9333.0;2022;04;BORDEAUX;FEMININ;ENSEIGNEMENT A DISTANCE;BAC TECHNOLOGIQUE;BAC STMG;BAC STMG RESSOURCES HUMAINES ET COMMUNICATION;7;6;3;2;1;1;0;4;0;0;0;0;4;2
9334.0;2022;04;BORDEAUX;FEMININ;FORMATION CONTINUE;BAC PROFESSIONNEL;BAC PRO PROD;BAC PRO 22004 PROC. CHIMIE EAU PAPIERS-CARTONS;4;4;4;0;0;0;0;4;0;3;1;0;0;0
9343.0;2022;04;BORDEAUX;FEMININ;INDIVIDUEL;BAC PROFESSIONNEL;BAC PRO PROD;BAC PRO AG 21004 CGEA;3;2;1;1;0;0;0;1;0;0;0;0;1;1
9344.0;2022;04;BORDEAUX;FEMININ;INDIVIDUEL;BAC PROFESSIONNEL;BAC PRO PROD;BAC PRO AG 21113 CGEVV;1;0;0;0;0;0;0;0;0;0;0;0;0;0
9349.0;2022;04;BORDEAUX;FEMININ;INDIVIDUEL;BAC PROFESSIONNEL;BAC PRO SERV;BAC PRO 31209 POISSONIER ECAILLER TRAITEUR;1;1;0;0;1;1;0;1;0;0;0;0;1;0
9353.0;2022;04;BORDEAUX;FEMININ;INDIVIDUEL;BAC PROFESSIONNEL;BAC PRO SERV;BAC PRO 33003 ACC.SOINS-S.PERS. OPT.A DOMICILE;2;2;2;0;0;0;0;2;0;0;0;1;1;0
9359.0;2022;04;BORDEAUX;FEMININ;INDIVIDUEL;BAC TECHNOLOGIQUE;BAC STMG;BAC STMG MERCATIQUE (MARKETING);13;6;1;5;0;0;0;1;0;0;0;0;1;5
9361.0;2022;04;BORDEAUX;FEMININ;SCOLAIRE;BAC GENERAL;BAC GENERAL;BAC GENE 10019 BAC GENERAL;10293;10293;9530;140;623;447;176;9977;142;1291;2594;3249;2701;316
9378.0;2022;04;BORDEAUX;FEMININ;SCOLAIRE;BAC PROFESSIONNEL;BAC PRO PROD;BAC PRO 24202 ARTIS.& MET.ART : TAPIS.D'AMEUBL;25;25;23;2;0;0;0;23;0;6;7;4;6;2
9384.0;2022;04;BORDEAUX;FEMININ;SCOLAIRE;BAC PROFESSIONNEL;BAC PRO PROD;BAC PRO 25215 MAINT.VEHIC.OPTB VEHIC.TRANS.ROUT;2;2;0;2;0;0;0;0;0;0;0;0;0;2
9386.0;2022;04;BORDEAUX;FEMININ;SCOLAIRE;BAC PROFESSIONNEL;BAC PRO PROD;BAC PRO 25302 AERONAUTIQUE OPTION AVIONIQUE;2;2;2;0;0;0;0;2;0;1;1;0;0;0
9398.0;2022;04;BORDEAUX;FEMININ;SCOLAIRE;BAC PROFESSIONNEL;BAC PRO PROD;BAC PRO AG 21204 PROD-AQUACOLES;2;2;1;1;0;0;0;1;0;0;1;0;0;1
9400.0;2022;04;BORDEAUX;FEMININ;SCOLAIRE;BAC PROFESSIONNEL;BAC PRO PROD;BAC PRO AG 21211 COND GEST ENTR HIPPIQUE;48;47;41;6;0;0;0;41;0;0;10;17;14;6
9401.0;2022;04;BORDEAUX;FEMININ;SCOLAIRE;BAC PROFESSIONNEL;BAC PRO PROD;BAC PRO AG 21302 GEST MILIEUX NATURELS FAUNE;30;30;29;1;0;0;0;29;0;1;6;8;14;1
9409.0;2022;04;BORDEAUX;FEMININ;SCOLAIRE;BAC PROFESSIONNEL;BAC PRO SERV;BAC PRO 31106 LOGISTIQUE;23;23;18;5;0;0;0;18;0;1;6;6;5;5
9413.0;2022;04;BORDEAUX;FEMININ;SCOLAIRE;BAC PROFESSIONNEL;BAC PRO SERV;BAC PRO 31213 MET.COM.VEN.OP.A ANI.GES.ESP.COM.;428;428;359;58;11;9;2;368;0;23;85;132;128;60
9418.0;2022;04;BORDEAUX;FEMININ;SCOLAIRE;BAC PROFESSIONNEL;BAC PRO SERV;BAC PRO 32304 PHOTOGRAPHIE;28;28;22;4;2;2;0;24;0;0;4;7;13;4
9421.0;2022;04;BORDEAUX;FEMININ;SCOLAIRE;BAC PROFESSIONNEL;BAC PRO SERV;BAC PRO 33004 ACC.SOINS-S.PERS. OPT.EN STRUCTUR;445;443;419;19;5;3;2;422;0;63;148;139;72;21
9424.0;2022;04;BORDEAUX;FEMININ;SCOLAIRE;BAC PROFESSIONNEL;BAC PRO SERV;BAC PRO 33403 COMMERC. SERVICES EN RESTAURATION;83;81;76;4;1;0;1;76;0;4;15;34;23;5
9427.0;2022;04;BORDEAUX;FEMININ;SCOLAIRE;BAC PROFESSIONNEL;BAC PRO SERV;BAC PRO 34305 TECHN.D'INTERV.SUR INSTALL. NUCL.;2;2;2;0;0;0;0;2;0;0;0;0;2;0
9428.0;2022;04;BORDEAUX;FEMININ;SCOLAIRE;BAC PROFESSIONNEL;BAC PRO SERV;BAC PRO 34403 METIERS DE LA SECURITE;20;20;20;0;0;0;0;20;0;2;6;11;1;0
9433.0;2022;04;BORDEAUX;FEMININ;SCOLAIRE;BAC TECHNOLOGIQUE;BAC STAV;BAC STAV AGRONOMIE ALIM ENV TERRITOI;186;186;182;4;0;0;0;182;0;1;28;82;71;4
9444.0;2022;04;BORDEAUX;FEMININ;SCOLAIRE;BAC TECHNOLOGIQUE;BAC STMG;BAC STMG RESSOURCES HUMAINES ET COMMUNICATION;542;542;434;25;83;65;18;499;0;9;46;179;265;43
9448.0;2022;04;BORDEAUX;MASCULIN;APPRENTISSAGE;BAC PROFESSIONNEL;BAC PRO PROD;BAC PRO 22106 CUISINE;41;40;25;15;0;0;0;25;0;1;4;12;8;15
9461.0;2022;04;BORDEAUX;MASCULIN;APPRENTISSAGE;BAC PROFESSIONNEL;BAC PRO PROD;BAC PRO 24302 METIERS DU CUIR : MAROQUINERIE;1;1;1;0;0;0;0;1;0;1;0;0;0;0
9465.0;2022;04;BORDEAUX;MASCULIN;APPRENTISSAGE;BAC PROFESSIONNEL;BAC PRO PROD;BAC PRO 25106 TECHNICIEN D'USINAGE;33;31;28;2;1;1;0;29;0;6;10;7;6;2
9466.0;2022;04;BORDEAUX;MASCULIN;APPRENTISSAGE;BAC PROFESSIONNEL;BAC PRO PROD;BAC PRO 25107 TECHNICIEN OUTILLEUR;1;1;1;0;0;0;0;1;0;0;0;0;1;0
9480.0;2022;04;BORDEAUX;MASCULIN;APPRENTISSAGE;BAC PROFESSIONNEL;BAC PRO PROD;BAC PRO AG 21001 AGRO-EQUIPEMENT;41;40;35;5;0;0;0;35;0;1;2;7;25;5
9490.0;2022;04;BORDEAUX;MASCULIN;APPRENTISSAGE;BAC PROFESSIONNEL;BAC PRO SERV;BAC PRO 31106 LOGISTIQUE;21;20;13;6;1;1;0;14;0;2;1;3;8;6
9504.0;2022;04;BORDEAUX;MASCULIN;ENSEIGNEMENT A DISTANCE;BAC PROFESSIONNEL;BAC PRO SERV;BAC PRO 30001 GESTION-ADMINISTRATION;1;0;0;0;0;0;0;0;0;0;0;0;0;0
9511.0;2022;04;BORDEAUX;MASCULIN;FORMATION CONTINUE;BAC PROFESSIONNEL;BAC PRO PROD;BAC PRO 22004 PROC. CHIMIE EAU PAPIERS-CARTONS;14;14;14;0;0;0;0;14;0;7;7;0;0;0
9514.0;2022;04;BORDEAUX;MASCULIN;FORMATION CONTINUE;BAC PROFESSIONNEL;BAC PRO PROD;BAC PRO AG 21114 CONDUITE PRODUCTIONS HORTICOLES;5;5;5;0;0;0;0;5;0;0;1;0;4;0
9517.0;2022;04;BORDEAUX;MASCULIN;FORMATION CONTINUE;BAC PROFESSIONNEL;BAC PRO SERV;BAC PRO 33102 PROTHESE DENTAIRE;3;3;3;0;0;0;0;3;0;0;1;1;1;0
9519.0;2022;04;BORDEAUX;MASCULIN;INDIVIDUEL;BAC PROFESSIONNEL;BAC PRO PROD;BAC PRO 22106 CUISINE;1;1;1;0;0;0;0;1;0;0;0;1;0;0
9523.0;2022;04;BORDEAUX;MASCULIN;INDIVIDUEL;BAC PROFESSIONNEL;BAC PRO PROD;BAC PRO 25411 TECH.CHAUDRONNERIE INDUSTRIELLE;1;0;0;0;0;0;0;0;0;0;0;0;0;0
9530.0;2022;04;BORDEAUX;MASCULIN;INDIVIDUEL;BAC PROFESSIONNEL;BAC PRO PROD;BAC PRO AG 21211 COND GEST ENTR HIPPIQUE;1;1;1;0;0;0;0;1;0;0;0;0;1;0
9534.0;2022;04;BORDEAUX;MASCULIN;INDIVIDUEL;BAC PROFESSIONNEL;BAC PRO SERV;BAC PRO 31209 POISSONIER ECAILLER TRAITEUR;1;1;1;0;0;0;0;1;0;0;0;0;1;0
9540.0;2022;04;BORDEAUX;MASCULIN;INDIVIDUEL;BAC TECHNOLOGIQUE;BAC ST2S;BAC ST2S SCIENCES & TECHNO. SANTE & SOCIAL;1;1;0;0;1;1;0;1;0;0;0;0;1;0
9541.0;2022;04;BORDEAUX;MASCULIN;INDIVIDUEL;BAC TECHNOLOGIQUE;BAC STI2D;BAC STI2D INNOVATION TECHNO.  ET ECO CONCEPTION;1;1;0;1;0;0;0;0;0;0;0;0;0;1
9562.0;2022;04;BORDEAUX;MASCULIN;SCOLAIRE;BAC PROFESSIONNEL;BAC PRO PROD;BAC PRO 23203 TECHNICIEN BAT. : ORG.REAL.GROS O;20;20;14;4;2;2;0;16;0;0;0;7;9;4
9563.0;2022;04;BORDEAUX;MASCULIN;SCOLAIRE;BAC PROFESSIONNEL;BAC PRO PROD;BAC PRO 23208 METIERS ET ARTS DE LA PIERRE;5;5;4;1;0;0;0;4;0;0;0;0;4;1
9564.0;2022;04;BORDEAUX;MASCULIN;SCOLAIRE;BAC PROFESSIONNEL;BAC PRO PROD;BAC PRO 23304 AMENAGEMENT FINITION BATIMENT;31;31;21;7;3;2;1;23;0;2;3;8;10;8
9571.0;2022;04;BORDEAUX;MASCULIN;SCOLAIRE;BAC PROFESSIONNEL;BAC PRO PROD;BAC PRO 25007 MAINTENANCE EQUIPEMENTS INDUST.;199;199;145;50;4;2;2;147;0;5;26;57;59;52
9576.0;2022;04;BORDEAUX;MASCULIN;SCOLAIRE;BAC PROFESSIONNEL;BAC PRO PROD;BAC PRO 25215 MAINT.VEHIC.OPTB VEHIC.TRANS.ROUT;38;38;33;3;2;1;1;34;0;1;6;15;12;4
9577.0;2022;04;BORDEAUX;MASCULIN;SCOLAIRE;BAC PROFESSIONNEL;BAC PRO PROD;BAC PRO 25216 MAINT.VEHIC.OPTC MOTOCYCLES;46;45;42;3;0;0;0;42;0;3;7;16;16;3
9582.0;2022;04;BORDEAUX;MASCULIN;SCOLAIRE;BAC PROFESSIONNEL;BAC PRO PROD;BAC PRO 25303 AERONAUTIQUE OPTION SYSTEMES;48;48;45;1;2;2;0;47;0;5;19;13;10;1
9600.0;2022;04;BORDEAUX;MASCULIN;SCOLAIRE;BAC PROFESSIONNEL;BAC PRO PROD;BAC PRO AG 21302 GEST MILIEUX NATURELS FAUNE;68;68;64;4;0;0;0;64;0;0;9;34;21;4
9604.0;2022;04;BORDEAUX;MASCULIN;SCOLAIRE;BAC PROFESSIONNEL;BAC PRO PROD;BAC PRO AG 22105 LABORATOIRE CONTROLE QUALITE;12;12;11;1;0;0;0;11;0;0;2;3;6;1
9605.0;2022;04;BORDEAUX;MASCULIN;SCOLAIRE;BAC PROFESSIONNEL;BAC PRO PROD;BAC PRO AG 22106 TEC CONS VTE ALIMENTATION VINS SP;20;19;15;4;0;0;0;15;0;0;2;6;7;4
9621.0;2022;04;BORDEAUX;MASCULIN;SCOLAIRE;BAC PROFESSIONNEL;BAC PRO SERV;BAC PRO 33101 OPTIQUE LUNETTERIE;4;4;3;1;0;0;0;3;0;0;0;0;3;1
9633.0;2022;04;BORDEAUX;MASCULIN;SCOLAIRE;BAC TECHNOLOGIQUE;BAC STD2A;BAC STD2A SCIENCES & TECHNO. DESIGN-ARTS APPLIQUES;44;44;43;0;1;0;1;43;0;2;11;13;17;1
9638.0;2022;04;BORDEAUX;MASCULIN;SCOLAIRE;BAC TECHNOLOGIQUE;BAC STI2D;BAC STI2D SYSTÈME D'INFORMATION  ET NUMERIQUE;414;414;336;12;66;45;21;381;0;3;36;134;208;33
9649.0;2022;06;CLERMONT-FERRAND;FEMININ;APPRENTISSAGE;BAC PROFESSIONNEL;BAC PRO PROD;BAC PRO 23405 TECHNICIEN MENUISIER AGENCEUR;1;1;1;0;0;0;0;1;0;0;0;1;0;0
9654.0;2022;06;CLERMONT-FERRAND;FEMININ;APPRENTISSAGE;BAC PROFESSIONNEL;BAC PRO PROD;BAC PRO 25221 MAINT.MATERIELS OPT.C ESP. VERTS;1;1;1;0;0;0;0;1;0;0;0;1;0;0
9673.0;2022;06;CLERMONT-FERRAND;FEMININ;ENSEIGNEMENT A DISTANCE;BAC TECHNOLOGIQUE;BAC ST2S;BAC ST2S SCIENCES & TECHNO. SANTE & SOCIAL;8;8;6;2;0;0;0;6;0;0;0;3;3;2
9675.0;2022;06;CLERMONT-FERRAND;FEMININ;ENSEIGNEMENT A DISTANCE;BAC TECHNOLOGIQUE;BAC STMG;BAC STMG GESTION ET FINANCE;2;2;1;1;0;0;0;1;0;0;0;0;1;1
9679.0;2022;06;CLERMONT-FERRAND;FEMININ;FORMATION CONTINUE;BAC PROFESSIONNEL;BAC PRO PROD;BAC PRO 23404 TECHNICIEN CONSTRUCTEUR BOIS;1;1;1;0;0;0;0;1;0;1;0;0;0;0
9680.0;2022;06;CLERMONT-FERRAND;FEMININ;FORMATION CONTINUE;BAC PROFESSIONNEL;BAC PRO PROD;BAC PRO 25007 MAINTENANCE EQUIPEMENTS INDUST.;1;1;0;1;0;0;0;0;0;0;0;0;0;1
9681.0;2022;06;CLERMONT-FERRAND;FEMININ;FORMATION CONTINUE;BAC PROFESSIONNEL;BAC PRO SERV;BAC PRO 30001 GESTION-ADMINISTRATION;1;1;1;0;0;0;0;1;0;0;1;0;0;0
9682.0;2022;06;CLERMONT-FERRAND;FEMININ;FORMATION CONTINUE;BAC PROFESSIONNEL;BAC PRO SERV;BAC PRO 31212 METIERS DE L'ACCUEIL;2;2;2;0;0;0;0;2;0;0;1;1;0;0
9691.0;2022;06;CLERMONT-FERRAND;FEMININ;INDIVIDUEL;BAC PROFESSIONNEL;BAC PRO SERV;BAC PRO 33004 ACC.SOINS-S.PERS. OPT.EN STRUCTUR;2;2;0;2;0;0;0;0;0;0;0;0;0;2
9693.0;2022;06;CLERMONT-FERRAND;FEMININ;INDIVIDUEL;BAC TECHNOLOGIQUE;BAC STI2D;BAC STI2D INNOVATION TECHNO.  ET ECO CONCEPTION;1;0;0;0;0;0;0;0;0;0;0;0;0;0
9694.0;2022;06;CLERMONT-FERRAND;FEMININ;INDIVIDUEL;BAC TECHNOLOGIQUE;BAC STL;BAC STL BIOCHIM.-BIOLOGIE-BIOTECHNOL.;1;1;0;1;0;0;0;0;0;0;0;0;0;1
9698.0;2022;06;CLERMONT-FERRAND;FEMININ;SCOLAIRE;BAC GENERAL;BAC GENERAL;BAC GENE 10019 BAC GENERAL;3881;3881;3626;48;207;142;65;3768;55;453;1006;1245;1009;113
9700.0;2022;06;CLERMONT-FERRAND;FEMININ;SCOLAIRE;BAC PROFESSIONNEL;BAC PRO PROD;BAC PRO 22003 BIO-INDUSTRIES DE TRANSFORMATION;18;18;13;5;0;0;0;13;0;2;2;5;4;5
9706.0;2022;06;CLERMONT-FERRAND;FEMININ;SCOLAIRE;BAC PROFESSIONNEL;BAC PRO PROD;BAC PRO 23005 TECHN. ETUDES BAT B ASSIST.ARCHI.;5;5;5;0;0;0;0;5;0;0;0;4;1;0
9717.0;2022;06;CLERMONT-FERRAND;FEMININ;SCOLAIRE;BAC PROFESSIONNEL;BAC PRO PROD;BAC PRO 25302 AERONAUTIQUE OPTION AVIONIQUE;2;2;1;1;0;0;0;1;0;0;0;1;0;1
9723.0;2022;06;CLERMONT-FERRAND;FEMININ;SCOLAIRE;BAC PROFESSIONNEL;BAC PRO PROD;BAC PRO AG 21114 CONDUITE PRODUCTIONS HORTICOLES;4;4;4;0;0;0;0;4;0;0;1;1;2;0
9725.0;2022;06;CLERMONT-FERRAND;FEMININ;SCOLAIRE;BAC PROFESSIONNEL;BAC PRO PROD;BAC PRO AG 21210 COND GEST ENTR CANIN ET FELIN;20;20;17;3;0;0;0;17;0;0;2;7;8;3
9730.0;2022;06;CLERMONT-FERRAND;FEMININ;SCOLAIRE;BAC PROFESSIONNEL;BAC PRO PROD;BAC PRO AG 21407 TEC CONS VTE UNIVERS JARDINERIE;6;6;4;2;0;0;0;4;0;0;1;2;1;2
9731.0;2022;06;CLERMONT-FERRAND;FEMININ;SCOLAIRE;BAC PROFESSIONNEL;BAC PRO PROD;BAC PRO AG 22105 LABORATOIRE CONTROLE QUALITE;6;6;6;0;0;0;0;6;0;0;0;2;4;0
9733.0;2022;06;CLERMONT-FERRAND;FEMININ;SCOLAIRE;BAC PROFESSIONNEL;BAC PRO SERV;BAC PRO 30001 GESTION-ADMINISTRATION;191;191;159;23;9;5;4;164;0;3;33;60;68;27
9734.0;2022;06;CLERMONT-FERRAND;FEMININ;SCOLAIRE;BAC PROFESSIONNEL;BAC PRO SERV;BAC PRO 31107 CONDUCT. TRANSP.ROUT.MARCHANDISES;2;2;2;0;0;0;0;2;0;0;0;1;1;0
9736.0;2022;06;CLERMONT-FERRAND;FEMININ;SCOLAIRE;BAC PROFESSIONNEL;BAC PRO SERV;BAC PRO 31212 METIERS DE L'ACCUEIL;83;83;62;9;12;7;5;69;0;3;10;24;32;14
9738.0;2022;06;CLERMONT-FERRAND;FEMININ;SCOLAIRE;BAC PROFESSIONNEL;BAC PRO SERV;BAC PRO 31214 MET.COM.VEN.OP.B PR.CL.VA.OF.COM.;56;56;51;4;1;0;1;51;0;2;10;23;16;5
9749.0;2022;06;CLERMONT-FERRAND;FEMININ;SCOLAIRE;BAC PROFESSIONNEL;BAC PRO SERV;BAC PRO 33603 ESTHETIQUE COSMETIQUE PARFUMERIE;67;67;62;4;1;1;0;63;0;1;7;27;28;4
9750.0;2022;06;CLERMONT-FERRAND;FEMININ;SCOLAIRE;BAC PROFESSIONNEL;BAC PRO SERV;BAC PRO 34304 HYGIENE PROPRETE STERILISATION;11;10;7;3;0;0;0;7;0;0;1;4;2;3
9760.0;2022;06;CLERMONT-FERRAND;FEMININ;SCOLAIRE;BAC TECHNOLOGIQUE;BAC STI2D;BAC STI2D SYSTÈME D'INFORMATION  ET NUMERIQUE;7;7;5;1;1;1;0;6;0;0;3;1;2;1
9762.0;2022;06;CLERMONT-FERRAND;FEMININ;SCOLAIRE;BAC TECHNOLOGIQUE;BAC STL;BAC STL SCIENCES PHYSIQUES CHIMIQUES  EN LABORAT.;17;17;16;0;1;1;0;17;0;1;3;7;6;0
9763.0;2022;06;CLERMONT-FERRAND;FEMININ;SCOLAIRE;BAC TECHNOLOGIQUE;BAC STMG;BAC STMG GESTION ET FINANCE;92;92;82;3;7;5;2;87;0;2;15;34;36;5
9770.0;2022;06;CLERMONT-FERRAND;MASCULIN;APPRENTISSAGE;BAC PROFESSIONNEL;BAC PRO PROD;BAC PRO 22503 PLASTIQUES ET COMPOSITES;6;6;6;0;0;0;0;6;0;0;2;2;2;0
9778.0;2022;06;CLERMONT-FERRAND;MASCULIN;APPRENTISSAGE;BAC PROFESSIONNEL;BAC PRO PROD;BAC PRO 23406 TECHNICIEN DE SCIERIE;2;2;2;0;0;0;0;2;0;0;0;1;1;0
9786.0;2022;06;CLERMONT-FERRAND;MASCULIN;APPRENTISSAGE;BAC PROFESSIONNEL;BAC PRO PROD;BAC PRO 25220 MAINT.MATERIELS OPT.B TP MANUT.;7;6;2;1;3;2;1;4;0;0;0;1;3;2
9790.0;2022;06;CLERMONT-FERRAND;MASCULIN;APPRENTISSAGE;BAC PROFESSIONNEL;BAC PRO PROD;BAC PRO 25304 AERONAUTIQUE OPTION STRUCTURE;2;2;1;1;0;0;0;1;0;0;0;0;1;1
9792.0;2022;06;CLERMONT-FERRAND;MASCULIN;APPRENTISSAGE;BAC PROFESSIONNEL;BAC PRO PROD;BAC PRO 25411 TECH.CHAUDRONNERIE INDUSTRIELLE;19;19;18;1;0;0;0;18;0;4;2;5;7;1
9793.0;2022;06;CLERMONT-FERRAND;MASCULIN;APPRENTISSAGE;BAC PROFESSIONNEL;BAC PRO PROD;BAC PRO 25509 TECHNIC. FROID CONDITIONNEMT AIR;17;17;8;9;0;0;0;8;0;1;1;1;5;9
9796.0;2022;06;CLERMONT-FERRAND;MASCULIN;APPRENTISSAGE;BAC PROFESSIONNEL;BAC PRO PROD;BAC PRO AG 21001 AGRO-EQUIPEMENT;2;2;0;2;0;0;0;0;0;0;0;0;0;2
9803.0;2022;06;CLERMONT-FERRAND;MASCULIN;APPRENTISSAGE;BAC PROFESSIONNEL;BAC PRO SERV;BAC PRO 31106 LOGISTIQUE;15;15;14;0;1;0;1;14;0;1;4;5;4;1
9804.0;2022;06;CLERMONT-FERRAND;MASCULIN;APPRENTISSAGE;BAC PROFESSIONNEL;BAC PRO SERV;BAC PRO 31212 METIERS DE L'ACCUEIL;3;3;3;0;0;0;0;3;0;1;0;2;0;0
9811.0;2022;06;CLERMONT-FERRAND;MASCULIN;APPRENTISSAGE;BAC PROFESSIONNEL;BAC PRO SERV;BAC PRO AG 33002 SERV PERS TERRIT;1;1;1;0;0;0;0;1;0;0;0;1;0;0
9816.0;2022;06;CLERMONT-FERRAND;MASCULIN;ENSEIGNEMENT A DISTANCE;BAC PROFESSIONNEL;BAC PRO SERV;BAC PRO 31214 MET.COM.VEN.OP.B PR.CL.VA.OF.COM.;1;0;0;0;0;0;0;0;0;0;0;0;0;0
9820.0;2022;06;CLERMONT-FERRAND;MASCULIN;FORMATION CONTINUE;BAC PROFESSIONNEL;BAC PRO PROD;BAC PRO 22705 TECHNICIEN GAZ;2;2;2;0;0;0;0;2;0;2;0;0;0;0
9833.0;2022;06;CLERMONT-FERRAND;MASCULIN;INDIVIDUEL;BAC PROFESSIONNEL;BAC PRO PROD;BAC PRO AG 21405 AMENAGEMENTS PAYSAGERS;1;0;0;0;0;0;0;0;0;0;0;0;0;0
9838.0;2022;06;CLERMONT-FERRAND;MASCULIN;INDIVIDUEL;BAC TECHNOLOGIQUE;BAC STMG;BAC STMG MERCATIQUE (MARKETING);3;1;0;0;1;0;1;0;0;0;0;0;0;1
9846.0;2022;06;CLERMONT-FERRAND;MASCULIN;SCOLAIRE;BAC PROFESSIONNEL;BAC PRO PROD;BAC PRO 22503 PLASTIQUES ET COMPOSITES;1;1;1;0;0;0;0;1;0;0;1;0;0;0
9849.0;2022;06;CLERMONT-FERRAND;MASCULIN;SCOLAIRE;BAC PROFESSIONNEL;BAC PRO PROD;BAC PRO 23003 ARTIS. & M.ART:MARCHANDISAGE VIS.;1;1;0;1;0;0;0;0;0;0;0;0;0;1
9852.0;2022;06;CLERMONT-FERRAND;MASCULIN;SCOLAIRE;BAC PROFESSIONNEL;BAC PRO PROD;BAC PRO 23102 TRAVAUX PUBLICS;14;14;11;2;1;1;0;12;0;0;3;6;3;2
9861.0;2022;06;CLERMONT-FERRAND;MASCULIN;SCOLAIRE;BAC PROFESSIONNEL;BAC PRO PROD;BAC PRO 25007 MAINTENANCE EQUIPEMENTS INDUST.;113;113;90;19;4;3;1;93;0;4;18;32;39;20
9864.0;2022;06;CLERMONT-FERRAND;MASCULIN;SCOLAIRE;BAC PROFESSIONNEL;BAC PRO PROD;BAC PRO 25215 MAINT.VEHIC.OPTB VEHIC.TRANS.ROUT;18;18;9;8;1;0;1;9;0;0;1;6;2;9
9874.0;2022;06;CLERMONT-FERRAND;MASCULIN;SCOLAIRE;BAC PROFESSIONNEL;BAC PRO PROD;BAC PRO 25509 TECHNIC. FROID CONDITIONNEMT AIR;20;20;15;5;0;0;0;15;0;0;0;8;7;5
9876.0;2022;06;CLERMONT-FERRAND;MASCULIN;SCOLAIRE;BAC PROFESSIONNEL;BAC PRO PROD;BAC PRO 25513 SYST.NUM.OPT.A SURETE SECURITE;23;23;13;8;2;2;0;15;0;0;0;3;12;8
9891.0;2022;06;CLERMONT-FERRAND;MASCULIN;SCOLAIRE;BAC PROFESSIONNEL;BAC PRO SERV;BAC PRO 30001 GESTION-ADMINISTRATION;106;106;90;13;3;3;0;93;0;3;7;39;44;13
9898.0;2022;06;CLERMONT-FERRAND;MASCULIN;SCOLAIRE;BAC PROFESSIONNEL;BAC PRO SERV;BAC PRO 32207 REAL.PR.IMPR.PLURI.OPTA.PR.GRAPH.;11;11;8;3;0;0;0;8;0;1;4;1;2;3
9902.0;2022;06;CLERMONT-FERRAND;MASCULIN;SCOLAIRE;BAC PROFESSIONNEL;BAC PRO SERV;BAC PRO 33002 SERVICES DE PROXIMITE  VIE LOCAL;17;17;12;4;1;0;1;12;0;0;2;3;7;5
9906.0;2022;06;CLERMONT-FERRAND;MASCULIN;SCOLAIRE;BAC PROFESSIONNEL;BAC PRO SERV;BAC PRO 33102 PROTHESE DENTAIRE;3;3;3;0;0;0;0;3;0;0;0;1;2;0
9913.0;2022;06;CLERMONT-FERRAND;MASCULIN;SCOLAIRE;BAC TECHNOLOGIQUE;BAC STAV;BAC STAV AGRONOMIE ALIM ENV TERRITOI;94;93;92;1;0;0;0;92;0;3;14;41;34;1
9915.0;2022;06;CLERMONT-FERRAND;MASCULIN;SCOLAIRE;BAC TECHNOLOGIQUE;BAC STHR;BAC STHR SC.&TEC. HOTELLERIE-RESTAURATION;29;29;24;0;5;3;2;27;0;0;6;9;12;2
9922.0;2022;06;CLERMONT-FERRAND;MASCULIN;SCOLAIRE;BAC TECHNOLOGIQUE;BAC STMG;BAC STMG GESTION ET FINANCE;131;131;105;9;17;12;5;117;0;0;11;42;64;14
9925.0;2022;06;CLERMONT-FERRAND;MASCULIN;SCOLAIRE;BAC TECHNOLOGIQUE;BAC STMG;BAC STMG SYSTEMES D'INFORMATION DE GESTION;17;17;6;4;7;5;2;11;0;0;0;1;10;6
9926.0;2022;27;CORSE;FEMININ;APPRENTISSAGE;BAC PROFESSIONNEL;BAC PRO SERV;BAC PRO 30001 GESTION-ADMINISTRATION;13;12;7;5;0;0;0;7;0;0;3;3;1;5
9927.0;2022;27;CORSE;FEMININ;APPRENTISSAGE;BAC PROFESSIONNEL;BAC PRO SERV;BAC PRO 31213 MET.COM.VEN.OP.A ANI.GES.ESP.COM.;6;5;4;1;0;0;0;4;0;0;0;3;1;1
9932.0;2022;27;CORSE;FEMININ;ENSEIGNEMENT A DISTANCE;BAC PROFESSIONNEL;BAC PRO SERV;BAC PRO 31213 MET.COM.VEN.OP.A ANI.GES.ESP.COM.;1;0;0;0;0;0;0;0;0;0;0;0;0;0
9935.0;2022;27;CORSE;FEMININ;ENSEIGNEMENT A DISTANCE;BAC TECHNOLOGIQUE;BAC STMG;BAC STMG RESSOURCES HUMAINES ET COMMUNICATION;1;1;1;0;0;0;0;1;0;0;0;0;1;0
9936.0;2022;27;CORSE;FEMININ;INDIVIDUEL;BAC GENERAL;BAC GENERAL;BAC GENE 10019 BAC GENERAL;7;5;3;1;1;1;0;4;1;0;0;1;2;1
9941.0;2022;27;CORSE;FEMININ;INDIVIDUEL;BAC TECHNOLOGIQUE;BAC ST2S;BAC ST2S SCIENCES & TECHNO. SANTE & SOCIAL;1;1;1;0;0;0;0;1;0;0;0;0;1;0
9976.0;2022;27;CORSE;MASCULIN;APPRENTISSAGE;BAC PROFESSIONNEL;BAC PRO PROD;BAC PRO 25214 MAINT.VEHIC.OPTA VOIT.PARTICUL.;15;15;12;3;0;0;0;12;0;2;1;3;6;3
9977.0;2022;27;CORSE;MASCULIN;APPRENTISSAGE;BAC PROFESSIONNEL;BAC PRO PROD;BAC PRO 25510 METIERS ELECT. ENVIRON. CONNECTES;18;17;17;0;0;0;0;17;0;4;4;6;3;0
9981.0;2022;27;CORSE;MASCULIN;APPRENTISSAGE;BAC PROFESSIONNEL;BAC PRO SERV;BAC PRO 31107 CONDUCT. TRANSP.ROUT.MARCHANDISES;1;1;1;0;0;0;0;1;0;0;0;1;0;0
9985.0;2022;27;CORSE;MASCULIN;ENSEIGNEMENT A DISTANCE;BAC GENERAL;BAC GENERAL;BAC GENE 10019 BAC GENERAL;3;3;3;0;0;0;0;3;0;0;0;2;1;0
20003.0;2023;28;LA REUNION;MASCULIN;APPRENTISSAGE;BAC PROFESSIONNEL;BAC PRO PROD;BAC PRO 20102 PILOTE DE LIGNE DE PRODUCTION;1;1;1;0;0;0;0;1;0;0;1;0;0;0
20013.0;2023;28;LA REUNION;MASCULIN;APPRENTISSAGE;BAC PROFESSIONNEL;BAC PRO PROD;BAC PRO 25406 OUVRAGES DU BATIMENT METALLERIE;7;7;6;1;0;0;0;6;0;0;0;3;3;1
20018.0;2023;28;LA REUNION;MASCULIN;APPRENTISSAGE;BAC PROFESSIONNEL;BAC PRO SERV;BAC PRO 31213 MET.COM.VEN.OP.A ANI.GES.ESP.COM.;7;7;0;5;2;1;1;1;0;0;0;0;1;6
20022.0;2023;28;LA REUNION;MASCULIN;FORMATION CONTINUE;BAC PROFESSIONNEL;BAC PRO PROD;BAC PRO 22003 BIO-INDUSTRIES DE TRANSFORMATION;1;0;0;0;0;0;0;0;0;0;0;0;0;0
20026.0;2023;28;LA REUNION;MASCULIN;INDIVIDUEL;BAC PROFESSIONNEL;BAC PRO PROD;BAC PRO AG 21004 CGEA;10;9;9;0;0;0;0;9;0;0;0;0;9;0
20029.0;2023;28;LA REUNION;MASCULIN;INDIVIDUEL;BAC PROFESSIONNEL;BAC PRO SERV;BAC PRO 31213 MET.COM.VEN.OP.A ANI.GES.ESP.COM.;1;0;0;0;0;0;0;0;0;0;0;0;0;0
20041.0;2023;28;LA REUNION;MASCULIN;SCOLAIRE;BAC PROFESSIONNEL;BAC PRO PROD;BAC PRO 22105 BOULANGER-PÂTISSIER;16;16;15;1;0;0;0;15;0;0;4;6;5;1
20049.0;2023;28;LA REUNION;MASCULIN;SCOLAIRE;BAC PROFESSIONNEL;BAC PRO PROD;BAC PRO 23102 TRAVAUX PUBLICS;25;25;15;8;2;2;0;17;0;1;0;2;14;8
20053.0;2023;28;LA REUNION;MASCULIN;SCOLAIRE;BAC PROFESSIONNEL;BAC PRO PROD;BAC PRO 23206 INTERV. SUR PATRIMOINE BATI OPT.B;8;8;6;1;1;1;0;7;0;0;0;2;5;1
20062.0;2023;28;LA REUNION;MASCULIN;SCOLAIRE;BAC PROFESSIONNEL;BAC PRO PROD;BAC PRO 25007 MAINTENANCE EQUIPEMENTS INDUST.;84;84;57;19;8;6;2;63;0;0;6;19;38;21
20063.0;2023;28;LA REUNION;MASCULIN;SCOLAIRE;BAC PROFESSIONNEL;BAC PRO PROD;BAC PRO 25106 TECHNICIEN D'USINAGE;8;8;7;0;1;1;0;8;0;0;1;3;4;0
20070.0;2023;28;LA REUNION;MASCULIN;SCOLAIRE;BAC PROFESSIONNEL;BAC PRO PROD;BAC PRO 25406 OUVRAGES DU BATIMENT METALLERIE;32;31;23;7;1;1;0;24;0;0;1;10;13;7
20072.0;2023;28;LA REUNION;MASCULIN;SCOLAIRE;BAC PROFESSIONNEL;BAC PRO PROD;BAC PRO 25411 TECH.CHAUDRONNERIE INDUSTRIELLE;28;28;17;8;3;2;1;19;0;1;2;4;12;9
20087.0;2023;28;LA REUNION;MASCULIN;SCOLAIRE;BAC PROFESSIONNEL;BAC PRO SERV;BAC PRO 31114 ORGANIS. TRANSPORT MARCHANDISES;31;31;21;8;2;2;0;23;0;1;2;9;11;8
20094.0;2023;28;LA REUNION;MASCULIN;SCOLAIRE;BAC PROFESSIONNEL;BAC PRO SERV;BAC PRO 33004 ACC.SOINS-S.PERS. OPT.EN STRUCTUR;10;10;10;0;0;0;0;10;0;0;0;2;8;0
20099.0;2023;28;LA REUNION;MASCULIN;SCOLAIRE;BAC PROFESSIONNEL;BAC PRO SERV;BAC PRO 34304 HYGIENE PROPRETE STERILISATION;6;6;5;1;0;0;0;5;0;0;0;2;3;1
20103.0;2023;28;LA REUNION;MASCULIN;SCOLAIRE;BAC TECHNOLOGIQUE;BAC STAV;BAC STAV AGRONOMIE ALIM ENV TERRITOI;16;15;15;0;0;0;0;15;0;0;0;4;11;0
20104.0;2023;28;LA REUNION;MASCULIN;SCOLAIRE;BAC TECHNOLOGIQUE;BAC STD2A;BAC STD2A SCIENCES & TECHNO. DESIGN-ARTS APPLIQUES;4;4;4;0;0;0;0;4;0;0;2;0;2;0
20107.0;2023;28;LA REUNION;MASCULIN;SCOLAIRE;BAC TECHNOLOGIQUE;BAC STI2D;BAC STI2D ENERGIES  ET ENVIRONNEMENT;91;91;70;5;16;9;7;79;0;2;6;29;42;12
20111.0;2023;28;LA REUNION;MASCULIN;SCOLAIRE;BAC TECHNOLOGIQUE;BAC STL;BAC STL SCIENCES PHYSIQUES CHIMIQUES  EN LABORAT.;17;17;10;2;5;2;3;12;0;1;0;4;7;5
20115.0;2023;28;LA REUNION;MASCULIN;SCOLAIRE;BAC TECHNOLOGIQUE;BAC STMG;BAC STMG SYSTEMES D'INFORMATION DE GESTION;34;34;17;6;11;10;1;27;0;0;0;5;22;7
20124.0;2023;09;LILLE;FEMININ;APPRENTISSAGE;BAC PROFESSIONNEL;BAC PRO PROD;BAC PRO 25214 MAINT.VEHIC.OPTA VOIT.PARTICUL.;3;3;2;1;0;0;0;2;0;0;1;0;1;1
20125.0;2023;09;LILLE;FEMININ;APPRENTISSAGE;BAC PROFESSIONNEL;BAC PRO PROD;BAC PRO 25215 MAINT.VEHIC.OPTB VEHIC.TRANS.ROUT;1;0;0;0;0;0;0;0;0;0;0;0;0;0
20126.0;2023;09;LILLE;FEMININ;APPRENTISSAGE;BAC PROFESSIONNEL;BAC PRO PROD;BAC PRO 25219 MAINT.MATERIELS OPT.A AGRICOLES;1;1;1;0;0;0;0;1;0;0;0;1;0;0
20133.0;2023;09;LILLE;FEMININ;APPRENTISSAGE;BAC PROFESSIONNEL;BAC PRO PROD;BAC PRO AG 21210 COND GEST ENTR CANIN ET FELIN;1;1;1;0;0;0;0;1;0;0;0;0;1;0
20135.0;2023;09;LILLE;FEMININ;APPRENTISSAGE;BAC PROFESSIONNEL;BAC PRO PROD;BAC PRO AG 21405 AMENAGEMENTS PAYSAGERS;2;2;1;1;0;0;0;1;0;0;0;1;0;1
20136.0;2023;09;LILLE;FEMININ;APPRENTISSAGE;BAC PROFESSIONNEL;BAC PRO PROD;BAC PRO AG 22108 TEC CONS VTE ALIMENTATION (PAB);40;38;36;2;0;0;0;36;0;0;2;14;20;2
20137.0;2023;09;LILLE;FEMININ;APPRENTISSAGE;BAC PROFESSIONNEL;BAC PRO SERV;BAC PRO 30004 ASSISTANC.GEST.ORGANIS.ACTIVITES;19;19;17;2;0;0;0;17;0;3;8;4;2;2
20156.0;2023;09;LILLE;FEMININ;ENSEIGNEMENT A DISTANCE;BAC TECHNOLOGIQUE;BAC ST2S;BAC ST2S SCIENCES & TECHNO. SANTE & SOCIAL;10;10;5;3;2;0;2;5;0;0;1;1;3;5
20167.0;2023;09;LILLE;FEMININ;INDIVIDUEL;BAC PROFESSIONNEL;BAC PRO PROD;BAC PRO AG 21114 CONDUITE PRODUCTIONS HORTICOLES;1;1;1;0;0;0;0;1;0;0;0;0;1;0
20171.0;2023;09;LILLE;FEMININ;INDIVIDUEL;BAC PROFESSIONNEL;BAC PRO SERV;BAC PRO 30004 ASSISTANC.GEST.ORGANIS.ACTIVITES;3;1;0;1;0;0;0;0;0;0;0;0;0;1
20178.0;2023;09;LILLE;FEMININ;INDIVIDUEL;BAC PROFESSIONNEL;BAC PRO SERV;BAC PRO 33403 COMMERC. SERVICES EN RESTAURATION;1;1;0;1;0;0;0;0;0;0;0;0;0;1
20180.0;2023;09;LILLE;FEMININ;INDIVIDUEL;BAC PROFESSIONNEL;BAC PRO SERV;BAC PRO 33603 ESTHETIQUE COSMETIQUE PARFUMERIE;2;2;2;0;0;0;0;2;0;0;0;0;2;0
20182.0;2023;09;LILLE;FEMININ;INDIVIDUEL;BAC TECHNOLOGIQUE;BAC ST2S;BAC ST2S SCIENCES & TECHNO. SANTE & SOCIAL;25;24;6;13;5;3;2;9;0;1;0;1;7;15
20191.0;2023;09;LILLE;FEMININ;SCOLAIRE;BAC PROFESSIONNEL;BAC PRO PROD;BAC PRO 22104 BOUCHER CHARCUTIER TRAITEUR;1;1;1;0;0;0;0;1;0;0;1;0;0;0
20192.0;2023;09;LILLE;FEMININ;SCOLAIRE;BAC PROFESSIONNEL;BAC PRO PROD;BAC PRO 22105 BOULANGER-PÂTISSIER;59;58;51;3;4;4;0;55;0;6;10;21;18;3
20196.0;2023;09;LILLE;FEMININ;SCOLAIRE;BAC PROFESSIONNEL;BAC PRO PROD;BAC PRO 22704 TECHN. MAINT. SYST.ENERG.CLIMATI;1;1;1;0;0;0;0;1;0;0;0;0;1;0
20198.0;2023;09;LILLE;FEMININ;SCOLAIRE;BAC PROFESSIONNEL;BAC PRO PROD;BAC PRO 23004 TECHN. ETUDES BAT.A ETUDES & ECO.;16;16;12;4;0;0;0;12;0;2;2;2;6;4
20200.0;2023;09;LILLE;FEMININ;SCOLAIRE;BAC PROFESSIONNEL;BAC PRO PROD;BAC PRO 23102 TRAVAUX PUBLICS;1;1;0;1;0;0;0;0;0;0;0;0;0;1
20216.0;2023;09;LILLE;FEMININ;SCOLAIRE;BAC PROFESSIONNEL;BAC PRO PROD;BAC PRO 25411 TECH.CHAUDRONNERIE INDUSTRIELLE;4;4;4;0;0;0;0;4;0;1;3;0;0;0
20225.0;2023;09;LILLE;FEMININ;SCOLAIRE;BAC PROFESSIONNEL;BAC PRO PROD;BAC PRO AG 21302 GEST MILIEUX NATURELS FAUNE;6;6;2;4;0;0;0;2;0;0;0;2;0;4
20229.0;2023;09;LILLE;FEMININ;SCOLAIRE;BAC PROFESSIONNEL;BAC PRO PROD;BAC PRO AG 22105 LABORATOIRE CONTROLE QUALITE;22;22;20;2;0;0;0;20;0;0;7;6;7;2
20230.0;2023;09;LILLE;FEMININ;SCOLAIRE;BAC PROFESSIONNEL;BAC PRO PROD;BAC PRO AG 22108 TEC CONS VTE ALIMENTATION (PAB);6;6;4;2;0;0;0;4;0;0;1;2;1;2
20239.0;2023;09;LILLE;FEMININ;SCOLAIRE;BAC PROFESSIONNEL;BAC PRO SERV;BAC PRO 32207 REAL.PR.IMPR.PLURI.OPTA.PR.GRAPH.;6;6;6;0;0;0;0;6;0;0;2;3;1;0
20242.0;2023;09;LILLE;FEMININ;SCOLAIRE;BAC PROFESSIONNEL;BAC PRO SERV;BAC PRO 33003 ACC.SOINS-S.PERS. OPT.A DOMICILE;255;253;186;48;19;17;2;203;0;7;43;65;88;50
20244.0;2023;09;LILLE;FEMININ;SCOLAIRE;BAC PROFESSIONNEL;BAC PRO SERV;BAC PRO 33006 ANIMAT. ENFANCE& PERSONNES AGEES;126;125;111;11;3;3;0;114;0;17;37;43;17;11
20246.0;2023;09;LILLE;FEMININ;SCOLAIRE;BAC PROFESSIONNEL;BAC PRO SERV;BAC PRO 33103 TECHNICIEN APPAREIL. ORTHOPEDIQUE;7;7;7;0;0;0;0;7;0;1;2;3;1;0
20250.0;2023;09;LILLE;FEMININ;SCOLAIRE;BAC PROFESSIONNEL;BAC PRO SERV;BAC PRO 33603 ESTHETIQUE COSMETIQUE PARFUMERIE;206;206;182;22;2;2;0;184;0;8;36;77;63;22
20253.0;2023;09;LILLE;FEMININ;SCOLAIRE;BAC PROFESSIONNEL;BAC PRO SERV;BAC PRO 34403 METIERS DE LA SECURITE;68;68;57;8;3;2;1;59;0;2;8;30;19;9
20255.0;2023;09;LILLE;FEMININ;SCOLAIRE;BAC TECHNOLOGIQUE;BAC S2TMD;BAC S2TMD DANSE;1;1;1;0;0;0;0;1;0;1;0;0;0;0
20257.0;2023;09;LILLE;FEMININ;SCOLAIRE;BAC TECHNOLOGIQUE;BAC ST2S;BAC ST2S SCIENCES & TECHNO. SANTE & SOCIAL;1663;1663;1391;59;213;146;67;1537;15;81;228;538;675;126
20261.0;2023;09;LILLE;FEMININ;SCOLAIRE;BAC TECHNOLOGIQUE;BAC STI2D;BAC STI2D ARCHITECTURE ET CONSTRUCTION;39;39;30;4;5;4;1;34;0;2;1;8;23;5
20267.0;2023;09;LILLE;FEMININ;SCOLAIRE;BAC TECHNOLOGIQUE;BAC STMG;BAC STMG GESTION ET FINANCE;351;351;305;9;37;33;4;338;1;14;58;122;143;13
20268.0;2023;09;LILLE;FEMININ;SCOLAIRE;BAC TECHNOLOGIQUE;BAC STMG;BAC STMG MERCATIQUE (MARKETING);931;931;731;57;143;115;28;846;1;15;89;285;456;85
20269.0;2023;09;LILLE;FEMININ;SCOLAIRE;BAC TECHNOLOGIQUE;BAC STMG;BAC STMG RESSOURCES HUMAINES ET COMMUNICATION;770;770;587;45;138;104;34;691;0;15;84;195;397;79
20272.0;2023;09;LILLE;MASCULIN;APPRENTISSAGE;BAC PROFESSIONNEL;BAC PRO PROD;BAC PRO 22004 PROC. CHIMIE EAU PAPIERS-CARTONS;2;2;2;0;0;0;0;2;0;1;1;0;0;0
20275.0;2023;09;LILLE;MASCULIN;APPRENTISSAGE;BAC PROFESSIONNEL;BAC PRO PROD;BAC PRO 22403 ARTS.& MET.ART:MET.ENSEIGN SIGNA;1;1;1;0;0;0;0;1;0;0;0;1;0;0
20283.0;2023;09;LILLE;MASCULIN;APPRENTISSAGE;BAC PROFESSIONNEL;BAC PRO PROD;BAC PRO 23405 TECHNICIEN MENUISIER AGENCEUR;25;25;14;10;1;1;0;15;0;2;1;5;7;10
20294.0;2023;09;LILLE;MASCULIN;APPRENTISSAGE;BAC PROFESSIONNEL;BAC PRO PROD;BAC PRO 25303 AERONAUTIQUE OPTION SYSTEMES;9;9;7;1;1;1;0;8;0;4;1;2;1;1
20296.0;2023;09;LILLE;MASCULIN;APPRENTISSAGE;BAC PROFESSIONNEL;BAC PRO PROD;BAC PRO 25406 OUVRAGES DU BATIMENT METALLERIE;10;10;9;1;0;0;0;9;0;0;0;4;5;1
20298.0;2023;09;LILLE;MASCULIN;APPRENTISSAGE;BAC PROFESSIONNEL;BAC PRO PROD;BAC PRO 25411 TECH.CHAUDRONNERIE INDUSTRIELLE;76;74;61;9;4;2;2;63;0;3;12;21;27;11
20303.0;2023;09;LILLE;MASCULIN;APPRENTISSAGE;BAC PROFESSIONNEL;BAC PRO PROD;BAC PRO AG 21203 TECHN CONSEIL DE VENTE ANIMAL;7;7;6;1;0;0;0;6;0;1;0;2;3;1
20308.0;2023;09;LILLE;MASCULIN;APPRENTISSAGE;BAC PROFESSIONNEL;BAC PRO PROD;BAC PRO AG 22108 TEC CONS VTE ALIMENTATION (PAB);15;15;11;4;0;0;0;11;0;1;3;4;3;4
20310.0;2023;09;LILLE;MASCULIN;APPRENTISSAGE;BAC PROFESSIONNEL;BAC PRO SERV;BAC PRO 31106 LOGISTIQUE;15;15;12;1;2;0;2;12;0;2;5;4;1;3
20314.0;2023;09;LILLE;MASCULIN;APPRENTISSAGE;BAC PROFESSIONNEL;BAC PRO SERV;BAC PRO 31214 MET.COM.VEN.OP.B PR.CL.VA.OF.COM.;4;4;3;1;0;0;0;3;0;0;1;2;0;1
20320.0;2023;09;LILLE;MASCULIN;ENSEIGNEMENT A DISTANCE;BAC PROFESSIONNEL;BAC PRO SERV;BAC PRO 30004 ASSISTANC.GEST.ORGANIS.ACTIVITES;1;0;0;0;0;0;0;0;0;0;0;0;0;0
20321.0;2023;09;LILLE;MASCULIN;ENSEIGNEMENT A DISTANCE;BAC PROFESSIONNEL;BAC PRO SERV;BAC PRO 31213 MET.COM.VEN.OP.A ANI.GES.ESP.COM.;1;1;0;1;0;0;0;0;0;0;0;0;0;1
20326.0;2023;09;LILLE;MASCULIN;ENSEIGNEMENT A DISTANCE;BAC TECHNOLOGIQUE;BAC STMG;BAC STMG RESSOURCES HUMAINES ET COMMUNICATION;1;1;0;0;1;1;0;1;0;0;0;0;1;0
20327.0;2023;09;LILLE;MASCULIN;ENSEIGNEMENT A DISTANCE;BAC TECHNOLOGIQUE;BAC STMG;BAC STMG SYSTEMES D'INFORMATION DE GESTION;2;2;0;1;1;1;0;1;0;0;0;0;1;1
20328.0;2023;09;LILLE;MASCULIN;FORMATION CONTINUE;BAC PROFESSIONNEL;BAC PRO PROD;BAC PRO 20102 PILOTE DE LIGNE DE PRODUCTION;1;1;1;0;0;0;0;1;0;0;1;0;0;0
20329.0;2023;09;LILLE;MASCULIN;FORMATION CONTINUE;BAC PROFESSIONNEL;BAC PRO PROD;BAC PRO 22703 TECHN.INSTALL.SYST.ENERG.CLIMATI;10;10;9;1;0;0;0;9;0;4;1;4;0;1
20330.0;2023;09;LILLE;MASCULIN;FORMATION CONTINUE;BAC PROFESSIONNEL;BAC PRO PROD;BAC PRO 22704 TECHN. MAINT. SYST.ENERG.CLIMATI;4;4;2;1;1;1;0;3;0;1;1;0;1;1
20334.0;2023;09;LILLE;MASCULIN;FORMATION CONTINUE;BAC PROFESSIONNEL;BAC PRO SERV;BAC PRO 30004 ASSISTANC.GEST.ORGANIS.ACTIVITES;3;3;2;1;0;0;0;2;0;0;1;1;0;1
20336.0;2023;09;LILLE;MASCULIN;FORMATION CONTINUE;BAC PROFESSIONNEL;BAC PRO SERV;BAC PRO 34403 METIERS DE LA SECURITE;1;1;1;0;0;0;0;1;0;0;0;0;1;0
20339.0;2023;09;LILLE;MASCULIN;INDIVIDUEL;BAC PROFESSIONNEL;BAC PRO PROD;BAC PRO 22703 TECHN.INSTALL.SYST.ENERG.CLIMATI;1;1;1;0;0;0;0;1;0;0;0;0;1;0
20345.0;2023;09;LILLE;MASCULIN;INDIVIDUEL;BAC PROFESSIONNEL;BAC PRO PROD;BAC PRO 25214 MAINT.VEHIC.OPTA VOIT.PARTICUL.;3;2;1;1;0;0;0;1;0;0;0;1;0;1
20348.0;2023;09;LILLE;MASCULIN;INDIVIDUEL;BAC PROFESSIONNEL;BAC PRO PROD;BAC PRO 25515 SYST.NUM.OPT.C RES.INF.SYST.COMM.;2;1;1;0;0;0;0;1;0;0;0;0;1;0
20353.0;2023;09;LILLE;MASCULIN;INDIVIDUEL;BAC PROFESSIONNEL;BAC PRO SERV;BAC PRO 31212 METIERS DE L'ACCUEIL;1;1;0;1;0;0;0;0;0;0;0;0;0;1
20357.0;2023;09;LILLE;MASCULIN;INDIVIDUEL;BAC PROFESSIONNEL;BAC PRO SERV;BAC PRO 33002 SERVICES DE PROXIMITE  VIE LOCAL;1;0;0;0;0;0;0;0;0;0;0;0;0;0
20364.0;2023;09;LILLE;MASCULIN;INDIVIDUEL;BAC TECHNOLOGIQUE;BAC STI2D;BAC STI2D SYSTÈME D'INFORMATION  ET NUMERIQUE;4;4;0;3;1;0;1;0;0;0;0;0;0;4
20365.0;2023;09;LILLE;MASCULIN;INDIVIDUEL;BAC TECHNOLOGIQUE;BAC STL;BAC STL BIOCHIM.-BIOLOGIE-BIOTECHNOL.;1;1;0;0;1;1;0;1;0;0;0;0;1;0
20366.0;2023;09;LILLE;MASCULIN;INDIVIDUEL;BAC TECHNOLOGIQUE;BAC STL;BAC STL SCIENCES PHYSIQUES CHIMIQUES  EN LABORAT.;1;1;0;1;0;0;0;0;0;0;0;0;0;1
20372.0;2023;09;LILLE;MASCULIN;SCOLAIRE;BAC PROFESSIONNEL;BAC PRO PROD;BACPRO 20002 ETUD.DEFINITION PRDTS INDUSTRIEL;19;19;14;5;0;0;0;14;0;2;1;5;6;5
20375.0;2023;09;LILLE;MASCULIN;SCOLAIRE;BAC PROFESSIONNEL;BAC PRO PROD;BAC PRO 22104 BOUCHER CHARCUTIER TRAITEUR;3;3;2;1;0;0;0;2;0;0;1;0;1;1
20381.0;2023;09;LILLE;MASCULIN;SCOLAIRE;BAC PROFESSIONNEL;BAC PRO PROD;BAC PRO 22703 TECHN.INSTALL.SYST.ENERG.CLIMATI;100;100;63;30;7;5;2;68;0;1;15;20;32;32
20384.0;2023;09;LILLE;MASCULIN;SCOLAIRE;BAC PROFESSIONNEL;BAC PRO PROD;BAC PRO 23004 TECHN. ETUDES BAT.A ETUDES & ECO.;48;48;35;13;0;0;0;35;0;2;6;11;16;13
20387.0;2023;09;LILLE;MASCULIN;SCOLAIRE;BAC PROFESSIONNEL;BAC PRO PROD;BACPRO 23103 TECHNICIEN GEOMETRE-TOPOGRAPHE;13;13;9;4;0;0;0;9;0;0;1;3;5;4
20394.0;2023;09;LILLE;MASCULIN;SCOLAIRE;BAC PROFESSIONNEL;BAC PRO PROD;BAC PRO 23407 TECHNIC.FAB.BOIS ET MATERX ASSOC;68;68;45;21;2;1;1;46;0;3;11;13;19;22
20399.0;2023;09;LILLE;MASCULIN;SCOLAIRE;BAC PROFESSIONNEL;BAC PRO PROD;BAC PRO 25106 TECHNICIEN D'USINAGE;92;92;72;15;5;3;2;75;0;5;14;26;30;17
20401.0;2023;09;LILLE;MASCULIN;SCOLAIRE;BAC PROFESSIONNEL;BAC PRO PROD;BAC PRO 25215 MAINT.VEHIC.OPTB VEHIC.TRANS.ROUT;36;36;24;8;4;4;0;28;0;3;8;7;10;8
20409.0;2023;09;LILLE;MASCULIN;SCOLAIRE;BAC PROFESSIONNEL;BAC PRO PROD;BAC PRO 25411 TECH.CHAUDRONNERIE INDUSTRIELLE;128;128;96;26;6;5;1;101;0;8;21;35;37;27
20419.0;2023;09;LILLE;MASCULIN;SCOLAIRE;BAC PROFESSIONNEL;BAC PRO PROD;BAC PRO AG 21204 PROD-AQUACOLES;9;9;7;2;0;0;0;7;0;0;0;3;4;2
20420.0;2023;09;LILLE;MASCULIN;SCOLAIRE;BAC PROFESSIONNEL;BAC PRO PROD;BAC PRO AG 21210 COND GEST ENTR CANIN ET FELIN;5;5;5;0;0;0;0;5;0;0;0;1;4;0
20426.0;2023;09;LILLE;MASCULIN;SCOLAIRE;BAC PROFESSIONNEL;BAC PRO PROD;BAC PRO AG 22105 LABORATOIRE CONTROLE QUALITE;17;17;17;0;0;0;0;17;0;0;7;5;5;0
20428.0;2023;09;LILLE;MASCULIN;SCOLAIRE;BAC PROFESSIONNEL;BAC PRO SERV;BAC PRO 30004 ASSISTANC.GEST.ORGANIS.ACTIVITES;279;278;193;71;14;13;1;206;0;8;37;60;101;72
20429.0;2023;09;LILLE;MASCULIN;SCOLAIRE;BAC PROFESSIONNEL;BAC PRO SERV;BAC PRO 31106 LOGISTIQUE;142;142;104;30;8;6;2;110;0;3;20;33;54;32
20430.0;2023;09;LILLE;MASCULIN;SCOLAIRE;BAC PROFESSIONNEL;BAC PRO SERV;BAC PRO 31107 CONDUCT. TRANSP.ROUT.MARCHANDISES;129;129;116;11;2;2;0;118;0;11;31;50;26;11
20434.0;2023;09;LILLE;MASCULIN;SCOLAIRE;BAC PROFESSIONNEL;BAC PRO SERV;BAC PRO 31213 MET.COM.VEN.OP.A ANI.GES.ESP.COM.;969;954;704;197;53;34;19;738;0;24;119;268;327;216
20438.0;2023;09;LILLE;MASCULIN;SCOLAIRE;BAC PROFESSIONNEL;BAC PRO SERV;BAC PRO 32303 ART.& MET.ART:COM.VIS.VIS.PLURI-M;79;79;66;13;0;0;0;66;0;3;15;21;27;13
20440.0;2023;09;LILLE;MASCULIN;SCOLAIRE;BAC PROFESSIONNEL;BAC PRO SERV;BAC PRO 33003 ACC.SOINS-S.PERS. OPT.A DOMICILE;22;22;19;3;0;0;0;19;0;0;2;8;9;3
20445.0;2023;09;LILLE;MASCULIN;SCOLAIRE;BAC PROFESSIONNEL;BAC PRO SERV;BAC PRO 33104 TECHNICIEN EN PROTHESE DENTAIRE;7;7;5;1;1;1;0;6;0;0;3;2;1;1
20449.0;2023;09;LILLE;MASCULIN;SCOLAIRE;BAC PROFESSIONNEL;BAC PRO SERV;BAC PRO 34304 HYGIENE PROPRETE STERILISATION;11;11;10;0;1;1;0;11;0;0;5;1;5;0
20457.0;2023;09;LILLE;MASCULIN;SCOLAIRE;BAC TECHNOLOGIQUE;BAC STI2D;BAC STI2D ARCHITECTURE ET CONSTRUCTION;284;284;220;17;47;38;9;258;1;9;33;60;155;26
20459.0;2023;09;LILLE;MASCULIN;SCOLAIRE;BAC TECHNOLOGIQUE;BAC STI2D;BAC STI2D INNOVATION TECHNO.  ET ECO CONCEPTION;364;364;303;19;42;33;9;336;0;14;43;116;163;28
20468.0;2023;22;LIMOGES;FEMININ;APPRENTISSAGE;BAC PROFESSIONNEL;BAC PRO PROD;BAC PRO 25214 MAINT.VEHIC.OPTA VOIT.PARTICUL.;1;1;1;0;0;0;0;1;0;0;0;1;0;0
20501.0;2023;22;LIMOGES;FEMININ;SCOLAIRE;BAC PROFESSIONNEL;BAC PRO PROD;BAC PRO 22004 PROC. CHIMIE EAU PAPIERS-CARTONS;4;4;2;2;0;0;0;2;0;0;0;1;1;2
20506.0;2023;22;LIMOGES;FEMININ;SCOLAIRE;BAC PROFESSIONNEL;BAC PRO PROD;BAC PRO 23405 TECHNICIEN MENUISIER AGENCEUR;2;2;2;0;0;0;0;2;0;0;0;1;1;0
20511.0;2023;22;LIMOGES;FEMININ;SCOLAIRE;BAC PROFESSIONNEL;BAC PRO PROD;BAC PRO 25219 MAINT.MATERIELS OPT.A AGRICOLES;1;1;1;0;0;0;0;1;0;0;1;0;0;0
20513.0;2023;22;LIMOGES;FEMININ;SCOLAIRE;BAC PROFESSIONNEL;BAC PRO PROD;BAC PRO 25514 SYST.NUM.OPT.B AUD.RES.EQUIP.DOM.;2;2;2;0;0;0;0;2;0;0;1;1;0;0
20517.0;2023;22;LIMOGES;FEMININ;SCOLAIRE;BAC PROFESSIONNEL;BAC PRO PROD;BAC PRO AG 21203 TECHN CONSEIL DE VENTE ANIMAL;36;33;24;9;0;0;0;24;0;0;5;6;13;9
20523.0;2023;22;LIMOGES;FEMININ;SCOLAIRE;BAC PROFESSIONNEL;BAC PRO SERV;BAC PRO 31107 CONDUCT. TRANSP.ROUT.MARCHANDISES;1;1;1;0;0;0;0;1;0;0;0;1;0;0
20526.0;2023;22;LIMOGES;FEMININ;SCOLAIRE;BAC PROFESSIONNEL;BAC PRO SERV;BAC PRO 31213 MET.COM.VEN.OP.A ANI.GES.ESP.COM.;40;39;29;5;5;4;1;33;0;1;6;10;16;6
20528.0;2023;22;LIMOGES;FEMININ;SCOLAIRE;BAC PROFESSIONNEL;BAC PRO SERV;BAC PRO 32207 REAL.PR.IMPR.PLURI.OPTA.PR.GRAPH.;5;5;5;0;0;0;0;5;0;0;1;1;3;0
20536.0;2023;22;LIMOGES;FEMININ;SCOLAIRE;BAC PROFESSIONNEL;BAC PRO SERV;BAC PRO 33603 ESTHETIQUE COSMETIQUE PARFUMERIE;42;42;36;5;1;1;0;37;0;0;7;16;14;5
20538.0;2023;22;LIMOGES;FEMININ;SCOLAIRE;BAC PROFESSIONNEL;BAC PRO SERV;BAC PRO 34304 HYGIENE PROPRETE STERILISATION;6;6;4;2;0;0;0;4;0;0;0;2;2;2
20540.0;2023;22;LIMOGES;FEMININ;SCOLAIRE;BAC PROFESSIONNEL;BAC PRO SERV;BAC PRO AG 33002 SERV PERS TERRIT;92;91;76;15;0;0;0;76;0;0;12;21;43;15
20546.0;2023;22;LIMOGES;FEMININ;SCOLAIRE;BAC TECHNOLOGIQUE;BAC STI2D;BAC STI2D ENERGIES  ET ENVIRONNEMENT;5;5;4;0;1;0;1;4;0;0;1;1;2;1
20553.0;2023;22;LIMOGES;FEMININ;SCOLAIRE;BAC TECHNOLOGIQUE;BAC STMG;BAC STMG SYSTEMES D'INFORMATION DE GESTION;8;8;4;1;3;2;1;6;0;0;0;0;6;2
20557.0;2023;22;LIMOGES;MASCULIN;APPRENTISSAGE;BAC PROFESSIONNEL;BAC PRO PROD;BAC PRO 23102 TRAVAUX PUBLICS;23;23;23;0;0;0;0;23;0;2;6;11;4;0
20562.0;2023;22;LIMOGES;MASCULIN;APPRENTISSAGE;BAC PROFESSIONNEL;BAC PRO PROD;BAC PRO 23404 TECHNICIEN CONSTRUCTEUR BOIS;2;1;1;0;0;0;0;1;0;0;0;0;1;0
20564.0;2023;22;LIMOGES;MASCULIN;APPRENTISSAGE;BAC PROFESSIONNEL;BAC PRO PROD;BAC PRO 23407 TECHNIC.FAB.BOIS ET MATERX ASSOC;5;5;5;0;0;0;0;5;0;0;2;3;0;0
20567.0;2023;22;LIMOGES;MASCULIN;APPRENTISSAGE;BAC PROFESSIONNEL;BAC PRO PROD;BAC PRO 25107 TECHNICIEN OUTILLEUR;1;1;0;1;0;0;0;0;0;0;0;0;0;1
20571.0;2023;22;LIMOGES;MASCULIN;APPRENTISSAGE;BAC PROFESSIONNEL;BAC PRO PROD;BAC PRO 25219 MAINT.MATERIELS OPT.A AGRICOLES;7;7;7;0;0;0;0;7;0;1;4;1;1;0
20572.0;2023;22;LIMOGES;MASCULIN;APPRENTISSAGE;BAC PROFESSIONNEL;BAC PRO PROD;BAC PRO 25220 MAINT.MATERIELS OPT.B TP MANUT.;2;2;1;0;1;1;0;2;0;0;1;0;1;0
20579.0;2023;22;LIMOGES;MASCULIN;APPRENTISSAGE;BAC PROFESSIONNEL;BAC PRO PROD;BAC PRO AG 21004 CGEA;22;22;17;5;0;0;0;17;0;2;0;4;11;5
20580.0;2023;22;LIMOGES;MASCULIN;APPRENTISSAGE;BAC PROFESSIONNEL;BAC PRO PROD;BAC PRO AG 21211 COND GEST ENTR HIPPIQUE;1;1;1;0;0;0;0;1;0;0;0;1;0;0
20586.0;2023;22;LIMOGES;MASCULIN;APPRENTISSAGE;BAC PROFESSIONNEL;BAC PRO SERV;BAC PRO 33403 COMMERC. SERVICES EN RESTAURATION;1;1;1;0;0;0;0;1;0;0;0;0;1;0
20590.0;2023;22;LIMOGES;MASCULIN;FORMATION CONTINUE;BAC PROFESSIONNEL;BAC PRO PROD;BAC PRO 25214 MAINT.VEHIC.OPTA VOIT.PARTICUL.;1;1;1;0;0;0;0;1;0;1;0;0;0;0
20592.0;2023;22;LIMOGES;MASCULIN;FORMATION CONTINUE;BAC PROFESSIONNEL;BAC PRO SERV;BAC PRO 30004 ASSISTANC.GEST.ORGANIS.ACTIVITES;1;0;0;0;0;0;0;0;0;0;0;0;0;0
20595.0;2023;22;LIMOGES;MASCULIN;INDIVIDUEL;BAC PROFESSIONNEL;BAC PRO PROD;BAC PRO 25220 MAINT.MATERIELS OPT.B TP MANUT.;1;0;0;0;0;0;0;0;0;0;0;0;0;0
20603.0;2023;22;LIMOGES;MASCULIN;INDIVIDUEL;BAC TECHNOLOGIQUE;BAC ST2S;BAC ST2S SCIENCES & TECHNO. SANTE & SOCIAL;1;1;0;0;1;1;0;1;0;0;0;0;1;0
20606.0;2023;22;LIMOGES;MASCULIN;INDIVIDUEL;BAC TECHNOLOGIQUE;BAC STMG;BAC STMG RESSOURCES HUMAINES ET COMMUNICATION;1;1;0;1;0;0;0;0;0;0;0;0;0;1
20616.0;2023;22;LIMOGES;MASCULIN;SCOLAIRE;BAC PROFESSIONNEL;BAC PRO PROD;BAC PRO 23102 TRAVAUX PUBLICS;114;114;108;2;4;4;0;112;0;12;41;43;16;2
20618.0;2023;22;LIMOGES;MASCULIN;SCOLAIRE;BAC PROFESSIONNEL;BAC PRO PROD;BAC PRO 23304 AMENAGEMENT FINITION BATIMENT;7;7;6;0;1;0;1;6;0;0;3;2;1;1
20623.0;2023;22;LIMOGES;MASCULIN;SCOLAIRE;BAC PROFESSIONNEL;BAC PRO PROD;BAC PRO 25007 MAINTENANCE EQUIPEMENTS INDUST.;44;44;28;14;2;1;1;29;0;1;2;12;14;15
20629.0;2023;22;LIMOGES;MASCULIN;SCOLAIRE;BAC PROFESSIONNEL;BAC PRO PROD;BAC PRO 25216 MAINT.VEHIC.OPTC MOTOCYCLES;3;3;3;0;0;0;0;3;0;0;1;0;2;0
20630.0;2023;22;LIMOGES;MASCULIN;SCOLAIRE;BAC PROFESSIONNEL;BAC PRO PROD;BAC PRO 25219 MAINT.MATERIELS OPT.A AGRICOLES;27;27;24;1;2;2;0;26;0;4;8;5;9;1
20642.0;2023;22;LIMOGES;MASCULIN;SCOLAIRE;BAC PROFESSIONNEL;BAC PRO PROD;BAC PRO AG 21114 CONDUITE PRODUCTIONS HORTICOLES;1;1;1;0;0;0;0;1;0;0;0;1;0;0
20643.0;2023;22;LIMOGES;MASCULIN;SCOLAIRE;BAC PROFESSIONNEL;BAC PRO PROD;BAC PRO AG 21203 TECHN CONSEIL DE VENTE ANIMAL;18;18;14;4;0;0;0;14;0;0;0;8;6;4
20646.0;2023;22;LIMOGES;MASCULIN;SCOLAIRE;BAC PROFESSIONNEL;BAC PRO PROD;BAC PRO AG 21303 FORET;28;28;25;3;0;0;0;25;0;1;6;11;7;3
20650.0;2023;22;LIMOGES;MASCULIN;SCOLAIRE;BAC PROFESSIONNEL;BAC PRO SERV;BAC PRO 31106 LOGISTIQUE;21;21;12;5;4;3;1;15;0;1;2;3;9;6
20651.0;2023;22;LIMOGES;MASCULIN;SCOLAIRE;BAC PROFESSIONNEL;BAC PRO SERV;BAC PRO 31107 CONDUCT. TRANSP.ROUT.MARCHANDISES;21;21;14;7;0;0;0;14;0;0;4;6;4;7
20653.0;2023;22;LIMOGES;MASCULIN;SCOLAIRE;BAC PROFESSIONNEL;BAC PRO SERV;BAC PRO 31212 METIERS DE L'ACCUEIL;4;4;2;1;1;0;1;2;0;0;1;0;1;2
20655.0;2023;22;LIMOGES;MASCULIN;SCOLAIRE;BAC PROFESSIONNEL;BAC PRO SERV;BAC PRO 31214 MET.COM.VEN.OP.B PR.CL.VA.OF.COM.;23;23;16;5;2;1;1;17;0;0;1;8;8;6
20659.0;2023;22;LIMOGES;MASCULIN;SCOLAIRE;BAC PROFESSIONNEL;BAC PRO SERV;BAC PRO 33003 ACC.SOINS-S.PERS. OPT.A DOMICILE;6;6;6;0;0;0;0;6;0;0;3;2;1;0
20660.0;2023;22;LIMOGES;MASCULIN;SCOLAIRE;BAC PROFESSIONNEL;BAC PRO SERV;BAC PRO 33004 ACC.SOINS-S.PERS. OPT.EN STRUCTUR;8;8;5;2;1;0;1;5;0;0;0;3;2;3
20663.0;2023;22;LIMOGES;MASCULIN;SCOLAIRE;BAC PROFESSIONNEL;BAC PRO SERV;BAC PRO 33403 COMMERC. SERVICES EN RESTAURATION;14;14;13;1;0;0;0;13;0;1;1;2;9;1
20664.0;2023;22;LIMOGES;MASCULIN;SCOLAIRE;BAC PROFESSIONNEL;BAC PRO SERV;BAC PRO 33603 ESTHETIQUE COSMETIQUE PARFUMERIE;2;2;2;0;0;0;0;2;0;0;0;1;1;0
20669.0;2023;22;LIMOGES;MASCULIN;SCOLAIRE;BAC TECHNOLOGIQUE;BAC STAV;BAC STAV AGRONOMIE ALIM ENV TERRITOI;51;51;49;2;0;0;0;49;0;0;9;18;22;2
20670.0;2023;22;LIMOGES;MASCULIN;SCOLAIRE;BAC TECHNOLOGIQUE;BAC STD2A;BAC STD2A SCIENCES & TECHNO. DESIGN-ARTS APPLIQUES;10;10;10;0;0;0;0;10;0;2;3;4;1;0
20675.0;2023;22;LIMOGES;MASCULIN;SCOLAIRE;BAC TECHNOLOGIQUE;BAC STI2D;BAC STI2D SYSTÈME D'INFORMATION  ET NUMERIQUE;77;77;64;3;10;6;4;70;0;1;5;24;40;7
20687.0;2023;10;LYON;FEMININ;APPRENTISSAGE;BAC PROFESSIONNEL;BAC PRO PROD;BAC PRO 22703 TECHN.INSTALL.SYST.ENERG.CLIMATI;1;1;1;0;0;0;0;1;0;0;1;0;0;0
20692.0;2023;10;LYON;FEMININ;APPRENTISSAGE;BAC PROFESSIONNEL;BAC PRO PROD;BAC PRO 24302 METIERS DU CUIR : MAROQUINERIE;6;6;6;0;0;0;0;6;0;1;2;2;1;0
20702.0;2023;10;LYON;FEMININ;APPRENTISSAGE;BAC PROFESSIONNEL;BAC PRO PROD;BAC PRO AG 21004 CGEA;12;12;10;2;0;0;0;10;0;0;0;7;3;2
20703.0;2023;10;LYON;FEMININ;APPRENTISSAGE;BAC PROFESSIONNEL;BAC PRO PROD;BAC PRO AG 21114 CONDUITE PRODUCTIONS HORTICOLES;4;4;4;0;0;0;0;4;0;0;0;1;3;0
20704.0;2023;10;LYON;FEMININ;APPRENTISSAGE;BAC PROFESSIONNEL;BAC PRO PROD;BAC PRO AG 21203 TECHN CONSEIL DE VENTE ANIMAL;4;4;3;1;0;0;0;3;0;0;1;0;2;1
20719.0;2023;10;LYON;FEMININ;APPRENTISSAGE;BAC PROFESSIONNEL;BAC PRO SERV;BAC PRO 33403 COMMERC. SERVICES EN RESTAURATION;9;9;8;0;1;1;0;9;0;0;1;3;5;0
20725.0;2023;10;LYON;FEMININ;ENSEIGNEMENT A DISTANCE;BAC TECHNOLOGIQUE;BAC ST2S;BAC ST2S SCIENCES & TECHNO. SANTE & SOCIAL;1;1;0;1;0;0;0;0;0;0;0;0;0;1
20729.0;2023;10;LYON;FEMININ;FORMATION CONTINUE;BAC PROFESSIONNEL;BAC PRO PROD;BAC PRO 22004 PROC. CHIMIE EAU PAPIERS-CARTONS;1;1;1;0;0;0;0;1;0;0;0;1;0;0
20734.0;2023;10;LYON;FEMININ;INDIVIDUEL;BAC GENERAL;BAC GENERAL;BAC GENE 10019 BAC GENERAL;137;135;44;72;19;11;8;55;1;1;5;14;34;80
20738.0;2023;10;LYON;FEMININ;INDIVIDUEL;BAC PROFESSIONNEL;BAC PRO PROD;BAC PRO AG 21211 COND GEST ENTR HIPPIQUE;5;4;4;0;0;0;0;4;0;0;0;0;4;0
20742.0;2023;10;LYON;FEMININ;INDIVIDUEL;BAC PROFESSIONNEL;BAC PRO SERV;BAC PRO 31212 METIERS DE L'ACCUEIL;1;0;0;0;0;0;0;0;0;0;0;0;0;0
20749.0;2023;10;LYON;FEMININ;INDIVIDUEL;BAC PROFESSIONNEL;BAC PRO SERV;BAC PRO AG 33002 SERV PERS TERRIT;1;1;0;1;0;0;0;0;0;0;0;0;0;1
20750.0;2023;10;LYON;FEMININ;INDIVIDUEL;BAC TECHNOLOGIQUE;BAC ST2S;BAC ST2S SCIENCES & TECHNO. SANTE & SOCIAL;26;26;13;9;4;4;0;17;0;0;3;5;9;9
20753.0;2023;10;LYON;FEMININ;INDIVIDUEL;BAC TECHNOLOGIQUE;BAC STL;BAC STL SCIENCES PHYSIQUES CHIMIQUES  EN LABORAT.;1;1;0;1;0;0;0;0;0;0;0;0;0;1
20754.0;2023;10;LYON;FEMININ;INDIVIDUEL;BAC TECHNOLOGIQUE;BAC STMG;BAC STMG GESTION ET FINANCE;10;10;2;6;2;1;1;3;0;0;1;0;2;7
20758.0;2023;10;LYON;FEMININ;SCOLAIRE;BAC PROFESSIONNEL;BAC PRO PROD;BACPRO 20002 ETUD.DEFINITION PRDTS INDUSTRIEL;4;4;4;0;0;0;0;4;0;0;1;2;1;0
20763.0;2023;10;LYON;FEMININ;SCOLAIRE;BAC PROFESSIONNEL;BAC PRO PROD;BAC PRO 22105 BOULANGER-PÂTISSIER;19;19;18;0;1;1;0;19;0;5;4;5;5;0
20773.0;2023;10;LYON;FEMININ;SCOLAIRE;BAC PROFESSIONNEL;BAC PRO PROD;BAC PRO 23406 TECHNICIEN DE SCIERIE;1;1;1;0;0;0;0;1;0;1;0;0;0;0
20776.0;2023;10;LYON;FEMININ;SCOLAIRE;BAC PROFESSIONNEL;BAC PRO PROD;BAC PRO 24002 METIERS PRESSING BLANCHISSERIE;7;7;2;5;0;0;0;2;0;0;0;0;2;5
20787.0;2023;10;LYON;FEMININ;SCOLAIRE;BAC PROFESSIONNEL;BAC PRO PROD;BAC PRO 25510 METIERS ELECT. ENVIRON. CONNECTES;5;5;5;0;0;0;0;5;0;2;1;0;2;0
20790.0;2023;10;LYON;FEMININ;SCOLAIRE;BAC PROFESSIONNEL;BAC PRO PROD;BAC PRO 25515 SYST.NUM.OPT.C RES.INF.SYST.COMM.;9;9;8;1;0;0;0;8;0;1;1;4;2;1
20793.0;2023;10;LYON;FEMININ;SCOLAIRE;BAC PROFESSIONNEL;BAC PRO PROD;BAC PRO AG 21203 TECHN CONSEIL DE VENTE ANIMAL;42;42;34;8;0;0;0;34;0;2;2;10;20;8
20794.0;2023;10;LYON;FEMININ;SCOLAIRE;BAC PROFESSIONNEL;BAC PRO PROD;BAC PRO AG 21210 COND GEST ENTR CANIN ET FELIN;36;36;32;4;0;0;0;32;0;0;4;17;11;4
20795.0;2023;10;LYON;FEMININ;SCOLAIRE;BAC PROFESSIONNEL;BAC PRO PROD;BAC PRO AG 21211 COND GEST ENTR HIPPIQUE;62;62;58;4;0;0;0;58;0;2;6;21;29;4
20797.0;2023;10;LYON;FEMININ;SCOLAIRE;BAC PROFESSIONNEL;BAC PRO PROD;BAC PRO AG 21302 GEST MILIEUX NATURELS FAUNE;14;14;14;0;0;0;0;14;0;1;0;7;6;0
20798.0;2023;10;LYON;FEMININ;SCOLAIRE;BAC PROFESSIONNEL;BAC PRO PROD;BAC PRO AG 21405 AMENAGEMENTS PAYSAGERS;6;6;6;0;0;0;0;6;0;0;1;1;4;0
20799.0;2023;10;LYON;FEMININ;SCOLAIRE;BAC PROFESSIONNEL;BAC PRO PROD;BAC PRO AG 21407 TEC CONS VTE UNIVERS JARDINERIE;9;9;5;4;0;0;0;5;0;0;0;1;4;4
20806.0;2023;10;LYON;FEMININ;SCOLAIRE;BAC PROFESSIONNEL;BAC PRO SERV;BAC PRO 31212 METIERS DE L'ACCUEIL;206;206;163;19;24;19;5;182;0;6;33;67;76;24
20813.0;2023;10;LYON;FEMININ;SCOLAIRE;BAC PROFESSIONNEL;BAC PRO SERV;BAC PRO 33002 SERVICES DE PROXIMITE  VIE LOCAL;1;1;0;1;0;0;0;0;0;0;0;0;0;1
20814.0;2023;10;LYON;FEMININ;SCOLAIRE;BAC PROFESSIONNEL;BAC PRO SERV;BAC PRO 33003 ACC.SOINS-S.PERS. OPT.A DOMICILE;78;78;59;13;6;6;0;65;0;0;10;27;28;13
20820.0;2023;10;LYON;FEMININ;SCOLAIRE;BAC PROFESSIONNEL;BAC PRO SERV;BAC PRO 33602 PERRUQUIER POSTICHEUR;7;7;7;0;0;0;0;7;0;1;4;2;0;0
20842.0;2023;10;LYON;MASCULIN;APPRENTISSAGE;BAC PROFESSIONNEL;BAC PRO PROD;BAC PRO 20102 PILOTE DE LIGNE DE PRODUCTION;11;11;9;1;1;0;1;9;0;2;1;3;3;2
20847.0;2023;10;LYON;MASCULIN;APPRENTISSAGE;BAC PROFESSIONNEL;BAC PRO PROD;BAC PRO 22403 ARTS.& MET.ART:MET.ENSEIGN SIGNA;4;4;4;0;0;0;0;4;0;0;0;3;1;0
20848.0;2023;10;LYON;MASCULIN;APPRENTISSAGE;BAC PROFESSIONNEL;BAC PRO PROD;BAC PRO 22503 PLASTIQUES ET COMPOSITES;8;8;7;1;0;0;0;7;0;0;2;2;3;1
20852.0;2023;10;LYON;MASCULIN;APPRENTISSAGE;BAC PROFESSIONNEL;BAC PRO PROD;BAC PRO 23102 TRAVAUX PUBLICS;21;21;18;2;1;1;0;19;0;2;6;9;2;2
20856.0;2023;10;LYON;MASCULIN;APPRENTISSAGE;BAC PROFESSIONNEL;BAC PRO PROD;BAC PRO 23303 MENUISERIE ALUMINIUM-VERRE;17;16;14;1;1;0;1;14;0;1;4;2;7;2
20858.0;2023;10;LYON;MASCULIN;APPRENTISSAGE;BAC PROFESSIONNEL;BAC PRO PROD;BAC PRO 23404 TECHNICIEN CONSTRUCTEUR BOIS;8;8;6;0;2;0;2;6;0;2;0;4;0;2
20860.0;2023;10;LYON;MASCULIN;APPRENTISSAGE;BAC PROFESSIONNEL;BAC PRO PROD;BAC PRO 23407 TECHNIC.FAB.BOIS ET MATERX ASSOC;6;6;6;0;0;0;0;6;0;0;2;1;3;0
20863.0;2023;10;LYON;MASCULIN;APPRENTISSAGE;BAC PROFESSIONNEL;BAC PRO PROD;BAC PRO 25006 MICROTECHNIQUES;1;1;1;0;0;0;0;1;0;0;0;0;1;0
20864.0;2023;10;LYON;MASCULIN;APPRENTISSAGE;BAC PROFESSIONNEL;BAC PRO PROD;BAC PRO 25007 MAINTENANCE EQUIPEMENTS INDUST.;48;48;43;4;1;0;1;43;0;6;9;15;13;5
20867.0;2023;10;LYON;MASCULIN;APPRENTISSAGE;BAC PROFESSIONNEL;BAC PRO PROD;BAC PRO 25214 MAINT.VEHIC.OPTA VOIT.PARTICUL.;160;159;137;14;8;3;5;140;0;12;45;50;33;19
20872.0;2023;10;LYON;MASCULIN;APPRENTISSAGE;BAC PROFESSIONNEL;BAC PRO PROD;BAC PRO 25221 MAINT.MATERIELS OPT.C ESP. VERTS;14;14;13;1;0;0;0;13;0;0;1;9;3;1
20876.0;2023;10;LYON;MASCULIN;APPRENTISSAGE;BAC PROFESSIONNEL;BAC PRO PROD;BAC PRO 25411 TECH.CHAUDRONNERIE INDUSTRIELLE;60;60;50;6;4;2;2;52;0;7;17;18;10;8
20882.0;2023;10;LYON;MASCULIN;APPRENTISSAGE;BAC PROFESSIONNEL;BAC PRO PROD;BAC PRO AG 21004 CGEA;56;55;43;12;0;0;0;43;0;1;10;19;13;12
20883.0;2023;10;LYON;MASCULIN;APPRENTISSAGE;BAC PROFESSIONNEL;BAC PRO PROD;BAC PRO AG 21113 CGEVV;7;7;5;2;0;0;0;5;0;0;2;1;2;2
20884.0;2023;10;LYON;MASCULIN;APPRENTISSAGE;BAC PROFESSIONNEL;BAC PRO PROD;BAC PRO AG 21114 CONDUITE PRODUCTIONS HORTICOLES;11;11;8;3;0;0;0;8;0;1;1;1;5;3
20886.0;2023;10;LYON;MASCULIN;APPRENTISSAGE;BAC PROFESSIONNEL;BAC PRO PROD;BAC PRO AG 21204 PROD-AQUACOLES;2;2;2;0;0;0;0;2;0;0;0;1;1;0
20892.0;2023;10;LYON;MASCULIN;APPRENTISSAGE;BAC PROFESSIONNEL;BAC PRO SERV;BAC PRO 30004 ASSISTANC.GEST.ORGANIS.ACTIVITES;5;5;4;1;0;0;0;4;0;2;0;2;0;1
20894.0;2023;10;LYON;MASCULIN;APPRENTISSAGE;BAC PROFESSIONNEL;BAC PRO SERV;BAC PRO 31212 METIERS DE L'ACCUEIL;11;11;9;1;1;1;0;10;0;2;1;5;2;1
20897.0;2023;10;LYON;MASCULIN;APPRENTISSAGE;BAC PROFESSIONNEL;BAC PRO SERV;BAC PRO 32207 REAL.PR.IMPR.PLURI.OPTA.PR.GRAPH.;1;1;1;0;0;0;0;1;0;0;0;1;0;0
20910.0;2023;10;LYON;MASCULIN;FORMATION CONTINUE;BAC PROFESSIONNEL;BAC PRO PROD;BAC PRO 25509 TECHNIC. FROID CONDITIONNEMT AIR;3;3;3;0;0;0;0;3;0;0;1;0;2;0
20919.0;2023;10;LYON;MASCULIN;INDIVIDUEL;BAC PROFESSIONNEL;BAC PRO PROD;BAC PRO 22106 CUISINE;1;1;0;1;0;0;0;0;0;0;0;0;0;1
20928.0;2023;10;LYON;MASCULIN;INDIVIDUEL;BAC PROFESSIONNEL;BAC PRO PROD;BAC PRO 25411 TECH.CHAUDRONNERIE INDUSTRIELLE;1;1;0;1;0;0;0;0;0;0;0;0;0;1
20929.0;2023;10;LYON;MASCULIN;INDIVIDUEL;BAC PROFESSIONNEL;BAC PRO PROD;BAC PRO 25509 TECHNIC. FROID CONDITIONNEMT AIR;1;1;0;1;0;0;0;0;0;0;0;0;0;1
20935.0;2023;10;LYON;MASCULIN;INDIVIDUEL;BAC PROFESSIONNEL;BAC PRO PROD;BAC PRO AG 21211 COND GEST ENTR HIPPIQUE;1;1;1;0;0;0;0;1;0;0;0;1;0;0
20940.0;2023;10;LYON;MASCULIN;INDIVIDUEL;BAC PROFESSIONNEL;BAC PRO SERV;BAC PRO 31213 MET.COM.VEN.OP.A ANI.GES.ESP.COM.;7;4;3;1;0;0;0;3;0;0;0;1;2;1
20955.0;2023;10;LYON;MASCULIN;INDIVIDUEL;BAC TECHNOLOGIQUE;BAC STMG;BAC STMG SYSTEMES D'INFORMATION DE GESTION;4;3;0;3;0;0;0;0;0;0;0;0;0;3
20958.0;2023;10;LYON;MASCULIN;SCOLAIRE;BAC PROFESSIONNEL;BAC PRO PROD;BAC PRO 20102 PILOTE DE LIGNE DE PRODUCTION;18;18;8;3;7;5;2;13;0;0;3;2;8;5
20959.0;2023;10;LYON;MASCULIN;SCOLAIRE;BAC PROFESSIONNEL;BAC PRO PROD;BAC PRO 22003 BIO-INDUSTRIES DE TRANSFORMATION;14;14;11;3;0;0;0;11;0;0;1;2;8;3
20967.0;2023;10;LYON;MASCULIN;SCOLAIRE;BAC PROFESSIONNEL;BAC PRO PROD;BAC PRO 22704 TECHN. MAINT. SYST.ENERG.CLIMATI;38;38;26;8;4;4;0;30;0;3;5;5;17;8
20969.0;2023;10;LYON;MASCULIN;SCOLAIRE;BAC PROFESSIONNEL;BAC PRO PROD;BAC PRO 23004 TECHN. ETUDES BAT.A ETUDES & ECO.;28;27;17;9;1;1;0;18;0;0;3;6;9;9
20971.0;2023;10;LYON;MASCULIN;SCOLAIRE;BAC PROFESSIONNEL;BAC PRO PROD;BAC PRO 23102 TRAVAUX PUBLICS;8;8;6;2;0;0;0;6;0;0;3;0;3;2
20976.0;2023;10;LYON;MASCULIN;SCOLAIRE;BAC PROFESSIONNEL;BAC PRO PROD;BAC PRO 23404 TECHNICIEN CONSTRUCTEUR BOIS;33;33;24;8;1;1;0;25;0;1;5;6;13;8
20979.0;2023;10;LYON;MASCULIN;SCOLAIRE;BAC PROFESSIONNEL;BAC PRO PROD;BAC PRO 23407 TECHNIC.FAB.BOIS ET MATERX ASSOC;11;11;8;1;2;2;0;10;0;0;2;5;3;1
20981.0;2023;10;LYON;MASCULIN;SCOLAIRE;BAC PROFESSIONNEL;BAC PRO PROD;BAC PRO 24002 METIERS PRESSING BLANCHISSERIE;3;3;0;2;1;1;0;1;0;0;0;0;1;2
20986.0;2023;10;LYON;MASCULIN;SCOLAIRE;BAC PROFESSIONNEL;BAC PRO PROD;BAC PRO 25006 MICROTECHNIQUES;25;25;18;4;3;3;0;21;0;3;5;7;6;4
20988.0;2023;10;LYON;MASCULIN;SCOLAIRE;BAC PROFESSIONNEL;BAC PRO PROD;BAC PRO 25106 TECHNICIEN D'USINAGE;132;129;94;30;5;2;3;96;0;7;20;37;32;33
20993.0;2023;10;LYON;MASCULIN;SCOLAIRE;BAC PROFESSIONNEL;BAC PRO PROD;BAC PRO 25216 MAINT.VEHIC.OPTC MOTOCYCLES;35;34;31;2;1;1;0;32;0;2;10;16;4;2
20994.0;2023;10;LYON;MASCULIN;SCOLAIRE;BAC PROFESSIONNEL;BAC PRO PROD;BAC PRO 25219 MAINT.MATERIELS OPT.A AGRICOLES;28;28;23;4;1;0;1;23;0;2;7;12;2;5
20997.0;2023;10;LYON;MASCULIN;SCOLAIRE;BAC PROFESSIONNEL;BAC PRO PROD;BAC PRO 25408 REPARATION DES CARROSSERIES;64;64;32;26;6;4;2;36;0;2;8;11;15;28
21005.0;2023;10;LYON;MASCULIN;SCOLAIRE;BAC PROFESSIONNEL;BAC PRO PROD;BAC PRO AG 21001 AGRO-EQUIPEMENT;14;14;11;3;0;0;0;11;0;1;1;5;4;3
21009.0;2023;10;LYON;MASCULIN;SCOLAIRE;BAC PROFESSIONNEL;BAC PRO PROD;BAC PRO AG 21204 PROD-AQUACOLES;3;3;1;2;0;0;0;1;0;0;0;0;1;2
21013.0;2023;10;LYON;MASCULIN;SCOLAIRE;BAC PROFESSIONNEL;BAC PRO PROD;BAC PRO AG 21302 GEST MILIEUX NATURELS FAUNE;54;54;50;4;0;0;0;50;0;0;9;20;21;4
21016.0;2023;10;LYON;MASCULIN;SCOLAIRE;BAC PROFESSIONNEL;BAC PRO PROD;BAC PRO AG 21407 TEC CONS VTE UNIVERS JARDINERIE;4;4;2;2;0;0;0;2;0;0;0;0;2;2
21021.0;2023;10;LYON;MASCULIN;SCOLAIRE;BAC PROFESSIONNEL;BAC PRO SERV;BAC PRO 31107 CONDUCT. TRANSP.ROUT.MARCHANDISES;84;83;79;4;0;0;0;79;0;3;27;32;17;4
21024.0;2023;10;LYON;MASCULIN;SCOLAIRE;BAC PROFESSIONNEL;BAC PRO SERV;BAC PRO 31213 MET.COM.VEN.OP.A ANI.GES.ESP.COM.;380;378;297;61;20;15;5;312;0;9;68;108;127;66
21026.0;2023;10;LYON;MASCULIN;SCOLAIRE;BAC PROFESSIONNEL;BAC PRO SERV;BAC PRO 32207 REAL.PR.IMPR.PLURI.OPTA.PR.GRAPH.;28;28;22;5;1;0;1;22;0;3;3;9;7;6
21041.0;2023;10;LYON;MASCULIN;SCOLAIRE;BAC TECHNOLOGIQUE;BAC S2TMD;BAC S2TMD MUSIQUE;2;2;2;0;0;0;0;2;0;0;1;1;0;0
21051.0;2023;10;LYON;MASCULIN;SCOLAIRE;BAC TECHNOLOGIQUE;BAC STL;BAC STL SCIENCES PHYSIQUES CHIMIQUES  EN LABORAT.;72;72;66;1;5;3;2;69;1;3;18;29;18;3
21064.0;2023;31;MARTINIQUE;FEMININ;ENSEIGNEMENT A DISTANCE;BAC TECHNOLOGIQUE;BAC STMG;BAC STMG RESSOURCES HUMAINES ET COMMUNICATION;2;2;2;0;0;0;0;2;0;0;0;2;0;0
21070.0;2023;31;MARTINIQUE;FEMININ;INDIVIDUEL;BAC PROFESSIONNEL;BAC PRO SERV;BAC PRO 33003 ACC.SOINS-S.PERS. OPT.A DOMICILE;6;4;2;2;0;0;0;2;0;0;0;0;2;2
21074.0;2023;31;MARTINIQUE;FEMININ;INDIVIDUEL;BAC TECHNOLOGIQUE;BAC ST2S;BAC ST2S SCIENCES & TECHNO. SANTE & SOCIAL;2;2;0;2;0;0;0;0;0;0;0;0;0;2
21078.0;2023;31;MARTINIQUE;FEMININ;SCOLAIRE;BAC PROFESSIONNEL;BAC PRO PROD;BAC PRO 22004 PROC. CHIMIE EAU PAPIERS-CARTONS;1;1;1;0;0;0;0;1;0;0;0;1;0;0
21081.0;2023;31;MARTINIQUE;FEMININ;SCOLAIRE;BAC PROFESSIONNEL;BAC PRO PROD;BAC PRO 23003 ARTIS. & M.ART:MARCHANDISAGE VIS.;8;8;7;0;1;1;0;8;0;0;1;4;3;0
21086.0;2023;31;MARTINIQUE;FEMININ;SCOLAIRE;BAC PROFESSIONNEL;BAC PRO PROD;BAC PRO 24203 METIERS DE LA MODE - VÊTEMENT;17;17;10;4;3;3;0;13;0;0;4;1;8;4
21091.0;2023;31;MARTINIQUE;FEMININ;SCOLAIRE;BAC PROFESSIONNEL;BAC PRO PROD;BAC PRO 25514 SYST.NUM.OPT.B AUD.RES.EQUIP.DOM.;1;1;1;0;0;0;0;1;0;0;1;0;0;0
21098.0;2023;31;MARTINIQUE;FEMININ;SCOLAIRE;BAC PROFESSIONNEL;BAC PRO SERV;BAC PRO 31114 ORGANIS. TRANSPORT MARCHANDISES;4;4;3;0;1;1;0;4;0;0;0;1;3;0
21105.0;2023;31;MARTINIQUE;FEMININ;SCOLAIRE;BAC PROFESSIONNEL;BAC PRO SERV;BAC PRO 33004 ACC.SOINS-S.PERS. OPT.EN STRUCTUR;79;79;60;14;5;4;1;64;0;0;8;31;25;15
21107.0;2023;31;MARTINIQUE;FEMININ;SCOLAIRE;BAC PROFESSIONNEL;BAC PRO SERV;BAC PRO 33403 COMMERC. SERVICES EN RESTAURATION;15;15;14;1;0;0;0;14;0;0;2;7;5;1
21111.0;2023;31;MARTINIQUE;FEMININ;SCOLAIRE;BAC PROFESSIONNEL;BAC PRO SERV;BAC PRO 34304 HYGIENE PROPRETE STERILISATION;3;3;3;0;0;0;0;3;0;0;0;2;1;0
21119.0;2023;31;MARTINIQUE;FEMININ;SCOLAIRE;BAC TECHNOLOGIQUE;BAC STI2D;BAC STI2D ENERGIES  ET ENVIRONNEMENT;4;4;3;0;1;1;0;4;0;0;1;0;3;0
21120.0;2023;31;MARTINIQUE;FEMININ;SCOLAIRE;BAC TECHNOLOGIQUE;BAC STI2D;BAC STI2D SYSTÈME D'INFORMATION  ET NUMERIQUE;2;2;2;0;0;0;0;2;0;0;1;1;0;0
21128.0;2023;31;MARTINIQUE;MASCULIN;APPRENTISSAGE;BAC PROFESSIONNEL;BAC PRO PROD;BAC PRO 22703 TECHN.INSTALL.SYST.ENERG.CLIMATI;1;1;0;1;0;0;0;0;0;0;0;0;0;1
21132.0;2023;31;MARTINIQUE;MASCULIN;APPRENTISSAGE;BAC PROFESSIONNEL;BAC PRO PROD;BAC PRO 23404 TECHNICIEN CONSTRUCTEUR BOIS;2;2;0;2;0;0;0;0;0;0;0;0;0;2
21136.0;2023;31;MARTINIQUE;MASCULIN;APPRENTISSAGE;BAC PROFESSIONNEL;BAC PRO SERV;BAC PRO 31106 LOGISTIQUE;7;4;4;0;0;0;0;4;0;0;1;2;1;0
21142.0;2023;31;MARTINIQUE;MASCULIN;INDIVIDUEL;BAC GENERAL;BAC GENERAL;BAC GENE 10019 BAC GENERAL;3;2;1;1;0;0;0;1;0;0;0;0;1;1
21144.0;2023;31;MARTINIQUE;MASCULIN;INDIVIDUEL;BAC PROFESSIONNEL;BAC PRO PROD;BAC PRO 22704 TECHN. MAINT. SYST.ENERG.CLIMATI;2;1;0;1;0;0;0;0;0;0;0;0;0;1
21153.0;2023;31;MARTINIQUE;MASCULIN;SCOLAIRE;BAC PROFESSIONNEL;BAC PRO PROD;BAC PRO 22003 BIO-INDUSTRIES DE TRANSFORMATION;8;7;6;1;0;0;0;6;0;0;1;2;3;1
21154.0;2023;31;MARTINIQUE;MASCULIN;SCOLAIRE;BAC PROFESSIONNEL;BAC PRO PROD;BAC PRO 22004 PROC. CHIMIE EAU PAPIERS-CARTONS;8;8;4;3;1;1;0;5;0;0;0;3;2;3
21157.0;2023;31;MARTINIQUE;MASCULIN;SCOLAIRE;BAC PROFESSIONNEL;BAC PRO PROD;BAC PRO 22703 TECHN.INSTALL.SYST.ENERG.CLIMATI;11;11;8;3;0;0;0;8;0;0;1;4;3;3
21159.0;2023;31;MARTINIQUE;MASCULIN;SCOLAIRE;BAC PROFESSIONNEL;BAC PRO PROD;BAC PRO 23004 TECHN. ETUDES BAT.A ETUDES & ECO.;1;1;1;0;0;0;0;1;0;0;1;0;0;0
21163.0;2023;31;MARTINIQUE;MASCULIN;SCOLAIRE;BAC PROFESSIONNEL;BAC PRO PROD;BAC PRO 23203 TECHNICIEN BAT. : ORG.REAL.GROS O;8;7;6;0;1;1;0;7;0;0;0;5;2;0
21165.0;2023;31;MARTINIQUE;MASCULIN;SCOLAIRE;BAC PROFESSIONNEL;BAC PRO PROD;BAC PRO 23304 AMENAGEMENT FINITION BATIMENT;4;4;4;0;0;0;0;4;0;0;2;1;1;0
21173.0;2023;31;MARTINIQUE;MASCULIN;SCOLAIRE;BAC PROFESSIONNEL;BAC PRO PROD;BAC PRO 25214 MAINT.VEHIC.OPTA VOIT.PARTICUL.;75;75;50;16;9;9;0;59;0;1;4;17;37;16
21188.0;2023;31;MARTINIQUE;MASCULIN;SCOLAIRE;BAC PROFESSIONNEL;BAC PRO PROD;BAC PRO AG 22108 TEC CONS VTE ALIMENTATION (PAB);2;2;2;0;0;0;0;2;0;0;0;0;2;0
21189.0;2023;31;MARTINIQUE;MASCULIN;SCOLAIRE;BAC PROFESSIONNEL;BAC PRO SERV;BAC PRO 30004 ASSISTANC.GEST.ORGANIS.ACTIVITES;54;53;31;19;3;2;1;33;0;2;2;7;22;20
21192.0;2023;31;MARTINIQUE;MASCULIN;SCOLAIRE;BAC PROFESSIONNEL;BAC PRO SERV;BAC PRO 31212 METIERS DE L'ACCUEIL;9;9;6;1;2;2;0;8;0;0;1;1;6;1
21199.0;2023;31;MARTINIQUE;MASCULIN;SCOLAIRE;BAC PROFESSIONNEL;BAC PRO SERV;BAC PRO 33403 COMMERC. SERVICES EN RESTAURATION;18;18;17;1;0;0;0;17;0;2;4;5;6;1
21204.0;2023;31;MARTINIQUE;MASCULIN;SCOLAIRE;BAC PROFESSIONNEL;BAC PRO SERV;BAC PRO AG 33002 SERV PERS TERRIT;7;7;6;1;0;0;0;6;0;0;1;2;3;1
21206.0;2023;31;MARTINIQUE;MASCULIN;SCOLAIRE;BAC TECHNOLOGIQUE;BAC STAV;BAC STAV AGRONOMIE ALIM ENV TERRITOI;7;7;7;0;0;0;0;7;0;0;0;3;4;0
21211.0;2023;31;MARTINIQUE;MASCULIN;SCOLAIRE;BAC TECHNOLOGIQUE;BAC STI2D;BAC STI2D INNOVATION TECHNO.  ET ECO CONCEPTION;21;21;20;0;1;1;0;21;0;2;3;5;11;0
21213.0;2023;31;MARTINIQUE;MASCULIN;SCOLAIRE;BAC TECHNOLOGIQUE;BAC STL;BAC STL BIOCHIM.-BIOLOGIE-BIOTECHNOL.;10;10;6;1;3;2;1;8;0;0;0;3;5;2
21216.0;2023;31;MARTINIQUE;MASCULIN;SCOLAIRE;BAC TECHNOLOGIQUE;BAC STMG;BAC STMG RESSOURCES HUMAINES ET COMMUNICATION;51;51;35;2;14;13;1;48;0;0;4;8;36;3
21219.0;2023;43;MAYOTTE;FEMININ;APPRENTISSAGE;BAC PROFESSIONNEL;BAC PRO PROD;BAC PRO 25303 AERONAUTIQUE OPTION SYSTEMES;1;1;1;0;0;0;0;1;0;0;1;0;0;0
21224.0;2023;43;MAYOTTE;FEMININ;ENSEIGNEMENT A DISTANCE;BAC PROFESSIONNEL;BAC PRO SERV;BAC PRO 31212 METIERS DE L'ACCUEIL;1;1;0;1;0;0;0;0;0;0;0;0;0;1
21226.0;2023;43;MAYOTTE;FEMININ;INDIVIDUEL;BAC PROFESSIONNEL;BAC PRO PROD;BAC PRO 22106 CUISINE;1;1;0;0;1;0;1;0;0;0;0;0;0;1
21227.0;2023;43;MAYOTTE;FEMININ;INDIVIDUEL;BAC PROFESSIONNEL;BAC PRO SERV;BAC PRO 30004 ASSISTANC.GEST.ORGANIS.ACTIVITES;7;4;0;3;1;1;0;1;0;0;0;0;1;3
21237.0;2023;43;MAYOTTE;FEMININ;INDIVIDUEL;BAC TECHNOLOGIQUE;BAC STI2D;BAC STI2D SYSTÈME D'INFORMATION  ET NUMERIQUE;2;2;0;0;2;2;0;2;0;0;0;0;2;0
21238.0;2023;43;MAYOTTE;FEMININ;INDIVIDUEL;BAC TECHNOLOGIQUE;BAC STL;BAC STL SCIENCES PHYSIQUES CHIMIQUES  EN LABORAT.;2;2;0;1;1;0;1;0;0;0;0;0;0;2
21244.0;2023;43;MAYOTTE;FEMININ;SCOLAIRE;BAC PROFESSIONNEL;BAC PRO PROD;BAC PRO 23004 TECHN. ETUDES BAT.A ETUDES & ECO.;2;2;2;0;0;0;0;2;0;0;0;0;2;0
21245.0;2023;43;MAYOTTE;FEMININ;SCOLAIRE;BAC PROFESSIONNEL;BAC PRO PROD;BAC PRO 23005 TECHN. ETUDES BAT B ASSIST.ARCHI.;1;1;0;1;0;0;0;0;0;0;0;0;0;1
21252.0;2023;43;MAYOTTE;FEMININ;SCOLAIRE;BAC PROFESSIONNEL;BAC PRO PROD;BAC PRO 25009 MAINTENANCE NAUTIQUE;2;2;0;0;2;2;0;2;0;0;0;0;2;0
21256.0;2023;43;MAYOTTE;FEMININ;SCOLAIRE;BAC PROFESSIONNEL;BAC PRO PROD;BAC PRO 25513 SYST.NUM.OPT.A SURETE SECURITE;3;3;0;2;1;0;1;0;0;0;0;0;0;3
21274.0;2023;43;MAYOTTE;FEMININ;SCOLAIRE;BAC TECHNOLOGIQUE;BAC ST2S;BAC ST2S SCIENCES & TECHNO. SANTE & SOCIAL;158;158;115;11;32;22;10;137;0;3;11;41;82;21
21276.0;2023;43;MAYOTTE;FEMININ;SCOLAIRE;BAC TECHNOLOGIQUE;BAC STD2A;BAC STD2A SCIENCES & TECHNO. DESIGN-ARTS APPLIQUES;21;21;11;2;8;5;3;16;0;1;3;4;8;5
21288.0;2023;43;MAYOTTE;MASCULIN;APPRENTISSAGE;BAC PROFESSIONNEL;BAC PRO SERV;BAC PRO 31106 LOGISTIQUE;17;17;10;6;1;1;0;11;0;0;1;5;5;6
21293.0;2023;43;MAYOTTE;MASCULIN;INDIVIDUEL;BAC PROFESSIONNEL;BAC PRO PROD;BAC PRO 23102 TRAVAUX PUBLICS;1;1;0;0;1;0;1;0;0;0;0;0;0;1
21295.0;2023;43;MAYOTTE;MASCULIN;INDIVIDUEL;BAC PROFESSIONNEL;BAC PRO PROD;BAC PRO 23405 TECHNICIEN MENUISIER AGENCEUR;2;1;0;1;0;0;0;0;0;0;0;0;0;1
21296.0;2023;43;MAYOTTE;MASCULIN;INDIVIDUEL;BAC PROFESSIONNEL;BAC PRO PROD;BAC PRO 25007 MAINTENANCE EQUIPEMENTS INDUST.;1;1;1;0;0;0;0;1;0;0;0;0;1;0
21300.0;2023;43;MAYOTTE;MASCULIN;INDIVIDUEL;BAC PROFESSIONNEL;BAC PRO PROD;BAC PRO 25513 SYST.NUM.OPT.A SURETE SECURITE;1;1;1;0;0;0;0;1;0;0;0;0;1;0
21301.0;2023;43;MAYOTTE;MASCULIN;INDIVIDUEL;BAC PROFESSIONNEL;BAC PRO PROD;BAC PRO AG 21114 CONDUITE PRODUCTIONS HORTICOLES;1;0;0;0;0;0;0;0;0;0;0;0;0;0
21302.0;2023;43;MAYOTTE;MASCULIN;INDIVIDUEL;BAC PROFESSIONNEL;BAC PRO SERV;BAC PRO 31106 LOGISTIQUE;2;2;0;2;0;0;0;0;0;0;0;0;0;2
21306.0;2023;43;MAYOTTE;MASCULIN;INDIVIDUEL;BAC PROFESSIONNEL;BAC PRO SERV;BAC PRO 33002 SERVICES DE PROXIMITE  VIE LOCAL;8;7;0;6;1;1;0;1;0;0;0;0;1;6
21307.0;2023;43;MAYOTTE;MASCULIN;INDIVIDUEL;BAC PROFESSIONNEL;BAC PRO SERV;BAC PRO 34403 METIERS DE LA SECURITE;1;0;0;0;0;0;0;0;0;0;0;0;0;0
21308.0;2023;43;MAYOTTE;MASCULIN;INDIVIDUEL;BAC TECHNOLOGIQUE;BAC ST2S;BAC ST2S SCIENCES & TECHNO. SANTE & SOCIAL;2;2;0;2;0;0;0;0;0;0;0;0;0;2
21309.0;2023;43;MAYOTTE;MASCULIN;INDIVIDUEL;BAC TECHNOLOGIQUE;BAC STAV;BAC STAV AGRONOMIE ALIM ENV TERRITOI;1;0;0;0;0;0;0;0;0;0;0;0;0;0
21319.0;2023;43;MAYOTTE;MASCULIN;SCOLAIRE;BAC PROFESSIONNEL;BAC PRO PROD;BAC PRO 23005 TECHN. ETUDES BAT B ASSIST.ARCHI.;17;17;9;7;1;1;0;10;0;0;2;4;4;7
21328.0;2023;43;MAYOTTE;MASCULIN;SCOLAIRE;BAC PROFESSIONNEL;BAC PRO PROD;BAC PRO 25009 MAINTENANCE NAUTIQUE;29;28;4;18;6;3;3;7;0;0;0;2;5;21
21345.0;2023;43;MAYOTTE;MASCULIN;SCOLAIRE;BAC PROFESSIONNEL;BAC PRO SERV;BAC PRO 31214 MET.COM.VEN.OP.B PR.CL.VA.OF.COM.;46;44;23;14;7;5;2;28;0;0;1;8;19;16
21346.0;2023;43;MAYOTTE;MASCULIN;SCOLAIRE;BAC PROFESSIONNEL;BAC PRO SERV;BAC PRO 32303 ART.& MET.ART:COM.VIS.VIS.PLURI-M;11;11;6;4;1;1;0;7;0;0;0;3;4;4
21354.0;2023;43;MAYOTTE;MASCULIN;SCOLAIRE;BAC TECHNOLOGIQUE;BAC STAV;BAC STAV AGRONOMIE ALIM ENV TERRITOI;9;7;4;3;0;0;0;4;0;0;1;1;2;3
21358.0;2023;43;MAYOTTE;MASCULIN;SCOLAIRE;BAC TECHNOLOGIQUE;BAC STI2D;BAC STI2D ENERGIES  ET ENVIRONNEMENT;54;54;18;15;21;21;0;39;0;0;0;4;35;15
21364.0;2023;43;MAYOTTE;MASCULIN;SCOLAIRE;BAC TECHNOLOGIQUE;BAC STMG;BAC STMG RESSOURCES HUMAINES ET COMMUNICATION;163;163;64;32;67;58;9;122;0;0;0;17;105;41
21366.0;2023;11;MONTPELLIER;FEMININ;APPRENTISSAGE;BAC PROFESSIONNEL;BAC PRO PROD;BAC PRO 25007 MAINTENANCE EQUIPEMENTS INDUST.;1;1;1;0;0;0;0;1;0;0;0;1;0;0
21369.0;2023;11;MONTPELLIER;FEMININ;APPRENTISSAGE;BAC PROFESSIONNEL;BAC PRO PROD;BAC PRO 25408 REPARATION DES CARROSSERIES;3;3;3;0;0;0;0;3;0;0;1;2;0;0
21374.0;2023;11;MONTPELLIER;FEMININ;APPRENTISSAGE;BAC PROFESSIONNEL;BAC PRO PROD;BAC PRO AG 21203 TECHN CONSEIL DE VENTE ANIMAL;5;5;4;1;0;0;0;4;0;1;1;1;1;1
21377.0;2023;11;MONTPELLIER;FEMININ;APPRENTISSAGE;BAC PROFESSIONNEL;BAC PRO PROD;BAC PRO AG 22108 TEC CONS VTE ALIMENTATION (PAB);1;1;1;0;0;0;0;1;0;1;0;0;0;0
21380.0;2023;11;MONTPELLIER;FEMININ;APPRENTISSAGE;BAC PROFESSIONNEL;BAC PRO SERV;BAC PRO 31212 METIERS DE L'ACCUEIL;6;6;4;1;1;1;0;5;0;0;1;2;2;1
21387.0;2023;11;MONTPELLIER;FEMININ;APPRENTISSAGE;BAC PROFESSIONNEL;BAC PRO SERV;BAC PRO 33604 METIERS DE LA COIFFURE;1;1;1;0;0;0;0;1;0;0;0;1;0;0
21399.0;2023;11;MONTPELLIER;FEMININ;ENSEIGNEMENT A DISTANCE;BAC TECHNOLOGIQUE;BAC STMG;BAC STMG MERCATIQUE (MARKETING);17;17;13;2;2;1;1;14;0;0;2;4;8;3
21405.0;2023;11;MONTPELLIER;FEMININ;INDIVIDUEL;BAC PROFESSIONNEL;BAC PRO PROD;BAC PRO 22003 BIO-INDUSTRIES DE TRANSFORMATION;1;0;0;0;0;0;0;0;0;0;0;0;0;0
21424.0;2023;11;MONTPELLIER;FEMININ;INDIVIDUEL;BAC TECHNOLOGIQUE;BAC STMG;BAC STMG MERCATIQUE (MARKETING);26;26;9;13;4;2;2;11;0;0;0;5;6;15
21426.0;2023;11;MONTPELLIER;FEMININ;INDIVIDUEL;BAC TECHNOLOGIQUE;BAC STMG;BAC STMG SYSTEMES D'INFORMATION DE GESTION;1;1;1;0;0;0;0;1;0;0;1;0;0;0
21431.0;2023;11;MONTPELLIER;FEMININ;SCOLAIRE;BAC PROFESSIONNEL;BAC PRO PROD;BAC PRO 22105 BOULANGER-PÂTISSIER;22;22;20;2;0;0;0;20;0;2;8;6;4;2
21432.0;2023;11;MONTPELLIER;FEMININ;SCOLAIRE;BAC PROFESSIONNEL;BAC PRO PROD;BAC PRO 22106 CUISINE;55;55;48;6;1;0;1;48;0;5;10;18;15;7
21436.0;2023;11;MONTPELLIER;FEMININ;SCOLAIRE;BAC PROFESSIONNEL;BAC PRO PROD;BAC PRO 23003 ARTIS. & M.ART:MARCHANDISAGE VIS.;11;11;11;0;0;0;0;11;0;0;3;5;3;0
21437.0;2023;11;MONTPELLIER;FEMININ;SCOLAIRE;BAC PROFESSIONNEL;BAC PRO PROD;BAC PRO 23004 TECHN. ETUDES BAT.A ETUDES & ECO.;11;11;9;2;0;0;0;9;0;0;0;4;5;2
21440.0;2023;11;MONTPELLIER;FEMININ;SCOLAIRE;BAC PROFESSIONNEL;BAC PRO PROD;BAC PRO 23205 INTERV. SUR PATRIMOINE BATI OPT.A;1;1;1;0;0;0;0;1;0;0;0;0;1;0
21450.0;2023;11;MONTPELLIER;FEMININ;SCOLAIRE;BAC PROFESSIONNEL;BAC PRO PROD;BAC PRO 25216 MAINT.VEHIC.OPTC MOTOCYCLES;2;2;1;1;0;0;0;1;0;0;0;1;0;1
21453.0;2023;11;MONTPELLIER;FEMININ;SCOLAIRE;BAC PROFESSIONNEL;BAC PRO PROD;BAC PRO 25408 REPARATION DES CARROSSERIES;2;2;2;0;0;0;0;2;0;0;0;1;1;0
21454.0;2023;11;MONTPELLIER;FEMININ;SCOLAIRE;BAC PROFESSIONNEL;BAC PRO PROD;BAC PRO 25509 TECHNIC. FROID CONDITIONNEMT AIR;1;1;1;0;0;0;0;1;0;0;0;0;1;0
21459.0;2023;11;MONTPELLIER;FEMININ;SCOLAIRE;BAC PROFESSIONNEL;BAC PRO PROD;BAC PRO AG 21113 CGEVV;3;3;1;2;0;0;0;1;0;0;0;0;1;2
21461.0;2023;11;MONTPELLIER;FEMININ;SCOLAIRE;BAC PROFESSIONNEL;BAC PRO PROD;BAC PRO AG 21203 TECHN CONSEIL DE VENTE ANIMAL;16;16;15;1;0;0;0;15;0;0;2;5;8;1
21462.0;2023;11;MONTPELLIER;FEMININ;SCOLAIRE;BAC PROFESSIONNEL;BAC PRO PROD;BAC PRO AG 21210 COND GEST ENTR CANIN ET FELIN;25;25;22;3;0;0;0;22;0;0;1;8;13;3
21467.0;2023;11;MONTPELLIER;FEMININ;SCOLAIRE;BAC PROFESSIONNEL;BAC PRO PROD;BAC PRO AG 21407 TEC CONS VTE UNIVERS JARDINERIE;8;7;5;2;0;0;0;5;0;0;0;2;3;2
21468.0;2023;11;MONTPELLIER;FEMININ;SCOLAIRE;BAC PROFESSIONNEL;BAC PRO PROD;BAC PRO AG 22105 LABORATOIRE CONTROLE QUALITE;13;12;6;6;0;0;0;6;0;0;1;2;3;6
21470.0;2023;11;MONTPELLIER;FEMININ;SCOLAIRE;BAC PROFESSIONNEL;BAC PRO SERV;BAC PRO 30004 ASSISTANC.GEST.ORGANIS.ACTIVITES;474;473;326;120;27;16;11;342;0;24;61;116;141;131
21471.0;2023;11;MONTPELLIER;FEMININ;SCOLAIRE;BAC PROFESSIONNEL;BAC PRO SERV;BAC PRO 31106 LOGISTIQUE;18;18;10;6;2;1;1;11;0;0;2;3;6;7
21474.0;2023;11;MONTPELLIER;FEMININ;SCOLAIRE;BAC PROFESSIONNEL;BAC PRO SERV;BAC PRO 31212 METIERS DE L'ACCUEIL;170;170;124;29;17;13;4;137;0;11;31;51;44;33
21478.0;2023;11;MONTPELLIER;FEMININ;SCOLAIRE;BAC PROFESSIONNEL;BAC PRO SERV;BAC PRO 32208 REAL.PR.IMPR.PLURI.OPTB.PR.IMPR.;5;5;4;0;1;0;1;4;0;2;0;1;1;1
21480.0;2023;11;MONTPELLIER;FEMININ;SCOLAIRE;BAC PROFESSIONNEL;BAC PRO SERV;BAC PRO 32304 PHOTOGRAPHIE;16;16;16;0;0;0;0;16;0;2;5;6;3;0
21483.0;2023;11;MONTPELLIER;FEMININ;SCOLAIRE;BAC PROFESSIONNEL;BAC PRO SERV;BAC PRO 33006 ANIMAT. ENFANCE& PERSONNES AGEES;68;68;62;6;0;0;0;62;0;12;22;19;9;6
21487.0;2023;11;MONTPELLIER;FEMININ;SCOLAIRE;BAC PROFESSIONNEL;BAC PRO SERV;BAC PRO 33603 ESTHETIQUE COSMETIQUE PARFUMERIE;144;144;130;10;4;3;1;133;0;4;19;45;65;11
21488.0;2023;11;MONTPELLIER;FEMININ;SCOLAIRE;BAC PROFESSIONNEL;BAC PRO SERV;BAC PRO 33604 METIERS DE LA COIFFURE;25;25;23;2;0;0;0;23;0;0;5;10;8;2
21490.0;2023;11;MONTPELLIER;FEMININ;SCOLAIRE;BAC PROFESSIONNEL;BAC PRO SERV;BAC PRO 34403 METIERS DE LA SECURITE;65;63;60;2;1;1;0;61;0;2;18;25;16;2
21496.0;2023;11;MONTPELLIER;FEMININ;SCOLAIRE;BAC TECHNOLOGIQUE;BAC STD2A;BAC STD2A SCIENCES & TECHNO. DESIGN-ARTS APPLIQUES;123;123;115;1;7;5;2;120;0;6;35;47;32;3
21505.0;2023;11;MONTPELLIER;FEMININ;SCOLAIRE;BAC TECHNOLOGIQUE;BAC STMG;BAC STMG MERCATIQUE (MARKETING);731;731;610;22;99;85;14;695;0;20;83;240;352;36
21507.0;2023;11;MONTPELLIER;FEMININ;SCOLAIRE;BAC TECHNOLOGIQUE;BAC STMG;BAC STMG SYSTEMES D'INFORMATION DE GESTION;8;8;5;1;2;2;0;7;0;0;0;2;5;1
21512.0;2023;11;MONTPELLIER;MASCULIN;APPRENTISSAGE;BAC PROFESSIONNEL;BAC PRO PROD;BAC PRO 22703 TECHN.INSTALL.SYST.ENERG.CLIMATI;18;18;13;2;3;2;1;15;0;3;4;5;3;3
21516.0;2023;11;MONTPELLIER;MASCULIN;APPRENTISSAGE;BAC PROFESSIONNEL;BAC PRO PROD;BAC PRO 23203 TECHNICIEN BAT. : ORG.REAL.GROS O;1;1;1;0;0;0;0;1;0;0;0;1;0;0
21521.0;2023;11;MONTPELLIER;MASCULIN;APPRENTISSAGE;BAC PROFESSIONNEL;BAC PRO PROD;BAC PRO 25007 MAINTENANCE EQUIPEMENTS INDUST.;22;21;14;6;1;1;0;15;0;0;3;4;8;6
21530.0;2023;11;MONTPELLIER;MASCULIN;APPRENTISSAGE;BAC PROFESSIONNEL;BAC PRO PROD;BAC PRO 25408 REPARATION DES CARROSSERIES;27;27;22;3;2;1;1;23;0;2;5;7;9;4
21541.0;2023;11;MONTPELLIER;MASCULIN;APPRENTISSAGE;BAC PROFESSIONNEL;BAC PRO PROD;BAC PRO AG 22108 TEC CONS VTE ALIMENTATION (PAB);2;2;2;0;0;0;0;2;0;0;0;1;1;0
21543.0;2023;11;MONTPELLIER;MASCULIN;APPRENTISSAGE;BAC PROFESSIONNEL;BAC PRO SERV;BAC PRO 31213 MET.COM.VEN.OP.A ANI.GES.ESP.COM.;48;46;34;11;1;1;0;35;0;3;5;15;12;11
21545.0;2023;11;MONTPELLIER;MASCULIN;APPRENTISSAGE;BAC PROFESSIONNEL;BAC PRO SERV;BAC PRO 33101 OPTIQUE LUNETTERIE;4;4;4;0;0;0;0;4;0;0;3;1;0;0
21548.0;2023;11;MONTPELLIER;MASCULIN;APPRENTISSAGE;BAC PROFESSIONNEL;BAC PRO SERV;BAC PRO AG 33002 SERV PERS TERRIT;10;10;10;0;0;0;0;10;0;1;1;4;4;0
21552.0;2023;11;MONTPELLIER;MASCULIN;ENSEIGNEMENT A DISTANCE;BAC PROFESSIONNEL;BAC PRO SERV;BAC PRO 31214 MET.COM.VEN.OP.B PR.CL.VA.OF.COM.;3;3;2;1;0;0;0;2;0;0;0;0;2;1
21554.0;2023;11;MONTPELLIER;MASCULIN;ENSEIGNEMENT A DISTANCE;BAC TECHNOLOGIQUE;BAC STMG;BAC STMG GESTION ET FINANCE;2;2;1;1;0;0;0;1;0;0;0;0;1;1
21558.0;2023;11;MONTPELLIER;MASCULIN;FORMATION CONTINUE;BAC PROFESSIONNEL;BAC PRO PROD;BAC PRO 23102 TRAVAUX PUBLICS;1;1;1;0;0;0;0;1;0;1;0;0;0;0
21559.0;2023;11;MONTPELLIER;MASCULIN;FORMATION CONTINUE;BAC PROFESSIONNEL;BAC PRO PROD;BAC PRO 25510 METIERS ELECT. ENVIRON. CONNECTES;17;16;13;3;0;0;0;13;0;7;3;2;1;3
21581.0;2023;11;MONTPELLIER;MASCULIN;INDIVIDUEL;BAC PROFESSIONNEL;BAC PRO SERV;BAC PRO 33002 SERVICES DE PROXIMITE  VIE LOCAL;2;0;0;0;0;0;0;0;0;0;0;0;0;0
21584.0;2023;11;MONTPELLIER;MASCULIN;INDIVIDUEL;BAC TECHNOLOGIQUE;BAC ST2S;BAC ST2S SCIENCES & TECHNO. SANTE & SOCIAL;3;2;0;2;0;0;0;0;0;0;0;0;0;2
21592.0;2023;11;MONTPELLIER;MASCULIN;INDIVIDUEL;BAC TECHNOLOGIQUE;BAC STMG;BAC STMG RESSOURCES HUMAINES ET COMMUNICATION;6;6;0;4;2;2;0;2;0;0;0;0;2;4
21604.0;2023;11;MONTPELLIER;MASCULIN;SCOLAIRE;BAC PROFESSIONNEL;BAC PRO PROD;BAC PRO 22704 TECHN. MAINT. SYST.ENERG.CLIMATI;57;57;36;15;6;5;1;41;0;1;3;12;25;16
21611.0;2023;11;MONTPELLIER;MASCULIN;SCOLAIRE;BAC PROFESSIONNEL;BAC PRO PROD;BAC PRO 23205 INTERV. SUR PATRIMOINE BATI OPT.A;4;4;3;1;0;0;0;3;0;0;0;1;2;1
21615.0;2023;11;MONTPELLIER;MASCULIN;SCOLAIRE;BAC PROFESSIONNEL;BAC PRO PROD;BAC PRO 23404 TECHNICIEN CONSTRUCTEUR BOIS;28;28;18;10;0;0;0;18;0;1;3;7;7;10
21616.0;2023;11;MONTPELLIER;MASCULIN;SCOLAIRE;BAC PROFESSIONNEL;BAC PRO PROD;BAC PRO 23405 TECHNICIEN MENUISIER AGENCEUR;37;36;23;12;1;1;0;24;0;2;2;8;12;12
21626.0;2023;11;MONTPELLIER;MASCULIN;SCOLAIRE;BAC PROFESSIONNEL;BAC PRO PROD;BAC PRO 25215 MAINT.VEHIC.OPTB VEHIC.TRANS.ROUT;20;20;15;4;1;1;0;16;0;2;3;3;8;4
21628.0;2023;11;MONTPELLIER;MASCULIN;SCOLAIRE;BAC PROFESSIONNEL;BAC PRO PROD;BAC PRO 25219 MAINT.MATERIELS OPT.A AGRICOLES;23;23;22;0;1;1;0;23;0;1;2;7;13;0
21639.0;2023;11;MONTPELLIER;MASCULIN;SCOLAIRE;BAC PROFESSIONNEL;BAC PRO PROD;BAC PRO 25515 SYST.NUM.OPT.C RES.INF.SYST.COMM.;214;214;185;25;4;2;2;187;0;21;46;64;56;27
21640.0;2023;11;MONTPELLIER;MASCULIN;SCOLAIRE;BAC PROFESSIONNEL;BAC PRO PROD;BAC PRO AG 21001 AGRO-EQUIPEMENT;29;29;27;2;0;0;0;27;0;2;3;7;15;2
21641.0;2023;11;MONTPELLIER;MASCULIN;SCOLAIRE;BAC PROFESSIONNEL;BAC PRO PROD;BAC PRO AG 21004 CGEA;39;38;35;3;0;0;0;35;0;0;6;13;16;3
21648.0;2023;11;MONTPELLIER;MASCULIN;SCOLAIRE;BAC PROFESSIONNEL;BAC PRO PROD;BAC PRO AG 21302 GEST MILIEUX NATURELS FAUNE;29;27;21;6;0;0;0;21;0;1;1;7;12;6
21650.0;2023;11;MONTPELLIER;MASCULIN;SCOLAIRE;BAC PROFESSIONNEL;BAC PRO PROD;BAC PRO AG 21405 AMENAGEMENTS PAYSAGERS;63;63;61;2;0;0;0;61;0;1;6;24;30;2
21654.0;2023;11;MONTPELLIER;MASCULIN;SCOLAIRE;BAC PROFESSIONNEL;BAC PRO SERV;BAC PRO 30004 ASSISTANC.GEST.ORGANIS.ACTIVITES;227;227;163;53;11;9;2;172;0;7;26;63;76;55
21659.0;2023;11;MONTPELLIER;MASCULIN;SCOLAIRE;BAC PROFESSIONNEL;BAC PRO SERV;BAC PRO 31213 MET.COM.VEN.OP.A ANI.GES.ESP.COM.;416;416;326;72;18;11;7;337;0;11;53;128;145;79
21670.0;2023;11;MONTPELLIER;MASCULIN;SCOLAIRE;BAC PROFESSIONNEL;BAC PRO SERV;BAC PRO 33403 COMMERC. SERVICES EN RESTAURATION;67;66;51;11;4;3;1;54;0;1;11;12;30;12
21672.0;2023;11;MONTPELLIER;MASCULIN;SCOLAIRE;BAC PROFESSIONNEL;BAC PRO SERV;BAC PRO 34304 HYGIENE PROPRETE STERILISATION;2;2;2;0;0;0;0;2;0;0;1;1;0;0
21676.0;2023;11;MONTPELLIER;MASCULIN;SCOLAIRE;BAC TECHNOLOGIQUE;BAC ST2S;BAC ST2S SCIENCES & TECHNO. SANTE & SOCIAL;188;188;153;8;27;15;12;168;0;2;22;45;99;20
21679.0;2023;11;MONTPELLIER;MASCULIN;SCOLAIRE;BAC TECHNOLOGIQUE;BAC STHR;BAC STHR SC.&TEC. HOTELLERIE-RESTAURATION;43;43;40;0;3;3;0;43;1;1;7;17;17;0
21683.0;2023;11;MONTPELLIER;MASCULIN;SCOLAIRE;BAC TECHNOLOGIQUE;BAC STI2D;BAC STI2D SYSTÈME D'INFORMATION  ET NUMERIQUE;317;317;267;16;34;25;9;292;0;17;56;107;112;25
21688.0;2023;11;MONTPELLIER;MASCULIN;SCOLAIRE;BAC TECHNOLOGIQUE;BAC STMG;BAC STMG RESSOURCES HUMAINES ET COMMUNICATION;324;324;223;36;65;51;14;274;0;1;12;61;200;50
21705.0;2023;12;NANCY-METZ;FEMININ;APPRENTISSAGE;BAC PROFESSIONNEL;BAC PRO PROD;BAC PRO AG 21001 AGRO-EQUIPEMENT;1;1;1;0;0;0;0;1;0;0;0;0;1;0
21709.0;2023;12;NANCY-METZ;FEMININ;APPRENTISSAGE;BAC PROFESSIONNEL;BAC PRO PROD;BAC PRO AG 21210 COND GEST ENTR CANIN ET FELIN;11;10;8;2;0;0;0;8;0;1;0;4;3;2
21710.0;2023;12;NANCY-METZ;FEMININ;APPRENTISSAGE;BAC PROFESSIONNEL;BAC PRO PROD;BAC PRO AG 21211 COND GEST ENTR HIPPIQUE;24;24;21;3;0;0;0;21;0;0;6;4;11;3
21719.0;2023;12;NANCY-METZ;FEMININ;APPRENTISSAGE;BAC PROFESSIONNEL;BAC PRO SERV;BAC PRO 32303 ART.& MET.ART:COM.VIS.VIS.PLURI-M;1;1;1;0;0;0;0;1;0;0;1;0;0;0
21720.0;2023;12;NANCY-METZ;FEMININ;APPRENTISSAGE;BAC PROFESSIONNEL;BAC PRO SERV;BAC PRO 33101 OPTIQUE LUNETTERIE;1;1;1;0;0;0;0;1;0;1;0;0;0;0
21726.0;2023;12;NANCY-METZ;FEMININ;ENSEIGNEMENT A DISTANCE;BAC PROFESSIONNEL;BAC PRO SERV;BAC PRO 30004 ASSISTANC.GEST.ORGANIS.ACTIVITES;3;2;0;2;0;0;0;0;0;0;0;0;0;2
21732.0;2023;12;NANCY-METZ;FEMININ;ENSEIGNEMENT A DISTANCE;BAC TECHNOLOGIQUE;BAC STMG;BAC STMG MERCATIQUE (MARKETING);2;2;2;0;0;0;0;2;0;0;0;1;1;0
21734.0;2023;12;NANCY-METZ;FEMININ;ENSEIGNEMENT A DISTANCE;BAC TECHNOLOGIQUE;BAC STMG;BAC STMG SYSTEMES D'INFORMATION DE GESTION;2;2;1;0;1;0;1;1;0;0;0;1;0;1
21735.0;2023;12;NANCY-METZ;FEMININ;FORMATION CONTINUE;BAC PROFESSIONNEL;BAC PRO PROD;BAC PRO 23407 TECHNIC.FAB.BOIS ET MATERX ASSOC;1;1;0;1;0;0;0;0;0;0;0;0;0;1
21738.0;2023;12;NANCY-METZ;FEMININ;FORMATION CONTINUE;BAC PROFESSIONNEL;BAC PRO PROD;BAC PRO 25408 REPARATION DES CARROSSERIES;1;1;1;0;0;0;0;1;0;1;0;0;0;0
21750.0;2023;12;NANCY-METZ;FEMININ;INDIVIDUEL;BAC PROFESSIONNEL;BAC PRO PROD;BAC PRO AG 21303 FORET;1;1;1;0;0;0;0;1;0;0;0;0;1;0
21752.0;2023;12;NANCY-METZ;FEMININ;INDIVIDUEL;BAC PROFESSIONNEL;BAC PRO SERV;BAC PRO 31213 MET.COM.VEN.OP.A ANI.GES.ESP.COM.;1;0;0;0;0;0;0;0;0;0;0;0;0;0
21761.0;2023;12;NANCY-METZ;FEMININ;INDIVIDUEL;BAC TECHNOLOGIQUE;BAC STMG;BAC STMG MERCATIQUE (MARKETING);7;7;1;3;3;2;1;3;0;0;1;0;2;4
21763.0;2023;12;NANCY-METZ;FEMININ;SCOLAIRE;BAC GENERAL;BAC GENERAL;BAC GENE 10019 BAC GENERAL;6569;6569;6157;69;343;261;82;6418;121;838;1666;2089;1704;151
21765.0;2023;12;NANCY-METZ;FEMININ;SCOLAIRE;BAC PROFESSIONNEL;BAC PRO PROD;BAC PRO 22003 BIO-INDUSTRIES DE TRANSFORMATION;2;2;2;0;0;0;0;2;0;0;0;0;2;0
21767.0;2023;12;NANCY-METZ;FEMININ;SCOLAIRE;BAC PROFESSIONNEL;BAC PRO PROD;BAC PRO 22105 BOULANGER-PÂTISSIER;63;63;59;1;3;1;2;60;0;1;16;25;18;3
21768.0;2023;12;NANCY-METZ;FEMININ;SCOLAIRE;BAC PROFESSIONNEL;BAC PRO PROD;BAC PRO 22106 CUISINE;65;64;49;11;4;4;0;53;0;6;9;12;26;11
21782.0;2023;12;NANCY-METZ;FEMININ;SCOLAIRE;BAC PROFESSIONNEL;BAC PRO PROD;BAC PRO 25215 MAINT.VEHIC.OPTB VEHIC.TRANS.ROUT;3;3;2;1;0;0;0;2;0;0;0;2;0;1
21785.0;2023;12;NANCY-METZ;FEMININ;SCOLAIRE;BAC PROFESSIONNEL;BAC PRO PROD;BAC PRO 25411 TECH.CHAUDRONNERIE INDUSTRIELLE;1;1;1;0;0;0;0;1;0;0;0;0;1;0
21797.0;2023;12;NANCY-METZ;FEMININ;SCOLAIRE;BAC PROFESSIONNEL;BAC PRO SERV;BAC PRO 30004 ASSISTANC.GEST.ORGANIS.ACTIVITES;338;338;252;68;18;10;8;262;0;9;43;97;113;76
21800.0;2023;12;NANCY-METZ;FEMININ;SCOLAIRE;BAC PROFESSIONNEL;BAC PRO SERV;BAC PRO 31114 ORGANIS. TRANSPORT MARCHANDISES;8;8;5;3;0;0;0;5;0;1;1;0;3;3
21813.0;2023;12;NANCY-METZ;FEMININ;SCOLAIRE;BAC PROFESSIONNEL;BAC PRO SERV;BAC PRO 33403 COMMERC. SERVICES EN RESTAURATION;66;66;45;14;7;4;3;49;0;1;7;21;20;17
21822.0;2023;12;NANCY-METZ;FEMININ;SCOLAIRE;BAC TECHNOLOGIQUE;BAC S2TMD;BAC S2TMD THEATRE;3;3;3;0;0;0;0;3;0;0;2;0;1;0
21824.0;2023;12;NANCY-METZ;FEMININ;SCOLAIRE;BAC TECHNOLOGIQUE;BAC STAV;BAC STAV AGRONOMIE ALIM ENV TERRITOI;55;55;54;1;0;0;0;54;0;0;2;25;27;1
21825.0;2023;12;NANCY-METZ;FEMININ;SCOLAIRE;BAC TECHNOLOGIQUE;BAC STD2A;BAC STD2A SCIENCES & TECHNO. DESIGN-ARTS APPLIQUES;80;80;79;0;1;1;0;80;1;11;29;20;19;0
21826.0;2023;12;NANCY-METZ;FEMININ;SCOLAIRE;BAC TECHNOLOGIQUE;BAC STHR;BAC STHR SC.&TEC. HOTELLERIE-RESTAURATION;45;45;40;0;5;4;1;44;0;3;8;15;18;1
21828.0;2023;12;NANCY-METZ;FEMININ;SCOLAIRE;BAC TECHNOLOGIQUE;BAC STI2D;BAC STI2D ENERGIES  ET ENVIRONNEMENT;13;13;10;2;1;1;0;11;0;0;0;4;7;2
21831.0;2023;12;NANCY-METZ;FEMININ;SCOLAIRE;BAC TECHNOLOGIQUE;BAC STL;BAC STL BIOCHIM.-BIOLOGIE-BIOTECHNOL.;57;57;46;3;8;3;5;49;0;4;10;16;19;8
21832.0;2023;12;NANCY-METZ;FEMININ;SCOLAIRE;BAC TECHNOLOGIQUE;BAC STL;BAC STL SCIENCES PHYSIQUES CHIMIQUES  EN LABORAT.;90;90;84;2;4;2;2;86;0;7;26;22;31;4
21834.0;2023;12;NANCY-METZ;FEMININ;SCOLAIRE;BAC TECHNOLOGIQUE;BAC STMG;BAC STMG MERCATIQUE (MARKETING);574;574;458;20;96;70;26;528;0;9;63;152;304;46
21838.0;2023;12;NANCY-METZ;MASCULIN;APPRENTISSAGE;BAC PROFESSIONNEL;BAC PRO PROD;BAC PRO 22004 PROC. CHIMIE EAU PAPIERS-CARTONS;1;1;1;0;0;0;0;1;0;0;1;0;0;0
21839.0;2023;12;NANCY-METZ;MASCULIN;APPRENTISSAGE;BAC PROFESSIONNEL;BAC PRO PROD;BAC PRO 22106 CUISINE;10;10;8;2;0;0;0;8;0;0;1;3;4;2
21844.0;2023;12;NANCY-METZ;MASCULIN;APPRENTISSAGE;BAC PROFESSIONNEL;BAC PRO PROD;BAC PRO 23203 TECHNICIEN BAT. : ORG.REAL.GROS O;7;6;5;0;1;1;0;6;0;1;1;2;2;0
21846.0;2023;12;NANCY-METZ;MASCULIN;APPRENTISSAGE;BAC PROFESSIONNEL;BAC PRO PROD;BAC PRO 23304 AMENAGEMENT FINITION BATIMENT;2;2;1;1;0;0;0;1;0;0;0;1;0;1
21847.0;2023;12;NANCY-METZ;MASCULIN;APPRENTISSAGE;BAC PROFESSIONNEL;BAC PRO PROD;BAC PRO 23404 TECHNICIEN CONSTRUCTEUR BOIS;6;6;5;1;0;0;0;5;0;0;1;3;1;1
21852.0;2023;12;NANCY-METZ;MASCULIN;APPRENTISSAGE;BAC PROFESSIONNEL;BAC PRO PROD;BAC PRO 25106 TECHNICIEN D'USINAGE;17;17;11;4;2;1;1;12;0;0;3;3;6;5
21855.0;2023;12;NANCY-METZ;MASCULIN;APPRENTISSAGE;BAC PROFESSIONNEL;BAC PRO PROD;BAC PRO 25215 MAINT.VEHIC.OPTB VEHIC.TRANS.ROUT;13;13;10;2;1;0;1;10;0;2;0;4;4;3
21858.0;2023;12;NANCY-METZ;MASCULIN;APPRENTISSAGE;BAC PROFESSIONNEL;BAC PRO PROD;BAC PRO 25220 MAINT.MATERIELS OPT.B TP MANUT.;10;10;9;1;0;0;0;9;0;1;2;4;2;1
21865.0;2023;12;NANCY-METZ;MASCULIN;APPRENTISSAGE;BAC PROFESSIONNEL;BAC PRO PROD;BAC PRO 25411 TECH.CHAUDRONNERIE INDUSTRIELLE;48;48;35;7;6;5;1;40;0;6;12;7;15;8
21877.0;2023;12;NANCY-METZ;MASCULIN;APPRENTISSAGE;BAC PROFESSIONNEL;BAC PRO PROD;BAC PRO AG 21303 FORET;20;18;17;1;0;0;0;17;0;0;0;8;9;1
21881.0;2023;12;NANCY-METZ;MASCULIN;APPRENTISSAGE;BAC PROFESSIONNEL;BAC PRO SERV;BAC PRO 31106 LOGISTIQUE;30;29;19;6;4;2;2;21;0;2;2;10;7;8
21885.0;2023;12;NANCY-METZ;MASCULIN;APPRENTISSAGE;BAC PROFESSIONNEL;BAC PRO SERV;BAC PRO 33104 TECHNICIEN EN PROTHESE DENTAIRE;1;1;1;0;0;0;0;1;0;0;1;0;0;0
21891.0;2023;12;NANCY-METZ;MASCULIN;ENSEIGNEMENT A DISTANCE;BAC PROFESSIONNEL;BAC PRO SERV;BAC PRO 31214 MET.COM.VEN.OP.B PR.CL.VA.OF.COM.;2;1;1;0;0;0;0;1;0;0;0;1;0;0
21893.0;2023;12;NANCY-METZ;MASCULIN;ENSEIGNEMENT A DISTANCE;BAC TECHNOLOGIQUE;BAC ST2S;BAC ST2S SCIENCES & TECHNO. SANTE & SOCIAL;1;1;0;1;0;0;0;0;0;0;0;0;0;1
21895.0;2023;12;NANCY-METZ;MASCULIN;ENSEIGNEMENT A DISTANCE;BAC TECHNOLOGIQUE;BAC STMG;BAC STMG RESSOURCES HUMAINES ET COMMUNICATION;1;1;1;0;0;0;0;1;0;0;0;0;1;0
21898.0;2023;12;NANCY-METZ;MASCULIN;FORMATION CONTINUE;BAC PROFESSIONNEL;BAC PRO PROD;BAC PRO 25214 MAINT.VEHIC.OPTA VOIT.PARTICUL.;8;8;8;0;0;0;0;8;0;1;0;2;5;0
21911.0;2023;12;NANCY-METZ;MASCULIN;INDIVIDUEL;BAC PROFESSIONNEL;BAC PRO PROD;BAC PRO 25214 MAINT.VEHIC.OPTA VOIT.PARTICUL.;1;1;0;0;1;1;0;1;0;0;0;0;1;0
21917.0;2023;12;NANCY-METZ;MASCULIN;INDIVIDUEL;BAC PROFESSIONNEL;BAC PRO SERV;BAC PRO 31106 LOGISTIQUE;1;1;1;0;0;0;0;1;0;0;0;0;1;0
21921.0;2023;12;NANCY-METZ;MASCULIN;INDIVIDUEL;BAC PROFESSIONNEL;BAC PRO SERV;BAC PRO 33006 ANIMAT. ENFANCE& PERSONNES AGEES;1;1;0;1;0;0;0;0;0;0;0;0;0;1
21922.0;2023;12;NANCY-METZ;MASCULIN;INDIVIDUEL;BAC TECHNOLOGIQUE;BAC ST2S;BAC ST2S SCIENCES & TECHNO. SANTE & SOCIAL;4;4;0;3;1;1;0;1;0;0;0;0;1;3
21924.0;2023;12;NANCY-METZ;MASCULIN;INDIVIDUEL;BAC TECHNOLOGIQUE;BAC STI2D;BAC STI2D SYSTÈME D'INFORMATION  ET NUMERIQUE;3;3;1;2;0;0;0;1;0;0;0;0;1;2
21937.0;2023;12;NANCY-METZ;MASCULIN;SCOLAIRE;BAC PROFESSIONNEL;BAC PRO PROD;BAC PRO 22503 PLASTIQUES ET COMPOSITES;9;9;7;2;0;0;0;7;0;0;1;4;2;2
21938.0;2023;12;NANCY-METZ;MASCULIN;SCOLAIRE;BAC PROFESSIONNEL;BAC PRO PROD;BAC PRO 22703 TECHN.INSTALL.SYST.ENERG.CLIMATI;30;30;24;4;2;2;0;26;0;1;1;12;12;4
21942.0;2023;12;NANCY-METZ;MASCULIN;SCOLAIRE;BAC PROFESSIONNEL;BAC PRO PROD;BAC PRO 23102 TRAVAUX PUBLICS;3;3;3;0;0;0;0;3;0;1;0;1;1;0
21947.0;2023;12;NANCY-METZ;MASCULIN;SCOLAIRE;BAC PROFESSIONNEL;BAC PRO PROD;BAC PRO 23304 AMENAGEMENT FINITION BATIMENT;21;21;11;7;3;1;2;12;0;0;1;7;4;9
21949.0;2023;12;NANCY-METZ;MASCULIN;SCOLAIRE;BAC PROFESSIONNEL;BAC PRO PROD;BAC PRO 23405 TECHNICIEN MENUISIER AGENCEUR;50;49;33;14;2;2;0;35;0;2;11;10;12;14
21951.0;2023;12;NANCY-METZ;MASCULIN;SCOLAIRE;BAC PROFESSIONNEL;BAC PRO PROD;BAC PRO 24202 ARTIS.& MET.ART : TAPIS.D'AMEUBL;1;1;1;0;0;0;0;1;0;0;0;1;0;0
21957.0;2023;12;NANCY-METZ;MASCULIN;SCOLAIRE;BAC PROFESSIONNEL;BAC PRO PROD;BAC PRO 25215 MAINT.VEHIC.OPTB VEHIC.TRANS.ROUT;30;30;17;9;4;4;0;21;0;2;4;4;11;9
21971.0;2023;12;NANCY-METZ;MASCULIN;SCOLAIRE;BAC PROFESSIONNEL;BAC PRO PROD;BAC PRO 25514 SYST.NUM.OPT.B AUD.RES.EQUIP.DOM.;73;73;51;16;6;6;0;57;0;2;15;17;23;16
21974.0;2023;12;NANCY-METZ;MASCULIN;SCOLAIRE;BAC PROFESSIONNEL;BAC PRO PROD;BAC PRO AG 21004 CGEA;56;55;41;14;0;0;0;41;0;1;12;15;13;14
21983.0;2023;12;NANCY-METZ;MASCULIN;SCOLAIRE;BAC PROFESSIONNEL;BAC PRO SERV;BAC PRO 30004 ASSISTANC.GEST.ORGANIS.ACTIVITES;210;210;153;47;10;9;1;162;0;2;25;51;84;48
21993.0;2023;12;NANCY-METZ;MASCULIN;SCOLAIRE;BAC PROFESSIONNEL;BAC PRO SERV;BAC PRO 32304 PHOTOGRAPHIE;5;5;5;0;0;0;0;5;0;0;0;2;3;0
21994.0;2023;12;NANCY-METZ;MASCULIN;SCOLAIRE;BAC PROFESSIONNEL;BAC PRO SERV;BAC PRO 33003 ACC.SOINS-S.PERS. OPT.A DOMICILE;11;11;8;2;1;1;0;9;0;1;4;3;1;2
21997.0;2023;12;NANCY-METZ;MASCULIN;SCOLAIRE;BAC PROFESSIONNEL;BAC PRO SERV;BAC PRO 33101 OPTIQUE LUNETTERIE;6;6;6;0;0;0;0;6;0;1;1;3;1;0
21998.0;2023;12;NANCY-METZ;MASCULIN;SCOLAIRE;BAC PROFESSIONNEL;BAC PRO SERV;BAC PRO 33104 TECHNICIEN EN PROTHESE DENTAIRE;6;6;5;0;1;1;0;6;0;0;3;1;2;0
22003.0;2023;12;NANCY-METZ;MASCULIN;SCOLAIRE;BAC PROFESSIONNEL;BAC PRO SERV;BAC PRO 34304 HYGIENE PROPRETE STERILISATION;3;3;3;0;0;0;0;3;0;0;2;1;0;0
22035.0;2023;17;NANTES;FEMININ;APPRENTISSAGE;BAC PROFESSIONNEL;BAC PRO PROD;BAC PRO 25106 TECHNICIEN D'USINAGE;2;2;2;0;0;0;0;2;0;0;2;0;0;0
22037.0;2023;17;NANTES;FEMININ;APPRENTISSAGE;BAC PROFESSIONNEL;BAC PRO PROD;BAC PRO 25216 MAINT.VEHIC.OPTC MOTOCYCLES;1;1;1;0;0;0;0;1;0;0;0;1;0;0
22042.0;2023;17;NANTES;FEMININ;APPRENTISSAGE;BAC PROFESSIONNEL;BAC PRO PROD;BAC PRO 25304 AERONAUTIQUE OPTION STRUCTURE;2;2;2;0;0;0;0;2;0;0;1;0;1;0
22051.0;2023;17;NANTES;FEMININ;APPRENTISSAGE;BAC PROFESSIONNEL;BAC PRO PROD;BAC PRO AG 21204 PROD-AQUACOLES;1;1;1;0;0;0;0;1;0;0;0;0;1;0
22054.0;2023;17;NANTES;FEMININ;APPRENTISSAGE;BAC PROFESSIONNEL;BAC PRO PROD;BAC PRO AG 21405 AMENAGEMENTS PAYSAGERS;3;3;3;0;0;0;0;3;0;0;0;2;1;0
22080.0;2023;17;NANTES;FEMININ;ENSEIGNEMENT A DISTANCE;BAC PROFESSIONNEL;BAC PRO SERV;BAC PRO 33603 ESTHETIQUE COSMETIQUE PARFUMERIE;1;1;1;0;0;0;0;1;0;0;1;0;0;0
22090.0;2023;17;NANTES;FEMININ;FORMATION CONTINUE;BAC PROFESSIONNEL;BAC PRO SERV;BAC PRO 31106 LOGISTIQUE;11;11;10;0;1;0;1;10;0;1;2;2;5;1
22091.0;2023;17;NANTES;FEMININ;FORMATION CONTINUE;BAC PROFESSIONNEL;BAC PRO SERV;BAC PRO 31213 MET.COM.VEN.OP.A ANI.GES.ESP.COM.;5;5;2;3;0;0;0;2;0;0;0;1;1;3
22102.0;2023;17;NANTES;FEMININ;INDIVIDUEL;BAC PROFESSIONNEL;BAC PRO SERV;BAC PRO 31213 MET.COM.VEN.OP.A ANI.GES.ESP.COM.;4;3;1;1;1;0;1;1;0;0;1;0;0;2
22104.0;2023;17;NANTES;FEMININ;INDIVIDUEL;BAC PROFESSIONNEL;BAC PRO SERV;BAC PRO 33004 ACC.SOINS-S.PERS. OPT.EN STRUCTUR;1;1;1;0;0;0;0;1;0;0;0;0;1;0
22107.0;2023;17;NANTES;FEMININ;INDIVIDUEL;BAC PROFESSIONNEL;BAC PRO SERV;BAC PRO AG 33002 SERV PERS TERRIT;7;5;4;1;0;0;0;4;0;0;0;0;4;1
22108.0;2023;17;NANTES;FEMININ;INDIVIDUEL;BAC TECHNOLOGIQUE;BAC ST2S;BAC ST2S SCIENCES & TECHNO. SANTE & SOCIAL;8;8;1;5;2;2;0;3;0;0;0;0;3;5
22109.0;2023;17;NANTES;FEMININ;INDIVIDUEL;BAC TECHNOLOGIQUE;BAC STAV;BAC STAV AGRONOMIE ALIM ENV TERRITOI;1;1;1;0;0;0;0;1;0;0;0;0;1;0
22111.0;2023;17;NANTES;FEMININ;INDIVIDUEL;BAC TECHNOLOGIQUE;BAC STMG;BAC STMG GESTION ET FINANCE;8;8;2;2;4;2;2;4;0;0;0;1;3;4
22114.0;2023;17;NANTES;FEMININ;SCOLAIRE;BAC GENERAL;BAC GENERAL;BAC GENE 10019 BAC GENERAL;11948;11948;11360;105;483;344;139;11704;194;1545;3105;3949;2911;244
22124.0;2023;17;NANTES;FEMININ;SCOLAIRE;BAC PROFESSIONNEL;BAC PRO PROD;BACPRO 23103 TECHNICIEN GEOMETRE-TOPOGRAPHE;3;3;0;3;0;0;0;0;0;0;0;0;0;3
22131.0;2023;17;NANTES;FEMININ;SCOLAIRE;BAC PROFESSIONNEL;BAC PRO PROD;BAC PRO 23408 Etude et réalisation d'agencement;25;25;23;2;0;0;0;23;0;4;12;6;1;2
22135.0;2023;17;NANTES;FEMININ;SCOLAIRE;BAC PROFESSIONNEL;BAC PRO PROD;BAC PRO 25006 MICROTECHNIQUES;1;1;1;0;0;0;0;1;0;0;0;0;1;0
22144.0;2023;17;NANTES;FEMININ;SCOLAIRE;BAC PROFESSIONNEL;BAC PRO PROD;BAC PRO 25510 METIERS ELECT. ENVIRON. CONNECTES;8;8;6;1;1;0;1;6;0;0;3;1;2;2
22146.0;2023;17;NANTES;FEMININ;SCOLAIRE;BAC PROFESSIONNEL;BAC PRO PROD;BAC PRO 25514 SYST.NUM.OPT.B AUD.RES.EQUIP.DOM.;6;6;6;0;0;0;0;6;0;0;3;3;0;0
22158.0;2023;17;NANTES;FEMININ;SCOLAIRE;BAC PROFESSIONNEL;BAC PRO PROD;BAC PRO AG 21407 TEC CONS VTE UNIVERS JARDINERIE;5;5;5;0;0;0;0;5;0;0;0;1;4;0
22161.0;2023;17;NANTES;FEMININ;SCOLAIRE;BAC PROFESSIONNEL;BAC PRO SERV;BAC PRO 30004 ASSISTANC.GEST.ORGANIS.ACTIVITES;487;487;402;65;20;13;7;415;0;22;91;145;157;72
22173.0;2023;17;NANTES;FEMININ;SCOLAIRE;BAC PROFESSIONNEL;BAC PRO SERV;BAC PRO 33006 ANIMAT. ENFANCE& PERSONNES AGEES;66;66;55;9;2;1;1;56;0;12;19;16;9;10
22179.0;2023;17;NANTES;FEMININ;SCOLAIRE;BAC PROFESSIONNEL;BAC PRO SERV;BAC PRO 33604 METIERS DE LA COIFFURE;73;73;64;9;0;0;0;64;0;1;10;32;21;9
22180.0;2023;17;NANTES;FEMININ;SCOLAIRE;BAC PROFESSIONNEL;BAC PRO SERV;BAC PRO 34303 GEST. POLLUTIONS PROTEC. ENVIRON.;4;4;4;0;0;0;0;4;0;2;1;1;0;0
22182.0;2023;17;NANTES;FEMININ;SCOLAIRE;BAC PROFESSIONNEL;BAC PRO SERV;BAC PRO 34403 METIERS DE LA SECURITE;53;53;52;1;0;0;0;52;0;4;13;19;16;1
22183.0;2023;17;NANTES;FEMININ;SCOLAIRE;BAC PROFESSIONNEL;BAC PRO SERV;BAC PRO AG 33002 SERV PERS TERRIT;726;714;653;61;0;0;0;653;0;9;99;242;303;61
22186.0;2023;17;NANTES;FEMININ;SCOLAIRE;BAC TECHNOLOGIQUE;BAC ST2S;BAC ST2S SCIENCES & TECHNO. SANTE & SOCIAL;989;989;887;18;84;49;35;936;1;30;163;368;374;53
22189.0;2023;17;NANTES;FEMININ;SCOLAIRE;BAC TECHNOLOGIQUE;BAC STHR;BAC STHR SC.&TEC. HOTELLERIE-RESTAURATION;67;67;64;0;3;1;2;65;0;6;15;28;16;2
22192.0;2023;17;NANTES;FEMININ;SCOLAIRE;BAC TECHNOLOGIQUE;BAC STI2D;BAC STI2D INNOVATION TECHNO.  ET ECO CONCEPTION;31;31;31;0;0;0;0;31;0;2;8;10;11;0
22194.0;2023;17;NANTES;FEMININ;SCOLAIRE;BAC TECHNOLOGIQUE;BAC STL;BAC STL BIOCHIM.-BIOLOGIE-BIOTECHNOL.;90;90;84;2;4;2;2;86;2;4;22;35;23;4
22196.0;2023;17;NANTES;FEMININ;SCOLAIRE;BAC TECHNOLOGIQUE;BAC STMG;BAC STMG GESTION ET FINANCE;345;345;288;10;47;30;17;318;0;6;45;112;155;27
22197.0;2023;17;NANTES;FEMININ;SCOLAIRE;BAC TECHNOLOGIQUE;BAC STMG;BAC STMG MERCATIQUE (MARKETING);1150;1150;971;49;130;89;41;1060;0;19;109;356;576;90
22202.0;2023;17;NANTES;MASCULIN;APPRENTISSAGE;BAC PROFESSIONNEL;BAC PRO PROD;BAC PRO 22105 BOULANGER-PÂTISSIER;25;25;21;3;1;1;0;22;0;0;5;7;10;3
22204.0;2023;17;NANTES;MASCULIN;APPRENTISSAGE;BAC PROFESSIONNEL;BAC PRO PROD;BAC PRO 22302 Traitement des matériaux;3;3;2;1;0;0;0;2;0;0;0;0;2;1
22207.0;2023;17;NANTES;MASCULIN;APPRENTISSAGE;BAC PROFESSIONNEL;BAC PRO PROD;BAC PRO 22704 TECHN. MAINT. SYST.ENERG.CLIMATI;10;10;6;4;0;0;0;6;0;0;2;2;2;4
22209.0;2023;17;NANTES;MASCULIN;APPRENTISSAGE;BAC PROFESSIONNEL;BAC PRO PROD;BAC PRO 23004 TECHN. ETUDES BAT.A ETUDES & ECO.;7;7;6;1;0;0;0;6;0;1;0;3;2;1
22211.0;2023;17;NANTES;MASCULIN;APPRENTISSAGE;BAC PROFESSIONNEL;BAC PRO PROD;BAC PRO 23203 TECHNICIEN BAT. : ORG.REAL.GROS O;41;41;32;6;3;2;1;34;0;0;7;14;13;7
22212.0;2023;17;NANTES;MASCULIN;APPRENTISSAGE;BAC PROFESSIONNEL;BAC PRO PROD;BAC PRO 23303 MENUISERIE ALUMINIUM-VERRE;14;14;5;6;3;2;1;7;0;0;0;3;4;7
22215.0;2023;17;NANTES;MASCULIN;APPRENTISSAGE;BAC PROFESSIONNEL;BAC PRO PROD;BAC PRO 23405 TECHNICIEN MENUISIER AGENCEUR;24;24;21;2;1;0;1;21;0;1;9;7;4;3
22216.0;2023;17;NANTES;MASCULIN;APPRENTISSAGE;BAC PROFESSIONNEL;BAC PRO PROD;BAC PRO 23407 TECHNIC.FAB.BOIS ET MATERX ASSOC;3;3;3;0;0;0;0;3;0;0;2;1;0;0
22217.0;2023;17;NANTES;MASCULIN;APPRENTISSAGE;BAC PROFESSIONNEL;BAC PRO PROD;BAC PRO 24203 METIERS DE LA MODE - VÊTEMENT;2;2;1;1;0;0;0;1;0;0;0;1;0;1
22221.0;2023;17;NANTES;MASCULIN;APPRENTISSAGE;BAC PROFESSIONNEL;BAC PRO PROD;BAC PRO 25106 TECHNICIEN D'USINAGE;56;56;49;6;1;1;0;50;0;5;5;25;15;6
22223.0;2023;17;NANTES;MASCULIN;APPRENTISSAGE;BAC PROFESSIONNEL;BAC PRO PROD;BAC PRO 25215 MAINT.VEHIC.OPTB VEHIC.TRANS.ROUT;41;40;23;11;6;3;3;26;0;3;3;9;11;14
22224.0;2023;17;NANTES;MASCULIN;APPRENTISSAGE;BAC PROFESSIONNEL;BAC PRO PROD;BAC PRO 25216 MAINT.VEHIC.OPTC MOTOCYCLES;28;28;26;1;1;1;0;27;0;3;8;12;4;1
22244.0;2023;17;NANTES;MASCULIN;APPRENTISSAGE;BAC PROFESSIONNEL;BAC PRO PROD;BAC PRO AG 21114 CONDUITE PRODUCTIONS HORTICOLES;18;18;17;1;0;0;0;17;0;0;1;5;11;1
22251.0;2023;17;NANTES;MASCULIN;APPRENTISSAGE;BAC PROFESSIONNEL;BAC PRO PROD;BAC PRO AG 21407 TEC CONS VTE UNIVERS JARDINERIE;2;2;1;1;0;0;0;1;0;0;0;0;1;1
22261.0;2023;17;NANTES;MASCULIN;APPRENTISSAGE;BAC PROFESSIONNEL;BAC PRO SERV;BAC PRO 32208 REAL.PR.IMPR.PLURI.OPTB.PR.IMPR.;10;10;10;0;0;0;0;10;0;1;1;3;5;0
22268.0;2023;17;NANTES;MASCULIN;ENSEIGNEMENT A DISTANCE;BAC PROFESSIONNEL;BAC PRO PROD;BAC PRO AG 21004 CGEA;3;3;2;1;0;0;0;2;0;0;0;0;2;1
22276.0;2023;17;NANTES;MASCULIN;ENSEIGNEMENT A DISTANCE;BAC TECHNOLOGIQUE;BAC STMG;BAC STMG SYSTEMES D'INFORMATION DE GESTION;1;1;1;0;0;0;0;1;0;0;1;0;0;0
22280.0;2023;17;NANTES;MASCULIN;FORMATION CONTINUE;BAC PROFESSIONNEL;BAC PRO PROD;BAC PRO 23004 TECHN. ETUDES BAT.A ETUDES & ECO.;6;6;3;3;0;0;0;3;0;1;1;1;0;3
22282.0;2023;17;NANTES;MASCULIN;FORMATION CONTINUE;BAC PROFESSIONNEL;BAC PRO PROD;BAC PRO 25214 MAINT.VEHIC.OPTA VOIT.PARTICUL.;3;3;3;0;0;0;0;3;0;1;1;1;0;0
22291.0;2023;17;NANTES;MASCULIN;FORMATION CONTINUE;BAC PROFESSIONNEL;BAC PRO SERV;BAC PRO 31213 MET.COM.VEN.OP.A ANI.GES.ESP.COM.;9;7;4;2;1;1;0;5;0;0;0;1;4;2
22293.0;2023;17;NANTES;MASCULIN;INDIVIDUEL;BAC GENERAL;BAC GENERAL;BAC GENE 10019 BAC GENERAL;95;95;43;41;11;8;3;51;0;0;6;15;30;44
22295.0;2023;17;NANTES;MASCULIN;INDIVIDUEL;BAC PROFESSIONNEL;BAC PRO PROD;BAC PRO 22703 TECHN.INSTALL.SYST.ENERG.CLIMATI;1;0;0;0;0;0;0;0;0;0;0;0;0;0
22303.0;2023;17;NANTES;MASCULIN;INDIVIDUEL;BAC PROFESSIONNEL;BAC PRO PROD;BAC PRO 25214 MAINT.VEHIC.OPTA VOIT.PARTICUL.;3;2;0;1;1;1;0;1;0;0;0;0;1;1
22305.0;2023;17;NANTES;MASCULIN;INDIVIDUEL;BAC PROFESSIONNEL;BAC PRO PROD;BAC PRO 25510 METIERS ELECT. ENVIRON. CONNECTES;4;2;2;0;0;0;0;2;0;1;0;0;1;0
22307.0;2023;17;NANTES;MASCULIN;INDIVIDUEL;BAC PROFESSIONNEL;BAC PRO PROD;BAC PRO 25514 SYST.NUM.OPT.B AUD.RES.EQUIP.DOM.;1;0;0;0;0;0;0;0;0;0;0;0;0;0
22317.0;2023;17;NANTES;MASCULIN;INDIVIDUEL;BAC PROFESSIONNEL;BAC PRO SERV;BAC PRO 33002 SERVICES DE PROXIMITE  VIE LOCAL;1;0;0;0;0;0;0;0;0;0;0;0;0;0
22321.0;2023;17;NANTES;MASCULIN;INDIVIDUEL;BAC TECHNOLOGIQUE;BAC STAV;BAC STAV AGRONOMIE ALIM ENV TERRITOI;1;0;0;0;0;0;0;0;0;0;0;0;0;0
22323.0;2023;17;NANTES;MASCULIN;INDIVIDUEL;BAC TECHNOLOGIQUE;BAC STI2D;BAC STI2D SYSTÈME D'INFORMATION  ET NUMERIQUE;3;3;1;1;1;1;0;2;0;0;0;0;2;1
22328.0;2023;17;NANTES;MASCULIN;INDIVIDUEL;BAC TECHNOLOGIQUE;BAC STMG;BAC STMG RESSOURCES HUMAINES ET COMMUNICATION;13;12;3;5;4;4;0;7;0;0;0;0;7;5
22329.0;2023;17;NANTES;MASCULIN;SCOLAIRE;BAC GENERAL;BAC GENERAL;BAC GENE 10019 BAC GENERAL;9472;9472;8846;78;548;372;176;9218;119;1009;2151;3132;2807;254
22334.0;2023;17;NANTES;MASCULIN;SCOLAIRE;BAC PROFESSIONNEL;BAC PRO PROD;BAC PRO 22106 CUISINE;140;140;116;11;13;12;1;128;0;10;21;47;50;12
22338.0;2023;17;NANTES;MASCULIN;SCOLAIRE;BAC PROFESSIONNEL;BAC PRO PROD;BAC PRO 22704 TECHN. MAINT. SYST.ENERG.CLIMATI;8;8;6;2;0;0;0;6;0;0;0;2;4;2
22340.0;2023;17;NANTES;MASCULIN;SCOLAIRE;BAC PROFESSIONNEL;BAC PRO PROD;BAC PRO 23004 TECHN. ETUDES BAT.A ETUDES & ECO.;76;76;60;16;0;0;0;60;0;4;14;19;23;16
22343.0;2023;17;NANTES;MASCULIN;SCOLAIRE;BAC PROFESSIONNEL;BAC PRO PROD;BACPRO 23103 TECHNICIEN GEOMETRE-TOPOGRAPHE;20;20;13;7;0;0;0;13;0;0;0;8;5;7
22345.0;2023;17;NANTES;MASCULIN;SCOLAIRE;BAC PROFESSIONNEL;BAC PRO PROD;BAC PRO 23205 INTERV. SUR PATRIMOINE BATI OPT.A;2;2;1;1;0;0;0;1;0;0;0;0;1;1
22349.0;2023;17;NANTES;MASCULIN;SCOLAIRE;BAC PROFESSIONNEL;BAC PRO PROD;BAC PRO 23405 TECHNICIEN MENUISIER AGENCEUR;116;116;88;26;2;1;1;89;0;6;20;33;30;27
22350.0;2023;17;NANTES;MASCULIN;SCOLAIRE;BAC PROFESSIONNEL;BAC PRO PROD;BAC PRO 23407 TECHNIC.FAB.BOIS ET MATERX ASSOC;30;30;27;2;1;1;0;28;0;1;7;12;8;2
22354.0;2023;17;NANTES;MASCULIN;SCOLAIRE;BAC PROFESSIONNEL;BAC PRO PROD;BAC PRO 25007 MAINTENANCE EQUIPEMENTS INDUST.;223;223;168;49;6;5;1;173;0;13;38;80;42;50
22357.0;2023;17;NANTES;MASCULIN;SCOLAIRE;BAC PROFESSIONNEL;BAC PRO PROD;BAC PRO 25107 TECHNICIEN OUTILLEUR;11;11;9;1;1;1;0;10;0;0;0;7;3;1
22358.0;2023;17;NANTES;MASCULIN;SCOLAIRE;BAC PROFESSIONNEL;BAC PRO PROD;BAC PRO 25214 MAINT.VEHIC.OPTA VOIT.PARTICUL.;214;213;174;27;12;6;6;180;0;22;39;65;54;33
22364.0;2023;17;NANTES;MASCULIN;SCOLAIRE;BAC PROFESSIONNEL;BAC PRO PROD;BAC PRO 25406 OUVRAGES DU BATIMENT METALLERIE;29;29;17;9;3;3;0;20;0;0;4;7;9;9
22365.0;2023;17;NANTES;MASCULIN;SCOLAIRE;BAC PROFESSIONNEL;BAC PRO PROD;BAC PRO 25408 REPARATION DES CARROSSERIES;52;52;45;5;2;2;0;47;0;0;5;16;26;5
22366.0;2023;17;NANTES;MASCULIN;SCOLAIRE;BAC PROFESSIONNEL;BAC PRO PROD;BAC PRO 25410 CONSTRUCTION DES CARROSSERIES;8;8;6;2;0;0;0;6;0;0;0;5;1;2
22372.0;2023;17;NANTES;MASCULIN;SCOLAIRE;BAC PROFESSIONNEL;BAC PRO PROD;BAC PRO 25515 SYST.NUM.OPT.C RES.INF.SYST.COMM.;170;170;150;18;2;2;0;152;0;15;43;58;36;18
22374.0;2023;17;NANTES;MASCULIN;SCOLAIRE;BAC PROFESSIONNEL;BAC PRO PROD;BAC PRO AG 21004 CGEA;240;239;210;29;0;0;0;210;0;3;25;66;116;29
22378.0;2023;17;NANTES;MASCULIN;SCOLAIRE;BAC PROFESSIONNEL;BAC PRO PROD;BAC PRO AG 21204 PROD-AQUACOLES;22;20;17;3;0;0;0;17;0;0;2;7;8;3
22380.0;2023;17;NANTES;MASCULIN;SCOLAIRE;BAC PROFESSIONNEL;BAC PRO PROD;BAC PRO AG 21211 COND GEST ENTR HIPPIQUE;5;5;4;1;0;0;0;4;0;0;1;3;0;1
22384.0;2023;17;NANTES;MASCULIN;SCOLAIRE;BAC PROFESSIONNEL;BAC PRO PROD;BAC PRO AG 22105 LABORATOIRE CONTROLE QUALITE;12;10;10;0;0;0;0;10;0;1;1;6;2;0
22388.0;2023;17;NANTES;MASCULIN;SCOLAIRE;BAC PROFESSIONNEL;BAC PRO SERV;BAC PRO 31107 CONDUCT. TRANSP.ROUT.MARCHANDISES;103;103;95;5;3;2;1;97;0;8;23;46;20;6
22390.0;2023;17;NANTES;MASCULIN;SCOLAIRE;BAC PROFESSIONNEL;BAC PRO SERV;BAC PRO 31212 METIERS DE L'ACCUEIL;76;75;63;7;5;3;2;66;0;1;12;21;32;9
22392.0;2023;17;NANTES;MASCULIN;SCOLAIRE;BAC PROFESSIONNEL;BAC PRO SERV;BAC PRO 31214 MET.COM.VEN.OP.B PR.CL.VA.OF.COM.;243;243;208;27;8;8;0;216;0;11;38;92;75;27
22403.0;2023;17;NANTES;MASCULIN;SCOLAIRE;BAC PROFESSIONNEL;BAC PRO SERV;BAC PRO 33403 COMMERC. SERVICES EN RESTAURATION;110;110;94;14;2;2;0;96;0;5;14;44;33;14
22415.0;2023;17;NANTES;MASCULIN;SCOLAIRE;BAC TECHNOLOGIQUE;BAC STI2D;BAC STI2D ARCHITECTURE ET CONSTRUCTION;240;240;221;5;14;10;4;231;0;9;52;95;75;9
22417.0;2023;17;NANTES;MASCULIN;SCOLAIRE;BAC TECHNOLOGIQUE;BAC STI2D;BAC STI2D INNOVATION TECHNO.  ET ECO CONCEPTION;387;387;359;7;21;14;7;373;1;14;73;137;148;14
22420.0;2023;17;NANTES;MASCULIN;SCOLAIRE;BAC TECHNOLOGIQUE;BAC STL;BAC STL SCIENCES PHYSIQUES CHIMIQUES  EN LABORAT.;74;74;69;2;3;1;2;70;0;6;18;23;23;4
22426.0;2023;23;NICE;FEMININ;APPRENTISSAGE;BAC PROFESSIONNEL;BAC PRO PROD;BAC PRO 23005 TECHN. ETUDES BAT B ASSIST.ARCHI.;1;1;0;1;0;0;0;0;0;0;0;0;0;1
22430.0;2023;23;NICE;FEMININ;APPRENTISSAGE;BAC PROFESSIONNEL;BAC PRO PROD;BAC PRO AG 21302 GEST MILIEUX NATURELS FAUNE;1;1;1;0;0;0;0;1;0;0;0;1;0;0
22432.0;2023;23;NICE;FEMININ;APPRENTISSAGE;BAC PROFESSIONNEL;BAC PRO SERV;BAC PRO 30004 ASSISTANC.GEST.ORGANIS.ACTIVITES;23;21;19;1;1;0;1;19;0;1;5;6;7;2
22434.0;2023;23;NICE;FEMININ;APPRENTISSAGE;BAC PROFESSIONNEL;BAC PRO SERV;BAC PRO 31212 METIERS DE L'ACCUEIL;1;1;0;0;1;0;1;0;0;0;0;0;0;1
22435.0;2023;23;NICE;FEMININ;APPRENTISSAGE;BAC PROFESSIONNEL;BAC PRO SERV;BAC PRO 31213 MET.COM.VEN.OP.A ANI.GES.ESP.COM.;68;67;45;13;9;6;3;51;0;2;10;13;26;16
22436.0;2023;23;NICE;FEMININ;APPRENTISSAGE;BAC PROFESSIONNEL;BAC PRO SERV;BAC PRO 31214 MET.COM.VEN.OP.B PR.CL.VA.OF.COM.;5;5;4;1;0;0;0;4;0;0;0;2;2;1
22437.0;2023;23;NICE;FEMININ;APPRENTISSAGE;BAC PROFESSIONNEL;BAC PRO SERV;BAC PRO 33004 ACC.SOINS-S.PERS. OPT.EN STRUCTUR;8;6;5;0;1;0;1;5;0;0;0;2;3;1
22447.0;2023;23;NICE;FEMININ;ENSEIGNEMENT A DISTANCE;BAC TECHNOLOGIQUE;BAC STMG;BAC STMG RESSOURCES HUMAINES ET COMMUNICATION;1;1;1;0;0;0;0;1;0;0;0;0;1;0
22448.0;2023;23;NICE;FEMININ;FORMATION CONTINUE;BAC PROFESSIONNEL;BAC PRO PROD;BAC PRO 25510 METIERS ELECT. ENVIRON. CONNECTES;1;1;1;0;0;0;0;1;0;1;0;0;0;0
22459.0;2023;23;NICE;FEMININ;INDIVIDUEL;BAC PROFESSIONNEL;BAC PRO PROD;BAC PRO AG 21113 CGEVV;1;0;0;0;0;0;0;0;0;0;0;0;0;0
22475.0;2023;23;NICE;FEMININ;INDIVIDUEL;BAC TECHNOLOGIQUE;BAC STMG;BAC STMG RESSOURCES HUMAINES ET COMMUNICATION;8;8;4;2;2;1;1;5;0;0;0;1;4;3
22494.0;2023;23;NICE;FEMININ;SCOLAIRE;BAC PROFESSIONNEL;BAC PRO PROD;BAC PRO 25106 TECHNICIEN D'USINAGE;2;2;1;1;0;0;0;1;0;0;0;0;1;1
22509.0;2023;23;NICE;FEMININ;SCOLAIRE;BAC PROFESSIONNEL;BAC PRO SERV;BAC PRO 31212 METIERS DE L'ACCUEIL;188;188;155;21;12;5;7;160;0;7;26;57;70;28
22512.0;2023;23;NICE;FEMININ;SCOLAIRE;BAC PROFESSIONNEL;BAC PRO SERV;BAC PRO 32207 REAL.PR.IMPR.PLURI.OPTA.PR.GRAPH.;6;6;6;0;0;0;0;6;0;1;1;4;0;0
22520.0;2023;23;NICE;FEMININ;SCOLAIRE;BAC PROFESSIONNEL;BAC PRO SERV;BAC PRO 33603 ESTHETIQUE COSMETIQUE PARFUMERIE;124;123;103;15;5;3;2;106;0;8;23;30;45;17
22524.0;2023;23;NICE;FEMININ;SCOLAIRE;BAC PROFESSIONNEL;BAC PRO SERV;BAC PRO AG 33002 SERV PERS TERRIT;89;89;81;8;0;0;0;81;0;1;9;23;48;8
22530.0;2023;23;NICE;FEMININ;SCOLAIRE;BAC TECHNOLOGIQUE;BAC STHR;BAC STHR SC.&TEC. HOTELLERIE-RESTAURATION;54;54;49;1;4;2;2;51;0;5;7;16;23;3
22531.0;2023;23;NICE;FEMININ;SCOLAIRE;BAC TECHNOLOGIQUE;BAC STI2D;BAC STI2D ARCHITECTURE ET CONSTRUCTION;18;18;15;0;3;2;1;17;0;0;3;11;3;1
22539.0;2023;23;NICE;FEMININ;SCOLAIRE;BAC TECHNOLOGIQUE;BAC STMG;BAC STMG RESSOURCES HUMAINES ET COMMUNICATION;385;385;280;24;81;57;24;337;0;7;24;104;202;48
22543.0;2023;23;NICE;MASCULIN;APPRENTISSAGE;BAC PROFESSIONNEL;BAC PRO PROD;BAC PRO 22704 TECHN. MAINT. SYST.ENERG.CLIMATI;9;9;7;2;0;0;0;7;0;1;1;1;4;2
22544.0;2023;23;NICE;MASCULIN;APPRENTISSAGE;BAC PROFESSIONNEL;BAC PRO PROD;BAC PRO 23102 TRAVAUX PUBLICS;14;13;10;2;1;1;0;11;0;0;1;3;7;2
22552.0;2023;23;NICE;MASCULIN;APPRENTISSAGE;BAC PROFESSIONNEL;BAC PRO PROD;BAC PRO 25214 MAINT.VEHIC.OPTA VOIT.PARTICUL.;89;88;65;19;4;3;1;68;0;7;17;18;26;20
22570.0;2023;23;NICE;MASCULIN;ENSEIGNEMENT A DISTANCE;BAC PROFESSIONNEL;BAC PRO SERV;BAC PRO 30004 ASSISTANC.GEST.ORGANIS.ACTIVITES;5;4;1;3;0;0;0;1;0;0;0;1;0;3
22572.0;2023;23;NICE;MASCULIN;ENSEIGNEMENT A DISTANCE;BAC PROFESSIONNEL;BAC PRO SERV;BAC PRO 31214 MET.COM.VEN.OP.B PR.CL.VA.OF.COM.;2;1;0;1;0;0;0;0;0;0;0;0;0;1
22577.0;2023;23;NICE;MASCULIN;FORMATION CONTINUE;BAC PROFESSIONNEL;BAC PRO PROD;BAC PRO 25510 METIERS ELECT. ENVIRON. CONNECTES;17;17;17;0;0;0;0;17;0;11;2;4;0;0
22578.0;2023;23;NICE;MASCULIN;FORMATION CONTINUE;BAC PROFESSIONNEL;BAC PRO SERV;BAC PRO 30004 ASSISTANC.GEST.ORGANIS.ACTIVITES;1;1;1;0;0;0;0;1;0;0;1;0;0;0
22579.0;2023;23;NICE;MASCULIN;FORMATION CONTINUE;BAC PROFESSIONNEL;BAC PRO SERV;BAC PRO 31212 METIERS DE L'ACCUEIL;2;2;2;0;0;0;0;2;0;0;0;1;1;0
22581.0;2023;23;NICE;MASCULIN;FORMATION CONTINUE;BAC PROFESSIONNEL;BAC PRO SERV;BAC PRO 33101 OPTIQUE LUNETTERIE;2;2;1;1;0;0;0;1;0;0;0;0;1;1
22589.0;2023;23;NICE;MASCULIN;INDIVIDUEL;BAC PROFESSIONNEL;BAC PRO PROD;BAC PRO 25214 MAINT.VEHIC.OPTA VOIT.PARTICUL.;1;1;1;0;0;0;0;1;0;0;0;0;1;0
22591.0;2023;23;NICE;MASCULIN;INDIVIDUEL;BAC PROFESSIONNEL;BAC PRO PROD;BAC PRO AG 21004 CGEA;1;1;0;1;0;0;0;0;0;0;0;0;0;1
22595.0;2023;23;NICE;MASCULIN;INDIVIDUEL;BAC PROFESSIONNEL;BAC PRO SERV;BAC PRO 30004 ASSISTANC.GEST.ORGANIS.ACTIVITES;6;4;1;2;1;1;0;2;0;0;0;0;2;2
22596.0;2023;23;NICE;MASCULIN;INDIVIDUEL;BAC PROFESSIONNEL;BAC PRO SERV;BAC PRO 31106 LOGISTIQUE;1;1;0;1;0;0;0;0;0;0;0;0;0;1
22602.0;2023;23;NICE;MASCULIN;INDIVIDUEL;BAC TECHNOLOGIQUE;BAC STI2D;BAC STI2D ENERGIES  ET ENVIRONNEMENT;1;1;1;0;0;0;0;1;0;0;0;0;1;0
22614.0;2023;23;NICE;MASCULIN;SCOLAIRE;BAC PROFESSIONNEL;BAC PRO PROD;BAC PRO 22703 TECHN.INSTALL.SYST.ENERG.CLIMATI;47;47;32;10;5;4;1;36;0;3;6;16;11;11
22620.0;2023;23;NICE;MASCULIN;SCOLAIRE;BAC PROFESSIONNEL;BAC PRO PROD;BAC PRO 23203 TECHNICIEN BAT. : ORG.REAL.GROS O;11;11;5;5;1;0;1;5;0;0;0;2;3;6
22627.0;2023;23;NICE;MASCULIN;SCOLAIRE;BAC PROFESSIONNEL;BAC PRO PROD;BAC PRO 23408 Etude et réalisation d'agencement;13;13;7;5;1;0;1;7;0;0;1;4;2;6
22637.0;2023;23;NICE;MASCULIN;SCOLAIRE;BAC PROFESSIONNEL;BAC PRO PROD;BAC PRO 25215 MAINT.VEHIC.OPTB VEHIC.TRANS.ROUT;23;22;16;6;0;0;0;16;0;0;2;7;7;6
22639.0;2023;23;NICE;MASCULIN;SCOLAIRE;BAC PROFESSIONNEL;BAC PRO PROD;BAC PRO 25220 MAINT.MATERIELS OPT.B TP MANUT.;12;12;8;2;2;2;0;10;0;0;2;1;7;2
22655.0;2023;23;NICE;MASCULIN;SCOLAIRE;BAC PROFESSIONNEL;BAC PRO SERV;BAC PRO 31107 CONDUCT. TRANSP.ROUT.MARCHANDISES;21;20;18;1;1;1;0;19;0;0;2;10;7;1
22658.0;2023;23;NICE;MASCULIN;SCOLAIRE;BAC PROFESSIONNEL;BAC PRO SERV;BAC PRO 31213 MET.COM.VEN.OP.A ANI.GES.ESP.COM.;285;283;216;45;22;15;7;231;0;3;31;76;121;52
22663.0;2023;23;NICE;MASCULIN;SCOLAIRE;BAC PROFESSIONNEL;BAC PRO SERV;BAC PRO 33003 ACC.SOINS-S.PERS. OPT.A DOMICILE;4;4;3;1;0;0;0;3;0;0;0;1;2;1
22666.0;2023;23;NICE;MASCULIN;SCOLAIRE;BAC PROFESSIONNEL;BAC PRO SERV;BAC PRO 33101 OPTIQUE LUNETTERIE;9;9;9;0;0;0;0;9;0;0;3;2;4;0
22670.0;2023;23;NICE;MASCULIN;SCOLAIRE;BAC PROFESSIONNEL;BAC PRO SERV;BAC PRO 34403 METIERS DE LA SECURITE;51;51;49;1;1;1;0;50;0;3;11;27;9;1
22672.0;2023;23;NICE;MASCULIN;SCOLAIRE;BAC TECHNOLOGIQUE;BAC S2TMD;BAC S2TMD MUSIQUE;6;6;6;0;0;0;0;6;0;1;1;2;2;0
22676.0;2023;23;NICE;MASCULIN;SCOLAIRE;BAC TECHNOLOGIQUE;BAC STHR;BAC STHR SC.&TEC. HOTELLERIE-RESTAURATION;43;43;36;1;6;4;2;40;0;0;3;11;26;3
22681.0;2023;23;NICE;MASCULIN;SCOLAIRE;BAC TECHNOLOGIQUE;BAC STL;BAC STL BIOCHIM.-BIOLOGIE-BIOTECHNOL.;33;33;28;3;2;1;1;29;0;1;7;7;14;4
22683.0;2023;23;NICE;MASCULIN;SCOLAIRE;BAC TECHNOLOGIQUE;BAC STMG;BAC STMG GESTION ET FINANCE;236;236;202;10;24;14;10;216;0;3;31;82;100;20
22687.0;2023;70;NORMANDIE;FEMININ;APPRENTISSAGE;BAC PROFESSIONNEL;BAC PRO PROD;BAC PRO 20102 PILOTE DE LIGNE DE PRODUCTION;2;2;2;0;0;0;0;2;0;1;1;0;0;0
22693.0;2023;70;NORMANDIE;FEMININ;APPRENTISSAGE;BAC PROFESSIONNEL;BAC PRO PROD;BAC PRO 23005 TECHN. ETUDES BAT B ASSIST.ARCHI.;1;1;1;0;0;0;0;1;0;1;0;0;0;0
22695.0;2023;70;NORMANDIE;FEMININ;APPRENTISSAGE;BAC PROFESSIONNEL;BAC PRO PROD;BAC PRO 23303 MENUISERIE ALUMINIUM-VERRE;1;1;1;0;0;0;0;1;0;0;1;0;0;0
22698.0;2023;70;NORMANDIE;FEMININ;APPRENTISSAGE;BAC PROFESSIONNEL;BAC PRO PROD;BAC PRO 23408 Etude et réalisation d'agencement;1;1;1;0;0;0;0;1;0;0;1;0;0;0
22703.0;2023;70;NORMANDIE;FEMININ;APPRENTISSAGE;BAC PROFESSIONNEL;BAC PRO PROD;BAC PRO 25215 MAINT.VEHIC.OPTB VEHIC.TRANS.ROUT;3;3;3;0;0;0;0;3;0;1;2;0;0;0
22717.0;2023;70;NORMANDIE;FEMININ;APPRENTISSAGE;BAC PROFESSIONNEL;BAC PRO SERV;BAC PRO 30004 ASSISTANC.GEST.ORGANIS.ACTIVITES;19;18;18;0;0;0;0;18;0;2;6;8;2;0
22719.0;2023;70;NORMANDIE;FEMININ;APPRENTISSAGE;BAC PROFESSIONNEL;BAC PRO SERV;BAC PRO 31212 METIERS DE L'ACCUEIL;2;2;1;0;1;0;1;1;0;0;0;0;1;1
22720.0;2023;70;NORMANDIE;FEMININ;APPRENTISSAGE;BAC PROFESSIONNEL;BAC PRO SERV;BAC PRO 31213 MET.COM.VEN.OP.A ANI.GES.ESP.COM.;182;176;146;23;7;2;5;148;0;8;30;50;60;28
22725.0;2023;70;NORMANDIE;FEMININ;APPRENTISSAGE;BAC PROFESSIONNEL;BAC PRO SERV;BAC PRO 34304 HYGIENE PROPRETE STERILISATION;1;1;1;0;0;0;0;1;0;0;0;1;0;0
22730.0;2023;70;NORMANDIE;FEMININ;ENSEIGNEMENT A DISTANCE;BAC PROFESSIONNEL;BAC PRO SERV;BAC PRO 31212 METIERS DE L'ACCUEIL;1;1;0;1;0;0;0;0;0;0;0;0;0;1
22738.0;2023;70;NORMANDIE;FEMININ;ENSEIGNEMENT A DISTANCE;BAC TECHNOLOGIQUE;BAC STMG;BAC STMG MERCATIQUE (MARKETING);8;8;6;1;1;1;0;7;0;0;0;3;4;1
22740.0;2023;70;NORMANDIE;FEMININ;FORMATION CONTINUE;BAC PROFESSIONNEL;BAC PRO PROD;BACPRO 20002 ETUD.DEFINITION PRDTS INDUSTRIEL;1;1;1;0;0;0;0;1;0;0;1;0;0;0
22741.0;2023;70;NORMANDIE;FEMININ;FORMATION CONTINUE;BAC PROFESSIONNEL;BAC PRO PROD;BAC PRO 20102 PILOTE DE LIGNE DE PRODUCTION;5;5;5;0;0;0;0;5;0;0;4;1;0;0
22746.0;2023;70;NORMANDIE;FEMININ;FORMATION CONTINUE;BAC PROFESSIONNEL;BAC PRO PROD;BAC PRO 25510 METIERS ELECT. ENVIRON. CONNECTES;2;2;2;0;0;0;0;2;0;1;1;0;0;0
22748.0;2023;70;NORMANDIE;FEMININ;FORMATION CONTINUE;BAC PROFESSIONNEL;BAC PRO SERV;BAC PRO 31106 LOGISTIQUE;1;1;1;0;0;0;0;1;0;0;1;0;0;0
22760.0;2023;70;NORMANDIE;FEMININ;INDIVIDUEL;BAC PROFESSIONNEL;BAC PRO SERV;BAC PRO 33003 ACC.SOINS-S.PERS. OPT.A DOMICILE;2;1;0;0;1;1;0;1;0;0;0;0;1;0
22764.0;2023;70;NORMANDIE;FEMININ;INDIVIDUEL;BAC PROFESSIONNEL;BAC PRO SERV;BAC PRO 34304 HYGIENE PROPRETE STERILISATION;1;1;0;1;0;0;0;0;0;0;0;0;0;1
22770.0;2023;70;NORMANDIE;FEMININ;INDIVIDUEL;BAC TECHNOLOGIQUE;BAC STMG;BAC STMG MERCATIQUE (MARKETING);7;7;0;5;2;2;0;2;0;0;0;0;2;5
22772.0;2023;70;NORMANDIE;FEMININ;SCOLAIRE;BAC GENERAL;BAC GENERAL;BAC GENE 10019 BAC GENERAL;9759;9759;9037;139;583;399;184;9436;189;1204;2348;3029;2666;323
22773.0;2023;70;NORMANDIE;FEMININ;SCOLAIRE;BAC PROFESSIONNEL;BAC PRO PROD;BACPRO 20002 ETUD.DEFINITION PRDTS INDUSTRIEL;7;7;3;4;0;0;0;3;0;0;0;0;3;4
22775.0;2023;70;NORMANDIE;FEMININ;SCOLAIRE;BAC PROFESSIONNEL;BAC PRO PROD;BAC PRO 22003 BIO-INDUSTRIES DE TRANSFORMATION;20;20;19;1;0;0;0;19;0;0;4;10;5;1
22782.0;2023;70;NORMANDIE;FEMININ;SCOLAIRE;BAC PROFESSIONNEL;BAC PRO PROD;BAC PRO 23005 TECHN. ETUDES BAT B ASSIST.ARCHI.;12;12;10;2;0;0;0;10;0;0;5;3;2;2
22783.0;2023;70;NORMANDIE;FEMININ;SCOLAIRE;BAC PROFESSIONNEL;BAC PRO PROD;BACPRO 23103 TECHNICIEN GEOMETRE-TOPOGRAPHE;2;2;1;1;0;0;0;1;0;0;0;0;1;1
22785.0;2023;70;NORMANDIE;FEMININ;SCOLAIRE;BAC PROFESSIONNEL;BAC PRO PROD;BAC PRO 23304 AMENAGEMENT FINITION BATIMENT;11;11;8;2;1;1;0;9;0;0;1;4;4;2
22786.0;2023;70;NORMANDIE;FEMININ;SCOLAIRE;BAC PROFESSIONNEL;BAC PRO PROD;BAC PRO 23405 TECHNICIEN MENUISIER AGENCEUR;9;9;5;3;1;1;0;6;0;0;2;1;3;3
22801.0;2023;70;NORMANDIE;FEMININ;SCOLAIRE;BAC PROFESSIONNEL;BAC PRO PROD;BAC PRO 25408 REPARATION DES CARROSSERIES;2;2;2;0;0;0;0;2;0;0;1;0;1;0
22805.0;2023;70;NORMANDIE;FEMININ;SCOLAIRE;BAC PROFESSIONNEL;BAC PRO PROD;BAC PRO 25513 SYST.NUM.OPT.A SURETE SECURITE;1;1;0;1;0;0;0;0;0;0;0;0;0;1
22809.0;2023;70;NORMANDIE;FEMININ;SCOLAIRE;BAC PROFESSIONNEL;BAC PRO PROD;BAC PRO AG 21004 CGEA;126;125;86;39;0;0;0;86;0;0;11;21;54;39
22812.0;2023;70;NORMANDIE;FEMININ;SCOLAIRE;BAC PROFESSIONNEL;BAC PRO PROD;BAC PRO AG 21210 COND GEST ENTR CANIN ET FELIN;57;57;53;4;0;0;0;53;0;2;6;15;30;4
22815.0;2023;70;NORMANDIE;FEMININ;SCOLAIRE;BAC PROFESSIONNEL;BAC PRO PROD;BAC PRO AG 21303 FORET;4;4;3;1;0;0;0;3;0;0;0;1;2;1
22816.0;2023;70;NORMANDIE;FEMININ;SCOLAIRE;BAC PROFESSIONNEL;BAC PRO PROD;BAC PRO AG 21405 AMENAGEMENTS PAYSAGERS;7;6;4;2;0;0;0;4;0;0;0;1;3;2
22817.0;2023;70;NORMANDIE;FEMININ;SCOLAIRE;BAC PROFESSIONNEL;BAC PRO PROD;BAC PRO AG 21407 TEC CONS VTE UNIVERS JARDINERIE;10;9;7;2;0;0;0;7;0;0;1;2;4;2
22821.0;2023;70;NORMANDIE;FEMININ;SCOLAIRE;BAC PROFESSIONNEL;BAC PRO SERV;BAC PRO 31106 LOGISTIQUE;55;55;41;8;6;5;1;46;0;2;9;11;24;9
22829.0;2023;70;NORMANDIE;FEMININ;SCOLAIRE;BAC PROFESSIONNEL;BAC PRO SERV;BAC PRO 32303 ART.& MET.ART:COM.VIS.VIS.PLURI-M;38;38;32;6;0;0;0;32;0;1;10;13;8;6
22831.0;2023;70;NORMANDIE;FEMININ;SCOLAIRE;BAC PROFESSIONNEL;BAC PRO SERV;BAC PRO 33003 ACC.SOINS-S.PERS. OPT.A DOMICILE;114;114;99;10;5;5;0;104;0;6;15;35;48;10
22835.0;2023;70;NORMANDIE;FEMININ;SCOLAIRE;BAC PROFESSIONNEL;BAC PRO SERV;BAC PRO 33104 TECHNICIEN EN PROTHESE DENTAIRE;10;10;9;0;1;1;0;10;0;1;1;6;2;0
22842.0;2023;70;NORMANDIE;FEMININ;SCOLAIRE;BAC PROFESSIONNEL;BAC PRO SERV;BAC PRO 34403 METIERS DE LA SECURITE;36;36;32;2;2;0;2;32;0;4;11;10;7;4
22846.0;2023;70;NORMANDIE;FEMININ;SCOLAIRE;BAC TECHNOLOGIQUE;BAC ST2S;BAC ST2S SCIENCES & TECHNO. SANTE & SOCIAL;882;882;716;25;141;96;45;812;3;14;111;265;419;70
22849.0;2023;70;NORMANDIE;FEMININ;SCOLAIRE;BAC TECHNOLOGIQUE;BAC STHR;BAC STHR SC.&TEC. HOTELLERIE-RESTAURATION;50;50;46;1;3;2;1;48;0;2;12;19;15;2
22855.0;2023;70;NORMANDIE;FEMININ;SCOLAIRE;BAC TECHNOLOGIQUE;BAC STL;BAC STL SCIENCES PHYSIQUES CHIMIQUES  EN LABORAT.;51;51;40;1;10;6;4;46;0;3;9;16;18;5
22857.0;2023;70;NORMANDIE;FEMININ;SCOLAIRE;BAC TECHNOLOGIQUE;BAC STMG;BAC STMG MERCATIQUE (MARKETING);917;917;687;52;178;130;48;817;0;7;83;224;503;100
22858.0;2023;70;NORMANDIE;FEMININ;SCOLAIRE;BAC TECHNOLOGIQUE;BAC STMG;BAC STMG RESSOURCES HUMAINES ET COMMUNICATION;738;738;540;57;141;97;44;637;0;5;38;162;432;101
22865.0;2023;70;NORMANDIE;MASCULIN;APPRENTISSAGE;BAC PROFESSIONNEL;BAC PRO PROD;BAC PRO 22704 TECHN. MAINT. SYST.ENERG.CLIMATI;21;21;15;4;2;1;1;16;0;3;1;7;5;5
22880.0;2023;70;NORMANDIE;MASCULIN;APPRENTISSAGE;BAC PROFESSIONNEL;BAC PRO PROD;BAC PRO 25107 TECHNICIEN OUTILLEUR;15;15;12;2;1;1;0;13;0;0;2;8;3;2
22882.0;2023;70;NORMANDIE;MASCULIN;APPRENTISSAGE;BAC PROFESSIONNEL;BAC PRO PROD;BAC PRO 25215 MAINT.VEHIC.OPTB VEHIC.TRANS.ROUT;37;36;33;2;1;1;0;34;0;7;6;14;7;2
22886.0;2023;70;NORMANDIE;MASCULIN;APPRENTISSAGE;BAC PROFESSIONNEL;BAC PRO PROD;BAC PRO 25221 MAINT.MATERIELS OPT.C ESP. VERTS;4;4;1;1;2;2;0;3;0;0;0;0;3;1
22893.0;2023;70;NORMANDIE;MASCULIN;APPRENTISSAGE;BAC PROFESSIONNEL;BAC PRO PROD;BAC PRO 25513 SYST.NUM.OPT.A SURETE SECURITE;5;5;5;0;0;0;0;5;0;0;1;3;1;0
22903.0;2023;70;NORMANDIE;MASCULIN;APPRENTISSAGE;BAC PROFESSIONNEL;BAC PRO PROD;BAC PRO AG 21405 AMENAGEMENTS PAYSAGERS;84;83;68;15;0;0;0;68;0;0;9;30;29;15
22904.0;2023;70;NORMANDIE;MASCULIN;APPRENTISSAGE;BAC PROFESSIONNEL;BAC PRO SERV;BAC PRO 30004 ASSISTANC.GEST.ORGANIS.ACTIVITES;4;4;4;0;0;0;0;4;0;0;1;2;1;0
22909.0;2023;70;NORMANDIE;MASCULIN;APPRENTISSAGE;BAC PROFESSIONNEL;BAC PRO SERV;BAC PRO 32208 REAL.PR.IMPR.PLURI.OPTB.PR.IMPR.;4;4;4;0;0;0;0;4;0;1;0;3;0;0
22910.0;2023;70;NORMANDIE;MASCULIN;APPRENTISSAGE;BAC PROFESSIONNEL;BAC PRO SERV;BAC PRO 33403 COMMERC. SERVICES EN RESTAURATION;8;8;5;2;1;0;1;5;0;0;1;3;1;3
22912.0;2023;70;NORMANDIE;MASCULIN;APPRENTISSAGE;BAC PROFESSIONNEL;BAC PRO SERV;BAC PRO AG 33002 SERV PERS TERRIT;5;5;4;1;0;0;0;4;0;0;0;0;4;1
22917.0;2023;70;NORMANDIE;MASCULIN;ENSEIGNEMENT A DISTANCE;BAC TECHNOLOGIQUE;BAC STMG;BAC STMG GESTION ET FINANCE;1;1;0;1;0;0;0;0;0;0;0;0;0;1
22918.0;2023;70;NORMANDIE;MASCULIN;ENSEIGNEMENT A DISTANCE;BAC TECHNOLOGIQUE;BAC STMG;BAC STMG MERCATIQUE (MARKETING);6;6;2;3;1;1;0;3;0;0;0;1;2;3
22936.0;2023;70;NORMANDIE;MASCULIN;FORMATION CONTINUE;BAC PROFESSIONNEL;BAC PRO SERV;BAC PRO 34303 GEST. POLLUTIONS PROTEC. ENVIRON.;1;1;1;0;0;0;0;1;0;0;1;0;0;0
22941.0;2023;70;NORMANDIE;MASCULIN;INDIVIDUEL;BAC PROFESSIONNEL;BAC PRO PROD;BAC PRO 23404 TECHNICIEN CONSTRUCTEUR BOIS;1;1;1;0;0;0;0;1;0;0;0;0;1;0
22944.0;2023;70;NORMANDIE;MASCULIN;INDIVIDUEL;BAC PROFESSIONNEL;BAC PRO PROD;BAC PRO 25214 MAINT.VEHIC.OPTA VOIT.PARTICUL.;2;1;1;0;0;0;0;1;0;0;0;0;1;0
22946.0;2023;70;NORMANDIE;MASCULIN;INDIVIDUEL;BAC PROFESSIONNEL;BAC PRO PROD;BAC PRO 25510 METIERS ELECT. ENVIRON. CONNECTES;4;2;0;1;1;1;0;1;0;0;0;0;1;1
22951.0;2023;70;NORMANDIE;MASCULIN;INDIVIDUEL;BAC PROFESSIONNEL;BAC PRO PROD;BAC PRO AG 21405 AMENAGEMENTS PAYSAGERS;1;1;0;1;0;0;0;0;0;0;0;0;0;1
22958.0;2023;70;NORMANDIE;MASCULIN;INDIVIDUEL;BAC PROFESSIONNEL;BAC PRO SERV;BAC PRO 32304 PHOTOGRAPHIE;1;1;1;0;0;0;0;1;0;0;0;0;1;0
22966.0;2023;70;NORMANDIE;MASCULIN;INDIVIDUEL;BAC TECHNOLOGIQUE;BAC STI2D;BAC STI2D SYSTÈME D'INFORMATION  ET NUMERIQUE;2;2;0;2;0;0;0;0;0;0;0;0;0;2
22967.0;2023;70;NORMANDIE;MASCULIN;INDIVIDUEL;BAC TECHNOLOGIQUE;BAC STL;BAC STL BIOCHIM.-BIOLOGIE-BIOTECHNOL.;1;1;0;0;1;0;1;0;0;0;0;0;0;1
22968.0;2023;70;NORMANDIE;MASCULIN;INDIVIDUEL;BAC TECHNOLOGIQUE;BAC STMG;BAC STMG GESTION ET FINANCE;4;4;0;3;1;1;0;1;0;0;0;0;1;3
22969.0;2023;70;NORMANDIE;MASCULIN;INDIVIDUEL;BAC TECHNOLOGIQUE;BAC STMG;BAC STMG MERCATIQUE (MARKETING);12;12;2;8;2;2;0;4;0;0;0;0;4;8
22970.0;2023;70;NORMANDIE;MASCULIN;INDIVIDUEL;BAC TECHNOLOGIQUE;BAC STMG;BAC STMG RESSOURCES HUMAINES ET COMMUNICATION;7;7;1;5;1;0;1;1;0;0;0;0;1;6
22974.0;2023;70;NORMANDIE;MASCULIN;SCOLAIRE;BAC PROFESSIONNEL;BAC PRO PROD;BAC PRO 22003 BIO-INDUSTRIES DE TRANSFORMATION;5;5;5;0;0;0;0;5;0;0;0;1;4;0
22978.0;2023;70;NORMANDIE;MASCULIN;SCOLAIRE;BAC PROFESSIONNEL;BAC PRO PROD;BAC PRO 22303 FONDERIE;4;4;3;1;0;0;0;3;0;0;1;0;2;1
22979.0;2023;70;NORMANDIE;MASCULIN;SCOLAIRE;BAC PROFESSIONNEL;BAC PRO PROD;BAC PRO 22503 PLASTIQUES ET COMPOSITES;13;13;10;2;1;1;0;11;0;0;2;3;6;2
22983.0;2023;70;NORMANDIE;MASCULIN;SCOLAIRE;BAC PROFESSIONNEL;BAC PRO PROD;BAC PRO 23004 TECHN. ETUDES BAT.A ETUDES & ECO.;75;75;46;29;0;0;0;46;0;0;5;14;27;29
22988.0;2023;70;NORMANDIE;MASCULIN;SCOLAIRE;BAC PROFESSIONNEL;BAC PRO PROD;BAC PRO 23205 INTERV. SUR PATRIMOINE BATI OPT.A;6;6;4;1;1;0;1;4;0;1;0;1;2;2
22989.0;2023;70;NORMANDIE;MASCULIN;SCOLAIRE;BAC PROFESSIONNEL;BAC PRO PROD;BAC PRO 23303 MENUISERIE ALUMINIUM-VERRE;10;10;4;6;0;0;0;4;0;0;1;1;2;6
22990.0;2023;70;NORMANDIE;MASCULIN;SCOLAIRE;BAC PROFESSIONNEL;BAC PRO PROD;BAC PRO 23304 AMENAGEMENT FINITION BATIMENT;12;11;5;5;1;1;0;6;0;0;0;1;5;5
22991.0;2023;70;NORMANDIE;MASCULIN;SCOLAIRE;BAC PROFESSIONNEL;BAC PRO PROD;BAC PRO 23404 TECHNICIEN CONSTRUCTEUR BOIS;54;54;41;12;1;1;0;42;0;5;6;15;16;12
22997.0;2023;70;NORMANDIE;MASCULIN;SCOLAIRE;BAC PROFESSIONNEL;BAC PRO PROD;BAC PRO 25006 MICROTECHNIQUES;36;36;35;1;0;0;0;35;0;3;11;12;9;1
23007.0;2023;70;NORMANDIE;MASCULIN;SCOLAIRE;BAC PROFESSIONNEL;BAC PRO PROD;BAC PRO 25221 MAINT.MATERIELS OPT.C ESP. VERTS;12;12;8;2;2;2;0;10;0;0;1;6;3;2
23009.0;2023;70;NORMANDIE;MASCULIN;SCOLAIRE;BAC PROFESSIONNEL;BAC PRO PROD;BAC PRO 25406 OUVRAGES DU BATIMENT METALLERIE;27;27;21;6;0;0;0;21;0;2;4;7;8;6
23023.0;2023;70;NORMANDIE;MASCULIN;SCOLAIRE;BAC PROFESSIONNEL;BAC PRO PROD;BAC PRO AG 21211 COND GEST ENTR HIPPIQUE;5;5;5;0;0;0;0;5;0;0;0;2;3;0
23027.0;2023;70;NORMANDIE;MASCULIN;SCOLAIRE;BAC PROFESSIONNEL;BAC PRO PROD;BAC PRO AG 21407 TEC CONS VTE UNIVERS JARDINERIE;6;6;6;0;0;0;0;6;0;0;0;4;2;0
23029.0;2023;70;NORMANDIE;MASCULIN;SCOLAIRE;BAC PROFESSIONNEL;BAC PRO PROD;BAC PRO AG 22108 TEC CONS VTE ALIMENTATION (PAB);18;18;17;1;0;0;0;17;0;0;0;6;11;1
23031.0;2023;70;NORMANDIE;MASCULIN;SCOLAIRE;BAC PROFESSIONNEL;BAC PRO SERV;BAC PRO 31106 LOGISTIQUE;145;145;97;35;13;8;5;105;0;4;19;25;57;40
23036.0;2023;70;NORMANDIE;MASCULIN;SCOLAIRE;BAC PROFESSIONNEL;BAC PRO SERV;BAC PRO 31214 MET.COM.VEN.OP.B PR.CL.VA.OF.COM.;160;160;134;22;4;4;0;138;0;10;21;55;52;22
23037.0;2023;70;NORMANDIE;MASCULIN;SCOLAIRE;BAC PROFESSIONNEL;BAC PRO SERV;BAC PRO 32207 REAL.PR.IMPR.PLURI.OPTA.PR.GRAPH.;14;14;13;1;0;0;0;13;0;1;2;6;4;1
23039.0;2023;70;NORMANDIE;MASCULIN;SCOLAIRE;BAC PROFESSIONNEL;BAC PRO SERV;BAC PRO 32303 ART.& MET.ART:COM.VIS.VIS.PLURI-M;15;15;13;2;0;0;0;13;0;1;2;5;5;2
23040.0;2023;70;NORMANDIE;MASCULIN;SCOLAIRE;BAC PROFESSIONNEL;BAC PRO SERV;BAC PRO 32304 PHOTOGRAPHIE;6;6;4;2;0;0;0;4;0;0;1;2;1;2
23045.0;2023;70;NORMANDIE;MASCULIN;SCOLAIRE;BAC PROFESSIONNEL;BAC PRO SERV;BAC PRO 33104 TECHNICIEN EN PROTHESE DENTAIRE;3;3;3;0;0;0;0;3;0;0;0;0;3;0
23052.0;2023;70;NORMANDIE;MASCULIN;SCOLAIRE;BAC PROFESSIONNEL;BAC PRO SERV;BAC PRO AG 33002 SERV PERS TERRIT;24;23;21;2;0;0;0;21;0;0;1;7;13;2
23057.0;2023;70;NORMANDIE;MASCULIN;SCOLAIRE;BAC TECHNOLOGIQUE;BAC STD2A;BAC STD2A SCIENCES & TECHNO. DESIGN-ARTS APPLIQUES;20;20;20;0;0;0;0;20;0;1;7;10;2;0
23061.0;2023;70;NORMANDIE;MASCULIN;SCOLAIRE;BAC TECHNOLOGIQUE;BAC STI2D;BAC STI2D INNOVATION TECHNO.  ET ECO CONCEPTION;483;483;414;15;54;32;22;446;1;21;74;168;182;37
23068.0;2023;70;NORMANDIE;MASCULIN;SCOLAIRE;BAC TECHNOLOGIQUE;BAC STMG;BAC STMG SYSTEMES D'INFORMATION DE GESTION;27;27;19;4;4;4;0;23;0;0;3;7;13;4
23075.0;2023;18;ORLEANS-TOURS;FEMININ;APPRENTISSAGE;BAC PROFESSIONNEL;BAC PRO PROD;BAC PRO 25214 MAINT.VEHIC.OPTA VOIT.PARTICUL.;7;7;7;0;0;0;0;7;0;3;0;3;1;0
23077.0;2023;18;ORLEANS-TOURS;FEMININ;APPRENTISSAGE;BAC PROFESSIONNEL;BAC PRO PROD;BAC PRO 25219 MAINT.MATERIELS OPT.A AGRICOLES;1;1;0;0;1;1;0;1;0;0;0;0;1;0
23080.0;2023;18;ORLEANS-TOURS;FEMININ;APPRENTISSAGE;BAC PROFESSIONNEL;BAC PRO PROD;BAC PRO AG 21114 CONDUITE PRODUCTIONS HORTICOLES;9;9;9;0;0;0;0;9;0;0;0;1;8;0
23081.0;2023;18;ORLEANS-TOURS;FEMININ;APPRENTISSAGE;BAC PROFESSIONNEL;BAC PRO PROD;BAC PRO AG 21203 TECHN CONSEIL DE VENTE ANIMAL;5;5;4;1;0;0;0;4;0;0;1;0;3;1
23082.0;2023;18;ORLEANS-TOURS;FEMININ;APPRENTISSAGE;BAC PROFESSIONNEL;BAC PRO PROD;BAC PRO AG 21211 COND GEST ENTR HIPPIQUE;5;4;2;2;0;0;0;2;0;0;0;0;2;2
23083.0;2023;18;ORLEANS-TOURS;FEMININ;APPRENTISSAGE;BAC PROFESSIONNEL;BAC PRO PROD;BAC PRO AG 21302 GEST MILIEUX NATURELS FAUNE;1;1;1;0;0;0;0;1;0;0;0;1;0;0
23086.0;2023;18;ORLEANS-TOURS;FEMININ;APPRENTISSAGE;BAC PROFESSIONNEL;BAC PRO SERV;BAC PRO 30004 ASSISTANC.GEST.ORGANIS.ACTIVITES;10;10;10;0;0;0;0;10;0;2;3;5;0;0
23096.0;2023;18;ORLEANS-TOURS;FEMININ;APPRENTISSAGE;BAC PROFESSIONNEL;BAC PRO SERV;BAC PRO 34304 HYGIENE PROPRETE STERILISATION;6;6;5;0;1;1;0;6;0;2;0;0;4;0
23100.0;2023;18;ORLEANS-TOURS;FEMININ;ENSEIGNEMENT A DISTANCE;BAC TECHNOLOGIQUE;BAC STMG;BAC STMG MERCATIQUE (MARKETING);8;8;4;2;2;2;0;6;0;0;0;1;5;2
23105.0;2023;18;ORLEANS-TOURS;FEMININ;FORMATION CONTINUE;BAC PROFESSIONNEL;BAC PRO PROD;BAC PRO 25108 TECHNICIEN MODELEUR;1;1;1;0;0;0;0;1;0;1;0;0;0;0
23112.0;2023;18;ORLEANS-TOURS;FEMININ;INDIVIDUEL;BAC GENERAL;BAC GENERAL;BAC GENE 10019 BAC GENERAL;50;49;13;26;10;3;7;16;0;1;1;3;11;33
23117.0;2023;18;ORLEANS-TOURS;FEMININ;INDIVIDUEL;BAC PROFESSIONNEL;BAC PRO PROD;BAC PRO AG 21210 COND GEST ENTR CANIN ET FELIN;1;0;0;0;0;0;0;0;0;0;0;0;0;0
23119.0;2023;18;ORLEANS-TOURS;FEMININ;INDIVIDUEL;BAC PROFESSIONNEL;BAC PRO PROD;BAC PRO AG 21302 GEST MILIEUX NATURELS FAUNE;2;2;2;0;0;0;0;2;0;0;0;0;2;0
23120.0;2023;18;ORLEANS-TOURS;FEMININ;INDIVIDUEL;BAC PROFESSIONNEL;BAC PRO SERV;BAC PRO 30004 ASSISTANC.GEST.ORGANIS.ACTIVITES;11;3;1;1;1;0;1;1;0;0;0;0;1;2
23126.0;2023;18;ORLEANS-TOURS;FEMININ;INDIVIDUEL;BAC PROFESSIONNEL;BAC PRO SERV;BAC PRO 33006 ANIMAT. ENFANCE& PERSONNES AGEES;1;1;1;0;0;0;0;1;0;0;0;1;0;0
23132.0;2023;18;ORLEANS-TOURS;FEMININ;INDIVIDUEL;BAC TECHNOLOGIQUE;BAC STMG;BAC STMG MERCATIQUE (MARKETING);9;9;1;6;2;2;0;3;0;0;0;0;3;6
23133.0;2023;18;ORLEANS-TOURS;FEMININ;INDIVIDUEL;BAC TECHNOLOGIQUE;BAC STMG;BAC STMG RESSOURCES HUMAINES ET COMMUNICATION;7;7;2;4;1;1;0;3;0;0;0;1;2;4
23136.0;2023;18;ORLEANS-TOURS;FEMININ;SCOLAIRE;BAC PROFESSIONNEL;BAC PRO PROD;BAC PRO 20102 PILOTE DE LIGNE DE PRODUCTION;1;1;1;0;0;0;0;1;0;0;0;1;0;0
23145.0;2023;18;ORLEANS-TOURS;FEMININ;SCOLAIRE;BAC PROFESSIONNEL;BAC PRO PROD;BAC PRO 23102 TRAVAUX PUBLICS;1;1;1;0;0;0;0;1;0;0;0;0;1;0
23148.0;2023;18;ORLEANS-TOURS;FEMININ;SCOLAIRE;BAC PROFESSIONNEL;BAC PRO PROD;BAC PRO 23304 AMENAGEMENT FINITION BATIMENT;11;11;9;1;1;0;1;9;0;1;3;4;1;2
23153.0;2023;18;ORLEANS-TOURS;FEMININ;SCOLAIRE;BAC PROFESSIONNEL;BAC PRO PROD;BAC PRO 24302 METIERS DU CUIR : MAROQUINERIE;15;15;8;6;1;1;0;9;0;0;2;4;3;6
23155.0;2023;18;ORLEANS-TOURS;FEMININ;SCOLAIRE;BAC PROFESSIONNEL;BAC PRO PROD;BAC PRO 25007 MAINTENANCE EQUIPEMENTS INDUST.;4;4;3;1;0;0;0;3;0;0;1;1;1;1
23157.0;2023;18;ORLEANS-TOURS;FEMININ;SCOLAIRE;BAC PROFESSIONNEL;BAC PRO PROD;BAC PRO 25107 TECHNICIEN OUTILLEUR;1;1;1;0;0;0;0;1;0;0;0;0;1;0
23162.0;2023;18;ORLEANS-TOURS;FEMININ;SCOLAIRE;BAC PROFESSIONNEL;BAC PRO PROD;BAC PRO 25411 TECH.CHAUDRONNERIE INDUSTRIELLE;10;10;10;0;0;0;0;10;0;1;3;1;5;0
23164.0;2023;18;ORLEANS-TOURS;FEMININ;SCOLAIRE;BAC PROFESSIONNEL;BAC PRO PROD;BAC PRO 25510 METIERS ELECT. ENVIRON. CONNECTES;6;6;3;3;0;0;0;3;0;0;1;1;1;3
23181.0;2023;18;ORLEANS-TOURS;FEMININ;SCOLAIRE;BAC PROFESSIONNEL;BAC PRO SERV;BAC PRO 30004 ASSISTANC.GEST.ORGANIS.ACTIVITES;414;413;317;76;20;12;8;329;0;9;52;125;143;84
23182.0;2023;18;ORLEANS-TOURS;FEMININ;SCOLAIRE;BAC PROFESSIONNEL;BAC PRO SERV;BAC PRO 31106 LOGISTIQUE;26;26;16;8;2;0;2;16;0;0;4;4;8;10
23184.0;2023;18;ORLEANS-TOURS;FEMININ;SCOLAIRE;BAC PROFESSIONNEL;BAC PRO SERV;BAC PRO 31114 ORGANIS. TRANSPORT MARCHANDISES;4;4;4;0;0;0;0;4;0;1;0;0;3;0
23185.0;2023;18;ORLEANS-TOURS;FEMININ;SCOLAIRE;BAC PROFESSIONNEL;BAC PRO SERV;BAC PRO 31212 METIERS DE L'ACCUEIL;184;184;147;16;21;11;10;158;0;6;22;49;81;26
23187.0;2023;18;ORLEANS-TOURS;FEMININ;SCOLAIRE;BAC PROFESSIONNEL;BAC PRO SERV;BAC PRO 31214 MET.COM.VEN.OP.B PR.CL.VA.OF.COM.;148;148;133;12;3;3;0;136;0;9;24;64;39;12
23194.0;2023;18;ORLEANS-TOURS;FEMININ;SCOLAIRE;BAC PROFESSIONNEL;BAC PRO SERV;BAC PRO 33006 ANIMAT. ENFANCE& PERSONNES AGEES;58;58;52;4;2;1;1;53;0;7;20;13;13;5
23198.0;2023;18;ORLEANS-TOURS;FEMININ;SCOLAIRE;BAC PROFESSIONNEL;BAC PRO SERV;BAC PRO 33604 METIERS DE LA COIFFURE;18;18;13;3;2;2;0;15;0;0;3;6;6;3
23199.0;2023;18;ORLEANS-TOURS;FEMININ;SCOLAIRE;BAC PROFESSIONNEL;BAC PRO SERV;BAC PRO 34304 HYGIENE PROPRETE STERILISATION;6;6;1;4;1;0;1;1;0;0;0;0;1;5
23201.0;2023;18;ORLEANS-TOURS;FEMININ;SCOLAIRE;BAC PROFESSIONNEL;BAC PRO SERV;BAC PRO AG 33002 SERV PERS TERRIT;228;222;198;24;0;0;0;198;0;7;25;65;101;24
23212.0;2023;18;ORLEANS-TOURS;FEMININ;SCOLAIRE;BAC TECHNOLOGIQUE;BAC STL;BAC STL BIOCHIM.-BIOLOGIE-BIOTECHNOL.;100;100;88;3;9;3;6;91;0;6;16;31;38;9
23214.0;2023;18;ORLEANS-TOURS;FEMININ;SCOLAIRE;BAC TECHNOLOGIQUE;BAC STMG;BAC STMG GESTION ET FINANCE;265;265;218;11;36;22;14;240;0;6;34;81;119;25
23216.0;2023;18;ORLEANS-TOURS;FEMININ;SCOLAIRE;BAC TECHNOLOGIQUE;BAC STMG;BAC STMG RESSOURCES HUMAINES ET COMMUNICATION;510;510;386;26;98;68;30;454;0;6;37;121;290;56
23219.0;2023;18;ORLEANS-TOURS;MASCULIN;APPRENTISSAGE;BAC PROFESSIONNEL;BAC PRO PROD;BAC PRO 22106 CUISINE;11;11;6;1;4;3;1;9;0;0;3;2;4;2
23221.0;2023;18;ORLEANS-TOURS;MASCULIN;APPRENTISSAGE;BAC PROFESSIONNEL;BAC PRO PROD;BAC PRO 22704 TECHN. MAINT. SYST.ENERG.CLIMATI;7;7;5;2;0;0;0;5;0;1;2;1;1;2
23224.0;2023;18;ORLEANS-TOURS;MASCULIN;APPRENTISSAGE;BAC PROFESSIONNEL;BAC PRO PROD;BAC PRO 23203 TECHNICIEN BAT. : ORG.REAL.GROS O;9;9;8;0;1;1;0;9;0;1;1;2;5;0
23225.0;2023;18;ORLEANS-TOURS;MASCULIN;APPRENTISSAGE;BAC PROFESSIONNEL;BAC PRO PROD;BAC PRO 23205 INTERV. SUR PATRIMOINE BATI OPT.A;5;5;3;2;0;0;0;3;0;0;1;2;0;2
23236.0;2023;18;ORLEANS-TOURS;MASCULIN;APPRENTISSAGE;BAC PROFESSIONNEL;BAC PRO PROD;BAC PRO 25215 MAINT.VEHIC.OPTB VEHIC.TRANS.ROUT;22;21;17;3;1;1;0;18;0;0;2;8;8;3
23243.0;2023;18;ORLEANS-TOURS;MASCULIN;APPRENTISSAGE;BAC PROFESSIONNEL;BAC PRO PROD;BAC PRO 25411 TECH.CHAUDRONNERIE INDUSTRIELLE;18;18;13;5;0;0;0;13;0;0;2;7;4;5
23247.0;2023;18;ORLEANS-TOURS;MASCULIN;APPRENTISSAGE;BAC PROFESSIONNEL;BAC PRO PROD;BAC PRO 25515 SYST.NUM.OPT.C RES.INF.SYST.COMM.;7;7;7;0;0;0;0;7;0;2;2;3;0;0
23254.0;2023;18;ORLEANS-TOURS;MASCULIN;APPRENTISSAGE;BAC PROFESSIONNEL;BAC PRO PROD;BAC PRO AG 21303 FORET;14;14;14;0;0;0;0;14;0;1;2;2;9;0
23256.0;2023;18;ORLEANS-TOURS;MASCULIN;APPRENTISSAGE;BAC PROFESSIONNEL;BAC PRO PROD;BAC PRO AG 22108 TEC CONS VTE ALIMENTATION (PAB);6;5;4;1;0;0;0;4;0;0;0;1;3;1
23257.0;2023;18;ORLEANS-TOURS;MASCULIN;APPRENTISSAGE;BAC PROFESSIONNEL;BAC PRO SERV;BAC PRO 30004 ASSISTANC.GEST.ORGANIS.ACTIVITES;4;4;3;1;0;0;0;3;0;0;1;1;1;1
23259.0;2023;18;ORLEANS-TOURS;MASCULIN;APPRENTISSAGE;BAC PROFESSIONNEL;BAC PRO SERV;BAC PRO 31212 METIERS DE L'ACCUEIL;1;1;1;0;0;0;0;1;0;0;0;1;0;0
23266.0;2023;18;ORLEANS-TOURS;MASCULIN;ENSEIGNEMENT A DISTANCE;BAC GENERAL;BAC GENERAL;BAC GENE 10019 BAC GENERAL;23;23;14;4;5;4;1;18;0;0;2;4;12;5
23274.0;2023;18;ORLEANS-TOURS;MASCULIN;FORMATION CONTINUE;BAC PROFESSIONNEL;BAC PRO PROD;BAC PRO 23304 AMENAGEMENT FINITION BATIMENT;1;1;1;0;0;0;0;1;0;0;0;1;0;0
23288.0;2023;18;ORLEANS-TOURS;MASCULIN;INDIVIDUEL;BAC PROFESSIONNEL;BAC PRO PROD;BAC PRO 22106 CUISINE;1;1;0;1;0;0;0;0;0;0;0;0;0;1
23291.0;2023;18;ORLEANS-TOURS;MASCULIN;INDIVIDUEL;BAC PROFESSIONNEL;BAC PRO PROD;BAC PRO 25007 MAINTENANCE EQUIPEMENTS INDUST.;3;2;0;2;0;0;0;0;0;0;0;0;0;2
23293.0;2023;18;ORLEANS-TOURS;MASCULIN;INDIVIDUEL;BAC PROFESSIONNEL;BAC PRO PROD;BAC PRO 25214 MAINT.VEHIC.OPTA VOIT.PARTICUL.;3;3;2;0;1;1;0;3;0;0;0;1;2;0
23299.0;2023;18;ORLEANS-TOURS;MASCULIN;INDIVIDUEL;BAC PROFESSIONNEL;BAC PRO PROD;BAC PRO AG 21114 CONDUITE PRODUCTIONS HORTICOLES;5;5;5;0;0;0;0;5;0;0;0;0;5;0
23300.0;2023;18;ORLEANS-TOURS;MASCULIN;INDIVIDUEL;BAC PROFESSIONNEL;BAC PRO PROD;BAC PRO AG 21211 COND GEST ENTR HIPPIQUE;2;1;1;0;0;0;0;1;0;0;0;0;1;0
23302.0;2023;18;ORLEANS-TOURS;MASCULIN;INDIVIDUEL;BAC PROFESSIONNEL;BAC PRO PROD;BAC PRO AG 21407 TEC CONS VTE UNIVERS JARDINERIE;1;1;0;1;0;0;0;0;0;0;0;0;0;1
23303.0;2023;18;ORLEANS-TOURS;MASCULIN;INDIVIDUEL;BAC PROFESSIONNEL;BAC PRO SERV;BAC PRO 30004 ASSISTANC.GEST.ORGANIS.ACTIVITES;4;4;1;1;2;1;1;2;0;0;0;0;2;2
23304.0;2023;18;ORLEANS-TOURS;MASCULIN;INDIVIDUEL;BAC PROFESSIONNEL;BAC PRO SERV;BAC PRO 31114 ORGANIS. TRANSPORT MARCHANDISES;1;0;0;0;0;0;0;0;0;0;0;0;0;0
23305.0;2023;18;ORLEANS-TOURS;MASCULIN;INDIVIDUEL;BAC PROFESSIONNEL;BAC PRO SERV;BAC PRO 31212 METIERS DE L'ACCUEIL;1;1;1;0;0;0;0;1;0;0;0;0;1;0
23307.0;2023;18;ORLEANS-TOURS;MASCULIN;INDIVIDUEL;BAC PROFESSIONNEL;BAC PRO SERV;BAC PRO 31214 MET.COM.VEN.OP.B PR.CL.VA.OF.COM.;6;5;1;3;1;0;1;1;0;0;0;0;1;4
23320.0;2023;18;ORLEANS-TOURS;MASCULIN;SCOLAIRE;BAC PROFESSIONNEL;BAC PRO PROD;BAC PRO 22003 BIO-INDUSTRIES DE TRANSFORMATION;13;12;5;6;1;1;0;6;0;0;1;1;4;6
23322.0;2023;18;ORLEANS-TOURS;MASCULIN;SCOLAIRE;BAC PROFESSIONNEL;BAC PRO PROD;BAC PRO 22106 CUISINE;113;113;96;15;2;2;0;98;0;4;20;39;35;15
23324.0;2023;18;ORLEANS-TOURS;MASCULIN;SCOLAIRE;BAC PROFESSIONNEL;BAC PRO PROD;BAC PRO 22403 ARTS.& MET.ART:MET.ENSEIGN SIGNA;8;8;8;0;0;0;0;8;0;0;1;6;1;0
23326.0;2023;18;ORLEANS-TOURS;MASCULIN;SCOLAIRE;BAC PROFESSIONNEL;BAC PRO PROD;BAC PRO 22703 TECHN.INSTALL.SYST.ENERG.CLIMATI;23;23;13;10;0;0;0;13;0;0;1;6;6;10
23330.0;2023;18;ORLEANS-TOURS;MASCULIN;SCOLAIRE;BAC PROFESSIONNEL;BAC PRO PROD;BAC PRO 23005 TECHN. ETUDES BAT B ASSIST.ARCHI.;36;36;28;8;0;0;0;28;0;0;5;11;12;8
23336.0;2023;18;ORLEANS-TOURS;MASCULIN;SCOLAIRE;BAC PROFESSIONNEL;BAC PRO PROD;BAC PRO 23303 MENUISERIE ALUMINIUM-VERRE;7;7;5;2;0;0;0;5;0;0;1;2;2;2
23340.0;2023;18;ORLEANS-TOURS;MASCULIN;SCOLAIRE;BAC PROFESSIONNEL;BAC PRO PROD;BAC PRO 23408 Etude et réalisation d'agencement;9;9;9;0;0;0;0;9;0;2;0;4;3;0
23342.0;2023;18;ORLEANS-TOURS;MASCULIN;SCOLAIRE;BAC PROFESSIONNEL;BAC PRO PROD;BAC PRO 24203 METIERS DE LA MODE - VÊTEMENT;6;6;5;1;0;0;0;5;0;2;1;1;1;1
23346.0;2023;18;ORLEANS-TOURS;MASCULIN;SCOLAIRE;BAC PROFESSIONNEL;BAC PRO PROD;BAC PRO 25007 MAINTENANCE EQUIPEMENTS INDUST.;223;222;131;81;10;8;2;139;0;4;18;54;63;83
23349.0;2023;18;ORLEANS-TOURS;MASCULIN;SCOLAIRE;BAC PROFESSIONNEL;BAC PRO PROD;BAC PRO 25108 TECHNICIEN MODELEUR;10;10;10;0;0;0;0;10;0;2;3;3;2;0
23350.0;2023;18;ORLEANS-TOURS;MASCULIN;SCOLAIRE;BAC PROFESSIONNEL;BAC PRO PROD;BAC PRO 25214 MAINT.VEHIC.OPTA VOIT.PARTICUL.;196;194;153;29;12;10;2;163;0;5;33;61;64;31
23356.0;2023;18;ORLEANS-TOURS;MASCULIN;SCOLAIRE;BAC PROFESSIONNEL;BAC PRO PROD;BAC PRO 25406 OUVRAGES DU BATIMENT METALLERIE;10;10;6;1;3;3;0;9;0;0;1;2;6;1
23365.0;2023;18;ORLEANS-TOURS;MASCULIN;SCOLAIRE;BAC PROFESSIONNEL;BAC PRO PROD;BAC PRO AG 21001 AGRO-EQUIPEMENT;28;28;26;2;0;0;0;26;0;0;3;9;14;2
23368.0;2023;18;ORLEANS-TOURS;MASCULIN;SCOLAIRE;BAC PROFESSIONNEL;BAC PRO PROD;BAC PRO AG 21114 CONDUITE PRODUCTIONS HORTICOLES;17;17;15;2;0;0;0;15;0;2;2;1;10;2
23369.0;2023;18;ORLEANS-TOURS;MASCULIN;SCOLAIRE;BAC PROFESSIONNEL;BAC PRO PROD;BAC PRO AG 21203 TECHN CONSEIL DE VENTE ANIMAL;22;22;20;2;0;0;0;20;0;0;2;9;9;2
23372.0;2023;18;ORLEANS-TOURS;MASCULIN;SCOLAIRE;BAC PROFESSIONNEL;BAC PRO PROD;BAC PRO AG 21302 GEST MILIEUX NATURELS FAUNE;36;36;34;2;0;0;0;34;0;0;5;12;17;2
23375.0;2023;18;ORLEANS-TOURS;MASCULIN;SCOLAIRE;BAC PROFESSIONNEL;BAC PRO PROD;BAC PRO AG 21407 TEC CONS VTE UNIVERS JARDINERIE;10;8;7;1;0;0;0;7;0;0;0;4;3;1
23379.0;2023;18;ORLEANS-TOURS;MASCULIN;SCOLAIRE;BAC PROFESSIONNEL;BAC PRO SERV;BAC PRO 31106 LOGISTIQUE;112;112;74;29;9;5;4;79;0;1;7;21;50;33
23382.0;2023;18;ORLEANS-TOURS;MASCULIN;SCOLAIRE;BAC PROFESSIONNEL;BAC PRO SERV;BAC PRO 31212 METIERS DE L'ACCUEIL;71;71;50;12;9;7;2;57;0;1;9;15;32;14
23387.0;2023;18;ORLEANS-TOURS;MASCULIN;SCOLAIRE;BAC PROFESSIONNEL;BAC PRO SERV;BAC PRO 32303 ART.& MET.ART:COM.VIS.VIS.PLURI-M;12;12;12;0;0;0;0;12;0;4;1;4;3;0
23391.0;2023;18;ORLEANS-TOURS;MASCULIN;SCOLAIRE;BAC PROFESSIONNEL;BAC PRO SERV;BAC PRO 33004 ACC.SOINS-S.PERS. OPT.EN STRUCTUR;21;21;17;2;2;2;0;19;0;0;4;8;7;2
23393.0;2023;18;ORLEANS-TOURS;MASCULIN;SCOLAIRE;BAC PROFESSIONNEL;BAC PRO SERV;BAC PRO 33104 TECHNICIEN EN PROTHESE DENTAIRE;2;2;2;0;0;0;0;2;0;0;1;1;0;0
23396.0;2023;18;ORLEANS-TOURS;MASCULIN;SCOLAIRE;BAC PROFESSIONNEL;BAC PRO SERV;BAC PRO 34304 HYGIENE PROPRETE STERILISATION;6;6;1;3;2;1;1;2;0;0;1;0;1;4
23408.0;2023;18;ORLEANS-TOURS;MASCULIN;SCOLAIRE;BAC TECHNOLOGIQUE;BAC STI2D;BAC STI2D INNOVATION TECHNO.  ET ECO CONCEPTION;349;349;310;9;30;19;11;329;0;13;47;126;143;20
23411.0;2023;18;ORLEANS-TOURS;MASCULIN;SCOLAIRE;BAC TECHNOLOGIQUE;BAC STL;BAC STL SCIENCES PHYSIQUES CHIMIQUES  EN LABORAT.;55;55;50;1;4;2;2;52;0;3;10;24;15;3
23413.0;2023;18;ORLEANS-TOURS;MASCULIN;SCOLAIRE;BAC TECHNOLOGIQUE;BAC STMG;BAC STMG MERCATIQUE (MARKETING);714;714;499;55;160;123;37;622;0;3;30;150;439;92
23423.0;2023;01;PARIS;FEMININ;APPRENTISSAGE;BAC PROFESSIONNEL;BAC PRO SERV;BAC PRO 30004 ASSISTANC.GEST.ORGANIS.ACTIVITES;21;21;17;3;1;1;0;18;0;2;2;10;4;3
23429.0;2023;01;PARIS;FEMININ;APPRENTISSAGE;BAC PROFESSIONNEL;BAC PRO SERV;BAC PRO 32208 REAL.PR.IMPR.PLURI.OPTB.PR.IMPR.;3;3;3;0;0;0;0;3;0;1;1;0;1;0
23430.0;2023;01;PARIS;FEMININ;APPRENTISSAGE;BAC PROFESSIONNEL;BAC PRO SERV;BAC PRO 33003 ACC.SOINS-S.PERS. OPT.A DOMICILE;15;15;9;5;1;1;0;10;0;1;0;1;8;5
23431.0;2023;01;PARIS;FEMININ;APPRENTISSAGE;BAC PROFESSIONNEL;BAC PRO SERV;BAC PRO 33101 OPTIQUE LUNETTERIE;12;12;7;3;2;0;2;7;0;0;1;4;2;5
23434.0;2023;01;PARIS;FEMININ;APPRENTISSAGE;BAC PROFESSIONNEL;BAC PRO SERV;BAC PRO 34403 METIERS DE LA SECURITE;1;1;1;0;0;0;0;1;0;0;0;1;0;0
23448.0;2023;01;PARIS;FEMININ;INDIVIDUEL;BAC PROFESSIONNEL;BAC PRO PROD;BAC PRO 25510 METIERS ELECT. ENVIRON. CONNECTES;1;1;1;0;0;0;0;1;0;1;0;0;0;0
23452.0;2023;01;PARIS;FEMININ;INDIVIDUEL;BAC PROFESSIONNEL;BAC PRO PROD;BAC PRO AG 21211 COND GEST ENTR HIPPIQUE;3;2;2;0;0;0;0;2;0;0;0;0;2;0
23481.0;2023;01;PARIS;FEMININ;SCOLAIRE;BAC PROFESSIONNEL;BAC PRO PROD;BAC PRO 23003 ARTIS. & M.ART:MARCHANDISAGE VIS.;21;21;16;5;0;0;0;16;0;0;3;6;7;5
23484.0;2023;01;PARIS;FEMININ;SCOLAIRE;BAC PROFESSIONNEL;BAC PRO PROD;BACPRO 23103 TECHNICIEN GEOMETRE-TOPOGRAPHE;2;2;1;1;0;0;0;1;0;0;0;1;0;1
23490.0;2023;01;PARIS;FEMININ;SCOLAIRE;BAC PROFESSIONNEL;BAC PRO PROD;BAC PRO 24302 METIERS DU CUIR : MAROQUINERIE;13;13;11;2;0;0;0;11;0;3;3;2;3;2
23494.0;2023;01;PARIS;FEMININ;SCOLAIRE;BAC PROFESSIONNEL;BAC PRO PROD;BAC PRO 25514 SYST.NUM.OPT.B AUD.RES.EQUIP.DOM.;1;1;1;0;0;0;0;1;0;0;0;1;0;0
23508.0;2023;01;PARIS;FEMININ;SCOLAIRE;BAC PROFESSIONNEL;BAC PRO SERV;BAC PRO 32304 PHOTOGRAPHIE;11;11;8;3;0;0;0;8;0;1;2;3;2;3
23509.0;2023;01;PARIS;FEMININ;SCOLAIRE;BAC PROFESSIONNEL;BAC PRO SERV;BAC PRO 33003 ACC.SOINS-S.PERS. OPT.A DOMICILE;34;34;14;17;3;2;1;16;0;0;3;8;5;18
23512.0;2023;01;PARIS;FEMININ;SCOLAIRE;BAC PROFESSIONNEL;BAC PRO SERV;BAC PRO 33101 OPTIQUE LUNETTERIE;11;11;8;3;0;0;0;8;0;0;3;2;3;3
23517.0;2023;01;PARIS;FEMININ;SCOLAIRE;BAC PROFESSIONNEL;BAC PRO SERV;BAC PRO 33603 ESTHETIQUE COSMETIQUE PARFUMERIE;66;66;51;12;3;2;1;53;0;3;6;20;24;13
23520.0;2023;01;PARIS;FEMININ;SCOLAIRE;BAC PROFESSIONNEL;BAC PRO SERV;BAC PRO 34403 METIERS DE LA SECURITE;28;28;23;3;2;1;1;24;0;1;5;14;4;4
23522.0;2023;01;PARIS;FEMININ;SCOLAIRE;BAC TECHNOLOGIQUE;BAC S2TMD;BAC S2TMD MUSIQUE;7;7;7;0;0;0;0;7;1;1;2;3;0;0
23527.0;2023;01;PARIS;FEMININ;SCOLAIRE;BAC TECHNOLOGIQUE;BAC STI2D;BAC STI2D ARCHITECTURE ET CONSTRUCTION;12;12;12;0;0;0;0;12;0;2;3;1;6;0
23541.0;2023;01;PARIS;MASCULIN;APPRENTISSAGE;BAC PROFESSIONNEL;BAC PRO PROD;BAC PRO 22704 TECHN. MAINT. SYST.ENERG.CLIMATI;40;40;31;5;4;2;2;33;0;1;10;8;14;7
23552.0;2023;01;PARIS;MASCULIN;APPRENTISSAGE;BAC PROFESSIONNEL;BAC PRO SERV;BAC PRO 31212 METIERS DE L'ACCUEIL;5;5;4;1;0;0;0;4;0;0;1;2;1;1
23560.0;2023;01;PARIS;MASCULIN;APPRENTISSAGE;BAC PROFESSIONNEL;BAC PRO SERV;BAC PRO 34403 METIERS DE LA SECURITE;11;11;6;4;1;1;0;7;0;1;1;4;1;4
23564.0;2023;01;PARIS;MASCULIN;ENSEIGNEMENT A DISTANCE;BAC TECHNOLOGIQUE;BAC STMG;BAC STMG GESTION ET FINANCE;1;1;1;0;0;0;0;1;0;0;0;1;0;0
23565.0;2023;01;PARIS;MASCULIN;ENSEIGNEMENT A DISTANCE;BAC TECHNOLOGIQUE;BAC STMG;BAC STMG MERCATIQUE (MARKETING);4;4;3;0;1;1;0;4;0;0;0;1;3;0
23569.0;2023;01;PARIS;MASCULIN;FORMATION CONTINUE;BAC PROFESSIONNEL;BAC PRO PROD;BAC PRO 25007 MAINTENANCE EQUIPEMENTS INDUST.;6;6;5;1;0;0;0;5;0;1;0;3;1;1
23584.0;2023;01;PARIS;MASCULIN;INDIVIDUEL;BAC PROFESSIONNEL;BAC PRO PROD;BAC PRO AG 21114 CONDUITE PRODUCTIONS HORTICOLES;3;3;3;0;0;0;0;3;0;0;0;0;3;0
23586.0;2023;01;PARIS;MASCULIN;INDIVIDUEL;BAC PROFESSIONNEL;BAC PRO SERV;BAC PRO 31106 LOGISTIQUE;1;0;0;0;0;0;0;0;0;0;0;0;0;0
23588.0;2023;01;PARIS;MASCULIN;INDIVIDUEL;BAC PROFESSIONNEL;BAC PRO SERV;BAC PRO 31213 MET.COM.VEN.OP.A ANI.GES.ESP.COM.;7;2;0;1;1;1;0;1;0;0;0;0;1;1
23591.0;2023;01;PARIS;MASCULIN;INDIVIDUEL;BAC PROFESSIONNEL;BAC PRO SERV;BAC PRO 34403 METIERS DE LA SECURITE;1;1;0;1;0;0;0;0;0;0;0;0;0;1
23604.0;2023;01;PARIS;MASCULIN;SCOLAIRE;BAC PROFESSIONNEL;BAC PRO PROD;BAC PRO 20102 PILOTE DE LIGNE DE PRODUCTION;6;6;4;2;0;0;0;4;0;0;0;2;2;2
23606.0;2023;01;PARIS;MASCULIN;SCOLAIRE;BAC PROFESSIONNEL;BAC PRO PROD;BAC PRO 22004 PROC. CHIMIE EAU PAPIERS-CARTONS;15;15;9;5;1;1;0;10;0;2;1;1;6;5
23609.0;2023;01;PARIS;MASCULIN;SCOLAIRE;BAC PROFESSIONNEL;BAC PRO PROD;BAC PRO 22402 ARTIS.& MET.ART:VERR.SCIENT.TECH;4;4;4;0;0;0;0;4;0;0;0;4;0;0
23620.0;2023;01;PARIS;MASCULIN;SCOLAIRE;BAC PROFESSIONNEL;BAC PRO PROD;BAC PRO 23304 AMENAGEMENT FINITION BATIMENT;11;11;9;2;0;0;0;9;0;0;1;2;6;2
23641.0;2023;01;PARIS;MASCULIN;SCOLAIRE;BAC PROFESSIONNEL;BAC PRO PROD;BAC PRO AG 21405 AMENAGEMENTS PAYSAGERS;16;16;15;1;0;0;0;15;0;0;3;6;6;1
23649.0;2023;01;PARIS;MASCULIN;SCOLAIRE;BAC PROFESSIONNEL;BAC PRO SERV;BAC PRO 32206 FACONNAGE PRODTS IMPRIMES ROUTAGE;10;10;10;0;0;0;0;10;0;2;1;4;3;0
23656.0;2023;01;PARIS;MASCULIN;SCOLAIRE;BAC PROFESSIONNEL;BAC PRO SERV;BAC PRO 33006 ANIMAT. ENFANCE& PERSONNES AGEES;23;23;18;4;1;1;0;19;0;2;6;5;6;4
23661.0;2023;01;PARIS;MASCULIN;SCOLAIRE;BAC PROFESSIONNEL;BAC PRO SERV;BAC PRO 33602 PERRUQUIER POSTICHEUR;2;2;1;1;0;0;0;1;0;1;0;0;0;1
23663.0;2023;01;PARIS;MASCULIN;SCOLAIRE;BAC PROFESSIONNEL;BAC PRO SERV;BAC PRO 34304 HYGIENE PROPRETE STERILISATION;2;2;1;1;0;0;0;1;0;0;0;1;0;1
23669.0;2023;01;PARIS;MASCULIN;SCOLAIRE;BAC TECHNOLOGIQUE;BAC STD2A;BAC STD2A SCIENCES & TECHNO. DESIGN-ARTS APPLIQUES;52;52;48;1;3;2;1;50;1;2;9;22;16;2
23674.0;2023;01;PARIS;MASCULIN;SCOLAIRE;BAC TECHNOLOGIQUE;BAC STI2D;BAC STI2D SYSTÈME D'INFORMATION  ET NUMERIQUE;262;262;224;17;21;16;5;240;0;13;35;91;101;22
23676.0;2023;01;PARIS;MASCULIN;SCOLAIRE;BAC TECHNOLOGIQUE;BAC STL;BAC STL SCIENCES PHYSIQUES CHIMIQUES  EN LABORAT.;35;35;28;1;6;2;4;30;0;2;5;13;10;5
23677.0;2023;01;PARIS;MASCULIN;SCOLAIRE;BAC TECHNOLOGIQUE;BAC STMG;BAC STMG GESTION ET FINANCE;265;265;187;18;60;49;11;236;0;1;30;71;134;29
23678.0;2023;01;PARIS;MASCULIN;SCOLAIRE;BAC TECHNOLOGIQUE;BAC STMG;BAC STMG MERCATIQUE (MARKETING);334;334;259;27;48;40;8;299;0;3;31;89;176;35
23682.0;2023;13;POITIERS;FEMININ;APPRENTISSAGE;BAC PROFESSIONNEL;BAC PRO PROD;BAC PRO 22004 PROC. CHIMIE EAU PAPIERS-CARTONS;1;1;1;0;0;0;0;1;0;1;0;0;0;0
23692.0;2023;13;POITIERS;FEMININ;APPRENTISSAGE;BAC PROFESSIONNEL;BAC PRO PROD;BAC PRO AG 21004 CGEA;15;15;11;4;0;0;0;11;0;0;1;3;7;4
23699.0;2023;13;POITIERS;FEMININ;APPRENTISSAGE;BAC PROFESSIONNEL;BAC PRO SERV;BAC PRO 31106 LOGISTIQUE;3;3;3;0;0;0;0;3;0;1;0;1;1;0
23720.0;2023;13;POITIERS;FEMININ;INDIVIDUEL;BAC PROFESSIONNEL;BAC PRO PROD;BAC PRO AG 21114 CONDUITE PRODUCTIONS HORTICOLES;2;2;2;0;0;0;0;2;0;0;0;0;2;0
23721.0;2023;13;POITIERS;FEMININ;INDIVIDUEL;BAC PROFESSIONNEL;BAC PRO PROD;BAC PRO AG 21211 COND GEST ENTR HIPPIQUE;6;6;2;4;0;0;0;2;0;0;0;1;1;4
23733.0;2023;13;POITIERS;FEMININ;INDIVIDUEL;BAC TECHNOLOGIQUE;BAC STMG;BAC STMG RESSOURCES HUMAINES ET COMMUNICATION;4;4;4;0;0;0;0;4;0;0;0;1;3;0
23737.0;2023;13;POITIERS;FEMININ;SCOLAIRE;BAC PROFESSIONNEL;BAC PRO PROD;BAC PRO 20102 PILOTE DE LIGNE DE PRODUCTION;1;1;1;0;0;0;0;1;0;0;0;1;0;0
23739.0;2023;13;POITIERS;FEMININ;SCOLAIRE;BAC PROFESSIONNEL;BAC PRO PROD;BAC PRO 22004 PROC. CHIMIE EAU PAPIERS-CARTONS;4;4;4;0;0;0;0;4;0;0;1;2;1;0
23754.0;2023;13;POITIERS;FEMININ;SCOLAIRE;BAC PROFESSIONNEL;BAC PRO PROD;BAC PRO 25106 TECHNICIEN D'USINAGE;1;1;1;0;0;0;0;1;0;0;1;0;0;0
23758.0;2023;13;POITIERS;FEMININ;SCOLAIRE;BAC PROFESSIONNEL;BAC PRO PROD;BAC PRO 25302 AERONAUTIQUE OPTION AVIONIQUE;4;4;4;0;0;0;0;4;0;0;2;2;0;0
23765.0;2023;13;POITIERS;FEMININ;SCOLAIRE;BAC PROFESSIONNEL;BAC PRO PROD;BAC PRO AG 21004 CGEA;74;74;61;13;0;0;0;61;0;2;4;13;42;13
23767.0;2023;13;POITIERS;FEMININ;SCOLAIRE;BAC PROFESSIONNEL;BAC PRO PROD;BAC PRO AG 21114 CONDUITE PRODUCTIONS HORTICOLES;13;12;12;0;0;0;0;12;0;0;0;6;6;0
23769.0;2023;13;POITIERS;FEMININ;SCOLAIRE;BAC PROFESSIONNEL;BAC PRO PROD;BAC PRO AG 21204 PROD-AQUACOLES;2;2;2;0;0;0;0;2;0;0;1;0;1;0
23793.0;2023;13;POITIERS;FEMININ;SCOLAIRE;BAC PROFESSIONNEL;BAC PRO SERV;BAC PRO 33603 ESTHETIQUE COSMETIQUE PARFUMERIE;90;89;75;11;3;3;0;78;0;5;18;26;29;11
23798.0;2023;13;POITIERS;FEMININ;SCOLAIRE;BAC TECHNOLOGIQUE;BAC ST2S;BAC ST2S SCIENCES & TECHNO. SANTE & SOCIAL;388;388;339;8;41;26;15;365;2;12;63;126;162;23
23807.0;2023;13;POITIERS;FEMININ;SCOLAIRE;BAC TECHNOLOGIQUE;BAC STL;BAC STL SCIENCES PHYSIQUES CHIMIQUES  EN LABORAT.;3;3;2;1;0;0;0;2;0;0;2;0;0;1
23808.0;2023;13;POITIERS;FEMININ;SCOLAIRE;BAC TECHNOLOGIQUE;BAC STMG;BAC STMG GESTION ET FINANCE;156;156;137;2;17;15;2;152;0;3;22;47;80;4
23810.0;2023;13;POITIERS;FEMININ;SCOLAIRE;BAC TECHNOLOGIQUE;BAC STMG;BAC STMG RESSOURCES HUMAINES ET COMMUNICATION;316;316;234;19;63;50;13;284;0;0;15;78;191;32
23819.0;2023;13;POITIERS;MASCULIN;APPRENTISSAGE;BAC PROFESSIONNEL;BAC PRO PROD;BAC PRO 23205 INTERV. SUR PATRIMOINE BATI OPT.A;1;1;0;1;0;0;0;0;0;0;0;0;0;1
23824.0;2023;13;POITIERS;MASCULIN;APPRENTISSAGE;BAC PROFESSIONNEL;BAC PRO PROD;BAC PRO 25007 MAINTENANCE EQUIPEMENTS INDUST.;28;27;19;6;2;1;1;20;0;0;4;7;9;7
23826.0;2023;13;POITIERS;MASCULIN;APPRENTISSAGE;BAC PROFESSIONNEL;BAC PRO PROD;BAC PRO 25106 TECHNICIEN D'USINAGE;10;10;8;2;0;0;0;8;0;0;1;3;4;2
23836.0;2023;13;POITIERS;MASCULIN;APPRENTISSAGE;BAC PROFESSIONNEL;BAC PRO PROD;BAC PRO 25509 TECHNIC. FROID CONDITIONNEMT AIR;2;2;2;0;0;0;0;2;0;0;0;2;0;0
23850.0;2023;13;POITIERS;MASCULIN;APPRENTISSAGE;BAC PROFESSIONNEL;BAC PRO SERV;BAC PRO 31213 MET.COM.VEN.OP.A ANI.GES.ESP.COM.;105;100;72;17;11;7;4;79;0;2;11;36;30;21
23858.0;2023;13;POITIERS;MASCULIN;APPRENTISSAGE;BAC PROFESSIONNEL;BAC PRO SERV;BAC PRO 34303 GEST. POLLUTIONS PROTEC. ENVIRON.;1;1;0;0;1;1;0;1;0;0;0;0;1;0
23870.0;2023;13;POITIERS;MASCULIN;INDIVIDUEL;BAC PROFESSIONNEL;BAC PRO PROD;BAC PRO 23405 TECHNICIEN MENUISIER AGENCEUR;1;1;0;1;0;0;0;0;0;0;0;0;0;1
23874.0;2023;13;POITIERS;MASCULIN;INDIVIDUEL;BAC PROFESSIONNEL;BAC PRO PROD;BAC PRO 25215 MAINT.VEHIC.OPTB VEHIC.TRANS.ROUT;1;1;1;0;0;0;0;1;0;0;0;0;1;0
23887.0;2023;13;POITIERS;MASCULIN;INDIVIDUEL;BAC TECHNOLOGIQUE;BAC ST2S;BAC ST2S SCIENCES & TECHNO. SANTE & SOCIAL;1;1;0;0;1;0;1;0;0;0;0;0;0;1
23896.0;2023;13;POITIERS;MASCULIN;SCOLAIRE;BAC PROFESSIONNEL;BAC PRO PROD;BAC PRO 22003 BIO-INDUSTRIES DE TRANSFORMATION;13;12;9;3;0;0;0;9;0;0;3;2;4;3
23897.0;2023;13;POITIERS;MASCULIN;SCOLAIRE;BAC PROFESSIONNEL;BAC PRO PROD;BAC PRO 22004 PROC. CHIMIE EAU PAPIERS-CARTONS;9;9;6;2;1;1;0;7;0;1;1;2;3;2
23904.0;2023;13;POITIERS;MASCULIN;SCOLAIRE;BAC PROFESSIONNEL;BAC PRO PROD;BAC PRO 23005 TECHN. ETUDES BAT B ASSIST.ARCHI.;22;22;16;5;1;0;1;16;0;1;1;9;5;6
23905.0;2023;13;POITIERS;MASCULIN;SCOLAIRE;BAC PROFESSIONNEL;BAC PRO PROD;BAC PRO 23102 TRAVAUX PUBLICS;9;9;5;1;3;3;0;8;0;0;0;3;5;1
23906.0;2023;13;POITIERS;MASCULIN;SCOLAIRE;BAC PROFESSIONNEL;BAC PRO PROD;BACPRO 23103 TECHNICIEN GEOMETRE-TOPOGRAPHE;23;23;15;7;1;1;0;16;0;0;3;10;3;7
23920.0;2023;13;POITIERS;MASCULIN;SCOLAIRE;BAC PROFESSIONNEL;BAC PRO PROD;BAC PRO 25107 TECHNICIEN OUTILLEUR;8;8;8;0;0;0;0;8;0;0;0;3;5;0
23928.0;2023;13;POITIERS;MASCULIN;SCOLAIRE;BAC PROFESSIONNEL;BAC PRO PROD;BAC PRO 25303 AERONAUTIQUE OPTION SYSTEMES;39;39;39;0;0;0;0;39;0;4;11;20;4;0
23929.0;2023;13;POITIERS;MASCULIN;SCOLAIRE;BAC PROFESSIONNEL;BAC PRO PROD;BAC PRO 25304 AERONAUTIQUE OPTION STRUCTURE;7;7;6;1;0;0;0;6;0;0;1;2;3;1
23932.0;2023;13;POITIERS;MASCULIN;SCOLAIRE;BAC PROFESSIONNEL;BAC PRO PROD;BAC PRO 25509 TECHNIC. FROID CONDITIONNEMT AIR;9;9;5;4;0;0;0;5;0;0;3;1;1;4
23933.0;2023;13;POITIERS;MASCULIN;SCOLAIRE;BAC PROFESSIONNEL;BAC PRO PROD;BAC PRO 25510 METIERS ELECT. ENVIRON. CONNECTES;176;176;130;36;10;5;5;135;0;5;19;54;57;41
23934.0;2023;13;POITIERS;MASCULIN;SCOLAIRE;BAC PROFESSIONNEL;BAC PRO PROD;BAC PRO 25513 SYST.NUM.OPT.A SURETE SECURITE;23;23;19;2;2;2;0;21;0;0;3;7;11;2
23935.0;2023;13;POITIERS;MASCULIN;SCOLAIRE;BAC PROFESSIONNEL;BAC PRO PROD;BAC PRO 25514 SYST.NUM.OPT.B AUD.RES.EQUIP.DOM.;46;46;34;6;6;5;1;39;0;0;8;18;13;7
23937.0;2023;13;POITIERS;MASCULIN;SCOLAIRE;BAC PROFESSIONNEL;BAC PRO PROD;BAC PRO AG 21001 AGRO-EQUIPEMENT;10;10;7;3;0;0;0;7;0;0;0;3;4;3
23939.0;2023;13;POITIERS;MASCULIN;SCOLAIRE;BAC PROFESSIONNEL;BAC PRO PROD;BAC PRO AG 21113 CGEVV;17;17;14;3;0;0;0;14;0;0;1;3;10;3
23942.0;2023;13;POITIERS;MASCULIN;SCOLAIRE;BAC PROFESSIONNEL;BAC PRO PROD;BAC PRO AG 21204 PROD-AQUACOLES;17;17;11;6;0;0;0;11;0;0;0;5;6;6
23945.0;2023;13;POITIERS;MASCULIN;SCOLAIRE;BAC PROFESSIONNEL;BAC PRO PROD;BAC PRO AG 21302 GEST MILIEUX NATURELS FAUNE;66;64;63;1;0;0;0;63;0;4;10;19;30;1
23952.0;2023;13;POITIERS;MASCULIN;SCOLAIRE;BAC PROFESSIONNEL;BAC PRO SERV;BAC PRO 31106 LOGISTIQUE;57;57;40;11;6;2;4;42;0;1;6;13;22;15
23961.0;2023;13;POITIERS;MASCULIN;SCOLAIRE;BAC PROFESSIONNEL;BAC PRO SERV;BAC PRO 33002 SERVICES DE PROXIMITE  VIE LOCAL;1;1;0;1;0;0;0;0;0;0;0;0;0;1
23967.0;2023;13;POITIERS;MASCULIN;SCOLAIRE;BAC PROFESSIONNEL;BAC PRO SERV;BAC PRO 33604 METIERS DE LA COIFFURE;2;2;1;1;0;0;0;1;0;0;0;0;1;1
23968.0;2023;13;POITIERS;MASCULIN;SCOLAIRE;BAC PROFESSIONNEL;BAC PRO SERV;BAC PRO 34303 GEST. POLLUTIONS PROTEC. ENVIRON.;5;5;5;0;0;0;0;5;0;1;0;3;1;0
23989.0;2023;19;REIMS;FEMININ;APPRENTISSAGE;BAC PROFESSIONNEL;BAC PRO PROD;BAC PRO 25221 MAINT.MATERIELS OPT.C ESP. VERTS;1;1;1;0;0;0;0;1;0;0;0;0;1;0
23990.0;2023;19;REIMS;FEMININ;APPRENTISSAGE;BAC PROFESSIONNEL;BAC PRO PROD;BAC PRO 25411 TECH.CHAUDRONNERIE INDUSTRIELLE;1;1;0;1;0;0;0;0;0;0;0;0;0;1
24007.0;2023;19;REIMS;FEMININ;ENSEIGNEMENT A DISTANCE;BAC PROFESSIONNEL;BAC PRO SERV;BAC PRO 31214 MET.COM.VEN.OP.B PR.CL.VA.OF.COM.;1;1;1;0;0;0;0;1;0;0;0;0;1;0
24008.0;2023;19;REIMS;FEMININ;ENSEIGNEMENT A DISTANCE;BAC PROFESSIONNEL;BAC PRO SERV;BAC PRO 33004 ACC.SOINS-S.PERS. OPT.EN STRUCTUR;2;1;1;0;0;0;0;1;0;0;0;1;0;0
24014.0;2023;19;REIMS;FEMININ;FORMATION CONTINUE;BAC PROFESSIONNEL;BAC PRO SERV;BAC PRO 30004 ASSISTANC.GEST.ORGANIS.ACTIVITES;9;9;9;0;0;0;0;9;0;2;3;2;2;0
24018.0;2023;19;REIMS;FEMININ;INDIVIDUEL;BAC PROFESSIONNEL;BAC PRO PROD;BAC PRO 23005 TECHN. ETUDES BAT B ASSIST.ARCHI.;2;2;1;1;0;0;0;1;0;0;0;0;1;1
24020.0;2023;19;REIMS;FEMININ;INDIVIDUEL;BAC PROFESSIONNEL;BAC PRO PROD;BAC PRO AG 21113 CGEVV;1;1;1;0;0;0;0;1;0;0;0;0;1;0
24034.0;2023;19;REIMS;FEMININ;SCOLAIRE;BAC PROFESSIONNEL;BAC PRO PROD;BAC PRO 20102 PILOTE DE LIGNE DE PRODUCTION;1;1;1;0;0;0;0;1;0;0;1;0;0;0
24035.0;2023;19;REIMS;FEMININ;SCOLAIRE;BAC PROFESSIONNEL;BAC PRO PROD;BAC PRO 22003 BIO-INDUSTRIES DE TRANSFORMATION;14;14;10;2;2;2;0;12;0;0;2;4;6;2
24037.0;2023;19;REIMS;FEMININ;SCOLAIRE;BAC PROFESSIONNEL;BAC PRO PROD;BAC PRO 22106 CUISINE;32;32;26;5;1;1;0;27;0;0;9;10;8;5
24043.0;2023;19;REIMS;FEMININ;SCOLAIRE;BAC PROFESSIONNEL;BAC PRO PROD;BAC PRO 23405 TECHNICIEN MENUISIER AGENCEUR;2;2;2;0;0;0;0;2;0;0;0;0;2;0
24044.0;2023;19;REIMS;FEMININ;SCOLAIRE;BAC PROFESSIONNEL;BAC PRO PROD;BAC PRO 23408 Etude et réalisation d'agencement;5;5;4;1;0;0;0;4;0;0;1;3;0;1
24047.0;2023;19;REIMS;FEMININ;SCOLAIRE;BAC PROFESSIONNEL;BAC PRO PROD;BAC PRO 25007 MAINTENANCE EQUIPEMENTS INDUST.;4;4;2;1;1;1;0;3;0;0;0;1;2;1
24050.0;2023;19;REIMS;FEMININ;SCOLAIRE;BAC PROFESSIONNEL;BAC PRO PROD;BAC PRO 25408 REPARATION DES CARROSSERIES;4;4;4;0;0;0;0;4;0;0;2;0;2;0
24058.0;2023;19;REIMS;FEMININ;SCOLAIRE;BAC PROFESSIONNEL;BAC PRO PROD;BAC PRO AG 21210 COND GEST ENTR CANIN ET FELIN;9;9;9;0;0;0;0;9;0;0;1;5;3;0
24060.0;2023;19;REIMS;FEMININ;SCOLAIRE;BAC PROFESSIONNEL;BAC PRO PROD;BAC PRO AG 21302 GEST MILIEUX NATURELS FAUNE;9;9;6;3;0;0;0;6;0;0;0;0;6;3
24064.0;2023;19;REIMS;FEMININ;SCOLAIRE;BAC PROFESSIONNEL;BAC PRO SERV;BAC PRO 31106 LOGISTIQUE;4;4;2;2;0;0;0;2;0;0;0;0;2;2
24065.0;2023;19;REIMS;FEMININ;SCOLAIRE;BAC PROFESSIONNEL;BAC PRO SERV;BAC PRO 31107 CONDUCT. TRANSP.ROUT.MARCHANDISES;2;2;2;0;0;0;0;2;0;0;2;0;0;0
24069.0;2023;19;REIMS;FEMININ;SCOLAIRE;BAC PROFESSIONNEL;BAC PRO SERV;BAC PRO 31214 MET.COM.VEN.OP.B PR.CL.VA.OF.COM.;119;119;96;17;6;6;0;102;0;1;17;43;41;17
24072.0;2023;19;REIMS;FEMININ;SCOLAIRE;BAC PROFESSIONNEL;BAC PRO SERV;BAC PRO 32303 ART.& MET.ART:COM.VIS.VIS.PLURI-M;20;20;17;2;1;0;1;17;0;1;8;4;4;3
24073.0;2023;19;REIMS;FEMININ;SCOLAIRE;BAC PROFESSIONNEL;BAC PRO SERV;BAC PRO 32304 PHOTOGRAPHIE;6;6;6;0;0;0;0;6;0;0;3;3;0;0
24076.0;2023;19;REIMS;FEMININ;SCOLAIRE;BAC PROFESSIONNEL;BAC PRO SERV;BAC PRO 33006 ANIMAT. ENFANCE& PERSONNES AGEES;10;10;9;1;0;0;0;9;0;0;3;3;3;1
24081.0;2023;19;REIMS;FEMININ;SCOLAIRE;BAC PROFESSIONNEL;BAC PRO SERV;BAC PRO 34304 HYGIENE PROPRETE STERILISATION;9;9;8;1;0;0;0;8;0;0;3;2;3;1
24084.0;2023;19;REIMS;FEMININ;SCOLAIRE;BAC TECHNOLOGIQUE;BAC S2TMD;BAC S2TMD DANSE;2;2;2;0;0;0;0;2;0;0;0;1;1;0
24085.0;2023;19;REIMS;FEMININ;SCOLAIRE;BAC TECHNOLOGIQUE;BAC S2TMD;BAC S2TMD MUSIQUE;1;1;1;0;0;0;0;1;0;0;1;0;0;0
24089.0;2023;19;REIMS;FEMININ;SCOLAIRE;BAC TECHNOLOGIQUE;BAC STHR;BAC STHR SC.&TEC. HOTELLERIE-RESTAURATION;12;12;11;0;1;0;1;11;0;1;3;6;1;1
24090.0;2023;19;REIMS;FEMININ;SCOLAIRE;BAC TECHNOLOGIQUE;BAC STI2D;BAC STI2D ARCHITECTURE ET CONSTRUCTION;20;20;18;1;1;1;0;19;0;1;1;7;10;1
24094.0;2023;19;REIMS;FEMININ;SCOLAIRE;BAC TECHNOLOGIQUE;BAC STL;BAC STL BIOCHIM.-BIOLOGIE-BIOTECHNOL.;28;28;27;0;1;0;1;27;0;1;7;9;10;1
24095.0;2023;19;REIMS;FEMININ;SCOLAIRE;BAC TECHNOLOGIQUE;BAC STL;BAC STL SCIENCES PHYSIQUES CHIMIQUES  EN LABORAT.;10;10;7;1;2;1;1;8;0;0;1;5;2;2
24098.0;2023;19;REIMS;FEMININ;SCOLAIRE;BAC TECHNOLOGIQUE;BAC STMG;BAC STMG RESSOURCES HUMAINES ET COMMUNICATION;307;307;217;17;73;48;25;265;0;3;14;72;176;42
24106.0;2023;19;REIMS;MASCULIN;APPRENTISSAGE;BAC PROFESSIONNEL;BAC PRO PROD;BAC PRO 23102 TRAVAUX PUBLICS;27;27;25;1;1;1;0;26;0;3;9;4;10;1
24108.0;2023;19;REIMS;MASCULIN;APPRENTISSAGE;BAC PROFESSIONNEL;BAC PRO PROD;BAC PRO 23303 MENUISERIE ALUMINIUM-VERRE;1;1;0;0;1;0;1;0;0;0;0;0;0;1
24111.0;2023;19;REIMS;MASCULIN;APPRENTISSAGE;BAC PROFESSIONNEL;BAC PRO PROD;BAC PRO 23405 TECHNICIEN MENUISIER AGENCEUR;8;8;4;3;1;0;1;4;0;0;0;1;3;4
24114.0;2023;19;REIMS;MASCULIN;APPRENTISSAGE;BAC PROFESSIONNEL;BAC PRO PROD;BAC PRO 25107 TECHNICIEN OUTILLEUR;3;3;2;1;0;0;0;2;0;0;2;0;0;1
24115.0;2023;19;REIMS;MASCULIN;APPRENTISSAGE;BAC PROFESSIONNEL;BAC PRO PROD;BAC PRO 25214 MAINT.VEHIC.OPTA VOIT.PARTICUL.;51;49;36;9;4;1;3;37;0;7;7;12;11;12
24129.0;2023;19;REIMS;MASCULIN;APPRENTISSAGE;BAC PROFESSIONNEL;BAC PRO PROD;BAC PRO AG 21113 CGEVV;34;33;22;11;0;0;0;22;0;0;1;5;16;11
24130.0;2023;19;REIMS;MASCULIN;APPRENTISSAGE;BAC PROFESSIONNEL;BAC PRO PROD;BAC PRO AG 21302 GEST MILIEUX NATURELS FAUNE;2;2;2;0;0;0;0;2;0;0;0;1;1;0
24136.0;2023;19;REIMS;MASCULIN;APPRENTISSAGE;BAC PROFESSIONNEL;BAC PRO SERV;BAC PRO 33104 TECHNICIEN EN PROTHESE DENTAIRE;3;3;3;0;0;0;0;3;0;0;0;2;1;0
24146.0;2023;19;REIMS;MASCULIN;FORMATION CONTINUE;BAC PROFESSIONNEL;BAC PRO PROD;BAC PRO 23205 INTERV. SUR PATRIMOINE BATI OPT.A;2;2;2;0;0;0;0;2;0;0;1;1;0;0
24147.0;2023;19;REIMS;MASCULIN;FORMATION CONTINUE;BAC PROFESSIONNEL;BAC PRO PROD;BAC PRO 23405 TECHNICIEN MENUISIER AGENCEUR;2;2;2;0;0;0;0;2;0;2;0;0;0;0
24150.0;2023;19;REIMS;MASCULIN;INDIVIDUEL;BAC PROFESSIONNEL;BAC PRO PROD;BAC PRO 23303 MENUISERIE ALUMINIUM-VERRE;1;0;0;0;0;0;0;0;0;0;0;0;0;0
24152.0;2023;19;REIMS;MASCULIN;INDIVIDUEL;BAC PROFESSIONNEL;BAC PRO PROD;BAC PRO 25215 MAINT.VEHIC.OPTB VEHIC.TRANS.ROUT;1;0;0;0;0;0;0;0;0;0;0;0;0;0
24153.0;2023;19;REIMS;MASCULIN;INDIVIDUEL;BAC PROFESSIONNEL;BAC PRO PROD;BAC PRO 25216 MAINT.VEHIC.OPTC MOTOCYCLES;1;1;1;0;0;0;0;1;0;0;0;0;1;0
24159.0;2023;19;REIMS;MASCULIN;INDIVIDUEL;BAC PROFESSIONNEL;BAC PRO SERV;BAC PRO 34305 TECHN.D'INTERV.SUR INSTALL. NUCL.;1;0;0;0;0;0;0;0;0;0;0;0;0;0
24166.0;2023;19;REIMS;MASCULIN;INDIVIDUEL;BAC TECHNOLOGIQUE;BAC STMG;BAC STMG RESSOURCES HUMAINES ET COMMUNICATION;13;12;5;5;2;1;1;6;0;0;0;1;5;6
24172.0;2023;19;REIMS;MASCULIN;SCOLAIRE;BAC PROFESSIONNEL;BAC PRO PROD;BAC PRO 22106 CUISINE;64;64;56;4;4;3;1;59;0;0;14;21;24;5
24191.0;2023;19;REIMS;MASCULIN;SCOLAIRE;BAC PROFESSIONNEL;BAC PRO PROD;BAC PRO 25214 MAINT.VEHIC.OPTA VOIT.PARTICUL.;109;109;74;21;14;8;6;82;0;6;23;24;29;27
24196.0;2023;19;REIMS;MASCULIN;SCOLAIRE;BAC PROFESSIONNEL;BAC PRO PROD;BAC PRO 25408 REPARATION DES CARROSSERIES;40;40;28;9;3;1;2;29;0;1;2;6;20;11
24198.0;2023;19;REIMS;MASCULIN;SCOLAIRE;BAC PROFESSIONNEL;BAC PRO PROD;BAC PRO 25509 TECHNIC. FROID CONDITIONNEMT AIR;19;19;15;4;0;0;0;15;0;1;3;5;6;4
24199.0;2023;19;REIMS;MASCULIN;SCOLAIRE;BAC PROFESSIONNEL;BAC PRO PROD;BAC PRO 25510 METIERS ELECT. ENVIRON. CONNECTES;197;197;133;54;10;10;0;143;0;5;27;50;61;54
24200.0;2023;19;REIMS;MASCULIN;SCOLAIRE;BAC PROFESSIONNEL;BAC PRO PROD;BAC PRO 25513 SYST.NUM.OPT.A SURETE SECURITE;23;23;12;10;1;1;0;13;0;0;3;4;6;10
24209.0;2023;19;REIMS;MASCULIN;SCOLAIRE;BAC PROFESSIONNEL;BAC PRO PROD;BAC PRO AG 21302 GEST MILIEUX NATURELS FAUNE;38;36;35;1;0;0;0;35;0;2;2;12;19;1
24210.0;2023;19;REIMS;MASCULIN;SCOLAIRE;BAC PROFESSIONNEL;BAC PRO PROD;BAC PRO AG 21303 FORET;13;13;10;3;0;0;0;10;0;0;1;2;7;3
24211.0;2023;19;REIMS;MASCULIN;SCOLAIRE;BAC PROFESSIONNEL;BAC PRO PROD;BAC PRO AG 21405 AMENAGEMENTS PAYSAGERS;22;21;21;0;0;0;0;21;0;1;2;3;15;0
24212.0;2023;19;REIMS;MASCULIN;SCOLAIRE;BAC PROFESSIONNEL;BAC PRO PROD;BAC PRO AG 22108 TEC CONS VTE ALIMENTATION (PAB);1;1;1;0;0;0;0;1;0;0;0;0;1;0
24222.0;2023;19;REIMS;MASCULIN;SCOLAIRE;BAC PROFESSIONNEL;BAC PRO SERV;BAC PRO 32303 ART.& MET.ART:COM.VIS.VIS.PLURI-M;26;26;23;3;0;0;0;23;0;1;8;10;4;3
24227.0;2023;19;REIMS;MASCULIN;SCOLAIRE;BAC PROFESSIONNEL;BAC PRO SERV;BAC PRO 33101 OPTIQUE LUNETTERIE;1;1;1;0;0;0;0;1;0;0;0;1;0;0
24229.0;2023;19;REIMS;MASCULIN;SCOLAIRE;BAC PROFESSIONNEL;BAC PRO SERV;BAC PRO 33604 METIERS DE LA COIFFURE;2;2;1;1;0;0;0;1;0;0;1;0;0;1
24235.0;2023;19;REIMS;MASCULIN;SCOLAIRE;BAC TECHNOLOGIQUE;BAC ST2S;BAC ST2S SCIENCES & TECHNO. SANTE & SOCIAL;62;62;47;7;8;3;5;50;0;1;4;26;19;12
24242.0;2023;19;REIMS;MASCULIN;SCOLAIRE;BAC TECHNOLOGIQUE;BAC STI2D;BAC STI2D SYSTÈME D'INFORMATION  ET NUMERIQUE;119;119;100;5;14;7;7;107;0;1;19;41;46;12
24250.0;2023;14;RENNES;FEMININ;APPRENTISSAGE;BAC PROFESSIONNEL;BAC PRO PROD;BAC PRO 22105 BOULANGER-PÂTISSIER;5;5;4;0;1;1;0;5;0;1;0;3;1;0
24257.0;2023;14;RENNES;FEMININ;APPRENTISSAGE;BAC PROFESSIONNEL;BAC PRO PROD;BAC PRO 25007 MAINTENANCE EQUIPEMENTS INDUST.;1;1;1;0;0;0;0;1;0;0;1;0;0;0
24258.0;2023;14;RENNES;FEMININ;APPRENTISSAGE;BAC PROFESSIONNEL;BAC PRO PROD;BAC PRO 25009 MAINTENANCE NAUTIQUE;1;1;1;0;0;0;0;1;0;0;0;1;0;0
24262.0;2023;14;RENNES;FEMININ;APPRENTISSAGE;BAC PROFESSIONNEL;BAC PRO PROD;BAC PRO 25219 MAINT.MATERIELS OPT.A AGRICOLES;1;1;1;0;0;0;0;1;0;0;0;1;0;0
24267.0;2023;14;RENNES;FEMININ;APPRENTISSAGE;BAC PROFESSIONNEL;BAC PRO PROD;BAC PRO AG 21004 CGEA;31;31;19;12;0;0;0;19;0;0;4;4;11;12
24270.0;2023;14;RENNES;FEMININ;APPRENTISSAGE;BAC PROFESSIONNEL;BAC PRO PROD;BAC PRO AG 21211 COND GEST ENTR HIPPIQUE;12;10;8;2;0;0;0;8;0;0;2;0;6;2
24274.0;2023;14;RENNES;FEMININ;APPRENTISSAGE;BAC PROFESSIONNEL;BAC PRO SERV;BAC PRO 31106 LOGISTIQUE;5;5;4;1;0;0;0;4;0;0;1;2;1;1
24277.0;2023;14;RENNES;FEMININ;APPRENTISSAGE;BAC PROFESSIONNEL;BAC PRO SERV;BAC PRO 31213 MET.COM.VEN.OP.A ANI.GES.ESP.COM.;176;174;140;20;14;11;3;151;0;9;30;40;72;23
24279.0;2023;14;RENNES;FEMININ;APPRENTISSAGE;BAC PROFESSIONNEL;BAC PRO SERV;BAC PRO 33603 ESTHETIQUE COSMETIQUE PARFUMERIE;18;17;16;1;0;0;0;16;0;2;4;2;8;1
24281.0;2023;14;RENNES;FEMININ;APPRENTISSAGE;BAC PROFESSIONNEL;BAC PRO SERV;BAC PRO 34304 HYGIENE PROPRETE STERILISATION;12;11;10;1;0;0;0;10;0;1;2;6;1;1
24283.0;2023;14;RENNES;FEMININ;ENSEIGNEMENT A DISTANCE;BAC GENERAL;BAC GENERAL;BAC GENE 10019 BAC GENERAL;89;89;63;16;10;9;1;72;0;4;9;20;39;17
24285.0;2023;14;RENNES;FEMININ;ENSEIGNEMENT A DISTANCE;BAC PROFESSIONNEL;BAC PRO SERV;BAC PRO 31213 MET.COM.VEN.OP.A ANI.GES.ESP.COM.;5;3;2;1;0;0;0;2;0;0;0;1;1;1
24286.0;2023;14;RENNES;FEMININ;ENSEIGNEMENT A DISTANCE;BAC PROFESSIONNEL;BAC PRO SERV;BAC PRO 33004 ACC.SOINS-S.PERS. OPT.EN STRUCTUR;5;5;4;1;0;0;0;4;0;0;0;1;3;1
24289.0;2023;14;RENNES;FEMININ;ENSEIGNEMENT A DISTANCE;BAC TECHNOLOGIQUE;BAC STMG;BAC STMG MERCATIQUE (MARKETING);8;8;5;1;2;0;2;5;0;0;0;1;4;3
24292.0;2023;14;RENNES;FEMININ;FORMATION CONTINUE;BAC PROFESSIONNEL;BAC PRO PROD;BAC PRO 25510 METIERS ELECT. ENVIRON. CONNECTES;1;1;1;0;0;0;0;1;0;1;0;0;0;0
24299.0;2023;14;RENNES;FEMININ;INDIVIDUEL;BAC PROFESSIONNEL;BAC PRO SERV;BAC PRO 30004 ASSISTANC.GEST.ORGANIS.ACTIVITES;4;2;1;1;0;0;0;1;0;0;0;0;1;1
24306.0;2023;14;RENNES;FEMININ;INDIVIDUEL;BAC TECHNOLOGIQUE;BAC STD2A;BAC STD2A SCIENCES & TECHNO. DESIGN-ARTS APPLIQUES;1;1;0;1;0;0;0;0;0;0;0;0;0;1
24307.0;2023;14;RENNES;FEMININ;INDIVIDUEL;BAC TECHNOLOGIQUE;BAC STL;BAC STL SCIENCES PHYSIQUES CHIMIQUES  EN LABORAT.;1;1;0;1;0;0;0;0;0;0;0;0;0;1
24309.0;2023;14;RENNES;FEMININ;INDIVIDUEL;BAC TECHNOLOGIQUE;BAC STMG;BAC STMG MERCATIQUE (MARKETING);10;10;2;5;3;1;2;3;0;0;0;1;2;7
24313.0;2023;14;RENNES;FEMININ;SCOLAIRE;BAC PROFESSIONNEL;BAC PRO PROD;BAC PRO 22106 CUISINE;85;85;78;3;4;4;0;82;0;7;24;34;17;3
24317.0;2023;14;RENNES;FEMININ;SCOLAIRE;BAC PROFESSIONNEL;BAC PRO PROD;BAC PRO 23003 ARTIS. & M.ART:MARCHANDISAGE VIS.;20;20;18;1;1;1;0;19;0;4;7;4;4;1
24324.0;2023;14;RENNES;FEMININ;SCOLAIRE;BAC PROFESSIONNEL;BAC PRO PROD;BAC PRO 23407 TECHNIC.FAB.BOIS ET MATERX ASSOC;2;2;2;0;0;0;0;2;0;0;0;1;1;0
24328.0;2023;14;RENNES;FEMININ;SCOLAIRE;BAC PROFESSIONNEL;BAC PRO PROD;BAC PRO 24302 METIERS DU CUIR : MAROQUINERIE;11;11;10;1;0;0;0;10;0;1;2;4;3;1
24331.0;2023;14;RENNES;FEMININ;SCOLAIRE;BAC PROFESSIONNEL;BAC PRO PROD;BAC PRO 25009 MAINTENANCE NAUTIQUE;1;1;1;0;0;0;0;1;0;0;0;0;1;0
24333.0;2023;14;RENNES;FEMININ;SCOLAIRE;BAC PROFESSIONNEL;BAC PRO PROD;BAC PRO 25215 MAINT.VEHIC.OPTB VEHIC.TRANS.ROUT;2;2;2;0;0;0;0;2;0;0;0;2;0;0
24336.0;2023;14;RENNES;FEMININ;SCOLAIRE;BAC PROFESSIONNEL;BAC PRO PROD;BAC PRO 25304 AERONAUTIQUE OPTION STRUCTURE;4;4;4;0;0;0;0;4;0;0;0;2;2;0
24339.0;2023;14;RENNES;FEMININ;SCOLAIRE;BAC PROFESSIONNEL;BAC PRO PROD;BAC PRO 25509 TECHNIC. FROID CONDITIONNEMT AIR;2;2;1;1;0;0;0;1;0;0;0;1;0;1
24343.0;2023;14;RENNES;FEMININ;SCOLAIRE;BAC PROFESSIONNEL;BAC PRO PROD;BAC PRO 25515 SYST.NUM.OPT.C RES.INF.SYST.COMM.;7;6;5;1;0;0;0;5;0;2;1;1;1;1
24345.0;2023;14;RENNES;FEMININ;SCOLAIRE;BAC PROFESSIONNEL;BAC PRO PROD;BAC PRO AG 21004 CGEA;145;140;114;26;0;0;0;114;0;2;11;36;65;26
24354.0;2023;14;RENNES;FEMININ;SCOLAIRE;BAC PROFESSIONNEL;BAC PRO PROD;BAC PRO AG 22105 LABORATOIRE CONTROLE QUALITE;18;18;16;2;0;0;0;16;0;0;1;7;8;2
24360.0;2023;14;RENNES;FEMININ;SCOLAIRE;BAC PROFESSIONNEL;BAC PRO SERV;BAC PRO 31212 METIERS DE L'ACCUEIL;195;195;162;19;14;8;6;170;0;10;45;61;54;25
24364.0;2023;14;RENNES;FEMININ;SCOLAIRE;BAC PROFESSIONNEL;BAC PRO SERV;BAC PRO 32208 REAL.PR.IMPR.PLURI.OPTB.PR.IMPR.;12;12;9;3;0;0;0;9;0;1;3;5;0;3
24365.0;2023;14;RENNES;FEMININ;SCOLAIRE;BAC PROFESSIONNEL;BAC PRO SERV;BAC PRO 32303 ART.& MET.ART:COM.VIS.VIS.PLURI-M;18;18;18;0;0;0;0;18;0;8;7;3;0;0
24369.0;2023;14;RENNES;FEMININ;SCOLAIRE;BAC PROFESSIONNEL;BAC PRO SERV;BAC PRO 33101 OPTIQUE LUNETTERIE;29;29;29;0;0;0;0;29;0;1;10;15;3;0
24381.0;2023;14;RENNES;FEMININ;SCOLAIRE;BAC TECHNOLOGIQUE;BAC STAV;BAC STAV AGRONOMIE ALIM ENV TERRITOI;211;211;206;5;0;0;0;206;0;1;22;80;103;5
24383.0;2023;14;RENNES;FEMININ;SCOLAIRE;BAC TECHNOLOGIQUE;BAC STHR;BAC STHR SC.&TEC. HOTELLERIE-RESTAURATION;50;50;50;0;0;0;0;50;0;4;13;20;13;0
24384.0;2023;14;RENNES;FEMININ;SCOLAIRE;BAC TECHNOLOGIQUE;BAC STI2D;BAC STI2D ARCHITECTURE ET CONSTRUCTION;56;56;52;1;3;2;1;54;0;3;19;20;12;2
24387.0;2023;14;RENNES;FEMININ;SCOLAIRE;BAC TECHNOLOGIQUE;BAC STI2D;BAC STI2D SYSTÈME D'INFORMATION  ET NUMERIQUE;16;16;16;0;0;0;0;16;0;2;4;8;2;0
24389.0;2023;14;RENNES;FEMININ;SCOLAIRE;BAC TECHNOLOGIQUE;BAC STL;BAC STL SCIENCES PHYSIQUES CHIMIQUES  EN LABORAT.;23;23;21;0;2;1;1;22;0;1;6;10;5;1
24394.0;2023;14;RENNES;MASCULIN;APPRENTISSAGE;BAC PROFESSIONNEL;BAC PRO PROD;BAC PRO 22104 BOUCHER CHARCUTIER TRAITEUR;11;11;7;3;1;1;0;8;0;0;1;3;4;3
24397.0;2023;14;RENNES;MASCULIN;APPRENTISSAGE;BAC PROFESSIONNEL;BAC PRO PROD;BAC PRO 22703 TECHN.INSTALL.SYST.ENERG.CLIMATI;31;31;26;4;1;0;1;26;0;2;4;6;14;5
24399.0;2023;14;RENNES;MASCULIN;APPRENTISSAGE;BAC PROFESSIONNEL;BAC PRO PROD;BAC PRO 23102 TRAVAUX PUBLICS;33;33;28;5;0;0;0;28;0;0;4;15;9;5
24400.0;2023;14;RENNES;MASCULIN;APPRENTISSAGE;BAC PROFESSIONNEL;BAC PRO PROD;BACPRO 23103 TECHNICIEN GEOMETRE-TOPOGRAPHE;1;1;1;0;0;0;0;1;0;0;0;1;0;0
24401.0;2023;14;RENNES;MASCULIN;APPRENTISSAGE;BAC PROFESSIONNEL;BAC PRO PROD;BAC PRO 23203 TECHNICIEN BAT. : ORG.REAL.GROS O;17;17;13;4;0;0;0;13;0;1;4;4;4;4
24402.0;2023;14;RENNES;MASCULIN;APPRENTISSAGE;BAC PROFESSIONNEL;BAC PRO PROD;BAC PRO 23304 AMENAGEMENT FINITION BATIMENT;1;1;1;0;0;0;0;1;0;0;0;0;1;0
24404.0;2023;14;RENNES;MASCULIN;APPRENTISSAGE;BAC PROFESSIONNEL;BAC PRO PROD;BAC PRO 23405 TECHNICIEN MENUISIER AGENCEUR;24;24;18;4;2;1;1;19;0;0;8;3;8;5
24409.0;2023;14;RENNES;MASCULIN;APPRENTISSAGE;BAC PROFESSIONNEL;BAC PRO PROD;BAC PRO 25214 MAINT.VEHIC.OPTA VOIT.PARTICUL.;221;218;170;31;17;11;6;181;0;19;34;60;68;37
24411.0;2023;14;RENNES;MASCULIN;APPRENTISSAGE;BAC PROFESSIONNEL;BAC PRO PROD;BAC PRO 25216 MAINT.VEHIC.OPTC MOTOCYCLES;9;9;7;2;0;0;0;7;0;1;0;3;3;2
24425.0;2023;14;RENNES;MASCULIN;APPRENTISSAGE;BAC PROFESSIONNEL;BAC PRO PROD;BAC PRO AG 21303 FORET;10;10;8;2;0;0;0;8;0;0;0;4;4;2
24432.0;2023;14;RENNES;MASCULIN;APPRENTISSAGE;BAC PROFESSIONNEL;BAC PRO SERV;BAC PRO 31214 MET.COM.VEN.OP.B PR.CL.VA.OF.COM.;1;1;1;0;0;0;0;1;0;0;0;0;1;0
24434.0;2023;14;RENNES;MASCULIN;APPRENTISSAGE;BAC PROFESSIONNEL;BAC PRO SERV;BAC PRO 34303 GEST. POLLUTIONS PROTEC. ENVIRON.;2;2;2;0;0;0;0;2;0;0;0;1;1;0
24435.0;2023;14;RENNES;MASCULIN;APPRENTISSAGE;BAC PROFESSIONNEL;BAC PRO SERV;BAC PRO 34304 HYGIENE PROPRETE STERILISATION;24;24;15;4;5;3;2;18;0;2;5;6;5;6
24442.0;2023;14;RENNES;MASCULIN;ENSEIGNEMENT A DISTANCE;BAC TECHNOLOGIQUE;BAC STMG;BAC STMG MERCATIQUE (MARKETING);4;4;3;1;0;0;0;3;0;0;0;1;2;1
24443.0;2023;14;RENNES;MASCULIN;ENSEIGNEMENT A DISTANCE;BAC TECHNOLOGIQUE;BAC STMG;BAC STMG RESSOURCES HUMAINES ET COMMUNICATION;5;5;3;1;1;1;0;4;0;0;0;2;2;1
24453.0;2023;14;RENNES;MASCULIN;INDIVIDUEL;BAC PROFESSIONNEL;BAC PRO PROD;BAC PRO 25215 MAINT.VEHIC.OPTB VEHIC.TRANS.ROUT;1;0;0;0;0;0;0;0;0;0;0;0;0;0
24459.0;2023;14;RENNES;MASCULIN;INDIVIDUEL;BAC PROFESSIONNEL;BAC PRO PROD;BAC PRO AG 21113 CGEVV;1;0;0;0;0;0;0;0;0;0;0;0;0;0
24463.0;2023;14;RENNES;MASCULIN;INDIVIDUEL;BAC PROFESSIONNEL;BAC PRO SERV;BAC PRO 30004 ASSISTANC.GEST.ORGANIS.ACTIVITES;2;2;1;1;0;0;0;1;0;0;0;0;1;1
24466.0;2023;14;RENNES;MASCULIN;INDIVIDUEL;BAC PROFESSIONNEL;BAC PRO SERV;BAC PRO 31214 MET.COM.VEN.OP.B PR.CL.VA.OF.COM.;4;2;1;1;0;0;0;1;0;0;0;0;1;1
24470.0;2023;14;RENNES;MASCULIN;INDIVIDUEL;BAC TECHNOLOGIQUE;BAC STL;BAC STL SCIENCES PHYSIQUES CHIMIQUES  EN LABORAT.;1;1;0;0;1;0;1;0;0;0;0;0;0;1
24476.0;2023;14;RENNES;MASCULIN;SCOLAIRE;BAC PROFESSIONNEL;BAC PRO PROD;BAC PRO 22105 BOULANGER-PÂTISSIER;53;52;52;0;0;0;0;52;0;1;20;17;14;0
24479.0;2023;14;RENNES;MASCULIN;SCOLAIRE;BAC PROFESSIONNEL;BAC PRO PROD;BAC PRO 22503 PLASTIQUES ET COMPOSITES;11;11;11;0;0;0;0;11;0;1;2;4;4;0
24481.0;2023;14;RENNES;MASCULIN;SCOLAIRE;BAC PROFESSIONNEL;BAC PRO PROD;BAC PRO 22704 TECHN. MAINT. SYST.ENERG.CLIMATI;16;16;13;3;0;0;0;13;0;0;3;4;6;3
24483.0;2023;14;RENNES;MASCULIN;SCOLAIRE;BAC PROFESSIONNEL;BAC PRO PROD;BAC PRO 23004 TECHN. ETUDES BAT.A ETUDES & ECO.;60;60;52;8;0;0;0;52;0;1;8;21;22;8
24487.0;2023;14;RENNES;MASCULIN;SCOLAIRE;BAC PROFESSIONNEL;BAC PRO PROD;BAC PRO 23203 TECHNICIEN BAT. : ORG.REAL.GROS O;22;22;12;8;2;2;0;14;0;1;4;3;6;8
24488.0;2023;14;RENNES;MASCULIN;SCOLAIRE;BAC PROFESSIONNEL;BAC PRO PROD;BAC PRO 23303 MENUISERIE ALUMINIUM-VERRE;3;3;2;0;1;0;1;2;0;0;1;0;1;1
24491.0;2023;14;RENNES;MASCULIN;SCOLAIRE;BAC PROFESSIONNEL;BAC PRO PROD;BAC PRO 23405 TECHNICIEN MENUISIER AGENCEUR;194;193;153;34;6;6;0;159;0;8;37;59;55;34
24495.0;2023;14;RENNES;MASCULIN;SCOLAIRE;BAC PROFESSIONNEL;BAC PRO PROD;BAC PRO 24203 METIERS DE LA MODE - VÊTEMENT;19;19;18;1;0;0;0;18;0;0;4;8;6;1
24498.0;2023;14;RENNES;MASCULIN;SCOLAIRE;BAC PROFESSIONNEL;BAC PRO PROD;BAC PRO 25007 MAINTENANCE EQUIPEMENTS INDUST.;256;256;215;35;6;6;0;221;0;3;43;103;72;35
24504.0;2023;14;RENNES;MASCULIN;SCOLAIRE;BAC PROFESSIONNEL;BAC PRO PROD;BAC PRO 25216 MAINT.VEHIC.OPTC MOTOCYCLES;44;44;43;1;0;0;0;43;0;1;15;18;9;1
24507.0;2023;14;RENNES;MASCULIN;SCOLAIRE;BAC PROFESSIONNEL;BAC PRO PROD;BAC PRO 25221 MAINT.MATERIELS OPT.C ESP. VERTS;8;8;4;3;1;1;0;5;0;0;1;0;4;3
24509.0;2023;14;RENNES;MASCULIN;SCOLAIRE;BAC PROFESSIONNEL;BAC PRO PROD;BAC PRO 25303 AERONAUTIQUE OPTION SYSTEMES;20;20;20;0;0;0;0;20;0;1;6;10;3;0
24511.0;2023;14;RENNES;MASCULIN;SCOLAIRE;BAC PROFESSIONNEL;BAC PRO PROD;BAC PRO 25406 OUVRAGES DU BATIMENT METALLERIE;18;18;16;1;1;1;0;17;0;0;1;8;8;1
24537.0;2023;14;RENNES;MASCULIN;SCOLAIRE;BAC PROFESSIONNEL;BAC PRO SERV;BAC PRO 31213 MET.COM.VEN.OP.A ANI.GES.ESP.COM.;518;518;446;51;21;17;4;463;0;14;84;169;196;55
24541.0;2023;14;RENNES;MASCULIN;SCOLAIRE;BAC PROFESSIONNEL;BAC PRO SERV;BAC PRO 32303 ART.& MET.ART:COM.VIS.VIS.PLURI-M;4;4;4;0;0;0;0;4;0;2;1;1;0;0
24542.0;2023;14;RENNES;MASCULIN;SCOLAIRE;BAC PROFESSIONNEL;BAC PRO SERV;BAC PRO 33003 ACC.SOINS-S.PERS. OPT.A DOMICILE;8;8;6;2;0;0;0;6;0;1;1;2;2;2
24549.0;2023;14;RENNES;MASCULIN;SCOLAIRE;BAC PROFESSIONNEL;BAC PRO SERV;BAC PRO 34304 HYGIENE PROPRETE STERILISATION;4;4;2;0;2;2;0;4;0;0;0;1;3;0
24558.0;2023;14;RENNES;MASCULIN;SCOLAIRE;BAC TECHNOLOGIQUE;BAC STI2D;BAC STI2D ARCHITECTURE ET CONSTRUCTION;197;197;183;3;11;6;5;189;0;9;32;96;52;8
24563.0;2023;14;RENNES;MASCULIN;SCOLAIRE;BAC TECHNOLOGIQUE;BAC STL;BAC STL SCIENCES PHYSIQUES CHIMIQUES  EN LABORAT.;48;48;44;2;2;1;1;45;0;2;12;19;12;3
24571.0;2023;15;STRASBOURG;FEMININ;APPRENTISSAGE;BAC PROFESSIONNEL;BAC PRO PROD;BAC PRO 22106 CUISINE;10;10;7;0;3;3;0;10;0;1;1;4;4;0
24574.0;2023;15;STRASBOURG;FEMININ;APPRENTISSAGE;BAC PROFESSIONNEL;BAC PRO PROD;BAC PRO 25007 MAINTENANCE EQUIPEMENTS INDUST.;4;4;3;1;0;0;0;3;0;1;2;0;0;1
24577.0;2023;15;STRASBOURG;FEMININ;APPRENTISSAGE;BAC PROFESSIONNEL;BAC PRO PROD;BAC PRO 25408 REPARATION DES CARROSSERIES;1;1;1;0;0;0;0;1;0;0;0;1;0;0
24591.0;2023;15;STRASBOURG;FEMININ;APPRENTISSAGE;BAC PROFESSIONNEL;BAC PRO SERV;BAC PRO 32208 REAL.PR.IMPR.PLURI.OPTB.PR.IMPR.;1;1;0;1;0;0;0;0;0;0;0;0;0;1
24601.0;2023;15;STRASBOURG;FEMININ;ENSEIGNEMENT A DISTANCE;BAC TECHNOLOGIQUE;BAC STMG;BAC STMG MERCATIQUE (MARKETING);3;3;2;0;1;0;1;2;0;0;0;0;2;1
24604.0;2023;15;STRASBOURG;FEMININ;FORMATION CONTINUE;BAC PROFESSIONNEL;BAC PRO PROD;BAC PRO 25106 TECHNICIEN D'USINAGE;1;1;1;0;0;0;0;1;0;1;0;0;0;0
24606.0;2023;15;STRASBOURG;FEMININ;FORMATION CONTINUE;BAC PROFESSIONNEL;BAC PRO SERV;BAC PRO 30004 ASSISTANC.GEST.ORGANIS.ACTIVITES;1;1;1;0;0;0;0;1;0;0;0;0;1;0
24609.0;2023;15;STRASBOURG;FEMININ;INDIVIDUEL;BAC GENERAL;BAC GENERAL;BAC GENE 10019 BAC GENERAL;78;78;50;20;8;4;4;54;0;8;13;16;17;24
24613.0;2023;15;STRASBOURG;FEMININ;INDIVIDUEL;BAC PROFESSIONNEL;BAC PRO SERV;BAC PRO 30004 ASSISTANC.GEST.ORGANIS.ACTIVITES;13;7;1;5;1;1;0;2;0;0;0;0;2;5
24615.0;2023;15;STRASBOURG;FEMININ;INDIVIDUEL;BAC PROFESSIONNEL;BAC PRO SERV;BAC PRO 31213 MET.COM.VEN.OP.A ANI.GES.ESP.COM.;8;5;1;4;0;0;0;1;0;0;0;0;1;4
24618.0;2023;15;STRASBOURG;FEMININ;INDIVIDUEL;BAC PROFESSIONNEL;BAC PRO SERV;BAC PRO 33004 ACC.SOINS-S.PERS. OPT.EN STRUCTUR;4;1;0;1;0;0;0;0;0;0;0;0;0;1
24619.0;2023;15;STRASBOURG;FEMININ;INDIVIDUEL;BAC PROFESSIONNEL;BAC PRO SERV;BAC PRO 33403 COMMERC. SERVICES EN RESTAURATION;1;1;0;1;0;0;0;0;0;0;0;0;0;1
24620.0;2023;15;STRASBOURG;FEMININ;INDIVIDUEL;BAC PROFESSIONNEL;BAC PRO SERV;BAC PRO 33603 ESTHETIQUE COSMETIQUE PARFUMERIE;1;1;1;0;0;0;0;1;0;0;0;1;0;0
24629.0;2023;15;STRASBOURG;FEMININ;SCOLAIRE;BAC PROFESSIONNEL;BAC PRO PROD;BAC PRO 22004 PROC. CHIMIE EAU PAPIERS-CARTONS;7;7;5;1;1;1;0;6;0;1;0;3;2;1
24637.0;2023;15;STRASBOURG;FEMININ;SCOLAIRE;BAC PROFESSIONNEL;BAC PRO PROD;BAC PRO 23405 TECHNICIEN MENUISIER AGENCEUR;3;3;2;1;0;0;0;2;0;0;0;0;2;1
24651.0;2023;15;STRASBOURG;FEMININ;SCOLAIRE;BAC PROFESSIONNEL;BAC PRO PROD;BAC PRO AG 21113 CGEVV;5;5;4;1;0;0;0;4;0;0;0;4;0;1
24657.0;2023;15;STRASBOURG;FEMININ;SCOLAIRE;BAC PROFESSIONNEL;BAC PRO SERV;BAC PRO 31106 LOGISTIQUE;3;3;0;3;0;0;0;0;0;0;0;0;0;3
24658.0;2023;15;STRASBOURG;FEMININ;SCOLAIRE;BAC PROFESSIONNEL;BAC PRO SERV;BAC PRO 31107 CONDUCT. TRANSP.ROUT.MARCHANDISES;3;3;1;2;0;0;0;1;0;0;0;0;1;2
24671.0;2023;15;STRASBOURG;FEMININ;SCOLAIRE;BAC PROFESSIONNEL;BAC PRO SERV;BAC PRO 33403 COMMERC. SERVICES EN RESTAURATION;33;33;30;2;1;0;1;30;0;1;11;13;5;3
24673.0;2023;15;STRASBOURG;FEMININ;SCOLAIRE;BAC PROFESSIONNEL;BAC PRO SERV;BAC PRO 33604 METIERS DE LA COIFFURE;11;11;9;2;0;0;0;9;0;2;0;2;5;2
24675.0;2023;15;STRASBOURG;FEMININ;SCOLAIRE;BAC PROFESSIONNEL;BAC PRO SERV;BAC PRO 34403 METIERS DE LA SECURITE;15;15;15;0;0;0;0;15;0;1;4;6;4;0
24676.0;2023;15;STRASBOURG;FEMININ;SCOLAIRE;BAC PROFESSIONNEL;BAC PRO SERV;BAC PRO AG 33002 SERV PERS TERRIT;31;30;25;5;0;0;0;25;0;0;4;12;9;5
24692.0;2023;15;STRASBOURG;MASCULIN;APPRENTISSAGE;BAC PROFESSIONNEL;BAC PRO PROD;BAC PRO 20102 PILOTE DE LIGNE DE PRODUCTION;15;15;13;1;1;1;0;14;0;3;3;4;4;1
24694.0;2023;15;STRASBOURG;MASCULIN;APPRENTISSAGE;BAC PROFESSIONNEL;BAC PRO PROD;BAC PRO 22308 ART.MET.ART-FACT.ORG. OPT.ORGAN.;2;2;2;0;0;0;0;2;0;0;1;1;0;0
24702.0;2023;15;STRASBOURG;MASCULIN;APPRENTISSAGE;BAC PROFESSIONNEL;BAC PRO PROD;BAC PRO 23405 TECHNICIEN MENUISIER AGENCEUR;13;13;11;2;0;0;0;11;0;0;1;5;5;2
24708.0;2023;15;STRASBOURG;MASCULIN;APPRENTISSAGE;BAC PROFESSIONNEL;BAC PRO PROD;BAC PRO 25214 MAINT.VEHIC.OPTA VOIT.PARTICUL.;110;109;94;9;6;3;3;97;0;19;21;35;22;12
24710.0;2023;15;STRASBOURG;MASCULIN;APPRENTISSAGE;BAC PROFESSIONNEL;BAC PRO PROD;BAC PRO 25216 MAINT.VEHIC.OPTC MOTOCYCLES;8;8;7;1;0;0;0;7;0;2;2;2;1;1
24715.0;2023;15;STRASBOURG;MASCULIN;APPRENTISSAGE;BAC PROFESSIONNEL;BAC PRO PROD;BAC PRO 25408 REPARATION DES CARROSSERIES;21;21;18;3;0;0;0;18;0;0;2;9;7;3
24725.0;2023;15;STRASBOURG;MASCULIN;APPRENTISSAGE;BAC PROFESSIONNEL;BAC PRO PROD;BAC PRO AG 21114 CONDUITE PRODUCTIONS HORTICOLES;7;7;7;0;0;0;0;7;0;2;0;2;3;0
24745.0;2023;15;STRASBOURG;MASCULIN;FORMATION CONTINUE;BAC PROFESSIONNEL;BAC PRO PROD;BAC PRO 22503 PLASTIQUES ET COMPOSITES;1;1;1;0;0;0;0;1;0;0;0;0;1;0
24749.0;2023;15;STRASBOURG;MASCULIN;FORMATION CONTINUE;BAC PROFESSIONNEL;BAC PRO PROD;BAC PRO 23407 TECHNIC.FAB.BOIS ET MATERX ASSOC;1;1;1;0;0;0;0;1;0;1;0;0;0;0
24759.0;2023;15;STRASBOURG;MASCULIN;INDIVIDUEL;BAC PROFESSIONNEL;BAC PRO PROD;BAC PRO 22703 TECHN.INSTALL.SYST.ENERG.CLIMATI;2;2;0;2;0;0;0;0;0;0;0;0;0;2
24761.0;2023;15;STRASBOURG;MASCULIN;INDIVIDUEL;BAC PROFESSIONNEL;BAC PRO PROD;BAC PRO 23303 MENUISERIE ALUMINIUM-VERRE;1;0;0;0;0;0;0;0;0;0;0;0;0;0
24764.0;2023;15;STRASBOURG;MASCULIN;INDIVIDUEL;BAC PROFESSIONNEL;BAC PRO PROD;BAC PRO 25408 REPARATION DES CARROSSERIES;2;2;2;0;0;0;0;2;0;0;0;1;1;0
24768.0;2023;15;STRASBOURG;MASCULIN;INDIVIDUEL;BAC PROFESSIONNEL;BAC PRO PROD;BAC PRO AG 21114 CONDUITE PRODUCTIONS HORTICOLES;2;2;2;0;0;0;0;2;0;0;0;0;2;0
24770.0;2023;15;STRASBOURG;MASCULIN;INDIVIDUEL;BAC PROFESSIONNEL;BAC PRO SERV;BAC PRO 30004 ASSISTANC.GEST.ORGANIS.ACTIVITES;3;2;0;2;0;0;0;0;0;0;0;0;0;2
24772.0;2023;15;STRASBOURG;MASCULIN;INDIVIDUEL;BAC PROFESSIONNEL;BAC PRO SERV;BAC PRO 31114 ORGANIS. TRANSPORT MARCHANDISES;1;1;1;0;0;0;0;1;0;0;0;0;1;0
24784.0;2023;15;STRASBOURG;MASCULIN;SCOLAIRE;BAC PROFESSIONNEL;BAC PRO PROD;BAC PRO 22003 BIO-INDUSTRIES DE TRANSFORMATION;12;12;6;6;0;0;0;6;0;0;0;2;4;6
24787.0;2023;15;STRASBOURG;MASCULIN;SCOLAIRE;BAC PROFESSIONNEL;BAC PRO PROD;BAC PRO 22106 CUISINE;64;64;53;8;3;1;2;54;0;11;14;15;14;10
24788.0;2023;15;STRASBOURG;MASCULIN;SCOLAIRE;BAC PROFESSIONNEL;BAC PRO PROD;BAC PRO 22503 PLASTIQUES ET COMPOSITES;11;11;11;0;0;0;0;11;0;0;3;7;1;0
24790.0;2023;15;STRASBOURG;MASCULIN;SCOLAIRE;BAC PROFESSIONNEL;BAC PRO PROD;BAC PRO 22704 TECHN. MAINT. SYST.ENERG.CLIMATI;40;40;33;6;1;1;0;34;0;0;4;13;17;6
24792.0;2023;15;STRASBOURG;MASCULIN;SCOLAIRE;BAC PROFESSIONNEL;BAC PRO PROD;BAC PRO 23005 TECHN. ETUDES BAT B ASSIST.ARCHI.;22;22;16;5;1;1;0;17;0;0;4;3;10;5
24806.0;2023;15;STRASBOURG;MASCULIN;SCOLAIRE;BAC PROFESSIONNEL;BAC PRO PROD;BAC PRO 25215 MAINT.VEHIC.OPTB VEHIC.TRANS.ROUT;20;20;17;2;1;1;0;18;0;1;3;6;8;2
24808.0;2023;15;STRASBOURG;MASCULIN;SCOLAIRE;BAC PROFESSIONNEL;BAC PRO PROD;BAC PRO 25219 MAINT.MATERIELS OPT.A AGRICOLES;11;11;8;3;0;0;0;8;0;0;3;2;3;3
24811.0;2023;15;STRASBOURG;MASCULIN;SCOLAIRE;BAC PROFESSIONNEL;BAC PRO PROD;BAC PRO 25406 OUVRAGES DU BATIMENT METALLERIE;17;17;14;3;0;0;0;14;0;1;3;5;5;3
24815.0;2023;15;STRASBOURG;MASCULIN;SCOLAIRE;BAC PROFESSIONNEL;BAC PRO PROD;BAC PRO 25510 METIERS ELECT. ENVIRON. CONNECTES;319;318;239;57;22;16;6;255;0;18;40;90;107;63
24825.0;2023;15;STRASBOURG;MASCULIN;SCOLAIRE;BAC PROFESSIONNEL;BAC PRO PROD;BAC PRO AG 22105 LABORATOIRE CONTROLE QUALITE;8;8;7;1;0;0;0;7;0;1;0;4;2;1
24826.0;2023;15;STRASBOURG;MASCULIN;SCOLAIRE;BAC PROFESSIONNEL;BAC PRO PROD;BAC PRO AG 22108 TEC CONS VTE ALIMENTATION (PAB);3;3;3;0;0;0;0;3;0;0;0;0;3;0
24828.0;2023;15;STRASBOURG;MASCULIN;SCOLAIRE;BAC PROFESSIONNEL;BAC PRO SERV;BAC PRO 31106 LOGISTIQUE;22;22;18;2;2;1;1;19;0;0;2;8;9;3
24836.0;2023;15;STRASBOURG;MASCULIN;SCOLAIRE;BAC PROFESSIONNEL;BAC PRO SERV;BAC PRO 32208 REAL.PR.IMPR.PLURI.OPTB.PR.IMPR.;8;8;6;1;1;1;0;7;0;0;1;1;5;1
24844.0;2023;15;STRASBOURG;MASCULIN;SCOLAIRE;BAC PROFESSIONNEL;BAC PRO SERV;BAC PRO 34304 HYGIENE PROPRETE STERILISATION;5;5;4;0;1;1;0;5;0;1;1;1;2;0
24847.0;2023;15;STRASBOURG;MASCULIN;SCOLAIRE;BAC TECHNOLOGIQUE;BAC ST2S;BAC ST2S SCIENCES & TECHNO. SANTE & SOCIAL;86;86;73;1;12;7;5;80;0;3;14;27;36;6
24860.0;2023;15;STRASBOURG;MASCULIN;SCOLAIRE;BAC TECHNOLOGIQUE;BAC STMG;BAC STMG SYSTEMES D'INFORMATION DE GESTION;28;28;18;2;8;7;1;25;0;1;2;1;21;3
24865.0;2023;16;TOULOUSE;FEMININ;APPRENTISSAGE;BAC PROFESSIONNEL;BAC PRO PROD;BAC PRO 23407 TECHNIC.FAB.BOIS ET MATERX ASSOC;1;1;1;0;0;0;0;1;0;0;1;0;0;0
24867.0;2023;16;TOULOUSE;FEMININ;APPRENTISSAGE;BAC PROFESSIONNEL;BAC PRO PROD;BAC PRO 25007 MAINTENANCE EQUIPEMENTS INDUST.;2;2;2;0;0;0;0;2;0;0;1;1;0;0
24872.0;2023;16;TOULOUSE;FEMININ;APPRENTISSAGE;BAC PROFESSIONNEL;BAC PRO PROD;BAC PRO 25221 MAINT.MATERIELS OPT.C ESP. VERTS;1;1;1;0;0;0;0;1;0;0;0;0;1;0
24877.0;2023;16;TOULOUSE;FEMININ;APPRENTISSAGE;BAC PROFESSIONNEL;BAC PRO PROD;BAC PRO AG 21004 CGEA;6;6;6;0;0;0;0;6;0;0;0;3;3;0
24880.0;2023;16;TOULOUSE;FEMININ;APPRENTISSAGE;BAC PROFESSIONNEL;BAC PRO SERV;BAC PRO 30004 ASSISTANC.GEST.ORGANIS.ACTIVITES;22;22;18;4;0;0;0;18;0;4;3;4;7;4
24882.0;2023;16;TOULOUSE;FEMININ;APPRENTISSAGE;BAC PROFESSIONNEL;BAC PRO SERV;BAC PRO 31212 METIERS DE L'ACCUEIL;8;8;8;0;0;0;0;8;0;1;0;4;3;0
24883.0;2023;16;TOULOUSE;FEMININ;APPRENTISSAGE;BAC PROFESSIONNEL;BAC PRO SERV;BAC PRO 31213 MET.COM.VEN.OP.A ANI.GES.ESP.COM.;92;88;69;15;4;3;1;72;0;9;13;24;26;16
24884.0;2023;16;TOULOUSE;FEMININ;APPRENTISSAGE;BAC PROFESSIONNEL;BAC PRO SERV;BAC PRO 31214 MET.COM.VEN.OP.B PR.CL.VA.OF.COM.;4;3;2;1;0;0;0;2;0;0;1;0;1;1
24886.0;2023;16;TOULOUSE;FEMININ;APPRENTISSAGE;BAC PROFESSIONNEL;BAC PRO SERV;BAC PRO 32208 REAL.PR.IMPR.PLURI.OPTB.PR.IMPR.;2;2;2;0;0;0;0;2;0;1;0;1;0;0
24887.0;2023;16;TOULOUSE;FEMININ;APPRENTISSAGE;BAC PROFESSIONNEL;BAC PRO SERV;BAC PRO 32304 PHOTOGRAPHIE;3;3;3;0;0;0;0;3;0;0;1;2;0;0
24891.0;2023;16;TOULOUSE;FEMININ;APPRENTISSAGE;BAC PROFESSIONNEL;BAC PRO SERV;BAC PRO 33403 COMMERC. SERVICES EN RESTAURATION;8;7;4;1;2;0;2;4;0;1;2;1;0;3
24892.0;2023;16;TOULOUSE;FEMININ;APPRENTISSAGE;BAC PROFESSIONNEL;BAC PRO SERV;BAC PRO 33603 ESTHETIQUE COSMETIQUE PARFUMERIE;9;9;8;1;0;0;0;8;0;0;2;2;4;1
24903.0;2023;16;TOULOUSE;FEMININ;ENSEIGNEMENT A DISTANCE;BAC TECHNOLOGIQUE;BAC STMG;BAC STMG MERCATIQUE (MARKETING);7;7;6;1;0;0;0;6;0;0;0;4;2;1
24906.0;2023;16;TOULOUSE;FEMININ;FORMATION CONTINUE;BAC PROFESSIONNEL;BAC PRO PROD;BAC PRO 22705 TECHNICIEN GAZ;1;1;1;0;0;0;0;1;0;0;1;0;0;0
24911.0;2023;16;TOULOUSE;FEMININ;INDIVIDUEL;BAC GENERAL;BAC GENERAL;BAC GENE 10019 BAC GENERAL;80;80;26;44;10;5;5;31;0;4;1;11;15;49
24912.0;2023;16;TOULOUSE;FEMININ;INDIVIDUEL;BAC PROFESSIONNEL;BAC PRO PROD;BAC PRO 22105 BOULANGER-PÂTISSIER;1;1;0;1;0;0;0;0;0;0;0;0;0;1
24918.0;2023;16;TOULOUSE;FEMININ;INDIVIDUEL;BAC PROFESSIONNEL;BAC PRO PROD;BAC PRO AG 21211 COND GEST ENTR HIPPIQUE;4;3;2;1;0;0;0;2;0;0;0;0;2;1
24919.0;2023;16;TOULOUSE;FEMININ;INDIVIDUEL;BAC PROFESSIONNEL;BAC PRO SERV;BAC PRO 30004 ASSISTANC.GEST.ORGANIS.ACTIVITES;4;3;2;0;1;0;1;2;0;0;0;0;2;1
24925.0;2023;16;TOULOUSE;FEMININ;INDIVIDUEL;BAC PROFESSIONNEL;BAC PRO SERV;BAC PRO 33004 ACC.SOINS-S.PERS. OPT.EN STRUCTUR;6;1;0;0;1;1;0;1;0;0;0;0;1;0
24928.0;2023;16;TOULOUSE;FEMININ;INDIVIDUEL;BAC PROFESSIONNEL;BAC PRO SERV;BAC PRO AG 33002 SERV PERS TERRIT;1;1;0;1;0;0;0;0;0;0;0;0;0;1
24942.0;2023;16;TOULOUSE;FEMININ;SCOLAIRE;BAC PROFESSIONNEL;BAC PRO PROD;BAC PRO 23003 ARTIS. & M.ART:MARCHANDISAGE VIS.;21;21;19;1;1;1;0;20;0;0;6;7;7;1
24943.0;2023;16;TOULOUSE;FEMININ;SCOLAIRE;BAC PROFESSIONNEL;BAC PRO PROD;BAC PRO 23004 TECHN. ETUDES BAT.A ETUDES & ECO.;17;17;11;6;0;0;0;11;0;0;2;3;6;6
24944.0;2023;16;TOULOUSE;FEMININ;SCOLAIRE;BAC PROFESSIONNEL;BAC PRO PROD;BAC PRO 23005 TECHN. ETUDES BAT B ASSIST.ARCHI.;31;31;26;4;1;1;0;27;0;2;10;10;5;4
24945.0;2023;16;TOULOUSE;FEMININ;SCOLAIRE;BAC PROFESSIONNEL;BAC PRO PROD;BACPRO 23103 TECHNICIEN GEOMETRE-TOPOGRAPHE;1;1;1;0;0;0;0;1;0;0;0;1;0;0
24947.0;2023;16;TOULOUSE;FEMININ;SCOLAIRE;BAC PROFESSIONNEL;BAC PRO PROD;BAC PRO 23304 AMENAGEMENT FINITION BATIMENT;2;2;2;0;0;0;0;2;0;0;2;0;0;0
24948.0;2023;16;TOULOUSE;FEMININ;SCOLAIRE;BAC PROFESSIONNEL;BAC PRO PROD;BAC PRO 23405 TECHNICIEN MENUISIER AGENCEUR;4;4;4;0;0;0;0;4;0;0;2;1;1;0
24950.0;2023;16;TOULOUSE;FEMININ;SCOLAIRE;BAC PROFESSIONNEL;BAC PRO PROD;BAC PRO 24202 ARTIS.& MET.ART : TAPIS.D'AMEUBL;11;11;9;2;0;0;0;9;0;0;2;3;4;2
24954.0;2023;16;TOULOUSE;FEMININ;SCOLAIRE;BAC PROFESSIONNEL;BAC PRO PROD;BAC PRO 25007 MAINTENANCE EQUIPEMENTS INDUST.;3;3;3;0;0;0;0;3;0;0;1;2;0;0
24955.0;2023;16;TOULOUSE;FEMININ;SCOLAIRE;BAC PROFESSIONNEL;BAC PRO PROD;BAC PRO 25106 TECHNICIEN D'USINAGE;5;5;4;1;0;0;0;4;0;0;2;0;2;1
24961.0;2023;16;TOULOUSE;FEMININ;SCOLAIRE;BAC PROFESSIONNEL;BAC PRO PROD;BAC PRO 25302 AERONAUTIQUE OPTION AVIONIQUE;7;7;7;0;0;0;0;7;0;1;2;3;1;0
24974.0;2023;16;TOULOUSE;FEMININ;SCOLAIRE;BAC PROFESSIONNEL;BAC PRO PROD;BAC PRO AG 21211 COND GEST ENTR HIPPIQUE;47;47;44;3;0;0;0;44;0;1;8;18;17;3
24980.0;2023;16;TOULOUSE;FEMININ;SCOLAIRE;BAC PROFESSIONNEL;BAC PRO SERV;BAC PRO 30004 ASSISTANC.GEST.ORGANIS.ACTIVITES;423;420;349;58;13;9;4;358;0;13;64;138;143;62
24984.0;2023;16;TOULOUSE;FEMININ;SCOLAIRE;BAC PROFESSIONNEL;BAC PRO SERV;BAC PRO 31212 METIERS DE L'ACCUEIL;240;240;195;26;19;14;5;209;0;19;48;55;87;31
24985.0;2023;16;TOULOUSE;FEMININ;SCOLAIRE;BAC PROFESSIONNEL;BAC PRO SERV;BAC PRO 31213 MET.COM.VEN.OP.A ANI.GES.ESP.COM.;426;426;358;43;25;17;8;375;0;29;86;132;128;51
24989.0;2023;16;TOULOUSE;FEMININ;SCOLAIRE;BAC PROFESSIONNEL;BAC PRO SERV;BAC PRO 32303 ART.& MET.ART:COM.VIS.VIS.PLURI-M;40;40;36;4;0;0;0;36;0;5;13;13;5;4
24990.0;2023;16;TOULOUSE;FEMININ;SCOLAIRE;BAC PROFESSIONNEL;BAC PRO SERV;BAC PRO 32304 PHOTOGRAPHIE;7;7;7;0;0;0;0;7;0;0;2;1;4;0
24994.0;2023;16;TOULOUSE;FEMININ;SCOLAIRE;BAC PROFESSIONNEL;BAC PRO SERV;BAC PRO 33101 OPTIQUE LUNETTERIE;9;9;9;0;0;0;0;9;0;0;4;5;0;0
25000.0;2023;16;TOULOUSE;FEMININ;SCOLAIRE;BAC PROFESSIONNEL;BAC PRO SERV;BAC PRO 33604 METIERS DE LA COIFFURE;40;40;35;3;2;1;1;36;0;0;6;16;14;4
25010.0;2023;16;TOULOUSE;FEMININ;SCOLAIRE;BAC TECHNOLOGIQUE;BAC STHR;BAC STHR SC.&TEC. HOTELLERIE-RESTAURATION;51;51;48;0;3;2;1;50;1;3;16;18;12;1
25016.0;2023;16;TOULOUSE;FEMININ;SCOLAIRE;BAC TECHNOLOGIQUE;BAC STL;BAC STL SCIENCES PHYSIQUES CHIMIQUES  EN LABORAT.;77;77;69;2;6;2;4;71;0;3;15;31;22;6
25039.0;2023;16;TOULOUSE;MASCULIN;APPRENTISSAGE;BAC PROFESSIONNEL;BAC PRO PROD;BAC PRO 23405 TECHNICIEN MENUISIER AGENCEUR;6;6;6;0;0;0;0;6;0;0;1;3;2;0
25042.0;2023;16;TOULOUSE;MASCULIN;APPRENTISSAGE;BAC PROFESSIONNEL;BAC PRO PROD;BAC PRO 25007 MAINTENANCE EQUIPEMENTS INDUST.;39;39;30;8;1;1;0;31;0;7;4;10;10;8
25043.0;2023;16;TOULOUSE;MASCULIN;APPRENTISSAGE;BAC PROFESSIONNEL;BAC PRO PROD;BAC PRO 25106 TECHNICIEN D'USINAGE;22;21;20;0;1;0;1;20;0;3;4;5;8;1
25055.0;2023;16;TOULOUSE;MASCULIN;APPRENTISSAGE;BAC PROFESSIONNEL;BAC PRO PROD;BAC PRO 25408 REPARATION DES CARROSSERIES;15;15;11;3;1;0;1;11;0;1;1;4;5;4
25059.0;2023;16;TOULOUSE;MASCULIN;APPRENTISSAGE;BAC PROFESSIONNEL;BAC PRO PROD;BAC PRO 25515 SYST.NUM.OPT.C RES.INF.SYST.COMM.;6;6;4;2;0;0;0;4;0;0;1;1;2;2
25062.0;2023;16;TOULOUSE;MASCULIN;APPRENTISSAGE;BAC PROFESSIONNEL;BAC PRO PROD;BAC PRO AG 22108 TEC CONS VTE ALIMENTATION (PAB);9;8;5;3;0;0;0;5;0;0;1;2;2;3
25065.0;2023;16;TOULOUSE;MASCULIN;APPRENTISSAGE;BAC PROFESSIONNEL;BAC PRO SERV;BAC PRO 31212 METIERS DE L'ACCUEIL;3;3;2;1;0;0;0;2;0;0;2;0;0;1
25072.0;2023;16;TOULOUSE;MASCULIN;APPRENTISSAGE;BAC PROFESSIONNEL;BAC PRO SERV;BAC PRO 33104 TECHNICIEN EN PROTHESE DENTAIRE;7;7;7;0;0;0;0;7;0;2;1;3;1;0
25077.0;2023;16;TOULOUSE;MASCULIN;ENSEIGNEMENT A DISTANCE;BAC PROFESSIONNEL;BAC PRO SERV;BAC PRO 30004 ASSISTANC.GEST.ORGANIS.ACTIVITES;1;0;0;0;0;0;0;0;0;0;0;0;0;0
25078.0;2023;16;TOULOUSE;MASCULIN;ENSEIGNEMENT A DISTANCE;BAC PROFESSIONNEL;BAC PRO SERV;BAC PRO 31213 MET.COM.VEN.OP.A ANI.GES.ESP.COM.;1;1;1;0;0;0;0;1;0;0;1;0;0;0
25079.0;2023;16;TOULOUSE;MASCULIN;ENSEIGNEMENT A DISTANCE;BAC PROFESSIONNEL;BAC PRO SERV;BAC PRO 31214 MET.COM.VEN.OP.B PR.CL.VA.OF.COM.;4;4;3;1;0;0;0;3;0;0;0;2;1;1
25084.0;2023;16;TOULOUSE;MASCULIN;FORMATION CONTINUE;BAC PROFESSIONNEL;BAC PRO PROD;BAC PRO 22703 TECHN.INSTALL.SYST.ENERG.CLIMATI;1;1;1;0;0;0;0;1;0;1;0;0;0;0
25088.0;2023;16;TOULOUSE;MASCULIN;FORMATION CONTINUE;BAC PROFESSIONNEL;BAC PRO PROD;BAC PRO 23304 AMENAGEMENT FINITION BATIMENT;1;1;1;0;0;0;0;1;0;0;0;1;0;0
25094.0;2023;16;TOULOUSE;MASCULIN;FORMATION CONTINUE;BAC PROFESSIONNEL;BAC PRO PROD;BAC PRO AG 21004 CGEA;1;1;1;0;0;0;0;1;0;1;0;0;0;0
25095.0;2023;16;TOULOUSE;MASCULIN;FORMATION CONTINUE;BAC PROFESSIONNEL;BAC PRO PROD;BAC PRO AG 21114 CONDUITE PRODUCTIONS HORTICOLES;4;4;4;0;0;0;0;4;0;0;2;2;0;0
25098.0;2023;16;TOULOUSE;MASCULIN;INDIVIDUEL;BAC PROFESSIONNEL;BAC PRO PROD;BAC PRO 23005 TECHN. ETUDES BAT B ASSIST.ARCHI.;4;4;1;3;0;0;0;1;0;0;0;0;1;3
25099.0;2023;16;TOULOUSE;MASCULIN;INDIVIDUEL;BAC PROFESSIONNEL;BAC PRO PROD;BAC PRO 23408 Etude et réalisation d'agencement;1;1;1;0;0;0;0;1;0;0;0;0;1;0
25106.0;2023;16;TOULOUSE;MASCULIN;INDIVIDUEL;BAC PROFESSIONNEL;BAC PRO PROD;BAC PRO 25302 AERONAUTIQUE OPTION AVIONIQUE;1;1;0;1;0;0;0;0;0;0;0;0;0;1
25109.0;2023;16;TOULOUSE;MASCULIN;INDIVIDUEL;BAC PROFESSIONNEL;BAC PRO PROD;BAC PRO 25411 TECH.CHAUDRONNERIE INDUSTRIELLE;1;1;0;1;0;0;0;0;0;0;0;0;0;1
25110.0;2023;16;TOULOUSE;MASCULIN;INDIVIDUEL;BAC PROFESSIONNEL;BAC PRO PROD;BAC PRO 25510 METIERS ELECT. ENVIRON. CONNECTES;5;2;1;1;0;0;0;1;0;0;0;0;1;1
25112.0;2023;16;TOULOUSE;MASCULIN;INDIVIDUEL;BAC PROFESSIONNEL;BAC PRO PROD;BAC PRO AG 21113 CGEVV;1;1;1;0;0;0;0;1;0;0;0;0;1;0
25114.0;2023;16;TOULOUSE;MASCULIN;INDIVIDUEL;BAC PROFESSIONNEL;BAC PRO PROD;BAC PRO AG 21405 AMENAGEMENTS PAYSAGERS;1;1;1;0;0;0;0;1;0;0;0;0;1;0
25116.0;2023;16;TOULOUSE;MASCULIN;INDIVIDUEL;BAC PROFESSIONNEL;BAC PRO SERV;BAC PRO 30004 ASSISTANC.GEST.ORGANIS.ACTIVITES;4;2;0;2;0;0;0;0;0;0;0;0;0;2
25119.0;2023;16;TOULOUSE;MASCULIN;INDIVIDUEL;BAC PROFESSIONNEL;BAC PRO SERV;BAC PRO 31213 MET.COM.VEN.OP.A ANI.GES.ESP.COM.;4;3;2;0;1;0;1;2;0;0;0;0;2;1
25123.0;2023;16;TOULOUSE;MASCULIN;INDIVIDUEL;BAC TECHNOLOGIQUE;BAC STI2D;BAC STI2D INNOVATION TECHNO.  ET ECO CONCEPTION;2;2;0;1;1;0;1;0;0;0;0;0;0;2
25124.0;2023;16;TOULOUSE;MASCULIN;INDIVIDUEL;BAC TECHNOLOGIQUE;BAC STI2D;BAC STI2D SYSTÈME D'INFORMATION  ET NUMERIQUE;2;2;0;1;1;0;1;0;0;0;0;0;0;2
25126.0;2023;16;TOULOUSE;MASCULIN;INDIVIDUEL;BAC TECHNOLOGIQUE;BAC STMG;BAC STMG MERCATIQUE (MARKETING);14;14;7;5;2;1;1;8;0;0;0;1;7;6
25133.0;2023;16;TOULOUSE;MASCULIN;SCOLAIRE;BAC PROFESSIONNEL;BAC PRO PROD;BAC PRO 22104 BOUCHER CHARCUTIER TRAITEUR;3;3;3;0;0;0;0;3;0;0;1;2;0;0
25137.0;2023;16;TOULOUSE;MASCULIN;SCOLAIRE;BAC PROFESSIONNEL;BAC PRO PROD;BAC PRO 22503 PLASTIQUES ET COMPOSITES;15;15;10;2;3;2;1;12;0;0;0;6;6;3
25141.0;2023;16;TOULOUSE;MASCULIN;SCOLAIRE;BAC PROFESSIONNEL;BAC PRO PROD;BAC PRO 23004 TECHN. ETUDES BAT.A ETUDES & ECO.;58;58;41;16;1;1;0;42;0;1;5;12;24;16
25144.0;2023;16;TOULOUSE;MASCULIN;SCOLAIRE;BAC PROFESSIONNEL;BAC PRO PROD;BACPRO 23103 TECHNICIEN GEOMETRE-TOPOGRAPHE;13;13;11;2;0;0;0;11;0;1;0;7;3;2
25151.0;2023;16;TOULOUSE;MASCULIN;SCOLAIRE;BAC PROFESSIONNEL;BAC PRO PROD;BAC PRO 23406 TECHNICIEN DE SCIERIE;1;1;1;0;0;0;0;1;0;0;1;0;0;0
25154.0;2023;16;TOULOUSE;MASCULIN;SCOLAIRE;BAC PROFESSIONNEL;BAC PRO PROD;BAC PRO 24202 ARTIS.& MET.ART : TAPIS.D'AMEUBL;2;2;2;0;0;0;0;2;0;0;0;1;1;0
25164.0;2023;16;TOULOUSE;MASCULIN;SCOLAIRE;BAC PROFESSIONNEL;BAC PRO PROD;BAC PRO 25216 MAINT.VEHIC.OPTC MOTOCYCLES;43;43;42;1;0;0;0;42;0;5;17;12;8;1
25167.0;2023;16;TOULOUSE;MASCULIN;SCOLAIRE;BAC PROFESSIONNEL;BAC PRO PROD;BAC PRO 25221 MAINT.MATERIELS OPT.C ESP. VERTS;15;15;8;6;1;1;0;9;0;0;2;2;5;6
25172.0;2023;16;TOULOUSE;MASCULIN;SCOLAIRE;BAC PROFESSIONNEL;BAC PRO PROD;BAC PRO 25408 REPARATION DES CARROSSERIES;40;40;34;4;2;1;1;35;0;3;5;15;12;5
25174.0;2023;16;TOULOUSE;MASCULIN;SCOLAIRE;BAC PROFESSIONNEL;BAC PRO PROD;BAC PRO 25509 TECHNIC. FROID CONDITIONNEMT AIR;15;15;11;2;2;1;1;12;0;1;3;3;5;3
25181.0;2023;16;TOULOUSE;MASCULIN;SCOLAIRE;BAC PROFESSIONNEL;BAC PRO PROD;BAC PRO AG 21113 CGEVV;10;10;10;0;0;0;0;10;0;0;1;3;6;0
25188.0;2023;16;TOULOUSE;MASCULIN;SCOLAIRE;BAC PROFESSIONNEL;BAC PRO PROD;BAC PRO AG 21405 AMENAGEMENTS PAYSAGERS;88;88;86;2;0;0;0;86;0;1;9;33;43;2
25193.0;2023;16;TOULOUSE;MASCULIN;SCOLAIRE;BAC PROFESSIONNEL;BAC PRO SERV;BAC PRO 31106 LOGISTIQUE;44;44;25;19;0;0;0;25;0;2;4;4;15;19
25196.0;2023;16;TOULOUSE;MASCULIN;SCOLAIRE;BAC PROFESSIONNEL;BAC PRO SERV;BAC PRO 31212 METIERS DE L'ACCUEIL;81;81;66;9;6;5;1;71;0;2;15;20;34;10
25200.0;2023;16;TOULOUSE;MASCULIN;SCOLAIRE;BAC PROFESSIONNEL;BAC PRO SERV;BAC PRO 32208 REAL.PR.IMPR.PLURI.OPTB.PR.IMPR.;5;5;5;0;0;0;0;5;0;0;2;2;1;0
25201.0;2023;16;TOULOUSE;MASCULIN;SCOLAIRE;BAC PROFESSIONNEL;BAC PRO SERV;BAC PRO 32303 ART.& MET.ART:COM.VIS.VIS.PLURI-M;46;46;39;7;0;0;0;39;0;0;7;23;9;7
25203.0;2023;16;TOULOUSE;MASCULIN;SCOLAIRE;BAC PROFESSIONNEL;BAC PRO SERV;BAC PRO 33003 ACC.SOINS-S.PERS. OPT.A DOMICILE;2;2;1;1;0;0;0;1;0;0;0;0;1;1
25206.0;2023;16;TOULOUSE;MASCULIN;SCOLAIRE;BAC PROFESSIONNEL;BAC PRO SERV;BAC PRO 33101 OPTIQUE LUNETTERIE;7;7;7;0;0;0;0;7;0;0;1;5;1;0
25211.0;2023;16;TOULOUSE;MASCULIN;SCOLAIRE;BAC PROFESSIONNEL;BAC PRO SERV;BAC PRO 33603 ESTHETIQUE COSMETIQUE PARFUMERIE;3;3;3;0;0;0;0;3;0;0;0;2;1;0
25213.0;2023;16;TOULOUSE;MASCULIN;SCOLAIRE;BAC PROFESSIONNEL;BAC PRO SERV;BAC PRO 34304 HYGIENE PROPRETE STERILISATION;3;3;2;0;1;0;1;2;0;0;0;1;1;1
25215.0;2023;16;TOULOUSE;MASCULIN;SCOLAIRE;BAC PROFESSIONNEL;BAC PRO SERV;BAC PRO AG 33002 SERV PERS TERRIT;49;45;38;7;0;0;0;38;0;0;1;11;26;7
25221.0;2023;16;TOULOUSE;MASCULIN;SCOLAIRE;BAC TECHNOLOGIQUE;BAC STHR;BAC STHR SC.&TEC. HOTELLERIE-RESTAURATION;52;52;47;0;5;2;3;49;1;2;13;18;15;3
25224.0;2023;16;TOULOUSE;MASCULIN;SCOLAIRE;BAC TECHNOLOGIQUE;BAC STI2D;BAC STI2D INNOVATION TECHNO.  ET ECO CONCEPTION;413;413;379;6;28;19;9;398;0;20;74;146;158;15
25234.0;2023;25;VERSAILLES;FEMININ;APPRENTISSAGE;BAC PROFESSIONNEL;BAC PRO PROD;BAC PRO 23304 AMENAGEMENT FINITION BATIMENT;1;1;0;0;1;1;0;1;0;0;0;0;1;0
25238.0;2023;25;VERSAILLES;FEMININ;APPRENTISSAGE;BAC PROFESSIONNEL;BAC PRO PROD;BAC PRO 25303 AERONAUTIQUE OPTION SYSTEMES;3;3;3;0;0;0;0;3;0;2;0;1;0;0
25239.0;2023;25;VERSAILLES;FEMININ;APPRENTISSAGE;BAC PROFESSIONNEL;BAC PRO PROD;BAC PRO 25304 AERONAUTIQUE OPTION STRUCTURE;1;1;1;0;0;0;0;1;0;0;1;0;0;0
25242.0;2023;25;VERSAILLES;FEMININ;APPRENTISSAGE;BAC PROFESSIONNEL;BAC PRO PROD;BAC PRO 25515 SYST.NUM.OPT.C RES.INF.SYST.COMM.;2;2;2;0;0;0;0;2;0;0;0;1;1;0
25249.0;2023;25;VERSAILLES;FEMININ;APPRENTISSAGE;BAC PROFESSIONNEL;BAC PRO SERV;BAC PRO 31213 MET.COM.VEN.OP.A ANI.GES.ESP.COM.;107;107;79;17;11;8;3;87;0;3;15;28;41;20
25250.0;2023;25;VERSAILLES;FEMININ;APPRENTISSAGE;BAC PROFESSIONNEL;BAC PRO SERV;BAC PRO 31214 MET.COM.VEN.OP.B PR.CL.VA.OF.COM.;12;12;9;1;2;2;0;11;0;0;2;2;7;1
25252.0;2023;25;VERSAILLES;FEMININ;APPRENTISSAGE;BAC PROFESSIONNEL;BAC PRO SERV;BAC PRO 33004 ACC.SOINS-S.PERS. OPT.EN STRUCTUR;23;23;20;1;2;2;0;22;0;1;5;8;8;1
25257.0;2023;25;VERSAILLES;FEMININ;APPRENTISSAGE;BAC PROFESSIONNEL;BAC PRO SERV;BAC PRO AG 33002 SERV PERS TERRIT;6;5;2;3;0;0;0;2;0;0;0;0;2;3
25258.0;2023;25;VERSAILLES;FEMININ;ENSEIGNEMENT A DISTANCE;BAC GENERAL;BAC GENERAL;BAC GENE 10019 BAC GENERAL;125;124;80;21;23;15;8;95;1;3;20;22;49;29
25261.0;2023;25;VERSAILLES;FEMININ;ENSEIGNEMENT A DISTANCE;BAC PROFESSIONNEL;BAC PRO SERV;BAC PRO 31213 MET.COM.VEN.OP.A ANI.GES.ESP.COM.;3;2;2;0;0;0;0;2;0;0;0;1;1;0
25262.0;2023;25;VERSAILLES;FEMININ;ENSEIGNEMENT A DISTANCE;BAC PROFESSIONNEL;BAC PRO SERV;BAC PRO 31214 MET.COM.VEN.OP.B PR.CL.VA.OF.COM.;3;2;1;1;0;0;0;1;0;0;0;0;1;1
25264.0;2023;25;VERSAILLES;FEMININ;ENSEIGNEMENT A DISTANCE;BAC PROFESSIONNEL;BAC PRO SERV;BAC PRO 33004 ACC.SOINS-S.PERS. OPT.EN STRUCTUR;4;4;2;1;1;1;0;3;0;0;0;2;1;1
25268.0;2023;25;VERSAILLES;FEMININ;ENSEIGNEMENT A DISTANCE;BAC TECHNOLOGIQUE;BAC STMG;BAC STMG MERCATIQUE (MARKETING);9;9;5;2;2;1;1;6;0;0;0;1;5;3
25270.0;2023;25;VERSAILLES;FEMININ;ENSEIGNEMENT A DISTANCE;BAC TECHNOLOGIQUE;BAC STMG;BAC STMG SYSTEMES D'INFORMATION DE GESTION;1;1;1;0;0;0;0;1;0;0;0;0;1;0
25279.0;2023;25;VERSAILLES;FEMININ;INDIVIDUEL;BAC GENERAL;BAC GENERAL;BAC GENE 10019 BAC GENERAL;376;371;169;151;51;33;18;202;4;32;42;59;65;169
25283.0;2023;25;VERSAILLES;FEMININ;INDIVIDUEL;BAC PROFESSIONNEL;BAC PRO PROD;BAC PRO AG 21113 CGEVV;1;1;1;0;0;0;0;1;0;0;0;0;1;0
25293.0;2023;25;VERSAILLES;FEMININ;INDIVIDUEL;BAC TECHNOLOGIQUE;BAC ST2S;BAC ST2S SCIENCES & TECHNO. SANTE & SOCIAL;41;40;6;26;8;3;5;9;0;0;0;1;8;31
25295.0;2023;25;VERSAILLES;FEMININ;INDIVIDUEL;BAC TECHNOLOGIQUE;BAC STI2D;BAC STI2D ARCHITECTURE ET CONSTRUCTION;1;1;0;1;0;0;0;0;0;0;0;0;0;1
25297.0;2023;25;VERSAILLES;FEMININ;INDIVIDUEL;BAC TECHNOLOGIQUE;BAC STL;BAC STL BIOCHIM.-BIOLOGIE-BIOTECHNOL.;1;1;0;1;0;0;0;0;0;0;0;0;0;1
25298.0;2023;25;VERSAILLES;FEMININ;INDIVIDUEL;BAC TECHNOLOGIQUE;BAC STL;BAC STL SCIENCES PHYSIQUES CHIMIQUES  EN LABORAT.;1;1;0;1;0;0;0;0;0;0;0;0;0;1
25304.0;2023;25;VERSAILLES;FEMININ;SCOLAIRE;BAC PROFESSIONNEL;BAC PRO PROD;BACPRO 20002 ETUD.DEFINITION PRDTS INDUSTRIEL;2;2;0;2;0;0;0;0;0;0;0;0;0;2
25313.0;2023;25;VERSAILLES;FEMININ;SCOLAIRE;BAC PROFESSIONNEL;BAC PRO PROD;BAC PRO 23404 TECHNICIEN CONSTRUCTEUR BOIS;1;1;1;0;0;0;0;1;0;0;0;0;1;0
25314.0;2023;25;VERSAILLES;FEMININ;SCOLAIRE;BAC PROFESSIONNEL;BAC PRO PROD;BAC PRO 23405 TECHNICIEN MENUISIER AGENCEUR;4;4;2;2;0;0;0;2;0;0;0;0;2;2
25315.0;2023;25;VERSAILLES;FEMININ;SCOLAIRE;BAC PROFESSIONNEL;BAC PRO PROD;BAC PRO 23408 Etude et réalisation d'agencement;36;36;24;11;1;1;0;25;0;0;5;11;9;11
25319.0;2023;25;VERSAILLES;FEMININ;SCOLAIRE;BAC PROFESSIONNEL;BAC PRO PROD;BAC PRO 25006 MICROTECHNIQUES;2;2;2;0;0;0;0;2;0;0;1;0;1;0
25321.0;2023;25;VERSAILLES;FEMININ;SCOLAIRE;BAC PROFESSIONNEL;BAC PRO PROD;BAC PRO 25009 MAINTENANCE NAUTIQUE;2;2;2;0;0;0;0;2;0;0;1;1;0;0
25325.0;2023;25;VERSAILLES;FEMININ;SCOLAIRE;BAC PROFESSIONNEL;BAC PRO PROD;BAC PRO 25302 AERONAUTIQUE OPTION AVIONIQUE;2;2;1;0;1;1;0;2;0;1;0;0;1;0
25329.0;2023;25;VERSAILLES;FEMININ;SCOLAIRE;BAC PROFESSIONNEL;BAC PRO PROD;BAC PRO 25513 SYST.NUM.OPT.A SURETE SECURITE;4;4;1;3;0;0;0;1;0;0;0;0;1;3
25331.0;2023;25;VERSAILLES;FEMININ;SCOLAIRE;BAC PROFESSIONNEL;BAC PRO PROD;BAC PRO 25515 SYST.NUM.OPT.C RES.INF.SYST.COMM.;10;10;9;0;1;0;1;9;0;1;2;4;2;1
25333.0;2023;25;VERSAILLES;FEMININ;SCOLAIRE;BAC PROFESSIONNEL;BAC PRO PROD;BAC PRO AG 21114 CONDUITE PRODUCTIONS HORTICOLES;7;7;4;3;0;0;0;4;0;0;0;1;3;3
25337.0;2023;25;VERSAILLES;FEMININ;SCOLAIRE;BAC PROFESSIONNEL;BAC PRO PROD;BAC PRO AG 21405 AMENAGEMENTS PAYSAGERS;4;4;3;1;0;0;0;3;0;0;0;1;2;1
25338.0;2023;25;VERSAILLES;FEMININ;SCOLAIRE;BAC PROFESSIONNEL;BAC PRO SERV;BAC PRO 30004 ASSISTANC.GEST.ORGANIS.ACTIVITES;1248;1248;882;300;66;47;19;929;0;29;127;309;464;319
25349.0;2023;25;VERSAILLES;FEMININ;SCOLAIRE;BAC PROFESSIONNEL;BAC PRO SERV;BAC PRO 32304 PHOTOGRAPHIE;16;16;13;3;0;0;0;13;0;0;3;4;6;3
25355.0;2023;25;VERSAILLES;FEMININ;SCOLAIRE;BAC PROFESSIONNEL;BAC PRO SERV;BAC PRO 33403 COMMERC. SERVICES EN RESTAURATION;45;45;37;8;0;0;0;37;0;2;14;13;8;8
25364.0;2023;25;VERSAILLES;FEMININ;SCOLAIRE;BAC TECHNOLOGIQUE;BAC STAV;BAC STAV AGRONOMIE ALIM ENV TERRITOI;42;42;42;0;0;0;0;42;0;0;5;16;21;0
25365.0;2023;25;VERSAILLES;FEMININ;SCOLAIRE;BAC TECHNOLOGIQUE;BAC STD2A;BAC STD2A SCIENCES & TECHNO. DESIGN-ARTS APPLIQUES;166;166;160;3;3;3;0;163;0;6;53;71;33;3
25366.0;2023;25;VERSAILLES;FEMININ;SCOLAIRE;BAC TECHNOLOGIQUE;BAC STHR;BAC STHR SC.&TEC. HOTELLERIE-RESTAURATION;59;59;50;2;7;3;4;53;0;5;13;18;17;6
25368.0;2023;25;VERSAILLES;FEMININ;SCOLAIRE;BAC TECHNOLOGIQUE;BAC STI2D;BAC STI2D ENERGIES  ET ENVIRONNEMENT;45;45;31;2;12;11;1;42;0;2;6;10;24;3
25374.0;2023;25;VERSAILLES;FEMININ;SCOLAIRE;BAC TECHNOLOGIQUE;BAC STMG;BAC STMG MERCATIQUE (MARKETING);1817;1817;1464;74;279;205;74;1669;0;17;192;547;913;148
25398.0;2023;25;VERSAILLES;MASCULIN;APPRENTISSAGE;BAC PROFESSIONNEL;BAC PRO PROD;BAC PRO 25408 REPARATION DES CARROSSERIES;88;88;65;18;5;4;1;69;0;6;12;22;29;19
25400.0;2023;25;VERSAILLES;MASCULIN;APPRENTISSAGE;BAC PROFESSIONNEL;BAC PRO PROD;BAC PRO 25509 TECHNIC. FROID CONDITIONNEMT AIR;9;9;3;5;1;1;0;4;0;0;0;3;1;5
25404.0;2023;25;VERSAILLES;MASCULIN;APPRENTISSAGE;BAC PROFESSIONNEL;BAC PRO PROD;BAC PRO AG 21203 TECHN CONSEIL DE VENTE ANIMAL;7;5;5;0;0;0;0;5;0;0;0;1;4;0
25407.0;2023;25;VERSAILLES;MASCULIN;APPRENTISSAGE;BAC PROFESSIONNEL;BAC PRO PROD;BAC PRO AG 22108 TEC CONS VTE ALIMENTATION (PAB);2;2;2;0;0;0;0;2;0;0;0;2;0;0
25411.0;2023;25;VERSAILLES;MASCULIN;APPRENTISSAGE;BAC PROFESSIONNEL;BAC PRO SERV;BAC PRO 31109 TRANSPORT FLUVIAL;25;25;19;3;3;1;2;20;0;6;2;4;8;5
25420.0;2023;25;VERSAILLES;MASCULIN;APPRENTISSAGE;BAC PROFESSIONNEL;BAC PRO SERV;BAC PRO 34403 METIERS DE LA SECURITE;23;23;18;4;1;1;0;19;0;1;2;9;7;4
25421.0;2023;25;VERSAILLES;MASCULIN;APPRENTISSAGE;BAC PROFESSIONNEL;BAC PRO SERV;BAC PRO AG 33002 SERV PERS TERRIT;1;1;1;0;0;0;0;1;0;0;0;0;1;0
25428.0;2023;25;VERSAILLES;MASCULIN;ENSEIGNEMENT A DISTANCE;BAC TECHNOLOGIQUE;BAC STMG;BAC STMG GESTION ET FINANCE;4;4;2;2;0;0;0;2;0;0;0;1;1;2
25438.0;2023;25;VERSAILLES;MASCULIN;FORMATION CONTINUE;BAC PROFESSIONNEL;BAC PRO PROD;BAC PRO 25303 AERONAUTIQUE OPTION SYSTEMES;1;1;1;0;0;0;0;1;0;1;0;0;0;0
25443.0;2023;25;VERSAILLES;MASCULIN;FORMATION CONTINUE;BAC PROFESSIONNEL;BAC PRO SERV;BAC PRO 31212 METIERS DE L'ACCUEIL;3;3;3;0;0;0;0;3;0;1;2;0;0;0
25449.0;2023;25;VERSAILLES;MASCULIN;INDIVIDUEL;BAC PROFESSIONNEL;BAC PRO PROD;BAC PRO 22704 TECHN. MAINT. SYST.ENERG.CLIMATI;1;1;0;1;0;0;0;0;0;0;0;0;0;1
25457.0;2023;25;VERSAILLES;MASCULIN;INDIVIDUEL;BAC PROFESSIONNEL;BAC PRO PROD;BAC PRO 25215 MAINT.VEHIC.OPTB VEHIC.TRANS.ROUT;2;2;0;2;0;0;0;0;0;0;0;0;0;2
25462.0;2023;25;VERSAILLES;MASCULIN;INDIVIDUEL;BAC PROFESSIONNEL;BAC PRO PROD;BAC PRO 25510 METIERS ELECT. ENVIRON. CONNECTES;13;5;1;3;1;1;0;2;0;0;0;0;2;3
25463.0;2023;25;VERSAILLES;MASCULIN;INDIVIDUEL;BAC PROFESSIONNEL;BAC PRO PROD;BAC PRO 25513 SYST.NUM.OPT.A SURETE SECURITE;1;0;0;0;0;0;0;0;0;0;0;0;0;0
25471.0;2023;25;VERSAILLES;MASCULIN;INDIVIDUEL;BAC PROFESSIONNEL;BAC PRO SERV;BAC PRO 31107 CONDUCT. TRANSP.ROUT.MARCHANDISES;2;0;0;0;0;0;0;0;0;0;0;0;0;0
25490.0;2023;25;VERSAILLES;MASCULIN;INDIVIDUEL;BAC TECHNOLOGIQUE;BAC STL;BAC STL SCIENCES PHYSIQUES CHIMIQUES  EN LABORAT.;1;1;0;0;1;0;1;0;0;0;0;0;0;1
25491.0;2023;25;VERSAILLES;MASCULIN;INDIVIDUEL;BAC TECHNOLOGIQUE;BAC STMG;BAC STMG GESTION ET FINANCE;20;19;4;13;2;1;1;5;0;0;0;1;4;14
25497.0;2023;25;VERSAILLES;MASCULIN;SCOLAIRE;BAC PROFESSIONNEL;BAC PRO PROD;BAC PRO 20102 PILOTE DE LIGNE DE PRODUCTION;7;7;5;2;0;0;0;5;0;0;1;1;3;2
25498.0;2023;25;VERSAILLES;MASCULIN;SCOLAIRE;BAC PROFESSIONNEL;BAC PRO PROD;BAC PRO 22004 PROC. CHIMIE EAU PAPIERS-CARTONS;7;7;7;0;0;0;0;7;0;1;3;2;1;0
25500.0;2023;25;VERSAILLES;MASCULIN;SCOLAIRE;BAC PROFESSIONNEL;BAC PRO PROD;BAC PRO 22106 CUISINE;163;163;126;25;12;11;1;137;0;7;28;41;61;26
25501.0;2023;25;VERSAILLES;MASCULIN;SCOLAIRE;BAC PROFESSIONNEL;BAC PRO PROD;BAC PRO 22703 TECHN.INSTALL.SYST.ENERG.CLIMATI;130;129;91;26;12;10;2;101;0;1;19;32;49;28
25503.0;2023;25;VERSAILLES;MASCULIN;SCOLAIRE;BAC PROFESSIONNEL;BAC PRO PROD;BAC PRO 23003 ARTIS. & M.ART:MARCHANDISAGE VIS.;16;16;12;3;1;1;0;13;0;0;4;2;7;3
25505.0;2023;25;VERSAILLES;MASCULIN;SCOLAIRE;BAC PROFESSIONNEL;BAC PRO PROD;BAC PRO 23005 TECHN. ETUDES BAT B ASSIST.ARCHI.;55;55;49;6;0;0;0;49;0;1;7;20;21;6
25507.0;2023;25;VERSAILLES;MASCULIN;SCOLAIRE;BAC PROFESSIONNEL;BAC PRO PROD;BACPRO 23103 TECHNICIEN GEOMETRE-TOPOGRAPHE;41;41;30;9;2;1;1;31;0;0;5;9;17;10
25510.0;2023;25;VERSAILLES;MASCULIN;SCOLAIRE;BAC PROFESSIONNEL;BAC PRO PROD;BAC PRO 23304 AMENAGEMENT FINITION BATIMENT;14;14;11;3;0;0;0;11;0;1;0;5;5;3
25512.0;2023;25;VERSAILLES;MASCULIN;SCOLAIRE;BAC PROFESSIONNEL;BAC PRO PROD;BAC PRO 23405 TECHNICIEN MENUISIER AGENCEUR;66;66;48;16;2;1;1;49;0;0;6;18;25;17
25513.0;2023;25;VERSAILLES;MASCULIN;SCOLAIRE;BAC PROFESSIONNEL;BAC PRO PROD;BAC PRO 23408 Etude et réalisation d'agencement;21;21;12;8;1;1;0;13;0;0;2;8;3;8
25519.0;2023;25;VERSAILLES;MASCULIN;SCOLAIRE;BAC PROFESSIONNEL;BAC PRO PROD;BAC PRO 25106 TECHNICIEN D'USINAGE;153;153;89;58;6;5;1;94;0;4;17;32;41;59
25521.0;2023;25;VERSAILLES;MASCULIN;SCOLAIRE;BAC PROFESSIONNEL;BAC PRO PROD;BAC PRO 25214 MAINT.VEHIC.OPTA VOIT.PARTICUL.;316;316;239;52;25;15;10;254;0;21;63;78;92;62
25522.0;2023;25;VERSAILLES;MASCULIN;SCOLAIRE;BAC PROFESSIONNEL;BAC PRO PROD;BAC PRO 25215 MAINT.VEHIC.OPTB VEHIC.TRANS.ROUT;12;12;6;4;2;2;0;8;0;0;0;3;5;4
25535.0;2023;25;VERSAILLES;MASCULIN;SCOLAIRE;BAC PROFESSIONNEL;BAC PRO PROD;BAC PRO 25510 METIERS ELECT. ENVIRON. CONNECTES;1232;1231;824;308;99;60;39;884;0;29;132;290;433;347
25545.0;2023;25;VERSAILLES;MASCULIN;SCOLAIRE;BAC PROFESSIONNEL;BAC PRO PROD;BAC PRO AG 21405 AMENAGEMENTS PAYSAGERS;39;38;36;2;0;0;0;36;0;0;11;10;15;2
25551.0;2023;25;VERSAILLES;MASCULIN;SCOLAIRE;BAC PROFESSIONNEL;BAC PRO SERV;BAC PRO 31213 MET.COM.VEN.OP.A ANI.GES.ESP.COM.;1033;1032;668;277;87;61;26;729;0;14;93;237;385;303
25552.0;2023;25;VERSAILLES;MASCULIN;SCOLAIRE;BAC PROFESSIONNEL;BAC PRO SERV;BAC PRO 31214 MET.COM.VEN.OP.B PR.CL.VA.OF.COM.;626;626;502;86;38;29;9;531;0;14;81;191;245;95
25555.0;2023;25;VERSAILLES;MASCULIN;SCOLAIRE;BAC PROFESSIONNEL;BAC PRO SERV;BAC PRO 32208 REAL.PR.IMPR.PLURI.OPTB.PR.IMPR.;14;14;9;5;0;0;0;9;0;1;1;3;4;5
25561.0;2023;25;VERSAILLES;MASCULIN;SCOLAIRE;BAC PROFESSIONNEL;BAC PRO SERV;BAC PRO 33101 OPTIQUE LUNETTERIE;18;18;16;1;1;1;0;17;0;1;2;7;7;1
25565.0;2023;25;VERSAILLES;MASCULIN;SCOLAIRE;BAC PROFESSIONNEL;BAC PRO SERV;BAC PRO 34304 HYGIENE PROPRETE STERILISATION;8;8;3;3;2;1;1;4;0;0;0;2;2;4
25566.0;2023;25;VERSAILLES;MASCULIN;SCOLAIRE;BAC PROFESSIONNEL;BAC PRO SERV;BAC PRO 34403 METIERS DE LA SECURITE;194;194;170;15;9;8;1;178;0;5;44;71;58;16
25570.0;2023;25;VERSAILLES;MASCULIN;SCOLAIRE;BAC TECHNOLOGIQUE;BAC STAV;BAC STAV AGRONOMIE ALIM ENV TERRITOI;29;29;27;2;0;0;0;27;0;0;2;14;11;2
25574.0;2023;25;VERSAILLES;MASCULIN;SCOLAIRE;BAC TECHNOLOGIQUE;BAC STI2D;BAC STI2D ENERGIES  ET ENVIRONNEMENT;603;603;410;68;125;85;40;495;0;12;57;115;311;108
25579.0;2023;25;VERSAILLES;MASCULIN;SCOLAIRE;BAC TECHNOLOGIQUE;BAC STMG;BAC STMG GESTION ET FINANCE;1020;1020;693;99;228;176;52;869;0;16;63;240;550;151
11.0;2021;02;AIX-MARSEILLE;FEMININ;APPRENTISSAGE;BAC PROFESSIONNEL;BAC PRO PROD;BAC PRO AG 21405 AMENAGEMENTS PAYSAGERS;3;3;2;1;0;0;0;2;0;0;0;0;2;1
18.0;2021;02;AIX-MARSEILLE;FEMININ;APPRENTISSAGE;BAC PROFESSIONNEL;BAC PRO SERV;BAC PRO 32303 ART.& MET.ART:COM.VIS.VIS.PLURI-M;2;1;1;0;0;0;0;1;0;0;0;0;1;0
19.0;2021;02;AIX-MARSEILLE;FEMININ;APPRENTISSAGE;BAC PROFESSIONNEL;BAC PRO SERV;BAC PRO 32304 PHOTOGRAPHIE;1;1;1;0;0;0;0;1;0;0;1;0;0;0
24.0;2021;02;AIX-MARSEILLE;FEMININ;APPRENTISSAGE;BAC PROFESSIONNEL;BAC PRO SERV;BAC PRO 34304 HYGIENE PROPRETE STERILISATION;7;7;5;2;0;0;0;5;0;0;2;2;1;2
26.0;2021;02;AIX-MARSEILLE;FEMININ;ENSEIGNEMENT A DISTANCE;BAC GENERAL;BAC GENERAL;BAC GENE 10019 BAC GENERAL;74;70;66;2;2;0;2;66;0;16;20;22;8;4
31.0;2021;02;AIX-MARSEILLE;FEMININ;ENSEIGNEMENT A DISTANCE;BAC PROFESSIONNEL;BAC PRO SERV;BAC PRO 33003 ACC.SOINS-S.PERS. OPT.A DOMICILE;1;1;0;1;0;0;0;0;0;0;0;0;0;1
32.0;2021;02;AIX-MARSEILLE;FEMININ;ENSEIGNEMENT A DISTANCE;BAC PROFESSIONNEL;BAC PRO SERV;BAC PRO 33004 ACC.SOINS-S.PERS. OPT.EN STRUCTUR;5;2;0;2;0;0;0;0;0;0;0;0;0;2
34.0;2021;02;AIX-MARSEILLE;FEMININ;ENSEIGNEMENT A DISTANCE;BAC TECHNOLOGIQUE;BAC STMG;BAC STMG GESTION ET FINANCE;4;4;3;1;0;0;0;3;1;1;1;0;0;1
35.0;2021;02;AIX-MARSEILLE;FEMININ;ENSEIGNEMENT A DISTANCE;BAC TECHNOLOGIQUE;BAC STMG;BAC STMG MERCATIQUE (MARKETING);4;3;3;0;0;0;0;3;0;0;0;3;0;0
49.0;2021;02;AIX-MARSEILLE;FEMININ;INDIVIDUEL;BAC PROFESSIONNEL;BAC PRO PROD;BAC PRO 23304 AMENAGEMENT FINITION BATIMENT;1;1;1;0;0;0;0;1;0;0;1;0;0;0
57.0;2021;02;AIX-MARSEILLE;FEMININ;INDIVIDUEL;BAC PROFESSIONNEL;BAC PRO SERV;BAC PRO 31206 VENTE (PROSPECT.NEGO.SUIV.CLIENT;1;1;0;1;0;0;0;0;0;0;0;0;0;1
58.0;2021;02;AIX-MARSEILLE;FEMININ;INDIVIDUEL;BAC PROFESSIONNEL;BAC PRO SERV;BAC PRO 31210 ACCUEIL -RELATION CLIENTS USAGERS;3;2;0;2;0;0;0;0;0;0;0;0;0;2
61.0;2021;02;AIX-MARSEILLE;FEMININ;INDIVIDUEL;BAC PROFESSIONNEL;BAC PRO SERV;BAC PRO 33003 ACC.SOINS-S.PERS. OPT.A DOMICILE;2;1;0;0;1;1;0;1;0;0;0;0;1;0
65.0;2021;02;AIX-MARSEILLE;FEMININ;INDIVIDUEL;BAC PROFESSIONNEL;BAC PRO SERV;BAC PRO 34304 HYGIENE PROPRETE STERILISATION;1;1;0;0;1;0;1;0;0;0;0;0;0;1
79.0;2021;02;AIX-MARSEILLE;FEMININ;SCOLAIRE;BAC PROFESSIONNEL;BAC PRO PROD;BAC PRO 22105 BOULANGER-PÂTISSIER;13;13;11;1;1;0;1;11;0;0;3;4;4;2
87.0;2021;02;AIX-MARSEILLE;FEMININ;SCOLAIRE;BAC PROFESSIONNEL;BAC PRO PROD;BAC PRO 24203 METIERS DE LA MODE - VÊTEMENT;74;74;59;13;2;2;0;61;0;9;12;18;22;13
90.0;2021;02;AIX-MARSEILLE;FEMININ;SCOLAIRE;BAC PROFESSIONNEL;BAC PRO PROD;BAC PRO 25009 MAINTENANCE NAUTIQUE;1;1;1;0;0;0;0;1;0;0;1;0;0;0
92.0;2021;02;AIX-MARSEILLE;FEMININ;SCOLAIRE;BAC PROFESSIONNEL;BAC PRO PROD;BAC PRO 25215 MAINT.VEHIC.OPTB VEHIC.TRANS.ROUT;1;1;1;0;0;0;0;1;0;0;0;1;0;0
98.0;2021;02;AIX-MARSEILLE;FEMININ;SCOLAIRE;BAC PROFESSIONNEL;BAC PRO PROD;BAC PRO 25411 TECH.CHAUDRONNERIE INDUSTRIELLE;2;2;2;0;0;0;0;2;0;1;0;1;0;0
100.0;2021;02;AIX-MARSEILLE;FEMININ;SCOLAIRE;BAC PROFESSIONNEL;BAC PRO PROD;BAC PRO 25514 SYST.NUM.OPT.B AUD.RES.EQUIP.DOM.;2;2;2;0;0;0;0;2;0;0;2;0;0;0
104.0;2021;02;AIX-MARSEILLE;FEMININ;SCOLAIRE;BAC PROFESSIONNEL;BAC PRO PROD;BAC PRO AG 21114 CONDUITE PRODUCTIONS HORTICOLES;6;6;6;0;0;0;0;6;0;0;0;5;1;0
110.0;2021;02;AIX-MARSEILLE;FEMININ;SCOLAIRE;BAC PROFESSIONNEL;BAC PRO PROD;BAC PRO AG 22106 TEC CONS VTE ALIMENTATION VINS SP;5;3;3;0;0;0;0;3;0;0;0;0;3;0
113.0;2021;02;AIX-MARSEILLE;FEMININ;SCOLAIRE;BAC PROFESSIONNEL;BAC PRO SERV;BAC PRO 31106 LOGISTIQUE;4;4;2;1;1;1;0;3;0;1;0;0;2;1
115.0;2021;02;AIX-MARSEILLE;FEMININ;SCOLAIRE;BAC PROFESSIONNEL;BAC PRO SERV;BAC PRO 31108 TRANSPORT;4;4;4;0;0;0;0;4;0;1;0;0;3;0
126.0;2021;02;AIX-MARSEILLE;FEMININ;SCOLAIRE;BAC PROFESSIONNEL;BAC PRO SERV;BAC PRO 33101 OPTIQUE LUNETTERIE;6;6;6;0;0;0;0;6;0;1;2;1;2;0
129.0;2021;02;AIX-MARSEILLE;FEMININ;SCOLAIRE;BAC PROFESSIONNEL;BAC PRO SERV;BAC PRO 33403 COMMERC. SERVICES EN RESTAURATION;47;47;43;3;1;0;1;43;0;2;15;12;14;4
130.0;2021;02;AIX-MARSEILLE;FEMININ;SCOLAIRE;BAC PROFESSIONNEL;BAC PRO SERV;BAC PRO 33603 ESTHETIQUE COSMETIQUE PARFUMERIE;141;139;119;12;8;6;2;125;0;7;28;53;37;14
132.0;2021;02;AIX-MARSEILLE;FEMININ;SCOLAIRE;BAC PROFESSIONNEL;BAC PRO SERV;BAC PRO 34403 METIERS DE LA SECURITE;14;14;14;0;0;0;0;14;0;0;3;8;3;0
134.0;2021;02;AIX-MARSEILLE;FEMININ;SCOLAIRE;BAC TECHNOLOGIQUE;BAC ST2S;BAC ST2S SCIENCES & TECHNO. SANTE & SOCIAL;800;800;720;15;65;33;32;753;0;15;124;310;304;47
145.0;2021;02;AIX-MARSEILLE;FEMININ;SCOLAIRE;BAC TECHNOLOGIQUE;BAC STMG;BAC STMG MERCATIQUE (MARKETING);688;688;636;7;45;29;16;665;0;18;127;284;236;23
147.0;2021;02;AIX-MARSEILLE;FEMININ;SCOLAIRE;BAC TECHNOLOGIQUE;BAC STMG;BAC STMG SYSTEMES D'INFORMATION DE GESTION;16;16;16;0;0;0;0;16;0;0;3;7;6;0
149.0;2021;02;AIX-MARSEILLE;MASCULIN;APPRENTISSAGE;BAC PROFESSIONNEL;BAC PRO PROD;BAC PRO 22106 CUISINE;23;23;19;4;0;0;0;19;0;1;6;6;6;4
153.0;2021;02;AIX-MARSEILLE;MASCULIN;APPRENTISSAGE;BAC PROFESSIONNEL;BAC PRO PROD;BAC PRO 23102 TRAVAUX PUBLICS;14;14;14;0;0;0;0;14;0;2;7;4;1;0
155.0;2021;02;AIX-MARSEILLE;MASCULIN;APPRENTISSAGE;BAC PROFESSIONNEL;BAC PRO PROD;BAC PRO 23404 TECHNICIEN CONSTRUCTEUR BOIS;1;1;1;0;0;0;0;1;0;0;0;0;1;0
158.0;2021;02;AIX-MARSEILLE;MASCULIN;APPRENTISSAGE;BAC PROFESSIONNEL;BAC PRO PROD;BAC PRO 25106 TECHNICIEN D'USINAGE;10;10;10;0;0;0;0;10;0;2;4;2;2;0
162.0;2021;02;AIX-MARSEILLE;MASCULIN;APPRENTISSAGE;BAC PROFESSIONNEL;BAC PRO PROD;BAC PRO 25220 MAINT.MATERIELS OPT.B TP MANUT.;9;9;7;2;0;0;0;7;0;0;2;2;3;2
163.0;2021;02;AIX-MARSEILLE;MASCULIN;APPRENTISSAGE;BAC PROFESSIONNEL;BAC PRO PROD;BAC PRO 25303 AERONAUTIQUE OPTION SYSTEMES;22;22;20;2;0;0;0;20;0;3;4;9;4;2
167.0;2021;02;AIX-MARSEILLE;MASCULIN;APPRENTISSAGE;BAC PROFESSIONNEL;BAC PRO PROD;BAC PRO 25509 TECHNIC. FROID CONDITIONNEMT AIR;1;1;0;1;0;0;0;0;0;0;0;0;0;1
168.0;2021;02;AIX-MARSEILLE;MASCULIN;APPRENTISSAGE;BAC PROFESSIONNEL;BAC PRO PROD;BAC PRO 25510 METIERS ELECT. ENVIRON. CONNECTES;60;60;52;6;2;1;1;53;0;7;12;19;15;7
172.0;2021;02;AIX-MARSEILLE;MASCULIN;APPRENTISSAGE;BAC PROFESSIONNEL;BAC PRO PROD;BAC PRO AG 21114 CONDUITE PRODUCTIONS HORTICOLES;3;3;3;0;0;0;0;3;0;0;0;0;3;0
181.0;2021;02;AIX-MARSEILLE;MASCULIN;APPRENTISSAGE;BAC PROFESSIONNEL;BAC PRO SERV;BAC PRO 31202 COMMERCE;75;69;56;8;5;4;1;60;0;6;11;25;18;9
185.0;2021;02;AIX-MARSEILLE;MASCULIN;APPRENTISSAGE;BAC PROFESSIONNEL;BAC PRO SERV;BAC PRO 32303 ART.& MET.ART:COM.VIS.VIS.PLURI-M;4;2;0;2;0;0;0;0;0;0;0;0;0;2
194.0;2021;02;AIX-MARSEILLE;MASCULIN;ENSEIGNEMENT A DISTANCE;BAC PROFESSIONNEL;BAC PRO SERV;BAC PRO 31202 COMMERCE;3;2;0;2;0;0;0;0;0;0;0;0;0;2
202.0;2021;02;AIX-MARSEILLE;MASCULIN;FORMATION CONTINUE;BAC PROFESSIONNEL;BAC PRO PROD;BAC PRO 22703 TECHN.INSTALL.SYST.ENERG.CLIMATI;11;11;10;1;0;0;0;10;0;0;2;4;4;1
203.0;2021;02;AIX-MARSEILLE;MASCULIN;FORMATION CONTINUE;BAC PROFESSIONNEL;BAC PRO PROD;BAC PRO 22704 TECHN. MAINT. SYST.ENERG.CLIMATI;10;10;7;2;1;1;0;8;0;3;2;1;2;2
204.0;2021;02;AIX-MARSEILLE;MASCULIN;FORMATION CONTINUE;BAC PROFESSIONNEL;BAC PRO PROD;BAC PRO 22705 TECHNICIEN GAZ;2;2;2;0;0;0;0;2;0;0;0;2;0;0
206.0;2021;02;AIX-MARSEILLE;MASCULIN;FORMATION CONTINUE;BAC PROFESSIONNEL;BAC PRO PROD;BAC PRO 25510 METIERS ELECT. ENVIRON. CONNECTES;19;16;16;0;0;0;0;16;0;8;3;3;2;0
212.0;2021;02;AIX-MARSEILLE;MASCULIN;FORMATION CONTINUE;BAC PROFESSIONNEL;BAC PRO SERV;BAC PRO 32304 PHOTOGRAPHIE;6;4;2;2;0;0;0;2;0;0;1;1;0;2
215.0;2021;02;AIX-MARSEILLE;MASCULIN;INDIVIDUEL;BAC PROFESSIONNEL;BAC PRO PROD;BAC PRO 22003 BIO-INDUSTRIES DE TRANSFORMATION;1;0;0;0;0;0;0;0;0;0;0;0;0;0
220.0;2021;02;AIX-MARSEILLE;MASCULIN;INDIVIDUEL;BAC PROFESSIONNEL;BAC PRO PROD;BAC PRO 25007 MAINTENANCE EQUIPEMENTS INDUST.;1;1;1;0;0;0;0;1;0;0;0;0;1;0
221.0;2021;02;AIX-MARSEILLE;MASCULIN;INDIVIDUEL;BAC PROFESSIONNEL;BAC PRO PROD;BAC PRO 25214 MAINT.VEHIC.OPTA VOIT.PARTICUL.;2;0;0;0;0;0;0;0;0;0;0;0;0;0
226.0;2021;02;AIX-MARSEILLE;MASCULIN;INDIVIDUEL;BAC PROFESSIONNEL;BAC PRO PROD;BAC PRO AG 21004 CGEA;6;6;2;4;0;0;0;2;0;0;0;0;2;4
229.0;2021;02;AIX-MARSEILLE;MASCULIN;INDIVIDUEL;BAC PROFESSIONNEL;BAC PRO PROD;BAC PRO AG 21203 TECHN CONSEIL DE VENTE ANIMAL;1;1;0;1;0;0;0;0;0;0;0;0;0;1
230.0;2021;02;AIX-MARSEILLE;MASCULIN;INDIVIDUEL;BAC PROFESSIONNEL;BAC PRO PROD;BAC PRO AG 21303 FORET;1;0;0;0;0;0;0;0;0;0;0;0;0;0
233.0;2021;02;AIX-MARSEILLE;MASCULIN;INDIVIDUEL;BAC PROFESSIONNEL;BAC PRO SERV;BAC PRO 31107 CONDUCT. TRANSP.ROUT.MARCHANDISES;1;1;1;0;0;0;0;1;0;0;0;0;1;0
236.0;2021;02;AIX-MARSEILLE;MASCULIN;INDIVIDUEL;BAC PROFESSIONNEL;BAC PRO SERV;BAC PRO 31210 ACCUEIL -RELATION CLIENTS USAGERS;1;0;0;0;0;0;0;0;0;0;0;0;0;0
239.0;2021;02;AIX-MARSEILLE;MASCULIN;INDIVIDUEL;BAC PROFESSIONNEL;BAC PRO SERV;BAC PRO 33002 SERVICES DE PROXIMITE  VIE LOCAL;2;0;0;0;0;0;0;0;0;0;0;0;0;0
245.0;2021;02;AIX-MARSEILLE;MASCULIN;INDIVIDUEL;BAC TECHNOLOGIQUE;BAC STI2D;BAC STI2D ENERGIES  ET ENVIRONNEMENT;1;0;0;0;0;0;0;0;0;0;0;0;0;0
250.0;2021;02;AIX-MARSEILLE;MASCULIN;INDIVIDUEL;BAC TECHNOLOGIQUE;BAC STMG;BAC STMG MERCATIQUE (MARKETING);22;11;6;3;2;0;2;6;0;0;0;0;6;5
255.0;2021;02;AIX-MARSEILLE;MASCULIN;SCOLAIRE;BAC PROFESSIONNEL;BAC PRO PROD;BAC PRO 20102 PILOTE DE LIGNE DE PRODUCTION;8;8;8;0;0;0;0;8;0;1;3;2;2;0
257.0;2021;02;AIX-MARSEILLE;MASCULIN;SCOLAIRE;BAC PROFESSIONNEL;BAC PRO PROD;BAC PRO 22004 PROC. CHIMIE EAU PAPIERS-CARTONS;38;38;32;6;0;0;0;32;0;1;3;17;11;6
260.0;2021;02;AIX-MARSEILLE;MASCULIN;SCOLAIRE;BAC PROFESSIONNEL;BAC PRO PROD;BAC PRO 22403 ARTS.& MET.ART:MET.ENSEIGN SIGNA;2;2;0;2;0;0;0;0;0;0;0;0;0;2
261.0;2021;02;AIX-MARSEILLE;MASCULIN;SCOLAIRE;BAC PROFESSIONNEL;BAC PRO PROD;BAC PRO 22503 PLASTIQUES ET COMPOSITES;6;6;5;0;1;1;0;6;0;0;0;2;4;0
262.0;2021;02;AIX-MARSEILLE;MASCULIN;SCOLAIRE;BAC PROFESSIONNEL;BAC PRO PROD;BAC PRO 22703 TECHN.INSTALL.SYST.ENERG.CLIMATI;45;45;39;4;2;1;1;40;0;0;3;8;29;5
271.0;2021;02;AIX-MARSEILLE;MASCULIN;SCOLAIRE;BAC PROFESSIONNEL;BAC PRO PROD;BAC PRO 23304 AMENAGEMENT FINITION BATIMENT;10;10;5;5;0;0;0;5;0;0;1;0;4;5
278.0;2021;02;AIX-MARSEILLE;MASCULIN;SCOLAIRE;BAC PROFESSIONNEL;BAC PRO PROD;BAC PRO 25009 MAINTENANCE NAUTIQUE;37;37;30;6;1;1;0;31;0;0;5;11;15;6
283.0;2021;02;AIX-MARSEILLE;MASCULIN;SCOLAIRE;BAC PROFESSIONNEL;BAC PRO PROD;BAC PRO 25216 MAINT.VEHIC.OPTC MOTOCYCLES;25;24;15;7;2;0;2;15;0;1;0;7;7;9
286.0;2021;02;AIX-MARSEILLE;MASCULIN;SCOLAIRE;BAC PROFESSIONNEL;BAC PRO PROD;BAC PRO 25221 MAINT.MATERIELS OPT.C ESP. VERTS;7;7;6;1;0;0;0;6;0;0;1;0;5;1
292.0;2021;02;AIX-MARSEILLE;MASCULIN;SCOLAIRE;BAC PROFESSIONNEL;BAC PRO PROD;BAC PRO 25411 TECH.CHAUDRONNERIE INDUSTRIELLE;67;66;55;8;3;2;1;57;0;2;15;22;18;9
301.0;2021;02;AIX-MARSEILLE;MASCULIN;SCOLAIRE;BAC PROFESSIONNEL;BAC PRO PROD;BAC PRO AG 21114 CONDUITE PRODUCTIONS HORTICOLES;15;15;14;1;0;0;0;14;0;0;4;2;8;1
306.0;2021;02;AIX-MARSEILLE;MASCULIN;SCOLAIRE;BAC PROFESSIONNEL;BAC PRO PROD;BAC PRO AG 21405 AMENAGEMENTS PAYSAGERS;56;56;52;4;0;0;0;52;0;2;10;21;19;4
309.0;2021;02;AIX-MARSEILLE;MASCULIN;SCOLAIRE;BAC PROFESSIONNEL;BAC PRO PROD;BAC PRO AG 22107 TEC CONS VTE ALIMENTATION P.ALIM;11;11;10;1;0;0;0;10;0;2;0;3;5;1
310.0;2021;02;AIX-MARSEILLE;MASCULIN;SCOLAIRE;BAC PROFESSIONNEL;BAC PRO SERV;BAC PRO 30001 GESTION-ADMINISTRATION;352;351;254;74;23;15;8;269;0;9;42;88;130;82
314.0;2021;02;AIX-MARSEILLE;MASCULIN;SCOLAIRE;BAC PROFESSIONNEL;BAC PRO SERV;BAC PRO 31202 COMMERCE;339;337;271;23;43;36;7;307;0;11;53;112;131;30
318.0;2021;02;AIX-MARSEILLE;MASCULIN;SCOLAIRE;BAC PROFESSIONNEL;BAC PRO SERV;BAC PRO 32208 REAL.PR.IMPR.PLURI.OPTB.PR.IMPR.;11;11;8;2;1;1;0;9;0;0;4;2;3;2
322.0;2021;02;AIX-MARSEILLE;MASCULIN;SCOLAIRE;BAC PROFESSIONNEL;BAC PRO SERV;BAC PRO 33003 ACC.SOINS-S.PERS. OPT.A DOMICILE;8;8;8;0;0;0;0;8;0;0;1;5;2;0
328.0;2021;02;AIX-MARSEILLE;MASCULIN;SCOLAIRE;BAC PROFESSIONNEL;BAC PRO SERV;BAC PRO 34304 HYGIENE PROPRETE STERILISATION;3;3;3;0;0;0;0;3;0;0;0;1;2;0
329.0;2021;02;AIX-MARSEILLE;MASCULIN;SCOLAIRE;BAC PROFESSIONNEL;BAC PRO SERV;BAC PRO 34403 METIERS DE LA SECURITE;56;56;55;1;0;0;0;55;0;5;19;21;10;1
330.0;2021;02;AIX-MARSEILLE;MASCULIN;SCOLAIRE;BAC PROFESSIONNEL;BAC PRO SERV;BAC PRO AG 33002 SERV PERS TERRIT;25;25;24;1;0;0;0;24;0;1;5;9;9;1
331.0;2021;02;AIX-MARSEILLE;MASCULIN;SCOLAIRE;BAC TECHNOLOGIQUE;BAC ST2S;BAC ST2S SCIENCES & TECHNO. SANTE & SOCIAL;157;157;135;4;18;8;10;143;0;0;23;53;67;14
342.0;2021;02;AIX-MARSEILLE;MASCULIN;SCOLAIRE;BAC TECHNOLOGIQUE;BAC STMG;BAC STMG MERCATIQUE (MARKETING);781;778;682;19;77;57;20;739;0;5;73;259;402;39
350.0;2021;20;AMIENS;FEMININ;APPRENTISSAGE;BAC PROFESSIONNEL;BAC PRO PROD;BAC PRO 25408 REPARATION DES CARROSSERIES;2;2;2;0;0;0;0;2;0;0;2;0;0;0
358.0;2021;20;AMIENS;FEMININ;APPRENTISSAGE;BAC PROFESSIONNEL;BAC PRO SERV;BAC PRO 31202 COMMERCE;41;39;36;1;2;1;1;37;0;3;9;13;12;2
366.0;2021;20;AMIENS;FEMININ;ENSEIGNEMENT A DISTANCE;BAC TECHNOLOGIQUE;BAC STMG;BAC STMG RESSOURCES HUMAINES ET COMMUNICATION;1;1;1;0;0;0;0;1;0;0;0;0;1;0
371.0;2021;20;AMIENS;FEMININ;INDIVIDUEL;BAC GENERAL;BAC GENERAL;BAC GENE 10019 BAC GENERAL;56;55;28;21;6;3;3;31;0;4;10;6;11;24
382.0;2021;20;AMIENS;FEMININ;INDIVIDUEL;BAC PROFESSIONNEL;BAC PRO SERV;BAC PRO 31206 VENTE (PROSPECT.NEGO.SUIV.CLIENT;1;1;0;1;0;0;0;0;0;0;0;0;0;1
401.0;2021;20;AMIENS;FEMININ;SCOLAIRE;BAC PROFESSIONNEL;BAC PRO PROD;BAC PRO 22106 CUISINE;48;48;41;4;3;1;2;42;0;2;13;15;12;6
407.0;2021;20;AMIENS;FEMININ;SCOLAIRE;BAC PROFESSIONNEL;BAC PRO PROD;BAC PRO 23405 TECHNICIEN MENUISIER AGENCEUR;3;3;3;0;0;0;0;3;0;0;1;1;1;0
416.0;2021;20;AMIENS;FEMININ;SCOLAIRE;BAC PROFESSIONNEL;BAC PRO PROD;BAC PRO 25408 REPARATION DES CARROSSERIES;2;2;2;0;0;0;0;2;0;0;0;1;1;0
418.0;2021;20;AMIENS;FEMININ;SCOLAIRE;BAC PROFESSIONNEL;BAC PRO PROD;BAC PRO 25513 SYST.NUM.OPT.A SURETE SECURITE;2;2;1;1;0;0;0;1;0;0;0;1;0;1
422.0;2021;20;AMIENS;FEMININ;SCOLAIRE;BAC PROFESSIONNEL;BAC PRO PROD;BAC PRO AG 21114 CONDUITE PRODUCTIONS HORTICOLES;7;7;7;0;0;0;0;7;0;0;0;5;2;0
432.0;2021;20;AMIENS;FEMININ;SCOLAIRE;BAC PROFESSIONNEL;BAC PRO SERV;BAC PRO 31202 COMMERCE;404;399;320;39;40;24;16;344;0;22;75;132;115;55
434.0;2021;20;AMIENS;FEMININ;SCOLAIRE;BAC PROFESSIONNEL;BAC PRO SERV;BAC PRO 31210 ACCUEIL -RELATION CLIENTS USAGERS;193;191;154;26;11;4;7;158;0;3;28;61;66;33
437.0;2021;20;AMIENS;FEMININ;SCOLAIRE;BAC PROFESSIONNEL;BAC PRO SERV;BAC PRO 33002 SERVICES DE PROXIMITE  VIE LOCAL;43;42;34;5;3;3;0;37;0;3;8;14;12;5
442.0;2021;20;AMIENS;FEMININ;SCOLAIRE;BAC PROFESSIONNEL;BAC PRO SERV;BAC PRO 33603 ESTHETIQUE COSMETIQUE PARFUMERIE;64;62;58;2;2;2;0;60;0;6;13;25;16;2
469.0;2021;20;AMIENS;MASCULIN;APPRENTISSAGE;BAC PROFESSIONNEL;BAC PRO PROD;BAC PRO 25216 MAINT.VEHIC.OPTC MOTOCYCLES;5;5;5;0;0;0;0;5;0;1;1;3;0;0
477.0;2021;20;AMIENS;MASCULIN;APPRENTISSAGE;BAC PROFESSIONNEL;BAC PRO PROD;BAC PRO 25510 METIERS ELECT. ENVIRON. CONNECTES;56;56;51;4;1;1;0;52;0;10;15;16;11;4
482.0;2021;20;AMIENS;MASCULIN;APPRENTISSAGE;BAC PROFESSIONNEL;BAC PRO PROD;BAC PRO AG 21405 AMENAGEMENTS PAYSAGERS;45;45;44;1;0;0;0;44;0;0;12;19;13;1
485.0;2021;20;AMIENS;MASCULIN;APPRENTISSAGE;BAC PROFESSIONNEL;BAC PRO SERV;BAC PRO 31106 LOGISTIQUE;55;54;43;8;3;1;2;44;0;1;9;18;16;10
489.0;2021;20;AMIENS;MASCULIN;APPRENTISSAGE;BAC PROFESSIONNEL;BAC PRO SERV;BAC PRO AG 33002 SERV PERS TERRIT;2;2;2;0;0;0;0;2;0;0;0;0;2;0
496.0;2021;20;AMIENS;MASCULIN;FORMATION CONTINUE;BAC PROFESSIONNEL;BAC PRO PROD;BAC PRO 25215 MAINT.VEHIC.OPTB VEHIC.TRANS.ROUT;1;1;1;0;0;0;0;1;0;1;0;0;0;0
500.0;2021;20;AMIENS;MASCULIN;FORMATION CONTINUE;BAC PROFESSIONNEL;BAC PRO SERV;BAC PRO 31106 LOGISTIQUE;8;8;8;0;0;0;0;8;0;3;3;1;1;0
502.0;2021;20;AMIENS;MASCULIN;FORMATION CONTINUE;BAC PROFESSIONNEL;BAC PRO SERV;BAC PRO 33101 OPTIQUE LUNETTERIE;1;1;1;0;0;0;0;1;0;0;0;1;0;0
505.0;2021;20;AMIENS;MASCULIN;INDIVIDUEL;BAC PROFESSIONNEL;BAC PRO PROD;BAC PRO 22106 CUISINE;1;1;1;0;0;0;0;1;0;0;0;0;1;0
507.0;2021;20;AMIENS;MASCULIN;INDIVIDUEL;BAC PROFESSIONNEL;BAC PRO PROD;BAC PRO 25007 MAINTENANCE EQUIPEMENTS INDUST.;2;1;1;0;0;0;0;1;0;0;0;1;0;0
510.0;2021;20;AMIENS;MASCULIN;INDIVIDUEL;BAC PROFESSIONNEL;BAC PRO PROD;BAC PRO 25215 MAINT.VEHIC.OPTB VEHIC.TRANS.ROUT;1;0;0;0;0;0;0;0;0;0;0;0;0;0
516.0;2021;20;AMIENS;MASCULIN;INDIVIDUEL;BAC PROFESSIONNEL;BAC PRO SERV;BAC PRO 30001 GESTION-ADMINISTRATION;5;4;3;1;0;0;0;3;0;0;0;0;3;1
517.0;2021;20;AMIENS;MASCULIN;INDIVIDUEL;BAC PROFESSIONNEL;BAC PRO SERV;BAC PRO 31106 LOGISTIQUE;2;0;0;0;0;0;0;0;0;0;0;0;0;0
525.0;2021;20;AMIENS;MASCULIN;INDIVIDUEL;BAC TECHNOLOGIQUE;BAC STHR;BAC STHR SC.&TEC. HOTELLERIE-RESTAURATION;1;1;0;0;1;1;0;1;0;0;0;0;1;0
531.0;2021;20;AMIENS;MASCULIN;INDIVIDUEL;BAC TECHNOLOGIQUE;BAC STMG;BAC STMG RESSOURCES HUMAINES ET COMMUNICATION;5;5;2;3;0;0;0;2;0;0;0;0;2;3
533.0;2021;20;AMIENS;MASCULIN;SCOLAIRE;BAC GENERAL;BAC GENERAL;BAC GENE 10019 BAC GENERAL;4466;4466;4178;60;228;153;75;4331;89;448;1020;1493;1281;135
540.0;2021;20;AMIENS;MASCULIN;SCOLAIRE;BAC PROFESSIONNEL;BAC PRO PROD;BAC PRO 22303 FONDERIE;8;8;8;0;0;0;0;8;0;0;5;2;1;0
541.0;2021;20;AMIENS;MASCULIN;SCOLAIRE;BAC PROFESSIONNEL;BAC PRO PROD;BAC PRO 22503 PLASTIQUES ET COMPOSITES;11;11;9;1;1;1;0;10;0;0;0;4;6;1
553.0;2021;20;AMIENS;MASCULIN;SCOLAIRE;BAC PROFESSIONNEL;BAC PRO PROD;BAC PRO 23405 TECHNICIEN MENUISIER AGENCEUR;60;60;53;4;3;3;0;56;0;7;7;15;27;4
556.0;2021;20;AMIENS;MASCULIN;SCOLAIRE;BAC PROFESSIONNEL;BAC PRO PROD;BAC PRO 24203 METIERS DE LA MODE - VÊTEMENT;10;10;9;1;0;0;0;9;0;1;3;5;0;1
564.0;2021;20;AMIENS;MASCULIN;SCOLAIRE;BAC PROFESSIONNEL;BAC PRO PROD;BAC PRO 25215 MAINT.VEHIC.OPTB VEHIC.TRANS.ROUT;23;23;21;1;1;1;0;22;0;0;10;7;5;1
578.0;2021;20;AMIENS;MASCULIN;SCOLAIRE;BAC PROFESSIONNEL;BAC PRO PROD;BAC PRO AG 21001 AGRO-EQUIPEMENT;15;15;15;0;0;0;0;15;0;0;1;4;10;0
580.0;2021;20;AMIENS;MASCULIN;SCOLAIRE;BAC PROFESSIONNEL;BAC PRO PROD;BAC PRO AG 21113 CGEVV;5;5;4;1;0;0;0;4;0;0;0;1;3;1
581.0;2021;20;AMIENS;MASCULIN;SCOLAIRE;BAC PROFESSIONNEL;BAC PRO PROD;BAC PRO AG 21114 CONDUITE PRODUCTIONS HORTICOLES;3;2;2;0;0;0;0;2;0;0;0;1;1;0
594.0;2021;20;AMIENS;MASCULIN;SCOLAIRE;BAC PROFESSIONNEL;BAC PRO SERV;BAC PRO 31206 VENTE (PROSPECT.NEGO.SUIV.CLIENT;140;137;104;18;15;12;3;116;0;5;22;42;47;21
599.0;2021;20;AMIENS;MASCULIN;SCOLAIRE;BAC PROFESSIONNEL;BAC PRO SERV;BAC PRO 33003 ACC.SOINS-S.PERS. OPT.A DOMICILE;10;10;7;2;1;0;1;7;0;0;3;2;2;3
600.0;2021;20;AMIENS;MASCULIN;SCOLAIRE;BAC PROFESSIONNEL;BAC PRO SERV;BAC PRO 33004 ACC.SOINS-S.PERS. OPT.EN STRUCTUR;30;30;26;3;1;1;0;27;0;2;10;9;6;3
603.0;2021;20;AMIENS;MASCULIN;SCOLAIRE;BAC PROFESSIONNEL;BAC PRO SERV;BAC PRO 34304 HYGIENE PROPRETE STERILISATION;5;5;4;1;0;0;0;4;0;1;0;1;2;1
607.0;2021;20;AMIENS;MASCULIN;SCOLAIRE;BAC TECHNOLOGIQUE;BAC STAV;BAC STAV AGRONOMIE ALIM ENV TERRITOI;54;54;53;1;0;0;0;53;0;2;6;23;22;1
609.0;2021;20;AMIENS;MASCULIN;SCOLAIRE;BAC TECHNOLOGIQUE;BAC STHR;BAC STHR SC.&TEC. HOTELLERIE-RESTAURATION;19;19;17;1;1;0;1;17;0;0;6;3;8;2
610.0;2021;20;AMIENS;MASCULIN;SCOLAIRE;BAC TECHNOLOGIQUE;BAC STI2D;BAC STI2D ARCHITECTURE ET CONSTRUCTION;106;106;96;2;8;4;4;100;0;6;18;36;40;6
611.0;2021;20;AMIENS;MASCULIN;SCOLAIRE;BAC TECHNOLOGIQUE;BAC STI2D;BAC STI2D ENERGIES  ET ENVIRONNEMENT;172;172;158;3;11;9;2;167;0;5;27;61;74;5
620.0;2021;03;BESANCON;FEMININ;APPRENTISSAGE;BAC PROFESSIONNEL;BAC PRO PROD;BAC PRO 22003 BIO-INDUSTRIES DE TRANSFORMATION;4;4;4;0;0;0;0;4;0;0;0;1;3;0
643.0;2021;03;BESANCON;FEMININ;ENSEIGNEMENT A DISTANCE;BAC PROFESSIONNEL;BAC PRO SERV;BAC PRO 33004 ACC.SOINS-S.PERS. OPT.EN STRUCTUR;2;2;2;0;0;0;0;2;0;0;1;0;1;0
646.0;2021;03;BESANCON;FEMININ;ENSEIGNEMENT A DISTANCE;BAC TECHNOLOGIQUE;BAC STMG;BAC STMG RESSOURCES HUMAINES ET COMMUNICATION;1;1;1;0;0;0;0;1;0;0;0;1;0;0
651.0;2021;03;BESANCON;FEMININ;INDIVIDUEL;BAC PROFESSIONNEL;BAC PRO SERV;BAC PRO 30001 GESTION-ADMINISTRATION;3;3;2;1;0;0;0;2;0;0;0;0;2;1
656.0;2021;03;BESANCON;FEMININ;INDIVIDUEL;BAC PROFESSIONNEL;BAC PRO SERV;BAC PRO AG 33002 SERV PERS TERRIT;1;0;0;0;0;0;0;0;0;0;0;0;0;0
668.0;2021;03;BESANCON;FEMININ;SCOLAIRE;BAC PROFESSIONNEL;BAC PRO PROD;BAC PRO 23404 TECHNICIEN CONSTRUCTEUR BOIS;1;1;1;0;0;0;0;1;0;0;0;1;0;0
673.0;2021;03;BESANCON;FEMININ;SCOLAIRE;BAC PROFESSIONNEL;BAC PRO PROD;BAC PRO 24203 METIERS DE LA MODE - VÊTEMENT;40;40;37;2;1;1;0;38;0;2;8;15;13;2
674.0;2021;03;BESANCON;FEMININ;SCOLAIRE;BAC PROFESSIONNEL;BAC PRO PROD;BAC PRO 24302 METIERS DU CUIR : MAROQUINERIE;12;12;9;1;2;2;0;11;0;1;1;3;6;1
675.0;2021;03;BESANCON;FEMININ;SCOLAIRE;BAC PROFESSIONNEL;BAC PRO PROD;BAC PRO 25006 MICROTECHNIQUES;3;3;2;1;0;0;0;2;0;0;0;2;0;1
678.0;2021;03;BESANCON;FEMININ;SCOLAIRE;BAC PROFESSIONNEL;BAC PRO PROD;BAC PRO 25214 MAINT.VEHIC.OPTA VOIT.PARTICUL.;5;5;3;2;0;0;0;3;0;0;1;0;2;2
680.0;2021;03;BESANCON;FEMININ;SCOLAIRE;BAC PROFESSIONNEL;BAC PRO PROD;BAC PRO 25411 TECH.CHAUDRONNERIE INDUSTRIELLE;1;1;1;0;0;0;0;1;0;0;0;1;0;0
682.0;2021;03;BESANCON;FEMININ;SCOLAIRE;BAC PROFESSIONNEL;BAC PRO PROD;BAC PRO 25514 SYST.NUM.OPT.B AUD.RES.EQUIP.DOM.;5;5;3;1;1;1;0;4;0;1;1;0;2;1
685.0;2021;03;BESANCON;FEMININ;SCOLAIRE;BAC PROFESSIONNEL;BAC PRO PROD;BAC PRO AG 21114 CONDUITE PRODUCTIONS HORTICOLES;5;5;4;1;0;0;0;4;0;0;0;4;0;1
686.0;2021;03;BESANCON;FEMININ;SCOLAIRE;BAC PROFESSIONNEL;BAC PRO PROD;BAC PRO AG 21203 TECHN CONSEIL DE VENTE ANIMAL;13;13;11;2;0;0;0;11;0;0;0;5;6;2
687.0;2021;03;BESANCON;FEMININ;SCOLAIRE;BAC PROFESSIONNEL;BAC PRO PROD;BAC PRO AG 21211 COND GEST ENTR HIPPIQUE;32;32;31;1;0;0;0;31;0;1;5;18;7;1
689.0;2021;03;BESANCON;FEMININ;SCOLAIRE;BAC PROFESSIONNEL;BAC PRO PROD;BAC PRO AG 21405 AMENAGEMENTS PAYSAGERS;7;7;5;2;0;0;0;5;0;0;1;2;2;2
690.0;2021;03;BESANCON;FEMININ;SCOLAIRE;BAC PROFESSIONNEL;BAC PRO PROD;BAC PRO AG 21406 TEC CONS VTE PROD DES JARDINS;4;4;4;0;0;0;0;4;0;0;1;0;3;0
696.0;2021;03;BESANCON;FEMININ;SCOLAIRE;BAC PROFESSIONNEL;BAC PRO SERV;BAC PRO 31206 VENTE (PROSPECT.NEGO.SUIV.CLIENT;62;62;55;2;5;5;0;60;0;3;17;15;25;2
702.0;2021;03;BESANCON;FEMININ;SCOLAIRE;BAC PROFESSIONNEL;BAC PRO SERV;BAC PRO 33403 COMMERC. SERVICES EN RESTAURATION;46;46;37;5;4;2;2;39;0;1;7;16;15;7
707.0;2021;03;BESANCON;FEMININ;SCOLAIRE;BAC TECHNOLOGIQUE;BAC S2TMD;BAC S2TMD DANSE;1;1;1;0;0;0;0;1;0;1;0;0;0;0
711.0;2021;03;BESANCON;FEMININ;SCOLAIRE;BAC TECHNOLOGIQUE;BAC STD2A;BAC STD2A SCIENCES & TECHNO. DESIGN-ARTS APPLIQUES;38;38;38;0;0;0;0;38;0;7;11;16;4;0
712.0;2021;03;BESANCON;FEMININ;SCOLAIRE;BAC TECHNOLOGIQUE;BAC STHR;BAC STHR SC.&TEC. HOTELLERIE-RESTAURATION;45;45;44;0;1;1;0;45;0;2;9;16;18;0
721.0;2021;03;BESANCON;FEMININ;SCOLAIRE;BAC TECHNOLOGIQUE;BAC STMG;BAC STMG RESSOURCES HUMAINES ET COMMUNICATION;266;266;244;5;17;6;11;250;0;1;21;103;125;16
722.0;2021;03;BESANCON;MASCULIN;APPRENTISSAGE;BAC PROFESSIONNEL;BAC PRO PROD;BAC PRO 22003 BIO-INDUSTRIES DE TRANSFORMATION;11;11;11;0;0;0;0;11;0;1;1;4;5;0
728.0;2021;03;BESANCON;MASCULIN;APPRENTISSAGE;BAC PROFESSIONNEL;BAC PRO PROD;BAC PRO 23207 INTERV. SUR PATRIMOINE BATI OPT.C;7;7;7;0;0;0;0;7;0;0;1;5;1;0
729.0;2021;03;BESANCON;MASCULIN;APPRENTISSAGE;BAC PROFESSIONNEL;BAC PRO PROD;BAC PRO 23304 AMENAGEMENT FINITION BATIMENT;2;2;2;0;0;0;0;2;0;0;1;0;1;0
733.0;2021;03;BESANCON;MASCULIN;APPRENTISSAGE;BAC PROFESSIONNEL;BAC PRO PROD;BAC PRO 25005 PRODUCTIQ.MECA. OPT.DECOLLETAGE;1;1;1;0;0;0;0;1;0;0;0;1;0;0
734.0;2021;03;BESANCON;MASCULIN;APPRENTISSAGE;BAC PROFESSIONNEL;BAC PRO PROD;BAC PRO 25006 MICROTECHNIQUES;5;5;5;0;0;0;0;5;0;0;2;1;2;0
739.0;2021;03;BESANCON;MASCULIN;APPRENTISSAGE;BAC PROFESSIONNEL;BAC PRO PROD;BAC PRO 25215 MAINT.VEHIC.OPTB VEHIC.TRANS.ROUT;4;4;4;0;0;0;0;4;0;0;0;3;1;0
746.0;2021;03;BESANCON;MASCULIN;APPRENTISSAGE;BAC PROFESSIONNEL;BAC PRO PROD;BAC PRO 25411 TECH.CHAUDRONNERIE INDUSTRIELLE;22;21;19;2;0;0;0;19;0;0;4;8;7;2
747.0;2021;03;BESANCON;MASCULIN;APPRENTISSAGE;BAC PROFESSIONNEL;BAC PRO PROD;BAC PRO 25509 TECHNIC. FROID CONDITIONNEMT AIR;4;4;3;1;0;0;0;3;0;0;1;2;0;1
754.0;2021;03;BESANCON;MASCULIN;APPRENTISSAGE;BAC PROFESSIONNEL;BAC PRO PROD;BAC PRO AG 21302 GEST MILIEUX NATURELS FAUNE;5;5;4;1;0;0;0;4;0;0;1;1;2;1
756.0;2021;03;BESANCON;MASCULIN;APPRENTISSAGE;BAC PROFESSIONNEL;BAC PRO PROD;BAC PRO AG 21405 AMENAGEMENTS PAYSAGERS;44;42;39;3;0;0;0;39;0;3;14;16;6;3
771.0;2021;03;BESANCON;MASCULIN;ENSEIGNEMENT A DISTANCE;BAC TECHNOLOGIQUE;BAC STMG;BAC STMG GESTION ET FINANCE;2;2;2;0;0;0;0;2;0;0;0;2;0;0
772.0;2021;03;BESANCON;MASCULIN;ENSEIGNEMENT A DISTANCE;BAC TECHNOLOGIQUE;BAC STMG;BAC STMG MERCATIQUE (MARKETING);1;1;0;0;1;1;0;1;0;0;0;0;1;0
773.0;2021;03;BESANCON;MASCULIN;FORMATION CONTINUE;BAC PROFESSIONNEL;BAC PRO PROD;BAC PRO 25007 MAINTENANCE EQUIPEMENTS INDUST.;1;1;1;0;0;0;0;1;0;1;0;0;0;0
774.0;2021;03;BESANCON;MASCULIN;FORMATION CONTINUE;BAC PROFESSIONNEL;BAC PRO PROD;BAC PRO 25509 TECHNIC. FROID CONDITIONNEMT AIR;1;1;1;0;0;0;0;1;0;1;0;0;0;0
777.0;2021;03;BESANCON;MASCULIN;INDIVIDUEL;BAC PROFESSIONNEL;BAC PRO PROD;BAC PRO 25214 MAINT.VEHIC.OPTA VOIT.PARTICUL.;1;1;1;0;0;0;0;1;0;0;1;0;0;0
785.0;2021;03;BESANCON;MASCULIN;INDIVIDUEL;BAC PROFESSIONNEL;BAC PRO SERV;BAC PRO 31202 COMMERCE;2;0;0;0;0;0;0;0;0;0;0;0;0;0
791.0;2021;03;BESANCON;MASCULIN;INDIVIDUEL;BAC TECHNOLOGIQUE;BAC STMG;BAC STMG RESSOURCES HUMAINES ET COMMUNICATION;2;0;0;0;0;0;0;0;0;0;0;0;0;0
794.0;2021;03;BESANCON;MASCULIN;SCOLAIRE;BAC PROFESSIONNEL;BAC PRO PROD;BAC PRO 22106 CUISINE;62;62;61;0;1;1;0;62;0;3;12;28;19;0
801.0;2021;03;BESANCON;MASCULIN;SCOLAIRE;BAC PROFESSIONNEL;BAC PRO PROD;BACPRO 23103 TECHNICIEN GEOMETRE-TOPOGRAPHE;7;7;5;1;1;0;1;5;0;0;3;0;2;2
802.0;2021;03;BESANCON;MASCULIN;SCOLAIRE;BAC PROFESSIONNEL;BAC PRO PROD;BAC PRO 23203 TECHNICIEN BAT. : ORG.REAL.GROS O;7;7;6;0;1;0;1;6;0;0;1;2;3;1
813.0;2021;03;BESANCON;MASCULIN;SCOLAIRE;BAC PROFESSIONNEL;BAC PRO PROD;BAC PRO 25106 TECHNICIEN D'USINAGE;54;53;33;15;5;3;2;36;0;1;4;14;17;17
815.0;2021;03;BESANCON;MASCULIN;SCOLAIRE;BAC PROFESSIONNEL;BAC PRO PROD;BAC PRO 25214 MAINT.VEHIC.OPTA VOIT.PARTICUL.;81;80;59;16;5;4;1;63;0;2;11;23;27;17
823.0;2021;03;BESANCON;MASCULIN;SCOLAIRE;BAC PROFESSIONNEL;BAC PRO PROD;BAC PRO 25513 SYST.NUM.OPT.A SURETE SECURITE;42;42;31;5;6;6;0;37;0;0;7;9;21;5
824.0;2021;03;BESANCON;MASCULIN;SCOLAIRE;BAC PROFESSIONNEL;BAC PRO PROD;BAC PRO 25514 SYST.NUM.OPT.B AUD.RES.EQUIP.DOM.;48;48;47;0;1;0;1;47;0;4;9;16;18;1
825.0;2021;03;BESANCON;MASCULIN;SCOLAIRE;BAC PROFESSIONNEL;BAC PRO PROD;BAC PRO 25515 SYST.NUM.OPT.C RES.INF.SYST.COMM.;104;104;95;3;6;3;3;98;0;4;22;40;32;6
826.0;2021;03;BESANCON;MASCULIN;SCOLAIRE;BAC PROFESSIONNEL;BAC PRO PROD;BAC PRO AG 21001 AGRO-EQUIPEMENT;27;27;26;1;0;0;0;26;0;0;0;11;15;1
827.0;2021;03;BESANCON;MASCULIN;SCOLAIRE;BAC PROFESSIONNEL;BAC PRO PROD;BAC PRO AG 21004 CGEA;79;78;72;6;0;0;0;72;0;0;13;37;22;6
832.0;2021;03;BESANCON;MASCULIN;SCOLAIRE;BAC PROFESSIONNEL;BAC PRO PROD;BAC PRO AG 21303 FORET;6;6;6;0;0;0;0;6;0;0;1;1;4;0
833.0;2021;03;BESANCON;MASCULIN;SCOLAIRE;BAC PROFESSIONNEL;BAC PRO PROD;BAC PRO AG 21405 AMENAGEMENTS PAYSAGERS;18;18;16;2;0;0;0;16;0;0;2;7;7;2
836.0;2021;03;BESANCON;MASCULIN;SCOLAIRE;BAC PROFESSIONNEL;BAC PRO SERV;BAC PRO 30001 GESTION-ADMINISTRATION;87;87;58;27;2;1;1;59;0;0;5;22;32;28
837.0;2021;03;BESANCON;MASCULIN;SCOLAIRE;BAC PROFESSIONNEL;BAC PRO SERV;BAC PRO 31106 LOGISTIQUE;25;25;14;9;2;1;1;15;0;0;1;9;5;10
840.0;2021;03;BESANCON;MASCULIN;SCOLAIRE;BAC PROFESSIONNEL;BAC PRO SERV;BAC PRO 31206 VENTE (PROSPECT.NEGO.SUIV.CLIENT;68;68;56;10;2;0;2;56;0;0;12;23;21;12
842.0;2021;03;BESANCON;MASCULIN;SCOLAIRE;BAC PROFESSIONNEL;BAC PRO SERV;BAC PRO 33002 SERVICES DE PROXIMITE  VIE LOCAL;6;6;5;1;0;0;0;5;0;0;1;2;2;1
845.0;2021;03;BESANCON;MASCULIN;SCOLAIRE;BAC PROFESSIONNEL;BAC PRO SERV;BAC PRO 33101 OPTIQUE LUNETTERIE;10;10;7;3;0;0;0;7;0;1;3;2;1;3
846.0;2021;03;BESANCON;MASCULIN;SCOLAIRE;BAC PROFESSIONNEL;BAC PRO SERV;BAC PRO 33403 COMMERC. SERVICES EN RESTAURATION;25;25;22;3;0;0;0;22;0;1;5;6;10;3
847.0;2021;03;BESANCON;MASCULIN;SCOLAIRE;BAC PROFESSIONNEL;BAC PRO SERV;BAC PRO 34403 METIERS DE LA SECURITE;47;47;40;4;3;2;1;42;0;1;8;18;15;5
850.0;2021;03;BESANCON;MASCULIN;SCOLAIRE;BAC TECHNOLOGIQUE;BAC ST2S;BAC ST2S SCIENCES & TECHNO. SANTE & SOCIAL;38;38;28;0;10;6;4;34;0;1;3;12;18;4
851.0;2021;03;BESANCON;MASCULIN;SCOLAIRE;BAC TECHNOLOGIQUE;BAC STAV;BAC STAV AGRONOMIE ALIM ENV TERRITOI;77;77;75;2;0;0;0;75;0;0;10;39;26;2
853.0;2021;03;BESANCON;MASCULIN;SCOLAIRE;BAC TECHNOLOGIQUE;BAC STHR;BAC STHR SC.&TEC. HOTELLERIE-RESTAURATION;22;22;21;0;1;1;0;22;0;1;1;11;9;0
854.0;2021;03;BESANCON;MASCULIN;SCOLAIRE;BAC TECHNOLOGIQUE;BAC STI2D;BAC STI2D ARCHITECTURE ET CONSTRUCTION;50;50;46;0;4;1;3;47;0;2;7;19;19;3
860.0;2021;03;BESANCON;MASCULIN;SCOLAIRE;BAC TECHNOLOGIQUE;BAC STMG;BAC STMG GESTION ET FINANCE;108;108;99;1;8;6;2;105;0;1;19;43;42;3
864.0;2021;04;BORDEAUX;FEMININ;APPRENTISSAGE;BAC PROFESSIONNEL;BAC PRO PROD;BAC PRO 20102 PILOTE DE LIGNE DE PRODUCTION;8;7;7;0;0;0;0;7;0;2;4;0;1;0
881.0;2021;04;BORDEAUX;FEMININ;APPRENTISSAGE;BAC PROFESSIONNEL;BAC PRO PROD;BAC PRO AG 21405 AMENAGEMENTS PAYSAGERS;4;4;4;0;0;0;0;4;0;0;3;1;0;0
883.0;2021;04;BORDEAUX;FEMININ;APPRENTISSAGE;BAC PROFESSIONNEL;BAC PRO SERV;BAC PRO 30001 GESTION-ADMINISTRATION;25;24;19;5;0;0;0;19;0;5;4;6;4;5
887.0;2021;04;BORDEAUX;FEMININ;APPRENTISSAGE;BAC PROFESSIONNEL;BAC PRO SERV;BAC PRO 31210 ACCUEIL -RELATION CLIENTS USAGERS;9;9;8;1;0;0;0;8;0;3;1;2;2;1
892.0;2021;04;BORDEAUX;FEMININ;APPRENTISSAGE;BAC PROFESSIONNEL;BAC PRO SERV;BAC PRO 33102 PROTHESE DENTAIRE;3;3;3;0;0;0;0;3;0;1;2;0;0;0
894.0;2021;04;BORDEAUX;FEMININ;APPRENTISSAGE;BAC PROFESSIONNEL;BAC PRO SERV;BAC PRO 34304 HYGIENE PROPRETE STERILISATION;8;8;7;1;0;0;0;7;0;0;4;2;1;1
906.0;2021;04;BORDEAUX;FEMININ;ENSEIGNEMENT A DISTANCE;BAC TECHNOLOGIQUE;BAC STMG;BAC STMG RESSOURCES HUMAINES ET COMMUNICATION;5;5;4;1;0;0;0;4;0;0;0;4;0;1
908.0;2021;04;BORDEAUX;FEMININ;FORMATION CONTINUE;BAC PROFESSIONNEL;BAC PRO PROD;BAC PRO 24302 METIERS DU CUIR : MAROQUINERIE;1;1;1;0;0;0;0;1;0;1;0;0;0;0
914.0;2021;04;BORDEAUX;FEMININ;FORMATION CONTINUE;BAC PROFESSIONNEL;BAC PRO SERV;BAC PRO 33101 OPTIQUE LUNETTERIE;2;2;2;0;0;0;0;2;0;2;0;0;0;0
920.0;2021;04;BORDEAUX;FEMININ;INDIVIDUEL;BAC PROFESSIONNEL;BAC PRO PROD;BAC PRO AG 21211 COND GEST ENTR HIPPIQUE;5;4;2;2;0;0;0;2;0;0;0;1;1;2
930.0;2021;04;BORDEAUX;FEMININ;INDIVIDUEL;BAC PROFESSIONNEL;BAC PRO SERV;BAC PRO 33102 PROTHESE DENTAIRE;1;0;0;0;0;0;0;0;0;0;0;0;0;0
937.0;2021;04;BORDEAUX;FEMININ;INDIVIDUEL;BAC TECHNOLOGIQUE;BAC STMG;BAC STMG GESTION ET FINANCE;3;3;1;1;1;1;0;2;0;0;0;1;1;1
950.0;2021;04;BORDEAUX;FEMININ;SCOLAIRE;BAC PROFESSIONNEL;BAC PRO PROD;BAC PRO 22703 TECHN.INSTALL.SYST.ENERG.CLIMATI;2;2;2;0;0;0;0;2;0;0;0;2;0;0
954.0;2021;04;BORDEAUX;FEMININ;SCOLAIRE;BAC PROFESSIONNEL;BAC PRO PROD;BAC PRO 23102 TRAVAUX PUBLICS;1;1;1;0;0;0;0;1;0;0;1;0;0;0
955.0;2021;04;BORDEAUX;FEMININ;SCOLAIRE;BAC PROFESSIONNEL;BAC PRO PROD;BAC PRO 23208 METIERS ET ARTS DE LA PIERRE;1;1;1;0;0;0;0;1;0;0;0;0;1;0
966.0;2021;04;BORDEAUX;FEMININ;SCOLAIRE;BAC PROFESSIONNEL;BAC PRO PROD;BAC PRO 25215 MAINT.VEHIC.OPTB VEHIC.TRANS.ROUT;1;1;1;0;0;0;0;1;0;0;1;0;0;0
970.0;2021;04;BORDEAUX;FEMININ;SCOLAIRE;BAC PROFESSIONNEL;BAC PRO PROD;BAC PRO 25408 REPARATION DES CARROSSERIES;1;1;1;0;0;0;0;1;0;0;0;1;0;0
976.0;2021;04;BORDEAUX;FEMININ;SCOLAIRE;BAC PROFESSIONNEL;BAC PRO PROD;BAC PRO AG 21001 AGRO-EQUIPEMENT;1;1;1;0;0;0;0;1;0;0;0;1;0;0
978.0;2021;04;BORDEAUX;FEMININ;SCOLAIRE;BAC PROFESSIONNEL;BAC PRO PROD;BAC PRO AG 21113 CGEVV;5;5;4;1;0;0;0;4;0;0;2;0;2;1
982.0;2021;04;BORDEAUX;FEMININ;SCOLAIRE;BAC PROFESSIONNEL;BAC PRO PROD;BAC PRO AG 21210 COND GEST ENTR CANIN ET FELIN;26;26;22;4;0;0;0;22;0;0;3;10;9;4
986.0;2021;04;BORDEAUX;FEMININ;SCOLAIRE;BAC PROFESSIONNEL;BAC PRO PROD;BAC PRO AG 21406 TEC CONS VTE PROD DES JARDINS;19;19;15;4;0;0;0;15;0;0;0;6;9;4
991.0;2021;04;BORDEAUX;FEMININ;SCOLAIRE;BAC PROFESSIONNEL;BAC PRO SERV;BAC PRO 31106 LOGISTIQUE;16;16;9;2;5;3;2;12;0;0;3;4;5;4
993.0;2021;04;BORDEAUX;FEMININ;SCOLAIRE;BAC PROFESSIONNEL;BAC PRO SERV;BAC PRO 31108 TRANSPORT;3;3;3;0;0;0;0;3;0;0;1;1;1;0
1008.0;2021;04;BORDEAUX;FEMININ;SCOLAIRE;BAC PROFESSIONNEL;BAC PRO SERV;BAC PRO 34304 HYGIENE PROPRETE STERILISATION;10;10;7;3;0;0;0;7;0;0;0;5;2;3
1014.0;2021;04;BORDEAUX;FEMININ;SCOLAIRE;BAC TECHNOLOGIQUE;BAC STAV;BAC STAV AGRONOMIE ALIM ENV TERRITOI;153;153;153;0;0;0;0;153;0;0;33;83;37;0
1033.0;2021;04;BORDEAUX;MASCULIN;APPRENTISSAGE;BAC PROFESSIONNEL;BAC PRO PROD;BAC PRO 23102 TRAVAUX PUBLICS;23;23;21;0;2;1;1;22;0;1;4;14;3;1
1038.0;2021;04;BORDEAUX;MASCULIN;APPRENTISSAGE;BAC PROFESSIONNEL;BAC PRO PROD;BAC PRO 23405 TECHNICIEN MENUISIER AGENCEUR;5;5;5;0;0;0;0;5;0;0;3;1;1;0
1041.0;2021;04;BORDEAUX;MASCULIN;APPRENTISSAGE;BAC PROFESSIONNEL;BAC PRO PROD;BAC PRO 24303 MET. DU CUIR: SELLERIE GARNISSAGE;4;4;4;0;0;0;0;4;0;0;1;3;0;0
1047.0;2021;04;BORDEAUX;MASCULIN;APPRENTISSAGE;BAC PROFESSIONNEL;BAC PRO PROD;BAC PRO 25215 MAINT.VEHIC.OPTB VEHIC.TRANS.ROUT;27;26;21;1;4;2;2;23;0;1;2;7;13;3
1054.0;2021;04;BORDEAUX;MASCULIN;APPRENTISSAGE;BAC PROFESSIONNEL;BAC PRO PROD;BAC PRO 25509 TECHNIC. FROID CONDITIONNEMT AIR;18;18;12;3;3;2;1;14;0;3;2;2;7;4
1061.0;2021;04;BORDEAUX;MASCULIN;APPRENTISSAGE;BAC PROFESSIONNEL;BAC PRO PROD;BAC PRO AG 21113 CGEVV;26;25;18;7;0;0;0;18;0;1;3;4;10;7
1063.0;2021;04;BORDEAUX;MASCULIN;APPRENTISSAGE;BAC PROFESSIONNEL;BAC PRO PROD;BAC PRO AG 21211 COND GEST ENTR HIPPIQUE;1;1;1;0;0;0;0;1;0;0;0;0;1;0
1065.0;2021;04;BORDEAUX;MASCULIN;APPRENTISSAGE;BAC PROFESSIONNEL;BAC PRO PROD;BAC PRO AG 21405 AMENAGEMENTS PAYSAGERS;81;75;69;6;0;0;0;69;0;1;14;24;30;6
1067.0;2021;04;BORDEAUX;MASCULIN;APPRENTISSAGE;BAC PROFESSIONNEL;BAC PRO SERV;BAC PRO 30001 GESTION-ADMINISTRATION;2;2;2;0;0;0;0;2;0;1;1;0;0;0
1074.0;2021;04;BORDEAUX;MASCULIN;APPRENTISSAGE;BAC PROFESSIONNEL;BAC PRO SERV;BAC PRO 32208 REAL.PR.IMPR.PLURI.OPTB.PR.IMPR.;3;3;2;1;0;0;0;2;0;0;1;0;1;1
1081.0;2021;04;BORDEAUX;MASCULIN;ENSEIGNEMENT A DISTANCE;BAC GENERAL;BAC GENERAL;BAC GENE 10019 BAC GENERAL;28;27;26;1;0;0;0;26;0;4;8;9;5;1
1089.0;2021;04;BORDEAUX;MASCULIN;ENSEIGNEMENT A DISTANCE;BAC TECHNOLOGIQUE;BAC STMG;BAC STMG MERCATIQUE (MARKETING);10;10;10;0;0;0;0;10;0;0;3;4;3;0
1093.0;2021;04;BORDEAUX;MASCULIN;FORMATION CONTINUE;BAC PROFESSIONNEL;BAC PRO PROD;BAC PRO 25411 TECH.CHAUDRONNERIE INDUSTRIELLE;1;1;1;0;0;0;0;1;0;0;1;0;0;0
1097.0;2021;04;BORDEAUX;MASCULIN;FORMATION CONTINUE;BAC PROFESSIONNEL;BAC PRO PROD;BAC PRO AG 21114 CONDUITE PRODUCTIONS HORTICOLES;1;1;1;0;0;0;0;1;0;0;0;0;1;0
1098.0;2021;04;BORDEAUX;MASCULIN;FORMATION CONTINUE;BAC PROFESSIONNEL;BAC PRO PROD;BAC PRO AG 21405 AMENAGEMENTS PAYSAGERS;3;3;3;0;0;0;0;3;0;1;1;0;1;0
1102.0;2021;04;BORDEAUX;MASCULIN;FORMATION CONTINUE;BAC PROFESSIONNEL;BAC PRO SERV;BAC PRO 33102 PROTHESE DENTAIRE;4;4;3;1;0;0;0;3;0;0;2;0;1;1
1104.0;2021;04;BORDEAUX;MASCULIN;INDIVIDUEL;BAC PROFESSIONNEL;BAC PRO PROD;BAC PRO 22004 PROC. CHIMIE EAU PAPIERS-CARTONS;1;0;0;0;0;0;0;0;0;0;0;0;0;0
1107.0;2021;04;BORDEAUX;MASCULIN;INDIVIDUEL;BAC PROFESSIONNEL;BAC PRO PROD;BAC PRO 23404 TECHNICIEN CONSTRUCTEUR BOIS;1;1;0;1;0;0;0;0;0;0;0;0;0;1
1109.0;2021;04;BORDEAUX;MASCULIN;INDIVIDUEL;BAC PROFESSIONNEL;BAC PRO PROD;BAC PRO 25007 MAINTENANCE EQUIPEMENTS INDUST.;1;1;1;0;0;0;0;1;0;0;0;0;1;0
1119.0;2021;04;BORDEAUX;MASCULIN;INDIVIDUEL;BAC PROFESSIONNEL;BAC PRO PROD;BAC PRO AG 21405 AMENAGEMENTS PAYSAGERS;1;1;0;1;0;0;0;0;0;0;0;0;0;1
1129.0;2021;04;BORDEAUX;MASCULIN;INDIVIDUEL;BAC TECHNOLOGIQUE;BAC STI2D;BAC STI2D INNOVATION TECHNO.  ET ECO CONCEPTION;2;1;0;0;1;1;0;1;0;0;0;0;1;0
1130.0;2021;04;BORDEAUX;MASCULIN;INDIVIDUEL;BAC TECHNOLOGIQUE;BAC STL;BAC STL BIOCHIM.-BIOLOGIE-BIOTECHNOL.;1;1;0;1;0;0;0;0;0;0;0;0;0;1
1131.0;2021;04;BORDEAUX;MASCULIN;INDIVIDUEL;BAC TECHNOLOGIQUE;BAC STMG;BAC STMG GESTION ET FINANCE;5;4;2;2;0;0;0;2;0;0;0;0;2;2
1140.0;2021;04;BORDEAUX;MASCULIN;SCOLAIRE;BAC PROFESSIONNEL;BAC PRO PROD;BAC PRO 22104 BOUCHER CHARCUTIER TRAITEUR;7;7;7;0;0;0;0;7;0;2;2;2;1;0
1146.0;2021;04;BORDEAUX;MASCULIN;SCOLAIRE;BAC PROFESSIONNEL;BAC PRO PROD;BAC PRO 23004 TECHN. ETUDES BAT.A ETUDES & ECO.;62;62;43;7;12;10;2;53;0;0;5;20;28;9
1156.0;2021;04;BORDEAUX;MASCULIN;SCOLAIRE;BAC PROFESSIONNEL;BAC PRO PROD;BAC PRO 23407 TECHNIC.FAB.BOIS ET MATERX ASSOC;9;9;8;1;0;0;0;8;0;0;2;3;3;1
1168.0;2021;04;BORDEAUX;MASCULIN;SCOLAIRE;BAC PROFESSIONNEL;BAC PRO PROD;BAC PRO 25220 MAINT.MATERIELS OPT.B TP MANUT.;28;28;24;3;1;1;0;25;0;0;6;13;6;3
1169.0;2021;04;BORDEAUX;MASCULIN;SCOLAIRE;BAC PROFESSIONNEL;BAC PRO PROD;BAC PRO 25221 MAINT.MATERIELS OPT.C ESP. VERTS;11;11;9;2;0;0;0;9;0;0;1;6;2;2
1182.0;2021;04;BORDEAUX;MASCULIN;SCOLAIRE;BAC PROFESSIONNEL;BAC PRO PROD;BAC PRO AG 21004 CGEA;107;106;98;8;0;0;0;98;0;3;22;30;43;8
1190.0;2021;04;BORDEAUX;MASCULIN;SCOLAIRE;BAC PROFESSIONNEL;BAC PRO PROD;BAC PRO AG 21303 FORET;38;38;38;0;0;0;0;38;0;2;10;10;16;0
1193.0;2021;04;BORDEAUX;MASCULIN;SCOLAIRE;BAC PROFESSIONNEL;BAC PRO PROD;BAC PRO AG 22105 LABORATOIRE CONTROLE QUALITE;12;11;9;2;0;0;0;9;0;0;5;1;3;2
1194.0;2021;04;BORDEAUX;MASCULIN;SCOLAIRE;BAC PROFESSIONNEL;BAC PRO PROD;BAC PRO AG 22106 TEC CONS VTE ALIMENTATION VINS SP;17;15;11;4;0;0;0;11;0;0;2;3;6;4
1200.0;2021;04;BORDEAUX;MASCULIN;SCOLAIRE;BAC PROFESSIONNEL;BAC PRO SERV;BAC PRO 31202 COMMERCE;473;471;373;48;50;33;17;406;0;23;79;155;149;65
1201.0;2021;04;BORDEAUX;MASCULIN;SCOLAIRE;BAC PROFESSIONNEL;BAC PRO SERV;BAC PRO 31206 VENTE (PROSPECT.NEGO.SUIV.CLIENT;262;261;204;34;23;17;6;221;0;6;29;79;107;40
1205.0;2021;04;BORDEAUX;MASCULIN;SCOLAIRE;BAC PROFESSIONNEL;BAC PRO SERV;BAC PRO 32303 ART.& MET.ART:COM.VIS.VIS.PLURI-M;56;56;49;7;0;0;0;49;0;4;7;25;13;7
1206.0;2021;04;BORDEAUX;MASCULIN;SCOLAIRE;BAC PROFESSIONNEL;BAC PRO SERV;BAC PRO 32304 PHOTOGRAPHIE;11;11;11;0;0;0;0;11;0;0;1;5;5;0
1242.0;2021;06;CLERMONT-FERRAND;FEMININ;APPRENTISSAGE;BAC PROFESSIONNEL;BAC PRO PROD;BAC PRO 25214 MAINT.VEHIC.OPTA VOIT.PARTICUL.;2;2;2;0;0;0;0;2;0;1;0;1;0;0
1249.0;2021;06;CLERMONT-FERRAND;FEMININ;APPRENTISSAGE;BAC PROFESSIONNEL;BAC PRO SERV;BAC PRO 31202 COMMERCE;40;37;35;2;0;0;0;35;0;3;12;14;6;2
1250.0;2021;06;CLERMONT-FERRAND;FEMININ;APPRENTISSAGE;BAC PROFESSIONNEL;BAC PRO SERV;BAC PRO 31210 ACCUEIL -RELATION CLIENTS USAGERS;8;8;7;0;1;0;1;7;0;1;3;1;2;1
1255.0;2021;06;CLERMONT-FERRAND;FEMININ;ENSEIGNEMENT A DISTANCE;BAC PROFESSIONNEL;BAC PRO PROD;BAC PRO AG 21113 CGEVV;12;10;10;0;0;0;0;10;0;0;0;0;10;0
1273.0;2021;06;CLERMONT-FERRAND;FEMININ;INDIVIDUEL;BAC PROFESSIONNEL;BAC PRO PROD;BAC PRO AG 21211 COND GEST ENTR HIPPIQUE;5;3;1;2;0;0;0;1;0;0;1;0;0;2
1275.0;2021;06;CLERMONT-FERRAND;FEMININ;INDIVIDUEL;BAC PROFESSIONNEL;BAC PRO SERV;BAC PRO 30001 GESTION-ADMINISTRATION;2;1;0;1;0;0;0;0;0;0;0;0;0;1
1276.0;2021;06;CLERMONT-FERRAND;FEMININ;INDIVIDUEL;BAC PROFESSIONNEL;BAC PRO SERV;BAC PRO 31202 COMMERCE;1;1;1;0;0;0;0;1;0;0;0;0;1;0
1279.0;2021;06;CLERMONT-FERRAND;FEMININ;INDIVIDUEL;BAC PROFESSIONNEL;BAC PRO SERV;BAC PRO 33603 ESTHETIQUE COSMETIQUE PARFUMERIE;1;1;1;0;0;0;0;1;0;0;0;0;1;0
1292.0;2021;06;CLERMONT-FERRAND;FEMININ;SCOLAIRE;BAC PROFESSIONNEL;BAC PRO PROD;BAC PRO 23004 TECHN. ETUDES BAT.A ETUDES & ECO.;3;3;2;1;0;0;0;2;0;0;0;2;0;1
1294.0;2021;06;CLERMONT-FERRAND;FEMININ;SCOLAIRE;BAC PROFESSIONNEL;BAC PRO PROD;BAC PRO 23304 AMENAGEMENT FINITION BATIMENT;1;1;1;0;0;0;0;1;0;0;0;0;1;0
1297.0;2021;06;CLERMONT-FERRAND;FEMININ;SCOLAIRE;BAC PROFESSIONNEL;BAC PRO PROD;BAC PRO 24203 METIERS DE LA MODE - VÊTEMENT;34;34;26;7;1;1;0;27;0;3;6;6;12;7
1313.0;2021;06;CLERMONT-FERRAND;FEMININ;SCOLAIRE;BAC PROFESSIONNEL;BAC PRO PROD;BAC PRO AG 21211 COND GEST ENTR HIPPIQUE;27;27;27;0;0;0;0;27;0;0;5;14;8;0
1317.0;2021;06;CLERMONT-FERRAND;FEMININ;SCOLAIRE;BAC PROFESSIONNEL;BAC PRO PROD;BAC PRO AG 21406 TEC CONS VTE PROD DES JARDINS;8;7;7;0;0;0;0;7;0;0;0;2;5;0
1341.0;2021;06;CLERMONT-FERRAND;FEMININ;SCOLAIRE;BAC TECHNOLOGIQUE;BAC STAV;BAC STAV AGRONOMIE ALIM ENV TERRITOI;65;65;65;0;0;0;0;65;0;1;10;36;18;0
1342.0;2021;06;CLERMONT-FERRAND;FEMININ;SCOLAIRE;BAC TECHNOLOGIQUE;BAC STD2A;BAC STD2A SCIENCES & TECHNO. DESIGN-ARTS APPLIQUES;64;64;63;0;1;1;0;64;1;4;29;25;5;0
1348.0;2021;06;CLERMONT-FERRAND;FEMININ;SCOLAIRE;BAC TECHNOLOGIQUE;BAC STL;BAC STL BIOCHIM.-BIOLOGIE-BIOTECHNOL.;66;66;64;0;2;2;0;66;0;3;12;29;22;0
1353.0;2021;06;CLERMONT-FERRAND;FEMININ;SCOLAIRE;BAC TECHNOLOGIQUE;BAC STMG;BAC STMG SYSTEMES D'INFORMATION DE GESTION;5;5;5;0;0;0;0;5;0;0;1;3;1;0
1367.0;2021;06;CLERMONT-FERRAND;MASCULIN;APPRENTISSAGE;BAC PROFESSIONNEL;BAC PRO PROD;BAC PRO 25106 TECHNICIEN D'USINAGE;22;22;19;2;1;1;0;20;0;4;10;5;1;2
1370.0;2021;06;CLERMONT-FERRAND;MASCULIN;APPRENTISSAGE;BAC PROFESSIONNEL;BAC PRO PROD;BAC PRO 25215 MAINT.VEHIC.OPTB VEHIC.TRANS.ROUT;11;11;7;3;1;1;0;8;0;0;1;3;4;3
1374.0;2021;06;CLERMONT-FERRAND;MASCULIN;APPRENTISSAGE;BAC PROFESSIONNEL;BAC PRO PROD;BAC PRO 25221 MAINT.MATERIELS OPT.C ESP. VERTS;1;1;1;0;0;0;0;1;0;0;0;1;0;0
1379.0;2021;06;CLERMONT-FERRAND;MASCULIN;APPRENTISSAGE;BAC PROFESSIONNEL;BAC PRO PROD;BAC PRO 25411 TECH.CHAUDRONNERIE INDUSTRIELLE;17;17;17;0;0;0;0;17;0;3;2;5;7;0
1381.0;2021;06;CLERMONT-FERRAND;MASCULIN;APPRENTISSAGE;BAC PROFESSIONNEL;BAC PRO PROD;BAC PRO 25510 METIERS ELECT. ENVIRON. CONNECTES;45;45;41;2;2;1;1;42;0;6;13;17;6;3
1382.0;2021;06;CLERMONT-FERRAND;MASCULIN;APPRENTISSAGE;BAC PROFESSIONNEL;BAC PRO PROD;BAC PRO AG 21004 CGEA;32;32;28;4;0;0;0;28;0;0;5;7;16;4
1387.0;2021;06;CLERMONT-FERRAND;MASCULIN;APPRENTISSAGE;BAC PROFESSIONNEL;BAC PRO SERV;BAC PRO 30001 GESTION-ADMINISTRATION;2;2;2;0;0;0;0;2;0;0;0;2;0;0
1397.0;2021;06;CLERMONT-FERRAND;MASCULIN;ENSEIGNEMENT A DISTANCE;BAC PROFESSIONNEL;BAC PRO PROD;BAC PRO AG 21113 CGEVV;14;13;13;0;0;0;0;13;0;0;0;0;13;0
1398.0;2021;06;CLERMONT-FERRAND;MASCULIN;ENSEIGNEMENT A DISTANCE;BAC TECHNOLOGIQUE;BAC ST2S;BAC ST2S SCIENCES & TECHNO. SANTE & SOCIAL;1;1;1;0;0;0;0;1;0;0;0;0;1;0
1399.0;2021;06;CLERMONT-FERRAND;MASCULIN;ENSEIGNEMENT A DISTANCE;BAC TECHNOLOGIQUE;BAC STAV;BAC STAV AGRONOMIE ALIM ENV TERRITOI;15;14;14;0;0;0;0;14;0;0;2;0;12;0
1402.0;2021;06;CLERMONT-FERRAND;MASCULIN;FORMATION CONTINUE;BAC PROFESSIONNEL;BAC PRO PROD;BAC PRO 22704 TECHN. MAINT. SYST.ENERG.CLIMATI;2;2;2;0;0;0;0;2;0;1;1;0;0;0
1404.0;2021;06;CLERMONT-FERRAND;MASCULIN;FORMATION CONTINUE;BAC PROFESSIONNEL;BAC PRO PROD;BAC PRO 25007 MAINTENANCE EQUIPEMENTS INDUST.;1;1;1;0;0;0;0;1;0;1;0;0;0;0
1405.0;2021;06;CLERMONT-FERRAND;MASCULIN;FORMATION CONTINUE;BAC PROFESSIONNEL;BAC PRO PROD;BAC PRO 25214 MAINT.VEHIC.OPTA VOIT.PARTICUL.;1;1;1;0;0;0;0;1;0;0;1;0;0;0
1406.0;2021;06;CLERMONT-FERRAND;MASCULIN;FORMATION CONTINUE;BAC PROFESSIONNEL;BAC PRO PROD;BAC PRO 25514 SYST.NUM.OPT.B AUD.RES.EQUIP.DOM.;1;1;1;0;0;0;0;1;0;0;1;0;0;0
1415.0;2021;06;CLERMONT-FERRAND;MASCULIN;INDIVIDUEL;BAC PROFESSIONNEL;BAC PRO SERV;BAC PRO 31206 VENTE (PROSPECT.NEGO.SUIV.CLIENT;2;1;1;0;0;0;0;1;0;0;0;0;1;0
1427.0;2021;06;CLERMONT-FERRAND;MASCULIN;SCOLAIRE;BAC PROFESSIONNEL;BAC PRO PROD;BAC PRO 22403 ARTS.& MET.ART:MET.ENSEIGN SIGNA;5;5;4;1;0;0;0;4;0;1;1;2;0;1
1428.0;2021;06;CLERMONT-FERRAND;MASCULIN;SCOLAIRE;BAC PROFESSIONNEL;BAC PRO PROD;BAC PRO 22503 PLASTIQUES ET COMPOSITES;6;6;6;0;0;0;0;6;0;0;0;2;4;0
1435.0;2021;06;CLERMONT-FERRAND;MASCULIN;SCOLAIRE;BAC PROFESSIONNEL;BAC PRO PROD;BACPRO 23103 TECHNICIEN GEOMETRE-TOPOGRAPHE;11;11;10;1;0;0;0;10;0;2;4;1;3;1
1443.0;2021;06;CLERMONT-FERRAND;MASCULIN;SCOLAIRE;BAC PROFESSIONNEL;BAC PRO PROD;BAC PRO 25007 MAINTENANCE EQUIPEMENTS INDUST.;138;137;114;14;9;6;3;120;0;4;28;45;43;17
1449.0;2021;06;CLERMONT-FERRAND;MASCULIN;SCOLAIRE;BAC PROFESSIONNEL;BAC PRO PROD;BAC PRO 25221 MAINT.MATERIELS OPT.C ESP. VERTS;8;8;6;1;1;0;1;6;0;0;1;2;3;2
1453.0;2021;06;CLERMONT-FERRAND;MASCULIN;SCOLAIRE;BAC PROFESSIONNEL;BAC PRO PROD;BAC PRO 25408 REPARATION DES CARROSSERIES;16;16;10;2;4;3;1;13;0;0;1;7;5;3
1454.0;2021;06;CLERMONT-FERRAND;MASCULIN;SCOLAIRE;BAC PROFESSIONNEL;BAC PRO PROD;BAC PRO 25410 CONSTRUCTION DES CARROSSERIES;5;5;5;0;0;0;0;5;0;0;1;2;2;0
1458.0;2021;06;CLERMONT-FERRAND;MASCULIN;SCOLAIRE;BAC PROFESSIONNEL;BAC PRO PROD;BAC PRO 25513 SYST.NUM.OPT.A SURETE SECURITE;23;23;15;6;2;1;1;16;0;0;1;7;8;7
1462.0;2021;06;CLERMONT-FERRAND;MASCULIN;SCOLAIRE;BAC PROFESSIONNEL;BAC PRO PROD;BAC PRO AG 21004 CGEA;159;157;150;7;0;0;0;150;0;3;22;64;61;7
1463.0;2021;06;CLERMONT-FERRAND;MASCULIN;SCOLAIRE;BAC PROFESSIONNEL;BAC PRO PROD;BAC PRO AG 21113 CGEVV;1;1;1;0;0;0;0;1;0;0;0;0;1;0
1465.0;2021;06;CLERMONT-FERRAND;MASCULIN;SCOLAIRE;BAC PROFESSIONNEL;BAC PRO PROD;BAC PRO AG 21203 TECHN CONSEIL DE VENTE ANIMAL;14;14;13;1;0;0;0;13;0;0;4;5;4;1
1470.0;2021;06;CLERMONT-FERRAND;MASCULIN;SCOLAIRE;BAC PROFESSIONNEL;BAC PRO PROD;BAC PRO AG 21405 AMENAGEMENTS PAYSAGERS;57;55;54;1;0;0;0;54;0;1;10;25;18;1
1476.0;2021;06;CLERMONT-FERRAND;MASCULIN;SCOLAIRE;BAC PROFESSIONNEL;BAC PRO SERV;BAC PRO 31107 CONDUCT. TRANSP.ROUT.MARCHANDISES;18;18;15;2;1;1;0;16;0;0;6;5;5;2
1477.0;2021;06;CLERMONT-FERRAND;MASCULIN;SCOLAIRE;BAC PROFESSIONNEL;BAC PRO SERV;BAC PRO 31108 TRANSPORT;18;18;10;7;1;1;0;11;0;1;1;4;5;7
1479.0;2021;06;CLERMONT-FERRAND;MASCULIN;SCOLAIRE;BAC PROFESSIONNEL;BAC PRO SERV;BAC PRO 31206 VENTE (PROSPECT.NEGO.SUIV.CLIENT;65;65;52;8;5;4;1;56;0;3;8;29;16;9
1490.0;2021;06;CLERMONT-FERRAND;MASCULIN;SCOLAIRE;BAC PROFESSIONNEL;BAC PRO SERV;BAC PRO 33403 COMMERC. SERVICES EN RESTAURATION;36;36;26;7;3;0;3;26;0;2;7;9;8;10
1497.0;2021;06;CLERMONT-FERRAND;MASCULIN;SCOLAIRE;BAC TECHNOLOGIQUE;BAC STHR;BAC STHR SC.&TEC. HOTELLERIE-RESTAURATION;24;24;24;0;0;0;0;24;0;1;7;6;10;0
1501.0;2021;06;CLERMONT-FERRAND;MASCULIN;SCOLAIRE;BAC TECHNOLOGIQUE;BAC STI2D;BAC STI2D SYSTÈME D'INFORMATION  ET NUMERIQUE;142;142;135;2;5;2;3;137;0;1;19;62;55;5
1506.0;2021;06;CLERMONT-FERRAND;MASCULIN;SCOLAIRE;BAC TECHNOLOGIQUE;BAC STMG;BAC STMG RESSOURCES HUMAINES ET COMMUNICATION;102;102;83;5;14;4;10;87;0;0;1;23;63;15
1508.0;2021;27;CORSE;FEMININ;APPRENTISSAGE;BAC PROFESSIONNEL;BAC PRO PROD;BAC PRO 25214 MAINT.VEHIC.OPTA VOIT.PARTICUL.;1;1;1;0;0;0;0;1;0;0;0;1;0;0
1509.0;2021;27;CORSE;FEMININ;APPRENTISSAGE;BAC PROFESSIONNEL;BAC PRO SERV;BAC PRO 30001 GESTION-ADMINISTRATION;12;10;9;1;0;0;0;9;0;0;3;5;1;1
1519.0;2021;27;CORSE;FEMININ;ENSEIGNEMENT A DISTANCE;BAC TECHNOLOGIQUE;BAC STMG;BAC STMG RESSOURCES HUMAINES ET COMMUNICATION;2;2;1;1;0;0;0;1;0;0;0;0;1;1
1521.0;2021;27;CORSE;FEMININ;INDIVIDUEL;BAC PROFESSIONNEL;BAC PRO PROD;BAC PRO 22106 CUISINE;1;1;1;0;0;0;0;1;0;0;0;1;0;0
1522.0;2021;27;CORSE;FEMININ;INDIVIDUEL;BAC PROFESSIONNEL;BAC PRO PROD;BAC PRO AG 21004 CGEA;7;5;4;1;0;0;0;4;0;0;0;0;4;1
1528.0;2021;27;CORSE;FEMININ;SCOLAIRE;BAC GENERAL;BAC GENERAL;BAC GENE 10019 BAC GENERAL;766;766;748;3;15;11;4;759;18;92;246;270;133;7
1529.0;2021;27;CORSE;FEMININ;SCOLAIRE;BAC PROFESSIONNEL;BAC PRO PROD;BAC PRO 22106 CUISINE;6;6;6;0;0;0;0;6;0;0;2;3;1;0
1530.0;2021;27;CORSE;FEMININ;SCOLAIRE;BAC PROFESSIONNEL;BAC PRO PROD;BAC PRO 23004 TECHN. ETUDES BAT.A ETUDES & ECO.;3;3;3;0;0;0;0;3;0;1;2;0;0;0
1546.0;2021;27;CORSE;FEMININ;SCOLAIRE;BAC PROFESSIONNEL;BAC PRO SERV;BAC PRO 33403 COMMERC. SERVICES EN RESTAURATION;11;11;10;1;0;0;0;10;0;0;2;6;2;1
1550.0;2021;27;CORSE;FEMININ;SCOLAIRE;BAC TECHNOLOGIQUE;BAC STAV;BAC STAV AGRONOMIE ALIM ENV TERRITOI;7;7;7;0;0;0;0;7;0;1;4;1;1;0
1554.0;2021;27;CORSE;FEMININ;SCOLAIRE;BAC TECHNOLOGIQUE;BAC STL;BAC STL BIOCHIM.-BIOLOGIE-BIOTECHNOL.;9;9;8;0;1;1;0;9;0;1;1;1;6;0
1556.0;2021;27;CORSE;FEMININ;SCOLAIRE;BAC TECHNOLOGIQUE;BAC STMG;BAC STMG MERCATIQUE (MARKETING);72;72;69;1;2;2;0;71;0;3;17;30;21;1
1557.0;2021;27;CORSE;FEMININ;SCOLAIRE;BAC TECHNOLOGIQUE;BAC STMG;BAC STMG RESSOURCES HUMAINES ET COMMUNICATION;69;69;61;0;8;5;3;66;0;0;19;31;16;3
1558.0;2021;27;CORSE;MASCULIN;APPRENTISSAGE;BAC PROFESSIONNEL;BAC PRO PROD;BAC PRO 22106 CUISINE;1;1;0;1;0;0;0;0;0;0;0;0;0;1
1570.0;2021;27;CORSE;MASCULIN;INDIVIDUEL;BAC PROFESSIONNEL;BAC PRO PROD;BAC PRO 22703 TECHN.INSTALL.SYST.ENERG.CLIMATI;1;1;1;0;0;0;0;1;0;0;0;0;1;0
1573.0;2021;27;CORSE;MASCULIN;INDIVIDUEL;BAC PROFESSIONNEL;BAC PRO PROD;BAC PRO AG 21113 CGEVV;5;4;3;1;0;0;0;3;0;0;0;0;3;1
1590.0;2021;27;CORSE;MASCULIN;SCOLAIRE;BAC PROFESSIONNEL;BAC PRO PROD;BAC PRO 25007 MAINTENANCE EQUIPEMENTS INDUST.;23;23;18;3;2;1;1;19;0;0;5;9;5;4
1591.0;2021;27;CORSE;MASCULIN;SCOLAIRE;BAC PROFESSIONNEL;BAC PRO PROD;BAC PRO 25009 MAINTENANCE NAUTIQUE;7;7;7;0;0;0;0;7;0;1;3;3;0;0
1595.0;2021;27;CORSE;MASCULIN;SCOLAIRE;BAC PROFESSIONNEL;BAC PRO PROD;BAC PRO 25510 METIERS ELECT. ENVIRON. CONNECTES;35;35;30;3;2;2;0;32;0;2;9;10;11;3
1608.0;2021;27;CORSE;MASCULIN;SCOLAIRE;BAC PROFESSIONNEL;BAC PRO SERV;BAC PRO 31210 ACCUEIL -RELATION CLIENTS USAGERS;6;6;4;2;0;0;0;4;0;0;1;0;3;2
1616.0;2021;27;CORSE;MASCULIN;SCOLAIRE;BAC TECHNOLOGIQUE;BAC STI2D;BAC STI2D ARCHITECTURE ET CONSTRUCTION;8;8;8;0;0;0;0;8;0;0;0;4;4;0
1618.0;2021;27;CORSE;MASCULIN;SCOLAIRE;BAC TECHNOLOGIQUE;BAC STI2D;BAC STI2D INNOVATION TECHNO.  ET ECO CONCEPTION;9;9;9;0;0;0;0;9;0;0;1;4;4;0
1625.0;2021;24;CRETEIL;FEMININ;APPRENTISSAGE;BAC PROFESSIONNEL;BAC PRO PROD;BAC PRO 22106 CUISINE;36;36;33;2;1;0;1;33;0;4;7;9;13;3
1627.0;2021;24;CRETEIL;FEMININ;APPRENTISSAGE;BAC PROFESSIONNEL;BAC PRO PROD;BAC PRO 25007 MAINTENANCE EQUIPEMENTS INDUST.;1;1;1;0;0;0;0;1;0;0;1;0;0;0
1633.0;2021;24;CRETEIL;FEMININ;APPRENTISSAGE;BAC PROFESSIONNEL;BAC PRO PROD;BAC PRO AG 21211 COND GEST ENTR HIPPIQUE;20;16;14;2;0;0;0;14;0;2;1;5;6;2
1636.0;2021;24;CRETEIL;FEMININ;APPRENTISSAGE;BAC PROFESSIONNEL;BAC PRO SERV;BAC PRO 31106 LOGISTIQUE;4;4;3;0;1;1;0;4;0;0;0;3;1;0
1642.0;2021;24;CRETEIL;FEMININ;APPRENTISSAGE;BAC PROFESSIONNEL;BAC PRO SERV;BAC PRO 33403 COMMERC. SERVICES EN RESTAURATION;25;24;18;2;4;2;2;20;0;2;7;0;11;4
1647.0;2021;24;CRETEIL;FEMININ;ENSEIGNEMENT A DISTANCE;BAC PROFESSIONNEL;BAC PRO SERV;BAC PRO 31202 COMMERCE;2;2;0;2;0;0;0;0;0;0;0;0;0;2
1658.0;2021;24;CRETEIL;FEMININ;FORMATION CONTINUE;BAC PROFESSIONNEL;BAC PRO PROD;BAC PRO AG 21114 CONDUITE PRODUCTIONS HORTICOLES;1;1;1;0;0;0;0;1;0;0;0;0;1;0
1662.0;2021;24;CRETEIL;FEMININ;FORMATION CONTINUE;BAC PROFESSIONNEL;BAC PRO SERV;BAC PRO 33603 ESTHETIQUE COSMETIQUE PARFUMERIE;10;7;3;4;0;0;0;3;0;0;0;0;3;4
1672.0;2021;24;CRETEIL;FEMININ;INDIVIDUEL;BAC PROFESSIONNEL;BAC PRO PROD;BAC PRO AG 21406 TEC CONS VTE PROD DES JARDINS;1;1;1;0;0;0;0;1;0;0;0;0;1;0
1676.0;2021;24;CRETEIL;FEMININ;INDIVIDUEL;BAC PROFESSIONNEL;BAC PRO SERV;BAC PRO 31210 ACCUEIL -RELATION CLIENTS USAGERS;9;5;5;0;0;0;0;5;0;0;1;2;2;0
1686.0;2021;24;CRETEIL;FEMININ;INDIVIDUEL;BAC TECHNOLOGIQUE;BAC STAV;BAC STAV AGRONOMIE ALIM ENV TERRITOI;1;0;0;0;0;0;0;0;0;0;0;0;0;0
1690.0;2021;24;CRETEIL;FEMININ;INDIVIDUEL;BAC TECHNOLOGIQUE;BAC STMG;BAC STMG MERCATIQUE (MARKETING);19;14;5;5;4;3;1;8;0;0;0;1;7;6
1693.0;2021;24;CRETEIL;FEMININ;SCOLAIRE;BAC GENERAL;BAC GENERAL;BAC GENE 10019 BAC GENERAL;14597;14590;13966;125;499;294;205;14260;218;1628;4026;5044;3344;330
1696.0;2021;24;CRETEIL;FEMININ;SCOLAIRE;BAC PROFESSIONNEL;BAC PRO PROD;BAC PRO 22106 CUISINE;40;40;35;4;1;0;1;35;0;1;3;18;13;5
1700.0;2021;24;CRETEIL;FEMININ;SCOLAIRE;BAC PROFESSIONNEL;BAC PRO PROD;BAC PRO 23203 TECHNICIEN BAT. : ORG.REAL.GROS O;2;2;1;1;0;0;0;1;0;0;0;0;1;1
1706.0;2021;24;CRETEIL;FEMININ;SCOLAIRE;BAC PROFESSIONNEL;BAC PRO PROD;BAC PRO 24302 METIERS DU CUIR : MAROQUINERIE;4;3;3;0;0;0;0;3;0;0;1;1;1;0
1707.0;2021;24;CRETEIL;FEMININ;SCOLAIRE;BAC PROFESSIONNEL;BAC PRO PROD;BAC PRO 25006 MICROTECHNIQUES;2;2;2;0;0;0;0;2;0;0;0;0;2;0
1710.0;2021;24;CRETEIL;FEMININ;SCOLAIRE;BAC PROFESSIONNEL;BAC PRO PROD;BAC PRO 25214 MAINT.VEHIC.OPTA VOIT.PARTICUL.;4;4;4;0;0;0;0;4;0;0;1;1;2;0
1711.0;2021;24;CRETEIL;FEMININ;SCOLAIRE;BAC PROFESSIONNEL;BAC PRO PROD;BAC PRO 25215 MAINT.VEHIC.OPTB VEHIC.TRANS.ROUT;1;1;1;0;0;0;0;1;0;0;0;0;1;0
1723.0;2021;24;CRETEIL;FEMININ;SCOLAIRE;BAC PROFESSIONNEL;BAC PRO PROD;BAC PRO AG 22105 LABORATOIRE CONTROLE QUALITE;16;13;10;3;0;0;0;10;0;0;0;2;8;3
1724.0;2021;24;CRETEIL;FEMININ;SCOLAIRE;BAC PROFESSIONNEL;BAC PRO PROD;BAC PRO AG 22107 TEC CONS VTE ALIMENTATION P.ALIM;5;4;4;0;0;0;0;4;0;0;3;0;1;0
1726.0;2021;24;CRETEIL;FEMININ;SCOLAIRE;BAC PROFESSIONNEL;BAC PRO SERV;BAC PRO 31106 LOGISTIQUE;11;11;6;3;2;2;0;8;0;0;1;3;4;3
1752.0;2021;24;CRETEIL;FEMININ;SCOLAIRE;BAC TECHNOLOGIQUE;BAC STI2D;BAC STI2D ENERGIES  ET ENVIRONNEMENT;18;18;16;1;1;0;1;16;0;0;4;6;6;2
1753.0;2021;24;CRETEIL;FEMININ;SCOLAIRE;BAC TECHNOLOGIQUE;BAC STI2D;BAC STI2D INNOVATION TECHNO.  ET ECO CONCEPTION;36;36;31;1;4;2;2;33;0;3;3;16;11;3
1756.0;2021;24;CRETEIL;FEMININ;SCOLAIRE;BAC TECHNOLOGIQUE;BAC STL;BAC STL SCIENCES PHYSIQUES CHIMIQUES  EN LABORAT.;80;80;63;2;15;7;8;70;1;4;12;24;29;10
1759.0;2021;24;CRETEIL;FEMININ;SCOLAIRE;BAC TECHNOLOGIQUE;BAC STMG;BAC STMG RESSOURCES HUMAINES ET COMMUNICATION;1079;1078;938;29;111;68;43;1006;0;8;118;403;477;72
1766.0;2021;24;CRETEIL;MASCULIN;APPRENTISSAGE;BAC PROFESSIONNEL;BAC PRO PROD;BAC PRO 23303 MENUISERIE ALUMINIUM-VERRE;5;5;4;1;0;0;0;4;0;0;1;2;1;1
1772.0;2021;24;CRETEIL;MASCULIN;APPRENTISSAGE;BAC PROFESSIONNEL;BAC PRO PROD;BAC PRO 25215 MAINT.VEHIC.OPTB VEHIC.TRANS.ROUT;36;35;22;10;3;1;2;23;0;2;3;3;15;12
1778.0;2021;24;CRETEIL;MASCULIN;APPRENTISSAGE;BAC PROFESSIONNEL;BAC PRO PROD;BAC PRO 25509 TECHNIC. FROID CONDITIONNEMT AIR;21;21;19;1;1;1;0;20;0;1;7;7;5;1
1791.0;2021;24;CRETEIL;MASCULIN;APPRENTISSAGE;BAC PROFESSIONNEL;BAC PRO SERV;BAC PRO 33403 COMMERC. SERVICES EN RESTAURATION;34;32;27;5;0;0;0;27;0;1;9;10;7;5
1795.0;2021;24;CRETEIL;MASCULIN;ENSEIGNEMENT A DISTANCE;BAC PROFESSIONNEL;BAC PRO SERV;BAC PRO 30001 GESTION-ADMINISTRATION;5;2;1;1;0;0;0;1;0;0;0;1;0;1
1800.0;2021;24;CRETEIL;MASCULIN;ENSEIGNEMENT A DISTANCE;BAC TECHNOLOGIQUE;BAC STMG;BAC STMG GESTION ET FINANCE;2;1;1;0;0;0;0;1;0;0;1;0;0;0
1808.0;2021;24;CRETEIL;MASCULIN;FORMATION CONTINUE;BAC PROFESSIONNEL;BAC PRO PROD;BAC PRO 25214 MAINT.VEHIC.OPTA VOIT.PARTICUL.;10;9;8;1;0;0;0;8;0;0;5;3;0;1
1809.0;2021;24;CRETEIL;MASCULIN;FORMATION CONTINUE;BAC PROFESSIONNEL;BAC PRO PROD;BAC PRO 25411 TECH.CHAUDRONNERIE INDUSTRIELLE;11;10;9;0;1;0;1;9;0;1;3;3;2;1
1815.0;2021;24;CRETEIL;MASCULIN;INDIVIDUEL;BAC PROFESSIONNEL;BAC PRO PROD;BACPRO 20002 ETUD.DEFINITION PRDTS INDUSTRIEL;1;0;0;0;0;0;0;0;0;0;0;0;0;0
1823.0;2021;24;CRETEIL;MASCULIN;INDIVIDUEL;BAC PROFESSIONNEL;BAC PRO PROD;BAC PRO 25215 MAINT.VEHIC.OPTB VEHIC.TRANS.ROUT;1;1;1;0;0;0;0;1;0;0;0;0;1;0
1828.0;2021;24;CRETEIL;MASCULIN;INDIVIDUEL;BAC PROFESSIONNEL;BAC PRO PROD;BAC PRO 25510 METIERS ELECT. ENVIRON. CONNECTES;8;6;4;2;0;0;0;4;0;0;0;1;3;2
1829.0;2021;24;CRETEIL;MASCULIN;INDIVIDUEL;BAC PROFESSIONNEL;BAC PRO PROD;BAC PRO 25513 SYST.NUM.OPT.A SURETE SECURITE;1;0;0;0;0;0;0;0;0;0;0;0;0;0
1831.0;2021;24;CRETEIL;MASCULIN;INDIVIDUEL;BAC PROFESSIONNEL;BAC PRO PROD;BAC PRO AG 21004 CGEA;3;3;3;0;0;0;0;3;0;0;0;0;3;0
1838.0;2021;24;CRETEIL;MASCULIN;INDIVIDUEL;BAC PROFESSIONNEL;BAC PRO SERV;BAC PRO 31202 COMMERCE;13;11;5;5;1;0;1;5;0;0;0;1;4;6
1839.0;2021;24;CRETEIL;MASCULIN;INDIVIDUEL;BAC PROFESSIONNEL;BAC PRO SERV;BAC PRO 31206 VENTE (PROSPECT.NEGO.SUIV.CLIENT;4;2;2;0;0;0;0;2;0;0;0;1;1;0
1842.0;2021;24;CRETEIL;MASCULIN;INDIVIDUEL;BAC PROFESSIONNEL;BAC PRO SERV;BAC PRO 32304 PHOTOGRAPHIE;1;0;0;0;0;0;0;0;0;0;0;0;0;0
1844.0;2021;24;CRETEIL;MASCULIN;INDIVIDUEL;BAC PROFESSIONNEL;BAC PRO SERV;BAC PRO 33101 OPTIQUE LUNETTERIE;1;0;0;0;0;0;0;0;0;0;0;0;0;0
1864.0;2021;24;CRETEIL;MASCULIN;SCOLAIRE;BAC PROFESSIONNEL;BAC PRO PROD;BAC PRO 22704 TECHN. MAINT. SYST.ENERG.CLIMATI;87;87;62;19;6;2;4;64;0;2;9;21;32;23
1870.0;2021;24;CRETEIL;MASCULIN;SCOLAIRE;BAC PROFESSIONNEL;BAC PRO PROD;BAC PRO 23203 TECHNICIEN BAT. : ORG.REAL.GROS O;41;41;24;9;8;7;1;31;0;2;5;2;22;10
1873.0;2021;24;CRETEIL;MASCULIN;SCOLAIRE;BAC PROFESSIONNEL;BAC PRO PROD;BAC PRO 23404 TECHNICIEN CONSTRUCTEUR BOIS;12;12;11;1;0;0;0;11;0;0;3;2;6;1
1877.0;2021;24;CRETEIL;MASCULIN;SCOLAIRE;BAC PROFESSIONNEL;BAC PRO PROD;BAC PRO 24203 METIERS DE LA MODE - VÊTEMENT;28;28;19;7;2;2;0;21;0;4;7;6;4;7
1880.0;2021;24;CRETEIL;MASCULIN;SCOLAIRE;BAC PROFESSIONNEL;BAC PRO PROD;BAC PRO 25007 MAINTENANCE EQUIPEMENTS INDUST.;287;286;182;65;39;16;23;198;0;4;30;57;107;88
1882.0;2021;24;CRETEIL;MASCULIN;SCOLAIRE;BAC PROFESSIONNEL;BAC PRO PROD;BAC PRO 25107 TECHNICIEN OUTILLEUR;5;5;4;1;0;0;0;4;0;0;2;2;0;1
1901.0;2021;24;CRETEIL;MASCULIN;SCOLAIRE;BAC PROFESSIONNEL;BAC PRO PROD;BAC PRO AG 21114 CONDUITE PRODUCTIONS HORTICOLES;7;7;7;0;0;0;0;7;0;0;1;1;5;0
1902.0;2021;24;CRETEIL;MASCULIN;SCOLAIRE;BAC PROFESSIONNEL;BAC PRO PROD;BAC PRO AG 21405 AMENAGEMENTS PAYSAGERS;36;36;35;1;0;0;0;35;0;1;8;11;15;1
1912.0;2021;24;CRETEIL;MASCULIN;SCOLAIRE;BAC PROFESSIONNEL;BAC PRO SERV;BAC PRO 31210 ACCUEIL -RELATION CLIENTS USAGERS;245;243;156;63;24;18;6;174;0;2;29;46;97;69
1922.0;2021;24;CRETEIL;MASCULIN;SCOLAIRE;BAC PROFESSIONNEL;BAC PRO SERV;BAC PRO 33403 COMMERC. SERVICES EN RESTAURATION;60;60;48;10;2;1;1;49;0;3;10;16;20;11
1923.0;2021;24;CRETEIL;MASCULIN;SCOLAIRE;BAC PROFESSIONNEL;BAC PRO SERV;BAC PRO 34303 GEST. POLLUTIONS PROTEC. ENVIRON.;8;8;6;2;0;0;0;6;0;0;0;3;3;2
1926.0;2021;24;CRETEIL;MASCULIN;SCOLAIRE;BAC PROFESSIONNEL;BAC PRO SERV;BAC PRO AG 33002 SERV PERS TERRIT;6;5;5;0;0;0;0;5;0;0;1;1;3;0
1934.0;2021;24;CRETEIL;MASCULIN;SCOLAIRE;BAC TECHNOLOGIQUE;BAC STI2D;BAC STI2D SYSTÈME D'INFORMATION  ET NUMERIQUE;770;767;698;18;51;35;16;733;0;15;111;281;326;34
1937.0;2021;24;CRETEIL;MASCULIN;SCOLAIRE;BAC TECHNOLOGIQUE;BAC STMG;BAC STMG GESTION ET FINANCE;1060;1059;911;49;99;63;36;974;2;12;110;379;471;85
1946.0;2021;07;DIJON;FEMININ;APPRENTISSAGE;BAC PROFESSIONNEL;BAC PRO PROD;BAC PRO 25007 MAINTENANCE EQUIPEMENTS INDUST.;1;1;1;0;0;0;0;1;0;1;0;0;0;0
1950.0;2021;07;DIJON;FEMININ;APPRENTISSAGE;BAC PROFESSIONNEL;BAC PRO PROD;BAC PRO 25408 REPARATION DES CARROSSERIES;1;1;1;0;0;0;0;1;0;0;0;1;0;0
1957.0;2021;07;DIJON;FEMININ;APPRENTISSAGE;BAC PROFESSIONNEL;BAC PRO PROD;BAC PRO AG 21405 AMENAGEMENTS PAYSAGERS;1;1;1;0;0;0;0;1;0;0;0;1;0;0
1960.0;2021;07;DIJON;FEMININ;APPRENTISSAGE;BAC PROFESSIONNEL;BAC PRO SERV;BAC PRO 30001 GESTION-ADMINISTRATION;9;9;8;0;1;0;1;8;0;0;4;4;0;1
1966.0;2021;07;DIJON;FEMININ;APPRENTISSAGE;BAC PROFESSIONNEL;BAC PRO SERV;BAC PRO AG 33002 SERV PERS TERRIT;1;1;1;0;0;0;0;1;0;0;0;0;1;0
1972.0;2021;07;DIJON;FEMININ;ENSEIGNEMENT A DISTANCE;BAC TECHNOLOGIQUE;BAC STMG;BAC STMG MERCATIQUE (MARKETING);3;3;2;0;1;0;1;2;0;0;1;0;1;1
1978.0;2021;07;DIJON;FEMININ;FORMATION CONTINUE;BAC PROFESSIONNEL;BAC PRO SERV;BAC PRO 31210 ACCUEIL -RELATION CLIENTS USAGERS;1;1;1;0;0;0;0;1;0;0;1;0;0;0
1983.0;2021;07;DIJON;FEMININ;INDIVIDUEL;BAC PROFESSIONNEL;BAC PRO PROD;BAC PRO AG 21211 COND GEST ENTR HIPPIQUE;5;5;4;1;0;0;0;4;0;0;0;0;4;1
1994.0;2021;07;DIJON;FEMININ;INDIVIDUEL;BAC TECHNOLOGIQUE;BAC STMG;BAC STMG MERCATIQUE (MARKETING);8;8;5;2;1;0;1;5;0;0;0;1;4;3
1999.0;2021;07;DIJON;FEMININ;SCOLAIRE;BAC PROFESSIONNEL;BAC PRO PROD;BAC PRO 22003 BIO-INDUSTRIES DE TRANSFORMATION;14;14;10;1;3;2;1;12;0;1;1;3;7;2
2001.0;2021;07;DIJON;FEMININ;SCOLAIRE;BAC PROFESSIONNEL;BAC PRO PROD;BAC PRO 22105 BOULANGER-PÂTISSIER;18;18;18;0;0;0;0;18;0;4;9;4;1;0
2005.0;2021;07;DIJON;FEMININ;SCOLAIRE;BAC PROFESSIONNEL;BAC PRO PROD;BAC PRO 23004 TECHN. ETUDES BAT.A ETUDES & ECO.;7;7;5;0;2;2;0;7;0;0;2;0;5;0
2011.0;2021;07;DIJON;FEMININ;SCOLAIRE;BAC PROFESSIONNEL;BAC PRO PROD;BAC PRO 24202 ARTIS.& MET.ART : TAPIS.D'AMEUBL;7;7;7;0;0;0;0;7;0;0;2;4;1;0
2012.0;2021;07;DIJON;FEMININ;SCOLAIRE;BAC PROFESSIONNEL;BAC PRO PROD;BAC PRO 24203 METIERS DE LA MODE - VÊTEMENT;69;69;59;9;1;1;0;60;0;1;14;22;23;9
2014.0;2021;07;DIJON;FEMININ;SCOLAIRE;BAC PROFESSIONNEL;BAC PRO PROD;BAC PRO 25007 MAINTENANCE EQUIPEMENTS INDUST.;8;8;6;2;0;0;0;6;0;0;2;1;3;2
2019.0;2021;07;DIJON;FEMININ;SCOLAIRE;BAC PROFESSIONNEL;BAC PRO PROD;BAC PRO 25303 AERONAUTIQUE OPTION SYSTEMES;1;1;0;0;1;0;1;0;0;0;0;0;0;1
2024.0;2021;07;DIJON;FEMININ;SCOLAIRE;BAC PROFESSIONNEL;BAC PRO PROD;BAC PRO 25510 METIERS ELECT. ENVIRON. CONNECTES;4;4;4;0;0;0;0;4;0;1;0;2;1;0
2028.0;2021;07;DIJON;FEMININ;SCOLAIRE;BAC PROFESSIONNEL;BAC PRO PROD;BAC PRO AG 21004 CGEA;29;29;26;3;0;0;0;26;0;1;6;4;15;3
2039.0;2021;07;DIJON;FEMININ;SCOLAIRE;BAC PROFESSIONNEL;BAC PRO SERV;BAC PRO 30001 GESTION-ADMINISTRATION;271;271;221;24;26;11;15;232;0;7;40;79;106;39
2043.0;2021;07;DIJON;FEMININ;SCOLAIRE;BAC PROFESSIONNEL;BAC PRO SERV;BAC PRO 31202 COMMERCE;243;241;212;15;14;3;11;215;0;18;55;82;60;26
2044.0;2021;07;DIJON;FEMININ;SCOLAIRE;BAC PROFESSIONNEL;BAC PRO SERV;BAC PRO 31206 VENTE (PROSPECT.NEGO.SUIV.CLIENT;58;58;53;2;3;3;0;56;0;3;13;20;20;2
2051.0;2021;07;DIJON;FEMININ;SCOLAIRE;BAC PROFESSIONNEL;BAC PRO SERV;BAC PRO 33101 OPTIQUE LUNETTERIE;6;6;5;1;0;0;0;5;0;0;2;2;1;1
2057.0;2021;07;DIJON;FEMININ;SCOLAIRE;BAC PROFESSIONNEL;BAC PRO SERV;BAC PRO 34403 METIERS DE LA SECURITE;21;21;21;0;0;0;0;21;0;2;5;10;4;0
2061.0;2021;07;DIJON;FEMININ;SCOLAIRE;BAC TECHNOLOGIQUE;BAC ST2S;BAC ST2S SCIENCES & TECHNO. SANTE & SOCIAL;388;388;357;2;29;14;15;371;0;12;60;143;156;17
2064.0;2021;07;DIJON;FEMININ;SCOLAIRE;BAC TECHNOLOGIQUE;BAC STHR;BAC STHR SC.&TEC. HOTELLERIE-RESTAURATION;25;25;25;0;0;0;0;25;1;1;4;7;12;0
2066.0;2021;07;DIJON;FEMININ;SCOLAIRE;BAC TECHNOLOGIQUE;BAC STI2D;BAC STI2D ENERGIES  ET ENVIRONNEMENT;6;6;5;0;1;0;1;5;0;0;1;2;2;1
2083.0;2021;07;DIJON;MASCULIN;APPRENTISSAGE;BAC PROFESSIONNEL;BAC PRO PROD;BAC PRO 23304 AMENAGEMENT FINITION BATIMENT;7;7;3;3;1;1;0;4;0;0;1;2;1;3
2085.0;2021;07;DIJON;MASCULIN;APPRENTISSAGE;BAC PROFESSIONNEL;BAC PRO PROD;BAC PRO 25009 MAINTENANCE NAUTIQUE;2;2;1;1;0;0;0;1;0;0;0;1;0;1
2088.0;2021;07;DIJON;MASCULIN;APPRENTISSAGE;BAC PROFESSIONNEL;BAC PRO PROD;BAC PRO 25108 TECHNICIEN MODELEUR;1;1;1;0;0;0;0;1;0;0;0;1;0;0
2091.0;2021;07;DIJON;MASCULIN;APPRENTISSAGE;BAC PROFESSIONNEL;BAC PRO PROD;BAC PRO 25216 MAINT.VEHIC.OPTC MOTOCYCLES;5;5;3;1;1;0;1;3;0;0;0;3;0;2
2098.0;2021;07;DIJON;MASCULIN;APPRENTISSAGE;BAC PROFESSIONNEL;BAC PRO PROD;BAC PRO AG 21001 AGRO-EQUIPEMENT;12;12;11;1;0;0;0;11;0;0;0;5;6;1
2101.0;2021;07;DIJON;MASCULIN;APPRENTISSAGE;BAC PROFESSIONNEL;BAC PRO PROD;BAC PRO AG 21114 CONDUITE PRODUCTIONS HORTICOLES;3;3;2;1;0;0;0;2;0;0;2;0;0;1
2106.0;2021;07;DIJON;MASCULIN;APPRENTISSAGE;BAC PROFESSIONNEL;BAC PRO SERV;BAC PRO 30001 GESTION-ADMINISTRATION;2;2;1;1;0;0;0;1;0;0;1;0;0;1
2111.0;2021;07;DIJON;MASCULIN;APPRENTISSAGE;BAC PROFESSIONNEL;BAC PRO SERV;BAC PRO 32208 REAL.PR.IMPR.PLURI.OPTB.PR.IMPR.;3;3;3;0;0;0;0;3;0;0;3;0;0;0
2117.0;2021;07;DIJON;MASCULIN;FORMATION CONTINUE;BAC PROFESSIONNEL;BAC PRO PROD;BAC PRO 23404 TECHNICIEN CONSTRUCTEUR BOIS;1;1;1;0;0;0;0;1;0;1;0;0;0;0
2121.0;2021;07;DIJON;MASCULIN;FORMATION CONTINUE;BAC PROFESSIONNEL;BAC PRO PROD;BAC PRO 25411 TECH.CHAUDRONNERIE INDUSTRIELLE;1;1;1;0;0;0;0;1;0;0;1;0;0;0
2125.0;2021;07;DIJON;MASCULIN;INDIVIDUEL;BAC GENERAL;BAC GENERAL;BAC GENE 10019 BAC GENERAL;46;37;18;11;8;4;4;22;1;1;1;8;11;15
2130.0;2021;07;DIJON;MASCULIN;INDIVIDUEL;BAC PROFESSIONNEL;BAC PRO PROD;BAC PRO AG 21004 CGEA;4;2;1;1;0;0;0;1;0;0;0;0;1;1
2136.0;2021;07;DIJON;MASCULIN;INDIVIDUEL;BAC PROFESSIONNEL;BAC PRO SERV;BAC PRO 33002 SERVICES DE PROXIMITE  VIE LOCAL;1;1;0;1;0;0;0;0;0;0;0;0;0;1
2150.0;2021;07;DIJON;MASCULIN;SCOLAIRE;BAC PROFESSIONNEL;BAC PRO PROD;BAC PRO 22105 BOULANGER-PÂTISSIER;31;31;29;2;0;0;0;29;0;3;6;14;6;2
2151.0;2021;07;DIJON;MASCULIN;SCOLAIRE;BAC PROFESSIONNEL;BAC PRO PROD;BAC PRO 22106 CUISINE;98;98;87;6;5;3;2;90;0;6;23;37;24;8
2155.0;2021;07;DIJON;MASCULIN;SCOLAIRE;BAC PROFESSIONNEL;BAC PRO PROD;BAC PRO 23004 TECHN. ETUDES BAT.A ETUDES & ECO.;12;12;7;5;0;0;0;7;0;0;0;2;5;5
2178.0;2021;07;DIJON;MASCULIN;SCOLAIRE;BAC PROFESSIONNEL;BAC PRO PROD;BAC PRO 25221 MAINT.MATERIELS OPT.C ESP. VERTS;8;8;7;1;0;0;0;7;0;0;0;2;5;1
2179.0;2021;07;DIJON;MASCULIN;SCOLAIRE;BAC PROFESSIONNEL;BAC PRO PROD;BAC PRO 25303 AERONAUTIQUE OPTION SYSTEMES;11;11;11;0;0;0;0;11;0;1;1;5;4;0
2182.0;2021;07;DIJON;MASCULIN;SCOLAIRE;BAC PROFESSIONNEL;BAC PRO PROD;BAC PRO 25408 REPARATION DES CARROSSERIES;16;16;11;3;2;0;2;11;0;0;1;1;9;5
2185.0;2021;07;DIJON;MASCULIN;SCOLAIRE;BAC PROFESSIONNEL;BAC PRO PROD;BAC PRO 25510 METIERS ELECT. ENVIRON. CONNECTES;216;216;167;41;8;2;6;169;0;7;33;59;70;47
2192.0;2021;07;DIJON;MASCULIN;SCOLAIRE;BAC PROFESSIONNEL;BAC PRO PROD;BAC PRO AG 21203 TECHN CONSEIL DE VENTE ANIMAL;6;6;5;1;0;0;0;5;0;0;1;1;3;1
2198.0;2021;07;DIJON;MASCULIN;SCOLAIRE;BAC PROFESSIONNEL;BAC PRO PROD;BAC PRO AG 21405 AMENAGEMENTS PAYSAGERS;63;63;62;1;0;0;0;62;0;1;13;25;23;1
2200.0;2021;07;DIJON;MASCULIN;SCOLAIRE;BAC PROFESSIONNEL;BAC PRO PROD;BAC PRO AG 22107 TEC CONS VTE ALIMENTATION P.ALIM;34;33;30;3;0;0;0;30;0;0;5;10;15;3
2206.0;2021;07;DIJON;MASCULIN;SCOLAIRE;BAC PROFESSIONNEL;BAC PRO SERV;BAC PRO 31206 VENTE (PROSPECT.NEGO.SUIV.CLIENT;71;70;52;10;8;6;2;58;0;3;8;23;24;12
2215.0;2021;07;DIJON;MASCULIN;SCOLAIRE;BAC PROFESSIONNEL;BAC PRO SERV;BAC PRO 33103 TECHNICIEN APPAREIL. ORTHOPEDIQUE;5;5;5;0;0;0;0;5;0;0;1;3;1;0
2216.0;2021;07;DIJON;MASCULIN;SCOLAIRE;BAC PROFESSIONNEL;BAC PRO SERV;BAC PRO 33403 COMMERC. SERVICES EN RESTAURATION;50;50;44;2;4;4;0;48;0;1;10;20;17;2
2222.0;2021;07;DIJON;MASCULIN;SCOLAIRE;BAC TECHNOLOGIQUE;BAC ST2S;BAC ST2S SCIENCES & TECHNO. SANTE & SOCIAL;60;60;49;4;7;7;0;56;0;1;7;21;27;4
2226.0;2021;07;DIJON;MASCULIN;SCOLAIRE;BAC TECHNOLOGIQUE;BAC STI2D;BAC STI2D ARCHITECTURE ET CONSTRUCTION;60;60;57;1;2;0;2;57;0;2;5;31;19;3
2230.0;2021;07;DIJON;MASCULIN;SCOLAIRE;BAC TECHNOLOGIQUE;BAC STL;BAC STL BIOCHIM.-BIOLOGIE-BIOTECHNOL.;38;38;27;2;9;6;3;33;0;1;3;12;17;5
2234.0;2021;07;DIJON;MASCULIN;SCOLAIRE;BAC TECHNOLOGIQUE;BAC STMG;BAC STMG RESSOURCES HUMAINES ET COMMUNICATION;141;141;107;6;28;21;7;128;0;0;4;32;92;13
2246.0;2021;08;GRENOBLE;FEMININ;APPRENTISSAGE;BAC PROFESSIONNEL;BAC PRO PROD;BAC PRO 25009 MAINTENANCE NAUTIQUE;1;1;1;0;0;0;0;1;0;0;1;0;0;0
2247.0;2021;08;GRENOBLE;FEMININ;APPRENTISSAGE;BAC PROFESSIONNEL;BAC PRO PROD;BAC PRO 25106 TECHNICIEN D'USINAGE;3;3;3;0;0;0;0;3;0;1;0;1;1;0
2251.0;2021;08;GRENOBLE;FEMININ;APPRENTISSAGE;BAC PROFESSIONNEL;BAC PRO PROD;BAC PRO 25411 TECH.CHAUDRONNERIE INDUSTRIELLE;2;2;1;1;0;0;0;1;0;0;0;1;0;1
2252.0;2021;08;GRENOBLE;FEMININ;APPRENTISSAGE;BAC PROFESSIONNEL;BAC PRO PROD;BAC PRO 25509 TECHNIC. FROID CONDITIONNEMT AIR;1;1;1;0;0;0;0;1;0;0;0;0;1;0
2256.0;2021;08;GRENOBLE;FEMININ;APPRENTISSAGE;BAC PROFESSIONNEL;BAC PRO PROD;BAC PRO AG 21405 AMENAGEMENTS PAYSAGERS;3;3;3;0;0;0;0;3;0;0;2;0;1;0
2261.0;2021;08;GRENOBLE;FEMININ;APPRENTISSAGE;BAC PROFESSIONNEL;BAC PRO SERV;BAC PRO 31210 ACCUEIL -RELATION CLIENTS USAGERS;26;25;25;0;0;0;0;25;0;3;8;9;5;0
2262.0;2021;08;GRENOBLE;FEMININ;APPRENTISSAGE;BAC PROFESSIONNEL;BAC PRO SERV;BAC PRO 33403 COMMERC. SERVICES EN RESTAURATION;2;2;2;0;0;0;0;2;0;0;0;1;1;0
2263.0;2021;08;GRENOBLE;FEMININ;APPRENTISSAGE;BAC PROFESSIONNEL;BAC PRO SERV;BAC PRO AG 33002 SERV PERS TERRIT;7;7;7;0;0;0;0;7;0;0;1;4;2;0
2267.0;2021;08;GRENOBLE;FEMININ;ENSEIGNEMENT A DISTANCE;BAC PROFESSIONNEL;BAC PRO SERV;BAC PRO 31210 ACCUEIL -RELATION CLIENTS USAGERS;1;1;1;0;0;0;0;1;0;0;0;1;0;0
2274.0;2021;08;GRENOBLE;FEMININ;FORMATION CONTINUE;BAC PROFESSIONNEL;BAC PRO PROD;BAC PRO AG 22105 LABORATOIRE CONTROLE QUALITE;6;5;5;0;0;0;0;5;0;1;0;1;3;0
2281.0;2021;08;GRENOBLE;FEMININ;INDIVIDUEL;BAC PROFESSIONNEL;BAC PRO PROD;BAC PRO AG 21004 CGEA;4;4;4;0;0;0;0;4;0;0;0;0;4;0
2285.0;2021;08;GRENOBLE;FEMININ;INDIVIDUEL;BAC PROFESSIONNEL;BAC PRO PROD;BAC PRO AG 21211 COND GEST ENTR HIPPIQUE;11;10;8;2;0;0;0;8;0;0;0;0;8;2
2287.0;2021;08;GRENOBLE;FEMININ;INDIVIDUEL;BAC PROFESSIONNEL;BAC PRO SERV;BAC PRO 30001 GESTION-ADMINISTRATION;13;5;1;3;1;1;0;2;0;0;0;0;2;3
2295.0;2021;08;GRENOBLE;FEMININ;INDIVIDUEL;BAC TECHNOLOGIQUE;BAC STAV;BAC STAV AGRONOMIE ALIM ENV TERRITOI;1;1;1;0;0;0;0;1;0;0;0;0;1;0
2296.0;2021;08;GRENOBLE;FEMININ;INDIVIDUEL;BAC TECHNOLOGIQUE;BAC STD2A;BAC STD2A SCIENCES & TECHNO. DESIGN-ARTS APPLIQUES;1;1;0;0;1;0;1;0;0;0;0;0;0;1
2299.0;2021;08;GRENOBLE;FEMININ;INDIVIDUEL;BAC TECHNOLOGIQUE;BAC STMG;BAC STMG MERCATIQUE (MARKETING);7;2;0;1;1;0;1;0;0;0;0;0;0;2
2305.0;2021;08;GRENOBLE;FEMININ;SCOLAIRE;BAC PROFESSIONNEL;BAC PRO PROD;BAC PRO 22004 PROC. CHIMIE EAU PAPIERS-CARTONS;10;10;4;4;2;2;0;6;0;0;0;3;3;4
2316.0;2021;08;GRENOBLE;FEMININ;SCOLAIRE;BAC PROFESSIONNEL;BAC PRO PROD;BAC PRO 23407 TECHNIC.FAB.BOIS ET MATERX ASSOC;1;1;1;0;0;0;0;1;0;0;1;0;0;0
2317.0;2021;08;GRENOBLE;FEMININ;SCOLAIRE;BAC PROFESSIONNEL;BAC PRO PROD;BAC PRO 24202 ARTIS.& MET.ART : TAPIS.D'AMEUBL;8;8;7;0;1;1;0;8;0;0;1;3;4;0
2321.0;2021;08;GRENOBLE;FEMININ;SCOLAIRE;BAC PROFESSIONNEL;BAC PRO PROD;BAC PRO 25006 MICROTECHNIQUES;4;4;3;1;0;0;0;3;0;0;2;1;0;1
2332.0;2021;08;GRENOBLE;FEMININ;SCOLAIRE;BAC PROFESSIONNEL;BAC PRO PROD;BAC PRO 25515 SYST.NUM.OPT.C RES.INF.SYST.COMM.;8;8;7;1;0;0;0;7;0;0;1;4;2;1
2335.0;2021;08;GRENOBLE;FEMININ;SCOLAIRE;BAC PROFESSIONNEL;BAC PRO PROD;BAC PRO AG 21114 CONDUITE PRODUCTIONS HORTICOLES;17;17;15;2;0;0;0;15;0;1;1;7;6;2
2336.0;2021;08;GRENOBLE;FEMININ;SCOLAIRE;BAC PROFESSIONNEL;BAC PRO PROD;BAC PRO AG 21203 TECHN CONSEIL DE VENTE ANIMAL;37;36;34;2;0;0;0;34;0;4;3;12;15;2
2340.0;2021;08;GRENOBLE;FEMININ;SCOLAIRE;BAC PROFESSIONNEL;BAC PRO PROD;BAC PRO AG 21303 FORET;4;4;4;0;0;0;0;4;0;0;0;1;3;0
2344.0;2021;08;GRENOBLE;FEMININ;SCOLAIRE;BAC PROFESSIONNEL;BAC PRO PROD;BAC PRO AG 22107 TEC CONS VTE ALIMENTATION P.ALIM;37;37;35;2;0;0;0;35;0;0;4;19;12;2
2362.0;2021;08;GRENOBLE;FEMININ;SCOLAIRE;BAC PROFESSIONNEL;BAC PRO SERV;BAC PRO AG 33002 SERV PERS TERRIT;489;477;465;12;0;0;0;465;0;17;80;200;168;12
2365.0;2021;08;GRENOBLE;FEMININ;SCOLAIRE;BAC TECHNOLOGIQUE;BAC ST2S;BAC ST2S SCIENCES & TECHNO. SANTE & SOCIAL;798;797;744;7;46;22;24;766;1;30;147;321;267;31
2367.0;2021;08;GRENOBLE;FEMININ;SCOLAIRE;BAC TECHNOLOGIQUE;BAC STD2A;BAC STD2A SCIENCES & TECHNO. DESIGN-ARTS APPLIQUES;118;118;116;1;1;1;0;117;0;15;49;44;9;1
2372.0;2021;08;GRENOBLE;FEMININ;SCOLAIRE;BAC TECHNOLOGIQUE;BAC STI2D;BAC STI2D SYSTÈME D'INFORMATION  ET NUMERIQUE;16;16;16;0;0;0;0;16;0;0;4;11;1;0
2380.0;2021;08;GRENOBLE;MASCULIN;APPRENTISSAGE;BAC PROFESSIONNEL;BAC PRO PROD;BAC PRO 20102 PILOTE DE LIGNE DE PRODUCTION;7;7;6;1;0;0;0;6;0;1;3;2;0;1
2383.0;2021;08;GRENOBLE;MASCULIN;APPRENTISSAGE;BAC PROFESSIONNEL;BAC PRO PROD;BAC PRO 22106 CUISINE;8;8;7;1;0;0;0;7;0;0;0;4;3;1
2390.0;2021;08;GRENOBLE;MASCULIN;APPRENTISSAGE;BAC PROFESSIONNEL;BAC PRO PROD;BAC PRO 23203 TECHNICIEN BAT. : ORG.REAL.GROS O;12;12;10;0;2;1;1;11;0;0;4;1;6;1
2404.0;2021;08;GRENOBLE;MASCULIN;APPRENTISSAGE;BAC PROFESSIONNEL;BAC PRO PROD;BAC PRO 25219 MAINT.MATERIELS OPT.A AGRICOLES;19;19;18;1;0;0;0;18;0;0;3;6;9;1
2407.0;2021;08;GRENOBLE;MASCULIN;APPRENTISSAGE;BAC PROFESSIONNEL;BAC PRO PROD;BAC PRO 25302 AERONAUTIQUE OPTION AVIONIQUE;2;2;2;0;0;0;0;2;0;0;0;2;0;0
2410.0;2021;08;GRENOBLE;MASCULIN;APPRENTISSAGE;BAC PROFESSIONNEL;BAC PRO PROD;BAC PRO 25408 REPARATION DES CARROSSERIES;15;15;13;2;0;0;0;13;0;1;2;8;2;2
2413.0;2021;08;GRENOBLE;MASCULIN;APPRENTISSAGE;BAC PROFESSIONNEL;BAC PRO PROD;BAC PRO 25510 METIERS ELECT. ENVIRON. CONNECTES;132;131;117;11;3;1;2;118;0;7;27;47;37;13
2414.0;2021;08;GRENOBLE;MASCULIN;APPRENTISSAGE;BAC PROFESSIONNEL;BAC PRO PROD;BAC PRO 25515 SYST.NUM.OPT.C RES.INF.SYST.COMM.;3;3;2;0;1;1;0;3;0;0;0;0;3;0
2417.0;2021;08;GRENOBLE;MASCULIN;APPRENTISSAGE;BAC PROFESSIONNEL;BAC PRO PROD;BAC PRO AG 21405 AMENAGEMENTS PAYSAGERS;71;71;70;1;0;0;0;70;0;3;11;36;20;1
2420.0;2021;08;GRENOBLE;MASCULIN;APPRENTISSAGE;BAC PROFESSIONNEL;BAC PRO SERV;BAC PRO 31106 LOGISTIQUE;29;29;22;5;2;1;1;23;0;3;4;5;11;6
2423.0;2021;08;GRENOBLE;MASCULIN;APPRENTISSAGE;BAC PROFESSIONNEL;BAC PRO SERV;BAC PRO 31202 COMMERCE;120;116;94;13;9;7;2;101;0;2;26;34;39;15
2429.0;2021;08;GRENOBLE;MASCULIN;ENSEIGNEMENT A DISTANCE;BAC PROFESSIONNEL;BAC PRO SERV;BAC PRO 30001 GESTION-ADMINISTRATION;2;1;1;0;0;0;0;1;0;0;0;0;1;0
2432.0;2021;08;GRENOBLE;MASCULIN;ENSEIGNEMENT A DISTANCE;BAC TECHNOLOGIQUE;BAC ST2S;BAC ST2S SCIENCES & TECHNO. SANTE & SOCIAL;1;1;1;0;0;0;0;1;0;0;0;0;1;0
2433.0;2021;08;GRENOBLE;MASCULIN;ENSEIGNEMENT A DISTANCE;BAC TECHNOLOGIQUE;BAC STMG;BAC STMG GESTION ET FINANCE;2;2;0;2;0;0;0;0;0;0;0;0;0;2
2434.0;2021;08;GRENOBLE;MASCULIN;ENSEIGNEMENT A DISTANCE;BAC TECHNOLOGIQUE;BAC STMG;BAC STMG MERCATIQUE (MARKETING);9;6;5;1;0;0;0;5;0;0;2;1;2;1
2435.0;2021;08;GRENOBLE;MASCULIN;ENSEIGNEMENT A DISTANCE;BAC TECHNOLOGIQUE;BAC STMG;BAC STMG RESSOURCES HUMAINES ET COMMUNICATION;1;0;0;0;0;0;0;0;0;0;0;0;0;0
2438.0;2021;08;GRENOBLE;MASCULIN;FORMATION CONTINUE;BAC PROFESSIONNEL;BAC PRO PROD;BAC PRO 22704 TECHN. MAINT. SYST.ENERG.CLIMATI;3;3;3;0;0;0;0;3;0;0;1;1;1;0
2439.0;2021;08;GRENOBLE;MASCULIN;FORMATION CONTINUE;BAC PROFESSIONNEL;BAC PRO PROD;BAC PRO 23405 TECHNICIEN MENUISIER AGENCEUR;1;1;1;0;0;0;0;1;0;1;0;0;0;0
2452.0;2021;08;GRENOBLE;MASCULIN;INDIVIDUEL;BAC PROFESSIONNEL;BAC PRO PROD;BAC PRO 25408 REPARATION DES CARROSSERIES;1;0;0;0;0;0;0;0;0;0;0;0;0;0
2455.0;2021;08;GRENOBLE;MASCULIN;INDIVIDUEL;BAC PROFESSIONNEL;BAC PRO PROD;BAC PRO 25513 SYST.NUM.OPT.A SURETE SECURITE;1;1;0;1;0;0;0;0;0;0;0;0;0;1
2472.0;2021;08;GRENOBLE;MASCULIN;INDIVIDUEL;BAC TECHNOLOGIQUE;BAC STAV;BAC STAV AGRONOMIE ALIM ENV TERRITOI;1;1;1;0;0;0;0;1;0;0;0;0;1;0
2477.0;2021;08;GRENOBLE;MASCULIN;INDIVIDUEL;BAC TECHNOLOGIQUE;BAC STL;BAC STL BIOCHIM.-BIOLOGIE-BIOTECHNOL.;1;1;0;0;1;0;1;0;0;0;0;0;0;1
2491.0;2021;08;GRENOBLE;MASCULIN;SCOLAIRE;BAC PROFESSIONNEL;BAC PRO PROD;BAC PRO 22704 TECHN. MAINT. SYST.ENERG.CLIMATI;31;31;26;5;0;0;0;26;0;1;8;12;5;5
2494.0;2021;08;GRENOBLE;MASCULIN;SCOLAIRE;BAC PROFESSIONNEL;BAC PRO PROD;BAC PRO 23005 TECHN. ETUDES BAT B ASSIST.ARCHI.;27;27;25;2;0;0;0;25;0;1;8;9;7;2
2504.0;2021;08;GRENOBLE;MASCULIN;SCOLAIRE;BAC PROFESSIONNEL;BAC PRO PROD;BAC PRO 24202 ARTIS.& MET.ART : TAPIS.D'AMEUBL;1;1;0;1;0;0;0;0;0;0;0;0;0;1
2506.0;2021;08;GRENOBLE;MASCULIN;SCOLAIRE;BAC PROFESSIONNEL;BAC PRO PROD;BAC PRO 24301 METIERS DU CUIR : CHAUSSURES;3;3;3;0;0;0;0;3;0;0;0;2;1;0
2513.0;2021;08;GRENOBLE;MASCULIN;SCOLAIRE;BAC PROFESSIONNEL;BAC PRO PROD;BAC PRO 25214 MAINT.VEHIC.OPTA VOIT.PARTICUL.;141;141;120;17;4;2;2;122;0;10;25;43;44;19
2516.0;2021;08;GRENOBLE;MASCULIN;SCOLAIRE;BAC PROFESSIONNEL;BAC PRO PROD;BAC PRO 25220 MAINT.MATERIELS OPT.B TP MANUT.;13;13;11;2;0;0;0;11;0;1;3;5;2;2
2519.0;2021;08;GRENOBLE;MASCULIN;SCOLAIRE;BAC PROFESSIONNEL;BAC PRO PROD;BAC PRO 25408 REPARATION DES CARROSSERIES;52;52;45;6;1;1;0;46;0;1;3;18;24;6
2524.0;2021;08;GRENOBLE;MASCULIN;SCOLAIRE;BAC PROFESSIONNEL;BAC PRO PROD;BAC PRO 25514 SYST.NUM.OPT.B AUD.RES.EQUIP.DOM.;81;81;74;3;4;4;0;78;0;0;11;34;33;3
2525.0;2021;08;GRENOBLE;MASCULIN;SCOLAIRE;BAC PROFESSIONNEL;BAC PRO PROD;BAC PRO 25515 SYST.NUM.OPT.C RES.INF.SYST.COMM.;157;157;132;18;7;7;0;139;0;12;33;50;44;18
2533.0;2021;08;GRENOBLE;MASCULIN;SCOLAIRE;BAC PROFESSIONNEL;BAC PRO PROD;BAC PRO AG 21302 GEST MILIEUX NATURELS FAUNE;78;75;69;6;0;0;0;69;0;3;8;32;26;6
2538.0;2021;08;GRENOBLE;MASCULIN;SCOLAIRE;BAC PROFESSIONNEL;BAC PRO PROD;BAC PRO AG 22107 TEC CONS VTE ALIMENTATION P.ALIM;51;51;48;3;0;0;0;48;0;0;6;22;20;3
2539.0;2021;08;GRENOBLE;MASCULIN;SCOLAIRE;BAC PROFESSIONNEL;BAC PRO SERV;BAC PRO 30001 GESTION-ADMINISTRATION;288;287;217;54;16;13;3;230;0;6;29;94;101;57
2542.0;2021;08;GRENOBLE;MASCULIN;SCOLAIRE;BAC PROFESSIONNEL;BAC PRO SERV;BAC PRO 31108 TRANSPORT;25;25;16;9;0;0;0;16;0;0;3;6;7;9
2550.0;2021;08;GRENOBLE;MASCULIN;SCOLAIRE;BAC PROFESSIONNEL;BAC PRO SERV;BAC PRO 33002 SERVICES DE PROXIMITE  VIE LOCAL;13;13;9;4;0;0;0;9;0;0;4;2;3;4
2552.0;2021;08;GRENOBLE;MASCULIN;SCOLAIRE;BAC PROFESSIONNEL;BAC PRO SERV;BAC PRO 33004 ACC.SOINS-S.PERS. OPT.EN STRUCTUR;38;38;36;1;1;0;1;36;0;0;9;16;11;2
2557.0;2021;08;GRENOBLE;MASCULIN;SCOLAIRE;BAC PROFESSIONNEL;BAC PRO SERV;BAC PRO 34403 METIERS DE LA SECURITE;32;32;29;1;2;1;1;30;0;2;16;9;3;2
2559.0;2021;08;GRENOBLE;MASCULIN;SCOLAIRE;BAC TECHNOLOGIQUE;BAC S2TMD;BAC S2TMD MUSIQUE;10;10;10;0;0;0;0;10;0;0;4;5;1;0
2561.0;2021;08;GRENOBLE;MASCULIN;SCOLAIRE;BAC TECHNOLOGIQUE;BAC STAV;BAC STAV AGRONOMIE ALIM ENV TERRITOI;161;161;158;3;0;0;0;158;0;2;25;66;65;3
2562.0;2021;08;GRENOBLE;MASCULIN;SCOLAIRE;BAC TECHNOLOGIQUE;BAC STD2A;BAC STD2A SCIENCES & TECHNO. DESIGN-ARTS APPLIQUES;28;28;26;1;1;0;1;26;0;4;5;13;4;2
2566.0;2021;08;GRENOBLE;MASCULIN;SCOLAIRE;BAC TECHNOLOGIQUE;BAC STI2D;BAC STI2D INNOVATION TECHNO.  ET ECO CONCEPTION;593;593;542;12;39;21;18;563;0;22;112;228;201;30
2569.0;2021;08;GRENOBLE;MASCULIN;SCOLAIRE;BAC TECHNOLOGIQUE;BAC STL;BAC STL SCIENCES PHYSIQUES CHIMIQUES  EN LABORAT.;60;60;53;2;5;3;2;56;0;3;12;18;23;4
2570.0;2021;08;GRENOBLE;MASCULIN;SCOLAIRE;BAC TECHNOLOGIQUE;BAC STMG;BAC STMG GESTION ET FINANCE;501;501;433;15;53;35;18;468;0;6;67;182;213;33
2573.0;2021;08;GRENOBLE;MASCULIN;SCOLAIRE;BAC TECHNOLOGIQUE;BAC STMG;BAC STMG SYSTEMES D'INFORMATION DE GESTION;78;78;65;0;13;7;6;72;0;0;8;25;39;6
2575.0;2021;32;GUADELOUPE;FEMININ;APPRENTISSAGE;BAC PROFESSIONNEL;BAC PRO PROD;BAC PRO AG 21405 AMENAGEMENTS PAYSAGERS;1;0;0;0;0;0;0;0;0;0;0;0;0;0
2587.0;2021;32;GUADELOUPE;FEMININ;INDIVIDUEL;BAC PROFESSIONNEL;BAC PRO PROD;BAC PRO AG 21004 CGEA;1;0;0;0;0;0;0;0;0;0;0;0;0;0
2595.0;2021;32;GUADELOUPE;FEMININ;INDIVIDUEL;BAC TECHNOLOGIQUE;BAC STD2A;BAC STD2A SCIENCES & TECHNO. DESIGN-ARTS APPLIQUES;1;1;1;0;0;0;0;1;0;0;0;1;0;0
2606.0;2021;32;GUADELOUPE;FEMININ;SCOLAIRE;BAC PROFESSIONNEL;BAC PRO PROD;BAC PRO 23303 MENUISERIE ALUMINIUM-VERRE;1;1;1;0;0;0;0;1;0;0;0;0;1;0
2616.0;2021;32;GUADELOUPE;FEMININ;SCOLAIRE;BAC PROFESSIONNEL;BAC PRO PROD;BAC PRO 25510 METIERS ELECT. ENVIRON. CONNECTES;3;3;3;0;0;0;0;3;0;0;0;1;2;0
2617.0;2021;32;GUADELOUPE;FEMININ;SCOLAIRE;BAC PROFESSIONNEL;BAC PRO PROD;BAC PRO 25514 SYST.NUM.OPT.B AUD.RES.EQUIP.DOM.;3;3;3;0;0;0;0;3;0;0;0;2;1;0
2618.0;2021;32;GUADELOUPE;FEMININ;SCOLAIRE;BAC PROFESSIONNEL;BAC PRO PROD;BAC PRO 25515 SYST.NUM.OPT.C RES.INF.SYST.COMM.;5;5;5;0;0;0;0;5;0;1;1;1;2;0
2630.0;2021;32;GUADELOUPE;FEMININ;SCOLAIRE;BAC PROFESSIONNEL;BAC PRO SERV;BAC PRO 33003 ACC.SOINS-S.PERS. OPT.A DOMICILE;64;64;51;5;8;5;3;56;0;2;4;20;30;8
2633.0;2021;32;GUADELOUPE;FEMININ;SCOLAIRE;BAC PROFESSIONNEL;BAC PRO SERV;BAC PRO 33602 PERRUQUIER POSTICHEUR;2;2;2;0;0;0;0;2;0;0;1;0;1;0
2644.0;2021;32;GUADELOUPE;FEMININ;SCOLAIRE;BAC TECHNOLOGIQUE;BAC STI2D;BAC STI2D ARCHITECTURE ET CONSTRUCTION;14;14;13;0;1;0;1;13;0;0;3;6;4;1
2652.0;2021;32;GUADELOUPE;FEMININ;SCOLAIRE;BAC TECHNOLOGIQUE;BAC STMG;BAC STMG RESSOURCES HUMAINES ET COMMUNICATION;130;130;109;5;16;15;1;124;0;1;11;38;74;6
2658.0;2021;32;GUADELOUPE;MASCULIN;APPRENTISSAGE;BAC PROFESSIONNEL;BAC PRO SERV;BAC PRO 31202 COMMERCE;1;0;0;0;0;0;0;0;0;0;0;0;0;0
2662.0;2021;32;GUADELOUPE;MASCULIN;FORMATION CONTINUE;BAC PROFESSIONNEL;BAC PRO PROD;BAC PRO 25214 MAINT.VEHIC.OPTA VOIT.PARTICUL.;2;1;1;0;0;0;0;1;0;0;0;1;0;0
2671.0;2021;32;GUADELOUPE;MASCULIN;INDIVIDUEL;BAC PROFESSIONNEL;BAC PRO PROD;BAC PRO 25510 METIERS ELECT. ENVIRON. CONNECTES;3;0;0;0;0;0;0;0;0;0;0;0;0;0
2675.0;2021;32;GUADELOUPE;MASCULIN;INDIVIDUEL;BAC TECHNOLOGIQUE;BAC S2TMD;BAC S2TMD MUSIQUE;1;1;1;0;0;0;0;1;0;0;0;0;1;0
2684.0;2021;32;GUADELOUPE;MASCULIN;SCOLAIRE;BAC PROFESSIONNEL;BAC PRO PROD;BAC PRO 22105 BOULANGER-PÂTISSIER;5;5;4;1;0;0;0;4;0;1;0;2;1;1
2690.0;2021;32;GUADELOUPE;MASCULIN;SCOLAIRE;BAC PROFESSIONNEL;BAC PRO PROD;BAC PRO 23203 TECHNICIEN BAT. : ORG.REAL.GROS O;24;24;18;2;4;4;0;22;0;0;3;4;15;2
2698.0;2021;32;GUADELOUPE;MASCULIN;SCOLAIRE;BAC PROFESSIONNEL;BAC PRO PROD;BAC PRO 25009 MAINTENANCE NAUTIQUE;54;54;40;6;8;6;2;46;0;0;4;15;27;8
2702.0;2021;32;GUADELOUPE;MASCULIN;SCOLAIRE;BAC PROFESSIONNEL;BAC PRO PROD;BAC PRO 25219 MAINT.MATERIELS OPT.A AGRICOLES;8;8;3;3;2;1;1;4;0;0;1;1;2;4
2706.0;2021;32;GUADELOUPE;MASCULIN;SCOLAIRE;BAC PROFESSIONNEL;BAC PRO PROD;BAC PRO 25408 REPARATION DES CARROSSERIES;11;11;11;0;0;0;0;11;0;0;2;2;7;0
2714.0;2021;32;GUADELOUPE;MASCULIN;SCOLAIRE;BAC PROFESSIONNEL;BAC PRO PROD;BAC PRO AG 21114 CONDUITE PRODUCTIONS HORTICOLES;10;10;10;0;0;0;0;10;0;1;1;4;4;0
2747.0;2021;33;GUYANE;FEMININ;APPRENTISSAGE;BAC PROFESSIONNEL;BAC PRO SERV;BAC PRO 31202 COMMERCE;1;1;0;1;0;0;0;0;0;0;0;0;0;1
2751.0;2021;33;GUYANE;FEMININ;INDIVIDUEL;BAC GENERAL;BAC GENERAL;BAC GENE 10019 BAC GENERAL;6;3;0;0;3;3;0;3;0;0;0;0;3;0
2761.0;2021;33;GUYANE;FEMININ;INDIVIDUEL;BAC TECHNOLOGIQUE;BAC STMG;BAC STMG GESTION ET FINANCE;1;1;0;1;0;0;0;0;0;0;0;0;0;1
2762.0;2021;33;GUYANE;FEMININ;INDIVIDUEL;BAC TECHNOLOGIQUE;BAC STMG;BAC STMG RESSOURCES HUMAINES ET COMMUNICATION;4;3;1;0;2;1;1;2;0;0;0;0;2;1
2763.0;2021;33;GUYANE;FEMININ;SCOLAIRE;BAC GENERAL;BAC GENERAL;BAC GENE 10019 BAC GENERAL;877;877;757;25;95;62;33;819;5;76;160;275;303;58
2766.0;2021;33;GUYANE;FEMININ;SCOLAIRE;BAC PROFESSIONNEL;BAC PRO PROD;BAC PRO 22106 CUISINE;15;15;14;1;0;0;0;14;0;0;1;3;10;1
2773.0;2021;33;GUYANE;FEMININ;SCOLAIRE;BAC PROFESSIONNEL;BAC PRO PROD;BAC PRO 23303 MENUISERIE ALUMINIUM-VERRE;3;3;0;2;1;1;0;1;0;0;0;0;1;2
2784.0;2021;33;GUYANE;FEMININ;SCOLAIRE;BAC PROFESSIONNEL;BAC PRO PROD;BAC PRO AG 22107 TEC CONS VTE ALIMENTATION P.ALIM;13;12;12;0;0;0;0;12;0;0;1;3;8;0
2785.0;2021;33;GUYANE;FEMININ;SCOLAIRE;BAC PROFESSIONNEL;BAC PRO SERV;BAC PRO 30001 GESTION-ADMINISTRATION;210;209;133;56;20;16;4;149;0;2;12;42;93;60
2788.0;2021;33;GUYANE;FEMININ;SCOLAIRE;BAC PROFESSIONNEL;BAC PRO SERV;BAC PRO 31206 VENTE (PROSPECT.NEGO.SUIV.CLIENT;23;23;15;4;4;1;3;16;0;0;1;5;10;7
2802.0;2021;33;GUYANE;FEMININ;SCOLAIRE;BAC TECHNOLOGIQUE;BAC STI2D;BAC STI2D ARCHITECTURE ET CONSTRUCTION;5;5;4;0;1;1;0;5;0;1;1;1;2;0
2809.0;2021;33;GUYANE;FEMININ;SCOLAIRE;BAC TECHNOLOGIQUE;BAC STMG;BAC STMG MERCATIQUE (MARKETING);39;39;33;3;3;1;2;34;0;1;1;16;16;5
2814.0;2021;33;GUYANE;MASCULIN;APPRENTISSAGE;BAC PROFESSIONNEL;BAC PRO SERV;BAC PRO 31202 COMMERCE;1;1;1;0;0;0;0;1;0;0;0;0;1;0
2820.0;2021;33;GUYANE;MASCULIN;INDIVIDUEL;BAC PROFESSIONNEL;BAC PRO PROD;BAC PRO 23004 TECHN. ETUDES BAT.A ETUDES & ECO.;1;1;0;1;0;0;0;0;0;0;0;0;0;1
2823.0;2021;33;GUYANE;MASCULIN;INDIVIDUEL;BAC PROFESSIONNEL;BAC PRO PROD;BAC PRO AG 21004 CGEA;3;3;3;0;0;0;0;3;0;0;0;0;3;0
2825.0;2021;33;GUYANE;MASCULIN;INDIVIDUEL;BAC PROFESSIONNEL;BAC PRO SERV;BAC PRO 30001 GESTION-ADMINISTRATION;1;1;1;0;0;0;0;1;0;0;0;1;0;0
2834.0;2021;33;GUYANE;MASCULIN;SCOLAIRE;BAC PROFESSIONNEL;BAC PRO PROD;BAC PRO 22704 TECHN. MAINT. SYST.ENERG.CLIMATI;11;11;10;1;0;0;0;10;0;0;1;4;5;1
2845.0;2021;33;GUYANE;MASCULIN;SCOLAIRE;BAC PROFESSIONNEL;BAC PRO PROD;BAC PRO 25007 MAINTENANCE EQUIPEMENTS INDUST.;20;20;6;14;0;0;0;6;0;2;0;1;3;14
2846.0;2021;33;GUYANE;MASCULIN;SCOLAIRE;BAC PROFESSIONNEL;BAC PRO PROD;BAC PRO 25214 MAINT.VEHIC.OPTA VOIT.PARTICUL.;52;52;31;20;1;1;0;32;0;0;3;9;20;20
2850.0;2021;33;GUYANE;MASCULIN;SCOLAIRE;BAC PROFESSIONNEL;BAC PRO PROD;BAC PRO 25510 METIERS ELECT. ENVIRON. CONNECTES;80;80;53;26;1;1;0;54;0;1;9;16;28;26
2851.0;2021;33;GUYANE;MASCULIN;SCOLAIRE;BAC PROFESSIONNEL;BAC PRO PROD;BAC PRO 25513 SYST.NUM.OPT.A SURETE SECURITE;10;10;6;2;2;2;0;8;0;0;1;4;3;2
2854.0;2021;33;GUYANE;MASCULIN;SCOLAIRE;BAC PROFESSIONNEL;BAC PRO PROD;BAC PRO AG 21114 CONDUITE PRODUCTIONS HORTICOLES;9;8;6;2;0;0;0;6;0;0;2;3;1;2
2863.0;2021;33;GUYANE;MASCULIN;SCOLAIRE;BAC PROFESSIONNEL;BAC PRO SERV;BAC PRO 33002 SERVICES DE PROXIMITE  VIE LOCAL;15;15;12;0;3;3;0;15;0;0;1;2;12;0
2882.0;2021;33;GUYANE;MASCULIN;SCOLAIRE;BAC TECHNOLOGIQUE;BAC STMG;BAC STMG SYSTEMES D'INFORMATION DE GESTION;10;10;9;0;1;0;1;9;0;0;1;4;4;1
2887.0;2021;28;LA REUNION;FEMININ;ENSEIGNEMENT A DISTANCE;BAC TECHNOLOGIQUE;BAC STMG;BAC STMG RESSOURCES HUMAINES ET COMMUNICATION;1;1;1;0;0;0;0;1;0;0;0;1;0;0
2898.0;2021;28;LA REUNION;FEMININ;INDIVIDUEL;BAC TECHNOLOGIQUE;BAC STMG;BAC STMG GESTION ET FINANCE;4;3;2;0;1;1;0;3;0;0;1;1;1;0
2900.0;2021;28;LA REUNION;FEMININ;INDIVIDUEL;BAC TECHNOLOGIQUE;BAC STMG;BAC STMG RESSOURCES HUMAINES ET COMMUNICATION;2;1;0;1;0;0;0;0;0;0;0;0;0;1
2911.0;2021;28;LA REUNION;FEMININ;SCOLAIRE;BAC PROFESSIONNEL;BAC PRO PROD;BAC PRO 23304 AMENAGEMENT FINITION BATIMENT;4;4;3;1;0;0;0;3;0;0;0;1;2;1
2912.0;2021;28;LA REUNION;FEMININ;SCOLAIRE;BAC PROFESSIONNEL;BAC PRO PROD;BAC PRO 23405 TECHNICIEN MENUISIER AGENCEUR;4;4;3;0;1;1;0;4;0;0;0;1;3;0
2919.0;2021;28;LA REUNION;FEMININ;SCOLAIRE;BAC PROFESSIONNEL;BAC PRO PROD;BAC PRO 25408 REPARATION DES CARROSSERIES;5;4;4;0;0;0;0;4;0;1;1;1;1;0
2926.0;2021;28;LA REUNION;FEMININ;SCOLAIRE;BAC PROFESSIONNEL;BAC PRO PROD;BAC PRO AG 21302 GEST MILIEUX NATURELS FAUNE;6;6;6;0;0;0;0;6;0;0;1;3;2;0
2933.0;2021;28;LA REUNION;FEMININ;SCOLAIRE;BAC PROFESSIONNEL;BAC PRO SERV;BAC PRO 31202 COMMERCE;212;212;167;20;25;19;6;186;0;8;27;69;82;26
2938.0;2021;28;LA REUNION;FEMININ;SCOLAIRE;BAC PROFESSIONNEL;BAC PRO SERV;BAC PRO 32303 ART.& MET.ART:COM.VIS.VIS.PLURI-M;5;5;3;2;0;0;0;3;0;0;0;0;3;2
2945.0;2021;28;LA REUNION;FEMININ;SCOLAIRE;BAC PROFESSIONNEL;BAC PRO SERV;BAC PRO 34303 GEST. POLLUTIONS PROTEC. ENVIRON.;4;4;0;2;2;1;1;1;0;0;0;0;1;3
2946.0;2021;28;LA REUNION;FEMININ;SCOLAIRE;BAC PROFESSIONNEL;BAC PRO SERV;BAC PRO 34304 HYGIENE PROPRETE STERILISATION;12;12;7;0;5;0;5;7;0;0;0;3;4;5
2948.0;2021;28;LA REUNION;FEMININ;SCOLAIRE;BAC PROFESSIONNEL;BAC PRO SERV;BAC PRO AG 33002 SERV PERS TERRIT;49;48;44;4;0;0;0;44;0;0;6;14;24;4
2963.0;2021;28;LA REUNION;MASCULIN;APPRENTISSAGE;BAC PROFESSIONNEL;BAC PRO PROD;BAC PRO 20102 PILOTE DE LIGNE DE PRODUCTION;1;1;0;0;1;1;0;1;0;0;0;0;1;0
2971.0;2021;28;LA REUNION;MASCULIN;APPRENTISSAGE;BAC PROFESSIONNEL;BAC PRO PROD;BAC PRO AG 22107 TEC CONS VTE ALIMENTATION P.ALIM;5;2;2;0;0;0;0;2;0;0;0;0;2;0
2974.0;2021;28;LA REUNION;MASCULIN;APPRENTISSAGE;BAC PROFESSIONNEL;BAC PRO SERV;BAC PRO 31202 COMMERCE;1;1;0;0;1;1;0;1;0;0;0;0;1;0
2979.0;2021;28;LA REUNION;MASCULIN;INDIVIDUEL;BAC GENERAL;BAC GENERAL;BAC GENE 10019 BAC GENERAL;15;9;2;1;6;6;0;8;0;0;0;1;7;1
2989.0;2021;28;LA REUNION;MASCULIN;INDIVIDUEL;BAC TECHNOLOGIQUE;BAC STI2D;BAC STI2D INNOVATION TECHNO.  ET ECO CONCEPTION;1;1;0;1;0;0;0;0;0;0;0;0;0;1
2998.0;2021;28;LA REUNION;MASCULIN;SCOLAIRE;BAC PROFESSIONNEL;BAC PRO PROD;BAC PRO 22105 BOULANGER-PÂTISSIER;6;6;5;0;1;0;1;5;0;3;1;1;0;1
3013.0;2021;28;LA REUNION;MASCULIN;SCOLAIRE;BAC PROFESSIONNEL;BAC PRO PROD;BAC PRO 23304 AMENAGEMENT FINITION BATIMENT;49;49;28;8;13;8;5;36;0;0;0;12;24;13
3014.0;2021;28;LA REUNION;MASCULIN;SCOLAIRE;BAC PROFESSIONNEL;BAC PRO PROD;BAC PRO 23404 TECHNICIEN CONSTRUCTEUR BOIS;34;34;24;0;10;6;4;30;0;0;0;9;21;4
3017.0;2021;28;LA REUNION;MASCULIN;SCOLAIRE;BAC PROFESSIONNEL;BAC PRO PROD;BAC PRO 23408 Etude et réalisation d'agencement;1;1;0;1;0;0;0;0;0;0;0;0;0;1
3021.0;2021;28;LA REUNION;MASCULIN;SCOLAIRE;BAC PROFESSIONNEL;BAC PRO PROD;BAC PRO 25214 MAINT.VEHIC.OPTA VOIT.PARTICUL.;140;139;102;25;12;9;3;111;0;5;13;36;57;28
3023.0;2021;28;LA REUNION;MASCULIN;SCOLAIRE;BAC PROFESSIONNEL;BAC PRO PROD;BAC PRO 25219 MAINT.MATERIELS OPT.A AGRICOLES;11;11;6;2;3;3;0;9;0;0;0;1;8;2
3024.0;2021;28;LA REUNION;MASCULIN;SCOLAIRE;BAC PROFESSIONNEL;BAC PRO PROD;BAC PRO 25220 MAINT.MATERIELS OPT.B TP MANUT.;9;9;3;4;2;2;0;5;0;0;0;0;5;4
3026.0;2021;28;LA REUNION;MASCULIN;SCOLAIRE;BAC PROFESSIONNEL;BAC PRO PROD;BAC PRO 25303 AERONAUTIQUE OPTION SYSTEMES;24;24;22;0;2;2;0;24;0;2;3;7;12;0
3035.0;2021;28;LA REUNION;MASCULIN;SCOLAIRE;BAC PROFESSIONNEL;BAC PRO PROD;BAC PRO AG 21001 AGRO-EQUIPEMENT;8;8;4;4;0;0;0;4;0;0;0;1;3;4
3039.0;2021;28;LA REUNION;MASCULIN;SCOLAIRE;BAC PROFESSIONNEL;BAC PRO PROD;BAC PRO AG 21405 AMENAGEMENTS PAYSAGERS;5;4;4;0;0;0;0;4;0;0;1;1;2;0
3043.0;2021;28;LA REUNION;MASCULIN;SCOLAIRE;BAC PROFESSIONNEL;BAC PRO SERV;BAC PRO 31106 LOGISTIQUE;65;65;35;12;18;17;1;52;0;3;2;9;38;13
3046.0;2021;28;LA REUNION;MASCULIN;SCOLAIRE;BAC PROFESSIONNEL;BAC PRO SERV;BAC PRO 31206 VENTE (PROSPECT.NEGO.SUIV.CLIENT;32;32;23;4;5;3;2;26;0;0;2;9;15;6
3051.0;2021;28;LA REUNION;MASCULIN;SCOLAIRE;BAC PROFESSIONNEL;BAC PRO SERV;BAC PRO 33002 SERVICES DE PROXIMITE  VIE LOCAL;8;8;5;1;2;2;0;7;0;0;0;2;5;1
3057.0;2021;28;LA REUNION;MASCULIN;SCOLAIRE;BAC PROFESSIONNEL;BAC PRO SERV;BAC PRO 34304 HYGIENE PROPRETE STERILISATION;9;9;7;1;1;0;1;7;0;0;1;1;5;2
3064.0;2021;28;LA REUNION;MASCULIN;SCOLAIRE;BAC TECHNOLOGIQUE;BAC STI2D;BAC STI2D ARCHITECTURE ET CONSTRUCTION;111;111;99;1;11;7;4;106;0;2;13;36;55;5
3070.0;2021;28;LA REUNION;MASCULIN;SCOLAIRE;BAC TECHNOLOGIQUE;BAC STMG;BAC STMG GESTION ET FINANCE;154;154;128;7;19;10;9;138;0;4;17;58;59;16
3071.0;2021;28;LA REUNION;MASCULIN;SCOLAIRE;BAC TECHNOLOGIQUE;BAC STMG;BAC STMG MERCATIQUE (MARKETING);303;303;250;6;47;35;12;285;0;2;17;106;160;18
3079.0;2021;09;LILLE;FEMININ;APPRENTISSAGE;BAC PROFESSIONNEL;BAC PRO PROD;BAC PRO 23102 TRAVAUX PUBLICS;1;1;1;0;0;0;0;1;0;0;0;0;1;0
3085.0;2021;09;LILLE;FEMININ;APPRENTISSAGE;BAC PROFESSIONNEL;BAC PRO PROD;BAC PRO 25214 MAINT.VEHIC.OPTA VOIT.PARTICUL.;3;3;2;0;1;1;0;3;0;0;0;1;2;0
3087.0;2021;09;LILLE;FEMININ;APPRENTISSAGE;BAC PROFESSIONNEL;BAC PRO PROD;BAC PRO 25216 MAINT.VEHIC.OPTC MOTOCYCLES;2;2;2;0;0;0;0;2;0;1;1;0;0;0
3091.0;2021;09;LILLE;FEMININ;APPRENTISSAGE;BAC PROFESSIONNEL;BAC PRO PROD;BAC PRO AG 21114 CONDUITE PRODUCTIONS HORTICOLES;1;1;1;0;0;0;0;1;0;0;0;0;1;0
3103.0;2021;09;LILLE;FEMININ;APPRENTISSAGE;BAC PROFESSIONNEL;BAC PRO SERV;BAC PRO AG 33002 SERV PERS TERRIT;18;15;15;0;0;0;0;15;0;0;5;4;6;0
3105.0;2021;09;LILLE;FEMININ;ENSEIGNEMENT A DISTANCE;BAC PROFESSIONNEL;BAC PRO SERV;BAC PRO 30001 GESTION-ADMINISTRATION;3;2;1;1;0;0;0;1;0;0;0;1;0;1
3107.0;2021;09;LILLE;FEMININ;ENSEIGNEMENT A DISTANCE;BAC PROFESSIONNEL;BAC PRO SERV;BAC PRO 31210 ACCUEIL -RELATION CLIENTS USAGERS;1;1;1;0;0;0;0;1;0;0;0;1;0;0
3116.0;2021;09;LILLE;FEMININ;FORMATION CONTINUE;BAC PROFESSIONNEL;BAC PRO PROD;BAC PRO 22705 TECHNICIEN GAZ;3;3;3;0;0;0;0;3;0;3;0;0;0;0
3117.0;2021;09;LILLE;FEMININ;FORMATION CONTINUE;BAC PROFESSIONNEL;BAC PRO PROD;BAC PRO 24301 METIERS DU CUIR : CHAUSSURES;1;0;0;0;0;0;0;0;0;0;0;0;0;0
3119.0;2021;09;LILLE;FEMININ;FORMATION CONTINUE;BAC PROFESSIONNEL;BAC PRO PROD;BAC PRO 25406 OUVRAGES DU BATIMENT METALLERIE;1;1;1;0;0;0;0;1;0;1;0;0;0;0
3125.0;2021;09;LILLE;FEMININ;FORMATION CONTINUE;BAC PROFESSIONNEL;BAC PRO SERV;BAC PRO 33403 COMMERC. SERVICES EN RESTAURATION;1;1;1;0;0;0;0;1;0;0;0;1;0;0
3135.0;2021;09;LILLE;FEMININ;INDIVIDUEL;BAC PROFESSIONNEL;BAC PRO SERV;BAC PRO 31206 VENTE (PROSPECT.NEGO.SUIV.CLIENT;1;1;1;0;0;0;0;1;0;0;0;1;0;0
3140.0;2021;09;LILLE;FEMININ;INDIVIDUEL;BAC TECHNOLOGIQUE;BAC ST2S;BAC ST2S SCIENCES & TECHNO. SANTE & SOCIAL;22;11;10;1;0;0;0;10;0;0;2;1;7;1
3141.0;2021;09;LILLE;FEMININ;INDIVIDUEL;BAC TECHNOLOGIQUE;BAC STI2D;BAC STI2D INNOVATION TECHNO.  ET ECO CONCEPTION;1;0;0;0;0;0;0;0;0;0;0;0;0;0
3145.0;2021;09;LILLE;FEMININ;SCOLAIRE;BAC GENERAL;BAC GENERAL;BAC GENE 10019 BAC GENERAL;12585;12582;12188;97;297;167;130;12355;483;2130;3740;3811;2191;227
3150.0;2021;09;LILLE;FEMININ;SCOLAIRE;BAC PROFESSIONNEL;BAC PRO PROD;BAC PRO 22403 ARTS.& MET.ART:MET.ENSEIGN SIGNA;4;4;4;0;0;0;0;4;0;0;3;0;1;0
3151.0;2021;09;LILLE;FEMININ;SCOLAIRE;BAC PROFESSIONNEL;BAC PRO PROD;BAC PRO 22704 TECHN. MAINT. SYST.ENERG.CLIMATI;1;1;1;0;0;0;0;1;0;0;0;1;0;0
3181.0;2021;09;LILLE;FEMININ;SCOLAIRE;BAC PROFESSIONNEL;BAC PRO PROD;BAC PRO AG 21204 PROD-AQUACOLES;1;1;1;0;0;0;0;1;0;0;0;0;1;0
3182.0;2021;09;LILLE;FEMININ;SCOLAIRE;BAC PROFESSIONNEL;BAC PRO PROD;BAC PRO AG 21210 COND GEST ENTR CANIN ET FELIN;23;23;23;0;0;0;0;23;0;0;3;11;9;0
3189.0;2021;09;LILLE;FEMININ;SCOLAIRE;BAC PROFESSIONNEL;BAC PRO SERV;BAC PRO 30001 GESTION-ADMINISTRATION;755;753;590;130;33;24;9;614;0;30;101;229;254;139
3199.0;2021;09;LILLE;FEMININ;SCOLAIRE;BAC PROFESSIONNEL;BAC PRO SERV;BAC PRO 32304 PHOTOGRAPHIE;22;22;16;6;0;0;0;16;0;1;5;3;7;6
3200.0;2021;09;LILLE;FEMININ;SCOLAIRE;BAC PROFESSIONNEL;BAC PRO SERV;BAC PRO 33002 SERVICES DE PROXIMITE  VIE LOCAL;123;121;97;8;16;10;6;107;0;3;23;39;42;14
3201.0;2021;09;LILLE;FEMININ;SCOLAIRE;BAC PROFESSIONNEL;BAC PRO SERV;BAC PRO 33003 ACC.SOINS-S.PERS. OPT.A DOMICILE;287;286;234;36;16;11;5;245;0;3;34;99;109;41
3204.0;2021;09;LILLE;FEMININ;SCOLAIRE;BAC PROFESSIONNEL;BAC PRO SERV;BAC PRO 33102 PROTHESE DENTAIRE;8;8;6;2;0;0;0;6;0;0;2;1;3;2
3205.0;2021;09;LILLE;FEMININ;SCOLAIRE;BAC PROFESSIONNEL;BAC PRO SERV;BAC PRO 33103 TECHNICIEN APPAREIL. ORTHOPEDIQUE;6;6;5;1;0;0;0;5;0;1;1;1;2;1
3207.0;2021;09;LILLE;FEMININ;SCOLAIRE;BAC PROFESSIONNEL;BAC PRO SERV;BAC PRO 33602 PERRUQUIER POSTICHEUR;3;3;3;0;0;0;0;3;0;0;1;1;1;0
3210.0;2021;09;LILLE;FEMININ;SCOLAIRE;BAC PROFESSIONNEL;BAC PRO SERV;BAC PRO 34403 METIERS DE LA SECURITE;61;61;55;4;2;2;0;57;0;3;15;19;20;4
3217.0;2021;09;LILLE;FEMININ;SCOLAIRE;BAC TECHNOLOGIQUE;BAC STHR;BAC STHR SC.&TEC. HOTELLERIE-RESTAURATION;54;54;47;2;5;3;2;50;0;7;14;10;19;4
3219.0;2021;09;LILLE;FEMININ;SCOLAIRE;BAC TECHNOLOGIQUE;BAC STI2D;BAC STI2D ENERGIES  ET ENVIRONNEMENT;16;16;15;1;0;0;0;15;0;0;1;7;7;1
3220.0;2021;09;LILLE;FEMININ;SCOLAIRE;BAC TECHNOLOGIQUE;BAC STI2D;BAC STI2D INNOVATION TECHNO.  ET ECO CONCEPTION;23;23;21;0;2;0;2;21;0;0;4;9;8;2
3226.0;2021;09;LILLE;FEMININ;SCOLAIRE;BAC TECHNOLOGIQUE;BAC STMG;BAC STMG RESSOURCES HUMAINES ET COMMUNICATION;934;934;820;31;83;48;35;868;0;18;141;343;366;66
3229.0;2021;09;LILLE;MASCULIN;APPRENTISSAGE;BAC PROFESSIONNEL;BAC PRO PROD;BAC PRO 22003 BIO-INDUSTRIES DE TRANSFORMATION;2;2;2;0;0;0;0;2;0;0;2;0;0;0
3234.0;2021;09;LILLE;MASCULIN;APPRENTISSAGE;BAC PROFESSIONNEL;BAC PRO PROD;BAC PRO 22704 TECHN. MAINT. SYST.ENERG.CLIMATI;21;21;15;3;3;2;1;17;0;3;1;6;7;4
3243.0;2021;09;LILLE;MASCULIN;APPRENTISSAGE;BAC PROFESSIONNEL;BAC PRO PROD;BAC PRO 25214 MAINT.VEHIC.OPTA VOIT.PARTICUL.;92;90;69;16;5;3;2;72;0;5;13;27;27;18
3244.0;2021;09;LILLE;MASCULIN;APPRENTISSAGE;BAC PROFESSIONNEL;BAC PRO PROD;BAC PRO 25215 MAINT.VEHIC.OPTB VEHIC.TRANS.ROUT;38;38;30;7;1;1;0;31;0;1;4;15;11;7
3246.0;2021;09;LILLE;MASCULIN;APPRENTISSAGE;BAC PROFESSIONNEL;BAC PRO PROD;BAC PRO 25219 MAINT.MATERIELS OPT.A AGRICOLES;26;26;26;0;0;0;0;26;0;3;5;8;10;0
3254.0;2021;09;LILLE;MASCULIN;APPRENTISSAGE;BAC PROFESSIONNEL;BAC PRO PROD;BAC PRO 25510 METIERS ELECT. ENVIRON. CONNECTES;135;132;117;11;4;0;4;117;0;19;34;34;30;15
3257.0;2021;09;LILLE;MASCULIN;APPRENTISSAGE;BAC PROFESSIONNEL;BAC PRO PROD;BAC PRO AG 21114 CONDUITE PRODUCTIONS HORTICOLES;2;2;2;0;0;0;0;2;0;0;0;1;1;0
3258.0;2021;09;LILLE;MASCULIN;APPRENTISSAGE;BAC PROFESSIONNEL;BAC PRO PROD;BAC PRO AG 21203 TECHN CONSEIL DE VENTE ANIMAL;8;8;8;0;0;0;0;8;0;1;1;3;3;0
3264.0;2021;09;LILLE;MASCULIN;APPRENTISSAGE;BAC PROFESSIONNEL;BAC PRO SERV;BAC PRO 31202 COMMERCE;61;55;50;4;1;1;0;51;0;3;9;26;13;4
3267.0;2021;09;LILLE;MASCULIN;APPRENTISSAGE;BAC PROFESSIONNEL;BAC PRO SERV;BAC PRO 32303 ART.& MET.ART:COM.VIS.VIS.PLURI-M;1;1;1;0;0;0;0;1;0;0;0;1;0;0
3268.0;2021;09;LILLE;MASCULIN;APPRENTISSAGE;BAC PROFESSIONNEL;BAC PRO SERV;BAC PRO 33403 COMMERC. SERVICES EN RESTAURATION;24;22;18;3;1;1;0;19;0;2;2;11;4;3
3271.0;2021;09;LILLE;MASCULIN;ENSEIGNEMENT A DISTANCE;BAC PROFESSIONNEL;BAC PRO SERV;BAC PRO 31202 COMMERCE;3;3;1;2;0;0;0;1;0;0;0;0;1;2
3277.0;2021;09;LILLE;MASCULIN;ENSEIGNEMENT A DISTANCE;BAC TECHNOLOGIQUE;BAC STMG;BAC STMG MERCATIQUE (MARKETING);7;7;7;0;0;0;0;7;0;0;4;1;2;0
3281.0;2021;09;LILLE;MASCULIN;FORMATION CONTINUE;BAC PROFESSIONNEL;BAC PRO PROD;BAC PRO 22106 CUISINE;2;2;0;2;0;0;0;0;0;0;0;0;0;2
3282.0;2021;09;LILLE;MASCULIN;FORMATION CONTINUE;BAC PROFESSIONNEL;BAC PRO PROD;BAC PRO 22703 TECHN.INSTALL.SYST.ENERG.CLIMATI;11;10;10;0;0;0;0;10;0;4;4;1;1;0
3292.0;2021;09;LILLE;MASCULIN;FORMATION CONTINUE;BAC PROFESSIONNEL;BAC PRO PROD;BAC PRO 25510 METIERS ELECT. ENVIRON. CONNECTES;3;3;3;0;0;0;0;3;0;3;0;0;0;0
3295.0;2021;09;LILLE;MASCULIN;FORMATION CONTINUE;BAC PROFESSIONNEL;BAC PRO SERV;BAC PRO 31106 LOGISTIQUE;7;7;5;2;0;0;0;5;0;0;1;2;2;2
3296.0;2021;09;LILLE;MASCULIN;FORMATION CONTINUE;BAC PROFESSIONNEL;BAC PRO SERV;BAC PRO 31108 TRANSPORT;13;13;10;3;0;0;0;10;0;0;3;6;1;3
3301.0;2021;09;LILLE;MASCULIN;INDIVIDUEL;BAC PROFESSIONNEL;BAC PRO PROD;BAC PRO 22704 TECHN. MAINT. SYST.ENERG.CLIMATI;1;0;0;0;0;0;0;0;0;0;0;0;0;0
3303.0;2021;09;LILLE;MASCULIN;INDIVIDUEL;BAC PROFESSIONNEL;BAC PRO PROD;BAC PRO 25408 REPARATION DES CARROSSERIES;1;1;1;0;0;0;0;1;0;0;0;0;1;0
3310.0;2021;09;LILLE;MASCULIN;INDIVIDUEL;BAC PROFESSIONNEL;BAC PRO SERV;BAC PRO 31206 VENTE (PROSPECT.NEGO.SUIV.CLIENT;1;1;1;0;0;0;0;1;0;0;0;0;1;0
3311.0;2021;09;LILLE;MASCULIN;INDIVIDUEL;BAC PROFESSIONNEL;BAC PRO SERV;BAC PRO 31210 ACCUEIL -RELATION CLIENTS USAGERS;1;1;1;0;0;0;0;1;0;0;0;0;1;0
3324.0;2021;09;LILLE;MASCULIN;SCOLAIRE;BAC GENERAL;BAC GENERAL;BAC GENE 10019 BAC GENERAL;9988;9983;9350;125;508;319;189;9669;265;1174;2329;3086;2815;314
3326.0;2021;09;LILLE;MASCULIN;SCOLAIRE;BAC PROFESSIONNEL;BAC PRO PROD;BAC PRO 22003 BIO-INDUSTRIES DE TRANSFORMATION;24;24;19;5;0;0;0;19;0;1;4;8;6;5
3338.0;2021;09;LILLE;MASCULIN;SCOLAIRE;BAC PROFESSIONNEL;BAC PRO PROD;BACPRO 23103 TECHNICIEN GEOMETRE-TOPOGRAPHE;18;18;16;2;0;0;0;16;0;0;4;8;4;2
3343.0;2021;09;LILLE;MASCULIN;SCOLAIRE;BAC PROFESSIONNEL;BAC PRO PROD;BAC PRO 23404 TECHNICIEN CONSTRUCTEUR BOIS;38;38;29;6;3;2;1;31;0;0;5;12;14;7
3346.0;2021;09;LILLE;MASCULIN;SCOLAIRE;BAC PROFESSIONNEL;BAC PRO PROD;BAC PRO 23408 Etude et réalisation d'agencement;12;12;11;1;0;0;0;11;0;0;2;6;3;1
3350.0;2021;09;LILLE;MASCULIN;SCOLAIRE;BAC PROFESSIONNEL;BAC PRO PROD;BAC PRO 25214 MAINT.VEHIC.OPTA VOIT.PARTICUL.;484;484;376;94;14;10;4;386;0;15;73;154;144;98
3354.0;2021;09;LILLE;MASCULIN;SCOLAIRE;BAC PROFESSIONNEL;BAC PRO PROD;BAC PRO 25220 MAINT.MATERIELS OPT.B TP MANUT.;30;30;24;5;1;0;1;24;0;0;2;16;6;6
3358.0;2021;09;LILLE;MASCULIN;SCOLAIRE;BAC PROFESSIONNEL;BAC PRO PROD;BAC PRO 25408 REPARATION DES CARROSSERIES;165;162;115;31;16;10;6;125;0;3;34;44;44;37
3360.0;2021;09;LILLE;MASCULIN;SCOLAIRE;BAC PROFESSIONNEL;BAC PRO PROD;BAC PRO 25411 TECH.CHAUDRONNERIE INDUSTRIELLE;150;150;104;37;9;7;2;111;0;2;21;45;43;39
3363.0;2021;09;LILLE;MASCULIN;SCOLAIRE;BAC PROFESSIONNEL;BAC PRO PROD;BAC PRO 25513 SYST.NUM.OPT.A SURETE SECURITE;70;70;57;8;5;4;1;61;0;0;13;29;19;9
3365.0;2021;09;LILLE;MASCULIN;SCOLAIRE;BAC PROFESSIONNEL;BAC PRO PROD;BAC PRO 25515 SYST.NUM.OPT.C RES.INF.SYST.COMM.;327;327;263;37;27;20;7;283;0;15;64;100;104;44
3377.0;2021;09;LILLE;MASCULIN;SCOLAIRE;BAC PROFESSIONNEL;BAC PRO PROD;BAC PRO AG 22105 LABORATOIRE CONTROLE QUALITE;17;17;16;1;0;0;0;16;0;1;4;7;4;1
3379.0;2021;09;LILLE;MASCULIN;SCOLAIRE;BAC PROFESSIONNEL;BAC PRO SERV;BAC PRO 30001 GESTION-ADMINISTRATION;346;344;235;89;20;17;3;252;0;7;27;79;139;92
3381.0;2021;09;LILLE;MASCULIN;SCOLAIRE;BAC PROFESSIONNEL;BAC PRO SERV;BAC PRO 31107 CONDUCT. TRANSP.ROUT.MARCHANDISES;106;106;94;10;2;2;0;96;0;5;29;41;21;10
3382.0;2021;09;LILLE;MASCULIN;SCOLAIRE;BAC PROFESSIONNEL;BAC PRO SERV;BAC PRO 31108 TRANSPORT;71;71;46;16;9;6;3;52;0;2;9;20;21;19
3391.0;2021;09;LILLE;MASCULIN;SCOLAIRE;BAC PROFESSIONNEL;BAC PRO SERV;BAC PRO 33003 ACC.SOINS-S.PERS. OPT.A DOMICILE;24;24;18;3;3;3;0;21;0;0;2;9;10;3
3392.0;2021;09;LILLE;MASCULIN;SCOLAIRE;BAC PROFESSIONNEL;BAC PRO SERV;BAC PRO 33004 ACC.SOINS-S.PERS. OPT.EN STRUCTUR;96;95;89;2;4;2;2;91;0;0;16;43;32;4
3394.0;2021;09;LILLE;MASCULIN;SCOLAIRE;BAC PROFESSIONNEL;BAC PRO SERV;BAC PRO 33102 PROTHESE DENTAIRE;13;13;9;3;1;1;0;10;0;0;1;6;3;3
3397.0;2021;09;LILLE;MASCULIN;SCOLAIRE;BAC PROFESSIONNEL;BAC PRO SERV;BAC PRO 33603 ESTHETIQUE COSMETIQUE PARFUMERIE;2;1;1;0;0;0;0;1;0;0;0;0;1;0
3400.0;2021;09;LILLE;MASCULIN;SCOLAIRE;BAC PROFESSIONNEL;BAC PRO SERV;BAC PRO AG 33002 SERV PERS TERRIT;14;13;11;2;0;0;0;11;0;1;1;2;7;2
3402.0;2021;09;LILLE;MASCULIN;SCOLAIRE;BAC TECHNOLOGIQUE;BAC ST2S;BAC ST2S SCIENCES & TECHNO. SANTE & SOCIAL;358;357;290;19;48;27;21;317;0;3;34;108;172;40
3404.0;2021;09;LILLE;MASCULIN;SCOLAIRE;BAC TECHNOLOGIQUE;BAC STD2A;BAC STD2A SCIENCES & TECHNO. DESIGN-ARTS APPLIQUES;38;38;36;1;1;0;1;36;1;3;10;13;9;2
3405.0;2021;09;LILLE;MASCULIN;SCOLAIRE;BAC TECHNOLOGIQUE;BAC STHR;BAC STHR SC.&TEC. HOTELLERIE-RESTAURATION;63;63;58;0;5;4;1;62;0;9;10;18;25;1
3409.0;2021;09;LILLE;MASCULIN;SCOLAIRE;BAC TECHNOLOGIQUE;BAC STI2D;BAC STI2D SYSTÈME D'INFORMATION  ET NUMERIQUE;584;583;538;10;35;21;14;559;1;17;108;216;217;24
3414.0;2021;09;LILLE;MASCULIN;SCOLAIRE;BAC TECHNOLOGIQUE;BAC STMG;BAC STMG RESSOURCES HUMAINES ET COMMUNICATION;585;585;469;34;82;45;37;514;0;4;48;176;286;71
3417.0;2021;22;LIMOGES;FEMININ;APPRENTISSAGE;BAC PROFESSIONNEL;BAC PRO PROD;BAC PRO 25007 MAINTENANCE EQUIPEMENTS INDUST.;2;2;2;0;0;0;0;2;0;1;1;0;0;0
3420.0;2021;22;LIMOGES;FEMININ;APPRENTISSAGE;BAC PROFESSIONNEL;BAC PRO PROD;BAC PRO 25510 METIERS ELECT. ENVIRON. CONNECTES;1;1;1;0;0;0;0;1;0;1;0;0;0;0
3435.0;2021;22;LIMOGES;FEMININ;INDIVIDUEL;BAC PROFESSIONNEL;BAC PRO PROD;BAC PRO AG 21004 CGEA;8;7;7;0;0;0;0;7;0;0;0;0;7;0
3446.0;2021;22;LIMOGES;FEMININ;INDIVIDUEL;BAC TECHNOLOGIQUE;BAC STL;BAC STL BIOCHIM.-BIOLOGIE-BIOTECHNOL.;1;0;0;0;0;0;0;0;0;0;0;0;0;0
3448.0;2021;22;LIMOGES;FEMININ;INDIVIDUEL;BAC TECHNOLOGIQUE;BAC STMG;BAC STMG RESSOURCES HUMAINES ET COMMUNICATION;3;2;0;1;1;1;0;1;0;0;0;0;1;1
3456.0;2021;22;LIMOGES;FEMININ;SCOLAIRE;BAC PROFESSIONNEL;BAC PRO PROD;BAC PRO 23304 AMENAGEMENT FINITION BATIMENT;3;3;3;0;0;0;0;3;0;0;2;1;0;0
3459.0;2021;22;LIMOGES;FEMININ;SCOLAIRE;BAC PROFESSIONNEL;BAC PRO PROD;BAC PRO 24202 ARTIS.& MET.ART : TAPIS.D'AMEUBL;7;7;5;1;1;0;1;5;0;0;0;4;1;2
3461.0;2021;22;LIMOGES;FEMININ;SCOLAIRE;BAC PROFESSIONNEL;BAC PRO PROD;BAC PRO 25007 MAINTENANCE EQUIPEMENTS INDUST.;1;1;1;0;0;0;0;1;0;0;0;0;1;0
3464.0;2021;22;LIMOGES;FEMININ;SCOLAIRE;BAC PROFESSIONNEL;BAC PRO PROD;BAC PRO 25214 MAINT.VEHIC.OPTA VOIT.PARTICUL.;1;1;1;0;0;0;0;1;0;0;0;1;0;0
3474.0;2021;22;LIMOGES;FEMININ;SCOLAIRE;BAC PROFESSIONNEL;BAC PRO PROD;BAC PRO AG 21302 GEST MILIEUX NATURELS FAUNE;2;2;2;0;0;0;0;2;0;0;0;0;2;0
3480.0;2021;22;LIMOGES;FEMININ;SCOLAIRE;BAC PROFESSIONNEL;BAC PRO SERV;BAC PRO 31202 COMMERCE;53;53;44;4;5;2;3;46;0;1;13;17;15;7
3489.0;2021;22;LIMOGES;FEMININ;SCOLAIRE;BAC PROFESSIONNEL;BAC PRO SERV;BAC PRO 33101 OPTIQUE LUNETTERIE;11;11;10;1;0;0;0;10;0;0;3;4;3;1
3495.0;2021;22;LIMOGES;FEMININ;SCOLAIRE;BAC TECHNOLOGIQUE;BAC ST2S;BAC ST2S SCIENCES & TECHNO. SANTE & SOCIAL;218;218;199;4;15;8;7;207;0;4;36;89;78;11
3503.0;2021;22;LIMOGES;FEMININ;SCOLAIRE;BAC TECHNOLOGIQUE;BAC STL;BAC STL BIOCHIM.-BIOLOGIE-BIOTECHNOL.;63;63;60;0;3;3;0;63;0;3;17;21;22;0
3521.0;2021;22;LIMOGES;MASCULIN;APPRENTISSAGE;BAC PROFESSIONNEL;BAC PRO PROD;BAC PRO 25214 MAINT.VEHIC.OPTA VOIT.PARTICUL.;28;28;26;2;0;0;0;26;0;2;11;7;6;2
3538.0;2021;22;LIMOGES;MASCULIN;FORMATION CONTINUE;BAC PROFESSIONNEL;BAC PRO PROD;BAC PRO 22704 TECHN. MAINT. SYST.ENERG.CLIMATI;1;1;1;0;0;0;0;1;0;0;1;0;0;0
3540.0;2021;22;LIMOGES;MASCULIN;FORMATION CONTINUE;BAC PROFESSIONNEL;BAC PRO PROD;BAC PRO 23407 TECHNIC.FAB.BOIS ET MATERX ASSOC;1;1;1;0;0;0;0;1;0;0;0;1;0;0
3553.0;2021;22;LIMOGES;MASCULIN;INDIVIDUEL;BAC TECHNOLOGIQUE;BAC STMG;BAC STMG GESTION ET FINANCE;1;1;1;0;0;0;0;1;0;0;1;0;0;0
3554.0;2021;22;LIMOGES;MASCULIN;INDIVIDUEL;BAC TECHNOLOGIQUE;BAC STMG;BAC STMG MERCATIQUE (MARKETING);2;1;0;1;0;0;0;0;0;0;0;0;0;1
3555.0;2021;22;LIMOGES;MASCULIN;INDIVIDUEL;BAC TECHNOLOGIQUE;BAC STMG;BAC STMG RESSOURCES HUMAINES ET COMMUNICATION;1;0;0;0;0;0;0;0;0;0;0;0;0;0
3558.0;2021;22;LIMOGES;MASCULIN;SCOLAIRE;BAC PROFESSIONNEL;BAC PRO PROD;BAC PRO 22004 PROC. CHIMIE EAU PAPIERS-CARTONS;7;7;3;4;0;0;0;3;0;0;1;0;2;4
3566.0;2021;22;LIMOGES;MASCULIN;SCOLAIRE;BAC PROFESSIONNEL;BAC PRO PROD;BAC PRO 23203 TECHNICIEN BAT. : ORG.REAL.GROS O;2;2;2;0;0;0;0;2;0;0;0;2;0;0
3580.0;2021;22;LIMOGES;MASCULIN;SCOLAIRE;BAC PROFESSIONNEL;BAC PRO PROD;BAC PRO 25219 MAINT.MATERIELS OPT.A AGRICOLES;22;22;20;1;1;1;0;21;0;0;5;11;5;1
3583.0;2021;22;LIMOGES;MASCULIN;SCOLAIRE;BAC PROFESSIONNEL;BAC PRO PROD;BAC PRO 25408 REPARATION DES CARROSSERIES;13;13;11;0;2;1;1;12;0;0;2;4;6;1
3586.0;2021;22;LIMOGES;MASCULIN;SCOLAIRE;BAC PROFESSIONNEL;BAC PRO PROD;BAC PRO 25509 TECHNIC. FROID CONDITIONNEMT AIR;5;5;4;1;0;0;0;4;0;0;1;1;2;1
3590.0;2021;22;LIMOGES;MASCULIN;SCOLAIRE;BAC PROFESSIONNEL;BAC PRO PROD;BAC PRO AG 21001 AGRO-EQUIPEMENT;16;16;16;0;0;0;0;16;0;1;0;7;8;0
3591.0;2021;22;LIMOGES;MASCULIN;SCOLAIRE;BAC PROFESSIONNEL;BAC PRO PROD;BAC PRO AG 21004 CGEA;64;63;50;13;0;0;0;50;0;2;10;17;21;13
3592.0;2021;22;LIMOGES;MASCULIN;SCOLAIRE;BAC PROFESSIONNEL;BAC PRO PROD;BAC PRO AG 21114 CONDUITE PRODUCTIONS HORTICOLES;6;6;6;0;0;0;0;6;0;0;1;1;4;0
3606.0;2021;22;LIMOGES;MASCULIN;SCOLAIRE;BAC PROFESSIONNEL;BAC PRO SERV;BAC PRO 31206 VENTE (PROSPECT.NEGO.SUIV.CLIENT;19;19;17;1;1;1;0;18;0;0;2;12;4;1
3617.0;2021;22;LIMOGES;MASCULIN;SCOLAIRE;BAC PROFESSIONNEL;BAC PRO SERV;BAC PRO 34403 METIERS DE LA SECURITE;30;30;25;4;1;1;0;26;0;0;7;11;8;4
3619.0;2021;22;LIMOGES;MASCULIN;SCOLAIRE;BAC TECHNOLOGIQUE;BAC ST2S;BAC ST2S SCIENCES & TECHNO. SANTE & SOCIAL;45;44;36;1;7;5;2;41;0;0;3;10;28;3
3620.0;2021;22;LIMOGES;MASCULIN;SCOLAIRE;BAC TECHNOLOGIQUE;BAC STAV;BAC STAV AGRONOMIE ALIM ENV TERRITOI;53;53;52;1;0;0;0;52;0;1;6;23;22;1
3626.0;2021;22;LIMOGES;MASCULIN;SCOLAIRE;BAC TECHNOLOGIQUE;BAC STI2D;BAC STI2D SYSTÈME D'INFORMATION  ET NUMERIQUE;55;55;52;1;2;1;1;53;0;1;7;22;23;2
3628.0;2021;22;LIMOGES;MASCULIN;SCOLAIRE;BAC TECHNOLOGIQUE;BAC STL;BAC STL SCIENCES PHYSIQUES CHIMIQUES  EN LABORAT.;11;11;11;0;0;0;0;11;0;0;1;8;2;0
3629.0;2021;22;LIMOGES;MASCULIN;SCOLAIRE;BAC TECHNOLOGIQUE;BAC STMG;BAC STMG GESTION ET FINANCE;48;48;44;0;4;2;2;46;0;0;3;25;18;2
3639.0;2021;10;LYON;FEMININ;APPRENTISSAGE;BAC PROFESSIONNEL;BAC PRO PROD;BACPRO 23103 TECHNICIEN GEOMETRE-TOPOGRAPHE;1;1;1;0;0;0;0;1;0;0;0;0;1;0
3642.0;2021;10;LYON;FEMININ;APPRENTISSAGE;BAC PROFESSIONNEL;BAC PRO PROD;BAC PRO 23407 TECHNIC.FAB.BOIS ET MATERX ASSOC;2;2;2;0;0;0;0;2;0;1;0;1;0;0
3644.0;2021;10;LYON;FEMININ;APPRENTISSAGE;BAC PROFESSIONNEL;BAC PRO PROD;BAC PRO 25106 TECHNICIEN D'USINAGE;3;3;3;0;0;0;0;3;0;0;0;2;1;0
3650.0;2021;10;LYON;FEMININ;APPRENTISSAGE;BAC PROFESSIONNEL;BAC PRO PROD;BAC PRO 25410 CONSTRUCTION DES CARROSSERIES;1;1;1;0;0;0;0;1;0;1;0;0;0;0
3651.0;2021;10;LYON;FEMININ;APPRENTISSAGE;BAC PROFESSIONNEL;BAC PRO PROD;BAC PRO 25510 METIERS ELECT. ENVIRON. CONNECTES;2;2;2;0;0;0;0;2;0;1;0;1;0;0
3658.0;2021;10;LYON;FEMININ;APPRENTISSAGE;BAC PROFESSIONNEL;BAC PRO PROD;BAC PRO AG 21405 AMENAGEMENTS PAYSAGERS;2;2;2;0;0;0;0;2;0;1;1;0;0;0
3660.0;2021;10;LYON;FEMININ;APPRENTISSAGE;BAC PROFESSIONNEL;BAC PRO SERV;BAC PRO 30001 GESTION-ADMINISTRATION;24;23;22;0;1;1;0;23;0;2;7;8;6;0
3672.0;2021;10;LYON;FEMININ;ENSEIGNEMENT A DISTANCE;BAC TECHNOLOGIQUE;BAC ST2S;BAC ST2S SCIENCES & TECHNO. SANTE & SOCIAL;5;5;5;0;0;0;0;5;0;2;1;1;1;0
3673.0;2021;10;LYON;FEMININ;ENSEIGNEMENT A DISTANCE;BAC TECHNOLOGIQUE;BAC STMG;BAC STMG GESTION ET FINANCE;2;2;2;0;0;0;0;2;0;0;0;2;0;0
3678.0;2021;10;LYON;FEMININ;FORMATION CONTINUE;BAC PROFESSIONNEL;BAC PRO PROD;BAC PRO 25510 METIERS ELECT. ENVIRON. CONNECTES;1;1;1;0;0;0;0;1;0;1;0;0;0;0
3683.0;2021;10;LYON;FEMININ;INDIVIDUEL;BAC GENERAL;BAC GENERAL;BAC GENE 10019 BAC GENERAL;157;109;57;36;16;5;11;62;0;5;5;15;37;47
3685.0;2021;10;LYON;FEMININ;INDIVIDUEL;BAC PROFESSIONNEL;BAC PRO PROD;BAC PRO AG 21114 CONDUITE PRODUCTIONS HORTICOLES;7;3;3;0;0;0;0;3;0;0;0;0;3;0
3695.0;2021;10;LYON;FEMININ;INDIVIDUEL;BAC PROFESSIONNEL;BAC PRO SERV;BAC PRO 33403 COMMERC. SERVICES EN RESTAURATION;2;0;0;0;0;0;0;0;0;0;0;0;0;0
3705.0;2021;10;LYON;FEMININ;INDIVIDUEL;BAC TECHNOLOGIQUE;BAC STMG;BAC STMG MERCATIQUE (MARKETING);15;7;2;1;4;4;0;6;0;0;0;1;5;1
3711.0;2021;10;LYON;FEMININ;SCOLAIRE;BAC PROFESSIONNEL;BAC PRO PROD;BAC PRO 22106 CUISINE;40;39;35;2;2;2;0;37;0;5;15;8;9;2
3719.0;2021;10;LYON;FEMININ;SCOLAIRE;BAC PROFESSIONNEL;BAC PRO PROD;BAC PRO 23408 Etude et réalisation d'agencement;26;26;24;2;0;0;0;24;0;1;5;10;8;2
3721.0;2021;10;LYON;FEMININ;SCOLAIRE;BAC PROFESSIONNEL;BAC PRO PROD;BAC PRO 24202 ARTIS.& MET.ART : TAPIS.D'AMEUBL;7;7;6;1;0;0;0;6;0;0;3;1;2;1
3730.0;2021;10;LYON;FEMININ;SCOLAIRE;BAC PROFESSIONNEL;BAC PRO PROD;BAC PRO 25219 MAINT.MATERIELS OPT.A AGRICOLES;2;2;1;1;0;0;0;1;0;0;0;1;0;1
3736.0;2021;10;LYON;FEMININ;SCOLAIRE;BAC PROFESSIONNEL;BAC PRO PROD;BAC PRO 25515 SYST.NUM.OPT.C RES.INF.SYST.COMM.;12;12;9;0;3;2;1;11;0;0;2;3;6;1
3749.0;2021;10;LYON;FEMININ;SCOLAIRE;BAC PROFESSIONNEL;BAC PRO PROD;BAC PRO AG 22107 TEC CONS VTE ALIMENTATION P.ALIM;38;38;38;0;0;0;0;38;0;1;3;23;11;0
3752.0;2021;10;LYON;FEMININ;SCOLAIRE;BAC PROFESSIONNEL;BAC PRO SERV;BAC PRO 31107 CONDUCT. TRANSP.ROUT.MARCHANDISES;5;5;4;1;0;0;0;4;0;1;1;2;0;1
3760.0;2021;10;LYON;FEMININ;SCOLAIRE;BAC PROFESSIONNEL;BAC PRO SERV;BAC PRO 32304 PHOTOGRAPHIE;23;23;17;6;0;0;0;17;0;0;5;6;6;6
3761.0;2021;10;LYON;FEMININ;SCOLAIRE;BAC PROFESSIONNEL;BAC PRO SERV;BAC PRO 33002 SERVICES DE PROXIMITE  VIE LOCAL;42;41;35;2;4;1;3;36;0;1;7;13;15;5
3768.0;2021;10;LYON;FEMININ;SCOLAIRE;BAC PROFESSIONNEL;BAC PRO SERV;BAC PRO 33603 ESTHETIQUE COSMETIQUE PARFUMERIE;175;175;163;10;2;2;0;165;0;4;41;60;60;10
3776.0;2021;10;LYON;FEMININ;SCOLAIRE;BAC TECHNOLOGIQUE;BAC STD2A;BAC STD2A SCIENCES & TECHNO. DESIGN-ARTS APPLIQUES;126;126;125;0;1;0;1;125;0;5;46;51;23;1
3780.0;2021;10;LYON;FEMININ;SCOLAIRE;BAC TECHNOLOGIQUE;BAC STI2D;BAC STI2D INNOVATION TECHNO.  ET ECO CONCEPTION;37;37;36;0;1;0;1;36;1;2;11;13;9;1
3783.0;2021;10;LYON;FEMININ;SCOLAIRE;BAC TECHNOLOGIQUE;BAC STL;BAC STL SCIENCES PHYSIQUES CHIMIQUES  EN LABORAT.;90;90;80;1;9;5;4;85;0;6;22;27;30;5
3789.0;2021;10;LYON;MASCULIN;APPRENTISSAGE;BAC PROFESSIONNEL;BAC PRO PROD;BAC PRO 22003 BIO-INDUSTRIES DE TRANSFORMATION;11;11;6;2;3;0;3;6;0;0;3;1;2;5
3796.0;2021;10;LYON;MASCULIN;APPRENTISSAGE;BAC PROFESSIONNEL;BAC PRO PROD;BAC PRO 22704 TECHN. MAINT. SYST.ENERG.CLIMATI;24;23;23;0;0;0;0;23;0;4;5;10;4;0
3801.0;2021;10;LYON;MASCULIN;APPRENTISSAGE;BAC PROFESSIONNEL;BAC PRO PROD;BAC PRO 23303 MENUISERIE ALUMINIUM-VERRE;13;13;8;5;0;0;0;8;0;0;3;4;1;5
3802.0;2021;10;LYON;MASCULIN;APPRENTISSAGE;BAC PROFESSIONNEL;BAC PRO PROD;BAC PRO 23304 AMENAGEMENT FINITION BATIMENT;6;6;6;0;0;0;0;6;0;0;1;2;3;0
3804.0;2021;10;LYON;MASCULIN;APPRENTISSAGE;BAC PROFESSIONNEL;BAC PRO PROD;BAC PRO 23405 TECHNICIEN MENUISIER AGENCEUR;28;27;26;0;1;1;0;27;0;5;12;5;5;0
3806.0;2021;10;LYON;MASCULIN;APPRENTISSAGE;BAC PROFESSIONNEL;BAC PRO PROD;BAC PRO 24202 ARTIS.& MET.ART : TAPIS.D'AMEUBL;1;1;1;0;0;0;0;1;0;1;0;0;0;0
3808.0;2021;10;LYON;MASCULIN;APPRENTISSAGE;BAC PROFESSIONNEL;BAC PRO PROD;BAC PRO 25106 TECHNICIEN D'USINAGE;24;24;19;2;3;2;1;21;0;1;3;8;9;3
3810.0;2021;10;LYON;MASCULIN;APPRENTISSAGE;BAC PROFESSIONNEL;BAC PRO PROD;BAC PRO 25214 MAINT.VEHIC.OPTA VOIT.PARTICUL.;131;130;102;24;4;3;1;105;0;11;28;31;35;25
3811.0;2021;10;LYON;MASCULIN;APPRENTISSAGE;BAC PROFESSIONNEL;BAC PRO PROD;BAC PRO 25215 MAINT.VEHIC.OPTB VEHIC.TRANS.ROUT;3;3;3;0;0;0;0;3;0;1;0;1;1;0
3814.0;2021;10;LYON;MASCULIN;APPRENTISSAGE;BAC PROFESSIONNEL;BAC PRO PROD;BAC PRO 25220 MAINT.MATERIELS OPT.B TP MANUT.;20;20;18;1;1;1;0;19;0;1;3;8;7;1
3819.0;2021;10;LYON;MASCULIN;APPRENTISSAGE;BAC PROFESSIONNEL;BAC PRO PROD;BAC PRO 25411 TECH.CHAUDRONNERIE INDUSTRIELLE;55;55;49;4;2;2;0;51;0;3;14;17;17;4
3830.0;2021;10;LYON;MASCULIN;APPRENTISSAGE;BAC PROFESSIONNEL;BAC PRO PROD;BAC PRO AG 21405 AMENAGEMENTS PAYSAGERS;63;61;57;4;0;0;0;57;0;1;5;26;25;4
3839.0;2021;10;LYON;MASCULIN;APPRENTISSAGE;BAC PROFESSIONNEL;BAC PRO SERV;BAC PRO 32303 ART.& MET.ART:COM.VIS.VIS.PLURI-M;6;6;5;1;0;0;0;5;0;0;0;3;2;1
3840.0;2021;10;LYON;MASCULIN;APPRENTISSAGE;BAC PROFESSIONNEL;BAC PRO SERV;BAC PRO 33102 PROTHESE DENTAIRE;3;2;1;1;0;0;0;1;0;0;0;0;1;1
3841.0;2021;10;LYON;MASCULIN;APPRENTISSAGE;BAC PROFESSIONNEL;BAC PRO SERV;BAC PRO 33403 COMMERC. SERVICES EN RESTAURATION;7;7;3;2;2;2;0;5;0;0;1;1;3;2
3846.0;2021;10;LYON;MASCULIN;ENSEIGNEMENT A DISTANCE;BAC TECHNOLOGIQUE;BAC STMG;BAC STMG MERCATIQUE (MARKETING);7;7;7;0;0;0;0;7;0;1;4;2;0;0
3849.0;2021;10;LYON;MASCULIN;FORMATION CONTINUE;BAC PROFESSIONNEL;BAC PRO PROD;BAC PRO 22004 PROC. CHIMIE EAU PAPIERS-CARTONS;5;5;5;0;0;0;0;5;0;4;1;0;0;0
3854.0;2021;10;LYON;MASCULIN;FORMATION CONTINUE;BAC PROFESSIONNEL;BAC PRO PROD;BAC PRO 24303 MET. DU CUIR: SELLERIE GARNISSAGE;2;1;1;0;0;0;0;1;0;0;1;0;0;0
3857.0;2021;10;LYON;MASCULIN;FORMATION CONTINUE;BAC PROFESSIONNEL;BAC PRO SERV;BAC PRO 30001 GESTION-ADMINISTRATION;1;1;1;0;0;0;0;1;0;0;1;0;0;0
3862.0;2021;10;LYON;MASCULIN;INDIVIDUEL;BAC PROFESSIONNEL;BAC PRO PROD;BAC PRO 22106 CUISINE;2;0;0;0;0;0;0;0;0;0;0;0;0;0
3865.0;2021;10;LYON;MASCULIN;INDIVIDUEL;BAC PROFESSIONNEL;BAC PRO PROD;BAC PRO 23004 TECHN. ETUDES BAT.A ETUDES & ECO.;2;0;0;0;0;0;0;0;0;0;0;0;0;0
3870.0;2021;10;LYON;MASCULIN;INDIVIDUEL;BAC PROFESSIONNEL;BAC PRO PROD;BAC PRO 25411 TECH.CHAUDRONNERIE INDUSTRIELLE;1;0;0;0;0;0;0;0;0;0;0;0;0;0
3883.0;2021;10;LYON;MASCULIN;INDIVIDUEL;BAC PROFESSIONNEL;BAC PRO SERV;BAC PRO 31202 COMMERCE;4;3;1;1;1;1;0;2;0;0;1;0;1;1
3886.0;2021;10;LYON;MASCULIN;INDIVIDUEL;BAC PROFESSIONNEL;BAC PRO SERV;BAC PRO 32207 REAL.PR.IMPR.PLURI.OPTA.PR.GRAPH.;1;1;1;0;0;0;0;1;0;0;0;0;1;0
3892.0;2021;10;LYON;MASCULIN;INDIVIDUEL;BAC TECHNOLOGIQUE;BAC ST2S;BAC ST2S SCIENCES & TECHNO. SANTE & SOCIAL;6;4;2;1;1;1;0;3;0;0;0;0;3;1
3893.0;2021;10;LYON;MASCULIN;INDIVIDUEL;BAC TECHNOLOGIQUE;BAC STAV;BAC STAV AGRONOMIE ALIM ENV TERRITOI;1;0;0;0;0;0;0;0;0;0;0;0;0;0
3899.0;2021;10;LYON;MASCULIN;INDIVIDUEL;BAC TECHNOLOGIQUE;BAC STL;BAC STL BIOCHIM.-BIOLOGIE-BIOTECHNOL.;1;0;0;0;0;0;0;0;0;0;0;0;0;0
3905.0;2021;10;LYON;MASCULIN;SCOLAIRE;BAC GENERAL;BAC GENERAL;BAC GENE 10019 BAC GENERAL;8193;8192;7751;71;370;235;135;7986;103;784;1795;2869;2435;206
3907.0;2021;10;LYON;MASCULIN;SCOLAIRE;BAC PROFESSIONNEL;BAC PRO PROD;BAC PRO 20102 PILOTE DE LIGNE DE PRODUCTION;23;22;13;5;4;3;1;16;0;0;2;6;8;6
3916.0;2021;10;LYON;MASCULIN;SCOLAIRE;BAC PROFESSIONNEL;BAC PRO PROD;BAC PRO 22704 TECHN. MAINT. SYST.ENERG.CLIMATI;45;45;29;11;5;2;3;31;0;0;8;12;11;14
3917.0;2021;10;LYON;MASCULIN;SCOLAIRE;BAC PROFESSIONNEL;BAC PRO PROD;BAC PRO 23003 ARTIS. & M.ART:MARCHANDISAGE VIS.;8;8;7;0;1;0;1;7;0;0;1;5;1;1
3938.0;2021;10;LYON;MASCULIN;SCOLAIRE;BAC PROFESSIONNEL;BAC PRO PROD;BAC PRO 25108 TECHNICIEN MODELEUR;2;2;1;1;0;0;0;1;0;0;0;0;1;1
3945.0;2021;10;LYON;MASCULIN;SCOLAIRE;BAC PROFESSIONNEL;BAC PRO PROD;BAC PRO 25408 REPARATION DES CARROSSERIES;61;61;40;13;8;6;2;46;0;1;8;13;24;15
3954.0;2021;10;LYON;MASCULIN;SCOLAIRE;BAC PROFESSIONNEL;BAC PRO PROD;BAC PRO AG 21004 CGEA;80;80;72;8;0;0;0;72;0;2;14;28;28;8
3966.0;2021;10;LYON;MASCULIN;SCOLAIRE;BAC PROFESSIONNEL;BAC PRO PROD;BAC PRO AG 22105 LABORATOIRE CONTROLE QUALITE;20;20;18;2;0;0;0;18;0;0;1;7;10;2
3971.0;2021;10;LYON;MASCULIN;SCOLAIRE;BAC PROFESSIONNEL;BAC PRO SERV;BAC PRO 31108 TRANSPORT;76;76;51;20;5;4;1;55;0;1;10;15;29;21
3973.0;2021;10;LYON;MASCULIN;SCOLAIRE;BAC PROFESSIONNEL;BAC PRO SERV;BAC PRO 31206 VENTE (PROSPECT.NEGO.SUIV.CLIENT;134;133;118;7;8;5;3;123;0;2;19;58;44;10
3974.0;2021;10;LYON;MASCULIN;SCOLAIRE;BAC PROFESSIONNEL;BAC PRO SERV;BAC PRO 31210 ACCUEIL -RELATION CLIENTS USAGERS;75;75;62;10;3;2;1;64;0;2;10;25;27;11
3978.0;2021;10;LYON;MASCULIN;SCOLAIRE;BAC PROFESSIONNEL;BAC PRO SERV;BAC PRO 32304 PHOTOGRAPHIE;8;8;4;3;1;0;1;4;0;0;1;2;1;4
3981.0;2021;10;LYON;MASCULIN;SCOLAIRE;BAC PROFESSIONNEL;BAC PRO SERV;BAC PRO 33004 ACC.SOINS-S.PERS. OPT.EN STRUCTUR;36;36;32;1;3;3;0;35;0;1;9;13;12;1
3983.0;2021;10;LYON;MASCULIN;SCOLAIRE;BAC PROFESSIONNEL;BAC PRO SERV;BAC PRO 33102 PROTHESE DENTAIRE;21;21;13;6;2;1;1;14;0;0;5;6;3;7
3987.0;2021;10;LYON;MASCULIN;SCOLAIRE;BAC PROFESSIONNEL;BAC PRO SERV;BAC PRO 34304 HYGIENE PROPRETE STERILISATION;6;6;4;2;0;0;0;4;0;0;0;3;1;2
3996.0;2021;10;LYON;MASCULIN;SCOLAIRE;BAC TECHNOLOGIQUE;BAC STI2D;BAC STI2D ARCHITECTURE ET CONSTRUCTION;327;327;314;2;11;6;5;320;0;9;60;129;122;7
3998.0;2021;10;LYON;MASCULIN;SCOLAIRE;BAC TECHNOLOGIQUE;BAC STI2D;BAC STI2D INNOVATION TECHNO.  ET ECO CONCEPTION;515;515;467;8;40;22;18;489;0;14;72;212;191;26
3999.0;2021;10;LYON;MASCULIN;SCOLAIRE;BAC TECHNOLOGIQUE;BAC STI2D;BAC STI2D SYSTÈME D'INFORMATION  ET NUMERIQUE;552;552;511;9;32;23;9;534;1;19;86;217;211;18
4021.0;2021;31;MARTINIQUE;FEMININ;INDIVIDUEL;BAC TECHNOLOGIQUE;BAC STMG;BAC STMG GESTION ET FINANCE;1;1;1;0;0;0;0;1;0;0;0;0;1;0
4026.0;2021;31;MARTINIQUE;FEMININ;SCOLAIRE;BAC PROFESSIONNEL;BAC PRO PROD;BAC PRO 22105 BOULANGER-PÂTISSIER;27;26;21;4;1;1;0;22;0;0;1;11;10;4
4032.0;2021;31;MARTINIQUE;FEMININ;SCOLAIRE;BAC PROFESSIONNEL;BAC PRO PROD;BAC PRO 23203 TECHNICIEN BAT. : ORG.REAL.GROS O;1;1;0;1;0;0;0;0;0;0;0;0;0;1
4035.0;2021;31;MARTINIQUE;FEMININ;SCOLAIRE;BAC PROFESSIONNEL;BAC PRO PROD;BAC PRO 23408 Etude et réalisation d'agencement;2;2;2;0;0;0;0;2;0;0;0;2;0;0
4040.0;2021;31;MARTINIQUE;FEMININ;SCOLAIRE;BAC PROFESSIONNEL;BAC PRO PROD;BAC PRO 25408 REPARATION DES CARROSSERIES;2;2;2;0;0;0;0;2;0;1;0;1;0;0
4042.0;2021;31;MARTINIQUE;FEMININ;SCOLAIRE;BAC PROFESSIONNEL;BAC PRO PROD;BAC PRO 25514 SYST.NUM.OPT.B AUD.RES.EQUIP.DOM.;1;1;0;0;1;1;0;1;0;0;0;0;1;0
4055.0;2021;31;MARTINIQUE;FEMININ;SCOLAIRE;BAC PROFESSIONNEL;BAC PRO SERV;BAC PRO 33002 SERVICES DE PROXIMITE  VIE LOCAL;21;21;18;2;1;1;0;19;0;0;1;6;12;2
4057.0;2021;31;MARTINIQUE;FEMININ;SCOLAIRE;BAC PROFESSIONNEL;BAC PRO SERV;BAC PRO 33004 ACC.SOINS-S.PERS. OPT.EN STRUCTUR;94;94;83;8;3;2;1;85;0;1;12;42;30;9
4059.0;2021;31;MARTINIQUE;FEMININ;SCOLAIRE;BAC PROFESSIONNEL;BAC PRO SERV;BAC PRO 33603 ESTHETIQUE COSMETIQUE PARFUMERIE;23;23;23;0;0;0;0;23;0;0;2;7;14;0
4060.0;2021;31;MARTINIQUE;FEMININ;SCOLAIRE;BAC PROFESSIONNEL;BAC PRO SERV;BAC PRO 34303 GEST. POLLUTIONS PROTEC. ENVIRON.;3;3;2;1;0;0;0;2;0;0;1;0;1;1
4064.0;2021;31;MARTINIQUE;FEMININ;SCOLAIRE;BAC TECHNOLOGIQUE;BAC STAV;BAC STAV AGRONOMIE ALIM ENV TERRITOI;5;5;5;0;0;0;0;5;0;0;1;2;2;0
4077.0;2021;31;MARTINIQUE;MASCULIN;APPRENTISSAGE;BAC PROFESSIONNEL;BAC PRO PROD;BAC PRO 22106 CUISINE;5;5;3;1;1;1;0;4;0;0;0;1;3;1
4078.0;2021;31;MARTINIQUE;MASCULIN;APPRENTISSAGE;BAC PROFESSIONNEL;BAC PRO PROD;BAC PRO 22703 TECHN.INSTALL.SYST.ENERG.CLIMATI;2;2;2;0;0;0;0;2;0;0;1;0;1;0
4083.0;2021;31;MARTINIQUE;MASCULIN;APPRENTISSAGE;BAC PROFESSIONNEL;BAC PRO PROD;BAC PRO 23405 TECHNICIEN MENUISIER AGENCEUR;1;1;1;0;0;0;0;1;0;0;0;0;1;0
4087.0;2021;31;MARTINIQUE;MASCULIN;APPRENTISSAGE;BAC PROFESSIONNEL;BAC PRO SERV;BAC PRO 31106 LOGISTIQUE;9;8;5;0;3;3;0;8;0;0;1;2;5;0
4089.0;2021;31;MARTINIQUE;MASCULIN;APPRENTISSAGE;BAC PROFESSIONNEL;BAC PRO SERV;BAC PRO 31210 ACCUEIL -RELATION CLIENTS USAGERS;1;1;1;0;0;0;0;1;0;0;0;1;0;0
4092.0;2021;31;MARTINIQUE;MASCULIN;ENSEIGNEMENT A DISTANCE;BAC TECHNOLOGIQUE;BAC ST2S;BAC ST2S SCIENCES & TECHNO. SANTE & SOCIAL;1;1;1;0;0;0;0;1;0;0;1;0;0;0
4097.0;2021;31;MARTINIQUE;MASCULIN;INDIVIDUEL;BAC PROFESSIONNEL;BAC PRO PROD;BAC PRO 23405 TECHNICIEN MENUISIER AGENCEUR;1;0;0;0;0;0;0;0;0;0;0;0;0;0
4102.0;2021;31;MARTINIQUE;MASCULIN;INDIVIDUEL;BAC PROFESSIONNEL;BAC PRO SERV;BAC PRO 31202 COMMERCE;2;1;1;0;0;0;0;1;0;0;0;0;1;0
4103.0;2021;31;MARTINIQUE;MASCULIN;INDIVIDUEL;BAC TECHNOLOGIQUE;BAC ST2S;BAC ST2S SCIENCES & TECHNO. SANTE & SOCIAL;1;0;0;0;0;0;0;0;0;0;0;0;0;0
4108.0;2021;31;MARTINIQUE;MASCULIN;SCOLAIRE;BAC GENERAL;BAC GENERAL;BAC GENE 10019 BAC GENERAL;855;854;782;8;64;54;10;836;9;51;181;283;312;18
4111.0;2021;31;MARTINIQUE;MASCULIN;SCOLAIRE;BAC PROFESSIONNEL;BAC PRO PROD;BAC PRO 22105 BOULANGER-PÂTISSIER;19;19;14;5;0;0;0;14;0;0;0;7;7;5
4113.0;2021;31;MARTINIQUE;MASCULIN;SCOLAIRE;BAC PROFESSIONNEL;BAC PRO PROD;BAC PRO 22703 TECHN.INSTALL.SYST.ENERG.CLIMATI;12;12;7;3;2;1;1;8;0;0;1;3;4;4
4119.0;2021;31;MARTINIQUE;MASCULIN;SCOLAIRE;BAC PROFESSIONNEL;BAC PRO PROD;BACPRO 23103 TECHNICIEN GEOMETRE-TOPOGRAPHE;11;11;11;0;0;0;0;11;0;1;0;5;5;0
4125.0;2021;31;MARTINIQUE;MASCULIN;SCOLAIRE;BAC PROFESSIONNEL;BAC PRO PROD;BAC PRO 23408 Etude et réalisation d'agencement;2;2;2;0;0;0;0;2;0;0;0;0;2;0
4130.0;2021;31;MARTINIQUE;MASCULIN;SCOLAIRE;BAC PROFESSIONNEL;BAC PRO PROD;BAC PRO 25214 MAINT.VEHIC.OPTA VOIT.PARTICUL.;66;66;52;8;6;6;0;58;0;1;5;24;28;8
4132.0;2021;31;MARTINIQUE;MASCULIN;SCOLAIRE;BAC PROFESSIONNEL;BAC PRO PROD;BAC PRO 25220 MAINT.MATERIELS OPT.B TP MANUT.;10;10;8;2;0;0;0;8;0;0;1;3;4;2
4136.0;2021;31;MARTINIQUE;MASCULIN;SCOLAIRE;BAC PROFESSIONNEL;BAC PRO PROD;BAC PRO 25509 TECHNIC. FROID CONDITIONNEMT AIR;4;4;4;0;0;0;0;4;0;1;0;2;1;0
4144.0;2021;31;MARTINIQUE;MASCULIN;SCOLAIRE;BAC PROFESSIONNEL;BAC PRO PROD;BAC PRO AG 21405 AMENAGEMENTS PAYSAGERS;12;12;12;0;0;0;0;12;0;0;3;5;4;0
4149.0;2021;31;MARTINIQUE;MASCULIN;SCOLAIRE;BAC PROFESSIONNEL;BAC PRO SERV;BAC PRO 31202 COMMERCE;62;62;47;6;9;5;4;52;0;2;7;23;20;10
4159.0;2021;31;MARTINIQUE;MASCULIN;SCOLAIRE;BAC PROFESSIONNEL;BAC PRO SERV;BAC PRO AG 33002 SERV PERS TERRIT;2;2;2;0;0;0;0;2;0;0;0;0;2;0
4178.0;2021;43;MAYOTTE;FEMININ;INDIVIDUEL;BAC PROFESSIONNEL;BAC PRO SERV;BAC PRO 30001 GESTION-ADMINISTRATION;2;1;0;1;0;0;0;0;0;0;0;0;0;1
4188.0;2021;43;MAYOTTE;FEMININ;SCOLAIRE;BAC GENERAL;BAC GENERAL;BAC GENE 10019 BAC GENERAL;1295;1295;970;67;258;164;94;1134;2;37;136;367;592;161
4194.0;2021;43;MAYOTTE;FEMININ;SCOLAIRE;BAC PROFESSIONNEL;BAC PRO PROD;BAC PRO 25510 METIERS ELECT. ENVIRON. CONNECTES;3;3;2;1;0;0;0;2;0;0;0;0;2;1
4199.0;2021;43;MAYOTTE;FEMININ;SCOLAIRE;BAC PROFESSIONNEL;BAC PRO SERV;BAC PRO 31106 LOGISTIQUE;6;6;3;1;2;2;0;5;0;0;0;1;4;1
4203.0;2021;43;MAYOTTE;FEMININ;SCOLAIRE;BAC PROFESSIONNEL;BAC PRO SERV;BAC PRO 31210 ACCUEIL -RELATION CLIENTS USAGERS;105;105;61;20;24;14;10;75;0;1;3;16;55;30
4208.0;2021;43;MAYOTTE;FEMININ;SCOLAIRE;BAC PROFESSIONNEL;BAC PRO SERV;BAC PRO 33403 COMMERC. SERVICES EN RESTAURATION;17;17;9;4;4;2;2;11;0;0;1;4;6;6
4220.0;2021;43;MAYOTTE;FEMININ;SCOLAIRE;BAC TECHNOLOGIQUE;BAC STMG;BAC STMG MERCATIQUE (MARKETING);216;216;110;28;78;49;29;159;0;0;4;23;132;57
4222.0;2021;43;MAYOTTE;MASCULIN;APPRENTISSAGE;BAC PROFESSIONNEL;BAC PRO PROD;BAC PRO 23102 TRAVAUX PUBLICS;14;13;4;5;4;4;0;8;0;0;0;0;8;5
4229.0;2021;43;MAYOTTE;MASCULIN;INDIVIDUEL;BAC PROFESSIONNEL;BAC PRO PROD;BAC PRO 25513 SYST.NUM.OPT.A SURETE SECURITE;1;1;0;1;0;0;0;0;0;0;0;0;0;1
4231.0;2021;43;MAYOTTE;MASCULIN;INDIVIDUEL;BAC TECHNOLOGIQUE;BAC ST2S;BAC ST2S SCIENCES & TECHNO. SANTE & SOCIAL;2;1;0;1;0;0;0;0;0;0;0;0;0;1
4235.0;2021;43;MAYOTTE;MASCULIN;INDIVIDUEL;BAC TECHNOLOGIQUE;BAC STL;BAC STL SCIENCES PHYSIQUES CHIMIQUES  EN LABORAT.;1;1;0;0;1;1;0;1;0;0;0;0;1;0
4239.0;2021;43;MAYOTTE;MASCULIN;SCOLAIRE;BAC GENERAL;BAC GENERAL;BAC GENE 10019 BAC GENERAL;723;723;519;55;149;91;58;610;3;19;74;171;343;113
4256.0;2021;43;MAYOTTE;MASCULIN;SCOLAIRE;BAC PROFESSIONNEL;BAC PRO PROD;BAC PRO 25509 TECHNIC. FROID CONDITIONNEMT AIR;15;15;6;8;1;1;0;7;0;0;0;0;7;8
4264.0;2021;43;MAYOTTE;MASCULIN;SCOLAIRE;BAC PROFESSIONNEL;BAC PRO SERV;BAC PRO 31106 LOGISTIQUE;27;27;7;11;9;9;0;16;0;0;3;1;12;11
4270.0;2021;43;MAYOTTE;MASCULIN;SCOLAIRE;BAC PROFESSIONNEL;BAC PRO SERV;BAC PRO 33002 SERVICES DE PROXIMITE  VIE LOCAL;10;10;2;5;3;1;2;3;0;0;1;0;2;7
4273.0;2021;43;MAYOTTE;MASCULIN;SCOLAIRE;BAC PROFESSIONNEL;BAC PRO SERV;BAC PRO 33403 COMMERC. SERVICES EN RESTAURATION;7;7;5;1;1;1;0;6;0;0;0;2;4;1
4275.0;2021;43;MAYOTTE;MASCULIN;SCOLAIRE;BAC PROFESSIONNEL;BAC PRO SERV;BAC PRO AG 33002 SERV PERS TERRIT;3;3;3;0;0;0;0;3;0;0;0;2;1;0
4278.0;2021;43;MAYOTTE;MASCULIN;SCOLAIRE;BAC TECHNOLOGIQUE;BAC STHR;BAC STHR SC.&TEC. HOTELLERIE-RESTAURATION;6;6;5;0;1;1;0;6;0;0;0;3;3;0
4279.0;2021;43;MAYOTTE;MASCULIN;SCOLAIRE;BAC TECHNOLOGIQUE;BAC STI2D;BAC STI2D ARCHITECTURE ET CONSTRUCTION;35;35;28;2;5;2;3;30;0;0;3;4;23;5
4280.0;2021;43;MAYOTTE;MASCULIN;SCOLAIRE;BAC TECHNOLOGIQUE;BAC STI2D;BAC STI2D ENERGIES  ET ENVIRONNEMENT;38;38;18;9;11;3;8;21;0;0;1;6;14;17
4287.0;2021;11;MONTPELLIER;FEMININ;APPRENTISSAGE;BAC PROFESSIONNEL;BAC PRO PROD;BAC PRO 22106 CUISINE;4;4;2;1;1;1;0;3;0;0;0;1;2;1
4288.0;2021;11;MONTPELLIER;FEMININ;APPRENTISSAGE;BAC PROFESSIONNEL;BAC PRO PROD;BAC PRO 22703 TECHN.INSTALL.SYST.ENERG.CLIMATI;1;1;1;0;0;0;0;1;0;0;1;0;0;0
4292.0;2021;11;MONTPELLIER;FEMININ;APPRENTISSAGE;BAC PROFESSIONNEL;BAC PRO PROD;BAC PRO 25216 MAINT.VEHIC.OPTC MOTOCYCLES;1;1;1;0;0;0;0;1;0;0;1;0;0;0
4294.0;2021;11;MONTPELLIER;FEMININ;APPRENTISSAGE;BAC PROFESSIONNEL;BAC PRO PROD;BAC PRO 25411 TECH.CHAUDRONNERIE INDUSTRIELLE;1;1;0;0;1;0;1;0;0;0;0;0;0;1
4296.0;2021;11;MONTPELLIER;FEMININ;APPRENTISSAGE;BAC PROFESSIONNEL;BAC PRO PROD;BAC PRO 25515 SYST.NUM.OPT.C RES.INF.SYST.COMM.;1;1;1;0;0;0;0;1;0;0;0;0;1;0
4299.0;2021;11;MONTPELLIER;FEMININ;APPRENTISSAGE;BAC PROFESSIONNEL;BAC PRO SERV;BAC PRO 30001 GESTION-ADMINISTRATION;5;5;5;0;0;0;0;5;0;0;3;2;0;0
4302.0;2021;11;MONTPELLIER;FEMININ;APPRENTISSAGE;BAC PROFESSIONNEL;BAC PRO SERV;BAC PRO 31210 ACCUEIL -RELATION CLIENTS USAGERS;4;4;4;0;0;0;0;4;0;2;0;2;0;0
4308.0;2021;11;MONTPELLIER;FEMININ;ENSEIGNEMENT A DISTANCE;BAC PROFESSIONNEL;BAC PRO SERV;BAC PRO 30001 GESTION-ADMINISTRATION;2;2;0;1;1;1;0;1;0;0;0;0;1;1
4312.0;2021;11;MONTPELLIER;FEMININ;ENSEIGNEMENT A DISTANCE;BAC PROFESSIONNEL;BAC PRO SERV;BAC PRO 33603 ESTHETIQUE COSMETIQUE PARFUMERIE;1;0;0;0;0;0;0;0;0;0;0;0;0;0
4313.0;2021;11;MONTPELLIER;FEMININ;ENSEIGNEMENT A DISTANCE;BAC TECHNOLOGIQUE;BAC ST2S;BAC ST2S SCIENCES & TECHNO. SANTE & SOCIAL;5;5;5;0;0;0;0;5;0;0;2;2;1;0
4330.0;2021;11;MONTPELLIER;FEMININ;INDIVIDUEL;BAC PROFESSIONNEL;BAC PRO PROD;BAC PRO AG 21211 COND GEST ENTR HIPPIQUE;8;4;3;1;0;0;0;3;0;0;1;0;2;1
4334.0;2021;11;MONTPELLIER;FEMININ;INDIVIDUEL;BAC PROFESSIONNEL;BAC PRO SERV;BAC PRO 31210 ACCUEIL -RELATION CLIENTS USAGERS;2;1;0;1;0;0;0;0;0;0;0;0;0;1
4339.0;2021;11;MONTPELLIER;FEMININ;INDIVIDUEL;BAC PROFESSIONNEL;BAC PRO SERV;BAC PRO AG 33002 SERV PERS TERRIT;1;1;1;0;0;0;0;1;0;0;0;0;1;0
4342.0;2021;11;MONTPELLIER;FEMININ;INDIVIDUEL;BAC TECHNOLOGIQUE;BAC STI2D;BAC STI2D ARCHITECTURE ET CONSTRUCTION;1;1;0;1;0;0;0;0;0;0;0;0;0;1
4343.0;2021;11;MONTPELLIER;FEMININ;INDIVIDUEL;BAC TECHNOLOGIQUE;BAC STMG;BAC STMG GESTION ET FINANCE;5;2;1;1;0;0;0;1;0;0;0;0;1;1
4349.0;2021;11;MONTPELLIER;FEMININ;SCOLAIRE;BAC PROFESSIONNEL;BAC PRO PROD;BAC PRO 22105 BOULANGER-PÂTISSIER;15;15;14;1;0;0;0;14;0;2;3;6;3;1
4355.0;2021;11;MONTPELLIER;FEMININ;SCOLAIRE;BAC PROFESSIONNEL;BAC PRO PROD;BAC PRO 23005 TECHN. ETUDES BAT B ASSIST.ARCHI.;11;11;7;2;2;2;0;9;0;0;1;4;4;2
4359.0;2021;11;MONTPELLIER;FEMININ;SCOLAIRE;BAC PROFESSIONNEL;BAC PRO PROD;BAC PRO 23404 TECHNICIEN CONSTRUCTEUR BOIS;3;3;3;0;0;0;0;3;0;0;0;1;2;0
4361.0;2021;11;MONTPELLIER;FEMININ;SCOLAIRE;BAC PROFESSIONNEL;BAC PRO PROD;BAC PRO 23408 Etude et réalisation d'agencement;8;8;6;2;0;0;0;6;0;0;1;4;1;2
4364.0;2021;11;MONTPELLIER;FEMININ;SCOLAIRE;BAC PROFESSIONNEL;BAC PRO PROD;BAC PRO 24302 METIERS DU CUIR : MAROQUINERIE;10;10;9;1;0;0;0;9;0;0;4;4;1;1
4365.0;2021;11;MONTPELLIER;FEMININ;SCOLAIRE;BAC PROFESSIONNEL;BAC PRO PROD;BAC PRO 24303 MET. DU CUIR: SELLERIE GARNISSAGE;21;21;16;5;0;0;0;16;0;1;4;6;5;5
4367.0;2021;11;MONTPELLIER;FEMININ;SCOLAIRE;BAC PROFESSIONNEL;BAC PRO PROD;BAC PRO 25007 MAINTENANCE EQUIPEMENTS INDUST.;4;4;3;1;0;0;0;3;0;0;1;0;2;1
4373.0;2021;11;MONTPELLIER;FEMININ;SCOLAIRE;BAC PROFESSIONNEL;BAC PRO PROD;BAC PRO 25302 AERONAUTIQUE OPTION AVIONIQUE;1;1;1;0;0;0;0;1;0;1;0;0;0;0
4378.0;2021;11;MONTPELLIER;FEMININ;SCOLAIRE;BAC PROFESSIONNEL;BAC PRO PROD;BAC PRO 25514 SYST.NUM.OPT.B AUD.RES.EQUIP.DOM.;3;3;2;1;0;0;0;2;0;0;0;0;2;1
4381.0;2021;11;MONTPELLIER;FEMININ;SCOLAIRE;BAC PROFESSIONNEL;BAC PRO PROD;BAC PRO AG 21113 CGEVV;9;9;7;2;0;0;0;7;0;0;2;0;5;2
4383.0;2021;11;MONTPELLIER;FEMININ;SCOLAIRE;BAC PROFESSIONNEL;BAC PRO PROD;BAC PRO AG 21203 TECHN CONSEIL DE VENTE ANIMAL;18;17;16;1;0;0;0;16;0;0;3;7;6;1
4388.0;2021;11;MONTPELLIER;FEMININ;SCOLAIRE;BAC PROFESSIONNEL;BAC PRO PROD;BAC PRO AG 21406 TEC CONS VTE PROD DES JARDINS;3;3;3;0;0;0;0;3;0;0;0;0;3;0
4400.0;2021;11;MONTPELLIER;FEMININ;SCOLAIRE;BAC PROFESSIONNEL;BAC PRO SERV;BAC PRO 32303 ART.& MET.ART:COM.VIS.VIS.PLURI-M;42;42;39;2;1;1;0;40;0;4;11;16;9;2
4403.0;2021;11;MONTPELLIER;FEMININ;SCOLAIRE;BAC PROFESSIONNEL;BAC PRO SERV;BAC PRO 33003 ACC.SOINS-S.PERS. OPT.A DOMICILE;95;95;87;6;2;1;1;88;0;1;17;37;33;7
4420.0;2021;11;MONTPELLIER;FEMININ;SCOLAIRE;BAC TECHNOLOGIQUE;BAC STI2D;BAC STI2D INNOVATION TECHNO.  ET ECO CONCEPTION;12;12;10;0;2;0;2;10;0;1;4;3;2;2
4422.0;2021;11;MONTPELLIER;FEMININ;SCOLAIRE;BAC TECHNOLOGIQUE;BAC STL;BAC STL BIOCHIM.-BIOLOGIE-BIOTECHNOL.;118;118;112;1;5;2;3;114;0;3;27;47;37;4
4425.0;2021;11;MONTPELLIER;FEMININ;SCOLAIRE;BAC TECHNOLOGIQUE;BAC STMG;BAC STMG MERCATIQUE (MARKETING);666;666;620;9;37;20;17;640;3;16;116;287;218;26
4434.0;2021;11;MONTPELLIER;MASCULIN;APPRENTISSAGE;BAC PROFESSIONNEL;BAC PRO PROD;BAC PRO 23404 TECHNICIEN CONSTRUCTEUR BOIS;3;3;2;0;1;0;1;2;0;0;1;1;0;1
4442.0;2021;11;MONTPELLIER;MASCULIN;APPRENTISSAGE;BAC PROFESSIONNEL;BAC PRO PROD;BAC PRO 25219 MAINT.MATERIELS OPT.A AGRICOLES;1;1;1;0;0;0;0;1;0;0;1;0;0;0
4443.0;2021;11;MONTPELLIER;MASCULIN;APPRENTISSAGE;BAC PROFESSIONNEL;BAC PRO PROD;BAC PRO 25220 MAINT.MATERIELS OPT.B TP MANUT.;4;4;4;0;0;0;0;4;0;0;1;2;1;0
4457.0;2021;11;MONTPELLIER;MASCULIN;APPRENTISSAGE;BAC PROFESSIONNEL;BAC PRO SERV;BAC PRO 31106 LOGISTIQUE;26;26;19;5;2;2;0;21;0;2;5;6;8;5
4459.0;2021;11;MONTPELLIER;MASCULIN;APPRENTISSAGE;BAC PROFESSIONNEL;BAC PRO SERV;BAC PRO 31202 COMMERCE;38;38;24;9;5;4;1;28;0;4;3;10;11;10
4463.0;2021;11;MONTPELLIER;MASCULIN;APPRENTISSAGE;BAC PROFESSIONNEL;BAC PRO SERV;BAC PRO 33403 COMMERC. SERVICES EN RESTAURATION;7;7;4;1;2;1;1;5;0;1;0;0;4;2
4473.0;2021;11;MONTPELLIER;MASCULIN;ENSEIGNEMENT A DISTANCE;BAC TECHNOLOGIQUE;BAC STMG;BAC STMG RESSOURCES HUMAINES ET COMMUNICATION;1;1;1;0;0;0;0;1;0;0;1;0;0;0
4475.0;2021;11;MONTPELLIER;MASCULIN;FORMATION CONTINUE;BAC PROFESSIONNEL;BAC PRO PROD;BAC PRO 22004 PROC. CHIMIE EAU PAPIERS-CARTONS;2;2;2;0;0;0;0;2;0;2;0;0;0;0
4476.0;2021;11;MONTPELLIER;MASCULIN;FORMATION CONTINUE;BAC PROFESSIONNEL;BAC PRO PROD;BAC PRO 22703 TECHN.INSTALL.SYST.ENERG.CLIMATI;5;5;5;0;0;0;0;5;0;1;1;3;0;0
4479.0;2021;11;MONTPELLIER;MASCULIN;FORMATION CONTINUE;BAC PROFESSIONNEL;BAC PRO PROD;BAC PRO 25214 MAINT.VEHIC.OPTA VOIT.PARTICUL.;8;5;4;1;0;0;0;4;0;3;0;0;1;1
4486.0;2021;11;MONTPELLIER;MASCULIN;FORMATION CONTINUE;BAC PROFESSIONNEL;BAC PRO SERV;BAC PRO 31206 VENTE (PROSPECT.NEGO.SUIV.CLIENT;3;3;2;1;0;0;0;2;0;0;0;0;2;1
4487.0;2021;11;MONTPELLIER;MASCULIN;FORMATION CONTINUE;BAC PROFESSIONNEL;BAC PRO SERV;BAC PRO 33102 PROTHESE DENTAIRE;1;1;1;0;0;0;0;1;0;0;0;0;1;0
4489.0;2021;11;MONTPELLIER;MASCULIN;INDIVIDUEL;BAC PROFESSIONNEL;BAC PRO PROD;BACPRO 20002 ETUD.DEFINITION PRDTS INDUSTRIEL;1;1;1;0;0;0;0;1;0;0;0;0;1;0
4494.0;2021;11;MONTPELLIER;MASCULIN;INDIVIDUEL;BAC PROFESSIONNEL;BAC PRO PROD;BAC PRO 25216 MAINT.VEHIC.OPTC MOTOCYCLES;1;0;0;0;0;0;0;0;0;0;0;0;0;0
4498.0;2021;11;MONTPELLIER;MASCULIN;INDIVIDUEL;BAC PROFESSIONNEL;BAC PRO PROD;BAC PRO 25510 METIERS ELECT. ENVIRON. CONNECTES;4;3;1;2;0;0;0;1;0;0;0;1;0;2
4501.0;2021;11;MONTPELLIER;MASCULIN;INDIVIDUEL;BAC PROFESSIONNEL;BAC PRO PROD;BAC PRO AG 21405 AMENAGEMENTS PAYSAGERS;2;0;0;0;0;0;0;0;0;0;0;0;0;0
4503.0;2021;11;MONTPELLIER;MASCULIN;INDIVIDUEL;BAC PROFESSIONNEL;BAC PRO SERV;BAC PRO 31202 COMMERCE;3;3;2;1;0;0;0;2;0;0;0;0;2;1
4508.0;2021;11;MONTPELLIER;MASCULIN;INDIVIDUEL;BAC TECHNOLOGIQUE;BAC S2TMD;BAC S2TMD DANSE;1;1;1;0;0;0;0;1;0;0;1;0;0;0
4511.0;2021;11;MONTPELLIER;MASCULIN;INDIVIDUEL;BAC TECHNOLOGIQUE;BAC STAV;BAC STAV AGRONOMIE ALIM ENV TERRITOI;1;1;1;0;0;0;0;1;0;0;0;0;1;0
4523.0;2021;11;MONTPELLIER;MASCULIN;SCOLAIRE;BAC PROFESSIONNEL;BAC PRO PROD;BAC PRO 22003 BIO-INDUSTRIES DE TRANSFORMATION;6;6;5;1;0;0;0;5;0;0;0;2;3;1
4525.0;2021;11;MONTPELLIER;MASCULIN;SCOLAIRE;BAC PROFESSIONNEL;BAC PRO PROD;BAC PRO 22105 BOULANGER-PÂTISSIER;24;24;19;5;0;0;0;19;0;1;1;13;4;5
4531.0;2021;11;MONTPELLIER;MASCULIN;SCOLAIRE;BAC PROFESSIONNEL;BAC PRO PROD;BAC PRO 23003 ARTIS. & M.ART:MARCHANDISAGE VIS.;2;2;2;0;0;0;0;2;0;0;0;1;1;0
4537.0;2021;11;MONTPELLIER;MASCULIN;SCOLAIRE;BAC PROFESSIONNEL;BAC PRO PROD;BAC PRO 23205 INTERV. SUR PATRIMOINE BATI OPT.A;4;4;3;0;1;0;1;3;0;0;1;0;2;1
4547.0;2021;11;MONTPELLIER;MASCULIN;SCOLAIRE;BAC PROFESSIONNEL;BAC PRO PROD;BAC PRO 24303 MET. DU CUIR: SELLERIE GARNISSAGE;6;6;3;3;0;0;0;3;0;0;1;2;0;3
4555.0;2021;11;MONTPELLIER;MASCULIN;SCOLAIRE;BAC PROFESSIONNEL;BAC PRO PROD;BAC PRO 25219 MAINT.MATERIELS OPT.A AGRICOLES;22;22;20;1;1;1;0;21;0;1;2;10;8;1
4559.0;2021;11;MONTPELLIER;MASCULIN;SCOLAIRE;BAC PROFESSIONNEL;BAC PRO PROD;BAC PRO 25406 OUVRAGES DU BATIMENT METALLERIE;7;7;3;2;2;1;1;4;0;0;0;3;1;3
4566.0;2021;11;MONTPELLIER;MASCULIN;SCOLAIRE;BAC PROFESSIONNEL;BAC PRO PROD;BAC PRO 25515 SYST.NUM.OPT.C RES.INF.SYST.COMM.;219;216;183;19;14;12;2;195;0;6;39;93;57;21
4567.0;2021;11;MONTPELLIER;MASCULIN;SCOLAIRE;BAC PROFESSIONNEL;BAC PRO PROD;BAC PRO AG 21001 AGRO-EQUIPEMENT;32;31;30;1;0;0;0;30;0;1;1;17;11;1
4580.0;2021;11;MONTPELLIER;MASCULIN;SCOLAIRE;BAC PROFESSIONNEL;BAC PRO PROD;BAC PRO AG 22107 TEC CONS VTE ALIMENTATION P.ALIM;20;16;14;2;0;0;0;14;0;0;1;7;6;2
4583.0;2021;11;MONTPELLIER;MASCULIN;SCOLAIRE;BAC PROFESSIONNEL;BAC PRO SERV;BAC PRO 31107 CONDUCT. TRANSP.ROUT.MARCHANDISES;47;47;40;7;0;0;0;40;0;0;8;14;18;7
4584.0;2021;11;MONTPELLIER;MASCULIN;SCOLAIRE;BAC PROFESSIONNEL;BAC PRO SERV;BAC PRO 31108 TRANSPORT;24;24;18;4;2;1;1;19;0;1;3;6;9;5
4587.0;2021;11;MONTPELLIER;MASCULIN;SCOLAIRE;BAC PROFESSIONNEL;BAC PRO SERV;BAC PRO 31210 ACCUEIL -RELATION CLIENTS USAGERS;59;59;47;7;5;4;1;51;0;2;7;23;19;8
4590.0;2021;11;MONTPELLIER;MASCULIN;SCOLAIRE;BAC PROFESSIONNEL;BAC PRO SERV;BAC PRO 32303 ART.& MET.ART:COM.VIS.VIS.PLURI-M;47;45;37;6;2;1;1;38;0;1;10;11;16;7
4596.0;2021;11;MONTPELLIER;MASCULIN;SCOLAIRE;BAC PROFESSIONNEL;BAC PRO SERV;BAC PRO 33102 PROTHESE DENTAIRE;9;9;6;3;0;0;0;6;0;0;1;2;3;3
4602.0;2021;11;MONTPELLIER;MASCULIN;SCOLAIRE;BAC TECHNOLOGIQUE;BAC ST2S;BAC ST2S SCIENCES & TECHNO. SANTE & SOCIAL;184;184;162;10;12;6;6;168;0;2;23;65;78;16
4615.0;2021;11;MONTPELLIER;MASCULIN;SCOLAIRE;BAC TECHNOLOGIQUE;BAC STMG;BAC STMG SYSTEMES D'INFORMATION DE GESTION;22;22;17;2;3;3;0;20;0;0;1;4;15;2
4626.0;2021;12;NANCY-METZ;FEMININ;APPRENTISSAGE;BAC PROFESSIONNEL;BAC PRO PROD;BAC PRO 25510 METIERS ELECT. ENVIRON. CONNECTES;2;2;2;0;0;0;0;2;0;0;1;1;0;0
4639.0;2021;12;NANCY-METZ;FEMININ;ENSEIGNEMENT A DISTANCE;BAC TECHNOLOGIQUE;BAC ST2S;BAC ST2S SCIENCES & TECHNO. SANTE & SOCIAL;2;2;2;0;0;0;0;2;0;0;2;0;0;0
4647.0;2021;12;NANCY-METZ;FEMININ;FORMATION CONTINUE;BAC PROFESSIONNEL;BAC PRO PROD;BAC PRO 25007 MAINTENANCE EQUIPEMENTS INDUST.;1;0;0;0;0;0;0;0;0;0;0;0;0;0
4656.0;2021;12;NANCY-METZ;FEMININ;FORMATION CONTINUE;BAC PROFESSIONNEL;BAC PRO SERV;BAC PRO 32303 ART.& MET.ART:COM.VIS.VIS.PLURI-M;1;1;1;0;0;0;0;1;0;0;0;1;0;0
4658.0;2021;12;NANCY-METZ;FEMININ;FORMATION CONTINUE;BAC PROFESSIONNEL;BAC PRO SERV;BAC PRO 33603 ESTHETIQUE COSMETIQUE PARFUMERIE;1;1;1;0;0;0;0;1;0;0;0;1;0;0
4659.0;2021;12;NANCY-METZ;FEMININ;FORMATION CONTINUE;BAC PROFESSIONNEL;BAC PRO SERV;BAC PRO 34403 METIERS DE LA SECURITE;3;3;3;0;0;0;0;3;0;0;0;2;1;0
4670.0;2021;12;NANCY-METZ;FEMININ;INDIVIDUEL;BAC PROFESSIONNEL;BAC PRO SERV;BAC PRO 33403 COMMERC. SERVICES EN RESTAURATION;1;1;1;0;0;0;0;1;0;0;0;0;1;0
4672.0;2021;12;NANCY-METZ;FEMININ;INDIVIDUEL;BAC PROFESSIONNEL;BAC PRO SERV;BAC PRO AG 33002 SERV PERS TERRIT;1;1;1;0;0;0;0;1;0;0;1;0;0;0
4676.0;2021;12;NANCY-METZ;FEMININ;INDIVIDUEL;BAC TECHNOLOGIQUE;BAC STMG;BAC STMG MERCATIQUE (MARKETING);5;4;3;1;0;0;0;3;0;0;1;0;2;1
4679.0;2021;12;NANCY-METZ;FEMININ;SCOLAIRE;BAC GENERAL;BAC GENERAL;BAC GENE 10019 BAC GENERAL;6490;6489;6312;23;154;83;71;6395;148;884;1792;2193;1378;94
4683.0;2021;12;NANCY-METZ;FEMININ;SCOLAIRE;BAC PROFESSIONNEL;BAC PRO PROD;BAC PRO 22105 BOULANGER-PÂTISSIER;66;66;62;1;3;2;1;64;0;4;19;21;20;2
4685.0;2021;12;NANCY-METZ;FEMININ;SCOLAIRE;BAC PROFESSIONNEL;BAC PRO PROD;BAC PRO 22403 ARTS.& MET.ART:MET.ENSEIGN SIGNA;6;6;5;1;0;0;0;5;0;1;1;3;0;1
4697.0;2021;12;NANCY-METZ;FEMININ;SCOLAIRE;BAC PROFESSIONNEL;BAC PRO PROD;BAC PRO 25106 TECHNICIEN D'USINAGE;7;7;7;0;0;0;0;7;0;1;1;4;1;0
4699.0;2021;12;NANCY-METZ;FEMININ;SCOLAIRE;BAC PROFESSIONNEL;BAC PRO PROD;BAC PRO 25216 MAINT.VEHIC.OPTC MOTOCYCLES;2;2;2;0;0;0;0;2;0;0;1;1;0;0
4704.0;2021;12;NANCY-METZ;FEMININ;SCOLAIRE;BAC PROFESSIONNEL;BAC PRO PROD;BAC PRO 25510 METIERS ELECT. ENVIRON. CONNECTES;5;4;4;0;0;0;0;4;0;1;0;2;1;0
4711.0;2021;12;NANCY-METZ;FEMININ;SCOLAIRE;BAC PROFESSIONNEL;BAC PRO PROD;BAC PRO AG 21203 TECHN CONSEIL DE VENTE ANIMAL;16;16;10;6;0;0;0;10;0;0;1;3;6;6
4712.0;2021;12;NANCY-METZ;FEMININ;SCOLAIRE;BAC PROFESSIONNEL;BAC PRO PROD;BAC PRO AG 21211 COND GEST ENTR HIPPIQUE;78;78;73;5;0;0;0;73;0;1;8;37;27;5
4715.0;2021;12;NANCY-METZ;FEMININ;SCOLAIRE;BAC PROFESSIONNEL;BAC PRO PROD;BAC PRO AG 21405 AMENAGEMENTS PAYSAGERS;2;2;2;0;0;0;0;2;0;0;1;1;0;0
4720.0;2021;12;NANCY-METZ;FEMININ;SCOLAIRE;BAC PROFESSIONNEL;BAC PRO SERV;BAC PRO 31108 TRANSPORT;3;3;2;0;1;1;0;3;0;0;0;1;2;0
4724.0;2021;12;NANCY-METZ;FEMININ;SCOLAIRE;BAC PROFESSIONNEL;BAC PRO SERV;BAC PRO 32207 REAL.PR.IMPR.PLURI.OPTA.PR.GRAPH.;12;12;12;0;0;0;0;12;0;0;4;6;2;0
4729.0;2021;12;NANCY-METZ;FEMININ;SCOLAIRE;BAC PROFESSIONNEL;BAC PRO SERV;BAC PRO 33003 ACC.SOINS-S.PERS. OPT.A DOMICILE;157;157;142;8;7;3;4;145;0;11;35;47;52;12
4731.0;2021;12;NANCY-METZ;FEMININ;SCOLAIRE;BAC PROFESSIONNEL;BAC PRO SERV;BAC PRO 33101 OPTIQUE LUNETTERIE;9;9;9;0;0;0;0;9;0;2;1;3;3;0
4732.0;2021;12;NANCY-METZ;FEMININ;SCOLAIRE;BAC PROFESSIONNEL;BAC PRO SERV;BAC PRO 33102 PROTHESE DENTAIRE;6;6;6;0;0;0;0;6;0;0;3;1;2;0
4734.0;2021;12;NANCY-METZ;FEMININ;SCOLAIRE;BAC PROFESSIONNEL;BAC PRO SERV;BAC PRO 33603 ESTHETIQUE COSMETIQUE PARFUMERIE;137;137;127;10;0;0;0;127;0;8;36;51;32;10
4741.0;2021;12;NANCY-METZ;FEMININ;SCOLAIRE;BAC TECHNOLOGIQUE;BAC STAV;BAC STAV AGRONOMIE ALIM ENV TERRITOI;75;75;74;1;0;0;0;74;0;3;10;33;28;1
4748.0;2021;12;NANCY-METZ;FEMININ;SCOLAIRE;BAC TECHNOLOGIQUE;BAC STL;BAC STL BIOCHIM.-BIOLOGIE-BIOTECHNOL.;91;91;79;5;7;3;4;82;0;1;19;31;31;9
4751.0;2021;12;NANCY-METZ;FEMININ;SCOLAIRE;BAC TECHNOLOGIQUE;BAC STMG;BAC STMG MERCATIQUE (MARKETING);445;445;413;5;27;14;13;427;0;4;66;174;183;18
4756.0;2021;12;NANCY-METZ;MASCULIN;APPRENTISSAGE;BAC PROFESSIONNEL;BAC PRO PROD;BAC PRO 22106 CUISINE;6;5;3;2;0;0;0;3;0;0;0;0;3;2
4759.0;2021;12;NANCY-METZ;MASCULIN;APPRENTISSAGE;BAC PROFESSIONNEL;BAC PRO PROD;BAC PRO 22705 TECHNICIEN GAZ;8;7;7;0;0;0;0;7;0;0;2;4;1;0
4761.0;2021;12;NANCY-METZ;MASCULIN;APPRENTISSAGE;BAC PROFESSIONNEL;BAC PRO PROD;BAC PRO 23203 TECHNICIEN BAT. : ORG.REAL.GROS O;8;8;8;0;0;0;0;8;0;1;1;4;2;0
4762.0;2021;12;NANCY-METZ;MASCULIN;APPRENTISSAGE;BAC PROFESSIONNEL;BAC PRO PROD;BAC PRO 23304 AMENAGEMENT FINITION BATIMENT;1;1;1;0;0;0;0;1;0;0;1;0;0;0
4764.0;2021;12;NANCY-METZ;MASCULIN;APPRENTISSAGE;BAC PROFESSIONNEL;BAC PRO PROD;BAC PRO 23405 TECHNICIEN MENUISIER AGENCEUR;5;5;3;1;1;0;1;3;0;1;1;0;1;2
4770.0;2021;12;NANCY-METZ;MASCULIN;APPRENTISSAGE;BAC PROFESSIONNEL;BAC PRO PROD;BAC PRO 25214 MAINT.VEHIC.OPTA VOIT.PARTICUL.;85;84;70;12;2;2;0;72;0;10;18;28;16;12
4789.0;2021;12;NANCY-METZ;MASCULIN;APPRENTISSAGE;BAC PROFESSIONNEL;BAC PRO PROD;BAC PRO AG 21405 AMENAGEMENTS PAYSAGERS;44;44;43;1;0;0;0;43;0;0;7;20;16;1
4796.0;2021;12;NANCY-METZ;MASCULIN;APPRENTISSAGE;BAC PROFESSIONNEL;BAC PRO SERV;BAC PRO 33102 PROTHESE DENTAIRE;4;4;3;0;1;0;1;3;0;0;1;2;0;1
4800.0;2021;12;NANCY-METZ;MASCULIN;ENSEIGNEMENT A DISTANCE;BAC TECHNOLOGIQUE;BAC STMG;BAC STMG RESSOURCES HUMAINES ET COMMUNICATION;2;2;1;1;0;0;0;1;0;0;0;1;0;1
4805.0;2021;12;NANCY-METZ;MASCULIN;FORMATION CONTINUE;BAC PROFESSIONNEL;BAC PRO PROD;BAC PRO 23406 TECHNICIEN DE SCIERIE;4;4;4;0;0;0;0;4;0;0;1;2;1;0
4815.0;2021;12;NANCY-METZ;MASCULIN;FORMATION CONTINUE;BAC PROFESSIONNEL;BAC PRO SERV;BAC PRO 30001 GESTION-ADMINISTRATION;9;8;7;1;0;0;0;7;0;0;4;2;1;1
4816.0;2021;12;NANCY-METZ;MASCULIN;FORMATION CONTINUE;BAC PROFESSIONNEL;BAC PRO SERV;BAC PRO 31106 LOGISTIQUE;8;8;5;1;2;1;1;6;0;2;1;1;2;2
4819.0;2021;12;NANCY-METZ;MASCULIN;FORMATION CONTINUE;BAC PROFESSIONNEL;BAC PRO SERV;BAC PRO 33102 PROTHESE DENTAIRE;4;4;4;0;0;0;0;4;0;0;2;2;0;0
4822.0;2021;12;NANCY-METZ;MASCULIN;INDIVIDUEL;BAC PROFESSIONNEL;BAC PRO PROD;BAC PRO 22004 PROC. CHIMIE EAU PAPIERS-CARTONS;1;1;1;0;0;0;0;1;0;0;0;0;1;0
4835.0;2021;12;NANCY-METZ;MASCULIN;INDIVIDUEL;BAC PROFESSIONNEL;BAC PRO SERV;BAC PRO 31108 TRANSPORT;1;0;0;0;0;0;0;0;0;0;0;0;0;0
4836.0;2021;12;NANCY-METZ;MASCULIN;INDIVIDUEL;BAC PROFESSIONNEL;BAC PRO SERV;BAC PRO 31202 COMMERCE;6;3;3;0;0;0;0;3;0;0;1;2;0;0
4846.0;2021;12;NANCY-METZ;MASCULIN;INDIVIDUEL;BAC TECHNOLOGIQUE;BAC STMG;BAC STMG RESSOURCES HUMAINES ET COMMUNICATION;11;7;6;0;1;1;0;7;0;0;1;1;5;0
4852.0;2021;12;NANCY-METZ;MASCULIN;SCOLAIRE;BAC PROFESSIONNEL;BAC PRO PROD;BAC PRO 22105 BOULANGER-PÂTISSIER;75;75;71;3;1;1;0;72;0;3;16;27;26;3
4859.0;2021;12;NANCY-METZ;MASCULIN;SCOLAIRE;BAC PROFESSIONNEL;BAC PRO PROD;BAC PRO 22705 TECHNICIEN GAZ;1;1;1;0;0;0;0;1;0;0;1;0;0;0
4862.0;2021;12;NANCY-METZ;MASCULIN;SCOLAIRE;BAC PROFESSIONNEL;BAC PRO PROD;BAC PRO 23102 TRAVAUX PUBLICS;7;7;7;0;0;0;0;7;0;0;2;4;1;0
4868.0;2021;12;NANCY-METZ;MASCULIN;SCOLAIRE;BAC PROFESSIONNEL;BAC PRO PROD;BAC PRO 23405 TECHNICIEN MENUISIER AGENCEUR;54;52;35;13;4;1;3;36;0;0;3;16;17;16
4870.0;2021;12;NANCY-METZ;MASCULIN;SCOLAIRE;BAC PROFESSIONNEL;BAC PRO PROD;BAC PRO 23407 TECHNIC.FAB.BOIS ET MATERX ASSOC;13;13;7;4;2;1;1;8;0;0;1;2;5;5
4880.0;2021;12;NANCY-METZ;MASCULIN;SCOLAIRE;BAC PROFESSIONNEL;BAC PRO PROD;BAC PRO 25220 MAINT.MATERIELS OPT.B TP MANUT.;16;16;13;2;1;0;1;13;0;3;3;5;2;3
4881.0;2021;12;NANCY-METZ;MASCULIN;SCOLAIRE;BAC PROFESSIONNEL;BAC PRO PROD;BAC PRO 25221 MAINT.MATERIELS OPT.C ESP. VERTS;4;4;4;0;0;0;0;4;0;0;3;0;1;0
4884.0;2021;12;NANCY-METZ;MASCULIN;SCOLAIRE;BAC PROFESSIONNEL;BAC PRO PROD;BAC PRO 25406 OUVRAGES DU BATIMENT METALLERIE;15;15;15;0;0;0;0;15;0;1;2;3;9;0
4888.0;2021;12;NANCY-METZ;MASCULIN;SCOLAIRE;BAC PROFESSIONNEL;BAC PRO PROD;BAC PRO 25509 TECHNIC. FROID CONDITIONNEMT AIR;42;42;31;6;5;1;4;32;0;2;4;15;11;10
4890.0;2021;12;NANCY-METZ;MASCULIN;SCOLAIRE;BAC PROFESSIONNEL;BAC PRO PROD;BAC PRO 25513 SYST.NUM.OPT.A SURETE SECURITE;49;49;46;2;1;0;1;46;0;1;9;16;20;3
4894.0;2021;12;NANCY-METZ;MASCULIN;SCOLAIRE;BAC PROFESSIONNEL;BAC PRO PROD;BAC PRO AG 21004 CGEA;71;70;60;10;0;0;0;60;0;1;12;18;29;10
4898.0;2021;12;NANCY-METZ;MASCULIN;SCOLAIRE;BAC PROFESSIONNEL;BAC PRO PROD;BAC PRO AG 21302 GEST MILIEUX NATURELS FAUNE;27;27;22;5;0;0;0;22;0;1;4;3;14;5
4904.0;2021;12;NANCY-METZ;MASCULIN;SCOLAIRE;BAC PROFESSIONNEL;BAC PRO SERV;BAC PRO 31107 CONDUCT. TRANSP.ROUT.MARCHANDISES;75;74;66;6;2;1;1;67;0;3;27;23;14;7
4906.0;2021;12;NANCY-METZ;MASCULIN;SCOLAIRE;BAC PROFESSIONNEL;BAC PRO SERV;BAC PRO 31202 COMMERCE;383;383;320;33;30;16;14;336;0;30;80;111;115;47
4907.0;2021;12;NANCY-METZ;MASCULIN;SCOLAIRE;BAC PROFESSIONNEL;BAC PRO SERV;BAC PRO 31206 VENTE (PROSPECT.NEGO.SUIV.CLIENT;185;184;143;23;18;11;7;154;0;7;22;60;65;30
4911.0;2021;12;NANCY-METZ;MASCULIN;SCOLAIRE;BAC PROFESSIONNEL;BAC PRO SERV;BAC PRO 32303 ART.& MET.ART:COM.VIS.VIS.PLURI-M;12;12;12;0;0;0;0;12;0;1;3;3;5;0
4919.0;2021;12;NANCY-METZ;MASCULIN;SCOLAIRE;BAC PROFESSIONNEL;BAC PRO SERV;BAC PRO 34303 GEST. POLLUTIONS PROTEC. ENVIRON.;10;10;8;2;0;0;0;8;0;0;3;3;2;2
4920.0;2021;12;NANCY-METZ;MASCULIN;SCOLAIRE;BAC PROFESSIONNEL;BAC PRO SERV;BAC PRO 34304 HYGIENE PROPRETE STERILISATION;4;4;4;0;0;0;0;4;0;0;1;0;3;0
4924.0;2021;12;NANCY-METZ;MASCULIN;SCOLAIRE;BAC TECHNOLOGIQUE;BAC ST2S;BAC ST2S SCIENCES & TECHNO. SANTE & SOCIAL;132;132;104;5;23;8;15;112;0;0;8;30;74;20
4927.0;2021;12;NANCY-METZ;MASCULIN;SCOLAIRE;BAC TECHNOLOGIQUE;BAC STHR;BAC STHR SC.&TEC. HOTELLERIE-RESTAURATION;31;31;29;0;2;2;0;31;0;1;3;10;17;0
4931.0;2021;12;NANCY-METZ;MASCULIN;SCOLAIRE;BAC TECHNOLOGIQUE;BAC STI2D;BAC STI2D SYSTÈME D'INFORMATION  ET NUMERIQUE;278;278;248;11;19;8;11;256;0;4;31;113;108;22
4945.0;2021;17;NANTES;FEMININ;APPRENTISSAGE;BAC PROFESSIONNEL;BAC PRO PROD;BAC PRO 24302 METIERS DU CUIR : MAROQUINERIE;3;3;3;0;0;0;0;3;0;1;2;0;0;0
4947.0;2021;17;NANTES;FEMININ;APPRENTISSAGE;BAC PROFESSIONNEL;BAC PRO PROD;BAC PRO 25106 TECHNICIEN D'USINAGE;2;2;2;0;0;0;0;2;0;0;1;1;0;0
4949.0;2021;17;NANTES;FEMININ;APPRENTISSAGE;BAC PROFESSIONNEL;BAC PRO PROD;BAC PRO 25215 MAINT.VEHIC.OPTB VEHIC.TRANS.ROUT;3;3;2;1;0;0;0;2;0;0;0;0;2;1
4951.0;2021;17;NANTES;FEMININ;APPRENTISSAGE;BAC PROFESSIONNEL;BAC PRO PROD;BAC PRO 25302 AERONAUTIQUE OPTION AVIONIQUE;3;3;3;0;0;0;0;3;0;0;2;1;0;0
4961.0;2021;17;NANTES;FEMININ;APPRENTISSAGE;BAC PROFESSIONNEL;BAC PRO PROD;BAC PRO AG 21114 CONDUITE PRODUCTIONS HORTICOLES;1;0;0;0;0;0;0;0;0;0;0;0;0;0
4966.0;2021;17;NANTES;FEMININ;APPRENTISSAGE;BAC PROFESSIONNEL;BAC PRO SERV;BAC PRO 30001 GESTION-ADMINISTRATION;12;12;11;0;1;0;1;11;0;3;2;3;3;1
4968.0;2021;17;NANTES;FEMININ;APPRENTISSAGE;BAC PROFESSIONNEL;BAC PRO SERV;BAC PRO 31202 COMMERCE;260;259;213;17;29;21;8;234;0;10;44;92;88;25
4973.0;2021;17;NANTES;FEMININ;APPRENTISSAGE;BAC PROFESSIONNEL;BAC PRO SERV;BAC PRO 33003 ACC.SOINS-S.PERS. OPT.A DOMICILE;4;4;3;0;1;0;1;3;0;0;1;0;2;1
4976.0;2021;17;NANTES;FEMININ;APPRENTISSAGE;BAC PROFESSIONNEL;BAC PRO SERV;BAC PRO AG 33002 SERV PERS TERRIT;23;21;20;1;0;0;0;20;0;1;2;5;12;1
4980.0;2021;17;NANTES;FEMININ;ENSEIGNEMENT A DISTANCE;BAC TECHNOLOGIQUE;BAC ST2S;BAC ST2S SCIENCES & TECHNO. SANTE & SOCIAL;4;4;4;0;0;0;0;4;0;0;0;4;0;0
5004.0;2021;17;NANTES;FEMININ;INDIVIDUEL;BAC PROFESSIONNEL;BAC PRO SERV;BAC PRO 30001 GESTION-ADMINISTRATION;13;11;6;3;2;0;2;6;0;0;1;3;2;5
5022.0;2021;17;NANTES;FEMININ;SCOLAIRE;BAC PROFESSIONNEL;BAC PRO PROD;BAC PRO 22503 PLASTIQUES ET COMPOSITES;3;3;3;0;0;0;0;3;0;1;0;0;2;0
5025.0;2021;17;NANTES;FEMININ;SCOLAIRE;BAC PROFESSIONNEL;BAC PRO PROD;BAC PRO 23004 TECHN. ETUDES BAT.A ETUDES & ECO.;21;21;18;2;1;1;0;19;0;0;2;8;9;2
5028.0;2021;17;NANTES;FEMININ;SCOLAIRE;BAC PROFESSIONNEL;BAC PRO PROD;BACPRO 23103 TECHNICIEN GEOMETRE-TOPOGRAPHE;5;5;4;1;0;0;0;4;0;0;0;1;3;1
5034.0;2021;17;NANTES;FEMININ;SCOLAIRE;BAC PROFESSIONNEL;BAC PRO PROD;BAC PRO 24203 METIERS DE LA MODE - VÊTEMENT;200;200;183;13;4;4;0;187;0;32;42;69;44;13
5038.0;2021;17;NANTES;FEMININ;SCOLAIRE;BAC PROFESSIONNEL;BAC PRO PROD;BAC PRO 25106 TECHNICIEN D'USINAGE;5;5;5;0;0;0;0;5;0;0;1;1;3;0
5039.0;2021;17;NANTES;FEMININ;SCOLAIRE;BAC PROFESSIONNEL;BAC PRO PROD;BAC PRO 25214 MAINT.VEHIC.OPTA VOIT.PARTICUL.;8;8;6;2;0;0;0;6;0;0;1;4;1;2
5042.0;2021;17;NANTES;FEMININ;SCOLAIRE;BAC PROFESSIONNEL;BAC PRO PROD;BAC PRO 25406 OUVRAGES DU BATIMENT METALLERIE;1;1;1;0;0;0;0;1;0;0;0;0;1;0
5048.0;2021;17;NANTES;FEMININ;SCOLAIRE;BAC PROFESSIONNEL;BAC PRO PROD;BAC PRO 25515 SYST.NUM.OPT.C RES.INF.SYST.COMM.;5;5;5;0;0;0;0;5;0;0;0;3;2;0
5051.0;2021;17;NANTES;FEMININ;SCOLAIRE;BAC PROFESSIONNEL;BAC PRO PROD;BAC PRO AG 21114 CONDUITE PRODUCTIONS HORTICOLES;40;39;38;1;0;0;0;38;0;0;7;16;15;1
5057.0;2021;17;NANTES;FEMININ;SCOLAIRE;BAC PROFESSIONNEL;BAC PRO PROD;BAC PRO AG 21406 TEC CONS VTE PROD DES JARDINS;18;18;18;0;0;0;0;18;0;1;2;9;6;0
5059.0;2021;17;NANTES;FEMININ;SCOLAIRE;BAC PROFESSIONNEL;BAC PRO PROD;BAC PRO AG 22107 TEC CONS VTE ALIMENTATION P.ALIM;87;85;72;13;0;0;0;72;0;1;10;24;37;13
5066.0;2021;17;NANTES;FEMININ;SCOLAIRE;BAC PROFESSIONNEL;BAC PRO SERV;BAC PRO 31210 ACCUEIL -RELATION CLIENTS USAGERS;299;299;259;18;22;15;7;274;0;12;57;115;90;25
5072.0;2021;17;NANTES;FEMININ;SCOLAIRE;BAC PROFESSIONNEL;BAC PRO SERV;BAC PRO 33003 ACC.SOINS-S.PERS. OPT.A DOMICILE;139;138;123;8;7;3;4;126;0;6;32;46;42;12
5079.0;2021;17;NANTES;FEMININ;SCOLAIRE;BAC PROFESSIONNEL;BAC PRO SERV;BAC PRO 34304 HYGIENE PROPRETE STERILISATION;9;9;7;1;1;1;0;8;0;0;2;2;4;1
5091.0;2021;17;NANTES;FEMININ;SCOLAIRE;BAC TECHNOLOGIQUE;BAC STI2D;BAC STI2D SYSTÈME D'INFORMATION  ET NUMERIQUE;25;25;24;0;1;1;0;25;0;2;1;12;10;0
5100.0;2021;17;NANTES;MASCULIN;APPRENTISSAGE;BAC PROFESSIONNEL;BAC PRO PROD;BAC PRO 22106 CUISINE;37;35;32;1;2;0;2;32;0;4;8;9;11;3
5101.0;2021;17;NANTES;MASCULIN;APPRENTISSAGE;BAC PROFESSIONNEL;BAC PRO PROD;BAC PRO 22302 Traitement des matériaux;6;6;6;0;0;0;0;6;0;0;1;2;3;0
5107.0;2021;17;NANTES;MASCULIN;APPRENTISSAGE;BAC PROFESSIONNEL;BAC PRO PROD;BAC PRO 23102 TRAVAUX PUBLICS;70;70;65;4;1;1;0;66;0;6;9;32;19;4
5108.0;2021;17;NANTES;MASCULIN;APPRENTISSAGE;BAC PROFESSIONNEL;BAC PRO PROD;BAC PRO 23203 TECHNICIEN BAT. : ORG.REAL.GROS O;42;42;39;1;2;1;1;40;0;2;7;13;18;2
5115.0;2021;17;NANTES;MASCULIN;APPRENTISSAGE;BAC PROFESSIONNEL;BAC PRO PROD;BAC PRO 25007 MAINTENANCE EQUIPEMENTS INDUST.;69;69;63;5;1;1;0;64;0;1;15;23;25;5
5122.0;2021;17;NANTES;MASCULIN;APPRENTISSAGE;BAC PROFESSIONNEL;BAC PRO PROD;BAC PRO 25220 MAINT.MATERIELS OPT.B TP MANUT.;23;23;19;4;0;0;0;19;0;3;3;8;5;4
5123.0;2021;17;NANTES;MASCULIN;APPRENTISSAGE;BAC PROFESSIONNEL;BAC PRO PROD;BAC PRO 25221 MAINT.MATERIELS OPT.C ESP. VERTS;27;27;23;1;3;1;2;24;0;3;4;12;5;3
5124.0;2021;17;NANTES;MASCULIN;APPRENTISSAGE;BAC PROFESSIONNEL;BAC PRO PROD;BAC PRO 25302 AERONAUTIQUE OPTION AVIONIQUE;10;10;10;0;0;0;0;10;0;1;5;4;0;0
5125.0;2021;17;NANTES;MASCULIN;APPRENTISSAGE;BAC PROFESSIONNEL;BAC PRO PROD;BAC PRO 25303 AERONAUTIQUE OPTION SYSTEMES;5;5;5;0;0;0;0;5;0;0;1;4;0;0
5130.0;2021;17;NANTES;MASCULIN;APPRENTISSAGE;BAC PROFESSIONNEL;BAC PRO PROD;BAC PRO 25411 TECH.CHAUDRONNERIE INDUSTRIELLE;104;104;96;7;1;1;0;97;0;4;26;48;19;7
5132.0;2021;17;NANTES;MASCULIN;APPRENTISSAGE;BAC PROFESSIONNEL;BAC PRO PROD;BAC PRO 25510 METIERS ELECT. ENVIRON. CONNECTES;106;106;100;4;2;2;0;102;0;7;30;39;26;4
5137.0;2021;17;NANTES;MASCULIN;APPRENTISSAGE;BAC PROFESSIONNEL;BAC PRO PROD;BAC PRO AG 21113 CGEVV;7;7;7;0;0;0;0;7;0;0;0;0;7;0
5138.0;2021;17;NANTES;MASCULIN;APPRENTISSAGE;BAC PROFESSIONNEL;BAC PRO PROD;BAC PRO AG 21114 CONDUITE PRODUCTIONS HORTICOLES;8;8;8;0;0;0;0;8;0;0;0;3;5;0
5142.0;2021;17;NANTES;MASCULIN;APPRENTISSAGE;BAC PROFESSIONNEL;BAC PRO PROD;BAC PRO AG 21303 FORET;1;1;1;0;0;0;0;1;0;0;0;0;1;0
5143.0;2021;17;NANTES;MASCULIN;APPRENTISSAGE;BAC PROFESSIONNEL;BAC PRO PROD;BAC PRO AG 21405 AMENAGEMENTS PAYSAGERS;119;116;114;2;0;0;0;114;0;0;32;44;38;2
5145.0;2021;17;NANTES;MASCULIN;APPRENTISSAGE;BAC PROFESSIONNEL;BAC PRO SERV;BAC PRO 30001 GESTION-ADMINISTRATION;1;0;0;0;0;0;0;0;0;0;0;0;0;0
5153.0;2021;17;NANTES;MASCULIN;APPRENTISSAGE;BAC PROFESSIONNEL;BAC PRO SERV;BAC PRO 33004 ACC.SOINS-S.PERS. OPT.EN STRUCTUR;1;1;1;0;0;0;0;1;0;0;0;1;0;0
5158.0;2021;17;NANTES;MASCULIN;ENSEIGNEMENT A DISTANCE;BAC PROFESSIONNEL;BAC PRO PROD;BAC PRO AG 21114 CONDUITE PRODUCTIONS HORTICOLES;11;10;10;0;0;0;0;10;0;0;0;0;10;0
5159.0;2021;17;NANTES;MASCULIN;ENSEIGNEMENT A DISTANCE;BAC TECHNOLOGIQUE;BAC ST2S;BAC ST2S SCIENCES & TECHNO. SANTE & SOCIAL;1;1;1;0;0;0;0;1;0;0;1;0;0;0
5165.0;2021;17;NANTES;MASCULIN;FORMATION CONTINUE;BAC PROFESSIONNEL;BAC PRO PROD;BAC PRO 22703 TECHN.INSTALL.SYST.ENERG.CLIMATI;2;2;2;0;0;0;0;2;0;2;0;0;0;0
5169.0;2021;17;NANTES;MASCULIN;FORMATION CONTINUE;BAC PROFESSIONNEL;BAC PRO PROD;BAC PRO 23405 TECHNICIEN MENUISIER AGENCEUR;1;1;1;0;0;0;0;1;0;1;0;0;0;0
5173.0;2021;17;NANTES;MASCULIN;FORMATION CONTINUE;BAC PROFESSIONNEL;BAC PRO PROD;BAC PRO 25215 MAINT.VEHIC.OPTB VEHIC.TRANS.ROUT;1;1;1;0;0;0;0;1;0;0;1;0;0;0
5191.0;2021;17;NANTES;MASCULIN;INDIVIDUEL;BAC PROFESSIONNEL;BAC PRO PROD;BAC PRO 25514 SYST.NUM.OPT.B AUD.RES.EQUIP.DOM.;2;2;1;1;0;0;0;1;0;0;0;0;1;1
5203.0;2021;17;NANTES;MASCULIN;INDIVIDUEL;BAC PROFESSIONNEL;BAC PRO SERV;BAC PRO 33004 ACC.SOINS-S.PERS. OPT.EN STRUCTUR;1;1;0;0;1;0;1;0;0;0;0;0;0;1
5204.0;2021;17;NANTES;MASCULIN;INDIVIDUEL;BAC PROFESSIONNEL;BAC PRO SERV;BAC PRO 33102 PROTHESE DENTAIRE;1;1;1;0;0;0;0;1;0;0;0;0;1;0
5206.0;2021;17;NANTES;MASCULIN;INDIVIDUEL;BAC TECHNOLOGIQUE;BAC S2TMD;BAC S2TMD DANSE;1;1;1;0;0;0;0;1;0;0;0;0;1;0
5207.0;2021;17;NANTES;MASCULIN;INDIVIDUEL;BAC TECHNOLOGIQUE;BAC ST2S;BAC ST2S SCIENCES & TECHNO. SANTE & SOCIAL;3;2;0;1;1;1;0;1;0;0;0;0;1;1
5209.0;2021;17;NANTES;MASCULIN;INDIVIDUEL;BAC TECHNOLOGIQUE;BAC STI2D;BAC STI2D SYSTÈME D'INFORMATION  ET NUMERIQUE;4;4;2;1;1;1;0;3;0;0;0;0;3;1
5216.0;2021;17;NANTES;MASCULIN;SCOLAIRE;BAC PROFESSIONNEL;BAC PRO PROD;BACPRO 20002 ETUD.DEFINITION PRDTS INDUSTRIEL;28;28;22;4;2;2;0;24;0;1;4;10;9;4
5221.0;2021;17;NANTES;MASCULIN;SCOLAIRE;BAC PROFESSIONNEL;BAC PRO PROD;BAC PRO 22403 ARTS.& MET.ART:MET.ENSEIGN SIGNA;6;6;6;0;0;0;0;6;0;0;0;3;3;0
5229.0;2021;17;NANTES;MASCULIN;SCOLAIRE;BAC PROFESSIONNEL;BAC PRO PROD;BACPRO 23103 TECHNICIEN GEOMETRE-TOPOGRAPHE;22;22;13;6;3;2;1;15;0;0;2;4;9;7
5233.0;2021;17;NANTES;MASCULIN;SCOLAIRE;BAC PROFESSIONNEL;BAC PRO PROD;BAC PRO 23304 AMENAGEMENT FINITION BATIMENT;32;32;23;4;5;1;4;24;0;0;2;5;17;8
5235.0;2021;17;NANTES;MASCULIN;SCOLAIRE;BAC PROFESSIONNEL;BAC PRO PROD;BAC PRO 23405 TECHNICIEN MENUISIER AGENCEUR;107;107;93;7;7;4;3;97;0;3;17;36;41;10
5237.0;2021;17;NANTES;MASCULIN;SCOLAIRE;BAC PROFESSIONNEL;BAC PRO PROD;BAC PRO 23408 Etude et réalisation d'agencement;3;3;2;1;0;0;0;2;0;0;0;1;1;1
5238.0;2021;17;NANTES;MASCULIN;SCOLAIRE;BAC PROFESSIONNEL;BAC PRO PROD;BAC PRO 24202 ARTIS.& MET.ART : TAPIS.D'AMEUBL;1;1;0;1;0;0;0;0;0;0;0;0;0;1
5244.0;2021;17;NANTES;MASCULIN;SCOLAIRE;BAC PROFESSIONNEL;BAC PRO PROD;BAC PRO 25106 TECHNICIEN D'USINAGE;129;128;106;18;4;1;3;107;0;12;20;46;29;21
5245.0;2021;17;NANTES;MASCULIN;SCOLAIRE;BAC PROFESSIONNEL;BAC PRO PROD;BAC PRO 25107 TECHNICIEN OUTILLEUR;12;12;10;1;1;0;1;10;0;0;1;7;2;2
5247.0;2021;17;NANTES;MASCULIN;SCOLAIRE;BAC PROFESSIONNEL;BAC PRO PROD;BAC PRO 25215 MAINT.VEHIC.OPTB VEHIC.TRANS.ROUT;28;28;22;6;0;0;0;22;0;0;3;11;8;6
5252.0;2021;17;NANTES;MASCULIN;SCOLAIRE;BAC PROFESSIONNEL;BAC PRO PROD;BAC PRO 25406 OUVRAGES DU BATIMENT METALLERIE;30;30;26;3;1;1;0;27;0;1;7;8;11;3
5259.0;2021;17;NANTES;MASCULIN;SCOLAIRE;BAC PROFESSIONNEL;BAC PRO PROD;BAC PRO 25514 SYST.NUM.OPT.B AUD.RES.EQUIP.DOM.;91;91;85;6;0;0;0;85;0;4;29;33;19;6
5265.0;2021;17;NANTES;MASCULIN;SCOLAIRE;BAC PROFESSIONNEL;BAC PRO PROD;BAC PRO AG 21203 TECHN CONSEIL DE VENTE ANIMAL;37;36;33;3;0;0;0;33;0;0;3;12;18;3
5267.0;2021;17;NANTES;MASCULIN;SCOLAIRE;BAC PROFESSIONNEL;BAC PRO PROD;BAC PRO AG 21210 COND GEST ENTR CANIN ET FELIN;10;10;10;0;0;0;0;10;0;0;0;3;7;0
5269.0;2021;17;NANTES;MASCULIN;SCOLAIRE;BAC PROFESSIONNEL;BAC PRO PROD;BAC PRO AG 21302 GEST MILIEUX NATURELS FAUNE;56;53;52;1;0;0;0;52;0;3;9;26;14;1
5270.0;2021;17;NANTES;MASCULIN;SCOLAIRE;BAC PROFESSIONNEL;BAC PRO PROD;BAC PRO AG 21303 FORET;6;6;6;0;0;0;0;6;0;0;0;2;4;0
5272.0;2021;17;NANTES;MASCULIN;SCOLAIRE;BAC PROFESSIONNEL;BAC PRO PROD;BAC PRO AG 21406 TEC CONS VTE PROD DES JARDINS;3;3;3;0;0;0;0;3;0;0;0;0;3;0
5278.0;2021;17;NANTES;MASCULIN;SCOLAIRE;BAC PROFESSIONNEL;BAC PRO SERV;BAC PRO 31108 TRANSPORT;65;65;44;14;7;5;2;49;0;0;5;20;24;16
5287.0;2021;17;NANTES;MASCULIN;SCOLAIRE;BAC PROFESSIONNEL;BAC PRO SERV;BAC PRO 33003 ACC.SOINS-S.PERS. OPT.A DOMICILE;10;10;7;3;0;0;0;7;0;0;0;3;4;3
5288.0;2021;17;NANTES;MASCULIN;SCOLAIRE;BAC PROFESSIONNEL;BAC PRO SERV;BAC PRO 33004 ACC.SOINS-S.PERS. OPT.EN STRUCTUR;37;37;34;3;0;0;0;34;0;3;5;19;7;3
5292.0;2021;17;NANTES;MASCULIN;SCOLAIRE;BAC PROFESSIONNEL;BAC PRO SERV;BAC PRO 33403 COMMERC. SERVICES EN RESTAURATION;108;108;97;7;4;3;1;100;0;1;21;41;37;8
5293.0;2021;17;NANTES;MASCULIN;SCOLAIRE;BAC PROFESSIONNEL;BAC PRO SERV;BAC PRO 33603 ESTHETIQUE COSMETIQUE PARFUMERIE;1;1;1;0;0;0;0;1;0;0;1;0;0;0
5300.0;2021;17;NANTES;MASCULIN;SCOLAIRE;BAC TECHNOLOGIQUE;BAC ST2S;BAC ST2S SCIENCES & TECHNO. SANTE & SOCIAL;177;177;155;4;18;14;4;169;0;2;15;49;103;8
5302.0;2021;17;NANTES;MASCULIN;SCOLAIRE;BAC TECHNOLOGIQUE;BAC STD2A;BAC STD2A SCIENCES & TECHNO. DESIGN-ARTS APPLIQUES;32;32;32;0;0;0;0;32;0;3;13;12;4;0
5306.0;2021;17;NANTES;MASCULIN;SCOLAIRE;BAC TECHNOLOGIQUE;BAC STI2D;BAC STI2D INNOVATION TECHNO.  ET ECO CONCEPTION;478;478;448;2;28;16;12;464;0;12;101;195;156;14
5307.0;2021;17;NANTES;MASCULIN;SCOLAIRE;BAC TECHNOLOGIQUE;BAC STI2D;BAC STI2D SYSTÈME D'INFORMATION  ET NUMERIQUE;459;459;428;3;28;15;13;443;2;13;66;205;157;16
5315.0;2021;23;NICE;FEMININ;APPRENTISSAGE;BAC PROFESSIONNEL;BAC PRO PROD;BAC PRO 25009 MAINTENANCE NAUTIQUE;1;1;1;0;0;0;0;1;0;0;0;0;1;0
5329.0;2021;23;NICE;FEMININ;ENSEIGNEMENT A DISTANCE;BAC PROFESSIONNEL;BAC PRO PROD;BAC PRO 25214 MAINT.VEHIC.OPTA VOIT.PARTICUL.;1;1;1;0;0;0;0;1;0;0;0;1;0;0
5334.0;2021;23;NICE;FEMININ;ENSEIGNEMENT A DISTANCE;BAC PROFESSIONNEL;BAC PRO SERV;BAC PRO 33603 ESTHETIQUE COSMETIQUE PARFUMERIE;4;1;0;1;0;0;0;0;0;0;0;0;0;1
5344.0;2021;23;NICE;FEMININ;FORMATION CONTINUE;BAC PROFESSIONNEL;BAC PRO SERV;BAC PRO 33101 OPTIQUE LUNETTERIE;5;5;5;0;0;0;0;5;0;0;1;2;2;0
5346.0;2021;23;NICE;FEMININ;FORMATION CONTINUE;BAC PROFESSIONNEL;BAC PRO SERV;BAC PRO AG 33002 SERV PERS TERRIT;5;5;3;2;0;0;0;3;0;1;0;1;1;2
5353.0;2021;23;NICE;FEMININ;INDIVIDUEL;BAC PROFESSIONNEL;BAC PRO SERV;BAC PRO 31210 ACCUEIL -RELATION CLIENTS USAGERS;1;0;0;0;0;0;0;0;0;0;0;0;0;0
5355.0;2021;23;NICE;FEMININ;INDIVIDUEL;BAC PROFESSIONNEL;BAC PRO SERV;BAC PRO 33403 COMMERC. SERVICES EN RESTAURATION;1;1;1;0;0;0;0;1;0;0;0;1;0;0
5356.0;2021;23;NICE;FEMININ;INDIVIDUEL;BAC PROFESSIONNEL;BAC PRO SERV;BAC PRO 34403 METIERS DE LA SECURITE;1;1;1;0;0;0;0;1;0;0;0;1;0;0
5358.0;2021;23;NICE;FEMININ;INDIVIDUEL;BAC TECHNOLOGIQUE;BAC ST2S;BAC ST2S SCIENCES & TECHNO. SANTE & SOCIAL;10;7;3;3;1;1;0;4;0;0;0;1;3;3
5362.0;2021;23;NICE;FEMININ;INDIVIDUEL;BAC TECHNOLOGIQUE;BAC STMG;BAC STMG RESSOURCES HUMAINES ET COMMUNICATION;9;5;1;3;1;1;0;2;0;0;0;1;1;3
5363.0;2021;23;NICE;FEMININ;SCOLAIRE;BAC GENERAL;BAC GENERAL;BAC GENE 10019 BAC GENERAL;6355;6354;6145;41;168;94;74;6239;187;967;1855;2060;1170;115
5365.0;2021;23;NICE;FEMININ;SCOLAIRE;BAC PROFESSIONNEL;BAC PRO PROD;BAC PRO 22106 CUISINE;57;57;53;2;2;0;2;53;0;3;13;30;7;4
5370.0;2021;23;NICE;FEMININ;SCOLAIRE;BAC PROFESSIONNEL;BAC PRO PROD;BAC PRO 23102 TRAVAUX PUBLICS;1;1;0;1;0;0;0;0;0;0;0;0;0;1
5373.0;2021;23;NICE;FEMININ;SCOLAIRE;BAC PROFESSIONNEL;BAC PRO PROD;BAC PRO 23304 AMENAGEMENT FINITION BATIMENT;4;4;2;1;1;1;0;3;0;0;0;1;2;1
5375.0;2021;23;NICE;FEMININ;SCOLAIRE;BAC PROFESSIONNEL;BAC PRO PROD;BAC PRO 23408 Etude et réalisation d'agencement;4;4;3;0;1;1;0;4;0;0;0;1;3;0
5396.0;2021;23;NICE;FEMININ;SCOLAIRE;BAC PROFESSIONNEL;BAC PRO PROD;BAC PRO AG 22105 LABORATOIRE CONTROLE QUALITE;13;11;9;2;0;0;0;9;0;3;1;3;2;2
5402.0;2021;23;NICE;FEMININ;SCOLAIRE;BAC PROFESSIONNEL;BAC PRO SERV;BAC PRO 31206 VENTE (PROSPECT.NEGO.SUIV.CLIENT;98;98;85;9;4;2;2;87;0;5;21;34;27;11
5407.0;2021;23;NICE;FEMININ;SCOLAIRE;BAC PROFESSIONNEL;BAC PRO SERV;BAC PRO 33002 SERVICES DE PROXIMITE  VIE LOCAL;7;7;6;0;1;0;1;6;0;0;0;3;3;1
5419.0;2021;23;NICE;FEMININ;SCOLAIRE;BAC TECHNOLOGIQUE;BAC STAV;BAC STAV AGRONOMIE ALIM ENV TERRITOI;38;38;37;1;0;0;0;37;0;2;1;23;11;1
5421.0;2021;23;NICE;FEMININ;SCOLAIRE;BAC TECHNOLOGIQUE;BAC STHR;BAC STHR SC.&TEC. HOTELLERIE-RESTAURATION;45;45;45;0;0;0;0;45;0;2;15;14;14;0
5427.0;2021;23;NICE;FEMININ;SCOLAIRE;BAC TECHNOLOGIQUE;BAC STL;BAC STL SCIENCES PHYSIQUES CHIMIQUES  EN LABORAT.;48;48;47;0;1;1;0;48;0;8;10;18;12;0
5428.0;2021;23;NICE;FEMININ;SCOLAIRE;BAC TECHNOLOGIQUE;BAC STMG;BAC STMG GESTION ET FINANCE;170;170;163;1;6;5;1;168;1;9;37;68;53;2
5441.0;2021;23;NICE;MASCULIN;APPRENTISSAGE;BAC PROFESSIONNEL;BAC PRO PROD;BAC PRO 25009 MAINTENANCE NAUTIQUE;26;25;16;3;6;1;5;17;0;1;0;8;8;8
5445.0;2021;23;NICE;MASCULIN;APPRENTISSAGE;BAC PROFESSIONNEL;BAC PRO PROD;BAC PRO 25408 REPARATION DES CARROSSERIES;20;19;15;4;0;0;0;15;0;2;3;4;6;4
5446.0;2021;23;NICE;MASCULIN;APPRENTISSAGE;BAC PROFESSIONNEL;BAC PRO PROD;BAC PRO 25411 TECH.CHAUDRONNERIE INDUSTRIELLE;7;7;4;2;1;0;1;4;0;2;0;1;1;3
5448.0;2021;23;NICE;MASCULIN;APPRENTISSAGE;BAC PROFESSIONNEL;BAC PRO PROD;BAC PRO 25510 METIERS ELECT. ENVIRON. CONNECTES;29;28;23;4;1;1;0;24;0;0;12;6;6;4
5449.0;2021;23;NICE;MASCULIN;APPRENTISSAGE;BAC PROFESSIONNEL;BAC PRO PROD;BAC PRO 25514 SYST.NUM.OPT.B AUD.RES.EQUIP.DOM.;10;10;9;1;0;0;0;9;0;1;5;3;0;1
5450.0;2021;23;NICE;MASCULIN;APPRENTISSAGE;BAC PROFESSIONNEL;BAC PRO PROD;BAC PRO AG 21113 CGEVV;7;7;7;0;0;0;0;7;0;0;1;2;4;0
5457.0;2021;23;NICE;MASCULIN;APPRENTISSAGE;BAC PROFESSIONNEL;BAC PRO SERV;BAC PRO 33004 ACC.SOINS-S.PERS. OPT.EN STRUCTUR;2;2;2;0;0;0;0;2;0;1;0;1;0;0
5462.0;2021;23;NICE;MASCULIN;ENSEIGNEMENT A DISTANCE;BAC PROFESSIONNEL;BAC PRO SERV;BAC PRO 31202 COMMERCE;2;1;0;1;0;0;0;0;0;0;0;0;0;1
5469.0;2021;23;NICE;MASCULIN;FORMATION CONTINUE;BAC PROFESSIONNEL;BAC PRO PROD;BAC PRO 22106 CUISINE;4;4;4;0;0;0;0;4;0;1;0;2;1;0
5471.0;2021;23;NICE;MASCULIN;FORMATION CONTINUE;BAC PROFESSIONNEL;BAC PRO PROD;BAC PRO 25216 MAINT.VEHIC.OPTC MOTOCYCLES;1;1;1;0;0;0;0;1;0;0;0;0;1;0
5472.0;2021;23;NICE;MASCULIN;FORMATION CONTINUE;BAC PROFESSIONNEL;BAC PRO PROD;BAC PRO 25510 METIERS ELECT. ENVIRON. CONNECTES;35;35;33;2;0;0;0;33;0;17;11;5;0;2
5478.0;2021;23;NICE;MASCULIN;INDIVIDUEL;BAC GENERAL;BAC GENERAL;BAC GENE 10019 BAC GENERAL;153;123;78;26;19;14;5;92;1;4;10;26;51;31
5481.0;2021;23;NICE;MASCULIN;INDIVIDUEL;BAC PROFESSIONNEL;BAC PRO PROD;BAC PRO 25006 MICROTECHNIQUES;1;1;1;0;0;0;0;1;0;0;1;0;0;0
5495.0;2021;23;NICE;MASCULIN;INDIVIDUEL;BAC PROFESSIONNEL;BAC PRO SERV;BAC PRO 34403 METIERS DE LA SECURITE;1;0;0;0;0;0;0;0;0;0;0;0;0;0
5498.0;2021;23;NICE;MASCULIN;INDIVIDUEL;BAC TECHNOLOGIQUE;BAC STAV;BAC STAV AGRONOMIE ALIM ENV TERRITOI;1;1;1;0;0;0;0;1;0;0;0;0;1;0
5499.0;2021;23;NICE;MASCULIN;INDIVIDUEL;BAC TECHNOLOGIQUE;BAC STI2D;BAC STI2D ENERGIES  ET ENVIRONNEMENT;3;2;0;1;1;1;0;1;0;0;0;0;1;1
5501.0;2021;23;NICE;MASCULIN;INDIVIDUEL;BAC TECHNOLOGIQUE;BAC STL;BAC STL SCIENCES PHYSIQUES CHIMIQUES  EN LABORAT.;1;0;0;0;0;0;0;0;0;0;0;0;0;0
5505.0;2021;23;NICE;MASCULIN;INDIVIDUEL;BAC TECHNOLOGIQUE;BAC STMG;BAC STMG SYSTEMES D'INFORMATION DE GESTION;2;2;1;0;1;0;1;1;0;0;0;0;1;1
5510.0;2021;23;NICE;MASCULIN;SCOLAIRE;BAC PROFESSIONNEL;BAC PRO PROD;BAC PRO 22106 CUISINE;132;132;116;9;7;2;5;118;0;5;29;60;24;14
5521.0;2021;23;NICE;MASCULIN;SCOLAIRE;BAC PROFESSIONNEL;BAC PRO PROD;BAC PRO 23304 AMENAGEMENT FINITION BATIMENT;11;11;8;1;2;1;1;9;0;0;1;4;4;2
5527.0;2021;23;NICE;MASCULIN;SCOLAIRE;BAC PROFESSIONNEL;BAC PRO PROD;BAC PRO 24302 METIERS DU CUIR : MAROQUINERIE;1;1;1;0;0;0;0;1;0;0;0;0;1;0
5531.0;2021;23;NICE;MASCULIN;SCOLAIRE;BAC PROFESSIONNEL;BAC PRO PROD;BAC PRO 25106 TECHNICIEN D'USINAGE;36;36;26;10;0;0;0;26;0;1;4;10;11;10
5532.0;2021;23;NICE;MASCULIN;SCOLAIRE;BAC PROFESSIONNEL;BAC PRO PROD;BAC PRO 25107 TECHNICIEN OUTILLEUR;7;7;7;0;0;0;0;7;0;0;0;4;3;0
5536.0;2021;23;NICE;MASCULIN;SCOLAIRE;BAC PROFESSIONNEL;BAC PRO PROD;BAC PRO 25220 MAINT.MATERIELS OPT.B TP MANUT.;18;18;15;3;0;0;0;15;0;0;3;6;6;3
5538.0;2021;23;NICE;MASCULIN;SCOLAIRE;BAC PROFESSIONNEL;BAC PRO PROD;BAC PRO 25408 REPARATION DES CARROSSERIES;36;36;26;8;2;2;0;28;0;0;4;6;18;8
5548.0;2021;23;NICE;MASCULIN;SCOLAIRE;BAC PROFESSIONNEL;BAC PRO PROD;BAC PRO AG 21303 FORET;10;10;10;0;0;0;0;10;0;0;0;7;3;0
5552.0;2021;23;NICE;MASCULIN;SCOLAIRE;BAC PROFESSIONNEL;BAC PRO SERV;BAC PRO 31106 LOGISTIQUE;25;25;19;4;2;2;0;21;0;0;0;5;16;4
5558.0;2021;23;NICE;MASCULIN;SCOLAIRE;BAC PROFESSIONNEL;BAC PRO SERV;BAC PRO 32207 REAL.PR.IMPR.PLURI.OPTA.PR.GRAPH.;6;6;6;0;0;0;0;6;0;0;1;4;1;0
5561.0;2021;23;NICE;MASCULIN;SCOLAIRE;BAC PROFESSIONNEL;BAC PRO SERV;BAC PRO 33002 SERVICES DE PROXIMITE  VIE LOCAL;5;5;4;1;0;0;0;4;0;0;0;1;3;1
5562.0;2021;23;NICE;MASCULIN;SCOLAIRE;BAC PROFESSIONNEL;BAC PRO SERV;BAC PRO 33003 ACC.SOINS-S.PERS. OPT.A DOMICILE;1;1;0;0;1;1;0;1;0;0;0;0;1;0
5565.0;2021;23;NICE;MASCULIN;SCOLAIRE;BAC PROFESSIONNEL;BAC PRO SERV;BAC PRO 33403 COMMERC. SERVICES EN RESTAURATION;63;63;50;6;7;3;4;53;0;7;5;23;18;10
5574.0;2021;23;NICE;MASCULIN;SCOLAIRE;BAC TECHNOLOGIQUE;BAC STHR;BAC STHR SC.&TEC. HOTELLERIE-RESTAURATION;38;38;36;0;2;1;1;37;0;3;9;16;9;1
5579.0;2021;23;NICE;MASCULIN;SCOLAIRE;BAC TECHNOLOGIQUE;BAC STL;BAC STL BIOCHIM.-BIOLOGIE-BIOTECHNOL.;36;36;34;0;2;1;1;35;0;3;6;9;17;1
5584.0;2021;23;NICE;MASCULIN;SCOLAIRE;BAC TECHNOLOGIQUE;BAC STMG;BAC STMG SYSTEMES D'INFORMATION DE GESTION;13;13;13;0;0;0;0;13;0;0;0;5;8;0
5592.0;2021;70;NORMANDIE;FEMININ;APPRENTISSAGE;BAC PROFESSIONNEL;BAC PRO PROD;BAC PRO 25107 TECHNICIEN OUTILLEUR;1;1;1;0;0;0;0;1;0;0;0;0;1;0
5600.0;2021;70;NORMANDIE;FEMININ;APPRENTISSAGE;BAC PROFESSIONNEL;BAC PRO PROD;BAC PRO AG 21114 CONDUITE PRODUCTIONS HORTICOLES;2;2;2;0;0;0;0;2;0;0;0;0;2;0
5601.0;2021;70;NORMANDIE;FEMININ;APPRENTISSAGE;BAC PROFESSIONNEL;BAC PRO PROD;BAC PRO AG 21203 TECHN CONSEIL DE VENTE ANIMAL;8;8;8;0;0;0;0;8;0;0;0;1;7;0
5603.0;2021;70;NORMANDIE;FEMININ;APPRENTISSAGE;BAC PROFESSIONNEL;BAC PRO PROD;BAC PRO AG 21405 AMENAGEMENTS PAYSAGERS;3;3;3;0;0;0;0;3;0;0;1;1;1;0
5605.0;2021;70;NORMANDIE;FEMININ;APPRENTISSAGE;BAC PROFESSIONNEL;BAC PRO PROD;BAC PRO AG 22107 TEC CONS VTE ALIMENTATION P.ALIM;13;12;9;3;0;0;0;9;0;0;1;6;2;3
5607.0;2021;70;NORMANDIE;FEMININ;APPRENTISSAGE;BAC PROFESSIONNEL;BAC PRO SERV;BAC PRO 31106 LOGISTIQUE;4;4;4;0;0;0;0;4;0;1;1;1;1;0
5611.0;2021;70;NORMANDIE;FEMININ;APPRENTISSAGE;BAC PROFESSIONNEL;BAC PRO SERV;BAC PRO 33003 ACC.SOINS-S.PERS. OPT.A DOMICILE;4;4;4;0;0;0;0;4;0;0;2;2;0;0
5620.0;2021;70;NORMANDIE;FEMININ;ENSEIGNEMENT A DISTANCE;BAC PROFESSIONNEL;BAC PRO SERV;BAC PRO 33004 ACC.SOINS-S.PERS. OPT.EN STRUCTUR;6;4;3;1;0;0;0;3;0;0;0;0;3;1
5622.0;2021;70;NORMANDIE;FEMININ;ENSEIGNEMENT A DISTANCE;BAC TECHNOLOGIQUE;BAC STMG;BAC STMG MERCATIQUE (MARKETING);5;5;4;1;0;0;0;4;0;0;2;1;1;1
5623.0;2021;70;NORMANDIE;FEMININ;ENSEIGNEMENT A DISTANCE;BAC TECHNOLOGIQUE;BAC STMG;BAC STMG RESSOURCES HUMAINES ET COMMUNICATION;4;4;4;0;0;0;0;4;0;0;0;3;1;0
5635.0;2021;70;NORMANDIE;FEMININ;FORMATION CONTINUE;BAC PROFESSIONNEL;BAC PRO SERV;BAC PRO 32207 REAL.PR.IMPR.PLURI.OPTA.PR.GRAPH.;6;5;2;3;0;0;0;2;0;0;0;2;0;3
5637.0;2021;70;NORMANDIE;FEMININ;FORMATION CONTINUE;BAC PROFESSIONNEL;BAC PRO SERV;BAC PRO 34304 HYGIENE PROPRETE STERILISATION;6;5;4;1;0;0;0;4;0;2;1;0;1;1
5641.0;2021;70;NORMANDIE;FEMININ;INDIVIDUEL;BAC PROFESSIONNEL;BAC PRO PROD;BAC PRO AG 21211 COND GEST ENTR HIPPIQUE;4;3;2;1;0;0;0;2;0;0;0;0;2;1
5642.0;2021;70;NORMANDIE;FEMININ;INDIVIDUEL;BAC PROFESSIONNEL;BAC PRO SERV;BAC PRO 30001 GESTION-ADMINISTRATION;11;11;6;3;2;0;2;6;0;1;0;1;4;5
5652.0;2021;70;NORMANDIE;FEMININ;INDIVIDUEL;BAC TECHNOLOGIQUE;BAC STI2D;BAC STI2D INNOVATION TECHNO.  ET ECO CONCEPTION;1;0;0;0;0;0;0;0;0;0;0;0;0;0
5654.0;2021;70;NORMANDIE;FEMININ;INDIVIDUEL;BAC TECHNOLOGIQUE;BAC STMG;BAC STMG MERCATIQUE (MARKETING);8;6;3;1;2;1;1;4;0;0;1;2;1;2
5663.0;2021;70;NORMANDIE;FEMININ;SCOLAIRE;BAC PROFESSIONNEL;BAC PRO PROD;BAC PRO 22503 PLASTIQUES ET COMPOSITES;3;3;1;1;1;1;0;2;0;0;0;0;2;1
5669.0;2021;70;NORMANDIE;FEMININ;SCOLAIRE;BAC PROFESSIONNEL;BAC PRO PROD;BAC PRO 23203 TECHNICIEN BAT. : ORG.REAL.GROS O;2;2;2;0;0;0;0;2;0;0;1;1;0;0
5672.0;2021;70;NORMANDIE;FEMININ;SCOLAIRE;BAC PROFESSIONNEL;BAC PRO PROD;BAC PRO 23405 TECHNICIEN MENUISIER AGENCEUR;5;5;5;0;0;0;0;5;0;1;2;1;1;0
5677.0;2021;70;NORMANDIE;FEMININ;SCOLAIRE;BAC PROFESSIONNEL;BAC PRO PROD;BAC PRO 25006 MICROTECHNIQUES;3;3;3;0;0;0;0;3;0;0;0;2;1;0
5679.0;2021;70;NORMANDIE;FEMININ;SCOLAIRE;BAC PROFESSIONNEL;BAC PRO PROD;BAC PRO 25106 TECHNICIEN D'USINAGE;6;6;4;1;1;1;0;5;0;0;2;1;2;1
5680.0;2021;70;NORMANDIE;FEMININ;SCOLAIRE;BAC PROFESSIONNEL;BAC PRO PROD;BAC PRO 25214 MAINT.VEHIC.OPTA VOIT.PARTICUL.;11;11;10;1;0;0;0;10;0;2;4;3;1;1
5684.0;2021;70;NORMANDIE;FEMININ;SCOLAIRE;BAC PROFESSIONNEL;BAC PRO PROD;BAC PRO 25411 TECH.CHAUDRONNERIE INDUSTRIELLE;3;3;3;0;0;0;0;3;0;0;1;0;2;0
5687.0;2021;70;NORMANDIE;FEMININ;SCOLAIRE;BAC PROFESSIONNEL;BAC PRO PROD;BAC PRO 25514 SYST.NUM.OPT.B AUD.RES.EQUIP.DOM.;2;2;1;1;0;0;0;1;0;0;0;0;1;1
5702.0;2021;70;NORMANDIE;FEMININ;SCOLAIRE;BAC PROFESSIONNEL;BAC PRO SERV;BAC PRO 31106 LOGISTIQUE;35;35;27;3;5;0;5;27;0;1;5;11;10;8
5705.0;2021;70;NORMANDIE;FEMININ;SCOLAIRE;BAC PROFESSIONNEL;BAC PRO SERV;BAC PRO 31202 COMMERCE;539;537;495;19;23;12;11;507;0;33;143;193;138;30
5710.0;2021;70;NORMANDIE;FEMININ;SCOLAIRE;BAC PROFESSIONNEL;BAC PRO SERV;BAC PRO 32303 ART.& MET.ART:COM.VIS.VIS.PLURI-M;22;22;19;3;0;0;0;19;0;1;5;11;2;3
5712.0;2021;70;NORMANDIE;FEMININ;SCOLAIRE;BAC PROFESSIONNEL;BAC PRO SERV;BAC PRO 33002 SERVICES DE PROXIMITE  VIE LOCAL;88;88;73;7;8;7;1;80;0;2;18;33;27;8
5713.0;2021;70;NORMANDIE;FEMININ;SCOLAIRE;BAC PROFESSIONNEL;BAC PRO SERV;BAC PRO 33003 ACC.SOINS-S.PERS. OPT.A DOMICILE;131;131;121;6;4;2;2;123;0;6;21;57;39;8
5715.0;2021;70;NORMANDIE;FEMININ;SCOLAIRE;BAC PROFESSIONNEL;BAC PRO SERV;BAC PRO 33101 OPTIQUE LUNETTERIE;10;10;10;0;0;0;0;10;0;3;3;3;1;0
5721.0;2021;70;NORMANDIE;FEMININ;SCOLAIRE;BAC PROFESSIONNEL;BAC PRO SERV;BAC PRO 34305 TECHN.D'INTERV.SUR INSTALL. NUCL.;1;1;1;0;0;0;0;1;0;0;1;0;0;0
5728.0;2021;70;NORMANDIE;FEMININ;SCOLAIRE;BAC TECHNOLOGIQUE;BAC STD2A;BAC STD2A SCIENCES & TECHNO. DESIGN-ARTS APPLIQUES;53;53;53;0;0;0;0;53;0;10;23;18;2;0
5732.0;2021;70;NORMANDIE;FEMININ;SCOLAIRE;BAC TECHNOLOGIQUE;BAC STI2D;BAC STI2D INNOVATION TECHNO.  ET ECO CONCEPTION;32;32;29;0;3;1;2;30;0;1;6;9;14;2
5734.0;2021;70;NORMANDIE;FEMININ;SCOLAIRE;BAC TECHNOLOGIQUE;BAC STL;BAC STL BIOCHIM.-BIOLOGIE-BIOTECHNOL.;168;168;151;2;15;10;5;161;1;4;25;51;80;7
5744.0;2021;70;NORMANDIE;MASCULIN;APPRENTISSAGE;BAC PROFESSIONNEL;BAC PRO PROD;BAC PRO 22105 BOULANGER-PÂTISSIER;3;3;1;1;1;0;1;1;0;0;1;0;0;2
5756.0;2021;70;NORMANDIE;MASCULIN;APPRENTISSAGE;BAC PROFESSIONNEL;BAC PRO PROD;BAC PRO 25009 MAINTENANCE NAUTIQUE;2;2;2;0;0;0;0;2;0;0;1;0;1;0
5759.0;2021;70;NORMANDIE;MASCULIN;APPRENTISSAGE;BAC PROFESSIONNEL;BAC PRO PROD;BAC PRO 25214 MAINT.VEHIC.OPTA VOIT.PARTICUL.;190;185;163;16;6;3;3;166;0;16;40;67;43;19
5760.0;2021;70;NORMANDIE;MASCULIN;APPRENTISSAGE;BAC PROFESSIONNEL;BAC PRO PROD;BAC PRO 25215 MAINT.VEHIC.OPTB VEHIC.TRANS.ROUT;31;30;27;2;1;1;0;28;0;1;9;6;12;2
5762.0;2021;70;NORMANDIE;MASCULIN;APPRENTISSAGE;BAC PROFESSIONNEL;BAC PRO PROD;BAC PRO 25220 MAINT.MATERIELS OPT.B TP MANUT.;6;6;5;1;0;0;0;5;0;1;0;3;1;1
5767.0;2021;70;NORMANDIE;MASCULIN;APPRENTISSAGE;BAC PROFESSIONNEL;BAC PRO PROD;BAC PRO 25510 METIERS ELECT. ENVIRON. CONNECTES;80;80;69;11;0;0;0;69;0;13;10;27;19;11
5768.0;2021;70;NORMANDIE;MASCULIN;APPRENTISSAGE;BAC PROFESSIONNEL;BAC PRO PROD;BAC PRO 25513 SYST.NUM.OPT.A SURETE SECURITE;1;1;1;0;0;0;0;1;0;1;0;0;0;0
5769.0;2021;70;NORMANDIE;MASCULIN;APPRENTISSAGE;BAC PROFESSIONNEL;BAC PRO PROD;BAC PRO 25514 SYST.NUM.OPT.B AUD.RES.EQUIP.DOM.;2;2;2;0;0;0;0;2;0;0;0;1;1;0
5770.0;2021;70;NORMANDIE;MASCULIN;APPRENTISSAGE;BAC PROFESSIONNEL;BAC PRO PROD;BAC PRO 25515 SYST.NUM.OPT.C RES.INF.SYST.COMM.;3;3;3;0;0;0;0;3;0;1;2;0;0;0
5772.0;2021;70;NORMANDIE;MASCULIN;APPRENTISSAGE;BAC PROFESSIONNEL;BAC PRO PROD;BAC PRO AG 21004 CGEA;79;79;64;15;0;0;0;64;0;0;3;18;43;15
5778.0;2021;70;NORMANDIE;MASCULIN;APPRENTISSAGE;BAC PROFESSIONNEL;BAC PRO PROD;BAC PRO AG 21405 AMENAGEMENTS PAYSAGERS;85;81;77;4;0;0;0;77;0;4;15;28;30;4
5781.0;2021;70;NORMANDIE;MASCULIN;APPRENTISSAGE;BAC PROFESSIONNEL;BAC PRO SERV;BAC PRO 30001 GESTION-ADMINISTRATION;4;4;2;2;0;0;0;2;0;0;2;0;0;2
5782.0;2021;70;NORMANDIE;MASCULIN;APPRENTISSAGE;BAC PROFESSIONNEL;BAC PRO SERV;BAC PRO 31106 LOGISTIQUE;36;36;27;5;4;1;3;28;0;4;6;10;8;8
5791.0;2021;70;NORMANDIE;MASCULIN;ENSEIGNEMENT A DISTANCE;BAC PROFESSIONNEL;BAC PRO SERV;BAC PRO 31202 COMMERCE;2;2;0;2;0;0;0;0;0;0;0;0;0;2
5801.0;2021;70;NORMANDIE;MASCULIN;FORMATION CONTINUE;BAC PROFESSIONNEL;BAC PRO PROD;BAC PRO 23004 TECHN. ETUDES BAT.A ETUDES & ECO.;2;2;2;0;0;0;0;2;0;0;2;0;0;0
5807.0;2021;70;NORMANDIE;MASCULIN;FORMATION CONTINUE;BAC PROFESSIONNEL;BAC PRO PROD;BAC PRO 25107 TECHNICIEN OUTILLEUR;1;1;1;0;0;0;0;1;0;0;0;0;1;0
5808.0;2021;70;NORMANDIE;MASCULIN;FORMATION CONTINUE;BAC PROFESSIONNEL;BAC PRO PROD;BAC PRO 25214 MAINT.VEHIC.OPTA VOIT.PARTICUL.;1;1;1;0;0;0;0;1;0;1;0;0;0;0
5810.0;2021;70;NORMANDIE;MASCULIN;FORMATION CONTINUE;BAC PROFESSIONNEL;BAC PRO PROD;BAC PRO 25510 METIERS ELECT. ENVIRON. CONNECTES;18;18;18;0;0;0;0;18;0;6;8;1;3;0
5811.0;2021;70;NORMANDIE;MASCULIN;FORMATION CONTINUE;BAC PROFESSIONNEL;BAC PRO PROD;BAC PRO 25513 SYST.NUM.OPT.A SURETE SECURITE;4;4;4;0;0;0;0;4;0;1;3;0;0;0
5813.0;2021;70;NORMANDIE;MASCULIN;FORMATION CONTINUE;BAC PROFESSIONNEL;BAC PRO PROD;BAC PRO AG 22107 TEC CONS VTE ALIMENTATION P.ALIM;3;1;1;0;0;0;0;1;0;0;0;0;1;0
5823.0;2021;70;NORMANDIE;MASCULIN;INDIVIDUEL;BAC PROFESSIONNEL;BAC PRO PROD;BAC PRO 25007 MAINTENANCE EQUIPEMENTS INDUST.;2;1;1;0;0;0;0;1;0;0;1;0;0;0
5829.0;2021;70;NORMANDIE;MASCULIN;INDIVIDUEL;BAC PROFESSIONNEL;BAC PRO PROD;BAC PRO 25510 METIERS ELECT. ENVIRON. CONNECTES;2;1;0;1;0;0;0;0;0;0;0;0;0;1
5835.0;2021;70;NORMANDIE;MASCULIN;INDIVIDUEL;BAC PROFESSIONNEL;BAC PRO PROD;BAC PRO AG 21405 AMENAGEMENTS PAYSAGERS;1;0;0;0;0;0;0;0;0;0;0;0;0;0
5841.0;2021;70;NORMANDIE;MASCULIN;INDIVIDUEL;BAC TECHNOLOGIQUE;BAC STAV;BAC STAV AGRONOMIE ALIM ENV TERRITOI;2;1;1;0;0;0;0;1;0;0;0;0;1;0
5848.0;2021;70;NORMANDIE;MASCULIN;INDIVIDUEL;BAC TECHNOLOGIQUE;BAC STMG;BAC STMG SYSTEMES D'INFORMATION DE GESTION;3;2;1;1;0;0;0;1;0;0;0;0;1;1
5849.0;2021;70;NORMANDIE;MASCULIN;SCOLAIRE;BAC GENERAL;BAC GENERAL;BAC GENE 10019 BAC GENERAL;7779;7777;7225;85;467;287;180;7512;115;704;1594;2504;2595;265
5856.0;2021;70;NORMANDIE;MASCULIN;SCOLAIRE;BAC PROFESSIONNEL;BAC PRO PROD;BAC PRO 22303 FONDERIE;6;6;3;2;1;0;1;3;0;1;0;2;0;3
5863.0;2021;70;NORMANDIE;MASCULIN;SCOLAIRE;BAC PROFESSIONNEL;BAC PRO PROD;BAC PRO 23102 TRAVAUX PUBLICS;44;44;43;1;0;0;0;43;0;2;17;17;7;1
5868.0;2021;70;NORMANDIE;MASCULIN;SCOLAIRE;BAC PROFESSIONNEL;BAC PRO PROD;BAC PRO 23304 AMENAGEMENT FINITION BATIMENT;26;26;16;8;2;2;0;18;0;2;6;4;6;8
5874.0;2021;70;NORMANDIE;MASCULIN;SCOLAIRE;BAC PROFESSIONNEL;BAC PRO PROD;BAC PRO 24203 METIERS DE LA MODE - VÊTEMENT;17;17;15;2;0;0;0;15;0;1;2;7;5;2
5880.0;2021;70;NORMANDIE;MASCULIN;SCOLAIRE;BAC PROFESSIONNEL;BAC PRO PROD;BAC PRO 25107 TECHNICIEN OUTILLEUR;22;22;22;0;0;0;0;22;0;1;5;10;6;0
5883.0;2021;70;NORMANDIE;MASCULIN;SCOLAIRE;BAC PROFESSIONNEL;BAC PRO PROD;BAC PRO 25216 MAINT.VEHIC.OPTC MOTOCYCLES;13;13;12;1;0;0;0;12;0;1;5;3;3;1
5896.0;2021;70;NORMANDIE;MASCULIN;SCOLAIRE;BAC PROFESSIONNEL;BAC PRO PROD;BAC PRO AG 21004 CGEA;232;230;205;25;0;0;0;205;0;0;24;75;106;25
5899.0;2021;70;NORMANDIE;MASCULIN;SCOLAIRE;BAC PROFESSIONNEL;BAC PRO PROD;BAC PRO AG 21204 PROD-AQUACOLES;4;4;4;0;0;0;0;4;0;0;0;2;2;0
5902.0;2021;70;NORMANDIE;MASCULIN;SCOLAIRE;BAC PROFESSIONNEL;BAC PRO PROD;BAC PRO AG 21302 GEST MILIEUX NATURELS FAUNE;35;33;29;4;0;0;0;29;0;0;3;10;16;4
5903.0;2021;70;NORMANDIE;MASCULIN;SCOLAIRE;BAC PROFESSIONNEL;BAC PRO PROD;BAC PRO AG 21303 FORET;48;48;41;7;0;0;0;41;0;0;2;20;19;7
5909.0;2021;70;NORMANDIE;MASCULIN;SCOLAIRE;BAC PROFESSIONNEL;BAC PRO SERV;BAC PRO 31106 LOGISTIQUE;165;165;132;17;16;6;10;138;0;7;33;40;58;27
5911.0;2021;70;NORMANDIE;MASCULIN;SCOLAIRE;BAC PROFESSIONNEL;BAC PRO SERV;BAC PRO 31108 TRANSPORT;47;46;36;4;6;2;4;38;0;1;4;15;18;8
5913.0;2021;70;NORMANDIE;MASCULIN;SCOLAIRE;BAC PROFESSIONNEL;BAC PRO SERV;BAC PRO 31206 VENTE (PROSPECT.NEGO.SUIV.CLIENT;117;117;100;13;4;4;0;104;0;5;10;44;45;13
5915.0;2021;70;NORMANDIE;MASCULIN;SCOLAIRE;BAC PROFESSIONNEL;BAC PRO SERV;BAC PRO 32207 REAL.PR.IMPR.PLURI.OPTA.PR.GRAPH.;12;12;12;0;0;0;0;12;0;0;7;2;3;0
5917.0;2021;70;NORMANDIE;MASCULIN;SCOLAIRE;BAC PROFESSIONNEL;BAC PRO SERV;BAC PRO 32303 ART.& MET.ART:COM.VIS.VIS.PLURI-M;17;17;16;0;1;1;0;17;0;2;2;6;7;0
5920.0;2021;70;NORMANDIE;MASCULIN;SCOLAIRE;BAC PROFESSIONNEL;BAC PRO SERV;BAC PRO 33003 ACC.SOINS-S.PERS. OPT.A DOMICILE;3;3;3;0;0;0;0;3;0;0;2;1;0;0
5925.0;2021;70;NORMANDIE;MASCULIN;SCOLAIRE;BAC PROFESSIONNEL;BAC PRO SERV;BAC PRO 34303 GEST. POLLUTIONS PROTEC. ENVIRON.;5;5;4;0;1;1;0;5;0;0;0;2;3;0
5935.0;2021;70;NORMANDIE;MASCULIN;SCOLAIRE;BAC TECHNOLOGIQUE;BAC STHR;BAC STHR SC.&TEC. HOTELLERIE-RESTAURATION;60;60;57;0;3;2;1;59;0;3;11;23;22;1
5937.0;2021;70;NORMANDIE;MASCULIN;SCOLAIRE;BAC TECHNOLOGIQUE;BAC STI2D;BAC STI2D ENERGIES  ET ENVIRONNEMENT;279;279;243;11;25;15;10;258;0;4;31;90;133;21
5938.0;2021;70;NORMANDIE;MASCULIN;SCOLAIRE;BAC TECHNOLOGIQUE;BAC STI2D;BAC STI2D INNOVATION TECHNO.  ET ECO CONCEPTION;488;488;444;8;36;24;12;468;0;4;65;188;211;20
5943.0;2021;70;NORMANDIE;MASCULIN;SCOLAIRE;BAC TECHNOLOGIQUE;BAC STMG;BAC STMG MERCATIQUE (MARKETING);886;885;724;34;127;76;51;800;0;5;64;256;475;85
5948.0;2021;18;ORLEANS-TOURS;FEMININ;APPRENTISSAGE;BAC PROFESSIONNEL;BAC PRO PROD;BAC PRO 24302 METIERS DU CUIR : MAROQUINERIE;3;3;2;1;0;0;0;2;0;0;1;1;0;1
5949.0;2021;18;ORLEANS-TOURS;FEMININ;APPRENTISSAGE;BAC PROFESSIONNEL;BAC PRO PROD;BAC PRO 25007 MAINTENANCE EQUIPEMENTS INDUST.;3;3;3;0;0;0;0;3;0;2;0;1;0;0
5955.0;2021;18;ORLEANS-TOURS;FEMININ;APPRENTISSAGE;BAC PROFESSIONNEL;BAC PRO PROD;BAC PRO 25510 METIERS ELECT. ENVIRON. CONNECTES;1;1;1;0;0;0;0;1;0;0;1;0;0;0
5958.0;2021;18;ORLEANS-TOURS;FEMININ;APPRENTISSAGE;BAC PROFESSIONNEL;BAC PRO PROD;BAC PRO AG 21203 TECHN CONSEIL DE VENTE ANIMAL;3;3;3;0;0;0;0;3;0;0;1;0;2;0
5961.0;2021;18;ORLEANS-TOURS;FEMININ;APPRENTISSAGE;BAC PROFESSIONNEL;BAC PRO PROD;BAC PRO AG 21405 AMENAGEMENTS PAYSAGERS;4;4;4;0;0;0;0;4;0;0;1;2;1;0
5969.0;2021;18;ORLEANS-TOURS;FEMININ;APPRENTISSAGE;BAC PROFESSIONNEL;BAC PRO SERV;BAC PRO 33403 COMMERC. SERVICES EN RESTAURATION;5;5;4;0;1;1;0;5;0;0;1;1;3;0
5987.0;2021;18;ORLEANS-TOURS;FEMININ;INDIVIDUEL;BAC PROFESSIONNEL;BAC PRO PROD;BAC PRO AG 21114 CONDUITE PRODUCTIONS HORTICOLES;9;8;7;1;0;0;0;7;0;0;0;0;7;1
5993.0;2021;18;ORLEANS-TOURS;FEMININ;INDIVIDUEL;BAC PROFESSIONNEL;BAC PRO SERV;BAC PRO 31210 ACCUEIL -RELATION CLIENTS USAGERS;6;5;3;2;0;0;0;3;0;0;0;2;1;2
5997.0;2021;18;ORLEANS-TOURS;FEMININ;INDIVIDUEL;BAC PROFESSIONNEL;BAC PRO SERV;BAC PRO AG 33002 SERV PERS TERRIT;2;1;1;0;0;0;0;1;0;0;0;0;1;0
6002.0;2021;18;ORLEANS-TOURS;FEMININ;INDIVIDUEL;BAC TECHNOLOGIQUE;BAC STMG;BAC STMG GESTION ET FINANCE;3;1;1;0;0;0;0;1;0;0;0;1;0;0
6013.0;2021;18;ORLEANS-TOURS;FEMININ;SCOLAIRE;BAC PROFESSIONNEL;BAC PRO PROD;BAC PRO 23003 ARTIS. & M.ART:MARCHANDISAGE VIS.;13;13;13;0;0;0;0;13;0;2;3;5;3;0
6016.0;2021;18;ORLEANS-TOURS;FEMININ;SCOLAIRE;BAC PROFESSIONNEL;BAC PRO PROD;BACPRO 23103 TECHNICIEN GEOMETRE-TOPOGRAPHE;1;1;1;0;0;0;0;1;0;0;0;0;1;0
6018.0;2021;18;ORLEANS-TOURS;FEMININ;SCOLAIRE;BAC PROFESSIONNEL;BAC PRO PROD;BAC PRO 23405 TECHNICIEN MENUISIER AGENCEUR;3;3;3;0;0;0;0;3;0;0;0;2;1;0
6019.0;2021;18;ORLEANS-TOURS;FEMININ;SCOLAIRE;BAC PROFESSIONNEL;BAC PRO PROD;BAC PRO 23408 Etude et réalisation d'agencement;18;18;17;1;0;0;0;17;0;1;5;6;5;1
6020.0;2021;18;ORLEANS-TOURS;FEMININ;SCOLAIRE;BAC PROFESSIONNEL;BAC PRO PROD;BAC PRO 24202 ARTIS.& MET.ART : TAPIS.D'AMEUBL;13;13;13;0;0;0;0;13;0;3;4;5;1;0
6028.0;2021;18;ORLEANS-TOURS;FEMININ;SCOLAIRE;BAC PROFESSIONNEL;BAC PRO PROD;BAC PRO 25216 MAINT.VEHIC.OPTC MOTOCYCLES;2;2;2;0;0;0;0;2;0;0;0;1;1;0
6032.0;2021;18;ORLEANS-TOURS;FEMININ;SCOLAIRE;BAC PROFESSIONNEL;BAC PRO PROD;BAC PRO 25411 TECH.CHAUDRONNERIE INDUSTRIELLE;4;4;4;0;0;0;0;4;0;0;0;3;1;0
6034.0;2021;18;ORLEANS-TOURS;FEMININ;SCOLAIRE;BAC PROFESSIONNEL;BAC PRO PROD;BAC PRO 25514 SYST.NUM.OPT.B AUD.RES.EQUIP.DOM.;3;3;2;0;1;1;0;3;0;0;1;1;1;0
6040.0;2021;18;ORLEANS-TOURS;FEMININ;SCOLAIRE;BAC PROFESSIONNEL;BAC PRO PROD;BAC PRO AG 21211 COND GEST ENTR HIPPIQUE;52;51;46;5;0;0;0;46;0;0;8;16;22;5
6043.0;2021;18;ORLEANS-TOURS;FEMININ;SCOLAIRE;BAC PROFESSIONNEL;BAC PRO PROD;BAC PRO AG 21405 AMENAGEMENTS PAYSAGERS;4;4;4;0;0;0;0;4;0;0;1;1;2;0
6044.0;2021;18;ORLEANS-TOURS;FEMININ;SCOLAIRE;BAC PROFESSIONNEL;BAC PRO PROD;BAC PRO AG 21406 TEC CONS VTE PROD DES JARDINS;22;20;20;0;0;0;0;20;0;1;5;5;9;0
6082.0;2021;18;ORLEANS-TOURS;FEMININ;SCOLAIRE;BAC TECHNOLOGIQUE;BAC STMG;BAC STMG MERCATIQUE (MARKETING);690;690;642;4;44;21;23;663;1;7;100;310;245;27
6083.0;2021;18;ORLEANS-TOURS;FEMININ;SCOLAIRE;BAC TECHNOLOGIQUE;BAC STMG;BAC STMG RESSOURCES HUMAINES ET COMMUNICATION;534;534;492;8;34;18;16;510;0;3;66;239;202;24
6089.0;2021;18;ORLEANS-TOURS;MASCULIN;APPRENTISSAGE;BAC PROFESSIONNEL;BAC PRO PROD;BAC PRO 23203 TECHNICIEN BAT. : ORG.REAL.GROS O;2;2;2;0;0;0;0;2;0;1;1;0;0;0
6091.0;2021;18;ORLEANS-TOURS;MASCULIN;APPRENTISSAGE;BAC PROFESSIONNEL;BAC PRO PROD;BAC PRO 23207 INTERV. SUR PATRIMOINE BATI OPT.C;1;1;1;0;0;0;0;1;0;0;0;0;1;0
6093.0;2021;18;ORLEANS-TOURS;MASCULIN;APPRENTISSAGE;BAC PROFESSIONNEL;BAC PRO PROD;BAC PRO 23404 TECHNICIEN CONSTRUCTEUR BOIS;1;1;1;0;0;0;0;1;0;0;0;1;0;0
6098.0;2021;18;ORLEANS-TOURS;MASCULIN;APPRENTISSAGE;BAC PROFESSIONNEL;BAC PRO PROD;BAC PRO 25214 MAINT.VEHIC.OPTA VOIT.PARTICUL.;126;126;109;13;4;1;3;110;0;7;25;41;37;16
6099.0;2021;18;ORLEANS-TOURS;MASCULIN;APPRENTISSAGE;BAC PROFESSIONNEL;BAC PRO PROD;BAC PRO 25215 MAINT.VEHIC.OPTB VEHIC.TRANS.ROUT;23;23;17;3;3;1;2;18;0;0;1;2;15;5
6101.0;2021;18;ORLEANS-TOURS;MASCULIN;APPRENTISSAGE;BAC PROFESSIONNEL;BAC PRO PROD;BAC PRO 25220 MAINT.MATERIELS OPT.B TP MANUT.;15;15;12;3;0;0;0;12;0;2;1;5;4;3
6102.0;2021;18;ORLEANS-TOURS;MASCULIN;APPRENTISSAGE;BAC PROFESSIONNEL;BAC PRO PROD;BAC PRO 25221 MAINT.MATERIELS OPT.C ESP. VERTS;14;14;12;2;0;0;0;12;0;1;3;3;5;2
6103.0;2021;18;ORLEANS-TOURS;MASCULIN;APPRENTISSAGE;BAC PROFESSIONNEL;BAC PRO PROD;BAC PRO 25406 OUVRAGES DU BATIMENT METALLERIE;2;2;0;1;1;0;1;0;0;0;0;0;0;2
6107.0;2021;18;ORLEANS-TOURS;MASCULIN;APPRENTISSAGE;BAC PROFESSIONNEL;BAC PRO PROD;BAC PRO 25509 TECHNIC. FROID CONDITIONNEMT AIR;3;3;2;0;1;1;0;3;0;0;1;1;1;0
6109.0;2021;18;ORLEANS-TOURS;MASCULIN;APPRENTISSAGE;BAC PROFESSIONNEL;BAC PRO PROD;BAC PRO 25513 SYST.NUM.OPT.A SURETE SECURITE;4;4;4;0;0;0;0;4;0;0;0;3;1;0
6110.0;2021;18;ORLEANS-TOURS;MASCULIN;APPRENTISSAGE;BAC PROFESSIONNEL;BAC PRO PROD;BAC PRO 25514 SYST.NUM.OPT.B AUD.RES.EQUIP.DOM.;1;1;1;0;0;0;0;1;0;0;0;1;0;0
6114.0;2021;18;ORLEANS-TOURS;MASCULIN;APPRENTISSAGE;BAC PROFESSIONNEL;BAC PRO PROD;BAC PRO AG 21114 CONDUITE PRODUCTIONS HORTICOLES;4;4;3;1;0;0;0;3;0;0;0;1;2;1
6117.0;2021;18;ORLEANS-TOURS;MASCULIN;APPRENTISSAGE;BAC PROFESSIONNEL;BAC PRO PROD;BAC PRO AG 21405 AMENAGEMENTS PAYSAGERS;108;104;102;2;0;0;0;102;0;1;15;40;46;2
6122.0;2021;18;ORLEANS-TOURS;MASCULIN;APPRENTISSAGE;BAC PROFESSIONNEL;BAC PRO SERV;BAC PRO 32206 FACONNAGE PRODTS IMPRIMES ROUTAGE;2;2;2;0;0;0;0;2;0;0;0;1;1;0
6149.0;2021;18;ORLEANS-TOURS;MASCULIN;FORMATION CONTINUE;BAC PROFESSIONNEL;BAC PRO PROD;BAC PRO AG 21113 CGEVV;5;5;5;0;0;0;0;5;0;0;0;0;5;0
6150.0;2021;18;ORLEANS-TOURS;MASCULIN;FORMATION CONTINUE;BAC PROFESSIONNEL;BAC PRO PROD;BAC PRO AG 21405 AMENAGEMENTS PAYSAGERS;11;11;11;0;0;0;0;11;0;0;2;2;7;0
6155.0;2021;18;ORLEANS-TOURS;MASCULIN;INDIVIDUEL;BAC PROFESSIONNEL;BAC PRO PROD;BAC PRO 22704 TECHN. MAINT. SYST.ENERG.CLIMATI;1;1;0;1;0;0;0;0;0;0;0;0;0;1
6156.0;2021;18;ORLEANS-TOURS;MASCULIN;INDIVIDUEL;BAC PROFESSIONNEL;BAC PRO PROD;BAC PRO 23005 TECHN. ETUDES BAT B ASSIST.ARCHI.;1;1;1;0;0;0;0;1;0;0;1;0;0;0
6157.0;2021;18;ORLEANS-TOURS;MASCULIN;INDIVIDUEL;BAC PROFESSIONNEL;BAC PRO PROD;BAC PRO 23408 Etude et réalisation d'agencement;1;0;0;0;0;0;0;0;0;0;0;0;0;0
6170.0;2021;18;ORLEANS-TOURS;MASCULIN;INDIVIDUEL;BAC PROFESSIONNEL;BAC PRO SERV;BAC PRO 30001 GESTION-ADMINISTRATION;12;8;5;2;1;1;0;6;0;0;1;2;3;2
6178.0;2021;18;ORLEANS-TOURS;MASCULIN;INDIVIDUEL;BAC TECHNOLOGIQUE;BAC STHR;BAC STHR SC.&TEC. HOTELLERIE-RESTAURATION;2;1;1;0;0;0;0;1;0;0;0;0;1;0
6186.0;2021;18;ORLEANS-TOURS;MASCULIN;SCOLAIRE;BAC GENERAL;BAC GENERAL;BAC GENE 10019 BAC GENERAL;5900;5900;5503;64;333;209;124;5712;89;512;1212;2029;1870;188
6195.0;2021;18;ORLEANS-TOURS;MASCULIN;SCOLAIRE;BAC PROFESSIONNEL;BAC PRO PROD;BAC PRO 22703 TECHN.INSTALL.SYST.ENERG.CLIMATI;29;29;25;2;2;2;0;27;0;0;6;13;8;2
6196.0;2021;18;ORLEANS-TOURS;MASCULIN;SCOLAIRE;BAC PROFESSIONNEL;BAC PRO PROD;BAC PRO 22704 TECHN. MAINT. SYST.ENERG.CLIMATI;44;44;27;12;5;4;1;31;0;0;3;14;14;13
6197.0;2021;18;ORLEANS-TOURS;MASCULIN;SCOLAIRE;BAC PROFESSIONNEL;BAC PRO PROD;BAC PRO 23003 ARTIS. & M.ART:MARCHANDISAGE VIS.;1;1;1;0;0;0;0;1;0;0;1;0;0;0
6203.0;2021;18;ORLEANS-TOURS;MASCULIN;SCOLAIRE;BAC PROFESSIONNEL;BAC PRO PROD;BAC PRO 23205 INTERV. SUR PATRIMOINE BATI OPT.A;8;8;5;2;1;0;1;5;0;0;2;2;1;3
6206.0;2021;18;ORLEANS-TOURS;MASCULIN;SCOLAIRE;BAC PROFESSIONNEL;BAC PRO PROD;BAC PRO 23304 AMENAGEMENT FINITION BATIMENT;33;33;28;2;3;0;3;28;0;1;5;8;14;5
6211.0;2021;18;ORLEANS-TOURS;MASCULIN;SCOLAIRE;BAC PROFESSIONNEL;BAC PRO PROD;BAC PRO 24203 METIERS DE LA MODE - VÊTEMENT;12;12;12;0;0;0;0;12;0;2;2;3;5;0
6212.0;2021;18;ORLEANS-TOURS;MASCULIN;SCOLAIRE;BAC PROFESSIONNEL;BAC PRO PROD;BAC PRO 24302 METIERS DU CUIR : MAROQUINERIE;3;3;3;0;0;0;0;3;0;1;1;0;1;0
6214.0;2021;18;ORLEANS-TOURS;MASCULIN;SCOLAIRE;BAC PROFESSIONNEL;BAC PRO PROD;BAC PRO 25006 MICROTECHNIQUES;12;12;10;2;0;0;0;10;0;2;1;4;3;2
6220.0;2021;18;ORLEANS-TOURS;MASCULIN;SCOLAIRE;BAC PROFESSIONNEL;BAC PRO PROD;BAC PRO 25215 MAINT.VEHIC.OPTB VEHIC.TRANS.ROUT;9;9;7;2;0;0;0;7;0;0;0;3;4;2
6224.0;2021;18;ORLEANS-TOURS;MASCULIN;SCOLAIRE;BAC PROFESSIONNEL;BAC PRO PROD;BAC PRO 25221 MAINT.MATERIELS OPT.C ESP. VERTS;7;7;5;2;0;0;0;5;0;0;1;0;4;2
6228.0;2021;18;ORLEANS-TOURS;MASCULIN;SCOLAIRE;BAC PROFESSIONNEL;BAC PRO PROD;BAC PRO 25411 TECH.CHAUDRONNERIE INDUSTRIELLE;82;81;68;11;2;1;1;69;0;5;22;30;12;12
6234.0;2021;18;ORLEANS-TOURS;MASCULIN;SCOLAIRE;BAC PROFESSIONNEL;BAC PRO PROD;BAC PRO AG 21001 AGRO-EQUIPEMENT;26;26;24;2;0;0;0;24;0;1;5;13;5;2
6242.0;2021;18;ORLEANS-TOURS;MASCULIN;SCOLAIRE;BAC PROFESSIONNEL;BAC PRO PROD;BAC PRO AG 21303 FORET;16;16;15;1;0;0;0;15;0;1;0;7;7;1
6253.0;2021;18;ORLEANS-TOURS;MASCULIN;SCOLAIRE;BAC PROFESSIONNEL;BAC PRO SERV;BAC PRO 31206 VENTE (PROSPECT.NEGO.SUIV.CLIENT;165;165;138;23;4;2;2;140;0;8;29;60;43;25
6259.0;2021;18;ORLEANS-TOURS;MASCULIN;SCOLAIRE;BAC PROFESSIONNEL;BAC PRO SERV;BAC PRO 33002 SERVICES DE PROXIMITE  VIE LOCAL;24;24;21;2;1;1;0;22;0;0;4;9;9;2
6260.0;2021;18;ORLEANS-TOURS;MASCULIN;SCOLAIRE;BAC PROFESSIONNEL;BAC PRO SERV;BAC PRO 33003 ACC.SOINS-S.PERS. OPT.A DOMICILE;19;19;17;1;1;1;0;18;0;3;2;6;7;1
6274.0;2021;18;ORLEANS-TOURS;MASCULIN;SCOLAIRE;BAC TECHNOLOGIQUE;BAC STI2D;BAC STI2D ENERGIES  ET ENVIRONNEMENT;139;139;130;1;8;4;4;134;0;2;16;62;54;5
6275.0;2021;18;ORLEANS-TOURS;MASCULIN;SCOLAIRE;BAC TECHNOLOGIQUE;BAC STI2D;BAC STI2D INNOVATION TECHNO.  ET ECO CONCEPTION;406;406;387;1;18;12;6;399;0;6;81;164;148;7
6276.0;2021;18;ORLEANS-TOURS;MASCULIN;SCOLAIRE;BAC TECHNOLOGIQUE;BAC STI2D;BAC STI2D SYSTÈME D'INFORMATION  ET NUMERIQUE;384;384;360;6;18;8;10;368;2;14;65;147;140;16
6285.0;2021;01;PARIS;FEMININ;APPRENTISSAGE;BAC PROFESSIONNEL;BAC PRO PROD;BAC PRO 22106 CUISINE;22;22;21;0;1;0;1;21;0;3;4;11;3;1
6287.0;2021;01;PARIS;FEMININ;APPRENTISSAGE;BAC PROFESSIONNEL;BAC PRO PROD;BAC PRO 23004 TECHN. ETUDES BAT.A ETUDES & ECO.;2;2;2;0;0;0;0;2;0;0;0;0;2;0
6288.0;2021;01;PARIS;FEMININ;APPRENTISSAGE;BAC PROFESSIONNEL;BAC PRO PROD;BAC PRO 23005 TECHN. ETUDES BAT B ASSIST.ARCHI.;2;2;2;0;0;0;0;2;0;0;0;2;0;0
6291.0;2021;01;PARIS;FEMININ;APPRENTISSAGE;BAC PROFESSIONNEL;BAC PRO PROD;BAC PRO 25214 MAINT.VEHIC.OPTA VOIT.PARTICUL.;1;1;1;0;0;0;0;1;0;1;0;0;0;0
6293.0;2021;01;PARIS;FEMININ;APPRENTISSAGE;BAC PROFESSIONNEL;BAC PRO SERV;BAC PRO 30001 GESTION-ADMINISTRATION;59;58;49;5;4;3;1;52;0;3;7;23;19;6
6297.0;2021;01;PARIS;FEMININ;APPRENTISSAGE;BAC PROFESSIONNEL;BAC PRO SERV;BAC PRO 32207 REAL.PR.IMPR.PLURI.OPTA.PR.GRAPH.;2;2;2;0;0;0;0;2;0;0;1;0;1;0
6298.0;2021;01;PARIS;FEMININ;APPRENTISSAGE;BAC PROFESSIONNEL;BAC PRO SERV;BAC PRO 32208 REAL.PR.IMPR.PLURI.OPTB.PR.IMPR.;1;1;1;0;0;0;0;1;0;0;0;0;1;0
6300.0;2021;01;PARIS;FEMININ;APPRENTISSAGE;BAC PROFESSIONNEL;BAC PRO SERV;BAC PRO 33101 OPTIQUE LUNETTERIE;15;14;6;8;0;0;0;6;0;0;1;1;4;8
6319.0;2021;01;PARIS;FEMININ;INDIVIDUEL;BAC PROFESSIONNEL;BAC PRO PROD;BAC PRO 25007 MAINTENANCE EQUIPEMENTS INDUST.;2;2;2;0;0;0;0;2;0;2;0;0;0;0
6325.0;2021;01;PARIS;FEMININ;INDIVIDUEL;BAC PROFESSIONNEL;BAC PRO SERV;BAC PRO 30001 GESTION-ADMINISTRATION;10;6;3;3;0;0;0;3;0;0;0;0;3;3
6327.0;2021;01;PARIS;FEMININ;INDIVIDUEL;BAC PROFESSIONNEL;BAC PRO SERV;BAC PRO 31206 VENTE (PROSPECT.NEGO.SUIV.CLIENT;1;1;1;0;0;0;0;1;0;0;0;0;1;0
6338.0;2021;01;PARIS;FEMININ;INDIVIDUEL;BAC TECHNOLOGIQUE;BAC STMG;BAC STMG MERCATIQUE (MARKETING);59;54;45;3;6;2;4;47;0;0;3;15;29;7
6340.0;2021;01;PARIS;FEMININ;SCOLAIRE;BAC GENERAL;BAC GENERAL;BAC GENE 10019 BAC GENERAL;8414;8410;8279;44;87;53;34;8332;200;1634;2991;2481;1026;78
6344.0;2021;01;PARIS;FEMININ;SCOLAIRE;BAC PROFESSIONNEL;BAC PRO PROD;BAC PRO 22402 ARTIS.& MET.ART:VERR.SCIENT.TECH;3;3;3;0;0;0;0;3;0;2;0;1;0;0
6351.0;2021;01;PARIS;FEMININ;SCOLAIRE;BAC PROFESSIONNEL;BAC PRO PROD;BAC PRO 24202 ARTIS.& MET.ART : TAPIS.D'AMEUBL;10;10;8;1;1;1;0;9;0;0;3;4;2;1
6353.0;2021;01;PARIS;FEMININ;SCOLAIRE;BAC PROFESSIONNEL;BAC PRO PROD;BAC PRO 24302 METIERS DU CUIR : MAROQUINERIE;5;5;2;3;0;0;0;2;0;0;1;0;1;3
6354.0;2021;01;PARIS;FEMININ;SCOLAIRE;BAC PROFESSIONNEL;BAC PRO PROD;BAC PRO 25006 MICROTECHNIQUES;1;1;1;0;0;0;0;1;0;0;1;0;0;0
6357.0;2021;01;PARIS;FEMININ;SCOLAIRE;BAC PROFESSIONNEL;BAC PRO PROD;BAC PRO 25515 SYST.NUM.OPT.C RES.INF.SYST.COMM.;3;3;3;0;0;0;0;3;0;0;0;1;2;0
6363.0;2021;01;PARIS;FEMININ;SCOLAIRE;BAC PROFESSIONNEL;BAC PRO SERV;BAC PRO 31202 COMMERCE;239;239;211;15;13;9;4;220;0;7;58;68;87;19
6372.0;2021;01;PARIS;FEMININ;SCOLAIRE;BAC PROFESSIONNEL;BAC PRO SERV;BAC PRO 33003 ACC.SOINS-S.PERS. OPT.A DOMICILE;27;24;12;7;5;3;2;15;0;0;1;6;8;9
6382.0;2021;01;PARIS;FEMININ;SCOLAIRE;BAC TECHNOLOGIQUE;BAC S2TMD;BAC S2TMD DANSE;15;15;15;0;0;0;0;15;1;3;7;3;1;0
6385.0;2021;01;PARIS;FEMININ;SCOLAIRE;BAC TECHNOLOGIQUE;BAC STD2A;BAC STD2A SCIENCES & TECHNO. DESIGN-ARTS APPLIQUES;161;161;160;0;1;0;1;160;1;12;58;66;23;1
6386.0;2021;01;PARIS;FEMININ;SCOLAIRE;BAC TECHNOLOGIQUE;BAC STHR;BAC STHR SC.&TEC. HOTELLERIE-RESTAURATION;44;44;43;0;1;1;0;44;0;1;12;17;14;0
6387.0;2021;01;PARIS;FEMININ;SCOLAIRE;BAC TECHNOLOGIQUE;BAC STI2D;BAC STI2D ARCHITECTURE ET CONSTRUCTION;18;18;18;0;0;0;0;18;0;0;6;6;6;0
6404.0;2021;01;PARIS;MASCULIN;APPRENTISSAGE;BAC PROFESSIONNEL;BAC PRO PROD;BAC PRO 25007 MAINTENANCE EQUIPEMENTS INDUST.;35;35;33;1;1;0;1;33;0;4;13;10;6;2
6405.0;2021;01;PARIS;MASCULIN;APPRENTISSAGE;BAC PROFESSIONNEL;BAC PRO PROD;BAC PRO 25214 MAINT.VEHIC.OPTA VOIT.PARTICUL.;12;12;9;3;0;0;0;9;0;0;1;2;6;3
6410.0;2021;01;PARIS;MASCULIN;APPRENTISSAGE;BAC PROFESSIONNEL;BAC PRO SERV;BAC PRO 30001 GESTION-ADMINISTRATION;18;17;12;5;0;0;0;12;0;0;3;8;1;5
6414.0;2021;01;PARIS;MASCULIN;APPRENTISSAGE;BAC PROFESSIONNEL;BAC PRO SERV;BAC PRO 32207 REAL.PR.IMPR.PLURI.OPTA.PR.GRAPH.;10;10;10;0;0;0;0;10;0;1;1;5;3;0
6417.0;2021;01;PARIS;MASCULIN;APPRENTISSAGE;BAC PROFESSIONNEL;BAC PRO SERV;BAC PRO 33101 OPTIQUE LUNETTERIE;16;14;13;1;0;0;0;13;0;0;5;3;5;1
6419.0;2021;01;PARIS;MASCULIN;APPRENTISSAGE;BAC PROFESSIONNEL;BAC PRO SERV;BAC PRO 34403 METIERS DE LA SECURITE;4;4;3;1;0;0;0;3;0;0;2;0;1;1
6427.0;2021;01;PARIS;MASCULIN;ENSEIGNEMENT A DISTANCE;BAC TECHNOLOGIQUE;BAC STMG;BAC STMG SYSTEMES D'INFORMATION DE GESTION;1;1;1;0;0;0;0;1;0;0;1;0;0;0
6433.0;2021;01;PARIS;MASCULIN;FORMATION CONTINUE;BAC PROFESSIONNEL;BAC PRO PROD;BAC PRO 25510 METIERS ELECT. ENVIRON. CONNECTES;30;29;28;1;0;0;0;28;0;13;10;4;1;1
6435.0;2021;01;PARIS;MASCULIN;FORMATION CONTINUE;BAC PROFESSIONNEL;BAC PRO PROD;BAC PRO 25515 SYST.NUM.OPT.C RES.INF.SYST.COMM.;9;9;6;3;0;0;0;6;0;2;1;3;0;3
6436.0;2021;01;PARIS;MASCULIN;FORMATION CONTINUE;BAC PROFESSIONNEL;BAC PRO PROD;BAC PRO AG 21405 AMENAGEMENTS PAYSAGERS;3;3;3;0;0;0;0;3;0;0;0;0;3;0
6441.0;2021;01;PARIS;MASCULIN;INDIVIDUEL;BAC PROFESSIONNEL;BAC PRO PROD;BAC PRO 22106 CUISINE;2;2;1;1;0;0;0;1;0;0;0;0;1;1
6460.0;2021;01;PARIS;MASCULIN;INDIVIDUEL;BAC PROFESSIONNEL;BAC PRO SERV;BAC PRO 33101 OPTIQUE LUNETTERIE;2;1;0;1;0;0;0;0;0;0;0;0;0;1
6464.0;2021;01;PARIS;MASCULIN;INDIVIDUEL;BAC TECHNOLOGIQUE;BAC STD2A;BAC STD2A SCIENCES & TECHNO. DESIGN-ARTS APPLIQUES;16;16;13;0;3;3;0;16;0;0;0;4;12;0
6468.0;2021;01;PARIS;MASCULIN;INDIVIDUEL;BAC TECHNOLOGIQUE;BAC STMG;BAC STMG MERCATIQUE (MARKETING);105;96;73;5;18;13;5;86;0;0;4;20;62;10
6471.0;2021;01;PARIS;MASCULIN;SCOLAIRE;BAC GENERAL;BAC GENERAL;BAC GENE 10019 BAC GENERAL;7131;7127;6868;55;204;144;60;7012;142;1039;2136;2297;1398;115
6473.0;2021;01;PARIS;MASCULIN;SCOLAIRE;BAC PROFESSIONNEL;BAC PRO PROD;BAC PRO 20102 PILOTE DE LIGNE DE PRODUCTION;6;6;4;1;1;1;0;5;0;0;1;0;4;1
6486.0;2021;01;PARIS;MASCULIN;SCOLAIRE;BAC PROFESSIONNEL;BAC PRO PROD;BAC PRO 23205 INTERV. SUR PATRIMOINE BATI OPT.A;3;3;2;0;1;0;1;2;0;0;1;0;1;1
6488.0;2021;01;PARIS;MASCULIN;SCOLAIRE;BAC PROFESSIONNEL;BAC PRO PROD;BAC PRO 23405 TECHNICIEN MENUISIER AGENCEUR;31;31;30;1;0;0;0;30;0;3;3;14;10;1
6489.0;2021;01;PARIS;MASCULIN;SCOLAIRE;BAC PROFESSIONNEL;BAC PRO PROD;BAC PRO 23407 TECHNIC.FAB.BOIS ET MATERX ASSOC;8;8;7;0;1;0;1;7;0;1;2;1;3;1
6491.0;2021;01;PARIS;MASCULIN;SCOLAIRE;BAC PROFESSIONNEL;BAC PRO PROD;BAC PRO 24202 ARTIS.& MET.ART : TAPIS.D'AMEUBL;6;5;4;1;0;0;0;4;0;0;3;0;1;1
6493.0;2021;01;PARIS;MASCULIN;SCOLAIRE;BAC PROFESSIONNEL;BAC PRO PROD;BAC PRO 24301 METIERS DU CUIR : CHAUSSURES;3;3;2;1;0;0;0;2;0;0;0;2;0;1
6496.0;2021;01;PARIS;MASCULIN;SCOLAIRE;BAC PROFESSIONNEL;BAC PRO PROD;BAC PRO 25007 MAINTENANCE EQUIPEMENTS INDUST.;38;37;28;6;3;1;2;29;0;1;7;12;9;8
6498.0;2021;01;PARIS;MASCULIN;SCOLAIRE;BAC PROFESSIONNEL;BAC PRO PROD;BAC PRO 25107 TECHNICIEN OUTILLEUR;6;6;5;0;1;0;1;5;0;0;1;0;4;1
6501.0;2021;01;PARIS;MASCULIN;SCOLAIRE;BAC PROFESSIONNEL;BAC PRO PROD;BAC PRO 25406 OUVRAGES DU BATIMENT METALLERIE;10;8;6;0;2;1;1;7;0;0;1;1;5;1
6502.0;2021;01;PARIS;MASCULIN;SCOLAIRE;BAC PROFESSIONNEL;BAC PRO PROD;BAC PRO 25411 TECH.CHAUDRONNERIE INDUSTRIELLE;16;14;12;1;1;1;0;13;0;2;2;4;5;1
6510.0;2021;01;PARIS;MASCULIN;SCOLAIRE;BAC PROFESSIONNEL;BAC PRO SERV;BAC PRO 30001 GESTION-ADMINISTRATION;295;295;197;74;24;21;3;218;0;2;28;79;109;77
6518.0;2021;01;PARIS;MASCULIN;SCOLAIRE;BAC PROFESSIONNEL;BAC PRO SERV;BAC PRO 32208 REAL.PR.IMPR.PLURI.OPTB.PR.IMPR.;13;13;11;2;0;0;0;11;0;0;2;7;2;2
6521.0;2021;01;PARIS;MASCULIN;SCOLAIRE;BAC PROFESSIONNEL;BAC PRO SERV;BAC PRO 33002 SERVICES DE PROXIMITE  VIE LOCAL;26;26;22;2;2;1;1;23;0;0;4;11;8;3
6528.0;2021;01;PARIS;MASCULIN;SCOLAIRE;BAC PROFESSIONNEL;BAC PRO SERV;BAC PRO 34304 HYGIENE PROPRETE STERILISATION;3;3;1;1;1;1;0;2;0;0;0;0;2;1
6531.0;2021;01;PARIS;MASCULIN;SCOLAIRE;BAC TECHNOLOGIQUE;BAC S2TMD;BAC S2TMD MUSIQUE;12;12;12;0;0;0;0;12;0;0;9;3;0;0
6535.0;2021;01;PARIS;MASCULIN;SCOLAIRE;BAC TECHNOLOGIQUE;BAC STI2D;BAC STI2D ARCHITECTURE ET CONSTRUCTION;70;70;63;4;3;2;1;65;0;0;10;26;29;5
6539.0;2021;01;PARIS;MASCULIN;SCOLAIRE;BAC TECHNOLOGIQUE;BAC STL;BAC STL BIOCHIM.-BIOLOGIE-BIOTECHNOL.;58;58;51;1;6;3;3;54;0;3;10;21;20;4
6541.0;2021;01;PARIS;MASCULIN;SCOLAIRE;BAC TECHNOLOGIQUE;BAC STMG;BAC STMG GESTION ET FINANCE;273;273;247;12;14;10;4;257;0;7;33;113;104;16
6546.0;2021;13;POITIERS;FEMININ;APPRENTISSAGE;BAC PROFESSIONNEL;BAC PRO PROD;BAC PRO 22106 CUISINE;7;7;5;1;1;0;1;5;0;1;1;2;1;2
6549.0;2021;13;POITIERS;FEMININ;APPRENTISSAGE;BAC PROFESSIONNEL;BAC PRO PROD;BAC PRO 25214 MAINT.VEHIC.OPTA VOIT.PARTICUL.;3;3;2;1;0;0;0;2;0;0;0;1;1;1
6550.0;2021;13;POITIERS;FEMININ;APPRENTISSAGE;BAC PROFESSIONNEL;BAC PRO PROD;BAC PRO 25215 MAINT.VEHIC.OPTB VEHIC.TRANS.ROUT;1;1;1;0;0;0;0;1;0;0;0;1;0;0
6562.0;2021;13;POITIERS;FEMININ;APPRENTISSAGE;BAC PROFESSIONNEL;BAC PRO SERV;BAC PRO 32207 REAL.PR.IMPR.PLURI.OPTA.PR.GRAPH.;3;3;3;0;0;0;0;3;0;0;1;2;0;0
6569.0;2021;13;POITIERS;FEMININ;APPRENTISSAGE;BAC PROFESSIONNEL;BAC PRO SERV;BAC PRO AG 33002 SERV PERS TERRIT;24;22;22;0;0;0;0;22;0;2;3;6;11;0
6572.0;2021;13;POITIERS;FEMININ;ENSEIGNEMENT A DISTANCE;BAC PROFESSIONNEL;BAC PRO SERV;BAC PRO 31206 VENTE (PROSPECT.NEGO.SUIV.CLIENT;1;1;1;0;0;0;0;1;0;0;0;0;1;0
6575.0;2021;13;POITIERS;FEMININ;ENSEIGNEMENT A DISTANCE;BAC TECHNOLOGIQUE;BAC ST2S;BAC ST2S SCIENCES & TECHNO. SANTE & SOCIAL;2;2;2;0;0;0;0;2;0;0;2;0;0;0
6576.0;2021;13;POITIERS;FEMININ;ENSEIGNEMENT A DISTANCE;BAC TECHNOLOGIQUE;BAC STMG;BAC STMG GESTION ET FINANCE;1;0;0;0;0;0;0;0;0;0;0;0;0;0
6578.0;2021;13;POITIERS;FEMININ;ENSEIGNEMENT A DISTANCE;BAC TECHNOLOGIQUE;BAC STMG;BAC STMG RESSOURCES HUMAINES ET COMMUNICATION;2;2;2;0;0;0;0;2;0;0;1;1;0;0
6582.0;2021;13;POITIERS;FEMININ;INDIVIDUEL;BAC GENERAL;BAC GENERAL;BAC GENE 10019 BAC GENERAL;38;21;16;0;5;1;4;17;0;0;6;7;4;4
6584.0;2021;13;POITIERS;FEMININ;INDIVIDUEL;BAC PROFESSIONNEL;BAC PRO PROD;BAC PRO AG 21114 CONDUITE PRODUCTIONS HORTICOLES;3;3;3;0;0;0;0;3;0;0;0;0;3;0
6587.0;2021;13;POITIERS;FEMININ;INDIVIDUEL;BAC PROFESSIONNEL;BAC PRO SERV;BAC PRO 31202 COMMERCE;2;0;0;0;0;0;0;0;0;0;0;0;0;0
6594.0;2021;13;POITIERS;FEMININ;INDIVIDUEL;BAC PROFESSIONNEL;BAC PRO SERV;BAC PRO AG 33002 SERV PERS TERRIT;3;2;2;0;0;0;0;2;0;0;0;1;1;0
6603.0;2021;13;POITIERS;FEMININ;SCOLAIRE;BAC PROFESSIONNEL;BAC PRO PROD;BAC PRO 22105 BOULANGER-PÂTISSIER;13;13;12;1;0;0;0;12;0;1;2;7;2;1
6614.0;2021;13;POITIERS;FEMININ;SCOLAIRE;BAC PROFESSIONNEL;BAC PRO PROD;BAC PRO 25106 TECHNICIEN D'USINAGE;2;2;1;0;1;0;1;1;0;0;0;1;0;1
6618.0;2021;13;POITIERS;FEMININ;SCOLAIRE;BAC PROFESSIONNEL;BAC PRO PROD;BAC PRO 25302 AERONAUTIQUE OPTION AVIONIQUE;1;1;1;0;0;0;0;1;0;0;0;1;0;0
6620.0;2021;13;POITIERS;FEMININ;SCOLAIRE;BAC PROFESSIONNEL;BAC PRO PROD;BAC PRO 25408 REPARATION DES CARROSSERIES;1;1;1;0;0;0;0;1;0;0;0;1;0;0
6624.0;2021;13;POITIERS;FEMININ;SCOLAIRE;BAC PROFESSIONNEL;BAC PRO PROD;BAC PRO 25513 SYST.NUM.OPT.A SURETE SECURITE;1;1;1;0;0;0;0;1;0;0;0;1;0;0
6628.0;2021;13;POITIERS;FEMININ;SCOLAIRE;BAC PROFESSIONNEL;BAC PRO PROD;BAC PRO AG 21114 CONDUITE PRODUCTIONS HORTICOLES;18;16;14;2;0;0;0;14;0;1;2;3;8;2
6629.0;2021;13;POITIERS;FEMININ;SCOLAIRE;BAC PROFESSIONNEL;BAC PRO PROD;BAC PRO AG 21203 TECHN CONSEIL DE VENTE ANIMAL;26;26;23;3;0;0;0;23;0;0;0;10;13;3
6632.0;2021;13;POITIERS;FEMININ;SCOLAIRE;BAC PROFESSIONNEL;BAC PRO PROD;BAC PRO AG 21211 COND GEST ENTR HIPPIQUE;82;80;72;8;0;0;0;72;0;2;15;23;32;8
6644.0;2021;13;POITIERS;FEMININ;SCOLAIRE;BAC PROFESSIONNEL;BAC PRO SERV;BAC PRO 31202 COMMERCE;263;263;232;15;16;12;4;244;0;14;65;92;73;19
6648.0;2021;13;POITIERS;FEMININ;SCOLAIRE;BAC PROFESSIONNEL;BAC PRO SERV;BAC PRO 32208 REAL.PR.IMPR.PLURI.OPTB.PR.IMPR.;3;3;2;1;0;0;0;2;0;0;1;1;0;1
6679.0;2021;13;POITIERS;MASCULIN;APPRENTISSAGE;BAC PROFESSIONNEL;BAC PRO PROD;BAC PRO 23203 TECHNICIEN BAT. : ORG.REAL.GROS O;7;7;7;0;0;0;0;7;0;0;3;2;2;0
6689.0;2021;13;POITIERS;MASCULIN;APPRENTISSAGE;BAC PROFESSIONNEL;BAC PRO PROD;BAC PRO 25219 MAINT.MATERIELS OPT.A AGRICOLES;25;25;24;1;0;0;0;24;0;3;7;10;4;1
6696.0;2021;13;POITIERS;MASCULIN;APPRENTISSAGE;BAC PROFESSIONNEL;BAC PRO PROD;BAC PRO 25509 TECHNIC. FROID CONDITIONNEMT AIR;14;13;10;3;0;0;0;10;0;1;2;2;5;3
6701.0;2021;13;POITIERS;MASCULIN;APPRENTISSAGE;BAC PROFESSIONNEL;BAC PRO PROD;BAC PRO AG 21004 CGEA;39;39;37;2;0;0;0;37;0;0;4;10;23;2
6702.0;2021;13;POITIERS;MASCULIN;APPRENTISSAGE;BAC PROFESSIONNEL;BAC PRO PROD;BAC PRO AG 21302 GEST MILIEUX NATURELS FAUNE;2;2;2;0;0;0;0;2;0;0;1;1;0;0
6712.0;2021;13;POITIERS;MASCULIN;APPRENTISSAGE;BAC PROFESSIONNEL;BAC PRO SERV;BAC PRO 33101 OPTIQUE LUNETTERIE;2;2;2;0;0;0;0;2;0;0;1;0;1;0
6722.0;2021;13;POITIERS;MASCULIN;FORMATION CONTINUE;BAC PROFESSIONNEL;BAC PRO PROD;BAC PRO 25510 METIERS ELECT. ENVIRON. CONNECTES;1;1;0;1;0;0;0;0;0;0;0;0;0;1
6731.0;2021;13;POITIERS;MASCULIN;INDIVIDUEL;BAC PROFESSIONNEL;BAC PRO PROD;BAC PRO AG 21114 CONDUITE PRODUCTIONS HORTICOLES;1;1;1;0;0;0;0;1;0;0;0;0;1;0
6732.0;2021;13;POITIERS;MASCULIN;INDIVIDUEL;BAC PROFESSIONNEL;BAC PRO PROD;BAC PRO AG 21211 COND GEST ENTR HIPPIQUE;3;3;3;0;0;0;0;3;0;0;0;0;3;0
6733.0;2021;13;POITIERS;MASCULIN;INDIVIDUEL;BAC PROFESSIONNEL;BAC PRO SERV;BAC PRO 31202 COMMERCE;1;0;0;0;0;0;0;0;0;0;0;0;0;0
6739.0;2021;13;POITIERS;MASCULIN;INDIVIDUEL;BAC TECHNOLOGIQUE;BAC STMG;BAC STMG SYSTEMES D'INFORMATION DE GESTION;1;1;0;1;0;0;0;0;0;0;0;0;0;1
6743.0;2021;13;POITIERS;MASCULIN;SCOLAIRE;BAC PROFESSIONNEL;BAC PRO PROD;BAC PRO 22003 BIO-INDUSTRIES DE TRANSFORMATION;4;4;3;1;0;0;0;3;0;0;0;2;1;1
6748.0;2021;13;POITIERS;MASCULIN;SCOLAIRE;BAC PROFESSIONNEL;BAC PRO PROD;BAC PRO 22703 TECHN.INSTALL.SYST.ENERG.CLIMATI;26;26;21;4;1;0;1;21;0;0;3;6;12;5
6753.0;2021;13;POITIERS;MASCULIN;SCOLAIRE;BAC PROFESSIONNEL;BAC PRO PROD;BACPRO 23103 TECHNICIEN GEOMETRE-TOPOGRAPHE;25;25;21;2;2;2;0;23;0;0;2;9;12;2
6754.0;2021;13;POITIERS;MASCULIN;SCOLAIRE;BAC PROFESSIONNEL;BAC PRO PROD;BAC PRO 23203 TECHNICIEN BAT. : ORG.REAL.GROS O;7;7;5;0;2;2;0;7;0;0;0;4;3;0
6756.0;2021;13;POITIERS;MASCULIN;SCOLAIRE;BAC PROFESSIONNEL;BAC PRO PROD;BAC PRO 23303 MENUISERIE ALUMINIUM-VERRE;20;19;17;1;1;1;0;18;0;0;5;5;8;1
6764.0;2021;13;POITIERS;MASCULIN;SCOLAIRE;BAC PROFESSIONNEL;BAC PRO PROD;BAC PRO 25007 MAINTENANCE EQUIPEMENTS INDUST.;119;117;79;23;15;13;2;92;0;2;23;24;43;25
6767.0;2021;13;POITIERS;MASCULIN;SCOLAIRE;BAC PROFESSIONNEL;BAC PRO PROD;BAC PRO 25107 TECHNICIEN OUTILLEUR;10;10;10;0;0;0;0;10;0;0;2;3;5;0
6769.0;2021;13;POITIERS;MASCULIN;SCOLAIRE;BAC PROFESSIONNEL;BAC PRO PROD;BAC PRO 25215 MAINT.VEHIC.OPTB VEHIC.TRANS.ROUT;28;28;24;3;1;1;0;25;0;2;2;13;8;3
6771.0;2021;13;POITIERS;MASCULIN;SCOLAIRE;BAC PROFESSIONNEL;BAC PRO PROD;BAC PRO 25219 MAINT.MATERIELS OPT.A AGRICOLES;11;11;10;1;0;0;0;10;0;0;3;3;4;1
6776.0;2021;13;POITIERS;MASCULIN;SCOLAIRE;BAC PROFESSIONNEL;BAC PRO PROD;BAC PRO 25304 AERONAUTIQUE OPTION STRUCTURE;11;11;11;0;0;0;0;11;0;0;4;5;2;0
6783.0;2021;13;POITIERS;MASCULIN;SCOLAIRE;BAC PROFESSIONNEL;BAC PRO PROD;BAC PRO 25515 SYST.NUM.OPT.C RES.INF.SYST.COMM.;104;104;94;9;1;1;0;95;0;8;30;36;21;9
6790.0;2021;13;POITIERS;MASCULIN;SCOLAIRE;BAC PROFESSIONNEL;BAC PRO PROD;BAC PRO AG 21210 COND GEST ENTR CANIN ET FELIN;8;8;8;0;0;0;0;8;0;0;2;0;6;0
6791.0;2021;13;POITIERS;MASCULIN;SCOLAIRE;BAC PROFESSIONNEL;BAC PRO PROD;BAC PRO AG 21211 COND GEST ENTR HIPPIQUE;5;5;5;0;0;0;0;5;0;0;1;0;4;0
6792.0;2021;13;POITIERS;MASCULIN;SCOLAIRE;BAC PROFESSIONNEL;BAC PRO PROD;BAC PRO AG 21302 GEST MILIEUX NATURELS FAUNE;75;74;74;0;0;0;0;74;0;1;13;31;29;0
6793.0;2021;13;POITIERS;MASCULIN;SCOLAIRE;BAC PROFESSIONNEL;BAC PRO PROD;BAC PRO AG 21303 FORET;13;13;10;3;0;0;0;10;0;0;1;3;6;3
6797.0;2021;13;POITIERS;MASCULIN;SCOLAIRE;BAC PROFESSIONNEL;BAC PRO PROD;BAC PRO AG 22106 TEC CONS VTE ALIMENTATION VINS SP;5;3;1;2;0;0;0;1;0;0;0;1;0;2
6798.0;2021;13;POITIERS;MASCULIN;SCOLAIRE;BAC PROFESSIONNEL;BAC PRO PROD;BAC PRO AG 22107 TEC CONS VTE ALIMENTATION P.ALIM;10;10;8;2;0;0;0;8;0;0;0;4;4;2
6799.0;2021;13;POITIERS;MASCULIN;SCOLAIRE;BAC PROFESSIONNEL;BAC PRO SERV;BAC PRO 30001 GESTION-ADMINISTRATION;84;84;56;23;5;3;2;59;0;0;11;23;25;25
6810.0;2021;13;POITIERS;MASCULIN;SCOLAIRE;BAC PROFESSIONNEL;BAC PRO SERV;BAC PRO 33004 ACC.SOINS-S.PERS. OPT.EN STRUCTUR;16;16;14;1;1;0;1;14;0;0;3;8;3;2
6813.0;2021;13;POITIERS;MASCULIN;SCOLAIRE;BAC PROFESSIONNEL;BAC PRO SERV;BAC PRO 34303 GEST. POLLUTIONS PROTEC. ENVIRON.;3;3;3;0;0;0;0;3;0;1;1;1;0;0
6815.0;2021;13;POITIERS;MASCULIN;SCOLAIRE;BAC PROFESSIONNEL;BAC PRO SERV;BAC PRO AG 33002 SERV PERS TERRIT;21;20;18;2;0;0;0;18;0;0;5;6;7;2
6821.0;2021;13;POITIERS;MASCULIN;SCOLAIRE;BAC TECHNOLOGIQUE;BAC STI2D;BAC STI2D ENERGIES  ET ENVIRONNEMENT;61;61;54;2;5;0;5;54;0;3;5;30;16;7
6826.0;2021;13;POITIERS;MASCULIN;SCOLAIRE;BAC TECHNOLOGIQUE;BAC STMG;BAC STMG GESTION ET FINANCE;173;173;157;4;12;8;4;165;0;6;30;65;64;8
6833.0;2021;19;REIMS;FEMININ;APPRENTISSAGE;BAC PROFESSIONNEL;BAC PRO PROD;BAC PRO 23102 TRAVAUX PUBLICS;1;1;1;0;0;0;0;1;0;0;0;1;0;0
6841.0;2021;19;REIMS;FEMININ;APPRENTISSAGE;BAC PROFESSIONNEL;BAC PRO SERV;BAC PRO 31202 COMMERCE;46;45;39;3;3;2;1;41;0;0;4;18;19;4
6846.0;2021;19;REIMS;FEMININ;ENSEIGNEMENT A DISTANCE;BAC GENERAL;BAC GENERAL;BAC GENE 10019 BAC GENERAL;15;15;13;2;0;0;0;13;0;1;4;4;4;2
6851.0;2021;19;REIMS;FEMININ;ENSEIGNEMENT A DISTANCE;BAC TECHNOLOGIQUE;BAC ST2S;BAC ST2S SCIENCES & TECHNO. SANTE & SOCIAL;2;2;2;0;0;0;0;2;0;0;1;0;1;0
6866.0;2021;19;REIMS;FEMININ;INDIVIDUEL;BAC PROFESSIONNEL;BAC PRO PROD;BAC PRO AG 21114 CONDUITE PRODUCTIONS HORTICOLES;1;1;1;0;0;0;0;1;0;0;0;0;1;0
6869.0;2021;19;REIMS;FEMININ;INDIVIDUEL;BAC PROFESSIONNEL;BAC PRO SERV;BAC PRO 31202 COMMERCE;1;0;0;0;0;0;0;0;0;0;0;0;0;0
6874.0;2021;19;REIMS;FEMININ;INDIVIDUEL;BAC TECHNOLOGIQUE;BAC ST2S;BAC ST2S SCIENCES & TECHNO. SANTE & SOCIAL;4;3;1;2;0;0;0;1;0;0;0;0;1;2
6878.0;2021;19;REIMS;FEMININ;INDIVIDUEL;BAC TECHNOLOGIQUE;BAC STMG;BAC STMG GESTION ET FINANCE;3;3;2;1;0;0;0;2;0;0;0;1;1;1
6879.0;2021;19;REIMS;FEMININ;INDIVIDUEL;BAC TECHNOLOGIQUE;BAC STMG;BAC STMG MERCATIQUE (MARKETING);1;1;0;1;0;0;0;0;0;0;0;0;0;1
6882.0;2021;19;REIMS;FEMININ;SCOLAIRE;BAC PROFESSIONNEL;BAC PRO PROD;BACPRO 20002 ETUD.DEFINITION PRDTS INDUSTRIEL;1;1;1;0;0;0;0;1;0;0;0;0;1;0
6884.0;2021;19;REIMS;FEMININ;SCOLAIRE;BAC PROFESSIONNEL;BAC PRO PROD;BAC PRO 22105 BOULANGER-PÂTISSIER;9;9;9;0;0;0;0;9;0;3;2;3;1;0
6897.0;2021;19;REIMS;FEMININ;SCOLAIRE;BAC PROFESSIONNEL;BAC PRO PROD;BAC PRO 25215 MAINT.VEHIC.OPTB VEHIC.TRANS.ROUT;1;1;1;0;0;0;0;1;0;0;0;0;1;0
6900.0;2021;19;REIMS;FEMININ;SCOLAIRE;BAC PROFESSIONNEL;BAC PRO PROD;BAC PRO 25408 REPARATION DES CARROSSERIES;3;3;3;0;0;0;0;3;0;0;1;2;0;0
6908.0;2021;19;REIMS;FEMININ;SCOLAIRE;BAC PROFESSIONNEL;BAC PRO PROD;BAC PRO AG 21114 CONDUITE PRODUCTIONS HORTICOLES;2;2;2;0;0;0;0;2;0;0;0;0;2;0
6911.0;2021;19;REIMS;FEMININ;SCOLAIRE;BAC PROFESSIONNEL;BAC PRO PROD;BAC PRO AG 21211 COND GEST ENTR HIPPIQUE;9;9;9;0;0;0;0;9;0;0;1;5;3;0
6916.0;2021;19;REIMS;FEMININ;SCOLAIRE;BAC PROFESSIONNEL;BAC PRO PROD;BAC PRO AG 22107 TEC CONS VTE ALIMENTATION P.ALIM;4;4;4;0;0;0;0;4;0;1;1;2;0;0
6921.0;2021;19;REIMS;FEMININ;SCOLAIRE;BAC PROFESSIONNEL;BAC PRO SERV;BAC PRO 31202 COMMERCE;263;262;220;18;24;17;7;237;0;5;36;96;100;25
6928.0;2021;19;REIMS;FEMININ;SCOLAIRE;BAC PROFESSIONNEL;BAC PRO SERV;BAC PRO 33003 ACC.SOINS-S.PERS. OPT.A DOMICILE;91;91;82;3;6;2;4;84;0;3;16;38;27;7
6932.0;2021;19;REIMS;FEMININ;SCOLAIRE;BAC PROFESSIONNEL;BAC PRO SERV;BAC PRO 33403 COMMERC. SERVICES EN RESTAURATION;40;40;34;4;2;1;1;35;0;1;10;13;11;5
6956.0;2021;19;REIMS;MASCULIN;APPRENTISSAGE;BAC PROFESSIONNEL;BAC PRO PROD;BAC PRO 22106 CUISINE;1;1;1;0;0;0;0;1;0;0;0;1;0;0
6967.0;2021;19;REIMS;MASCULIN;APPRENTISSAGE;BAC PROFESSIONNEL;BAC PRO PROD;BAC PRO 25107 TECHNICIEN OUTILLEUR;4;4;4;0;0;0;0;4;0;0;1;0;3;0
6979.0;2021;19;REIMS;MASCULIN;APPRENTISSAGE;BAC PROFESSIONNEL;BAC PRO PROD;BAC PRO AG 21004 CGEA;31;21;16;5;0;0;0;16;0;0;0;6;10;5
6982.0;2021;19;REIMS;MASCULIN;APPRENTISSAGE;BAC PROFESSIONNEL;BAC PRO PROD;BAC PRO AG 21405 AMENAGEMENTS PAYSAGERS;4;4;4;0;0;0;0;4;0;0;0;0;4;0
6992.0;2021;19;REIMS;MASCULIN;FORMATION CONTINUE;BAC PROFESSIONNEL;BAC PRO PROD;BAC PRO 22106 CUISINE;3;3;3;0;0;0;0;3;0;1;0;1;1;0
6994.0;2021;19;REIMS;MASCULIN;FORMATION CONTINUE;BAC PROFESSIONNEL;BAC PRO PROD;BAC PRO 23205 INTERV. SUR PATRIMOINE BATI OPT.A;1;1;1;0;0;0;0;1;0;0;0;1;0;0
7001.0;2021;19;REIMS;MASCULIN;FORMATION CONTINUE;BAC PROFESSIONNEL;BAC PRO SERV;BAC PRO 34403 METIERS DE LA SECURITE;3;3;1;1;1;1;0;2;0;0;0;0;2;1
7009.0;2021;19;REIMS;MASCULIN;INDIVIDUEL;BAC PROFESSIONNEL;BAC PRO SERV;BAC PRO 31206 VENTE (PROSPECT.NEGO.SUIV.CLIENT;1;1;0;0;1;1;0;1;0;0;0;0;1;0
7016.0;2021;19;REIMS;MASCULIN;SCOLAIRE;BAC PROFESSIONNEL;BAC PRO PROD;BACPRO 20002 ETUD.DEFINITION PRDTS INDUSTRIEL;13;13;13;0;0;0;0;13;0;0;2;6;5;0
7025.0;2021;19;REIMS;MASCULIN;SCOLAIRE;BAC PROFESSIONNEL;BAC PRO PROD;BAC PRO 22704 TECHN. MAINT. SYST.ENERG.CLIMATI;18;18;13;3;2;2;0;15;0;0;4;3;8;3
7037.0;2021;19;REIMS;MASCULIN;SCOLAIRE;BAC PROFESSIONNEL;BAC PRO PROD;BAC PRO 25007 MAINTENANCE EQUIPEMENTS INDUST.;135;135;102;27;6;4;2;106;0;4;19;37;46;29
7038.0;2021;19;REIMS;MASCULIN;SCOLAIRE;BAC PROFESSIONNEL;BAC PRO PROD;BAC PRO 25106 TECHNICIEN D'USINAGE;11;11;6;4;1;0;1;6;0;1;1;4;0;5
7044.0;2021;19;REIMS;MASCULIN;SCOLAIRE;BAC PROFESSIONNEL;BAC PRO PROD;BAC PRO 25221 MAINT.MATERIELS OPT.C ESP. VERTS;5;5;4;1;0;0;0;4;0;1;1;1;1;1
7054.0;2021;19;REIMS;MASCULIN;SCOLAIRE;BAC PROFESSIONNEL;BAC PRO PROD;BAC PRO AG 21113 CGEVV;36;36;29;7;0;0;0;29;0;0;0;14;15;7
7061.0;2021;19;REIMS;MASCULIN;SCOLAIRE;BAC PROFESSIONNEL;BAC PRO PROD;BAC PRO AG 22105 LABORATOIRE CONTROLE QUALITE;6;6;6;0;0;0;0;6;0;1;1;2;2;0
7063.0;2021;19;REIMS;MASCULIN;SCOLAIRE;BAC PROFESSIONNEL;BAC PRO PROD;BAC PRO AG 22107 TEC CONS VTE ALIMENTATION P.ALIM;2;2;2;0;0;0;0;2;0;0;0;2;0;0
7064.0;2021;19;REIMS;MASCULIN;SCOLAIRE;BAC PROFESSIONNEL;BAC PRO SERV;BAC PRO 30001 GESTION-ADMINISTRATION;119;119;73;31;15;9;6;82;0;0;15;31;36;37
7082.0;2021;19;REIMS;MASCULIN;SCOLAIRE;BAC PROFESSIONNEL;BAC PRO SERV;BAC PRO 34403 METIERS DE LA SECURITE;45;45;41;2;2;2;0;43;0;3;8;20;12;2
7092.0;2021;19;REIMS;MASCULIN;SCOLAIRE;BAC TECHNOLOGIQUE;BAC STI2D;BAC STI2D SYSTÈME D'INFORMATION  ET NUMERIQUE;160;160;141;3;16;6;10;147;0;3;19;63;62;13
7107.0;2021;14;RENNES;FEMININ;APPRENTISSAGE;BAC PROFESSIONNEL;BAC PRO PROD;BAC PRO 25411 TECH.CHAUDRONNERIE INDUSTRIELLE;2;2;2;0;0;0;0;2;0;1;0;0;1;0
7110.0;2021;14;RENNES;FEMININ;APPRENTISSAGE;BAC PROFESSIONNEL;BAC PRO PROD;BAC PRO AG 21004 CGEA;15;15;13;2;0;0;0;13;0;0;2;4;7;2
7112.0;2021;14;RENNES;FEMININ;APPRENTISSAGE;BAC PROFESSIONNEL;BAC PRO PROD;BAC PRO AG 21210 COND GEST ENTR CANIN ET FELIN;11;11;9;2;0;0;0;9;0;1;1;0;7;2
7121.0;2021;14;RENNES;FEMININ;APPRENTISSAGE;BAC PROFESSIONNEL;BAC PRO SERV;BAC PRO 33403 COMMERC. SERVICES EN RESTAURATION;16;16;14;1;1;0;1;14;0;0;3;4;7;2
7123.0;2021;14;RENNES;FEMININ;APPRENTISSAGE;BAC PROFESSIONNEL;BAC PRO SERV;BAC PRO 34304 HYGIENE PROPRETE STERILISATION;15;15;11;2;2;0;2;11;0;4;3;2;2;4
7124.0;2021;14;RENNES;FEMININ;APPRENTISSAGE;BAC PROFESSIONNEL;BAC PRO SERV;BAC PRO AG 33002 SERV PERS TERRIT;4;4;4;0;0;0;0;4;0;0;1;1;2;0
7126.0;2021;14;RENNES;FEMININ;ENSEIGNEMENT A DISTANCE;BAC PROFESSIONNEL;BAC PRO SERV;BAC PRO 30001 GESTION-ADMINISTRATION;2;2;2;0;0;0;0;2;0;0;1;0;1;0
7131.0;2021;14;RENNES;FEMININ;ENSEIGNEMENT A DISTANCE;BAC TECHNOLOGIQUE;BAC ST2S;BAC ST2S SCIENCES & TECHNO. SANTE & SOCIAL;8;7;6;1;0;0;0;6;0;1;2;2;1;1
7132.0;2021;14;RENNES;FEMININ;ENSEIGNEMENT A DISTANCE;BAC TECHNOLOGIQUE;BAC STMG;BAC STMG GESTION ET FINANCE;2;2;0;2;0;0;0;0;0;0;0;0;0;2
7136.0;2021;14;RENNES;FEMININ;FORMATION CONTINUE;BAC PROFESSIONNEL;BAC PRO PROD;BAC PRO 24203 METIERS DE LA MODE - VÊTEMENT;1;1;1;0;0;0;0;1;0;0;1;0;0;0
7144.0;2021;14;RENNES;FEMININ;INDIVIDUEL;BAC PROFESSIONNEL;BAC PRO PROD;BAC PRO AG 21004 CGEA;13;12;12;0;0;0;0;12;0;0;0;0;12;0
7159.0;2021;14;RENNES;FEMININ;INDIVIDUEL;BAC TECHNOLOGIQUE;BAC ST2S;BAC ST2S SCIENCES & TECHNO. SANTE & SOCIAL;7;5;1;2;2;1;1;2;0;0;0;0;2;3
7161.0;2021;14;RENNES;FEMININ;INDIVIDUEL;BAC TECHNOLOGIQUE;BAC STI2D;BAC STI2D ARCHITECTURE ET CONSTRUCTION;1;0;0;0;0;0;0;0;0;0;0;0;0;0
7173.0;2021;14;RENNES;FEMININ;SCOLAIRE;BAC PROFESSIONNEL;BAC PRO PROD;BAC PRO 23005 TECHN. ETUDES BAT B ASSIST.ARCHI.;26;26;24;2;0;0;0;24;0;4;8;9;3;2
7174.0;2021;14;RENNES;FEMININ;SCOLAIRE;BAC PROFESSIONNEL;BAC PRO PROD;BAC PRO 23102 TRAVAUX PUBLICS;1;1;1;0;0;0;0;1;0;0;1;0;0;0
7178.0;2021;14;RENNES;FEMININ;SCOLAIRE;BAC PROFESSIONNEL;BAC PRO PROD;BAC PRO 23405 TECHNICIEN MENUISIER AGENCEUR;22;22;21;0;1;1;0;22;0;2;5;9;6;0
7180.0;2021;14;RENNES;FEMININ;SCOLAIRE;BAC PROFESSIONNEL;BAC PRO PROD;BAC PRO 23408 Etude et réalisation d'agencement;13;13;12;1;0;0;0;12;0;1;6;5;0;1
7181.0;2021;14;RENNES;FEMININ;SCOLAIRE;BAC PROFESSIONNEL;BAC PRO PROD;BAC PRO 24202 ARTIS.& MET.ART : TAPIS.D'AMEUBL;20;20;16;2;2;0;2;16;0;0;6;4;6;4
7182.0;2021;14;RENNES;FEMININ;SCOLAIRE;BAC PROFESSIONNEL;BAC PRO PROD;BAC PRO 24203 METIERS DE LA MODE - VÊTEMENT;131;131;111;20;0;0;0;111;0;9;27;40;35;20
7194.0;2021;14;RENNES;FEMININ;SCOLAIRE;BAC PROFESSIONNEL;BAC PRO PROD;BAC PRO 25411 TECH.CHAUDRONNERIE INDUSTRIELLE;1;1;1;0;0;0;0;1;0;0;0;0;1;0
7196.0;2021;14;RENNES;FEMININ;SCOLAIRE;BAC PROFESSIONNEL;BAC PRO PROD;BAC PRO 25510 METIERS ELECT. ENVIRON. CONNECTES;9;9;8;1;0;0;0;8;0;0;4;2;2;1
7204.0;2021;14;RENNES;FEMININ;SCOLAIRE;BAC PROFESSIONNEL;BAC PRO PROD;BAC PRO AG 21204 PROD-AQUACOLES;1;1;1;0;0;0;0;1;0;0;0;0;1;0
7205.0;2021;14;RENNES;FEMININ;SCOLAIRE;BAC PROFESSIONNEL;BAC PRO PROD;BAC PRO AG 21210 COND GEST ENTR CANIN ET FELIN;36;35;35;0;0;0;0;35;0;1;5;14;15;0
7211.0;2021;14;RENNES;FEMININ;SCOLAIRE;BAC PROFESSIONNEL;BAC PRO PROD;BAC PRO AG 22107 TEC CONS VTE ALIMENTATION P.ALIM;54;53;52;1;0;0;0;52;0;2;12;22;16;1
7213.0;2021;14;RENNES;FEMININ;SCOLAIRE;BAC PROFESSIONNEL;BAC PRO SERV;BAC PRO 31106 LOGISTIQUE;17;17;11;2;4;2;2;13;0;0;5;3;5;4
7225.0;2021;14;RENNES;FEMININ;SCOLAIRE;BAC PROFESSIONNEL;BAC PRO SERV;BAC PRO 33101 OPTIQUE LUNETTERIE;29;29;28;1;0;0;0;28;0;3;16;7;2;1
7227.0;2021;14;RENNES;FEMININ;SCOLAIRE;BAC PROFESSIONNEL;BAC PRO SERV;BAC PRO 33603 ESTHETIQUE COSMETIQUE PARFUMERIE;123;123;114;2;7;7;0;121;0;2;27;53;39;2
7229.0;2021;14;RENNES;FEMININ;SCOLAIRE;BAC PROFESSIONNEL;BAC PRO SERV;BAC PRO 34403 METIERS DE LA SECURITE;10;10;10;0;0;0;0;10;0;2;2;3;3;0
7251.0;2021;14;RENNES;MASCULIN;APPRENTISSAGE;BAC PROFESSIONNEL;BAC PRO PROD;BAC PRO 22704 TECHN. MAINT. SYST.ENERG.CLIMATI;2;2;2;0;0;0;0;2;0;2;0;0;0;0
7257.0;2021;14;RENNES;MASCULIN;APPRENTISSAGE;BAC PROFESSIONNEL;BAC PRO PROD;BAC PRO 24301 METIERS DU CUIR : CHAUSSURES;1;1;1;0;0;0;0;1;0;0;0;0;1;0
7264.0;2021;14;RENNES;MASCULIN;APPRENTISSAGE;BAC PROFESSIONNEL;BAC PRO PROD;BAC PRO 25216 MAINT.VEHIC.OPTC MOTOCYCLES;12;12;11;1;0;0;0;11;0;1;3;5;2;1
7267.0;2021;14;RENNES;MASCULIN;APPRENTISSAGE;BAC PROFESSIONNEL;BAC PRO PROD;BAC PRO 25221 MAINT.MATERIELS OPT.C ESP. VERTS;17;17;11;4;2;1;1;12;0;0;2;4;6;5
7273.0;2021;14;RENNES;MASCULIN;APPRENTISSAGE;BAC PROFESSIONNEL;BAC PRO PROD;BAC PRO 25510 METIERS ELECT. ENVIRON. CONNECTES;61;59;51;7;1;1;0;52;0;7;15;19;11;7
7277.0;2021;14;RENNES;MASCULIN;APPRENTISSAGE;BAC PROFESSIONNEL;BAC PRO PROD;BAC PRO AG 21114 CONDUITE PRODUCTIONS HORTICOLES;3;3;3;0;0;0;0;3;0;0;0;1;2;0
7281.0;2021;14;RENNES;MASCULIN;APPRENTISSAGE;BAC PROFESSIONNEL;BAC PRO PROD;BAC PRO AG 21303 FORET;4;4;4;0;0;0;0;4;0;0;1;1;2;0
7283.0;2021;14;RENNES;MASCULIN;APPRENTISSAGE;BAC PROFESSIONNEL;BAC PRO PROD;BAC PRO AG 22107 TEC CONS VTE ALIMENTATION P.ALIM;2;2;1;1;0;0;0;1;0;0;0;0;1;1
7289.0;2021;14;RENNES;MASCULIN;APPRENTISSAGE;BAC PROFESSIONNEL;BAC PRO SERV;BAC PRO 34304 HYGIENE PROPRETE STERILISATION;44;44;35;4;5;4;1;39;0;4;6;14;15;5
7290.0;2021;14;RENNES;MASCULIN;ENSEIGNEMENT A DISTANCE;BAC GENERAL;BAC GENERAL;BAC GENE 10019 BAC GENERAL;26;25;23;1;1;0;1;23;0;5;13;2;3;2
7293.0;2021;14;RENNES;MASCULIN;ENSEIGNEMENT A DISTANCE;BAC PROFESSIONNEL;BAC PRO SERV;BAC PRO 33004 ACC.SOINS-S.PERS. OPT.EN STRUCTUR;1;0;0;0;0;0;0;0;0;0;0;0;0;0
7295.0;2021;14;RENNES;MASCULIN;ENSEIGNEMENT A DISTANCE;BAC TECHNOLOGIQUE;BAC STMG;BAC STMG GESTION ET FINANCE;2;1;1;0;0;0;0;1;0;0;1;0;0;0
7299.0;2021;14;RENNES;MASCULIN;FORMATION CONTINUE;BAC PROFESSIONNEL;BAC PRO PROD;BAC PRO 22703 TECHN.INSTALL.SYST.ENERG.CLIMATI;1;1;1;0;0;0;0;1;0;1;0;0;0;0
7301.0;2021;14;RENNES;MASCULIN;FORMATION CONTINUE;BAC PROFESSIONNEL;BAC PRO PROD;BAC PRO 25219 MAINT.MATERIELS OPT.A AGRICOLES;2;2;1;1;0;0;0;1;0;1;0;0;0;1
7308.0;2021;14;RENNES;MASCULIN;INDIVIDUEL;BAC GENERAL;BAC GENERAL;BAC GENE 10019 BAC GENERAL;63;46;32;5;9;6;3;38;0;5;10;6;17;8
7314.0;2021;14;RENNES;MASCULIN;INDIVIDUEL;BAC PROFESSIONNEL;BAC PRO PROD;BAC PRO 25106 TECHNICIEN D'USINAGE;1;1;1;0;0;0;0;1;0;0;0;1;0;0
7324.0;2021;14;RENNES;MASCULIN;INDIVIDUEL;BAC PROFESSIONNEL;BAC PRO SERV;BAC PRO 30001 GESTION-ADMINISTRATION;1;0;0;0;0;0;0;0;0;0;0;0;0;0
7325.0;2021;14;RENNES;MASCULIN;INDIVIDUEL;BAC PROFESSIONNEL;BAC PRO SERV;BAC PRO 31202 COMMERCE;4;4;1;1;2;2;0;3;0;0;0;0;3;1
7329.0;2021;14;RENNES;MASCULIN;INDIVIDUEL;BAC TECHNOLOGIQUE;BAC ST2S;BAC ST2S SCIENCES & TECHNO. SANTE & SOCIAL;2;2;2;0;0;0;0;2;0;0;1;0;1;0
7333.0;2021;14;RENNES;MASCULIN;INDIVIDUEL;BAC TECHNOLOGIQUE;BAC STI2D;BAC STI2D INNOVATION TECHNO.  ET ECO CONCEPTION;1;0;0;0;0;0;0;0;0;0;0;0;0;0
7340.0;2021;14;RENNES;MASCULIN;SCOLAIRE;BAC PROFESSIONNEL;BAC PRO PROD;BACPRO 20002 ETUD.DEFINITION PRDTS INDUSTRIEL;28;28;21;7;0;0;0;21;0;1;1;10;9;7
7343.0;2021;14;RENNES;MASCULIN;SCOLAIRE;BAC PROFESSIONNEL;BAC PRO PROD;BAC PRO 22403 ARTS.& MET.ART:MET.ENSEIGN SIGNA;9;9;9;0;0;0;0;9;0;1;1;3;4;0
7345.0;2021;14;RENNES;MASCULIN;SCOLAIRE;BAC PROFESSIONNEL;BAC PRO PROD;BAC PRO 22703 TECHN.INSTALL.SYST.ENERG.CLIMATI;73;73;61;8;4;3;1;64;0;1;15;23;25;9
7347.0;2021;14;RENNES;MASCULIN;SCOLAIRE;BAC PROFESSIONNEL;BAC PRO PROD;BAC PRO 23003 ARTIS. & M.ART:MARCHANDISAGE VIS.;2;2;2;0;0;0;0;2;0;0;0;2;0;0
7349.0;2021;14;RENNES;MASCULIN;SCOLAIRE;BAC PROFESSIONNEL;BAC PRO PROD;BAC PRO 23005 TECHN. ETUDES BAT B ASSIST.ARCHI.;40;40;36;3;1;1;0;37;0;1;10;15;11;3
7357.0;2021;14;RENNES;MASCULIN;SCOLAIRE;BAC PROFESSIONNEL;BAC PRO PROD;BAC PRO 23407 TECHNIC.FAB.BOIS ET MATERX ASSOC;17;17;15;1;1;1;0;16;0;1;3;6;6;1
7359.0;2021;14;RENNES;MASCULIN;SCOLAIRE;BAC PROFESSIONNEL;BAC PRO PROD;BAC PRO 24202 ARTIS.& MET.ART : TAPIS.D'AMEUBL;1;1;1;0;0;0;0;1;0;0;0;1;0;0
7360.0;2021;14;RENNES;MASCULIN;SCOLAIRE;BAC PROFESSIONNEL;BAC PRO PROD;BAC PRO 24203 METIERS DE LA MODE - VÊTEMENT;24;23;17;6;0;0;0;17;0;1;2;5;9;6
7363.0;2021;14;RENNES;MASCULIN;SCOLAIRE;BAC PROFESSIONNEL;BAC PRO PROD;BAC PRO 25007 MAINTENANCE EQUIPEMENTS INDUST.;261;261;217;27;17;9;8;226;0;7;48;95;76;35
7368.0;2021;14;RENNES;MASCULIN;SCOLAIRE;BAC PROFESSIONNEL;BAC PRO PROD;BAC PRO 25215 MAINT.VEHIC.OPTB VEHIC.TRANS.ROUT;51;51;43;4;4;2;2;45;0;2;7;15;21;6
7382.0;2021;14;RENNES;MASCULIN;SCOLAIRE;BAC PROFESSIONNEL;BAC PRO PROD;BAC PRO 25514 SYST.NUM.OPT.B AUD.RES.EQUIP.DOM.;158;158;151;5;2;1;1;152;0;5;32;76;39;6
7384.0;2021;14;RENNES;MASCULIN;SCOLAIRE;BAC PROFESSIONNEL;BAC PRO PROD;BAC PRO AG 21001 AGRO-EQUIPEMENT;117;117;104;13;0;0;0;104;0;1;5;37;61;13
7402.0;2021;14;RENNES;MASCULIN;SCOLAIRE;BAC PROFESSIONNEL;BAC PRO SERV;BAC PRO 31206 VENTE (PROSPECT.NEGO.SUIV.CLIENT;318;317;270;25;22;20;2;290;0;6;28;110;146;27
7407.0;2021;14;RENNES;MASCULIN;SCOLAIRE;BAC PROFESSIONNEL;BAC PRO SERV;BAC PRO 33002 SERVICES DE PROXIMITE  VIE LOCAL;44;44;41;3;0;0;0;41;0;1;12;19;9;3
7425.0;2021;14;RENNES;MASCULIN;SCOLAIRE;BAC TECHNOLOGIQUE;BAC STL;BAC STL SCIENCES PHYSIQUES CHIMIQUES  EN LABORAT.;56;56;55;0;1;1;0;56;0;3;10;22;21;0
7427.0;2021;14;RENNES;MASCULIN;SCOLAIRE;BAC TECHNOLOGIQUE;BAC STMG;BAC STMG MERCATIQUE (MARKETING);1146;1146;1044;15;87;54;33;1098;0;8;103;470;517;48
7430.0;2021;15;STRASBOURG;FEMININ;APPRENTISSAGE;BAC PROFESSIONNEL;BAC PRO PROD;BAC PRO 20102 PILOTE DE LIGNE DE PRODUCTION;3;3;3;0;0;0;0;3;0;3;0;0;0;0
7432.0;2021;15;STRASBOURG;FEMININ;APPRENTISSAGE;BAC PROFESSIONNEL;BAC PRO PROD;BAC PRO 22503 PLASTIQUES ET COMPOSITES;1;1;1;0;0;0;0;1;0;0;0;1;0;0
7437.0;2021;15;STRASBOURG;FEMININ;APPRENTISSAGE;BAC PROFESSIONNEL;BAC PRO PROD;BAC PRO 25214 MAINT.VEHIC.OPTA VOIT.PARTICUL.;3;3;3;0;0;0;0;3;0;0;0;3;0;0
7443.0;2021;15;STRASBOURG;FEMININ;APPRENTISSAGE;BAC PROFESSIONNEL;BAC PRO PROD;BAC PRO AG 21211 COND GEST ENTR HIPPIQUE;8;8;8;0;0;0;0;8;0;0;0;2;6;0
7460.0;2021;15;STRASBOURG;FEMININ;ENSEIGNEMENT A DISTANCE;BAC TECHNOLOGIQUE;BAC STMG;BAC STMG RESSOURCES HUMAINES ET COMMUNICATION;2;2;2;0;0;0;0;2;0;0;1;0;1;0
7468.0;2021;15;STRASBOURG;FEMININ;INDIVIDUEL;BAC PROFESSIONNEL;BAC PRO PROD;BAC PRO AG 21203 TECHN CONSEIL DE VENTE ANIMAL;1;1;1;0;0;0;0;1;0;0;0;0;1;0
7469.0;2021;15;STRASBOURG;FEMININ;INDIVIDUEL;BAC PROFESSIONNEL;BAC PRO PROD;BAC PRO AG 21211 COND GEST ENTR HIPPIQUE;3;3;2;1;0;0;0;2;0;0;0;0;2;1
7473.0;2021;15;STRASBOURG;FEMININ;INDIVIDUEL;BAC PROFESSIONNEL;BAC PRO SERV;BAC PRO 33004 ACC.SOINS-S.PERS. OPT.EN STRUCTUR;2;0;0;0;0;0;0;0;0;0;0;0;0;0
7478.0;2021;15;STRASBOURG;FEMININ;INDIVIDUEL;BAC TECHNOLOGIQUE;BAC STL;BAC STL BIOCHIM.-BIOLOGIE-BIOTECHNOL.;1;1;1;0;0;0;0;1;0;0;0;0;1;0
7481.0;2021;15;STRASBOURG;FEMININ;INDIVIDUEL;BAC TECHNOLOGIQUE;BAC STMG;BAC STMG MERCATIQUE (MARKETING);6;4;4;0;0;0;0;4;0;0;1;2;1;0
7482.0;2021;15;STRASBOURG;FEMININ;INDIVIDUEL;BAC TECHNOLOGIQUE;BAC STMG;BAC STMG RESSOURCES HUMAINES ET COMMUNICATION;8;4;0;2;2;1;1;1;0;0;0;0;1;3
7492.0;2021;15;STRASBOURG;FEMININ;SCOLAIRE;BAC PROFESSIONNEL;BAC PRO PROD;BAC PRO 23405 TECHNICIEN MENUISIER AGENCEUR;3;3;2;1;0;0;0;2;0;0;1;1;0;1
7493.0;2021;15;STRASBOURG;FEMININ;SCOLAIRE;BAC PROFESSIONNEL;BAC PRO PROD;BAC PRO 24002 METIERS PRESSING BLANCHISSERIE;4;4;2;1;1;1;0;3;0;1;0;0;2;1
7505.0;2021;15;STRASBOURG;FEMININ;SCOLAIRE;BAC PROFESSIONNEL;BAC PRO PROD;BAC PRO 25515 SYST.NUM.OPT.C RES.INF.SYST.COMM.;6;6;5;1;0;0;0;5;0;0;1;1;3;1
7506.0;2021;15;STRASBOURG;FEMININ;SCOLAIRE;BAC PROFESSIONNEL;BAC PRO PROD;BAC PRO AG 21004 CGEA;13;13;11;2;0;0;0;11;0;0;2;4;5;2
7508.0;2021;15;STRASBOURG;FEMININ;SCOLAIRE;BAC PROFESSIONNEL;BAC PRO PROD;BAC PRO AG 21114 CONDUITE PRODUCTIONS HORTICOLES;12;12;11;1;0;0;0;11;0;0;3;6;2;1
7522.0;2021;15;STRASBOURG;FEMININ;SCOLAIRE;BAC PROFESSIONNEL;BAC PRO SERV;BAC PRO 33002 SERVICES DE PROXIMITE  VIE LOCAL;95;95;79;4;12;5;7;84;0;3;18;26;37;11
7526.0;2021;15;STRASBOURG;FEMININ;SCOLAIRE;BAC PROFESSIONNEL;BAC PRO SERV;BAC PRO 33403 COMMERC. SERVICES EN RESTAURATION;34;33;27;3;3;1;2;28;0;5;8;10;5;5
7528.0;2021;15;STRASBOURG;FEMININ;SCOLAIRE;BAC PROFESSIONNEL;BAC PRO SERV;BAC PRO 34304 HYGIENE PROPRETE STERILISATION;18;18;15;2;1;1;0;16;0;0;1;6;9;2
7529.0;2021;15;STRASBOURG;FEMININ;SCOLAIRE;BAC PROFESSIONNEL;BAC PRO SERV;BAC PRO 34403 METIERS DE LA SECURITE;15;15;15;0;0;0;0;15;0;1;5;6;3;0
7530.0;2021;15;STRASBOURG;FEMININ;SCOLAIRE;BAC PROFESSIONNEL;BAC PRO SERV;BAC PRO AG 33002 SERV PERS TERRIT;41;40;40;0;0;0;0;40;0;3;9;19;9;0
7532.0;2021;15;STRASBOURG;FEMININ;SCOLAIRE;BAC TECHNOLOGIQUE;BAC STAV;BAC STAV AGRONOMIE ALIM ENV TERRITOI;42;42;42;0;0;0;0;42;0;2;12;15;13;0
7541.0;2021;15;STRASBOURG;FEMININ;SCOLAIRE;BAC TECHNOLOGIQUE;BAC STMG;BAC STMG GESTION ET FINANCE;163;163;158;2;3;1;2;159;0;8;35;59;57;4
7544.0;2021;15;STRASBOURG;FEMININ;SCOLAIRE;BAC TECHNOLOGIQUE;BAC STMG;BAC STMG SYSTEMES D'INFORMATION DE GESTION;27;27;26;0;1;1;0;27;0;1;1;14;11;0
7550.0;2021;15;STRASBOURG;MASCULIN;APPRENTISSAGE;BAC PROFESSIONNEL;BAC PRO PROD;BAC PRO 22704 TECHN. MAINT. SYST.ENERG.CLIMATI;10;10;7;2;1;1;0;8;0;2;0;2;4;2
7563.0;2021;15;STRASBOURG;MASCULIN;APPRENTISSAGE;BAC PROFESSIONNEL;BAC PRO PROD;BAC PRO 25219 MAINT.MATERIELS OPT.A AGRICOLES;10;10;9;1;0;0;0;9;0;1;2;4;2;1
7564.0;2021;15;STRASBOURG;MASCULIN;APPRENTISSAGE;BAC PROFESSIONNEL;BAC PRO PROD;BAC PRO 25220 MAINT.MATERIELS OPT.B TP MANUT.;17;15;14;1;0;0;0;14;0;4;2;4;4;1
7565.0;2021;15;STRASBOURG;MASCULIN;APPRENTISSAGE;BAC PROFESSIONNEL;BAC PRO PROD;BAC PRO 25221 MAINT.MATERIELS OPT.C ESP. VERTS;7;7;6;0;1;0;1;6;0;0;0;5;1;1
7577.0;2021;15;STRASBOURG;MASCULIN;APPRENTISSAGE;BAC PROFESSIONNEL;BAC PRO PROD;BAC PRO AG 21114 CONDUITE PRODUCTIONS HORTICOLES;3;3;3;0;0;0;0;3;0;0;1;0;2;0
7586.0;2021;15;STRASBOURG;MASCULIN;APPRENTISSAGE;BAC PROFESSIONNEL;BAC PRO SERV;BAC PRO 33403 COMMERC. SERVICES EN RESTAURATION;9;9;8;1;0;0;0;8;0;0;5;2;1;1
7589.0;2021;15;STRASBOURG;MASCULIN;ENSEIGNEMENT A DISTANCE;BAC PROFESSIONNEL;BAC PRO SERV;BAC PRO 31202 COMMERCE;7;5;3;2;0;0;0;3;0;0;0;0;3;2
7592.0;2021;15;STRASBOURG;MASCULIN;FORMATION CONTINUE;BAC PROFESSIONNEL;BAC PRO PROD;BAC PRO 20102 PILOTE DE LIGNE DE PRODUCTION;3;3;3;0;0;0;0;3;0;0;1;2;0;0
7598.0;2021;15;STRASBOURG;MASCULIN;FORMATION CONTINUE;BAC PROFESSIONNEL;BAC PRO PROD;BAC PRO 25007 MAINTENANCE EQUIPEMENTS INDUST.;3;3;3;0;0;0;0;3;0;0;1;1;1;0
7599.0;2021;15;STRASBOURG;MASCULIN;FORMATION CONTINUE;BAC PROFESSIONNEL;BAC PRO PROD;BAC PRO 25106 TECHNICIEN D'USINAGE;5;4;4;0;0;0;0;4;0;2;0;1;1;0
7601.0;2021;15;STRASBOURG;MASCULIN;FORMATION CONTINUE;BAC PROFESSIONNEL;BAC PRO PROD;BAC PRO 25408 REPARATION DES CARROSSERIES;1;1;1;0;0;0;0;1;0;0;1;0;0;0
7607.0;2021;15;STRASBOURG;MASCULIN;INDIVIDUEL;BAC GENERAL;BAC GENERAL;BAC GENE 10019 BAC GENERAL;80;56;38;10;8;2;6;40;0;7;12;8;13;16
7610.0;2021;15;STRASBOURG;MASCULIN;INDIVIDUEL;BAC PROFESSIONNEL;BAC PRO PROD;BAC PRO 22704 TECHN. MAINT. SYST.ENERG.CLIMATI;1;1;1;0;0;0;0;1;0;0;0;0;1;0
7613.0;2021;15;STRASBOURG;MASCULIN;INDIVIDUEL;BAC PROFESSIONNEL;BAC PRO PROD;BAC PRO 25214 MAINT.VEHIC.OPTA VOIT.PARTICUL.;4;2;1;1;0;0;0;1;0;0;0;0;1;1
7615.0;2021;15;STRASBOURG;MASCULIN;INDIVIDUEL;BAC PROFESSIONNEL;BAC PRO PROD;BAC PRO 25510 METIERS ELECT. ENVIRON. CONNECTES;9;5;2;2;1;0;1;2;0;2;0;0;0;3
7616.0;2021;15;STRASBOURG;MASCULIN;INDIVIDUEL;BAC PROFESSIONNEL;BAC PRO PROD;BAC PRO AG 21004 CGEA;1;0;0;0;0;0;0;0;0;0;0;0;0;0
7619.0;2021;15;STRASBOURG;MASCULIN;INDIVIDUEL;BAC PROFESSIONNEL;BAC PRO SERV;BAC PRO 30001 GESTION-ADMINISTRATION;1;1;1;0;0;0;0;1;0;0;0;0;1;0
7624.0;2021;15;STRASBOURG;MASCULIN;INDIVIDUEL;BAC TECHNOLOGIQUE;BAC ST2S;BAC ST2S SCIENCES & TECHNO. SANTE & SOCIAL;4;3;1;0;2;1;1;2;0;0;0;0;2;1
7626.0;2021;15;STRASBOURG;MASCULIN;INDIVIDUEL;BAC TECHNOLOGIQUE;BAC STI2D;BAC STI2D INNOVATION TECHNO.  ET ECO CONCEPTION;1;1;0;1;0;0;0;0;0;0;0;0;0;1
7644.0;2021;15;STRASBOURG;MASCULIN;SCOLAIRE;BAC PROFESSIONNEL;BAC PRO PROD;BAC PRO 23205 INTERV. SUR PATRIMOINE BATI OPT.A;3;3;1;0;2;2;0;3;0;0;0;0;3;0
7645.0;2021;15;STRASBOURG;MASCULIN;SCOLAIRE;BAC PROFESSIONNEL;BAC PRO PROD;BAC PRO 23303 MENUISERIE ALUMINIUM-VERRE;9;9;2;4;3;0;3;2;0;0;0;1;1;7
7652.0;2021;15;STRASBOURG;MASCULIN;SCOLAIRE;BAC PROFESSIONNEL;BAC PRO PROD;BAC PRO 25106 TECHNICIEN D'USINAGE;69;69;57;10;2;2;0;59;0;3;11;24;21;10
7663.0;2021;15;STRASBOURG;MASCULIN;SCOLAIRE;BAC PROFESSIONNEL;BAC PRO PROD;BAC PRO 25509 TECHNIC. FROID CONDITIONNEMT AIR;12;12;11;1;0;0;0;11;0;0;3;2;6;1
7671.0;2021;15;STRASBOURG;MASCULIN;SCOLAIRE;BAC PROFESSIONNEL;BAC PRO PROD;BAC PRO AG 21302 GEST MILIEUX NATURELS FAUNE;10;10;9;1;0;0;0;9;0;0;3;2;4;1
7676.0;2021;15;STRASBOURG;MASCULIN;SCOLAIRE;BAC PROFESSIONNEL;BAC PRO SERV;BAC PRO 30001 GESTION-ADMINISTRATION;153;153;108;32;13;6;7;114;0;2;19;43;50;39
7683.0;2021;15;STRASBOURG;MASCULIN;SCOLAIRE;BAC PROFESSIONNEL;BAC PRO SERV;BAC PRO 31210 ACCUEIL -RELATION CLIENTS USAGERS;31;31;28;2;1;1;0;29;0;0;5;12;12;2
7689.0;2021;15;STRASBOURG;MASCULIN;SCOLAIRE;BAC PROFESSIONNEL;BAC PRO SERV;BAC PRO 33101 OPTIQUE LUNETTERIE;5;5;5;0;0;0;0;5;0;0;1;3;1;0
7692.0;2021;15;STRASBOURG;MASCULIN;SCOLAIRE;BAC PROFESSIONNEL;BAC PRO SERV;BAC PRO 34304 HYGIENE PROPRETE STERILISATION;5;5;3;0;2;1;1;4;0;0;0;1;3;1
7696.0;2021;15;STRASBOURG;MASCULIN;SCOLAIRE;BAC TECHNOLOGIQUE;BAC STAV;BAC STAV AGRONOMIE ALIM ENV TERRITOI;32;32;32;0;0;0;0;32;0;0;6;16;10;0
7707.0;2021;15;STRASBOURG;MASCULIN;SCOLAIRE;BAC TECHNOLOGIQUE;BAC STMG;BAC STMG RESSOURCES HUMAINES ET COMMUNICATION;116;116;97;3;16;7;9;104;0;3;10;31;60;12
7708.0;2021;15;STRASBOURG;MASCULIN;SCOLAIRE;BAC TECHNOLOGIQUE;BAC STMG;BAC STMG SYSTEMES D'INFORMATION DE GESTION;40;40;33;3;4;1;3;34;0;0;0;12;22;6
7711.0;2021;16;TOULOUSE;FEMININ;APPRENTISSAGE;BAC PROFESSIONNEL;BAC PRO PROD;BAC PRO 22106 CUISINE;1;1;1;0;0;0;0;1;0;0;0;0;1;0
7712.0;2021;16;TOULOUSE;FEMININ;APPRENTISSAGE;BAC PROFESSIONNEL;BAC PRO PROD;BAC PRO 22703 TECHN.INSTALL.SYST.ENERG.CLIMATI;1;1;1;0;0;0;0;1;0;1;0;0;0;0
7713.0;2021;16;TOULOUSE;FEMININ;APPRENTISSAGE;BAC PROFESSIONNEL;BAC PRO PROD;BAC PRO 22705 TECHNICIEN GAZ;1;0;0;0;0;0;0;0;0;0;0;0;0;0
7716.0;2021;16;TOULOUSE;FEMININ;APPRENTISSAGE;BAC PROFESSIONNEL;BAC PRO PROD;BAC PRO 23304 AMENAGEMENT FINITION BATIMENT;1;1;1;0;0;0;0;1;0;0;1;0;0;0
7719.0;2021;16;TOULOUSE;FEMININ;APPRENTISSAGE;BAC PROFESSIONNEL;BAC PRO PROD;BAC PRO 25007 MAINTENANCE EQUIPEMENTS INDUST.;2;2;1;0;1;1;0;2;0;0;1;0;1;0
7729.0;2021;16;TOULOUSE;FEMININ;APPRENTISSAGE;BAC PROFESSIONNEL;BAC PRO PROD;BAC PRO AG 21405 AMENAGEMENTS PAYSAGERS;1;1;1;0;0;0;0;1;0;0;0;0;1;0
7732.0;2021;16;TOULOUSE;FEMININ;APPRENTISSAGE;BAC PROFESSIONNEL;BAC PRO SERV;BAC PRO 31106 LOGISTIQUE;2;2;1;0;1;1;0;2;0;0;1;0;1;0
7735.0;2021;16;TOULOUSE;FEMININ;APPRENTISSAGE;BAC PROFESSIONNEL;BAC PRO SERV;BAC PRO 32207 REAL.PR.IMPR.PLURI.OPTA.PR.GRAPH.;2;2;2;0;0;0;0;2;0;0;0;1;1;0
7740.0;2021;16;TOULOUSE;FEMININ;APPRENTISSAGE;BAC PROFESSIONNEL;BAC PRO SERV;BAC PRO 33603 ESTHETIQUE COSMETIQUE PARFUMERIE;5;5;4;1;0;0;0;4;0;0;1;2;1;1
7742.0;2021;16;TOULOUSE;FEMININ;APPRENTISSAGE;BAC PROFESSIONNEL;BAC PRO SERV;BAC PRO AG 33002 SERV PERS TERRIT;4;4;4;0;0;0;0;4;0;0;0;3;1;0
7749.0;2021;16;TOULOUSE;FEMININ;ENSEIGNEMENT A DISTANCE;BAC TECHNOLOGIQUE;BAC ST2S;BAC ST2S SCIENCES & TECHNO. SANTE & SOCIAL;9;9;9;0;0;0;0;9;0;1;2;2;4;0
7750.0;2021;16;TOULOUSE;FEMININ;ENSEIGNEMENT A DISTANCE;BAC TECHNOLOGIQUE;BAC STMG;BAC STMG GESTION ET FINANCE;2;2;2;0;0;0;0;2;0;1;0;1;0;0
7757.0;2021;16;TOULOUSE;FEMININ;FORMATION CONTINUE;BAC PROFESSIONNEL;BAC PRO PROD;BAC PRO AG 21114 CONDUITE PRODUCTIONS HORTICOLES;10;10;10;0;0;0;0;10;0;0;7;3;0;0
7762.0;2021;16;TOULOUSE;FEMININ;INDIVIDUEL;BAC PROFESSIONNEL;BAC PRO PROD;BAC PRO 22003 BIO-INDUSTRIES DE TRANSFORMATION;1;0;0;0;0;0;0;0;0;0;0;0;0;0
7778.0;2021;16;TOULOUSE;FEMININ;INDIVIDUEL;BAC TECHNOLOGIQUE;BAC STAV;BAC STAV AGRONOMIE ALIM ENV TERRITOI;1;1;1;0;0;0;0;1;0;0;0;0;1;0
7779.0;2021;16;TOULOUSE;FEMININ;INDIVIDUEL;BAC TECHNOLOGIQUE;BAC STMG;BAC STMG GESTION ET FINANCE;5;3;0;2;1;1;0;1;0;0;0;0;1;2
7781.0;2021;16;TOULOUSE;FEMININ;INDIVIDUEL;BAC TECHNOLOGIQUE;BAC STMG;BAC STMG RESSOURCES HUMAINES ET COMMUNICATION;13;7;3;2;2;2;0;5;0;0;0;1;4;2
7783.0;2021;16;TOULOUSE;FEMININ;SCOLAIRE;BAC GENERAL;BAC GENERAL;BAC GENE 10019 BAC GENERAL;9116;9114;8903;47;164;103;61;9006;184;1253;2690;3265;1614;108
7788.0;2021;16;TOULOUSE;FEMININ;SCOLAIRE;BAC PROFESSIONNEL;BAC PRO PROD;BAC PRO 22106 CUISINE;80;80;77;1;2;0;2;77;0;10;19;34;14;3
7792.0;2021;16;TOULOUSE;FEMININ;SCOLAIRE;BAC PROFESSIONNEL;BAC PRO PROD;BAC PRO 23003 ARTIS. & M.ART:MARCHANDISAGE VIS.;14;14;12;2;0;0;0;12;0;1;3;3;5;2
7794.0;2021;16;TOULOUSE;FEMININ;SCOLAIRE;BAC PROFESSIONNEL;BAC PRO PROD;BAC PRO 23005 TECHN. ETUDES BAT B ASSIST.ARCHI.;19;18;16;0;2;2;0;18;0;1;4;6;7;0
7795.0;2021;16;TOULOUSE;FEMININ;SCOLAIRE;BAC PROFESSIONNEL;BAC PRO PROD;BACPRO 23103 TECHNICIEN GEOMETRE-TOPOGRAPHE;2;2;2;0;0;0;0;2;0;0;0;1;1;0
7798.0;2021;16;TOULOUSE;FEMININ;SCOLAIRE;BAC PROFESSIONNEL;BAC PRO PROD;BAC PRO 23405 TECHNICIEN MENUISIER AGENCEUR;6;5;5;0;0;0;0;5;0;0;2;3;0;0
7803.0;2021;16;TOULOUSE;FEMININ;SCOLAIRE;BAC PROFESSIONNEL;BAC PRO PROD;BAC PRO 25006 MICROTECHNIQUES;1;1;1;0;0;0;0;1;0;0;0;1;0;0
7805.0;2021;16;TOULOUSE;FEMININ;SCOLAIRE;BAC PROFESSIONNEL;BAC PRO PROD;BAC PRO 25106 TECHNICIEN D'USINAGE;5;5;5;0;0;0;0;5;0;0;0;1;4;0
7807.0;2021;16;TOULOUSE;FEMININ;SCOLAIRE;BAC PROFESSIONNEL;BAC PRO PROD;BAC PRO 25214 MAINT.VEHIC.OPTA VOIT.PARTICUL.;6;6;6;0;0;0;0;6;0;0;0;4;2;0
7813.0;2021;16;TOULOUSE;FEMININ;SCOLAIRE;BAC PROFESSIONNEL;BAC PRO PROD;BAC PRO 25304 AERONAUTIQUE OPTION STRUCTURE;15;15;15;0;0;0;0;15;0;2;9;3;1;0
7814.0;2021;16;TOULOUSE;FEMININ;SCOLAIRE;BAC PROFESSIONNEL;BAC PRO PROD;BAC PRO 25408 REPARATION DES CARROSSERIES;1;1;0;1;0;0;0;0;0;0;0;0;0;1
7821.0;2021;16;TOULOUSE;FEMININ;SCOLAIRE;BAC PROFESSIONNEL;BAC PRO PROD;BAC PRO AG 21113 CGEVV;3;3;3;0;0;0;0;3;0;0;0;1;2;0
7834.0;2021;16;TOULOUSE;FEMININ;SCOLAIRE;BAC PROFESSIONNEL;BAC PRO SERV;BAC PRO 31107 CONDUCT. TRANSP.ROUT.MARCHANDISES;1;1;1;0;0;0;0;1;0;0;0;0;1;0
7838.0;2021;16;TOULOUSE;FEMININ;SCOLAIRE;BAC PROFESSIONNEL;BAC PRO SERV;BAC PRO 31210 ACCUEIL -RELATION CLIENTS USAGERS;259;258;221;15;22;19;3;240;0;6;58;85;91;18
7839.0;2021;16;TOULOUSE;FEMININ;SCOLAIRE;BAC PROFESSIONNEL;BAC PRO SERV;BAC PRO 32207 REAL.PR.IMPR.PLURI.OPTA.PR.GRAPH.;6;6;5;1;0;0;0;5;0;0;1;4;0;1
7840.0;2021;16;TOULOUSE;FEMININ;SCOLAIRE;BAC PROFESSIONNEL;BAC PRO SERV;BAC PRO 32208 REAL.PR.IMPR.PLURI.OPTB.PR.IMPR.;7;7;7;0;0;0;0;7;0;0;4;1;2;0
7843.0;2021;16;TOULOUSE;FEMININ;SCOLAIRE;BAC PROFESSIONNEL;BAC PRO SERV;BAC PRO 33002 SERVICES DE PROXIMITE  VIE LOCAL;22;22;22;0;0;0;0;22;0;2;11;6;3;0
7851.0;2021;16;TOULOUSE;FEMININ;SCOLAIRE;BAC PROFESSIONNEL;BAC PRO SERV;BAC PRO 33603 ESTHETIQUE COSMETIQUE PARFUMERIE;152;151;140;5;6;5;1;145;0;6;43;63;33;6
7852.0;2021;16;TOULOUSE;FEMININ;SCOLAIRE;BAC PROFESSIONNEL;BAC PRO SERV;BAC PRO 34403 METIERS DE LA SECURITE;19;19;18;0;1;1;0;19;0;4;4;7;4;0
7854.0;2021;16;TOULOUSE;FEMININ;SCOLAIRE;BAC TECHNOLOGIQUE;BAC S2TMD;BAC S2TMD DANSE;3;3;3;0;0;0;0;3;0;0;2;1;0;0
7863.0;2021;16;TOULOUSE;FEMININ;SCOLAIRE;BAC TECHNOLOGIQUE;BAC STI2D;BAC STI2D SYSTÈME D'INFORMATION  ET NUMERIQUE;17;17;16;0;1;1;0;17;0;2;4;5;6;0
7870.0;2021;16;TOULOUSE;MASCULIN;APPRENTISSAGE;BAC PROFESSIONNEL;BAC PRO PROD;BAC PRO 22003 BIO-INDUSTRIES DE TRANSFORMATION;2;2;1;1;0;0;0;1;0;0;0;0;1;1
7871.0;2021;16;TOULOUSE;MASCULIN;APPRENTISSAGE;BAC PROFESSIONNEL;BAC PRO PROD;BAC PRO 22104 BOUCHER CHARCUTIER TRAITEUR;6;6;5;0;1;1;0;6;0;0;2;1;3;0
7872.0;2021;16;TOULOUSE;MASCULIN;APPRENTISSAGE;BAC PROFESSIONNEL;BAC PRO PROD;BAC PRO 22105 BOULANGER-PÂTISSIER;1;1;1;0;0;0;0;1;0;0;0;0;1;0
7873.0;2021;16;TOULOUSE;MASCULIN;APPRENTISSAGE;BAC PROFESSIONNEL;BAC PRO PROD;BAC PRO 22106 CUISINE;7;6;4;2;0;0;0;4;0;0;1;2;1;2
7875.0;2021;16;TOULOUSE;MASCULIN;APPRENTISSAGE;BAC PROFESSIONNEL;BAC PRO PROD;BAC PRO 22703 TECHN.INSTALL.SYST.ENERG.CLIMATI;22;21;19;2;0;0;0;19;0;1;3;6;9;2
7888.0;2021;16;TOULOUSE;MASCULIN;APPRENTISSAGE;BAC PROFESSIONNEL;BAC PRO PROD;BAC PRO 23407 TECHNIC.FAB.BOIS ET MATERX ASSOC;1;1;1;0;0;0;0;1;0;1;0;0;0;0
7889.0;2021;16;TOULOUSE;MASCULIN;APPRENTISSAGE;BAC PROFESSIONNEL;BAC PRO PROD;BAC PRO 25007 MAINTENANCE EQUIPEMENTS INDUST.;22;22;17;2;3;3;0;20;0;6;1;6;7;2
7890.0;2021;16;TOULOUSE;MASCULIN;APPRENTISSAGE;BAC PROFESSIONNEL;BAC PRO PROD;BAC PRO 25106 TECHNICIEN D'USINAGE;55;53;44;3;6;4;2;48;0;7;7;18;16;5
7891.0;2021;16;TOULOUSE;MASCULIN;APPRENTISSAGE;BAC PROFESSIONNEL;BAC PRO PROD;BAC PRO 25214 MAINT.VEHIC.OPTA VOIT.PARTICUL.;116;115;102;7;6;3;3;105;0;11;19;40;35;10
7894.0;2021;16;TOULOUSE;MASCULIN;APPRENTISSAGE;BAC PROFESSIONNEL;BAC PRO PROD;BAC PRO 25219 MAINT.MATERIELS OPT.A AGRICOLES;36;35;28;5;2;1;1;29;0;0;7;8;14;6
7896.0;2021;16;TOULOUSE;MASCULIN;APPRENTISSAGE;BAC PROFESSIONNEL;BAC PRO PROD;BAC PRO 25221 MAINT.MATERIELS OPT.C ESP. VERTS;5;5;4;0;1;1;0;5;0;0;1;3;1;0
7904.0;2021;16;TOULOUSE;MASCULIN;APPRENTISSAGE;BAC PROFESSIONNEL;BAC PRO PROD;BAC PRO 25510 METIERS ELECT. ENVIRON. CONNECTES;61;61;50;5;6;3;3;53;0;6;14;15;18;8
7912.0;2021;16;TOULOUSE;MASCULIN;APPRENTISSAGE;BAC PROFESSIONNEL;BAC PRO SERV;BAC PRO 31210 ACCUEIL -RELATION CLIENTS USAGERS;1;1;0;1;0;0;0;0;0;0;0;0;0;1
7920.0;2021;16;TOULOUSE;MASCULIN;ENSEIGNEMENT A DISTANCE;BAC PROFESSIONNEL;BAC PRO PROD;BAC PRO 25007 MAINTENANCE EQUIPEMENTS INDUST.;1;1;0;1;0;0;0;0;0;0;0;0;0;1
7925.0;2021;16;TOULOUSE;MASCULIN;ENSEIGNEMENT A DISTANCE;BAC TECHNOLOGIQUE;BAC ST2S;BAC ST2S SCIENCES & TECHNO. SANTE & SOCIAL;1;1;1;0;0;0;0;1;0;1;0;0;0;0
7929.0;2021;16;TOULOUSE;MASCULIN;FORMATION CONTINUE;BAC PROFESSIONNEL;BAC PRO PROD;BAC PRO 22703 TECHN.INSTALL.SYST.ENERG.CLIMATI;1;1;1;0;0;0;0;1;0;0;1;0;0;0
7932.0;2021;16;TOULOUSE;MASCULIN;FORMATION CONTINUE;BAC PROFESSIONNEL;BAC PRO PROD;BAC PRO 23304 AMENAGEMENT FINITION BATIMENT;1;1;1;0;0;0;0;1;0;0;1;0;0;0
7934.0;2021;16;TOULOUSE;MASCULIN;FORMATION CONTINUE;BAC PROFESSIONNEL;BAC PRO PROD;BAC PRO 25215 MAINT.VEHIC.OPTB VEHIC.TRANS.ROUT;3;3;2;1;0;0;0;2;0;0;2;0;0;1
7940.0;2021;16;TOULOUSE;MASCULIN;INDIVIDUEL;BAC PROFESSIONNEL;BAC PRO PROD;BAC PRO 22105 BOULANGER-PÂTISSIER;1;0;0;0;0;0;0;0;0;0;0;0;0;0
7942.0;2021;16;TOULOUSE;MASCULIN;INDIVIDUEL;BAC PROFESSIONNEL;BAC PRO PROD;BAC PRO 25007 MAINTENANCE EQUIPEMENTS INDUST.;2;1;0;1;0;0;0;0;0;0;0;0;0;1
7945.0;2021;16;TOULOUSE;MASCULIN;INDIVIDUEL;BAC PROFESSIONNEL;BAC PRO PROD;BAC PRO 25216 MAINT.VEHIC.OPTC MOTOCYCLES;1;0;0;0;0;0;0;0;0;0;0;0;0;0
7951.0;2021;16;TOULOUSE;MASCULIN;INDIVIDUEL;BAC PROFESSIONNEL;BAC PRO PROD;BAC PRO AG 21302 GEST MILIEUX NATURELS FAUNE;2;0;0;0;0;0;0;0;0;0;0;0;0;0
7965.0;2021;16;TOULOUSE;MASCULIN;INDIVIDUEL;BAC TECHNOLOGIQUE;BAC STL;BAC STL BIOCHIM.-BIOLOGIE-BIOTECHNOL.;1;1;0;0;1;1;0;1;0;0;0;0;1;0
7967.0;2021;16;TOULOUSE;MASCULIN;INDIVIDUEL;BAC TECHNOLOGIQUE;BAC STMG;BAC STMG GESTION ET FINANCE;6;3;2;1;0;0;0;2;0;0;0;0;2;1
7974.0;2021;16;TOULOUSE;MASCULIN;SCOLAIRE;BAC PROFESSIONNEL;BAC PRO PROD;BAC PRO 22104 BOUCHER CHARCUTIER TRAITEUR;15;15;12;2;1;1;0;13;0;1;4;4;4;2
7975.0;2021;16;TOULOUSE;MASCULIN;SCOLAIRE;BAC PROFESSIONNEL;BAC PRO PROD;BAC PRO 22105 BOULANGER-PÂTISSIER;41;41;35;4;2;1;1;36;0;2;13;15;6;5
7981.0;2021;16;TOULOUSE;MASCULIN;SCOLAIRE;BAC PROFESSIONNEL;BAC PRO PROD;BAC PRO 23003 ARTIS. & M.ART:MARCHANDISAGE VIS.;13;13;12;1;0;0;0;12;0;1;4;5;2;1
7983.0;2021;16;TOULOUSE;MASCULIN;SCOLAIRE;BAC PROFESSIONNEL;BAC PRO PROD;BAC PRO 23005 TECHN. ETUDES BAT B ASSIST.ARCHI.;46;46;37;6;3;3;0;40;0;2;8;15;15;6
7995.0;2021;16;TOULOUSE;MASCULIN;SCOLAIRE;BAC PROFESSIONNEL;BAC PRO PROD;BAC PRO 24202 ARTIS.& MET.ART : TAPIS.D'AMEUBL;1;1;1;0;0;0;0;1;0;0;0;0;1;0
7999.0;2021;16;TOULOUSE;MASCULIN;SCOLAIRE;BAC PROFESSIONNEL;BAC PRO PROD;BAC PRO 25106 TECHNICIEN D'USINAGE;149;148;106;35;7;4;3;110;0;4;24;45;37;38
8002.0;2021;16;TOULOUSE;MASCULIN;SCOLAIRE;BAC PROFESSIONNEL;BAC PRO PROD;BAC PRO 25214 MAINT.VEHIC.OPTA VOIT.PARTICUL.;233;233;188;34;11;6;5;194;0;11;39;74;70;39
8003.0;2021;16;TOULOUSE;MASCULIN;SCOLAIRE;BAC PROFESSIONNEL;BAC PRO PROD;BAC PRO 25215 MAINT.VEHIC.OPTB VEHIC.TRANS.ROUT;26;26;18;6;2;1;1;19;0;0;6;3;10;7
8006.0;2021;16;TOULOUSE;MASCULIN;SCOLAIRE;BAC PROFESSIONNEL;BAC PRO PROD;BAC PRO 25220 MAINT.MATERIELS OPT.B TP MANUT.;50;50;43;6;1;1;0;44;0;2;9;20;13;6
8008.0;2021;16;TOULOUSE;MASCULIN;SCOLAIRE;BAC PROFESSIONNEL;BAC PRO PROD;BAC PRO 25302 AERONAUTIQUE OPTION AVIONIQUE;42;42;41;1;0;0;0;41;0;4;17;16;4;1
8012.0;2021;16;TOULOUSE;MASCULIN;SCOLAIRE;BAC PROFESSIONNEL;BAC PRO PROD;BAC PRO 25408 REPARATION DES CARROSSERIES;55;55;47;6;2;1;1;48;0;1;5;24;18;7
8015.0;2021;16;TOULOUSE;MASCULIN;SCOLAIRE;BAC PROFESSIONNEL;BAC PRO PROD;BAC PRO 25510 METIERS ELECT. ENVIRON. CONNECTES;462;462;396;55;11;4;7;400;0;11;102;158;129;62
8016.0;2021;16;TOULOUSE;MASCULIN;SCOLAIRE;BAC PROFESSIONNEL;BAC PRO PROD;BAC PRO 25513 SYST.NUM.OPT.A SURETE SECURITE;38;37;31;2;4;2;2;33;0;1;7;13;12;4
8024.0;2021;16;TOULOUSE;MASCULIN;SCOLAIRE;BAC PROFESSIONNEL;BAC PRO PROD;BAC PRO AG 21210 COND GEST ENTR CANIN ET FELIN;11;11;9;2;0;0;0;9;0;0;0;3;6;2
8029.0;2021;16;TOULOUSE;MASCULIN;SCOLAIRE;BAC PROFESSIONNEL;BAC PRO PROD;BAC PRO AG 21406 TEC CONS VTE PROD DES JARDINS;2;2;1;1;0;0;0;1;0;0;1;0;0;1
8034.0;2021;16;TOULOUSE;MASCULIN;SCOLAIRE;BAC PROFESSIONNEL;BAC PRO SERV;BAC PRO 31107 CONDUCT. TRANSP.ROUT.MARCHANDISES;40;40;35;2;3;2;1;37;0;4;12;15;6;3
8039.0;2021;16;TOULOUSE;MASCULIN;SCOLAIRE;BAC PROFESSIONNEL;BAC PRO SERV;BAC PRO 32207 REAL.PR.IMPR.PLURI.OPTA.PR.GRAPH.;6;6;4;2;0;0;0;4;0;0;0;2;2;2
8041.0;2021;16;TOULOUSE;MASCULIN;SCOLAIRE;BAC PROFESSIONNEL;BAC PRO SERV;BAC PRO 32303 ART.& MET.ART:COM.VIS.VIS.PLURI-M;35;35;33;1;1;1;0;34;0;1;9;14;10;1
8042.0;2021;16;TOULOUSE;MASCULIN;SCOLAIRE;BAC PROFESSIONNEL;BAC PRO SERV;BAC PRO 32304 PHOTOGRAPHIE;7;7;7;0;0;0;0;7;0;1;3;2;1;0
8047.0;2021;16;TOULOUSE;MASCULIN;SCOLAIRE;BAC PROFESSIONNEL;BAC PRO SERV;BAC PRO 33102 PROTHESE DENTAIRE;17;17;14;2;1;0;1;14;0;1;2;7;4;3
8049.0;2021;16;TOULOUSE;MASCULIN;SCOLAIRE;BAC PROFESSIONNEL;BAC PRO SERV;BAC PRO 33403 COMMERC. SERVICES EN RESTAURATION;78;78;66;6;6;5;1;71;0;1;7;29;34;7
8056.0;2021;16;TOULOUSE;MASCULIN;SCOLAIRE;BAC TECHNOLOGIQUE;BAC STD2A;BAC STD2A SCIENCES & TECHNO. DESIGN-ARTS APPLIQUES;22;22;22;0;0;0;0;22;0;3;9;7;3;0
8062.0;2021;16;TOULOUSE;MASCULIN;SCOLAIRE;BAC TECHNOLOGIQUE;BAC STL;BAC STL BIOCHIM.-BIOLOGIE-BIOTECHNOL.;82;82;74;0;8;5;3;79;0;2;11;35;31;3
8066.0;2021;16;TOULOUSE;MASCULIN;SCOLAIRE;BAC TECHNOLOGIQUE;BAC STMG;BAC STMG RESSOURCES HUMAINES ET COMMUNICATION;193;193;155;7;31;14;17;169;0;0;9;61;99;24
8068.0;2021;25;VERSAILLES;FEMININ;APPRENTISSAGE;BAC PROFESSIONNEL;BAC PRO PROD;BAC PRO 22105 BOULANGER-PÂTISSIER;9;9;6;2;1;0;1;6;0;0;2;4;0;3
8074.0;2021;25;VERSAILLES;FEMININ;APPRENTISSAGE;BAC PROFESSIONNEL;BAC PRO PROD;BAC PRO 25216 MAINT.VEHIC.OPTC MOTOCYCLES;1;1;1;0;0;0;0;1;0;0;0;1;0;0
8075.0;2021;25;VERSAILLES;FEMININ;APPRENTISSAGE;BAC PROFESSIONNEL;BAC PRO PROD;BAC PRO 25302 AERONAUTIQUE OPTION AVIONIQUE;3;3;3;0;0;0;0;3;0;1;1;1;0;0
8077.0;2021;25;VERSAILLES;FEMININ;APPRENTISSAGE;BAC PROFESSIONNEL;BAC PRO PROD;BAC PRO 25304 AERONAUTIQUE OPTION STRUCTURE;3;3;3;0;0;0;0;3;0;1;1;1;0;0
8096.0;2021;25;VERSAILLES;FEMININ;ENSEIGNEMENT A DISTANCE;BAC PROFESSIONNEL;BAC PRO SERV;BAC PRO 31210 ACCUEIL -RELATION CLIENTS USAGERS;5;3;2;1;0;0;0;2;0;1;0;1;0;1
8098.0;2021;25;VERSAILLES;FEMININ;ENSEIGNEMENT A DISTANCE;BAC PROFESSIONNEL;BAC PRO SERV;BAC PRO 33004 ACC.SOINS-S.PERS. OPT.EN STRUCTUR;12;9;1;8;0;0;0;1;0;0;0;0;1;8
8100.0;2021;25;VERSAILLES;FEMININ;ENSEIGNEMENT A DISTANCE;BAC TECHNOLOGIQUE;BAC ST2S;BAC ST2S SCIENCES & TECHNO. SANTE & SOCIAL;6;6;4;1;1;0;1;4;0;1;1;0;2;2
8105.0;2021;25;VERSAILLES;FEMININ;FORMATION CONTINUE;BAC PROFESSIONNEL;BAC PRO PROD;BAC PRO 22106 CUISINE;1;1;1;0;0;0;0;1;0;1;0;0;0;0
8107.0;2021;25;VERSAILLES;FEMININ;FORMATION CONTINUE;BAC PROFESSIONNEL;BAC PRO PROD;BAC PRO 25303 AERONAUTIQUE OPTION SYSTEMES;1;1;1;0;0;0;0;1;0;1;0;0;0;0
8111.0;2021;25;VERSAILLES;FEMININ;FORMATION CONTINUE;BAC PROFESSIONNEL;BAC PRO SERV;BAC PRO 31210 ACCUEIL -RELATION CLIENTS USAGERS;3;3;3;0;0;0;0;3;0;1;1;0;1;0
8118.0;2021;25;VERSAILLES;FEMININ;INDIVIDUEL;BAC PROFESSIONNEL;BAC PRO PROD;BAC PRO 24203 METIERS DE LA MODE - VÊTEMENT;3;1;1;0;0;0;0;1;0;0;0;0;1;0
8119.0;2021;25;VERSAILLES;FEMININ;INDIVIDUEL;BAC PROFESSIONNEL;BAC PRO PROD;BAC PRO AG 21004 CGEA;5;4;3;1;0;0;0;3;0;0;0;0;3;1
8124.0;2021;25;VERSAILLES;FEMININ;INDIVIDUEL;BAC PROFESSIONNEL;BAC PRO PROD;BAC PRO AG 21211 COND GEST ENTR HIPPIQUE;7;7;6;1;0;0;0;6;0;0;1;1;4;1
8133.0;2021;25;VERSAILLES;FEMININ;INDIVIDUEL;BAC PROFESSIONNEL;BAC PRO SERV;BAC PRO 33603 ESTHETIQUE COSMETIQUE PARFUMERIE;4;3;1;2;0;0;0;1;0;0;0;0;1;2
8134.0;2021;25;VERSAILLES;FEMININ;INDIVIDUEL;BAC PROFESSIONNEL;BAC PRO SERV;BAC PRO AG 33002 SERV PERS TERRIT;1;0;0;0;0;0;0;0;0;0;0;0;0;0
8138.0;2021;25;VERSAILLES;FEMININ;INDIVIDUEL;BAC TECHNOLOGIQUE;BAC STI2D;BAC STI2D SYSTÈME D'INFORMATION  ET NUMERIQUE;1;0;0;0;0;0;0;0;0;0;0;0;0;0
8142.0;2021;25;VERSAILLES;FEMININ;INDIVIDUEL;BAC TECHNOLOGIQUE;BAC STMG;BAC STMG MERCATIQUE (MARKETING);26;21;8;5;8;4;4;12;0;0;0;3;9;9
8145.0;2021;25;VERSAILLES;FEMININ;SCOLAIRE;BAC GENERAL;BAC GENERAL;BAC GENE 10019 BAC GENERAL;21450;21445;20738;144;563;363;200;21101;367;3065;6521;7175;3973;344
8149.0;2021;25;VERSAILLES;FEMININ;SCOLAIRE;BAC PROFESSIONNEL;BAC PRO PROD;BAC PRO 22106 CUISINE;65;65;56;5;4;3;1;59;0;5;15;24;15;6
8150.0;2021;25;VERSAILLES;FEMININ;SCOLAIRE;BAC PROFESSIONNEL;BAC PRO PROD;BAC PRO 22503 PLASTIQUES ET COMPOSITES;1;1;0;1;0;0;0;0;0;0;0;0;0;1
8154.0;2021;25;VERSAILLES;FEMININ;SCOLAIRE;BAC PROFESSIONNEL;BAC PRO PROD;BAC PRO 23005 TECHN. ETUDES BAT B ASSIST.ARCHI.;19;19;15;3;1;1;0;16;0;0;5;6;5;3
8164.0;2021;25;VERSAILLES;FEMININ;SCOLAIRE;BAC PROFESSIONNEL;BAC PRO PROD;BAC PRO 25106 TECHNICIEN D'USINAGE;1;1;1;0;0;0;0;1;0;0;0;0;1;0
8165.0;2021;25;VERSAILLES;FEMININ;SCOLAIRE;BAC PROFESSIONNEL;BAC PRO PROD;BAC PRO 25108 TECHNICIEN MODELEUR;2;2;2;0;0;0;0;2;0;0;1;1;0;0
8168.0;2021;25;VERSAILLES;FEMININ;SCOLAIRE;BAC PROFESSIONNEL;BAC PRO PROD;BAC PRO 25302 AERONAUTIQUE OPTION AVIONIQUE;1;1;1;0;0;0;0;1;0;0;1;0;0;0
8181.0;2021;25;VERSAILLES;FEMININ;SCOLAIRE;BAC PROFESSIONNEL;BAC PRO SERV;BAC PRO 31107 CONDUCT. TRANSP.ROUT.MARCHANDISES;2;2;2;0;0;0;0;2;0;0;0;2;0;0
8183.0;2021;25;VERSAILLES;FEMININ;SCOLAIRE;BAC PROFESSIONNEL;BAC PRO SERV;BAC PRO 31202 COMMERCE;803;800;683;55;62;45;17;728;0;47;166;261;254;72
8194.0;2021;25;VERSAILLES;FEMININ;SCOLAIRE;BAC PROFESSIONNEL;BAC PRO SERV;BAC PRO 33101 OPTIQUE LUNETTERIE;21;21;19;1;1;0;1;19;0;3;6;7;3;2
8195.0;2021;25;VERSAILLES;FEMININ;SCOLAIRE;BAC PROFESSIONNEL;BAC PRO SERV;BAC PRO 33102 PROTHESE DENTAIRE;1;1;0;1;0;0;0;0;0;0;0;0;0;1
8198.0;2021;25;VERSAILLES;FEMININ;SCOLAIRE;BAC PROFESSIONNEL;BAC PRO SERV;BAC PRO 34304 HYGIENE PROPRETE STERILISATION;30;30;26;1;3;2;1;28;0;1;4;10;13;2
8199.0;2021;25;VERSAILLES;FEMININ;SCOLAIRE;BAC PROFESSIONNEL;BAC PRO SERV;BAC PRO 34403 METIERS DE LA SECURITE;81;81;69;6;6;2;4;71;0;3;24;29;15;10
8203.0;2021;25;VERSAILLES;FEMININ;SCOLAIRE;BAC TECHNOLOGIQUE;BAC ST2S;BAC ST2S SCIENCES & TECHNO. SANTE & SOCIAL;1416;1416;1294;26;96;40;56;1334;6;56;254;491;527;82
8206.0;2021;25;VERSAILLES;FEMININ;SCOLAIRE;BAC TECHNOLOGIQUE;BAC STHR;BAC STHR SC.&TEC. HOTELLERIE-RESTAURATION;56;56;54;1;1;0;1;54;1;3;15;21;14;2
8214.0;2021;25;VERSAILLES;FEMININ;SCOLAIRE;BAC TECHNOLOGIQUE;BAC STMG;BAC STMG MERCATIQUE (MARKETING);1615;1614;1527;21;66;42;24;1569;0;38;292;686;553;45
8215.0;2021;25;VERSAILLES;FEMININ;SCOLAIRE;BAC TECHNOLOGIQUE;BAC STMG;BAC STMG RESSOURCES HUMAINES ET COMMUNICATION;1447;1447;1274;31;142;74;68;1348;0;23;162;579;584;99
8217.0;2021;25;VERSAILLES;MASCULIN;APPRENTISSAGE;BAC PROFESSIONNEL;BAC PRO PROD;BAC PRO 22105 BOULANGER-PÂTISSIER;31;31;24;6;1;0;1;24;0;0;3;10;11;7
8220.0;2021;25;VERSAILLES;MASCULIN;APPRENTISSAGE;BAC PROFESSIONNEL;BAC PRO PROD;BAC PRO 22704 TECHN. MAINT. SYST.ENERG.CLIMATI;59;55;41;11;3;1;2;42;0;2;9;15;16;13
8229.0;2021;25;VERSAILLES;MASCULIN;APPRENTISSAGE;BAC PROFESSIONNEL;BAC PRO PROD;BAC PRO 25221 MAINT.MATERIELS OPT.C ESP. VERTS;3;3;1;1;1;0;1;1;0;1;0;0;0;2
8232.0;2021;25;VERSAILLES;MASCULIN;APPRENTISSAGE;BAC PROFESSIONNEL;BAC PRO PROD;BAC PRO 25304 AERONAUTIQUE OPTION STRUCTURE;31;31;28;0;3;1;2;29;0;0;4;20;5;2
8239.0;2021;25;VERSAILLES;MASCULIN;APPRENTISSAGE;BAC PROFESSIONNEL;BAC PRO PROD;BAC PRO AG 21203 TECHN CONSEIL DE VENTE ANIMAL;5;5;5;0;0;0;0;5;0;0;2;1;2;0
8260.0;2021;25;VERSAILLES;MASCULIN;ENSEIGNEMENT A DISTANCE;BAC TECHNOLOGIQUE;BAC STMG;BAC STMG RESSOURCES HUMAINES ET COMMUNICATION;8;7;6;1;0;0;0;6;0;0;1;3;2;1
8270.0;2021;25;VERSAILLES;MASCULIN;FORMATION CONTINUE;BAC PROFESSIONNEL;BAC PRO PROD;BAC PRO AG 21405 AMENAGEMENTS PAYSAGERS;2;2;2;0;0;0;0;2;0;0;0;0;2;0
8273.0;2021;25;VERSAILLES;MASCULIN;FORMATION CONTINUE;BAC PROFESSIONNEL;BAC PRO SERV;BAC PRO 32303 ART.& MET.ART:COM.VIS.VIS.PLURI-M;4;4;3;1;0;0;0;3;0;1;0;2;0;1
8279.0;2021;25;VERSAILLES;MASCULIN;INDIVIDUEL;BAC PROFESSIONNEL;BAC PRO PROD;BAC PRO 23004 TECHN. ETUDES BAT.A ETUDES & ECO.;3;1;0;1;0;0;0;0;0;0;0;0;0;1
8280.0;2021;25;VERSAILLES;MASCULIN;INDIVIDUEL;BAC PROFESSIONNEL;BAC PRO PROD;BAC PRO 23005 TECHN. ETUDES BAT B ASSIST.ARCHI.;1;1;1;0;0;0;0;1;0;0;0;1;0;0
8283.0;2021;25;VERSAILLES;MASCULIN;INDIVIDUEL;BAC PROFESSIONNEL;BAC PRO PROD;BAC PRO 25007 MAINTENANCE EQUIPEMENTS INDUST.;2;2;1;0;1;1;0;2;0;0;0;0;2;0
8287.0;2021;25;VERSAILLES;MASCULIN;INDIVIDUEL;BAC PROFESSIONNEL;BAC PRO PROD;BAC PRO 25510 METIERS ELECT. ENVIRON. CONNECTES;24;15;10;5;0;0;0;10;0;1;1;2;6;5
8290.0;2021;25;VERSAILLES;MASCULIN;INDIVIDUEL;BAC PROFESSIONNEL;BAC PRO PROD;BAC PRO 25515 SYST.NUM.OPT.C RES.INF.SYST.COMM.;4;2;2;0;0;0;0;2;0;0;0;1;1;0
8291.0;2021;25;VERSAILLES;MASCULIN;INDIVIDUEL;BAC PROFESSIONNEL;BAC PRO PROD;BAC PRO AG 21004 CGEA;7;5;5;0;0;0;0;5;0;0;0;0;5;0
8296.0;2021;25;VERSAILLES;MASCULIN;INDIVIDUEL;BAC PROFESSIONNEL;BAC PRO PROD;BAC PRO AG 21405 AMENAGEMENTS PAYSAGERS;2;1;1;0;0;0;0;1;0;0;0;0;1;0
8298.0;2021;25;VERSAILLES;MASCULIN;INDIVIDUEL;BAC PROFESSIONNEL;BAC PRO SERV;BAC PRO 31106 LOGISTIQUE;4;3;0;2;1;1;0;1;0;0;0;0;1;2
8299.0;2021;25;VERSAILLES;MASCULIN;INDIVIDUEL;BAC PROFESSIONNEL;BAC PRO SERV;BAC PRO 31107 CONDUCT. TRANSP.ROUT.MARCHANDISES;1;0;0;0;0;0;0;0;0;0;0;0;0;0
8306.0;2021;25;VERSAILLES;MASCULIN;INDIVIDUEL;BAC PROFESSIONNEL;BAC PRO SERV;BAC PRO 33102 PROTHESE DENTAIRE;1;1;0;1;0;0;0;0;0;0;0;0;0;1
8311.0;2021;25;VERSAILLES;MASCULIN;INDIVIDUEL;BAC TECHNOLOGIQUE;BAC STD2A;BAC STD2A SCIENCES & TECHNO. DESIGN-ARTS APPLIQUES;2;2;2;0;0;0;0;2;0;0;0;1;1;0
8322.0;2021;25;VERSAILLES;MASCULIN;SCOLAIRE;BAC PROFESSIONNEL;BAC PRO PROD;BACPRO 20002 ETUD.DEFINITION PRDTS INDUSTRIEL;55;55;39;13;3;3;0;42;0;1;10;8;23;13
8331.0;2021;25;VERSAILLES;MASCULIN;SCOLAIRE;BAC PROFESSIONNEL;BAC PRO PROD;BAC PRO 23004 TECHN. ETUDES BAT.A ETUDES & ECO.;77;77;46;15;16;15;1;61;0;0;6;16;39;16
8332.0;2021;25;VERSAILLES;MASCULIN;SCOLAIRE;BAC PROFESSIONNEL;BAC PRO PROD;BAC PRO 23005 TECHN. ETUDES BAT B ASSIST.ARCHI.;66;66;50;9;7;6;1;56;0;2;9;22;23;10
8335.0;2021;25;VERSAILLES;MASCULIN;SCOLAIRE;BAC PROFESSIONNEL;BAC PRO PROD;BAC PRO 23203 TECHNICIEN BAT. : ORG.REAL.GROS O;43;43;27;13;3;3;0;30;0;2;3;10;15;13
8360.0;2021;25;VERSAILLES;MASCULIN;SCOLAIRE;BAC PROFESSIONNEL;BAC PRO PROD;BAC PRO 25411 TECH.CHAUDRONNERIE INDUSTRIELLE;66;66;39;24;3;0;3;39;0;3;4;14;18;27
8368.0;2021;25;VERSAILLES;MASCULIN;SCOLAIRE;BAC PROFESSIONNEL;BAC PRO PROD;BAC PRO AG 21203 TECHN CONSEIL DE VENTE ANIMAL;26;25;23;2;0;0;0;23;0;0;1;8;14;2
8380.0;2021;25;VERSAILLES;MASCULIN;SCOLAIRE;BAC PROFESSIONNEL;BAC PRO SERV;BAC PRO 32207 REAL.PR.IMPR.PLURI.OPTA.PR.GRAPH.;41;41;38;3;0;0;0;38;0;1;6;22;9;3
8385.0;2021;25;VERSAILLES;MASCULIN;SCOLAIRE;BAC PROFESSIONNEL;BAC PRO SERV;BAC PRO 33003 ACC.SOINS-S.PERS. OPT.A DOMICILE;6;6;6;0;0;0;0;6;0;1;1;1;3;0
8387.0;2021;25;VERSAILLES;MASCULIN;SCOLAIRE;BAC PROFESSIONNEL;BAC PRO SERV;BAC PRO 33101 OPTIQUE LUNETTERIE;22;22;18;4;0;0;0;18;0;1;3;5;9;4
8391.0;2021;25;VERSAILLES;MASCULIN;SCOLAIRE;BAC PROFESSIONNEL;BAC PRO SERV;BAC PRO 34403 METIERS DE LA SECURITE;180;180;155;15;10;5;5;160;0;8;37;73;42;20
8392.0;2021;25;VERSAILLES;MASCULIN;SCOLAIRE;BAC PROFESSIONNEL;BAC PRO SERV;BAC PRO AG 33002 SERV PERS TERRIT;12;11;10;1;0;0;0;10;0;0;1;5;4;1
8393.0;2021;25;VERSAILLES;MASCULIN;SCOLAIRE;BAC TECHNOLOGIQUE;BAC S2TMD;BAC S2TMD MUSIQUE;3;3;3;0;0;0;0;3;0;0;2;0;1;0
8404.0;2021;25;VERSAILLES;MASCULIN;SCOLAIRE;BAC TECHNOLOGIQUE;BAC STMG;BAC STMG GESTION ET FINANCE;995;993;843;44;106;78;28;921;0;10;108;333;470;72
8412.0;2022;02;AIX-MARSEILLE;FEMININ;APPRENTISSAGE;BAC PROFESSIONNEL;BAC PRO PROD;BAC PRO 25214 MAINT.VEHIC.OPTA VOIT.PARTICUL.;4;4;3;1;0;0;0;3;0;1;0;1;1;1
8417.0;2022;02;AIX-MARSEILLE;FEMININ;APPRENTISSAGE;BAC PROFESSIONNEL;BAC PRO PROD;BAC PRO AG 21004 CGEA;1;1;0;1;0;0;0;0;0;0;0;0;0;1
8420.0;2022;02;AIX-MARSEILLE;FEMININ;APPRENTISSAGE;BAC PROFESSIONNEL;BAC PRO PROD;BAC PRO AG 21203 TECHN CONSEIL DE VENTE ANIMAL;3;2;2;0;0;0;0;2;0;0;0;0;2;0
8422.0;2022;02;AIX-MARSEILLE;FEMININ;APPRENTISSAGE;BAC PROFESSIONNEL;BAC PRO PROD;BAC PRO AG 21211 COND GEST ENTR HIPPIQUE;27;26;20;6;0;0;0;20;0;1;2;6;11;6
8428.0;2022;02;AIX-MARSEILLE;FEMININ;APPRENTISSAGE;BAC PROFESSIONNEL;BAC PRO SERV;BAC PRO 31106 LOGISTIQUE;3;2;1;1;0;0;0;1;0;0;1;0;0;1
8430.0;2022;02;AIX-MARSEILLE;FEMININ;APPRENTISSAGE;BAC PROFESSIONNEL;BAC PRO SERV;BAC PRO 31213 MET.COM.VEN.OP.A ANI.GES.ESP.COM.;79;71;60;8;3;1;2;61;0;1;13;33;14;10
8435.0;2022;02;AIX-MARSEILLE;FEMININ;APPRENTISSAGE;BAC PROFESSIONNEL;BAC PRO SERV;BAC PRO 33403 COMMERC. SERVICES EN RESTAURATION;13;12;9;3;0;0;0;9;0;0;1;5;3;3
8438.0;2022;02;AIX-MARSEILLE;FEMININ;APPRENTISSAGE;BAC PROFESSIONNEL;BAC PRO SERV;BAC PRO AG 33002 SERV PERS TERRIT;8;6;6;0;0;0;0;6;0;0;1;2;3;0
8439.0;2022;02;AIX-MARSEILLE;FEMININ;ENSEIGNEMENT A DISTANCE;BAC GENERAL;BAC GENERAL;BAC GENE 10019 BAC GENERAL;71;65;54;7;4;2;2;56;0;6;11;18;21;9
8442.0;2022;02;AIX-MARSEILLE;FEMININ;ENSEIGNEMENT A DISTANCE;BAC PROFESSIONNEL;BAC PRO SERV;BAC PRO 31214 MET.COM.VEN.OP.B PR.CL.VA.OF.COM.;1;0;0;0;0;0;0;0;0;0;0;0;0;0
8443.0;2022;02;AIX-MARSEILLE;FEMININ;ENSEIGNEMENT A DISTANCE;BAC PROFESSIONNEL;BAC PRO SERV;BAC PRO 33004 ACC.SOINS-S.PERS. OPT.EN STRUCTUR;3;3;1;1;1;1;0;2;0;0;0;0;2;1
8445.0;2022;02;AIX-MARSEILLE;FEMININ;ENSEIGNEMENT A DISTANCE;BAC TECHNOLOGIQUE;BAC STMG;BAC STMG GESTION ET FINANCE;2;2;1;0;1;0;1;1;0;0;0;1;0;1
8451.0;2022;02;AIX-MARSEILLE;FEMININ;FORMATION CONTINUE;BAC PROFESSIONNEL;BAC PRO PROD;BAC PRO 22705 TECHNICIEN GAZ;1;1;1;0;0;0;0;1;0;0;1;0;0;0
8457.0;2022;02;AIX-MARSEILLE;FEMININ;FORMATION CONTINUE;BAC PROFESSIONNEL;BAC PRO SERV;BAC PRO 32304 PHOTOGRAPHIE;3;3;3;0;0;0;0;3;0;0;2;1;0;0
8460.0;2022;02;AIX-MARSEILLE;FEMININ;INDIVIDUEL;BAC GENERAL;BAC GENERAL;BAC GENE 10019 BAC GENERAL;144;101;51;32;18;8;10;59;1;4;9;18;27;42
8471.0;2022;02;AIX-MARSEILLE;FEMININ;INDIVIDUEL;BAC PROFESSIONNEL;BAC PRO SERV;BAC PRO 33403 COMMERC. SERVICES EN RESTAURATION;1;1;1;0;0;0;0;1;0;0;0;1;0;0
8473.0;2022;02;AIX-MARSEILLE;FEMININ;INDIVIDUEL;BAC TECHNOLOGIQUE;BAC ST2S;BAC ST2S SCIENCES & TECHNO. SANTE & SOCIAL;16;6;1;0;5;2;3;3;0;0;0;1;2;3
8475.0;2022;02;AIX-MARSEILLE;FEMININ;INDIVIDUEL;BAC TECHNOLOGIQUE;BAC STHR;BAC STHR SC.&TEC. HOTELLERIE-RESTAURATION;8;7;5;0;2;1;1;6;0;0;1;3;2;1
8477.0;2022;02;AIX-MARSEILLE;FEMININ;INDIVIDUEL;BAC TECHNOLOGIQUE;BAC STMG;BAC STMG GESTION ET FINANCE;7;1;0;1;0;0;0;0;0;0;0;0;0;1
8478.0;2022;02;AIX-MARSEILLE;FEMININ;INDIVIDUEL;BAC TECHNOLOGIQUE;BAC STMG;BAC STMG MERCATIQUE (MARKETING);17;12;7;4;1;0;1;7;0;0;1;5;1;5
8480.0;2022;02;AIX-MARSEILLE;FEMININ;INDIVIDUEL;BAC TECHNOLOGIQUE;BAC STMG;BAC STMG SYSTEMES D'INFORMATION DE GESTION;1;0;0;0;0;0;0;0;0;0;0;0;0;0
8483.0;2022;02;AIX-MARSEILLE;FEMININ;SCOLAIRE;BAC PROFESSIONNEL;BAC PRO PROD;BAC PRO 20102 PILOTE DE LIGNE DE PRODUCTION;1;1;1;0;0;0;0;1;0;0;0;0;1;0
8489.0;2022;02;AIX-MARSEILLE;FEMININ;SCOLAIRE;BAC PROFESSIONNEL;BAC PRO PROD;BAC PRO 22503 PLASTIQUES ET COMPOSITES;1;1;0;1;0;0;0;0;0;0;0;0;0;1
8494.0;2022;02;AIX-MARSEILLE;FEMININ;SCOLAIRE;BAC PROFESSIONNEL;BAC PRO PROD;BAC PRO 23304 AMENAGEMENT FINITION BATIMENT;6;6;4;2;0;0;0;4;0;0;0;3;1;2
8495.0;2022;02;AIX-MARSEILLE;FEMININ;SCOLAIRE;BAC PROFESSIONNEL;BAC PRO PROD;BAC PRO 23404 TECHNICIEN CONSTRUCTEUR BOIS;2;2;1;1;0;0;0;1;0;0;0;1;0;1
8498.0;2022;02;AIX-MARSEILLE;FEMININ;SCOLAIRE;BAC PROFESSIONNEL;BAC PRO PROD;BAC PRO 24203 METIERS DE LA MODE - VÊTEMENT;81;81;74;5;2;1;1;75;0;14;17;23;21;6
8507.0;2022;02;AIX-MARSEILLE;FEMININ;SCOLAIRE;BAC PROFESSIONNEL;BAC PRO PROD;BAC PRO 25411 TECH.CHAUDRONNERIE INDUSTRIELLE;1;1;0;0;1;0;1;0;0;0;0;0;0;1
8511.0;2022;02;AIX-MARSEILLE;FEMININ;SCOLAIRE;BAC PROFESSIONNEL;BAC PRO PROD;BAC PRO 25515 SYST.NUM.OPT.C RES.INF.SYST.COMM.;6;6;5;1;0;0;0;5;0;0;1;0;4;1
8513.0;2022;02;AIX-MARSEILLE;FEMININ;SCOLAIRE;BAC PROFESSIONNEL;BAC PRO PROD;BAC PRO AG 21004 CGEA;24;23;18;5;0;0;0;18;0;0;2;6;10;5
8514.0;2022;02;AIX-MARSEILLE;FEMININ;SCOLAIRE;BAC PROFESSIONNEL;BAC PRO PROD;BAC PRO AG 21113 CGEVV;5;4;3;1;0;0;0;3;0;0;0;2;1;1
8516.0;2022;02;AIX-MARSEILLE;FEMININ;SCOLAIRE;BAC PROFESSIONNEL;BAC PRO PROD;BAC PRO AG 21203 TECHN CONSEIL DE VENTE ANIMAL;24;24;21;3;0;0;0;21;0;0;0;6;15;3
8527.0;2022;02;AIX-MARSEILLE;FEMININ;SCOLAIRE;BAC PROFESSIONNEL;BAC PRO SERV;BAC PRO 31107 CONDUCT. TRANSP.ROUT.MARCHANDISES;4;4;3;1;0;0;0;3;0;0;1;2;0;1
8530.0;2022;02;AIX-MARSEILLE;FEMININ;SCOLAIRE;BAC PROFESSIONNEL;BAC PRO SERV;BAC PRO 31213 MET.COM.VEN.OP.A ANI.GES.ESP.COM.;320;320;266;38;16;12;4;278;0;8;51;111;108;42
8537.0;2022;02;AIX-MARSEILLE;FEMININ;SCOLAIRE;BAC PROFESSIONNEL;BAC PRO SERV;BAC PRO 33003 ACC.SOINS-S.PERS. OPT.A DOMICILE;120;120;90;27;3;2;1;92;0;2;21;35;34;28
8547.0;2022;02;AIX-MARSEILLE;FEMININ;SCOLAIRE;BAC TECHNOLOGIQUE;BAC S2TMD;BAC S2TMD MUSIQUE;1;1;1;0;0;0;0;1;0;0;1;0;0;0
8548.0;2022;02;AIX-MARSEILLE;FEMININ;SCOLAIRE;BAC TECHNOLOGIQUE;BAC ST2S;BAC ST2S SCIENCES & TECHNO. SANTE & SOCIAL;766;766;618;28;120;55;65;673;1;14;94;228;336;93
8552.0;2022;02;AIX-MARSEILLE;FEMININ;SCOLAIRE;BAC TECHNOLOGIQUE;BAC STI2D;BAC STI2D ARCHITECTURE ET CONSTRUCTION;22;22;19;0;3;3;0;22;0;0;2;11;9;0
8554.0;2022;02;AIX-MARSEILLE;FEMININ;SCOLAIRE;BAC TECHNOLOGIQUE;BAC STI2D;BAC STI2D INNOVATION TECHNO.  ET ECO CONCEPTION;25;25;19;1;5;4;1;23;0;1;2;9;11;2
8555.0;2022;02;AIX-MARSEILLE;FEMININ;SCOLAIRE;BAC TECHNOLOGIQUE;BAC STI2D;BAC STI2D SYSTÈME D'INFORMATION  ET NUMERIQUE;16;16;15;1;0;0;0;15;0;0;1;6;8;1
8558.0;2022;02;AIX-MARSEILLE;FEMININ;SCOLAIRE;BAC TECHNOLOGIQUE;BAC STMG;BAC STMG GESTION ET FINANCE;310;310;253;11;46;29;17;282;0;7;50;110;115;28
8559.0;2022;02;AIX-MARSEILLE;FEMININ;SCOLAIRE;BAC TECHNOLOGIQUE;BAC STMG;BAC STMG MERCATIQUE (MARKETING);802;802;669;21;112;72;40;741;0;17;115;260;349;61
8563.0;2022;02;AIX-MARSEILLE;MASCULIN;APPRENTISSAGE;BAC PROFESSIONNEL;BAC PRO PROD;BAC PRO 22104 BOUCHER CHARCUTIER TRAITEUR;7;6;2;3;1;1;0;3;0;0;0;1;2;3
8564.0;2022;02;AIX-MARSEILLE;MASCULIN;APPRENTISSAGE;BAC PROFESSIONNEL;BAC PRO PROD;BAC PRO 22105 BOULANGER-PÂTISSIER;2;1;0;1;0;0;0;0;0;0;0;0;0;1
8570.0;2022;02;AIX-MARSEILLE;MASCULIN;APPRENTISSAGE;BAC PROFESSIONNEL;BAC PRO PROD;BAC PRO 23203 TECHNICIEN BAT. : ORG.REAL.GROS O;3;3;3;0;0;0;0;3;0;0;1;1;1;0
8572.0;2022;02;AIX-MARSEILLE;MASCULIN;APPRENTISSAGE;BAC PROFESSIONNEL;BAC PRO PROD;BAC PRO 23404 TECHNICIEN CONSTRUCTEUR BOIS;3;3;3;0;0;0;0;3;0;0;0;1;2;0
8573.0;2022;02;AIX-MARSEILLE;MASCULIN;APPRENTISSAGE;BAC PROFESSIONNEL;BAC PRO PROD;BAC PRO 23405 TECHNICIEN MENUISIER AGENCEUR;2;2;2;0;0;0;0;2;0;0;1;1;0;0
8576.0;2022;02;AIX-MARSEILLE;MASCULIN;APPRENTISSAGE;BAC PROFESSIONNEL;BAC PRO PROD;BAC PRO 25009 MAINTENANCE NAUTIQUE;1;1;0;0;1;1;0;1;0;0;0;0;1;0
8578.0;2022;02;AIX-MARSEILLE;MASCULIN;APPRENTISSAGE;BAC PROFESSIONNEL;BAC PRO PROD;BAC PRO 25214 MAINT.VEHIC.OPTA VOIT.PARTICUL.;123;120;93;21;6;3;3;96;0;6;21;37;32;24
8580.0;2022;02;AIX-MARSEILLE;MASCULIN;APPRENTISSAGE;BAC PROFESSIONNEL;BAC PRO PROD;BAC PRO 25216 MAINT.VEHIC.OPTC MOTOCYCLES;17;16;13;2;1;1;0;14;0;0;4;6;4;2
8584.0;2022;02;AIX-MARSEILLE;MASCULIN;APPRENTISSAGE;BAC PROFESSIONNEL;BAC PRO PROD;BAC PRO 25406 OUVRAGES DU BATIMENT METALLERIE;3;3;3;0;0;0;0;3;0;0;0;1;2;0
8593.0;2022;02;AIX-MARSEILLE;MASCULIN;APPRENTISSAGE;BAC PROFESSIONNEL;BAC PRO PROD;BAC PRO AG 21203 TECHN CONSEIL DE VENTE ANIMAL;3;3;3;0;0;0;0;3;0;1;0;2;0;0
8596.0;2022;02;AIX-MARSEILLE;MASCULIN;APPRENTISSAGE;BAC PROFESSIONNEL;BAC PRO PROD;BAC PRO AG 21303 FORET;2;2;1;1;0;0;0;1;0;0;0;0;1;1
8599.0;2022;02;AIX-MARSEILLE;MASCULIN;APPRENTISSAGE;BAC PROFESSIONNEL;BAC PRO SERV;BAC PRO 30001 GESTION-ADMINISTRATION;4;4;4;0;0;0;0;4;0;0;1;2;1;0
8616.0;2022;02;AIX-MARSEILLE;MASCULIN;ENSEIGNEMENT A DISTANCE;BAC TECHNOLOGIQUE;BAC STMG;BAC STMG GESTION ET FINANCE;1;1;0;1;0;0;0;0;0;0;0;0;0;1
8620.0;2022;02;AIX-MARSEILLE;MASCULIN;FORMATION CONTINUE;BAC PROFESSIONNEL;BAC PRO PROD;BAC PRO 22106 CUISINE;3;2;1;1;0;0;0;1;0;0;0;1;0;1
8629.0;2022;02;AIX-MARSEILLE;MASCULIN;FORMATION CONTINUE;BAC PROFESSIONNEL;BAC PRO SERV;BAC PRO 31213 MET.COM.VEN.OP.A ANI.GES.ESP.COM.;9;5;3;1;1;0;1;3;0;0;0;2;1;2
8631.0;2022;02;AIX-MARSEILLE;MASCULIN;INDIVIDUEL;BAC GENERAL;BAC GENERAL;BAC GENE 10019 BAC GENERAL;119;81;39;28;14;11;3;50;0;0;6;9;35;31
8633.0;2022;02;AIX-MARSEILLE;MASCULIN;INDIVIDUEL;BAC PROFESSIONNEL;BAC PRO PROD;BAC PRO 25007 MAINTENANCE EQUIPEMENTS INDUST.;1;0;0;0;0;0;0;0;0;0;0;0;0;0
8641.0;2022;02;AIX-MARSEILLE;MASCULIN;INDIVIDUEL;BAC PROFESSIONNEL;BAC PRO PROD;BAC PRO AG 21114 CONDUITE PRODUCTIONS HORTICOLES;6;3;3;0;0;0;0;3;0;0;0;0;3;0
8648.0;2022;02;AIX-MARSEILLE;MASCULIN;INDIVIDUEL;BAC PROFESSIONNEL;BAC PRO SERV;BAC PRO 31214 MET.COM.VEN.OP.B PR.CL.VA.OF.COM.;3;1;1;0;0;0;0;1;0;0;0;0;1;0
8664.0;2022;02;AIX-MARSEILLE;MASCULIN;INDIVIDUEL;BAC TECHNOLOGIQUE;BAC STMG;BAC STMG SYSTEMES D'INFORMATION DE GESTION;1;1;0;0;1;1;0;1;0;0;0;0;1;0
8669.0;2022;02;AIX-MARSEILLE;MASCULIN;SCOLAIRE;BAC PROFESSIONNEL;BAC PRO PROD;BAC PRO 22004 PROC. CHIMIE EAU PAPIERS-CARTONS;31;31;25;5;1;1;0;26;0;1;4;8;13;5
8671.0;2022;02;AIX-MARSEILLE;MASCULIN;SCOLAIRE;BAC PROFESSIONNEL;BAC PRO PROD;BAC PRO 22106 CUISINE;89;89;80;9;0;0;0;80;0;3;22;34;21;9
8674.0;2022;02;AIX-MARSEILLE;MASCULIN;SCOLAIRE;BAC PROFESSIONNEL;BAC PRO PROD;BAC PRO 22703 TECHN.INSTALL.SYST.ENERG.CLIMATI;50;50;33;14;3;2;1;35;0;0;5;10;20;15
8678.0;2022;02;AIX-MARSEILLE;MASCULIN;SCOLAIRE;BAC PROFESSIONNEL;BAC PRO PROD;BAC PRO 23102 TRAVAUX PUBLICS;16;16;12;2;2;1;1;13;0;0;1;4;8;3
8679.0;2022;02;AIX-MARSEILLE;MASCULIN;SCOLAIRE;BAC PROFESSIONNEL;BAC PRO PROD;BACPRO 23103 TECHNICIEN GEOMETRE-TOPOGRAPHE;22;22;13;8;1;1;0;14;0;0;2;3;9;8
8681.0;2022;02;AIX-MARSEILLE;MASCULIN;SCOLAIRE;BAC PROFESSIONNEL;BAC PRO PROD;BAC PRO 23205 INTERV. SUR PATRIMOINE BATI OPT.A;3;3;2;1;0;0;0;2;0;0;0;1;1;1
8691.0;2022;02;AIX-MARSEILLE;MASCULIN;SCOLAIRE;BAC PROFESSIONNEL;BAC PRO PROD;BAC PRO 25106 TECHNICIEN D'USINAGE;38;38;30;4;4;4;0;34;0;3;6;9;16;4
8702.0;2022;02;AIX-MARSEILLE;MASCULIN;SCOLAIRE;BAC PROFESSIONNEL;BAC PRO PROD;BAC PRO 25406 OUVRAGES DU BATIMENT METALLERIE;23;22;15;6;1;1;0;16;0;1;0;6;9;6
8708.0;2022;02;AIX-MARSEILLE;MASCULIN;SCOLAIRE;BAC PROFESSIONNEL;BAC PRO PROD;BAC PRO 25514 SYST.NUM.OPT.B AUD.RES.EQUIP.DOM.;120;120;101;14;5;4;1;105;0;5;26;44;30;15
8712.0;2022;02;AIX-MARSEILLE;MASCULIN;SCOLAIRE;BAC PROFESSIONNEL;BAC PRO PROD;BAC PRO AG 21113 CGEVV;24;23;21;2;0;0;0;21;0;0;1;8;12;2
8713.0;2022;02;AIX-MARSEILLE;MASCULIN;SCOLAIRE;BAC PROFESSIONNEL;BAC PRO PROD;BAC PRO AG 21114 CONDUITE PRODUCTIONS HORTICOLES;16;16;14;2;0;0;0;14;0;0;0;6;8;2
8718.0;2022;02;AIX-MARSEILLE;MASCULIN;SCOLAIRE;BAC PROFESSIONNEL;BAC PRO PROD;BAC PRO AG 21405 AMENAGEMENTS PAYSAGERS;60;59;57;2;0;0;0;57;0;0;8;20;29;2
8723.0;2022;02;AIX-MARSEILLE;MASCULIN;SCOLAIRE;BAC PROFESSIONNEL;BAC PRO SERV;BAC PRO 31106 LOGISTIQUE;59;59;43;14;2;0;2;43;0;0;11;18;14;16
8729.0;2022;02;AIX-MARSEILLE;MASCULIN;SCOLAIRE;BAC PROFESSIONNEL;BAC PRO SERV;BAC PRO 32207 REAL.PR.IMPR.PLURI.OPTA.PR.GRAPH.;18;18;12;6;0;0;0;12;0;0;5;3;4;6
8730.0;2022;02;AIX-MARSEILLE;MASCULIN;SCOLAIRE;BAC PROFESSIONNEL;BAC PRO SERV;BAC PRO 32208 REAL.PR.IMPR.PLURI.OPTB.PR.IMPR.;19;19;14;3;2;1;1;15;0;2;4;7;2;4
8737.0;2022;02;AIX-MARSEILLE;MASCULIN;SCOLAIRE;BAC PROFESSIONNEL;BAC PRO SERV;BAC PRO 33102 PROTHESE DENTAIRE;6;6;4;2;0;0;0;4;0;0;2;2;0;2
8744.0;2022;02;AIX-MARSEILLE;MASCULIN;SCOLAIRE;BAC TECHNOLOGIQUE;BAC ST2S;BAC ST2S SCIENCES & TECHNO. SANTE & SOCIAL;171;171;130;9;32;21;11;151;0;1;13;50;87;20
8748.0;2022;02;AIX-MARSEILLE;MASCULIN;SCOLAIRE;BAC TECHNOLOGIQUE;BAC STI2D;BAC STI2D ARCHITECTURE ET CONSTRUCTION;122;122;100;3;19;9;10;109;0;1;8;41;59;13
8757.0;2022;02;AIX-MARSEILLE;MASCULIN;SCOLAIRE;BAC TECHNOLOGIQUE;BAC STMG;BAC STMG SYSTEMES D'INFORMATION DE GESTION;47;47;26;5;16;9;7;35;0;0;2;7;26;12
8759.0;2022;20;AMIENS;FEMININ;APPRENTISSAGE;BAC PROFESSIONNEL;BAC PRO PROD;BAC PRO 22106 CUISINE;4;4;2;2;0;0;0;2;0;0;1;1;0;2
8764.0;2022;20;AMIENS;FEMININ;APPRENTISSAGE;BAC PROFESSIONNEL;BAC PRO PROD;BAC PRO 25304 AERONAUTIQUE OPTION STRUCTURE;1;1;1;0;0;0;0;1;0;0;0;1;0;0
8765.0;2022;20;AMIENS;FEMININ;APPRENTISSAGE;BAC PROFESSIONNEL;BAC PRO PROD;BAC PRO 25408 REPARATION DES CARROSSERIES;1;1;1;0;0;0;0;1;0;0;0;1;0;0
8774.0;2022;20;AMIENS;FEMININ;APPRENTISSAGE;BAC PROFESSIONNEL;BAC PRO SERV;BAC PRO 31106 LOGISTIQUE;9;8;5;3;0;0;0;5;0;2;1;1;1;3
8778.0;2022;20;AMIENS;FEMININ;APPRENTISSAGE;BAC PROFESSIONNEL;BAC PRO SERV;BAC PRO AG 33002 SERV PERS TERRIT;13;13;13;0;0;0;0;13;0;1;0;6;6;0
8782.0;2022;20;AMIENS;FEMININ;ENSEIGNEMENT A DISTANCE;BAC TECHNOLOGIQUE;BAC STMG;BAC STMG RESSOURCES HUMAINES ET COMMUNICATION;3;2;2;0;0;0;0;2;0;0;0;0;2;0
8786.0;2022;20;AMIENS;FEMININ;INDIVIDUEL;BAC PROFESSIONNEL;BAC PRO PROD;BAC PRO AG 21004 CGEA;5;4;2;2;0;0;0;2;0;0;0;0;2;2
8787.0;2022;20;AMIENS;FEMININ;INDIVIDUEL;BAC PROFESSIONNEL;BAC PRO PROD;BAC PRO AG 21113 CGEVV;1;0;0;0;0;0;0;0;0;0;0;0;0;0
8790.0;2022;20;AMIENS;FEMININ;INDIVIDUEL;BAC PROFESSIONNEL;BAC PRO PROD;BAC PRO AG 21302 GEST MILIEUX NATURELS FAUNE;1;1;1;0;0;0;0;1;0;0;0;0;1;0
8794.0;2022;20;AMIENS;FEMININ;INDIVIDUEL;BAC PROFESSIONNEL;BAC PRO SERV;BAC PRO 31214 MET.COM.VEN.OP.B PR.CL.VA.OF.COM.;3;2;1;1;0;0;0;1;0;0;0;0;1;1
8809.0;2022;20;AMIENS;FEMININ;SCOLAIRE;BAC PROFESSIONNEL;BAC PRO PROD;BAC PRO 22105 BOULANGER-PÂTISSIER;9;9;8;1;0;0;0;8;0;0;3;4;1;1
8822.0;2022;20;AMIENS;FEMININ;SCOLAIRE;BAC PROFESSIONNEL;BAC PRO PROD;BAC PRO 25009 MAINTENANCE NAUTIQUE;1;1;1;0;0;0;0;1;0;0;0;1;0;0
8824.0;2022;20;AMIENS;FEMININ;SCOLAIRE;BAC PROFESSIONNEL;BAC PRO PROD;BAC PRO 25108 TECHNICIEN MODELEUR;3;3;2;1;0;0;0;2;0;1;1;0;0;1
8825.0;2022;20;AMIENS;FEMININ;SCOLAIRE;BAC PROFESSIONNEL;BAC PRO PROD;BAC PRO 25214 MAINT.VEHIC.OPTA VOIT.PARTICUL.;6;6;5;1;0;0;0;5;0;0;1;0;4;1
8834.0;2022;20;AMIENS;FEMININ;SCOLAIRE;BAC PROFESSIONNEL;BAC PRO PROD;BAC PRO AG 21113 CGEVV;3;3;3;0;0;0;0;3;0;0;0;0;3;0
8846.0;2022;20;AMIENS;FEMININ;SCOLAIRE;BAC PROFESSIONNEL;BAC PRO SERV;BAC PRO 31212 METIERS DE L'ACCUEIL;175;174;143;23;8;5;3;148;0;14;39;56;39;26
8849.0;2022;20;AMIENS;FEMININ;SCOLAIRE;BAC PROFESSIONNEL;BAC PRO SERV;BAC PRO 32207 REAL.PR.IMPR.PLURI.OPTA.PR.GRAPH.;6;6;5;1;0;0;0;5;0;1;0;3;1;1
8852.0;2022;20;AMIENS;FEMININ;SCOLAIRE;BAC PROFESSIONNEL;BAC PRO SERV;BAC PRO 33003 ACC.SOINS-S.PERS. OPT.A DOMICILE;171;171;144;22;5;2;3;146;0;3;43;70;30;25
8854.0;2022;20;AMIENS;FEMININ;SCOLAIRE;BAC PROFESSIONNEL;BAC PRO SERV;BAC PRO 33101 OPTIQUE LUNETTERIE;19;19;12;5;2;1;1;13;0;0;4;5;4;6
8857.0;2022;20;AMIENS;FEMININ;SCOLAIRE;BAC PROFESSIONNEL;BAC PRO SERV;BAC PRO 34304 HYGIENE PROPRETE STERILISATION;20;20;13;4;3;0;3;13;0;1;1;5;6;7
8859.0;2022;20;AMIENS;FEMININ;SCOLAIRE;BAC PROFESSIONNEL;BAC PRO SERV;BAC PRO AG 33002 SERV PERS TERRIT;146;144;130;14;0;0;0;130;0;1;16;44;69;14
8863.0;2022;20;AMIENS;FEMININ;SCOLAIRE;BAC TECHNOLOGIQUE;BAC STHR;BAC STHR SC.&TEC. HOTELLERIE-RESTAURATION;22;22;21;0;1;1;0;22;0;0;5;11;6;0
8868.0;2022;20;AMIENS;FEMININ;SCOLAIRE;BAC TECHNOLOGIQUE;BAC STL;BAC STL BIOCHIM.-BIOLOGIE-BIOTECHNOL.;54;54;44;5;5;2;3;46;0;1;11;19;15;8
8882.0;2022;20;AMIENS;MASCULIN;APPRENTISSAGE;BAC PROFESSIONNEL;BAC PRO PROD;BAC PRO 23208 METIERS ET ARTS DE LA PIERRE;3;3;3;0;0;0;0;3;0;0;1;1;1;0
8893.0;2022;20;AMIENS;MASCULIN;APPRENTISSAGE;BAC PROFESSIONNEL;BAC PRO PROD;BAC PRO 25221 MAINT.MATERIELS OPT.C ESP. VERTS;4;4;3;1;0;0;0;3;0;0;2;0;1;1
8895.0;2022;20;AMIENS;MASCULIN;APPRENTISSAGE;BAC PROFESSIONNEL;BAC PRO PROD;BAC PRO 25406 OUVRAGES DU BATIMENT METALLERIE;4;4;3;1;0;0;0;3;0;0;0;2;1;1
8899.0;2022;20;AMIENS;MASCULIN;APPRENTISSAGE;BAC PROFESSIONNEL;BAC PRO PROD;BAC PRO 25510 METIERS ELECT. ENVIRON. CONNECTES;72;71;62;3;6;4;2;66;0;9;15;21;21;5
8903.0;2022;20;AMIENS;MASCULIN;APPRENTISSAGE;BAC PROFESSIONNEL;BAC PRO PROD;BAC PRO AG 21211 COND GEST ENTR HIPPIQUE;8;8;2;6;0;0;0;2;0;0;0;0;2;6
8908.0;2022;20;AMIENS;MASCULIN;APPRENTISSAGE;BAC PROFESSIONNEL;BAC PRO SERV;BAC PRO 31214 MET.COM.VEN.OP.B PR.CL.VA.OF.COM.;1;1;0;1;0;0;0;0;0;0;0;0;0;1
8917.0;2022;20;AMIENS;MASCULIN;FORMATION CONTINUE;BAC PROFESSIONNEL;BAC PRO PROD;BAC PRO 22704 TECHN. MAINT. SYST.ENERG.CLIMATI;1;1;1;0;0;0;0;1;0;0;0;0;1;0
8921.0;2022;20;AMIENS;MASCULIN;FORMATION CONTINUE;BAC PROFESSIONNEL;BAC PRO PROD;BAC PRO 25509 TECHNIC. FROID CONDITIONNEMT AIR;11;9;9;0;0;0;0;9;0;1;4;3;1;0
8924.0;2022;20;AMIENS;MASCULIN;INDIVIDUEL;BAC PROFESSIONNEL;BAC PRO PROD;BAC PRO 22106 CUISINE;1;1;1;0;0;0;0;1;0;0;0;0;1;0
8928.0;2022;20;AMIENS;MASCULIN;INDIVIDUEL;BAC PROFESSIONNEL;BAC PRO PROD;BAC PRO 25220 MAINT.MATERIELS OPT.B TP MANUT.;2;1;1;0;0;0;0;1;0;0;0;0;1;0
8937.0;2022;20;AMIENS;MASCULIN;INDIVIDUEL;BAC TECHNOLOGIQUE;BAC ST2S;BAC ST2S SCIENCES & TECHNO. SANTE & SOCIAL;5;2;1;0;1;1;0;2;0;0;0;1;1;0
8941.0;2022;20;AMIENS;MASCULIN;INDIVIDUEL;BAC TECHNOLOGIQUE;BAC STL;BAC STL SCIENCES PHYSIQUES CHIMIQUES  EN LABORAT.;1;0;0;0;0;0;0;0;0;0;0;0;0;0
8943.0;2022;20;AMIENS;MASCULIN;INDIVIDUEL;BAC TECHNOLOGIQUE;BAC STMG;BAC STMG MERCATIQUE (MARKETING);5;3;3;0;0;0;0;3;0;0;0;0;3;0
8948.0;2022;20;AMIENS;MASCULIN;SCOLAIRE;BAC PROFESSIONNEL;BAC PRO PROD;BAC PRO 22003 BIO-INDUSTRIES DE TRANSFORMATION;13;13;9;4;0;0;0;9;0;0;2;6;1;4
8951.0;2022;20;AMIENS;MASCULIN;SCOLAIRE;BAC PROFESSIONNEL;BAC PRO PROD;BAC PRO 22105 BOULANGER-PÂTISSIER;11;11;10;1;0;0;0;10;0;1;1;5;3;1
8966.0;2022;20;AMIENS;MASCULIN;SCOLAIRE;BAC PROFESSIONNEL;BAC PRO PROD;BAC PRO 23405 TECHNICIEN MENUISIER AGENCEUR;39;39;28;10;1;1;0;29;0;0;6;17;6;10
8980.0;2022;20;AMIENS;MASCULIN;SCOLAIRE;BAC PROFESSIONNEL;BAC PRO PROD;BAC PRO 25220 MAINT.MATERIELS OPT.B TP MANUT.;17;17;13;3;1;1;0;14;0;2;3;4;5;3
8983.0;2022;20;AMIENS;MASCULIN;SCOLAIRE;BAC PROFESSIONNEL;BAC PRO PROD;BAC PRO 25406 OUVRAGES DU BATIMENT METALLERIE;12;10;10;0;0;0;0;10;0;1;3;3;3;0
8988.0;2022;20;AMIENS;MASCULIN;SCOLAIRE;BAC PROFESSIONNEL;BAC PRO PROD;BAC PRO 25513 SYST.NUM.OPT.A SURETE SECURITE;73;73;65;8;0;0;0;65;0;3;19;26;17;8
8992.0;2022;20;AMIENS;MASCULIN;SCOLAIRE;BAC PROFESSIONNEL;BAC PRO PROD;BAC PRO AG 21004 CGEA;75;75;59;16;0;0;0;59;0;1;10;19;29;16
8996.0;2022;20;AMIENS;MASCULIN;SCOLAIRE;BAC PROFESSIONNEL;BAC PRO PROD;BAC PRO AG 21204 PROD-AQUACOLES;6;5;4;1;0;0;0;4;0;0;0;0;4;1
8999.0;2022;20;AMIENS;MASCULIN;SCOLAIRE;BAC PROFESSIONNEL;BAC PRO PROD;BAC PRO AG 21405 AMENAGEMENTS PAYSAGERS;40;38;35;3;0;0;0;35;0;1;4;6;24;3
9000.0;2022;20;AMIENS;MASCULIN;SCOLAIRE;BAC PROFESSIONNEL;BAC PRO PROD;BAC PRO AG 22105 LABORATOIRE CONTROLE QUALITE;2;2;2;0;0;0;0;2;0;0;1;1;0;0
9003.0;2022;20;AMIENS;MASCULIN;SCOLAIRE;BAC PROFESSIONNEL;BAC PRO SERV;BAC PRO 31106 LOGISTIQUE;92;92;62;25;5;4;1;66;0;1;14;24;27;26
9007.0;2022;20;AMIENS;MASCULIN;SCOLAIRE;BAC PROFESSIONNEL;BAC PRO SERV;BAC PRO 31213 MET.COM.VEN.OP.A ANI.GES.ESP.COM.;314;312;207;92;13;10;3;217;0;11;35;74;97;95
9014.0;2022;20;AMIENS;MASCULIN;SCOLAIRE;BAC PROFESSIONNEL;BAC PRO SERV;BAC PRO 33101 OPTIQUE LUNETTERIE;8;8;6;2;0;0;0;6;0;0;0;4;2;2
9018.0;2022;20;AMIENS;MASCULIN;SCOLAIRE;BAC PROFESSIONNEL;BAC PRO SERV;BAC PRO 34403 METIERS DE LA SECURITE;99;99;90;7;2;1;1;91;0;1;22;46;22;8
9021.0;2022;20;AMIENS;MASCULIN;SCOLAIRE;BAC TECHNOLOGIQUE;BAC STAV;BAC STAV AGRONOMIE ALIM ENV TERRITOI;74;73;69;4;0;0;0;69;0;1;5;27;36;4
9029.0;2022;20;AMIENS;MASCULIN;SCOLAIRE;BAC TECHNOLOGIQUE;BAC STL;BAC STL SCIENCES PHYSIQUES CHIMIQUES  EN LABORAT.;67;67;51;3;13;7;6;58;0;0;10;21;27;9
9043.0;2022;03;BESANCON;FEMININ;APPRENTISSAGE;BAC PROFESSIONNEL;BAC PRO PROD;BAC PRO 24302 METIERS DU CUIR : MAROQUINERIE;1;1;0;1;0;0;0;0;0;0;0;0;0;1
9046.0;2022;03;BESANCON;FEMININ;APPRENTISSAGE;BAC PROFESSIONNEL;BAC PRO PROD;BAC PRO 25214 MAINT.VEHIC.OPTA VOIT.PARTICUL.;6;6;6;0;0;0;0;6;0;0;1;3;2;0
9047.0;2022;03;BESANCON;FEMININ;APPRENTISSAGE;BAC PROFESSIONNEL;BAC PRO PROD;BAC PRO AG 21004 CGEA;7;7;6;1;0;0;0;6;0;0;1;2;3;1
9052.0;2022;03;BESANCON;FEMININ;APPRENTISSAGE;BAC PROFESSIONNEL;BAC PRO PROD;BAC PRO AG 21405 AMENAGEMENTS PAYSAGERS;1;1;1;0;0;0;0;1;0;0;0;1;0;0
9058.0;2022;03;BESANCON;FEMININ;APPRENTISSAGE;BAC PROFESSIONNEL;BAC PRO SERV;BAC PRO 31214 MET.COM.VEN.OP.B PR.CL.VA.OF.COM.;1;1;1;0;0;0;0;1;0;0;0;1;0;0
9059.0;2022;03;BESANCON;FEMININ;APPRENTISSAGE;BAC PROFESSIONNEL;BAC PRO SERV;BAC PRO 32303 ART.& MET.ART:COM.VIS.VIS.PLURI-M;1;1;1;0;0;0;0;1;0;0;1;0;0;0
9062.0;2022;03;BESANCON;FEMININ;APPRENTISSAGE;BAC PROFESSIONNEL;BAC PRO SERV;BAC PRO 33102 PROTHESE DENTAIRE;2;2;2;0;0;0;0;2;0;0;0;1;1;0
9073.0;2022;03;BESANCON;FEMININ;ENSEIGNEMENT A DISTANCE;BAC TECHNOLOGIQUE;BAC STMG;BAC STMG RESSOURCES HUMAINES ET COMMUNICATION;1;1;0;0;1;1;0;1;0;0;0;0;1;0
9074.0;2022;03;BESANCON;FEMININ;FORMATION CONTINUE;BAC PROFESSIONNEL;BAC PRO PROD;BAC PRO 25303 AERONAUTIQUE OPTION SYSTEMES;2;2;2;0;0;0;0;2;0;2;0;0;0;0
9076.0;2022;03;BESANCON;FEMININ;INDIVIDUEL;BAC GENERAL;BAC GENERAL;BAC GENE 10019 BAC GENERAL;37;32;25;5;2;1;1;26;0;2;9;8;7;6
9078.0;2022;03;BESANCON;FEMININ;INDIVIDUEL;BAC PROFESSIONNEL;BAC PRO SERV;BAC PRO 30001 GESTION-ADMINISTRATION;4;2;1;0;1;1;0;2;0;0;0;0;2;0
9081.0;2022;03;BESANCON;FEMININ;INDIVIDUEL;BAC TECHNOLOGIQUE;BAC STAV;BAC STAV AGRONOMIE ALIM ENV TERRITOI;1;1;1;0;0;0;0;1;0;0;0;0;1;0
9084.0;2022;03;BESANCON;FEMININ;SCOLAIRE;BAC PROFESSIONNEL;BAC PRO PROD;BAC PRO 22004 PROC. CHIMIE EAU PAPIERS-CARTONS;7;7;7;0;0;0;0;7;0;0;1;3;3;0
9089.0;2022;03;BESANCON;FEMININ;SCOLAIRE;BAC PROFESSIONNEL;BAC PRO PROD;BAC PRO 23405 TECHNICIEN MENUISIER AGENCEUR;2;2;2;0;0;0;0;2;0;0;1;1;0;0
9094.0;2022;03;BESANCON;FEMININ;SCOLAIRE;BAC PROFESSIONNEL;BAC PRO PROD;BAC PRO 25006 MICROTECHNIQUES;4;4;3;1;0;0;0;3;0;0;0;1;2;1
9100.0;2022;03;BESANCON;FEMININ;SCOLAIRE;BAC PROFESSIONNEL;BAC PRO PROD;BAC PRO 25509 TECHNIC. FROID CONDITIONNEMT AIR;1;1;1;0;0;0;0;1;0;0;0;1;0;0
9116.0;2022;03;BESANCON;FEMININ;SCOLAIRE;BAC PROFESSIONNEL;BAC PRO SERV;BAC PRO 31213 MET.COM.VEN.OP.A ANI.GES.ESP.COM.;165;165;136;19;10;9;1;145;0;8;34;56;47;20
9121.0;2022;03;BESANCON;FEMININ;SCOLAIRE;BAC PROFESSIONNEL;BAC PRO SERV;BAC PRO 33101 OPTIQUE LUNETTERIE;15;15;14;1;0;0;0;14;0;2;2;6;4;1
9130.0;2022;03;BESANCON;FEMININ;SCOLAIRE;BAC TECHNOLOGIQUE;BAC STAV;BAC STAV AGRONOMIE ALIM ENV TERRITOI;74;74;73;1;0;0;0;73;0;2;8;38;25;1
9131.0;2022;03;BESANCON;FEMININ;SCOLAIRE;BAC TECHNOLOGIQUE;BAC STD2A;BAC STD2A SCIENCES & TECHNO. DESIGN-ARTS APPLIQUES;46;46;44;0;2;2;0;46;0;2;11;16;17;0
9137.0;2022;03;BESANCON;FEMININ;SCOLAIRE;BAC TECHNOLOGIQUE;BAC STL;BAC STL BIOCHIM.-BIOLOGIE-BIOTECHNOL.;57;57;52;0;5;2;3;54;0;1;12;19;22;3
9138.0;2022;03;BESANCON;FEMININ;SCOLAIRE;BAC TECHNOLOGIQUE;BAC STL;BAC STL SCIENCES PHYSIQUES CHIMIQUES  EN LABORAT.;39;39;36;1;2;2;0;38;0;1;6;10;21;1
9140.0;2022;03;BESANCON;FEMININ;SCOLAIRE;BAC TECHNOLOGIQUE;BAC STMG;BAC STMG MERCATIQUE (MARKETING);266;266;231;5;30;26;4;257;0;3;35;100;119;9
9142.0;2022;03;BESANCON;FEMININ;SCOLAIRE;BAC TECHNOLOGIQUE;BAC STMG;BAC STMG SYSTEMES D'INFORMATION DE GESTION;1;1;1;0;0;0;0;1;0;0;0;1;0;0
9145.0;2022;03;BESANCON;MASCULIN;APPRENTISSAGE;BAC PROFESSIONNEL;BAC PRO PROD;BAC PRO 22106 CUISINE;8;7;5;0;2;2;0;7;0;1;0;1;5;0
9149.0;2022;03;BESANCON;MASCULIN;APPRENTISSAGE;BAC PROFESSIONNEL;BAC PRO PROD;BAC PRO 23005 TECHN. ETUDES BAT B ASSIST.ARCHI.;1;1;1;0;0;0;0;1;0;0;0;1;0;0
9155.0;2022;03;BESANCON;MASCULIN;APPRENTISSAGE;BAC PROFESSIONNEL;BAC PRO PROD;BAC PRO 23405 TECHNICIEN MENUISIER AGENCEUR;11;11;11;0;0;0;0;11;0;0;6;3;2;0
9163.0;2022;03;BESANCON;MASCULIN;APPRENTISSAGE;BAC PROFESSIONNEL;BAC PRO PROD;BAC PRO 25215 MAINT.VEHIC.OPTB VEHIC.TRANS.ROUT;13;13;10;3;0;0;0;10;0;0;2;2;6;3
9173.0;2022;03;BESANCON;MASCULIN;APPRENTISSAGE;BAC PROFESSIONNEL;BAC PRO PROD;BAC PRO 25514 SYST.NUM.OPT.B AUD.RES.EQUIP.DOM.;2;2;2;0;0;0;0;2;0;1;1;0;0;0
9176.0;2022;03;BESANCON;MASCULIN;APPRENTISSAGE;BAC PROFESSIONNEL;BAC PRO PROD;BAC PRO AG 21004 CGEA;66;64;47;17;0;0;0;47;0;0;5;12;30;17
9182.0;2022;03;BESANCON;MASCULIN;APPRENTISSAGE;BAC PROFESSIONNEL;BAC PRO PROD;BAC PRO AG 22107 TEC CONS VTE ALIMENTATION P.ALIM;4;4;4;0;0;0;0;4;0;0;0;2;2;0
9183.0;2022;03;BESANCON;MASCULIN;APPRENTISSAGE;BAC PROFESSIONNEL;BAC PRO SERV;BAC PRO 30001 GESTION-ADMINISTRATION;1;1;0;1;0;0;0;0;0;0;0;0;0;1
9186.0;2022;03;BESANCON;MASCULIN;APPRENTISSAGE;BAC PROFESSIONNEL;BAC PRO SERV;BAC PRO 32303 ART.& MET.ART:COM.VIS.VIS.PLURI-M;6;6;3;3;0;0;0;3;0;0;1;1;1;3
9187.0;2022;03;BESANCON;MASCULIN;APPRENTISSAGE;BAC PROFESSIONNEL;BAC PRO SERV;BAC PRO 33101 OPTIQUE LUNETTERIE;2;2;1;1;0;0;0;1;0;1;0;0;0;1
9192.0;2022;03;BESANCON;MASCULIN;ENSEIGNEMENT A DISTANCE;BAC GENERAL;BAC GENERAL;BAC GENE 10019 BAC GENERAL;8;8;8;0;0;0;0;8;0;1;1;3;3;0
9193.0;2022;03;BESANCON;MASCULIN;ENSEIGNEMENT A DISTANCE;BAC PROFESSIONNEL;BAC PRO SERV;BAC PRO 30001 GESTION-ADMINISTRATION;1;1;1;0;0;0;0;1;0;0;0;1;0;0
9194.0;2022;03;BESANCON;MASCULIN;FORMATION CONTINUE;BAC PROFESSIONNEL;BAC PRO PROD;BAC PRO 25106 TECHNICIEN D'USINAGE;1;1;0;1;0;0;0;0;0;0;0;0;0;1
9195.0;2022;03;BESANCON;MASCULIN;FORMATION CONTINUE;BAC PROFESSIONNEL;BAC PRO PROD;BAC PRO 25303 AERONAUTIQUE OPTION SYSTEMES;3;3;3;0;0;0;0;3;0;1;2;0;0;0
9205.0;2022;03;BESANCON;MASCULIN;INDIVIDUEL;BAC PROFESSIONNEL;BAC PRO PROD;BAC PRO AG 21113 CGEVV;1;1;1;0;0;0;0;1;0;0;0;0;1;0
9206.0;2022;03;BESANCON;MASCULIN;INDIVIDUEL;BAC PROFESSIONNEL;BAC PRO SERV;BAC PRO 30001 GESTION-ADMINISTRATION;3;2;1;1;0;0;0;1;0;0;0;0;1;1
9210.0;2022;03;BESANCON;MASCULIN;INDIVIDUEL;BAC TECHNOLOGIQUE;BAC STHR;BAC STHR SC.&TEC. HOTELLERIE-RESTAURATION;1;1;0;1;0;0;0;0;0;0;0;0;0;1
9220.0;2022;03;BESANCON;MASCULIN;SCOLAIRE;BAC PROFESSIONNEL;BAC PRO PROD;BAC PRO 22704 TECHN. MAINT. SYST.ENERG.CLIMATI;14;14;13;1;0;0;0;13;0;0;1;7;5;1
9224.0;2022;03;BESANCON;MASCULIN;SCOLAIRE;BAC PROFESSIONNEL;BAC PRO PROD;BACPRO 23103 TECHNICIEN GEOMETRE-TOPOGRAPHE;10;10;6;4;0;0;0;6;0;0;1;2;3;4
9228.0;2022;03;BESANCON;MASCULIN;SCOLAIRE;BAC PROFESSIONNEL;BAC PRO PROD;BAC PRO 23404 TECHNICIEN CONSTRUCTEUR BOIS;23;23;20;3;0;0;0;20;0;0;3;8;9;3
9230.0;2022;03;BESANCON;MASCULIN;SCOLAIRE;BAC PROFESSIONNEL;BAC PRO PROD;BAC PRO 23407 TECHNIC.FAB.BOIS ET MATERX ASSOC;24;24;14;9;1;1;0;15;0;1;1;9;4;9
9233.0;2022;03;BESANCON;MASCULIN;SCOLAIRE;BAC PROFESSIONNEL;BAC PRO PROD;BAC PRO 24302 METIERS DU CUIR : MAROQUINERIE;2;2;1;1;0;0;0;1;0;0;0;1;0;1
9237.0;2022;03;BESANCON;MASCULIN;SCOLAIRE;BAC PROFESSIONNEL;BAC PRO PROD;BAC PRO 25106 TECHNICIEN D'USINAGE;81;81;53;24;4;4;0;57;0;1;5;19;32;24
9240.0;2022;03;BESANCON;MASCULIN;SCOLAIRE;BAC PROFESSIONNEL;BAC PRO PROD;BAC PRO 25215 MAINT.VEHIC.OPTB VEHIC.TRANS.ROUT;10;10;8;1;1;1;0;9;0;0;3;3;3;1
9241.0;2022;03;BESANCON;MASCULIN;SCOLAIRE;BAC PROFESSIONNEL;BAC PRO PROD;BAC PRO 25216 MAINT.VEHIC.OPTC MOTOCYCLES;20;20;18;2;0;0;0;18;0;2;3;6;7;2
9249.0;2022;03;BESANCON;MASCULIN;SCOLAIRE;BAC PROFESSIONNEL;BAC PRO PROD;BAC PRO 25515 SYST.NUM.OPT.C RES.INF.SYST.COMM.;88;88;79;7;2;2;0;81;0;7;18;41;15;7
9251.0;2022;03;BESANCON;MASCULIN;SCOLAIRE;BAC PROFESSIONNEL;BAC PRO PROD;BAC PRO AG 21004 CGEA;80;79;76;3;0;0;0;76;0;1;13;30;32;3
9276.0;2022;03;BESANCON;MASCULIN;SCOLAIRE;BAC TECHNOLOGIQUE;BAC STAV;BAC STAV AGRONOMIE ALIM ENV TERRITOI;95;95;95;0;0;0;0;95;0;3;15;51;26;0
9279.0;2022;03;BESANCON;MASCULIN;SCOLAIRE;BAC TECHNOLOGIQUE;BAC STI2D;BAC STI2D ARCHITECTURE ET CONSTRUCTION;34;34;29;1;4;2;2;31;0;0;2;10;19;3
9282.0;2022;03;BESANCON;MASCULIN;SCOLAIRE;BAC TECHNOLOGIQUE;BAC STI2D;BAC STI2D SYSTÈME D'INFORMATION  ET NUMERIQUE;138;138;106;5;27;15;12;121;0;1;11;37;72;17
9288.0;2022;03;BESANCON;MASCULIN;SCOLAIRE;BAC TECHNOLOGIQUE;BAC STMG;BAC STMG SYSTEMES D'INFORMATION DE GESTION;5;5;4;1;0;0;0;4;0;0;0;2;2;1
9291.0;2022;04;BORDEAUX;FEMININ;APPRENTISSAGE;BAC PROFESSIONNEL;BAC PRO PROD;BAC PRO 22106 CUISINE;7;7;4;3;0;0;0;4;0;0;0;2;2;3
9292.0;2022;04;BORDEAUX;FEMININ;APPRENTISSAGE;BAC PROFESSIONNEL;BAC PRO PROD;BAC PRO 23405 TECHNICIEN MENUISIER AGENCEUR;1;1;1;0;0;0;0;1;0;0;0;0;1;0
9294.0;2022;04;BORDEAUX;FEMININ;APPRENTISSAGE;BAC PROFESSIONNEL;BAC PRO PROD;BAC PRO 24303 MET. DU CUIR: SELLERIE GARNISSAGE;1;1;1;0;0;0;0;1;0;1;0;0;0;0
9295.0;2022;04;BORDEAUX;FEMININ;APPRENTISSAGE;BAC PROFESSIONNEL;BAC PRO PROD;BAC PRO 25007 MAINTENANCE EQUIPEMENTS INDUST.;2;2;2;0;0;0;0;2;0;1;1;0;0;0
9297.0;2022;04;BORDEAUX;FEMININ;APPRENTISSAGE;BAC PROFESSIONNEL;BAC PRO PROD;BAC PRO 25214 MAINT.VEHIC.OPTA VOIT.PARTICUL.;9;8;8;0;0;0;0;8;0;1;2;4;1;0
9303.0;2022;04;BORDEAUX;FEMININ;APPRENTISSAGE;BAC PROFESSIONNEL;BAC PRO PROD;BAC PRO 25510 METIERS ELECT. ENVIRON. CONNECTES;1;1;1;0;0;0;0;1;0;0;1;0;0;0
9317.0;2022;04;BORDEAUX;FEMININ;APPRENTISSAGE;BAC PROFESSIONNEL;BAC PRO SERV;BAC PRO 32207 REAL.PR.IMPR.PLURI.OPTA.PR.GRAPH.;3;3;3;0;0;0;0;3;0;1;1;1;0;0
9318.0;2022;04;BORDEAUX;FEMININ;APPRENTISSAGE;BAC PROFESSIONNEL;BAC PRO SERV;BAC PRO 33101 OPTIQUE LUNETTERIE;10;10;10;0;0;0;0;10;0;7;3;0;0;0
9331.0;2022;04;BORDEAUX;FEMININ;ENSEIGNEMENT A DISTANCE;BAC TECHNOLOGIQUE;BAC STMG;BAC STMG GESTION ET FINANCE;1;1;0;1;0;0;0;0;0;0;0;0;0;1
9332.0;2022;04;BORDEAUX;FEMININ;ENSEIGNEMENT A DISTANCE;BAC TECHNOLOGIQUE;BAC STMG;BAC STMG MERCATIQUE (MARKETING);5;5;3;0;2;2;0;5;0;0;0;0;5;0
9335.0;2022;04;BORDEAUX;FEMININ;FORMATION CONTINUE;BAC PROFESSIONNEL;BAC PRO PROD;BAC PRO AG 21113 CGEVV;1;1;1;0;0;0;0;1;0;0;1;0;0;0
9337.0;2022;04;BORDEAUX;FEMININ;FORMATION CONTINUE;BAC PROFESSIONNEL;BAC PRO PROD;BAC PRO AG 21405 AMENAGEMENTS PAYSAGERS;5;5;5;0;0;0;0;5;0;0;0;0;5;0
9355.0;2022;04;BORDEAUX;FEMININ;INDIVIDUEL;BAC TECHNOLOGIQUE;BAC ST2S;BAC ST2S SCIENCES & TECHNO. SANTE & SOCIAL;10;5;4;0;1;1;0;5;1;0;0;1;3;0
9356.0;2022;04;BORDEAUX;FEMININ;INDIVIDUEL;BAC TECHNOLOGIQUE;BAC STHR;BAC STHR SC.&TEC. HOTELLERIE-RESTAURATION;2;0;0;0;0;0;0;0;0;0;0;0;0;0
9363.0;2022;04;BORDEAUX;FEMININ;SCOLAIRE;BAC PROFESSIONNEL;BAC PRO PROD;BAC PRO 22003 BIO-INDUSTRIES DE TRANSFORMATION;25;25;20;5;0;0;0;20;0;0;5;7;8;5
9376.0;2022;04;BORDEAUX;FEMININ;SCOLAIRE;BAC PROFESSIONNEL;BAC PRO PROD;BAC PRO 23407 TECHNIC.FAB.BOIS ET MATERX ASSOC;1;1;1;0;0;0;0;1;0;0;0;1;0;0
9379.0;2022;04;BORDEAUX;FEMININ;SCOLAIRE;BAC PROFESSIONNEL;BAC PRO PROD;BAC PRO 24203 METIERS DE LA MODE - VÊTEMENT;108;108;88;17;3;2;1;90;0;7;20;35;28;18
9385.0;2022;04;BORDEAUX;FEMININ;SCOLAIRE;BAC PROFESSIONNEL;BAC PRO PROD;BAC PRO 25216 MAINT.VEHIC.OPTC MOTOCYCLES;4;3;3;0;0;0;0;3;0;1;0;2;0;0
9387.0;2022;04;BORDEAUX;FEMININ;SCOLAIRE;BAC PROFESSIONNEL;BAC PRO PROD;BAC PRO 25303 AERONAUTIQUE OPTION SYSTEMES;4;4;4;0;0;0;0;4;0;1;1;1;1;0
9389.0;2022;04;BORDEAUX;FEMININ;SCOLAIRE;BAC PROFESSIONNEL;BAC PRO PROD;BAC PRO 25408 REPARATION DES CARROSSERIES;1;1;1;0;0;0;0;1;0;0;1;0;0;0
9395.0;2022;04;BORDEAUX;FEMININ;SCOLAIRE;BAC PROFESSIONNEL;BAC PRO PROD;BAC PRO AG 21113 CGEVV;5;5;5;0;0;0;0;5;0;0;0;4;1;0
9402.0;2022;04;BORDEAUX;FEMININ;SCOLAIRE;BAC PROFESSIONNEL;BAC PRO PROD;BAC PRO AG 21303 FORET;2;2;2;0;0;0;0;2;0;0;0;1;1;0
9403.0;2022;04;BORDEAUX;FEMININ;SCOLAIRE;BAC PROFESSIONNEL;BAC PRO PROD;BAC PRO AG 21405 AMENAGEMENTS PAYSAGERS;4;3;3;0;0;0;0;3;0;0;0;0;3;0
9405.0;2022;04;BORDEAUX;FEMININ;SCOLAIRE;BAC PROFESSIONNEL;BAC PRO PROD;BAC PRO AG 22105 LABORATOIRE CONTROLE QUALITE;20;19;12;7;0;0;0;12;0;0;2;4;6;7
9410.0;2022;04;BORDEAUX;FEMININ;SCOLAIRE;BAC PROFESSIONNEL;BAC PRO SERV;BAC PRO 31107 CONDUCT. TRANSP.ROUT.MARCHANDISES;3;3;3;0;0;0;0;3;0;0;1;1;1;0
9416.0;2022;04;BORDEAUX;FEMININ;SCOLAIRE;BAC PROFESSIONNEL;BAC PRO SERV;BAC PRO 32208 REAL.PR.IMPR.PLURI.OPTB.PR.IMPR.;6;5;5;0;0;0;0;5;0;0;2;0;3;0
9422.0;2022;04;BORDEAUX;FEMININ;SCOLAIRE;BAC PROFESSIONNEL;BAC PRO SERV;BAC PRO 33101 OPTIQUE LUNETTERIE;13;13;10;3;0;0;0;10;0;2;1;4;3;3
9423.0;2022;04;BORDEAUX;FEMININ;SCOLAIRE;BAC PROFESSIONNEL;BAC PRO SERV;BAC PRO 33102 PROTHESE DENTAIRE;8;8;6;2;0;0;0;6;0;1;1;1;3;2
9430.0;2022;04;BORDEAUX;FEMININ;SCOLAIRE;BAC TECHNOLOGIQUE;BAC S2TMD;BAC S2TMD DANSE;1;1;1;0;0;0;0;1;0;0;1;0;0;0
9432.0;2022;04;BORDEAUX;FEMININ;SCOLAIRE;BAC TECHNOLOGIQUE;BAC ST2S;BAC ST2S SCIENCES & TECHNO. SANTE & SOCIAL;546;546;487;10;49;36;13;523;0;11;91;192;229;23
9436.0;2022;04;BORDEAUX;FEMININ;SCOLAIRE;BAC TECHNOLOGIQUE;BAC STI2D;BAC STI2D ARCHITECTURE ET CONSTRUCTION;41;41;34;1;6;5;1;39;0;1;4;11;23;2
9437.0;2022;04;BORDEAUX;FEMININ;SCOLAIRE;BAC TECHNOLOGIQUE;BAC STI2D;BAC STI2D ENERGIES  ET ENVIRONNEMENT;9;9;7;1;1;1;0;8;0;0;1;4;3;1
9438.0;2022;04;BORDEAUX;FEMININ;SCOLAIRE;BAC TECHNOLOGIQUE;BAC STI2D;BAC STI2D INNOVATION TECHNO.  ET ECO CONCEPTION;33;33;25;1;7;5;2;30;0;1;2;9;18;3
9452.0;2022;04;BORDEAUX;MASCULIN;APPRENTISSAGE;BAC PROFESSIONNEL;BAC PRO PROD;BAC PRO 23102 TRAVAUX PUBLICS;25;25;18;5;2;0;2;18;0;0;4;10;4;7
9454.0;2022;04;BORDEAUX;MASCULIN;APPRENTISSAGE;BAC PROFESSIONNEL;BAC PRO PROD;BAC PRO 23205 INTERV. SUR PATRIMOINE BATI OPT.A;2;2;1;0;1;0;1;1;0;0;1;0;0;1
9455.0;2022;04;BORDEAUX;MASCULIN;APPRENTISSAGE;BAC PROFESSIONNEL;BAC PRO PROD;BAC PRO 23208 METIERS ET ARTS DE LA PIERRE;1;1;0;1;0;0;0;0;0;0;0;0;0;1
9458.0;2022;04;BORDEAUX;MASCULIN;APPRENTISSAGE;BAC PROFESSIONNEL;BAC PRO PROD;BAC PRO 23404 TECHNICIEN CONSTRUCTEUR BOIS;9;9;8;1;0;0;0;8;0;0;0;2;6;1
9459.0;2022;04;BORDEAUX;MASCULIN;APPRENTISSAGE;BAC PROFESSIONNEL;BAC PRO PROD;BAC PRO 23405 TECHNICIEN MENUISIER AGENCEUR;8;8;7;1;0;0;0;7;0;1;2;3;1;1
9472.0;2022;04;BORDEAUX;MASCULIN;APPRENTISSAGE;BAC PROFESSIONNEL;BAC PRO PROD;BAC PRO 25302 AERONAUTIQUE OPTION AVIONIQUE;1;1;1;0;0;0;0;1;0;0;1;0;0;0
9474.0;2022;04;BORDEAUX;MASCULIN;APPRENTISSAGE;BAC PROFESSIONNEL;BAC PRO PROD;BAC PRO 25304 AERONAUTIQUE OPTION STRUCTURE;12;11;9;1;1;0;1;9;0;2;4;1;2;2
9477.0;2022;04;BORDEAUX;MASCULIN;APPRENTISSAGE;BAC PROFESSIONNEL;BAC PRO PROD;BAC PRO 25510 METIERS ELECT. ENVIRON. CONNECTES;124;123;103;15;5;3;2;106;0;9;26;39;32;17
9479.0;2022;04;BORDEAUX;MASCULIN;APPRENTISSAGE;BAC PROFESSIONNEL;BAC PRO PROD;BAC PRO 25515 SYST.NUM.OPT.C RES.INF.SYST.COMM.;10;10;8;2;0;0;0;8;0;0;2;5;1;2
9486.0;2022;04;BORDEAUX;MASCULIN;APPRENTISSAGE;BAC PROFESSIONNEL;BAC PRO PROD;BAC PRO AG 21405 AMENAGEMENTS PAYSAGERS;76;67;59;8;0;0;0;59;0;0;7;13;39;8
9494.0;2022;04;BORDEAUX;MASCULIN;APPRENTISSAGE;BAC PROFESSIONNEL;BAC PRO SERV;BAC PRO 31214 MET.COM.VEN.OP.B PR.CL.VA.OF.COM.;6;6;5;1;0;0;0;5;0;0;0;1;4;1
9507.0;2022;04;BORDEAUX;MASCULIN;ENSEIGNEMENT A DISTANCE;BAC PROFESSIONNEL;BAC PRO SERV;BAC PRO 33003 ACC.SOINS-S.PERS. OPT.A DOMICILE;1;1;1;0;0;0;0;1;0;0;0;0;1;0
9508.0;2022;04;BORDEAUX;MASCULIN;ENSEIGNEMENT A DISTANCE;BAC TECHNOLOGIQUE;BAC STMG;BAC STMG GESTION ET FINANCE;2;2;1;0;1;1;0;2;0;0;0;1;1;0
9513.0;2022;04;BORDEAUX;MASCULIN;FORMATION CONTINUE;BAC PROFESSIONNEL;BAC PRO PROD;BAC PRO 25509 TECHNIC. FROID CONDITIONNEMT AIR;1;1;1;0;0;0;0;1;0;0;1;0;0;0
9516.0;2022;04;BORDEAUX;MASCULIN;FORMATION CONTINUE;BAC PROFESSIONNEL;BAC PRO SERV;BAC PRO 31213 MET.COM.VEN.OP.A ANI.GES.ESP.COM.;12;12;9;2;1;1;0;10;0;0;0;1;9;2
9521.0;2022;04;BORDEAUX;MASCULIN;INDIVIDUEL;BAC PROFESSIONNEL;BAC PRO PROD;BAC PRO 25007 MAINTENANCE EQUIPEMENTS INDUST.;1;0;0;0;0;0;0;0;0;0;0;0;0;0
9527.0;2022;04;BORDEAUX;MASCULIN;INDIVIDUEL;BAC PROFESSIONNEL;BAC PRO PROD;BAC PRO AG 21113 CGEVV;2;2;1;1;0;0;0;1;0;0;0;0;1;1
9528.0;2022;04;BORDEAUX;MASCULIN;INDIVIDUEL;BAC PROFESSIONNEL;BAC PRO PROD;BAC PRO AG 21114 CONDUITE PRODUCTIONS HORTICOLES;6;4;4;0;0;0;0;4;0;0;0;0;4;0
9532.0;2022;04;BORDEAUX;MASCULIN;INDIVIDUEL;BAC PROFESSIONNEL;BAC PRO SERV;BAC PRO 30001 GESTION-ADMINISTRATION;2;0;0;0;0;0;0;0;0;0;0;0;0;0
9535.0;2022;04;BORDEAUX;MASCULIN;INDIVIDUEL;BAC PROFESSIONNEL;BAC PRO SERV;BAC PRO 31212 METIERS DE L'ACCUEIL;1;0;0;0;0;0;0;0;0;0;0;0;0;0
9543.0;2022;04;BORDEAUX;MASCULIN;INDIVIDUEL;BAC TECHNOLOGIQUE;BAC STMG;BAC STMG GESTION ET FINANCE;4;0;0;0;0;0;0;0;0;0;0;0;0;0
9550.0;2022;04;BORDEAUX;MASCULIN;SCOLAIRE;BAC PROFESSIONNEL;BAC PRO PROD;BAC PRO 22004 PROC. CHIMIE EAU PAPIERS-CARTONS;28;28;23;3;2;2;0;25;0;1;4;7;13;3
9551.0;2022;04;BORDEAUX;MASCULIN;SCOLAIRE;BAC PROFESSIONNEL;BAC PRO PROD;BAC PRO 22104 BOUCHER CHARCUTIER TRAITEUR;7;7;5;0;2;2;0;7;0;0;2;2;3;0
9553.0;2022;04;BORDEAUX;MASCULIN;SCOLAIRE;BAC PROFESSIONNEL;BAC PRO PROD;BAC PRO 22106 CUISINE;176;176;162;11;3;3;0;165;0;4;40;79;42;11
9556.0;2022;04;BORDEAUX;MASCULIN;SCOLAIRE;BAC PROFESSIONNEL;BAC PRO PROD;BAC PRO 22704 TECHN. MAINT. SYST.ENERG.CLIMATI;13;13;10;3;0;0;0;10;0;1;0;4;5;3
9557.0;2022;04;BORDEAUX;MASCULIN;SCOLAIRE;BAC PROFESSIONNEL;BAC PRO PROD;BAC PRO 23003 ARTIS. & M.ART:MARCHANDISAGE VIS.;2;2;1;0;1;1;0;2;0;0;0;0;2;0
9558.0;2022;04;BORDEAUX;MASCULIN;SCOLAIRE;BAC PROFESSIONNEL;BAC PRO PROD;BAC PRO 23004 TECHN. ETUDES BAT.A ETUDES & ECO.;49;48;39;9;0;0;0;39;0;0;6;18;15;9
9559.0;2022;04;BORDEAUX;MASCULIN;SCOLAIRE;BAC PROFESSIONNEL;BAC PRO PROD;BAC PRO 23005 TECHN. ETUDES BAT B ASSIST.ARCHI.;7;7;6;1;0;0;0;6;0;1;1;2;2;1
9560.0;2022;04;BORDEAUX;MASCULIN;SCOLAIRE;BAC PROFESSIONNEL;BAC PRO PROD;BAC PRO 23102 TRAVAUX PUBLICS;50;50;48;2;0;0;0;48;0;3;11;16;18;2
9574.0;2022;04;BORDEAUX;MASCULIN;SCOLAIRE;BAC PROFESSIONNEL;BAC PRO PROD;BAC PRO 25107 TECHNICIEN OUTILLEUR;26;26;23;1;2;1;1;24;0;0;5;10;9;2
9578.0;2022;04;BORDEAUX;MASCULIN;SCOLAIRE;BAC PROFESSIONNEL;BAC PRO PROD;BAC PRO 25219 MAINT.MATERIELS OPT.A AGRICOLES;40;40;32;7;1;1;0;33;0;4;11;11;7;7
9580.0;2022;04;BORDEAUX;MASCULIN;SCOLAIRE;BAC PROFESSIONNEL;BAC PRO PROD;BAC PRO 25221 MAINT.MATERIELS OPT.C ESP. VERTS;15;15;13;2;0;0;0;13;0;0;3;5;5;2
9584.0;2022;04;BORDEAUX;MASCULIN;SCOLAIRE;BAC PROFESSIONNEL;BAC PRO PROD;BAC PRO 25406 OUVRAGES DU BATIMENT METALLERIE;13;13;12;1;0;0;0;12;0;0;5;2;5;1
9587.0;2022;04;BORDEAUX;MASCULIN;SCOLAIRE;BAC PROFESSIONNEL;BAC PRO PROD;BAC PRO 25509 TECHNIC. FROID CONDITIONNEMT AIR;47;47;36;10;1;0;1;36;0;2;6;12;16;11
9594.0;2022;04;BORDEAUX;MASCULIN;SCOLAIRE;BAC PROFESSIONNEL;BAC PRO PROD;BAC PRO AG 21113 CGEVV;24;24;20;4;0;0;0;20;0;0;1;8;11;4
9599.0;2022;04;BORDEAUX;MASCULIN;SCOLAIRE;BAC PROFESSIONNEL;BAC PRO PROD;BAC PRO AG 21211 COND GEST ENTR HIPPIQUE;6;6;3;3;0;0;0;3;0;0;1;0;2;3
9603.0;2022;04;BORDEAUX;MASCULIN;SCOLAIRE;BAC PROFESSIONNEL;BAC PRO PROD;BAC PRO AG 21407 TEC CONS VTE UNIVERS JARDINERIE;11;9;6;3;0;0;0;6;0;0;0;1;5;3
9609.0;2022;04;BORDEAUX;MASCULIN;SCOLAIRE;BAC PROFESSIONNEL;BAC PRO SERV;BAC PRO 31107 CONDUCT. TRANSP.ROUT.MARCHANDISES;63;63;61;2;0;0;0;61;0;6;22;26;7;2
9612.0;2022;04;BORDEAUX;MASCULIN;SCOLAIRE;BAC PROFESSIONNEL;BAC PRO SERV;BAC PRO 31213 MET.COM.VEN.OP.A ANI.GES.ESP.COM.;438;436;310;111;15;14;1;324;0;7;55;107;155;112
9613.0;2022;04;BORDEAUX;MASCULIN;SCOLAIRE;BAC PROFESSIONNEL;BAC PRO SERV;BAC PRO 31214 MET.COM.VEN.OP.B PR.CL.VA.OF.COM.;264;263;186;70;7;5;2;191;0;6;30;68;87;72
9636.0;2022;04;BORDEAUX;MASCULIN;SCOLAIRE;BAC TECHNOLOGIQUE;BAC STI2D;BAC STI2D ENERGIES  ET ENVIRONNEMENT;170;170;125;13;32;19;13;144;0;0;9;51;84;26
9639.0;2022;04;BORDEAUX;MASCULIN;SCOLAIRE;BAC TECHNOLOGIQUE;BAC STL;BAC STL BIOCHIM.-BIOLOGIE-BIOTECHNOL.;100;100;81;3;16;12;4;93;0;6;11;25;51;7
9642.0;2022;04;BORDEAUX;MASCULIN;SCOLAIRE;BAC TECHNOLOGIQUE;BAC STMG;BAC STMG MERCATIQUE (MARKETING);898;898;676;68;154;109;45;785;0;4;53;240;488;113
9646.0;2022;06;CLERMONT-FERRAND;FEMININ;APPRENTISSAGE;BAC PROFESSIONNEL;BAC PRO PROD;BAC PRO 22106 CUISINE;1;1;1;0;0;0;0;1;0;0;1;0;0;0
9662.0;2022;06;CLERMONT-FERRAND;FEMININ;APPRENTISSAGE;BAC PROFESSIONNEL;BAC PRO SERV;BAC PRO 31106 LOGISTIQUE;3;3;3;0;0;0;0;3;0;1;0;2;0;0
9664.0;2022;06;CLERMONT-FERRAND;FEMININ;APPRENTISSAGE;BAC PROFESSIONNEL;BAC PRO SERV;BAC PRO 31213 MET.COM.VEN.OP.A ANI.GES.ESP.COM.;57;56;44;8;4;3;1;47;0;0;14;14;19;9
9668.0;2022;06;CLERMONT-FERRAND;FEMININ;APPRENTISSAGE;BAC PROFESSIONNEL;BAC PRO SERV;BAC PRO AG 33002 SERV PERS TERRIT;13;11;11;0;0;0;0;11;0;0;1;4;6;0
9687.0;2022;06;CLERMONT-FERRAND;FEMININ;INDIVIDUEL;BAC PROFESSIONNEL;BAC PRO PROD;BAC PRO AG 21211 COND GEST ENTR HIPPIQUE;3;3;1;2;0;0;0;1;0;0;0;0;1;2
9697.0;2022;06;CLERMONT-FERRAND;FEMININ;INDIVIDUEL;BAC TECHNOLOGIQUE;BAC STMG;BAC STMG RESSOURCES HUMAINES ET COMMUNICATION;9;6;3;3;0;0;0;3;0;0;1;2;0;3
9704.0;2022;06;CLERMONT-FERRAND;FEMININ;SCOLAIRE;BAC PROFESSIONNEL;BAC PRO PROD;BAC PRO 23003 ARTIS. & M.ART:MARCHANDISAGE VIS.;11;11;8;2;1;1;0;9;0;0;2;4;3;2
9714.0;2022;06;CLERMONT-FERRAND;FEMININ;SCOLAIRE;BAC PROFESSIONNEL;BAC PRO PROD;BAC PRO 25007 MAINTENANCE EQUIPEMENTS INDUST.;3;3;3;0;0;0;0;3;0;0;1;1;1;0
9715.0;2022;06;CLERMONT-FERRAND;FEMININ;SCOLAIRE;BAC PROFESSIONNEL;BAC PRO PROD;BAC PRO 25214 MAINT.VEHIC.OPTA VOIT.PARTICUL.;3;3;3;0;0;0;0;3;0;0;0;2;1;0
9716.0;2022;06;CLERMONT-FERRAND;FEMININ;SCOLAIRE;BAC PROFESSIONNEL;BAC PRO PROD;BAC PRO 25221 MAINT.MATERIELS OPT.C ESP. VERTS;1;1;0;1;0;0;0;0;0;0;0;0;0;1
9721.0;2022;06;CLERMONT-FERRAND;FEMININ;SCOLAIRE;BAC PROFESSIONNEL;BAC PRO PROD;BAC PRO 25515 SYST.NUM.OPT.C RES.INF.SYST.COMM.;1;1;1;0;0;0;0;1;0;0;0;0;1;0
9732.0;2022;06;CLERMONT-FERRAND;FEMININ;SCOLAIRE;BAC PROFESSIONNEL;BAC PRO PROD;BAC PRO AG 22107 TEC CONS VTE ALIMENTATION P.ALIM;4;4;3;1;0;0;0;3;0;0;0;0;3;1
9737.0;2022;06;CLERMONT-FERRAND;FEMININ;SCOLAIRE;BAC PROFESSIONNEL;BAC PRO SERV;BAC PRO 31213 MET.COM.VEN.OP.A ANI.GES.ESP.COM.;163;163;137;19;7;5;2;142;0;7;23;52;60;21
9739.0;2022;06;CLERMONT-FERRAND;FEMININ;SCOLAIRE;BAC PROFESSIONNEL;BAC PRO SERV;BAC PRO 32207 REAL.PR.IMPR.PLURI.OPTA.PR.GRAPH.;2;2;2;0;0;0;0;2;0;0;2;0;0;0
9753.0;2022;06;CLERMONT-FERRAND;FEMININ;SCOLAIRE;BAC TECHNOLOGIQUE;BAC ST2S;BAC ST2S SCIENCES & TECHNO. SANTE & SOCIAL;381;381;317;11;53;32;21;349;1;15;39;133;161;32
9756.0;2022;06;CLERMONT-FERRAND;FEMININ;SCOLAIRE;BAC TECHNOLOGIQUE;BAC STHR;BAC STHR SC.&TEC. HOTELLERIE-RESTAURATION;30;30;28;0;2;1;1;29;0;2;5;14;8;1
9766.0;2022;06;CLERMONT-FERRAND;FEMININ;SCOLAIRE;BAC TECHNOLOGIQUE;BAC STMG;BAC STMG SYSTEMES D'INFORMATION DE GESTION;3;3;3;0;0;0;0;3;0;0;0;2;1;0
9768.0;2022;06;CLERMONT-FERRAND;MASCULIN;APPRENTISSAGE;BAC PROFESSIONNEL;BAC PRO PROD;BAC PRO 20102 PILOTE DE LIGNE DE PRODUCTION;12;12;12;0;0;0;0;12;0;4;1;5;2;0
9769.0;2022;06;CLERMONT-FERRAND;MASCULIN;APPRENTISSAGE;BAC PROFESSIONNEL;BAC PRO PROD;BAC PRO 22106 CUISINE;5;5;4;0;1;1;0;5;0;0;0;2;3;0
9779.0;2022;06;CLERMONT-FERRAND;MASCULIN;APPRENTISSAGE;BAC PROFESSIONNEL;BAC PRO PROD;BAC PRO 24202 ARTIS.& MET.ART : TAPIS.D'AMEUBL;1;1;0;1;0;0;0;0;0;0;0;0;0;1
9781.0;2022;06;CLERMONT-FERRAND;MASCULIN;APPRENTISSAGE;BAC PROFESSIONNEL;BAC PRO PROD;BAC PRO 25106 TECHNICIEN D'USINAGE;24;24;21;2;1;1;0;22;0;2;5;9;6;2
9784.0;2022;06;CLERMONT-FERRAND;MASCULIN;APPRENTISSAGE;BAC PROFESSIONNEL;BAC PRO PROD;BAC PRO 25216 MAINT.VEHIC.OPTC MOTOCYCLES;12;12;7;3;2;2;0;9;0;0;1;1;7;3
9785.0;2022;06;CLERMONT-FERRAND;MASCULIN;APPRENTISSAGE;BAC PROFESSIONNEL;BAC PRO PROD;BAC PRO 25219 MAINT.MATERIELS OPT.A AGRICOLES;17;17;11;3;3;3;0;14;0;1;1;3;9;3
9788.0;2022;06;CLERMONT-FERRAND;MASCULIN;APPRENTISSAGE;BAC PROFESSIONNEL;BAC PRO PROD;BAC PRO 25302 AERONAUTIQUE OPTION AVIONIQUE;2;2;2;0;0;0;0;2;0;0;0;2;0;0
9800.0;2022;06;CLERMONT-FERRAND;MASCULIN;APPRENTISSAGE;BAC PROFESSIONNEL;BAC PRO PROD;BAC PRO AG 21303 FORET;4;4;4;0;0;0;0;4;0;0;0;2;2;0
9808.0;2022;06;CLERMONT-FERRAND;MASCULIN;APPRENTISSAGE;BAC PROFESSIONNEL;BAC PRO SERV;BAC PRO 33002 SERVICES DE PROXIMITE  VIE LOCAL;1;1;1;0;0;0;0;1;0;0;0;1;0;0
9822.0;2022;06;CLERMONT-FERRAND;MASCULIN;FORMATION CONTINUE;BAC PROFESSIONNEL;BAC PRO PROD;BAC PRO 25007 MAINTENANCE EQUIPEMENTS INDUST.;5;5;5;0;0;0;0;5;0;3;1;0;1;0
9829.0;2022;06;CLERMONT-FERRAND;MASCULIN;INDIVIDUEL;BAC PROFESSIONNEL;BAC PRO PROD;BAC PRO AG 21004 CGEA;1;1;0;1;0;0;0;0;0;0;0;0;0;1
9841.0;2022;06;CLERMONT-FERRAND;MASCULIN;SCOLAIRE;BAC PROFESSIONNEL;BAC PRO PROD;BACPRO 20002 ETUD.DEFINITION PRDTS INDUSTRIEL;14;14;9;5;0;0;0;9;0;1;2;4;2;5
9842.0;2022;06;CLERMONT-FERRAND;MASCULIN;SCOLAIRE;BAC PROFESSIONNEL;BAC PRO PROD;BAC PRO 20102 PILOTE DE LIGNE DE PRODUCTION;5;5;2;3;0;0;0;2;0;0;1;1;0;3
9858.0;2022;06;CLERMONT-FERRAND;MASCULIN;SCOLAIRE;BAC PROFESSIONNEL;BAC PRO PROD;BAC PRO 24202 ARTIS.& MET.ART : TAPIS.D'AMEUBL;1;1;0;1;0;0;0;0;0;0;0;0;0;1
9860.0;2022;06;CLERMONT-FERRAND;MASCULIN;SCOLAIRE;BAC PROFESSIONNEL;BAC PRO PROD;BAC PRO 24302 METIERS DU CUIR : MAROQUINERIE;2;2;2;0;0;0;0;2;0;0;2;0;0;0
9866.0;2022;06;CLERMONT-FERRAND;MASCULIN;SCOLAIRE;BAC PROFESSIONNEL;BAC PRO PROD;BAC PRO 25220 MAINT.MATERIELS OPT.B TP MANUT.;9;9;8;1;0;0;0;8;0;1;1;1;5;1
9867.0;2022;06;CLERMONT-FERRAND;MASCULIN;SCOLAIRE;BAC PROFESSIONNEL;BAC PRO PROD;BAC PRO 25221 MAINT.MATERIELS OPT.C ESP. VERTS;10;10;5;4;1;1;0;6;0;0;0;3;3;4
9870.0;2022;06;CLERMONT-FERRAND;MASCULIN;SCOLAIRE;BAC PROFESSIONNEL;BAC PRO PROD;BAC PRO 25304 AERONAUTIQUE OPTION STRUCTURE;18;18;10;8;0;0;0;10;0;0;1;2;7;8
9879.0;2022;06;CLERMONT-FERRAND;MASCULIN;SCOLAIRE;BAC PROFESSIONNEL;BAC PRO PROD;BAC PRO AG 21001 AGRO-EQUIPEMENT;33;33;27;6;0;0;0;27;0;0;3;7;17;6
9880.0;2022;06;CLERMONT-FERRAND;MASCULIN;SCOLAIRE;BAC PROFESSIONNEL;BAC PRO PROD;BAC PRO AG 21004 CGEA;177;174;151;23;0;0;0;151;0;4;14;48;85;23
9881.0;2022;06;CLERMONT-FERRAND;MASCULIN;SCOLAIRE;BAC PROFESSIONNEL;BAC PRO PROD;BAC PRO AG 21114 CONDUITE PRODUCTIONS HORTICOLES;7;7;4;3;0;0;0;4;0;0;0;3;1;3
9888.0;2022;06;CLERMONT-FERRAND;MASCULIN;SCOLAIRE;BAC PROFESSIONNEL;BAC PRO PROD;BAC PRO AG 21407 TEC CONS VTE UNIVERS JARDINERIE;1;1;1;0;0;0;0;1;0;0;0;0;1;0
9890.0;2022;06;CLERMONT-FERRAND;MASCULIN;SCOLAIRE;BAC PROFESSIONNEL;BAC PRO PROD;BAC PRO AG 22107 TEC CONS VTE ALIMENTATION P.ALIM;2;2;2;0;0;0;0;2;0;0;0;2;0;0
9899.0;2022;06;CLERMONT-FERRAND;MASCULIN;SCOLAIRE;BAC PROFESSIONNEL;BAC PRO SERV;BAC PRO 32208 REAL.PR.IMPR.PLURI.OPTB.PR.IMPR.;3;3;3;0;0;0;0;3;0;1;2;0;0;0
9900.0;2022;06;CLERMONT-FERRAND;MASCULIN;SCOLAIRE;BAC PROFESSIONNEL;BAC PRO SERV;BAC PRO 32303 ART.& MET.ART:COM.VIS.VIS.PLURI-M;30;30;30;0;0;0;0;30;0;2;4;21;3;0
9901.0;2022;06;CLERMONT-FERRAND;MASCULIN;SCOLAIRE;BAC PROFESSIONNEL;BAC PRO SERV;BAC PRO 32304 PHOTOGRAPHIE;2;2;1;1;0;0;0;1;0;0;0;0;1;1
9903.0;2022;06;CLERMONT-FERRAND;MASCULIN;SCOLAIRE;BAC PROFESSIONNEL;BAC PRO SERV;BAC PRO 33003 ACC.SOINS-S.PERS. OPT.A DOMICILE;3;3;2;0;1;0;1;2;0;0;0;2;0;1
9909.0;2022;06;CLERMONT-FERRAND;MASCULIN;SCOLAIRE;BAC PROFESSIONNEL;BAC PRO SERV;BAC PRO 34304 HYGIENE PROPRETE STERILISATION;4;4;2;2;0;0;0;2;0;0;1;0;1;2
9910.0;2022;06;CLERMONT-FERRAND;MASCULIN;SCOLAIRE;BAC PROFESSIONNEL;BAC PRO SERV;BAC PRO 34403 METIERS DE LA SECURITE;25;25;22;2;1;1;0;23;0;0;2;10;11;2
9912.0;2022;06;CLERMONT-FERRAND;MASCULIN;SCOLAIRE;BAC TECHNOLOGIQUE;BAC ST2S;BAC ST2S SCIENCES & TECHNO. SANTE & SOCIAL;62;62;40;5;17;3;14;43;0;0;5;14;24;19
9916.0;2022;06;CLERMONT-FERRAND;MASCULIN;SCOLAIRE;BAC TECHNOLOGIQUE;BAC STI2D;BAC STI2D ARCHITECTURE ET CONSTRUCTION;94;94;79;2;13;10;3;89;0;0;7;29;53;5
9919.0;2022;06;CLERMONT-FERRAND;MASCULIN;SCOLAIRE;BAC TECHNOLOGIQUE;BAC STI2D;BAC STI2D SYSTÈME D'INFORMATION  ET NUMERIQUE;146;146;125;1;20;12;8;137;0;2;21;52;62;9
9921.0;2022;06;CLERMONT-FERRAND;MASCULIN;SCOLAIRE;BAC TECHNOLOGIQUE;BAC STL;BAC STL SCIENCES PHYSIQUES CHIMIQUES  EN LABORAT.;21;21;17;2;2;1;1;18;0;1;4;9;4;3
9928.0;2022;27;CORSE;FEMININ;APPRENTISSAGE;BAC PROFESSIONNEL;BAC PRO SERV;BAC PRO 31214 MET.COM.VEN.OP.B PR.CL.VA.OF.COM.;1;1;1;0;0;0;0;1;0;0;0;0;1;0
9929.0;2022;27;CORSE;FEMININ;APPRENTISSAGE;BAC PROFESSIONNEL;BAC PRO SERV;BAC PRO 33403 COMMERC. SERVICES EN RESTAURATION;2;2;2;0;0;0;0;2;0;0;0;2;0;0
9933.0;2022;27;CORSE;FEMININ;ENSEIGNEMENT A DISTANCE;BAC TECHNOLOGIQUE;BAC STMG;BAC STMG GESTION ET FINANCE;1;1;1;0;0;0;0;1;0;0;0;1;0;0
9934.0;2022;27;CORSE;FEMININ;ENSEIGNEMENT A DISTANCE;BAC TECHNOLOGIQUE;BAC STMG;BAC STMG MERCATIQUE (MARKETING);1;1;1;0;0;0;0;1;0;0;0;1;0;0
9942.0;2022;27;CORSE;FEMININ;INDIVIDUEL;BAC TECHNOLOGIQUE;BAC STMG;BAC STMG GESTION ET FINANCE;3;1;1;0;0;0;0;1;0;0;0;1;0;0
9945.0;2022;27;CORSE;FEMININ;SCOLAIRE;BAC GENERAL;BAC GENERAL;BAC GENE 10019 BAC GENERAL;786;786;740;12;34;25;9;765;18;106;228;239;174;21
9946.0;2022;27;CORSE;FEMININ;SCOLAIRE;BAC PROFESSIONNEL;BAC PRO PROD;BAC PRO 22106 CUISINE;13;13;13;0;0;0;0;13;0;3;4;2;4;0
9950.0;2022;27;CORSE;FEMININ;SCOLAIRE;BAC PROFESSIONNEL;BAC PRO PROD;BAC PRO AG 21004 CGEA;3;3;3;0;0;0;0;3;0;0;0;1;2;0
9953.0;2022;27;CORSE;FEMININ;SCOLAIRE;BAC PROFESSIONNEL;BAC PRO SERV;BAC PRO 30001 GESTION-ADMINISTRATION;46;46;36;10;0;0;0;36;0;2;5;15;14;10
9956.0;2022;27;CORSE;FEMININ;SCOLAIRE;BAC PROFESSIONNEL;BAC PRO SERV;BAC PRO 31213 MET.COM.VEN.OP.A ANI.GES.ESP.COM.;24;24;21;2;1;1;0;22;0;2;5;9;6;2
9957.0;2022;27;CORSE;FEMININ;SCOLAIRE;BAC PROFESSIONNEL;BAC PRO SERV;BAC PRO 31214 MET.COM.VEN.OP.B PR.CL.VA.OF.COM.;15;15;15;0;0;0;0;15;0;0;1;10;4;0
9966.0;2022;27;CORSE;FEMININ;SCOLAIRE;BAC TECHNOLOGIQUE;BAC STI2D;BAC STI2D ARCHITECTURE ET CONSTRUCTION;3;3;3;0;0;0;0;3;0;0;0;2;1;0
9967.0;2022;27;CORSE;FEMININ;SCOLAIRE;BAC TECHNOLOGIQUE;BAC STI2D;BAC STI2D INNOVATION TECHNO.  ET ECO CONCEPTION;2;2;2;0;0;0;0;2;0;0;0;0;2;0
9970.0;2022;27;CORSE;FEMININ;SCOLAIRE;BAC TECHNOLOGIQUE;BAC STMG;BAC STMG GESTION ET FINANCE;28;28;26;1;1;1;0;27;0;0;11;8;8;1
9971.0;2022;27;CORSE;FEMININ;SCOLAIRE;BAC TECHNOLOGIQUE;BAC STMG;BAC STMG MERCATIQUE (MARKETING);100;100;79;5;16;13;3;92;0;2;10;32;48;8
9984.0;2022;27;CORSE;MASCULIN;APPRENTISSAGE;BAC PROFESSIONNEL;BAC PRO SERV;BAC PRO 33403 COMMERC. SERVICES EN RESTAURATION;1;1;0;1;0;0;0;0;0;0;0;0;0;1
9986.0;2022;27;CORSE;MASCULIN;ENSEIGNEMENT A DISTANCE;BAC PROFESSIONNEL;BAC PRO SERV;BAC PRO 30001 GESTION-ADMINISTRATION;1;1;1;0;0;0;0;1;0;0;0;0;1;0
9995.0;2022;27;CORSE;MASCULIN;SCOLAIRE;BAC GENERAL;BAC GENERAL;BAC GENE 10019 BAC GENERAL;610;610;561;15;34;25;9;586;13;72;138;212;151;24
9997.0;2022;27;CORSE;MASCULIN;SCOLAIRE;BAC PROFESSIONNEL;BAC PRO PROD;BAC PRO 22703 TECHN.INSTALL.SYST.ENERG.CLIMATI;7;7;4;2;1;1;0;5;0;0;0;1;4;2
10002.0;2022;27;CORSE;MASCULIN;SCOLAIRE;BAC PROFESSIONNEL;BAC PRO PROD;BAC PRO 25214 MAINT.VEHIC.OPTA VOIT.PARTICUL.;13;13;10;3;0;0;0;10;0;0;1;6;3;3
10008.0;2022;27;CORSE;MASCULIN;SCOLAIRE;BAC PROFESSIONNEL;BAC PRO PROD;BAC PRO 25515 SYST.NUM.OPT.C RES.INF.SYST.COMM.;22;22;21;1;0;0;0;21;0;2;4;8;7;1
10011.0;2022;27;CORSE;MASCULIN;SCOLAIRE;BAC PROFESSIONNEL;BAC PRO PROD;BAC PRO AG 21303 FORET;9;8;7;1;0;0;0;7;0;0;1;0;6;1
10018.0;2022;27;CORSE;MASCULIN;SCOLAIRE;BAC PROFESSIONNEL;BAC PRO SERV;BAC PRO 31214 MET.COM.VEN.OP.B PR.CL.VA.OF.COM.;24;24;22;1;1;1;0;23;0;0;2;13;8;1
10020.0;2022;27;CORSE;MASCULIN;SCOLAIRE;BAC PROFESSIONNEL;BAC PRO SERV;BAC PRO 33403 COMMERC. SERVICES EN RESTAURATION;14;14;11;2;1;1;0;12;0;0;2;3;7;2
10032.0;2022;27;CORSE;MASCULIN;SCOLAIRE;BAC TECHNOLOGIQUE;BAC STMG;BAC STMG RESSOURCES HUMAINES ET COMMUNICATION;48;48;35;4;9;7;2;42;0;0;1;12;29;6
10039.0;2022;24;CRETEIL;FEMININ;APPRENTISSAGE;BAC PROFESSIONNEL;BAC PRO PROD;BAC PRO 25214 MAINT.VEHIC.OPTA VOIT.PARTICUL.;3;3;3;0;0;0;0;3;0;1;2;0;0;0
10046.0;2022;24;CRETEIL;FEMININ;APPRENTISSAGE;BAC PROFESSIONNEL;BAC PRO SERV;BAC PRO 31212 METIERS DE L'ACCUEIL;13;13;13;0;0;0;0;13;0;8;2;2;1;0
10053.0;2022;24;CRETEIL;FEMININ;APPRENTISSAGE;BAC PROFESSIONNEL;BAC PRO SERV;BAC PRO 34304 HYGIENE PROPRETE STERILISATION;19;19;13;4;2;0;2;13;0;1;1;3;8;6
10068.0;2022;24;CRETEIL;FEMININ;FORMATION CONTINUE;BAC PROFESSIONNEL;BAC PRO SERV;BAC PRO 30001 GESTION-ADMINISTRATION;4;4;4;0;0;0;0;4;0;2;0;0;2;0
10071.0;2022;24;CRETEIL;FEMININ;FORMATION CONTINUE;BAC PROFESSIONNEL;BAC PRO SERV;BAC PRO 32304 PHOTOGRAPHIE;3;3;3;0;0;0;0;3;0;0;0;2;1;0
10089.0;2022;24;CRETEIL;FEMININ;INDIVIDUEL;BAC PROFESSIONNEL;BAC PRO SERV;BAC PRO 33603 ESTHETIQUE COSMETIQUE PARFUMERIE;3;3;0;3;0;0;0;0;0;0;0;0;0;3
10090.0;2022;24;CRETEIL;FEMININ;INDIVIDUEL;BAC TECHNOLOGIQUE;BAC ST2S;BAC ST2S SCIENCES & TECHNO. SANTE & SOCIAL;27;9;2;4;3;1;2;3;0;0;1;0;2;6
10101.0;2022;24;CRETEIL;FEMININ;SCOLAIRE;BAC PROFESSIONNEL;BAC PRO PROD;BAC PRO 22106 CUISINE;57;56;49;4;3;1;2;50;0;2;8;22;18;6
10112.0;2022;24;CRETEIL;FEMININ;SCOLAIRE;BAC PROFESSIONNEL;BAC PRO PROD;BAC PRO 24202 ARTIS.& MET.ART : TAPIS.D'AMEUBL;7;7;7;0;0;0;0;7;0;1;0;4;2;0
10116.0;2022;24;CRETEIL;FEMININ;SCOLAIRE;BAC PROFESSIONNEL;BAC PRO PROD;BAC PRO 25106 TECHNICIEN D'USINAGE;2;2;2;0;0;0;0;2;0;0;2;0;0;0
10121.0;2022;24;CRETEIL;FEMININ;SCOLAIRE;BAC PROFESSIONNEL;BAC PRO PROD;BAC PRO 25406 OUVRAGES DU BATIMENT METALLERIE;2;2;2;0;0;0;0;2;0;0;1;0;1;0
10127.0;2022;24;CRETEIL;FEMININ;SCOLAIRE;BAC PROFESSIONNEL;BAC PRO PROD;BAC PRO 25515 SYST.NUM.OPT.C RES.INF.SYST.COMM.;12;12;11;1;0;0;0;11;0;1;3;4;3;1
10137.0;2022;24;CRETEIL;FEMININ;SCOLAIRE;BAC PROFESSIONNEL;BAC PRO SERV;BAC PRO 31212 METIERS DE L'ACCUEIL;444;441;347;79;15;10;5;357;0;22;83;111;141;84
10139.0;2022;24;CRETEIL;FEMININ;SCOLAIRE;BAC PROFESSIONNEL;BAC PRO SERV;BAC PRO 31214 MET.COM.VEN.OP.B PR.CL.VA.OF.COM.;282;282;251;20;11;5;6;256;0;8;48;105;95;26
10143.0;2022;24;CRETEIL;FEMININ;SCOLAIRE;BAC PROFESSIONNEL;BAC PRO SERV;BAC PRO 32303 ART.& MET.ART:COM.VIS.VIS.PLURI-M;87;87;80;7;0;0;0;80;0;1;29;30;20;7
10145.0;2022;24;CRETEIL;FEMININ;SCOLAIRE;BAC PROFESSIONNEL;BAC PRO SERV;BAC PRO 33002 SERVICES DE PROXIMITE  VIE LOCAL;185;183;157;20;6;4;2;161;0;8;32;61;60;22
10151.0;2022;24;CRETEIL;FEMININ;SCOLAIRE;BAC PROFESSIONNEL;BAC PRO SERV;BAC PRO 34304 HYGIENE PROPRETE STERILISATION;10;10;4;2;4;2;2;6;0;0;0;2;4;4
10153.0;2022;24;CRETEIL;FEMININ;SCOLAIRE;BAC PROFESSIONNEL;BAC PRO SERV;BAC PRO AG 33002 SERV PERS TERRIT;28;27;21;6;0;0;0;21;0;0;0;11;10;6
10162.0;2022;24;CRETEIL;FEMININ;SCOLAIRE;BAC TECHNOLOGIQUE;BAC STL;BAC STL BIOCHIM.-BIOLOGIE-BIOTECHNOL.;145;145;109;11;25;10;15;119;0;4;24;42;49;26
10173.0;2022;24;CRETEIL;MASCULIN;APPRENTISSAGE;BAC PROFESSIONNEL;BAC PRO PROD;BAC PRO 23304 AMENAGEMENT FINITION BATIMENT;12;12;7;2;3;2;1;9;0;1;0;1;7;3
10174.0;2022;24;CRETEIL;MASCULIN;APPRENTISSAGE;BAC PROFESSIONNEL;BAC PRO PROD;BAC PRO 24303 MET. DU CUIR: SELLERIE GARNISSAGE;5;5;5;0;0;0;0;5;0;3;2;0;0;0
10178.0;2022;24;CRETEIL;MASCULIN;APPRENTISSAGE;BAC PROFESSIONNEL;BAC PRO PROD;BAC PRO 25215 MAINT.VEHIC.OPTB VEHIC.TRANS.ROUT;40;39;24;10;5;3;2;27;0;2;5;11;9;12
10189.0;2022;24;CRETEIL;MASCULIN;APPRENTISSAGE;BAC PROFESSIONNEL;BAC PRO PROD;BAC PRO AG 21004 CGEA;7;7;3;4;0;0;0;3;0;0;0;0;3;4
10196.0;2022;24;CRETEIL;MASCULIN;APPRENTISSAGE;BAC PROFESSIONNEL;BAC PRO SERV;BAC PRO 32303 ART.& MET.ART:COM.VIS.VIS.PLURI-M;9;9;5;4;0;0;0;5;0;0;0;0;5;4
10212.0;2022;24;CRETEIL;MASCULIN;FORMATION CONTINUE;BAC PROFESSIONNEL;BAC PRO PROD;BAC PRO 24302 METIERS DU CUIR : MAROQUINERIE;4;4;4;0;0;0;0;4;0;0;1;2;1;0
10216.0;2022;24;CRETEIL;MASCULIN;FORMATION CONTINUE;BAC PROFESSIONNEL;BAC PRO PROD;BAC PRO 25411 TECH.CHAUDRONNERIE INDUSTRIELLE;12;11;7;4;0;0;0;7;0;1;1;4;1;4
10217.0;2022;24;CRETEIL;MASCULIN;FORMATION CONTINUE;BAC PROFESSIONNEL;BAC PRO PROD;BAC PRO 25510 METIERS ELECT. ENVIRON. CONNECTES;76;75;63;10;2;2;0;65;0;13;24;16;12;10
10230.0;2022;24;CRETEIL;MASCULIN;INDIVIDUEL;BAC PROFESSIONNEL;BAC PRO PROD;BAC PRO 25214 MAINT.VEHIC.OPTA VOIT.PARTICUL.;4;4;3;1;0;0;0;3;0;0;1;0;2;1
10236.0;2022;24;CRETEIL;MASCULIN;INDIVIDUEL;BAC PROFESSIONNEL;BAC PRO PROD;BAC PRO 25509 TECHNIC. FROID CONDITIONNEMT AIR;1;1;1;0;0;0;0;1;0;0;0;0;1;0
10247.0;2022;24;CRETEIL;MASCULIN;INDIVIDUEL;BAC PROFESSIONNEL;BAC PRO SERV;BAC PRO 31212 METIERS DE L'ACCUEIL;2;2;1;1;0;0;0;1;0;0;0;0;1;1
10250.0;2022;24;CRETEIL;MASCULIN;INDIVIDUEL;BAC PROFESSIONNEL;BAC PRO SERV;BAC PRO 32303 ART.& MET.ART:COM.VIS.VIS.PLURI-M;1;1;0;1;0;0;0;0;0;0;0;0;0;1
10251.0;2022;24;CRETEIL;MASCULIN;INDIVIDUEL;BAC PROFESSIONNEL;BAC PRO SERV;BAC PRO 33002 SERVICES DE PROXIMITE  VIE LOCAL;1;1;1;0;0;0;0;1;0;0;0;0;1;0
10266.0;2022;24;CRETEIL;MASCULIN;SCOLAIRE;BAC PROFESSIONNEL;BAC PRO PROD;BAC PRO 22106 CUISINE;108;108;70;36;2;1;1;71;0;5;13;21;32;37
10267.0;2022;24;CRETEIL;MASCULIN;SCOLAIRE;BAC PROFESSIONNEL;BAC PRO PROD;BAC PRO 22302 Traitement des matériaux;9;9;6;2;1;1;0;7;0;0;0;4;3;2
10276.0;2022;24;CRETEIL;MASCULIN;SCOLAIRE;BAC PROFESSIONNEL;BAC PRO PROD;BAC PRO 23303 MENUISERIE ALUMINIUM-VERRE;6;6;4;1;1;1;0;5;0;0;0;1;4;1
10277.0;2022;24;CRETEIL;MASCULIN;SCOLAIRE;BAC PROFESSIONNEL;BAC PRO PROD;BAC PRO 23304 AMENAGEMENT FINITION BATIMENT;37;37;28;7;2;2;0;30;0;1;4;11;14;7
10279.0;2022;24;CRETEIL;MASCULIN;SCOLAIRE;BAC PROFESSIONNEL;BAC PRO PROD;BAC PRO 23405 TECHNICIEN MENUISIER AGENCEUR;107;107;72;29;6;4;2;76;0;4;10;30;32;31
10281.0;2022;24;CRETEIL;MASCULIN;SCOLAIRE;BAC PROFESSIONNEL;BAC PRO PROD;BAC PRO 23408 Etude et réalisation d'agencement;8;8;6;2;0;0;0;6;0;0;1;3;2;2
10282.0;2022;24;CRETEIL;MASCULIN;SCOLAIRE;BAC PROFESSIONNEL;BAC PRO PROD;BAC PRO 24202 ARTIS.& MET.ART : TAPIS.D'AMEUBL;1;1;1;0;0;0;0;1;0;0;0;0;1;0
10292.0;2022;24;CRETEIL;MASCULIN;SCOLAIRE;BAC PROFESSIONNEL;BAC PRO PROD;BAC PRO 25219 MAINT.MATERIELS OPT.A AGRICOLES;6;6;6;0;0;0;0;6;0;0;0;2;4;0
10296.0;2022;24;CRETEIL;MASCULIN;SCOLAIRE;BAC PROFESSIONNEL;BAC PRO PROD;BAC PRO 25303 AERONAUTIQUE OPTION SYSTEMES;16;16;15;1;0;0;0;15;0;3;6;5;1;1
10297.0;2022;24;CRETEIL;MASCULIN;SCOLAIRE;BAC PROFESSIONNEL;BAC PRO PROD;BAC PRO 25304 AERONAUTIQUE OPTION STRUCTURE;11;11;8;3;0;0;0;8;0;0;2;2;4;3
10299.0;2022;24;CRETEIL;MASCULIN;SCOLAIRE;BAC PROFESSIONNEL;BAC PRO PROD;BAC PRO 25408 REPARATION DES CARROSSERIES;39;39;32;7;0;0;0;32;0;1;10;10;11;7
10302.0;2022;24;CRETEIL;MASCULIN;SCOLAIRE;BAC PROFESSIONNEL;BAC PRO PROD;BAC PRO 25509 TECHNIC. FROID CONDITIONNEMT AIR;109;108;47;59;2;2;0;49;0;5;11;16;17;59
10305.0;2022;24;CRETEIL;MASCULIN;SCOLAIRE;BAC PROFESSIONNEL;BAC PRO PROD;BAC PRO 25514 SYST.NUM.OPT.B AUD.RES.EQUIP.DOM.;89;89;81;6;2;2;0;83;0;5;24;33;21;6
10316.0;2022;24;CRETEIL;MASCULIN;SCOLAIRE;BAC PROFESSIONNEL;BAC PRO SERV;BAC PRO 31108 TRANSPORT;30;30;21;8;1;1;0;22;0;0;0;5;17;8
10332.0;2022;24;CRETEIL;MASCULIN;SCOLAIRE;BAC PROFESSIONNEL;BAC PRO SERV;BAC PRO 34304 HYGIENE PROPRETE STERILISATION;11;11;8;0;3;0;3;8;0;1;3;1;3;3
10337.0;2022;24;CRETEIL;MASCULIN;SCOLAIRE;BAC TECHNOLOGIQUE;BAC STD2A;BAC STD2A SCIENCES & TECHNO. DESIGN-ARTS APPLIQUES;60;60;42;5;13;5;8;47;0;2;5;20;20;13
10342.0;2022;24;CRETEIL;MASCULIN;SCOLAIRE;BAC TECHNOLOGIQUE;BAC STI2D;BAC STI2D SYSTÈME D'INFORMATION  ET NUMERIQUE;757;757;601;55;101;69;32;670;0;14;89;208;359;87
10343.0;2022;24;CRETEIL;MASCULIN;SCOLAIRE;BAC TECHNOLOGIQUE;BAC STL;BAC STL BIOCHIM.-BIOLOGIE-BIOTECHNOL.;105;105;74;7;24;13;11;87;0;0;6;22;59;18
10346.0;2022;24;CRETEIL;MASCULIN;SCOLAIRE;BAC TECHNOLOGIQUE;BAC STMG;BAC STMG MERCATIQUE (MARKETING);1631;1631;1205;127;299;236;63;1441;0;10;93;456;882;190
10349.0;2022;07;DIJON;FEMININ;APPRENTISSAGE;BAC PROFESSIONNEL;BAC PRO PROD;BAC PRO 22106 CUISINE;7;7;7;0;0;0;0;7;0;1;2;2;2;0
10350.0;2022;07;DIJON;FEMININ;APPRENTISSAGE;BAC PROFESSIONNEL;BAC PRO PROD;BAC PRO 22704 TECHN. MAINT. SYST.ENERG.CLIMATI;1;1;1;0;0;0;0;1;0;0;0;0;1;0
10351.0;2022;07;DIJON;FEMININ;APPRENTISSAGE;BAC PROFESSIONNEL;BAC PRO PROD;BAC PRO 22705 TECHNICIEN GAZ;1;1;1;0;0;0;0;1;0;1;0;0;0;0
10354.0;2022;07;DIJON;FEMININ;APPRENTISSAGE;BAC PROFESSIONNEL;BAC PRO PROD;BAC PRO 23304 AMENAGEMENT FINITION BATIMENT;2;2;2;0;0;0;0;2;0;0;2;0;0;0
10375.0;2022;07;DIJON;FEMININ;APPRENTISSAGE;BAC PROFESSIONNEL;BAC PRO SERV;BAC PRO AG 33002 SERV PERS TERRIT;4;4;4;0;0;0;0;4;0;0;0;1;3;0
10379.0;2022;07;DIJON;FEMININ;ENSEIGNEMENT A DISTANCE;BAC PROFESSIONNEL;BAC PRO SERV;BAC PRO 33004 ACC.SOINS-S.PERS. OPT.EN STRUCTUR;1;1;0;1;0;0;0;0;0;0;0;0;0;1
10405.0;2022;07;DIJON;FEMININ;SCOLAIRE;BAC PROFESSIONNEL;BAC PRO PROD;BAC PRO 23004 TECHN. ETUDES BAT.A ETUDES & ECO.;1;1;0;1;0;0;0;0;0;0;0;0;0;1
10406.0;2022;07;DIJON;FEMININ;SCOLAIRE;BAC PROFESSIONNEL;BAC PRO PROD;BAC PRO 23005 TECHN. ETUDES BAT B ASSIST.ARCHI.;2;2;1;1;0;0;0;1;0;0;1;0;0;1
10410.0;2022;07;DIJON;FEMININ;SCOLAIRE;BAC PROFESSIONNEL;BAC PRO PROD;BAC PRO 23304 AMENAGEMENT FINITION BATIMENT;6;6;6;0;0;0;0;6;0;1;1;1;3;0
10411.0;2022;07;DIJON;FEMININ;SCOLAIRE;BAC PROFESSIONNEL;BAC PRO PROD;BAC PRO 23405 TECHNICIEN MENUISIER AGENCEUR;4;4;3;1;0;0;0;3;0;0;0;1;2;1
10412.0;2022;07;DIJON;FEMININ;SCOLAIRE;BAC PROFESSIONNEL;BAC PRO PROD;BAC PRO 23408 Etude et réalisation d'agencement;8;8;8;0;0;0;0;8;0;1;1;5;1;0
10414.0;2022;07;DIJON;FEMININ;SCOLAIRE;BAC PROFESSIONNEL;BAC PRO PROD;BAC PRO 24203 METIERS DE LA MODE - VÊTEMENT;63;63;55;8;0;0;0;55;0;6;11;23;15;8
10419.0;2022;07;DIJON;FEMININ;SCOLAIRE;BAC PROFESSIONNEL;BAC PRO PROD;BAC PRO 25214 MAINT.VEHIC.OPTA VOIT.PARTICUL.;7;7;6;1;0;0;0;6;0;0;1;3;2;1
10432.0;2022;07;DIJON;FEMININ;SCOLAIRE;BAC PROFESSIONNEL;BAC PRO PROD;BAC PRO AG 22106 TEC CONS VTE ALIMENTATION VINS SP;12;12;8;4;0;0;0;8;0;1;1;3;3;4
10433.0;2022;07;DIJON;FEMININ;SCOLAIRE;BAC PROFESSIONNEL;BAC PRO PROD;BAC PRO AG 22107 TEC CONS VTE ALIMENTATION P.ALIM;42;41;34;7;0;0;0;34;0;0;1;14;19;7
10434.0;2022;07;DIJON;FEMININ;SCOLAIRE;BAC PROFESSIONNEL;BAC PRO SERV;BAC PRO 30001 GESTION-ADMINISTRATION;273;273;215;45;13;9;4;224;0;8;46;84;86;49
10437.0;2022;07;DIJON;FEMININ;SCOLAIRE;BAC PROFESSIONNEL;BAC PRO SERV;BAC PRO 31212 METIERS DE L'ACCUEIL;91;91;80;4;7;4;3;84;0;6;20;32;26;7
10443.0;2022;07;DIJON;FEMININ;SCOLAIRE;BAC PROFESSIONNEL;BAC PRO SERV;BAC PRO 33003 ACC.SOINS-S.PERS. OPT.A DOMICILE;104;104;83;11;10;7;3;90;0;2;16;39;33;14
10447.0;2022;07;DIJON;FEMININ;SCOLAIRE;BAC PROFESSIONNEL;BAC PRO SERV;BAC PRO 33103 TECHNICIEN APPAREIL. ORTHOPEDIQUE;6;6;6;0;0;0;0;6;0;0;1;4;1;0
10455.0;2022;07;DIJON;FEMININ;SCOLAIRE;BAC TECHNOLOGIQUE;BAC S2TMD;BAC S2TMD MUSIQUE;2;2;2;0;0;0;0;2;0;0;1;1;0;0
10458.0;2022;07;DIJON;FEMININ;SCOLAIRE;BAC TECHNOLOGIQUE;BAC STD2A;BAC STD2A SCIENCES & TECHNO. DESIGN-ARTS APPLIQUES;41;41;40;1;0;0;0;40;0;0;18;11;11;1
10464.0;2022;07;DIJON;FEMININ;SCOLAIRE;BAC TECHNOLOGIQUE;BAC STL;BAC STL BIOCHIM.-BIOLOGIE-BIOTECHNOL.;69;69;55;3;11;6;5;61;0;5;13;15;28;8
10468.0;2022;07;DIJON;FEMININ;SCOLAIRE;BAC TECHNOLOGIQUE;BAC STMG;BAC STMG RESSOURCES HUMAINES ET COMMUNICATION;310;310;239;13;58;37;21;276;0;2;14;89;171;34
10470.0;2022;07;DIJON;MASCULIN;APPRENTISSAGE;BAC PROFESSIONNEL;BAC PRO PROD;BAC PRO 20102 PILOTE DE LIGNE DE PRODUCTION;1;1;0;1;0;0;0;0;0;0;0;0;0;1
10474.0;2022;07;DIJON;MASCULIN;APPRENTISSAGE;BAC PROFESSIONNEL;BAC PRO PROD;BAC PRO 22705 TECHNICIEN GAZ;7;7;7;0;0;0;0;7;0;4;2;1;0;0
10479.0;2022;07;DIJON;MASCULIN;APPRENTISSAGE;BAC PROFESSIONNEL;BAC PRO PROD;BAC PRO 23205 INTERV. SUR PATRIMOINE BATI OPT.A;1;1;1;0;0;0;0;1;0;0;1;0;0;0
10483.0;2022;07;DIJON;MASCULIN;APPRENTISSAGE;BAC PROFESSIONNEL;BAC PRO PROD;BAC PRO 23404 TECHNICIEN CONSTRUCTEUR BOIS;2;2;2;0;0;0;0;2;0;0;2;0;0;0
10488.0;2022;07;DIJON;MASCULIN;APPRENTISSAGE;BAC PROFESSIONNEL;BAC PRO PROD;BAC PRO 25106 TECHNICIEN D'USINAGE;19;19;17;2;0;0;0;17;0;0;7;8;2;2
10490.0;2022;07;DIJON;MASCULIN;APPRENTISSAGE;BAC PROFESSIONNEL;BAC PRO PROD;BAC PRO 25214 MAINT.VEHIC.OPTA VOIT.PARTICUL.;119;115;87;20;8;4;4;91;0;6;6;30;49;24
10493.0;2022;07;DIJON;MASCULIN;APPRENTISSAGE;BAC PROFESSIONNEL;BAC PRO PROD;BAC PRO 25219 MAINT.MATERIELS OPT.A AGRICOLES;19;19;19;0;0;0;0;19;0;2;5;8;4;0
10494.0;2022;07;DIJON;MASCULIN;APPRENTISSAGE;BAC PROFESSIONNEL;BAC PRO PROD;BAC PRO 25408 REPARATION DES CARROSSERIES;25;25;18;5;2;2;0;20;0;0;3;7;10;5
10503.0;2022;07;DIJON;MASCULIN;APPRENTISSAGE;BAC PROFESSIONNEL;BAC PRO PROD;BAC PRO AG 21114 CONDUITE PRODUCTIONS HORTICOLES;2;2;1;1;0;0;0;1;0;0;0;0;1;1
10505.0;2022;07;DIJON;MASCULIN;APPRENTISSAGE;BAC PROFESSIONNEL;BAC PRO PROD;BAC PRO AG 21211 COND GEST ENTR HIPPIQUE;1;1;1;0;0;0;0;1;0;0;1;0;0;0
10506.0;2022;07;DIJON;MASCULIN;APPRENTISSAGE;BAC PROFESSIONNEL;BAC PRO PROD;BAC PRO AG 21405 AMENAGEMENTS PAYSAGERS;81;78;77;1;0;0;0;77;0;0;10;28;39;1
10512.0;2022;07;DIJON;MASCULIN;APPRENTISSAGE;BAC PROFESSIONNEL;BAC PRO SERV;BAC PRO 31213 MET.COM.VEN.OP.A ANI.GES.ESP.COM.;37;31;22;6;3;3;0;25;0;0;4;9;12;6
10516.0;2022;07;DIJON;MASCULIN;APPRENTISSAGE;BAC PROFESSIONNEL;BAC PRO SERV;BAC PRO 33403 COMMERC. SERVICES EN RESTAURATION;9;8;6;2;0;0;0;6;0;0;1;3;2;2
10519.0;2022;07;DIJON;MASCULIN;ENSEIGNEMENT A DISTANCE;BAC GENERAL;BAC GENERAL;BAC GENE 10019 BAC GENERAL;23;22;17;4;1;1;0;18;1;0;3;6;8;4
10544.0;2022;07;DIJON;MASCULIN;INDIVIDUEL;BAC TECHNOLOGIQUE;BAC S2TMD;BAC S2TMD DANSE;1;1;1;0;0;0;0;1;0;1;0;0;0;0
10550.0;2022;07;DIJON;MASCULIN;INDIVIDUEL;BAC TECHNOLOGIQUE;BAC STMG;BAC STMG MERCATIQUE (MARKETING);10;8;3;2;3;1;2;4;0;0;0;0;4;4
10552.0;2022;07;DIJON;MASCULIN;SCOLAIRE;BAC GENERAL;BAC GENERAL;BAC GENE 10019 BAC GENERAL;3400;3400;3055;57;288;193;95;3248;39;322;718;1039;1130;152
10556.0;2022;07;DIJON;MASCULIN;SCOLAIRE;BAC PROFESSIONNEL;BAC PRO PROD;BAC PRO 22004 PROC. CHIMIE EAU PAPIERS-CARTONS;4;4;3;1;0;0;0;3;0;1;1;1;0;1
10561.0;2022;07;DIJON;MASCULIN;SCOLAIRE;BAC PROFESSIONNEL;BAC PRO PROD;BAC PRO 22704 TECHN. MAINT. SYST.ENERG.CLIMATI;23;23;17;6;0;0;0;17;0;1;1;6;9;6
10570.0;2022;07;DIJON;MASCULIN;SCOLAIRE;BAC PROFESSIONNEL;BAC PRO PROD;BAC PRO 23404 TECHNICIEN CONSTRUCTEUR BOIS;18;18;11;7;0;0;0;11;0;0;1;3;7;7
10575.0;2022;07;DIJON;MASCULIN;SCOLAIRE;BAC PROFESSIONNEL;BAC PRO PROD;BAC PRO 24302 METIERS DU CUIR : MAROQUINERIE;1;1;1;0;0;0;0;1;0;0;0;0;1;0
10578.0;2022;07;DIJON;MASCULIN;SCOLAIRE;BAC PROFESSIONNEL;BAC PRO PROD;BAC PRO 25107 TECHNICIEN OUTILLEUR;16;16;9;6;1;1;0;10;0;0;3;1;6;6
10590.0;2022;07;DIJON;MASCULIN;SCOLAIRE;BAC PROFESSIONNEL;BAC PRO PROD;BAC PRO 25509 TECHNIC. FROID CONDITIONNEMT AIR;18;18;11;6;1;0;1;11;0;1;2;5;3;7
10592.0;2022;07;DIJON;MASCULIN;SCOLAIRE;BAC PROFESSIONNEL;BAC PRO PROD;BAC PRO 25513 SYST.NUM.OPT.A SURETE SECURITE;31;31;26;5;0;0;0;26;0;1;5;13;7;5
10594.0;2022;07;DIJON;MASCULIN;SCOLAIRE;BAC PROFESSIONNEL;BAC PRO PROD;BAC PRO 25515 SYST.NUM.OPT.C RES.INF.SYST.COMM.;69;69;67;2;0;0;0;67;0;11;22;23;11;2
10595.0;2022;07;DIJON;MASCULIN;SCOLAIRE;BAC PROFESSIONNEL;BAC PRO PROD;BAC PRO AG 21001 AGRO-EQUIPEMENT;4;4;4;0;0;0;0;4;0;0;0;2;2;0
10612.0;2022;07;DIJON;MASCULIN;SCOLAIRE;BAC PROFESSIONNEL;BAC PRO SERV;BAC PRO 31212 METIERS DE L'ACCUEIL;45;44;38;4;2;1;1;39;0;0;5;13;21;5
10614.0;2022;07;DIJON;MASCULIN;SCOLAIRE;BAC PROFESSIONNEL;BAC PRO SERV;BAC PRO 31214 MET.COM.VEN.OP.B PR.CL.VA.OF.COM.;81;79;64;13;2;2;0;66;0;3;7;23;33;13
10618.0;2022;07;DIJON;MASCULIN;SCOLAIRE;BAC PROFESSIONNEL;BAC PRO SERV;BAC PRO 33003 ACC.SOINS-S.PERS. OPT.A DOMICILE;4;4;4;0;0;0;0;4;0;0;0;1;3;0
10626.0;2022;07;DIJON;MASCULIN;SCOLAIRE;BAC PROFESSIONNEL;BAC PRO SERV;BAC PRO 34403 METIERS DE LA SECURITE;60;59;59;0;0;0;0;59;0;9;18;22;10;0
10629.0;2022;07;DIJON;MASCULIN;SCOLAIRE;BAC TECHNOLOGIQUE;BAC ST2S;BAC ST2S SCIENCES & TECHNO. SANTE & SOCIAL;57;57;45;1;11;6;5;51;0;2;6;13;30;6
10640.0;2022;07;DIJON;MASCULIN;SCOLAIRE;BAC TECHNOLOGIQUE;BAC STMG;BAC STMG MERCATIQUE (MARKETING);340;340;250;16;74;58;16;308;0;0;17;76;215;32
10641.0;2022;07;DIJON;MASCULIN;SCOLAIRE;BAC TECHNOLOGIQUE;BAC STMG;BAC STMG RESSOURCES HUMAINES ET COMMUNICATION;125;125;86;11;28;17;11;103;0;0;4;30;69;22
10652.0;2022;08;GRENOBLE;FEMININ;APPRENTISSAGE;BAC PROFESSIONNEL;BAC PRO PROD;BAC PRO 25214 MAINT.VEHIC.OPTA VOIT.PARTICUL.;6;6;6;0;0;0;0;6;0;0;1;4;1;0
10660.0;2022;08;GRENOBLE;FEMININ;APPRENTISSAGE;BAC PROFESSIONNEL;BAC PRO PROD;BAC PRO AG 21405 AMENAGEMENTS PAYSAGERS;6;5;4;1;0;0;0;4;0;0;0;1;3;1
10664.0;2022;08;GRENOBLE;FEMININ;APPRENTISSAGE;BAC PROFESSIONNEL;BAC PRO SERV;BAC PRO 31108 TRANSPORT;4;4;3;1;0;0;0;3;0;0;2;0;1;1
10672.0;2022;08;GRENOBLE;FEMININ;APPRENTISSAGE;BAC PROFESSIONNEL;BAC PRO SERV;BAC PRO 34403 METIERS DE LA SECURITE;2;2;2;0;0;0;0;2;0;0;0;1;1;0
10674.0;2022;08;GRENOBLE;FEMININ;ENSEIGNEMENT A DISTANCE;BAC GENERAL;BAC GENERAL;BAC GENE 10019 BAC GENERAL;88;85;72;9;4;2;2;74;1;8;15;29;21;11
10675.0;2022;08;GRENOBLE;FEMININ;ENSEIGNEMENT A DISTANCE;BAC PROFESSIONNEL;BAC PRO PROD;BAC PRO 24203 METIERS DE LA MODE - VÊTEMENT;1;1;0;1;0;0;0;0;0;0;0;0;0;1
10677.0;2022;08;GRENOBLE;FEMININ;ENSEIGNEMENT A DISTANCE;BAC PROFESSIONNEL;BAC PRO SERV;BAC PRO 30001 GESTION-ADMINISTRATION;10;10;7;3;0;0;0;7;0;0;0;6;1;3
10681.0;2022;08;GRENOBLE;FEMININ;ENSEIGNEMENT A DISTANCE;BAC PROFESSIONNEL;BAC PRO SERV;BAC PRO 33603 ESTHETIQUE COSMETIQUE PARFUMERIE;1;0;0;0;0;0;0;0;0;0;0;0;0;0
10682.0;2022;08;GRENOBLE;FEMININ;ENSEIGNEMENT A DISTANCE;BAC TECHNOLOGIQUE;BAC ST2S;BAC ST2S SCIENCES & TECHNO. SANTE & SOCIAL;4;4;0;3;1;1;0;1;0;0;0;0;1;3
10686.0;2022;08;GRENOBLE;FEMININ;FORMATION CONTINUE;BAC PROFESSIONNEL;BAC PRO PROD;BAC PRO 24302 METIERS DU CUIR : MAROQUINERIE;1;1;1;0;0;0;0;1;0;0;0;1;0;0
10690.0;2022;08;GRENOBLE;FEMININ;INDIVIDUEL;BAC GENERAL;BAC GENERAL;BAC GENE 10019 BAC GENERAL;79;54;26;14;14;9;5;35;0;6;6;6;17;19
10692.0;2022;08;GRENOBLE;FEMININ;INDIVIDUEL;BAC PROFESSIONNEL;BAC PRO PROD;BAC PRO 24203 METIERS DE LA MODE - VÊTEMENT;1;1;1;0;0;0;0;1;0;0;0;0;1;0
10695.0;2022;08;GRENOBLE;FEMININ;INDIVIDUEL;BAC PROFESSIONNEL;BAC PRO PROD;BAC PRO AG 21114 CONDUITE PRODUCTIONS HORTICOLES;5;5;3;2;0;0;0;3;0;0;0;0;3;2
10703.0;2022;08;GRENOBLE;FEMININ;INDIVIDUEL;BAC PROFESSIONNEL;BAC PRO SERV;BAC PRO 33004 ACC.SOINS-S.PERS. OPT.EN STRUCTUR;5;4;1;3;0;0;0;1;0;0;0;0;1;3
10711.0;2022;08;GRENOBLE;FEMININ;SCOLAIRE;BAC GENERAL;BAC GENERAL;BAC GENE 10019 BAC GENERAL;10778;10778;10139;103;536;389;147;10528;194;1621;2891;3297;2525;250
10712.0;2022;08;GRENOBLE;FEMININ;SCOLAIRE;BAC PROFESSIONNEL;BAC PRO PROD;BACPRO 20002 ETUD.DEFINITION PRDTS INDUSTRIEL;4;4;3;1;0;0;0;3;0;0;0;0;3;1
10713.0;2022;08;GRENOBLE;FEMININ;SCOLAIRE;BAC PROFESSIONNEL;BAC PRO PROD;BAC PRO 20102 PILOTE DE LIGNE DE PRODUCTION;4;4;2;2;0;0;0;2;0;0;0;2;0;2
10714.0;2022;08;GRENOBLE;FEMININ;SCOLAIRE;BAC PROFESSIONNEL;BAC PRO PROD;BAC PRO 22003 BIO-INDUSTRIES DE TRANSFORMATION;7;7;7;0;0;0;0;7;0;0;4;2;1;0
10716.0;2022;08;GRENOBLE;FEMININ;SCOLAIRE;BAC PROFESSIONNEL;BAC PRO PROD;BAC PRO 22105 BOULANGER-PÂTISSIER;24;24;24;0;0;0;0;24;0;5;8;8;3;0
10718.0;2022;08;GRENOBLE;FEMININ;SCOLAIRE;BAC PROFESSIONNEL;BAC PRO PROD;BAC PRO 22704 TECHN. MAINT. SYST.ENERG.CLIMATI;1;1;1;0;0;0;0;1;0;0;0;1;0;0
10721.0;2022;08;GRENOBLE;FEMININ;SCOLAIRE;BAC PROFESSIONNEL;BAC PRO PROD;BAC PRO 23005 TECHN. ETUDES BAT B ASSIST.ARCHI.;16;16;16;0;0;0;0;16;0;1;4;8;3;0
10726.0;2022;08;GRENOBLE;FEMININ;SCOLAIRE;BAC PROFESSIONNEL;BAC PRO PROD;BAC PRO 23405 TECHNICIEN MENUISIER AGENCEUR;5;5;4;0;1;1;0;5;0;1;1;1;2;0
10728.0;2022;08;GRENOBLE;FEMININ;SCOLAIRE;BAC PROFESSIONNEL;BAC PRO PROD;BAC PRO 24202 ARTIS.& MET.ART : TAPIS.D'AMEUBL;8;8;7;0;1;1;0;8;0;1;1;2;4;0
10729.0;2022;08;GRENOBLE;FEMININ;SCOLAIRE;BAC PROFESSIONNEL;BAC PRO PROD;BAC PRO 24203 METIERS DE LA MODE - VÊTEMENT;114;114;93;14;7;4;3;97;0;10;24;27;36;17
10737.0;2022;08;GRENOBLE;FEMININ;SCOLAIRE;BAC PROFESSIONNEL;BAC PRO PROD;BAC PRO 25406 OUVRAGES DU BATIMENT METALLERIE;1;1;1;0;0;0;0;1;0;0;0;1;0;0
10759.0;2022;08;GRENOBLE;FEMININ;SCOLAIRE;BAC PROFESSIONNEL;BAC PRO SERV;BAC PRO 31107 CONDUCT. TRANSP.ROUT.MARCHANDISES;3;3;2;1;0;0;0;2;0;0;0;2;0;1
10766.0;2022;08;GRENOBLE;FEMININ;SCOLAIRE;BAC PROFESSIONNEL;BAC PRO SERV;BAC PRO 32208 REAL.PR.IMPR.PLURI.OPTB.PR.IMPR.;4;4;3;1;0;0;0;3;0;0;1;1;1;1
10769.0;2022;08;GRENOBLE;FEMININ;SCOLAIRE;BAC PROFESSIONNEL;BAC PRO SERV;BAC PRO 33003 ACC.SOINS-S.PERS. OPT.A DOMICILE;153;153;126;21;6;6;0;132;0;5;26;53;48;21
10777.0;2022;08;GRENOBLE;FEMININ;SCOLAIRE;BAC PROFESSIONNEL;BAC PRO SERV;BAC PRO AG 33002 SERV PERS TERRIT;437;432;391;41;0;0;0;391;0;14;50;159;168;41
10778.0;2022;08;GRENOBLE;FEMININ;SCOLAIRE;BAC TECHNOLOGIQUE;BAC S2TMD;BAC S2TMD DANSE;7;7;7;0;0;0;0;7;0;0;2;4;1;0
10791.0;2022;08;GRENOBLE;FEMININ;SCOLAIRE;BAC TECHNOLOGIQUE;BAC STMG;BAC STMG MERCATIQUE (MARKETING);1137;1137;959;37;141;99;42;1058;1;20;143;367;527;79
10792.0;2022;08;GRENOBLE;FEMININ;SCOLAIRE;BAC TECHNOLOGIQUE;BAC STMG;BAC STMG RESSOURCES HUMAINES ET COMMUNICATION;719;719;577;28;114;77;37;654;0;10;70;210;364;65
10794.0;2022;08;GRENOBLE;MASCULIN;APPRENTISSAGE;BAC PROFESSIONNEL;BAC PRO PROD;BACPRO 20002 ETUD.DEFINITION PRDTS INDUSTRIEL;3;3;3;0;0;0;0;3;0;0;2;0;1;0
10797.0;2022;08;GRENOBLE;MASCULIN;APPRENTISSAGE;BAC PROFESSIONNEL;BAC PRO PROD;BAC PRO 22004 PROC. CHIMIE EAU PAPIERS-CARTONS;21;21;21;0;0;0;0;21;0;14;5;2;0;0
10809.0;2022;08;GRENOBLE;MASCULIN;APPRENTISSAGE;BAC PROFESSIONNEL;BAC PRO PROD;BAC PRO 24302 METIERS DU CUIR : MAROQUINERIE;1;1;1;0;0;0;0;1;0;0;1;0;0;0
10810.0;2022;08;GRENOBLE;MASCULIN;APPRENTISSAGE;BAC PROFESSIONNEL;BAC PRO PROD;BAC PRO 25005 PRODUCTIQ.MECA. OPT.DECOLLETAGE;2;2;0;2;0;0;0;0;0;0;0;0;0;2
10814.0;2022;08;GRENOBLE;MASCULIN;APPRENTISSAGE;BAC PROFESSIONNEL;BAC PRO PROD;BAC PRO 25106 TECHNICIEN D'USINAGE;79;79;60;13;6;5;1;65;0;6;15;21;23;14
10816.0;2022;08;GRENOBLE;MASCULIN;APPRENTISSAGE;BAC PROFESSIONNEL;BAC PRO PROD;BAC PRO 25214 MAINT.VEHIC.OPTA VOIT.PARTICUL.;251;246;210;32;4;2;2;212;0;14;38;97;63;34
10820.0;2022;08;GRENOBLE;MASCULIN;APPRENTISSAGE;BAC PROFESSIONNEL;BAC PRO PROD;BAC PRO 25220 MAINT.MATERIELS OPT.B TP MANUT.;31;31;25;6;0;0;0;25;0;3;6;6;10;6
10823.0;2022;08;GRENOBLE;MASCULIN;APPRENTISSAGE;BAC PROFESSIONNEL;BAC PRO PROD;BAC PRO 25406 OUVRAGES DU BATIMENT METALLERIE;3;3;1;1;1;1;0;2;0;0;0;0;2;1
10825.0;2022;08;GRENOBLE;MASCULIN;APPRENTISSAGE;BAC PROFESSIONNEL;BAC PRO PROD;BAC PRO 25411 TECH.CHAUDRONNERIE INDUSTRIELLE;85;85;68;13;4;3;1;71;0;7;13;32;19;14
10830.0;2022;08;GRENOBLE;MASCULIN;APPRENTISSAGE;BAC PROFESSIONNEL;BAC PRO PROD;BAC PRO AG 21114 CONDUITE PRODUCTIONS HORTICOLES;2;2;1;1;0;0;0;1;0;1;0;0;0;1
10832.0;2022;08;GRENOBLE;MASCULIN;APPRENTISSAGE;BAC PROFESSIONNEL;BAC PRO PROD;BAC PRO AG 21302 GEST MILIEUX NATURELS FAUNE;2;1;1;0;0;0;0;1;0;0;0;1;0;0
10837.0;2022;08;GRENOBLE;MASCULIN;APPRENTISSAGE;BAC PROFESSIONNEL;BAC PRO SERV;BAC PRO 31106 LOGISTIQUE;52;52;45;6;1;0;1;45;0;5;14;19;7;7
10844.0;2022;08;GRENOBLE;MASCULIN;APPRENTISSAGE;BAC PROFESSIONNEL;BAC PRO SERV;BAC PRO 33403 COMMERC. SERVICES EN RESTAURATION;11;11;6;3;2;2;0;8;0;1;1;1;5;3
10849.0;2022;08;GRENOBLE;MASCULIN;ENSEIGNEMENT A DISTANCE;BAC PROFESSIONNEL;BAC PRO SERV;BAC PRO 31213 MET.COM.VEN.OP.A ANI.GES.ESP.COM.;4;3;1;2;0;0;0;1;0;0;0;0;1;2
10864.0;2022;08;GRENOBLE;MASCULIN;INDIVIDUEL;BAC PROFESSIONNEL;BAC PRO PROD;BAC PRO 25006 MICROTECHNIQUES;3;2;2;0;0;0;0;2;0;0;0;0;2;0
10869.0;2022;08;GRENOBLE;MASCULIN;INDIVIDUEL;BAC PROFESSIONNEL;BAC PRO PROD;BAC PRO 25510 METIERS ELECT. ENVIRON. CONNECTES;6;3;2;1;0;0;0;2;0;0;0;0;2;1
10870.0;2022;08;GRENOBLE;MASCULIN;INDIVIDUEL;BAC PROFESSIONNEL;BAC PRO PROD;BAC PRO AG 21004 CGEA;3;2;2;0;0;0;0;2;0;0;0;0;2;0
10871.0;2022;08;GRENOBLE;MASCULIN;INDIVIDUEL;BAC PROFESSIONNEL;BAC PRO PROD;BAC PRO AG 21113 CGEVV;2;2;2;0;0;0;0;2;0;0;0;0;2;0
10883.0;2022;08;GRENOBLE;MASCULIN;INDIVIDUEL;BAC TECHNOLOGIQUE;BAC STI2D;BAC STI2D ARCHITECTURE ET CONSTRUCTION;2;2;1;1;0;0;0;1;0;0;0;0;1;1
10885.0;2022;08;GRENOBLE;MASCULIN;INDIVIDUEL;BAC TECHNOLOGIQUE;BAC STI2D;BAC STI2D INNOVATION TECHNO.  ET ECO CONCEPTION;2;2;1;1;0;0;0;1;0;0;0;0;1;1
10886.0;2022;08;GRENOBLE;MASCULIN;INDIVIDUEL;BAC TECHNOLOGIQUE;BAC STL;BAC STL BIOCHIM.-BIOLOGIE-BIOTECHNOL.;1;0;0;0;0;0;0;0;0;0;0;0;0;0
10887.0;2022;08;GRENOBLE;MASCULIN;INDIVIDUEL;BAC TECHNOLOGIQUE;BAC STL;BAC STL SCIENCES PHYSIQUES CHIMIQUES  EN LABORAT.;1;0;0;0;0;0;0;0;0;0;0;0;0;0
10889.0;2022;08;GRENOBLE;MASCULIN;INDIVIDUEL;BAC TECHNOLOGIQUE;BAC STMG;BAC STMG MERCATIQUE (MARKETING);10;5;2;3;0;0;0;2;0;0;0;0;2;3
10893.0;2022;08;GRENOBLE;MASCULIN;SCOLAIRE;BAC PROFESSIONNEL;BAC PRO PROD;BACPRO 20002 ETUD.DEFINITION PRDTS INDUSTRIEL;67;67;46;21;0;0;0;46;0;5;5;19;17;21
10895.0;2022;08;GRENOBLE;MASCULIN;SCOLAIRE;BAC PROFESSIONNEL;BAC PRO PROD;BAC PRO 22003 BIO-INDUSTRIES DE TRANSFORMATION;3;3;3;0;0;0;0;3;0;0;0;1;2;0
10897.0;2022;08;GRENOBLE;MASCULIN;SCOLAIRE;BAC PROFESSIONNEL;BAC PRO PROD;BAC PRO 22105 BOULANGER-PÂTISSIER;25;25;24;1;0;0;0;24;0;2;8;9;5;1
10908.0;2022;08;GRENOBLE;MASCULIN;SCOLAIRE;BAC PROFESSIONNEL;BAC PRO PROD;BAC PRO 23304 AMENAGEMENT FINITION BATIMENT;20;20;19;0;1;1;0;20;0;3;2;6;9;0
10914.0;2022;08;GRENOBLE;MASCULIN;SCOLAIRE;BAC PROFESSIONNEL;BAC PRO PROD;BAC PRO 24301 METIERS DU CUIR : CHAUSSURES;1;1;1;0;0;0;0;1;0;0;0;0;1;0
10917.0;2022;08;GRENOBLE;MASCULIN;SCOLAIRE;BAC PROFESSIONNEL;BAC PRO PROD;BAC PRO 25006 MICROTECHNIQUES;58;58;47;11;0;0;0;47;0;1;15;18;13;11
10931.0;2022;08;GRENOBLE;MASCULIN;SCOLAIRE;BAC PROFESSIONNEL;BAC PRO PROD;BAC PRO 25514 SYST.NUM.OPT.B AUD.RES.EQUIP.DOM.;77;77;69;7;1;1;0;70;0;6;14;31;19;7
10932.0;2022;08;GRENOBLE;MASCULIN;SCOLAIRE;BAC PROFESSIONNEL;BAC PRO PROD;BAC PRO 25515 SYST.NUM.OPT.C RES.INF.SYST.COMM.;172;171;141;28;2;1;1;142;0;17;37;59;29;29
10934.0;2022;08;GRENOBLE;MASCULIN;SCOLAIRE;BAC PROFESSIONNEL;BAC PRO PROD;BAC PRO AG 21004 CGEA;101;99;91;8;0;0;0;91;0;4;14;38;35;8
10938.0;2022;08;GRENOBLE;MASCULIN;SCOLAIRE;BAC PROFESSIONNEL;BAC PRO PROD;BAC PRO AG 21210 COND GEST ENTR CANIN ET FELIN;7;7;3;4;0;0;0;3;0;0;0;1;2;4
10944.0;2022;08;GRENOBLE;MASCULIN;SCOLAIRE;BAC PROFESSIONNEL;BAC PRO PROD;BAC PRO AG 22105 LABORATOIRE CONTROLE QUALITE;12;12;12;0;0;0;0;12;0;2;2;4;4;0
10952.0;2022;08;GRENOBLE;MASCULIN;SCOLAIRE;BAC PROFESSIONNEL;BAC PRO SERV;BAC PRO 31213 MET.COM.VEN.OP.A ANI.GES.ESP.COM.;403;402;339;43;20;17;3;356;0;7;57;154;138;46
10955.0;2022;08;GRENOBLE;MASCULIN;SCOLAIRE;BAC PROFESSIONNEL;BAC PRO SERV;BAC PRO 32208 REAL.PR.IMPR.PLURI.OPTB.PR.IMPR.;5;5;5;0;0;0;0;5;0;0;2;2;1;0
10958.0;2022;08;GRENOBLE;MASCULIN;SCOLAIRE;BAC PROFESSIONNEL;BAC PRO SERV;BAC PRO 33003 ACC.SOINS-S.PERS. OPT.A DOMICILE;5;5;3;2;0;0;0;3;0;0;1;1;1;2
10980.0;2022;08;GRENOBLE;MASCULIN;SCOLAIRE;BAC TECHNOLOGIQUE;BAC STMG;BAC STMG MERCATIQUE (MARKETING);1092;1092;795;83;214;149;65;944;0;4;47;286;607;148
10985.0;2022;32;GUADELOUPE;FEMININ;APPRENTISSAGE;BAC PROFESSIONNEL;BAC PRO SERV;BAC PRO 33004 ACC.SOINS-S.PERS. OPT.EN STRUCTUR;2;1;0;1;0;0;0;0;0;0;0;0;0;1
10987.0;2022;32;GUADELOUPE;FEMININ;ENSEIGNEMENT A DISTANCE;BAC GENERAL;BAC GENERAL;BAC GENE 10019 BAC GENERAL;9;9;8;0;1;1;0;9;0;0;3;2;4;0
10990.0;2022;32;GUADELOUPE;FEMININ;ENSEIGNEMENT A DISTANCE;BAC TECHNOLOGIQUE;BAC ST2S;BAC ST2S SCIENCES & TECHNO. SANTE & SOCIAL;1;1;0;0;1;0;1;0;0;0;0;0;0;1
10997.0;2022;32;GUADELOUPE;FEMININ;INDIVIDUEL;BAC PROFESSIONNEL;BAC PRO PROD;BAC PRO 23003 ARTIS. & M.ART:MARCHANDISAGE VIS.;1;1;0;1;0;0;0;0;0;0;0;0;0;1
11003.0;2022;32;GUADELOUPE;FEMININ;INDIVIDUEL;BAC PROFESSIONNEL;BAC PRO SERV;BAC PRO 31213 MET.COM.VEN.OP.A ANI.GES.ESP.COM.;3;2;2;0;0;0;0;2;0;0;0;2;0;0
11008.0;2022;32;GUADELOUPE;FEMININ;SCOLAIRE;BAC GENERAL;BAC GENERAL;BAC GENE 10019 BAC GENERAL;1612;1612;1408;23;181;141;40;1549;28;169;332;452;568;63
11010.0;2022;32;GUADELOUPE;FEMININ;SCOLAIRE;BAC PROFESSIONNEL;BAC PRO PROD;BAC PRO 22105 BOULANGER-PÂTISSIER;7;7;7;0;0;0;0;7;0;0;3;2;2;0
11011.0;2022;32;GUADELOUPE;FEMININ;SCOLAIRE;BAC PROFESSIONNEL;BAC PRO PROD;BAC PRO 22106 CUISINE;20;20;12;8;0;0;0;12;0;0;2;5;5;8
11014.0;2022;32;GUADELOUPE;FEMININ;SCOLAIRE;BAC PROFESSIONNEL;BAC PRO PROD;BAC PRO 23004 TECHN. ETUDES BAT.A ETUDES & ECO.;4;4;2;2;0;0;0;2;0;0;0;0;2;2
11018.0;2022;32;GUADELOUPE;FEMININ;SCOLAIRE;BAC PROFESSIONNEL;BAC PRO PROD;BAC PRO 23405 TECHNICIEN MENUISIER AGENCEUR;6;6;3;3;0;0;0;3;0;0;0;1;2;3
11021.0;2022;32;GUADELOUPE;FEMININ;SCOLAIRE;BAC PROFESSIONNEL;BAC PRO PROD;BAC PRO 25009 MAINTENANCE NAUTIQUE;3;3;2;0;1;1;0;3;0;0;0;0;3;0
11023.0;2022;32;GUADELOUPE;FEMININ;SCOLAIRE;BAC PROFESSIONNEL;BAC PRO PROD;BAC PRO 25219 MAINT.MATERIELS OPT.A AGRICOLES;1;1;1;0;0;0;0;1;0;0;1;0;0;0
11027.0;2022;32;GUADELOUPE;FEMININ;SCOLAIRE;BAC PROFESSIONNEL;BAC PRO PROD;BAC PRO 25510 METIERS ELECT. ENVIRON. CONNECTES;3;3;3;0;0;0;0;3;0;0;0;3;0;0
11033.0;2022;32;GUADELOUPE;FEMININ;SCOLAIRE;BAC PROFESSIONNEL;BAC PRO PROD;BAC PRO AG 21405 AMENAGEMENTS PAYSAGERS;6;6;6;0;0;0;0;6;0;0;0;2;4;0
11037.0;2022;32;GUADELOUPE;FEMININ;SCOLAIRE;BAC PROFESSIONNEL;BAC PRO SERV;BAC PRO 31108 TRANSPORT;8;8;3;5;0;0;0;3;0;0;2;1;0;5
11041.0;2022;32;GUADELOUPE;FEMININ;SCOLAIRE;BAC PROFESSIONNEL;BAC PRO SERV;BAC PRO 32303 ART.& MET.ART:COM.VIS.VIS.PLURI-M;7;7;6;1;0;0;0;6;0;0;4;2;0;1
11044.0;2022;32;GUADELOUPE;FEMININ;SCOLAIRE;BAC PROFESSIONNEL;BAC PRO SERV;BAC PRO 33004 ACC.SOINS-S.PERS. OPT.EN STRUCTUR;90;90;54;28;8;6;2;60;0;1;3;20;36;30
11047.0;2022;32;GUADELOUPE;FEMININ;SCOLAIRE;BAC PROFESSIONNEL;BAC PRO SERV;BAC PRO 34304 HYGIENE PROPRETE STERILISATION;22;22;12;6;4;2;2;14;0;0;1;5;8;8
11050.0;2022;32;GUADELOUPE;FEMININ;SCOLAIRE;BAC TECHNOLOGIQUE;BAC S2TMD;BAC S2TMD DANSE;2;2;2;0;0;0;0;2;0;0;1;1;0;0
11052.0;2022;32;GUADELOUPE;FEMININ;SCOLAIRE;BAC TECHNOLOGIQUE;BAC ST2S;BAC ST2S SCIENCES & TECHNO. SANTE & SOCIAL;224;224;187;1;36;30;6;217;0;6;21;75;115;7
11061.0;2022;32;GUADELOUPE;FEMININ;SCOLAIRE;BAC TECHNOLOGIQUE;BAC STL;BAC STL SCIENCES PHYSIQUES CHIMIQUES  EN LABORAT.;16;16;9;2;5;5;0;14;0;0;1;3;10;2
11077.0;2022;32;GUADELOUPE;MASCULIN;FORMATION CONTINUE;BAC PROFESSIONNEL;BAC PRO PROD;BAC PRO 25214 MAINT.VEHIC.OPTA VOIT.PARTICUL.;5;2;1;1;0;0;0;1;0;0;0;0;1;1
11079.0;2022;32;GUADELOUPE;MASCULIN;FORMATION CONTINUE;BAC PROFESSIONNEL;BAC PRO SERV;BAC PRO 30001 GESTION-ADMINISTRATION;1;0;0;0;0;0;0;0;0;0;0;0;0;0
11083.0;2022;32;GUADELOUPE;MASCULIN;INDIVIDUEL;BAC PROFESSIONNEL;BAC PRO PROD;BAC PRO 22106 CUISINE;1;1;0;1;0;0;0;0;0;0;0;0;0;1
11084.0;2022;32;GUADELOUPE;MASCULIN;INDIVIDUEL;BAC PROFESSIONNEL;BAC PRO PROD;BAC PRO 23304 AMENAGEMENT FINITION BATIMENT;1;0;0;0;0;0;0;0;0;0;0;0;0;0
11090.0;2022;32;GUADELOUPE;MASCULIN;INDIVIDUEL;BAC PROFESSIONNEL;BAC PRO SERV;BAC PRO 33003 ACC.SOINS-S.PERS. OPT.A DOMICILE;1;0;0;0;0;0;0;0;0;0;0;0;0;0
11104.0;2022;32;GUADELOUPE;MASCULIN;SCOLAIRE;BAC PROFESSIONNEL;BAC PRO PROD;BAC PRO 23005 TECHN. ETUDES BAT B ASSIST.ARCHI.;10;10;4;5;1;1;0;5;0;0;0;1;4;5
11106.0;2022;32;GUADELOUPE;MASCULIN;SCOLAIRE;BAC PROFESSIONNEL;BAC PRO PROD;BAC PRO 23303 MENUISERIE ALUMINIUM-VERRE;20;20;13;2;5;1;4;14;0;0;1;2;11;6
11114.0;2022;32;GUADELOUPE;MASCULIN;SCOLAIRE;BAC PROFESSIONNEL;BAC PRO PROD;BAC PRO 25214 MAINT.VEHIC.OPTA VOIT.PARTICUL.;86;79;55;12;12;7;5;62;0;0;7;19;36;17
11123.0;2022;32;GUADELOUPE;MASCULIN;SCOLAIRE;BAC PROFESSIONNEL;BAC PRO PROD;BAC PRO 25509 TECHNIC. FROID CONDITIONNEMT AIR;55;53;35;7;11;10;1;45;0;0;5;12;28;8
11134.0;2022;32;GUADELOUPE;MASCULIN;SCOLAIRE;BAC PROFESSIONNEL;BAC PRO SERV;BAC PRO 31108 TRANSPORT;24;24;13;11;0;0;0;13;0;0;0;6;7;11
11135.0;2022;32;GUADELOUPE;MASCULIN;SCOLAIRE;BAC PROFESSIONNEL;BAC PRO SERV;BAC PRO 31212 METIERS DE L'ACCUEIL;19;19;12;6;1;1;0;13;0;0;3;5;5;6
11141.0;2022;32;GUADELOUPE;MASCULIN;SCOLAIRE;BAC PROFESSIONNEL;BAC PRO SERV;BAC PRO 33004 ACC.SOINS-S.PERS. OPT.EN STRUCTUR;2;2;2;0;0;0;0;2;0;0;0;0;2;0
11150.0;2022;32;GUADELOUPE;MASCULIN;SCOLAIRE;BAC TECHNOLOGIQUE;BAC STAV;BAC STAV AGRONOMIE ALIM ENV TERRITOI;13;13;13;0;0;0;0;13;0;0;0;4;9;0
11160.0;2022;32;GUADELOUPE;MASCULIN;SCOLAIRE;BAC TECHNOLOGIQUE;BAC STMG;BAC STMG MERCATIQUE (MARKETING);105;105;88;3;14;14;0;102;0;0;9;38;55;3
11166.0;2022;33;GUYANE;FEMININ;ENSEIGNEMENT A DISTANCE;BAC GENERAL;BAC GENERAL;BAC GENE 10019 BAC GENERAL;1;1;0;0;1;1;0;1;0;0;0;0;1;0
11172.0;2022;33;GUYANE;FEMININ;INDIVIDUEL;BAC PROFESSIONNEL;BAC PRO PROD;BAC PRO 24203 METIERS DE LA MODE - VÊTEMENT;1;1;0;1;0;0;0;0;0;0;0;0;0;1
11176.0;2022;33;GUYANE;FEMININ;INDIVIDUEL;BAC PROFESSIONNEL;BAC PRO SERV;BAC PRO 31214 MET.COM.VEN.OP.B PR.CL.VA.OF.COM.;1;1;0;1;0;0;0;0;0;0;0;0;0;1
11179.0;2022;33;GUYANE;FEMININ;INDIVIDUEL;BAC PROFESSIONNEL;BAC PRO SERV;BAC PRO 33004 ACC.SOINS-S.PERS. OPT.EN STRUCTUR;2;2;1;0;1;1;0;2;0;0;0;0;2;0
11182.0;2022;33;GUYANE;FEMININ;INDIVIDUEL;BAC TECHNOLOGIQUE;BAC STMG;BAC STMG GESTION ET FINANCE;2;1;0;1;0;0;0;0;0;0;0;0;0;1
11187.0;2022;33;GUYANE;FEMININ;SCOLAIRE;BAC PROFESSIONNEL;BAC PRO PROD;BAC PRO 22106 CUISINE;13;13;7;3;3;2;1;9;0;0;2;3;4;4
11191.0;2022;33;GUYANE;FEMININ;SCOLAIRE;BAC PROFESSIONNEL;BAC PRO PROD;BACPRO 23103 TECHNICIEN GEOMETRE-TOPOGRAPHE;1;1;0;1;0;0;0;0;0;0;0;0;0;1
11193.0;2022;33;GUYANE;FEMININ;SCOLAIRE;BAC PROFESSIONNEL;BAC PRO PROD;BAC PRO 23303 MENUISERIE ALUMINIUM-VERRE;5;5;4;0;1;0;1;4;0;0;0;2;2;1
11200.0;2022;33;GUYANE;FEMININ;SCOLAIRE;BAC PROFESSIONNEL;BAC PRO PROD;BAC PRO 25510 METIERS ELECT. ENVIRON. CONNECTES;2;2;1;1;0;0;0;1;0;0;0;1;0;1
11205.0;2022;33;GUYANE;FEMININ;SCOLAIRE;BAC PROFESSIONNEL;BAC PRO SERV;BAC PRO 30001 GESTION-ADMINISTRATION;137;136;93;30;13;13;0;106;0;1;15;35;55;30
11210.0;2022;33;GUYANE;FEMININ;SCOLAIRE;BAC PROFESSIONNEL;BAC PRO SERV;BAC PRO 31214 MET.COM.VEN.OP.B PR.CL.VA.OF.COM.;26;26;14;11;1;1;0;15;0;0;0;3;12;11
11211.0;2022;33;GUYANE;FEMININ;SCOLAIRE;BAC PROFESSIONNEL;BAC PRO SERV;BAC PRO 32303 ART.& MET.ART:COM.VIS.VIS.PLURI-M;1;1;0;1;0;0;0;0;0;0;0;0;0;1
11217.0;2022;33;GUYANE;FEMININ;SCOLAIRE;BAC PROFESSIONNEL;BAC PRO SERV;BAC PRO 34304 HYGIENE PROPRETE STERILISATION;15;15;11;3;1;0;1;11;0;0;1;2;8;4
11226.0;2022;33;GUYANE;FEMININ;SCOLAIRE;BAC TECHNOLOGIQUE;BAC STI2D;BAC STI2D SYSTÈME D'INFORMATION  ET NUMERIQUE;3;3;1;0;2;1;1;2;0;0;0;0;2;1
11231.0;2022;33;GUYANE;FEMININ;SCOLAIRE;BAC TECHNOLOGIQUE;BAC STMG;BAC STMG RESSOURCES HUMAINES ET COMMUNICATION;76;76;43;9;24;17;7;60;0;0;1;15;44;16
11240.0;2022;33;GUYANE;MASCULIN;INDIVIDUEL;BAC PROFESSIONNEL;BAC PRO PROD;BAC PRO 25214 MAINT.VEHIC.OPTA VOIT.PARTICUL.;1;1;0;1;0;0;0;0;0;0;0;0;0;1
11249.0;2022;33;GUYANE;MASCULIN;SCOLAIRE;BAC PROFESSIONNEL;BAC PRO PROD;BAC PRO 22104 BOUCHER CHARCUTIER TRAITEUR;10;10;4;4;2;2;0;6;0;0;2;0;4;4
11256.0;2022;33;GUYANE;MASCULIN;SCOLAIRE;BAC PROFESSIONNEL;BAC PRO PROD;BAC PRO 23203 TECHNICIEN BAT. : ORG.REAL.GROS O;32;32;20;11;1;0;1;20;0;0;1;5;14;12
11263.0;2022;33;GUYANE;MASCULIN;SCOLAIRE;BAC PROFESSIONNEL;BAC PRO PROD;BAC PRO 24203 METIERS DE LA MODE - VÊTEMENT;3;3;2;1;0;0;0;2;0;0;0;0;2;1
11266.0;2022;33;GUYANE;MASCULIN;SCOLAIRE;BAC PROFESSIONNEL;BAC PRO PROD;BAC PRO 25215 MAINT.VEHIC.OPTB VEHIC.TRANS.ROUT;15;14;8;3;3;0;3;8;0;0;0;1;7;6
11273.0;2022;33;GUYANE;MASCULIN;SCOLAIRE;BAC PROFESSIONNEL;BAC PRO PROD;BAC PRO AG 21114 CONDUITE PRODUCTIONS HORTICOLES;7;7;4;3;0;0;0;4;0;0;0;1;3;3
11276.0;2022;33;GUYANE;MASCULIN;SCOLAIRE;BAC PROFESSIONNEL;BAC PRO SERV;BAC PRO 30001 GESTION-ADMINISTRATION;77;77;53;17;7;4;3;57;0;0;4;23;30;20
11281.0;2022;33;GUYANE;MASCULIN;SCOLAIRE;BAC PROFESSIONNEL;BAC PRO SERV;BAC PRO 31214 MET.COM.VEN.OP.B PR.CL.VA.OF.COM.;29;29;18;10;1;1;0;19;0;0;0;5;14;10
11285.0;2022;33;GUYANE;MASCULIN;SCOLAIRE;BAC PROFESSIONNEL;BAC PRO SERV;BAC PRO 33004 ACC.SOINS-S.PERS. OPT.EN STRUCTUR;1;1;1;0;0;0;0;1;0;0;0;0;1;0
11293.0;2022;33;GUYANE;MASCULIN;SCOLAIRE;BAC TECHNOLOGIQUE;BAC STHR;BAC STHR SC.&TEC. HOTELLERIE-RESTAURATION;9;9;6;2;1;1;0;7;0;0;0;3;4;2
11294.0;2022;33;GUYANE;MASCULIN;SCOLAIRE;BAC TECHNOLOGIQUE;BAC STI2D;BAC STI2D ARCHITECTURE ET CONSTRUCTION;18;18;7;3;8;6;2;13;0;0;0;4;9;5
11300.0;2022;33;GUYANE;MASCULIN;SCOLAIRE;BAC TECHNOLOGIQUE;BAC STMG;BAC STMG GESTION ET FINANCE;41;41;21;5;15;15;0;36;0;2;3;7;24;5
11302.0;2022;33;GUYANE;MASCULIN;SCOLAIRE;BAC TECHNOLOGIQUE;BAC STMG;BAC STMG RESSOURCES HUMAINES ET COMMUNICATION;28;28;11;7;10;9;1;20;0;0;2;2;16;8
11308.0;2022;28;LA REUNION;FEMININ;APPRENTISSAGE;BAC PROFESSIONNEL;BAC PRO SERV;BAC PRO 31213 MET.COM.VEN.OP.A ANI.GES.ESP.COM.;3;2;1;1;0;0;0;1;0;0;0;1;0;1
11317.0;2022;28;LA REUNION;FEMININ;INDIVIDUEL;BAC PROFESSIONNEL;BAC PRO SERV;BAC PRO 31214 MET.COM.VEN.OP.B PR.CL.VA.OF.COM.;1;1;0;1;0;0;0;0;0;0;0;0;0;1
11340.0;2022;28;LA REUNION;FEMININ;SCOLAIRE;BAC PROFESSIONNEL;BAC PRO PROD;BAC PRO 23303 MENUISERIE ALUMINIUM-VERRE;1;1;1;0;0;0;0;1;0;0;1;0;0;0
11341.0;2022;28;LA REUNION;FEMININ;SCOLAIRE;BAC PROFESSIONNEL;BAC PRO PROD;BAC PRO 23304 AMENAGEMENT FINITION BATIMENT;1;1;1;0;0;0;0;1;0;0;0;0;1;0
11344.0;2022;28;LA REUNION;FEMININ;SCOLAIRE;BAC PROFESSIONNEL;BAC PRO PROD;BAC PRO 24203 METIERS DE LA MODE - VÊTEMENT;30;30;23;7;0;0;0;23;0;4;6;7;6;7
11348.0;2022;28;LA REUNION;FEMININ;SCOLAIRE;BAC PROFESSIONNEL;BAC PRO PROD;BAC PRO 25303 AERONAUTIQUE OPTION SYSTEMES;1;1;1;0;0;0;0;1;0;0;0;1;0;0
11350.0;2022;28;LA REUNION;FEMININ;SCOLAIRE;BAC PROFESSIONNEL;BAC PRO PROD;BAC PRO 25510 METIERS ELECT. ENVIRON. CONNECTES;2;2;1;1;0;0;0;1;0;0;0;0;1;1
11361.0;2022;28;LA REUNION;FEMININ;SCOLAIRE;BAC PROFESSIONNEL;BAC PRO SERV;BAC PRO 31213 MET.COM.VEN.OP.A ANI.GES.ESP.COM.;229;228;168;45;15;14;1;182;0;5;31;54;92;46
11362.0;2022;28;LA REUNION;FEMININ;SCOLAIRE;BAC PROFESSIONNEL;BAC PRO SERV;BAC PRO 31214 MET.COM.VEN.OP.B PR.CL.VA.OF.COM.;29;29;28;0;1;1;0;29;0;4;4;9;12;0
11367.0;2022;28;LA REUNION;FEMININ;SCOLAIRE;BAC PROFESSIONNEL;BAC PRO SERV;BAC PRO 33004 ACC.SOINS-S.PERS. OPT.EN STRUCTUR;163;163;143;14;6;6;0;149;0;12;40;55;42;14
11370.0;2022;28;LA REUNION;FEMININ;SCOLAIRE;BAC PROFESSIONNEL;BAC PRO SERV;BAC PRO 33603 ESTHETIQUE COSMETIQUE PARFUMERIE;22;22;21;1;0;0;0;21;0;0;3;8;10;1
11371.0;2022;28;LA REUNION;FEMININ;SCOLAIRE;BAC PROFESSIONNEL;BAC PRO SERV;BAC PRO 34303 GEST. POLLUTIONS PROTEC. ENVIRON.;2;2;2;0;0;0;0;2;0;0;0;2;0;0
11373.0;2022;28;LA REUNION;FEMININ;SCOLAIRE;BAC PROFESSIONNEL;BAC PRO SERV;BAC PRO 34403 METIERS DE LA SECURITE;23;23;20;3;0;0;0;20;0;0;3;9;8;3
11382.0;2022;28;LA REUNION;FEMININ;SCOLAIRE;BAC TECHNOLOGIQUE;BAC STI2D;BAC STI2D SYSTÈME D'INFORMATION  ET NUMERIQUE;14;14;9;0;5;4;1;13;0;0;0;4;9;1
11389.0;2022;28;LA REUNION;MASCULIN;APPRENTISSAGE;BAC PROFESSIONNEL;BAC PRO PROD;BAC PRO 20102 PILOTE DE LIGNE DE PRODUCTION;1;1;1;0;0;0;0;1;0;0;0;1;0;0
11391.0;2022;28;LA REUNION;MASCULIN;APPRENTISSAGE;BAC PROFESSIONNEL;BAC PRO PROD;BAC PRO 23203 TECHNICIEN BAT. : ORG.REAL.GROS O;1;1;1;0;0;0;0;1;0;0;1;0;0;0
11393.0;2022;28;LA REUNION;MASCULIN;APPRENTISSAGE;BAC PROFESSIONNEL;BAC PRO PROD;BAC PRO 23304 AMENAGEMENT FINITION BATIMENT;1;0;0;0;0;0;0;0;0;0;0;0;0;0
11396.0;2022;28;LA REUNION;MASCULIN;APPRENTISSAGE;BAC PROFESSIONNEL;BAC PRO PROD;BAC PRO 25214 MAINT.VEHIC.OPTA VOIT.PARTICUL.;22;20;11;7;2;1;1;12;0;0;2;3;7;8
11400.0;2022;28;LA REUNION;MASCULIN;APPRENTISSAGE;BAC PROFESSIONNEL;BAC PRO PROD;BAC PRO 25510 METIERS ELECT. ENVIRON. CONNECTES;4;3;3;0;0;0;0;3;0;0;0;2;1;0
11404.0;2022;28;LA REUNION;MASCULIN;ENSEIGNEMENT A DISTANCE;BAC GENERAL;BAC GENERAL;BAC GENE 10019 BAC GENERAL;8;7;3;2;2;1;1;4;0;1;0;0;3;3
11406.0;2022;28;LA REUNION;MASCULIN;ENSEIGNEMENT A DISTANCE;BAC TECHNOLOGIQUE;BAC STMG;BAC STMG MERCATIQUE (MARKETING);1;1;1;0;0;0;0;1;0;0;0;0;1;0
11408.0;2022;28;LA REUNION;MASCULIN;FORMATION CONTINUE;BAC PROFESSIONNEL;BAC PRO SERV;BAC PRO 31106 LOGISTIQUE;3;0;0;0;0;0;0;0;0;0;0;0;0;0
11410.0;2022;28;LA REUNION;MASCULIN;INDIVIDUEL;BAC PROFESSIONNEL;BAC PRO PROD;BAC PRO 23102 TRAVAUX PUBLICS;2;2;0;2;0;0;0;0;0;0;0;0;0;2
11413.0;2022;28;LA REUNION;MASCULIN;INDIVIDUEL;BAC PROFESSIONNEL;BAC PRO PROD;BAC PRO 25406 OUVRAGES DU BATIMENT METALLERIE;1;1;1;0;0;0;0;1;0;0;1;0;0;0
11426.0;2022;28;LA REUNION;MASCULIN;SCOLAIRE;BAC PROFESSIONNEL;BAC PRO PROD;BAC PRO 20102 PILOTE DE LIGNE DE PRODUCTION;5;5;4;1;0;0;0;4;0;0;1;2;1;1
11433.0;2022;28;LA REUNION;MASCULIN;SCOLAIRE;BAC PROFESSIONNEL;BAC PRO PROD;BAC PRO 22704 TECHN. MAINT. SYST.ENERG.CLIMATI;19;19;13;5;1;1;0;14;0;0;0;7;7;5
11440.0;2022;28;LA REUNION;MASCULIN;SCOLAIRE;BAC PROFESSIONNEL;BAC PRO PROD;BAC PRO 23205 INTERV. SUR PATRIMOINE BATI OPT.A;3;3;3;0;0;0;0;3;0;0;2;0;1;0
11453.0;2022;28;LA REUNION;MASCULIN;SCOLAIRE;BAC PROFESSIONNEL;BAC PRO PROD;BAC PRO 25216 MAINT.VEHIC.OPTC MOTOCYCLES;12;12;10;2;0;0;0;10;0;0;1;5;4;2
11454.0;2022;28;LA REUNION;MASCULIN;SCOLAIRE;BAC PROFESSIONNEL;BAC PRO PROD;BAC PRO 25219 MAINT.MATERIELS OPT.A AGRICOLES;3;3;0;3;0;0;0;0;0;0;0;0;0;3
11455.0;2022;28;LA REUNION;MASCULIN;SCOLAIRE;BAC PROFESSIONNEL;BAC PRO PROD;BAC PRO 25220 MAINT.MATERIELS OPT.B TP MANUT.;8;8;6;1;1;0;1;6;0;0;0;2;4;2
11457.0;2022;28;LA REUNION;MASCULIN;SCOLAIRE;BAC PROFESSIONNEL;BAC PRO PROD;BAC PRO 25303 AERONAUTIQUE OPTION SYSTEMES;20;20;18;1;1;1;0;19;0;0;4;8;7;1
11463.0;2022;28;LA REUNION;MASCULIN;SCOLAIRE;BAC PROFESSIONNEL;BAC PRO PROD;BAC PRO 25513 SYST.NUM.OPT.A SURETE SECURITE;19;19;13;5;1;1;0;14;0;0;1;7;6;5
11464.0;2022;28;LA REUNION;MASCULIN;SCOLAIRE;BAC PROFESSIONNEL;BAC PRO PROD;BAC PRO 25514 SYST.NUM.OPT.B AUD.RES.EQUIP.DOM.;30;30;28;1;1;1;0;29;0;1;4;11;13;1
11468.0;2022;28;LA REUNION;MASCULIN;SCOLAIRE;BAC PROFESSIONNEL;BAC PRO PROD;BAC PRO AG 21114 CONDUITE PRODUCTIONS HORTICOLES;14;12;9;3;0;0;0;9;0;0;0;2;7;3
11471.0;2022;28;LA REUNION;MASCULIN;SCOLAIRE;BAC PROFESSIONNEL;BAC PRO PROD;BAC PRO AG 21407 TEC CONS VTE UNIVERS JARDINERIE;10;10;9;1;0;0;0;9;0;0;0;0;9;1
11473.0;2022;28;LA REUNION;MASCULIN;SCOLAIRE;BAC PROFESSIONNEL;BAC PRO SERV;BAC PRO 30001 GESTION-ADMINISTRATION;188;187;147;27;13;12;1;159;0;6;17;54;82;28
11477.0;2022;28;LA REUNION;MASCULIN;SCOLAIRE;BAC PROFESSIONNEL;BAC PRO SERV;BAC PRO 31213 MET.COM.VEN.OP.A ANI.GES.ESP.COM.;199;199;143;42;14;13;1;156;0;4;30;47;75;43
11485.0;2022;28;LA REUNION;MASCULIN;SCOLAIRE;BAC PROFESSIONNEL;BAC PRO SERV;BAC PRO 33101 OPTIQUE LUNETTERIE;7;7;7;0;0;0;0;7;0;0;1;4;2;0
11489.0;2022;28;LA REUNION;MASCULIN;SCOLAIRE;BAC PROFESSIONNEL;BAC PRO SERV;BAC PRO 34403 METIERS DE LA SECURITE;44;44;40;4;0;0;0;40;0;7;7;11;15;4
11490.0;2022;28;LA REUNION;MASCULIN;SCOLAIRE;BAC PROFESSIONNEL;BAC PRO SERV;BAC PRO AG 33002 SERV PERS TERRIT;6;6;5;1;0;0;0;5;0;0;0;1;4;1
11494.0;2022;28;LA REUNION;MASCULIN;SCOLAIRE;BAC TECHNOLOGIQUE;BAC STHR;BAC STHR SC.&TEC. HOTELLERIE-RESTAURATION;10;10;8;0;2;1;1;9;0;0;0;3;6;1
11502.0;2022;28;LA REUNION;MASCULIN;SCOLAIRE;BAC TECHNOLOGIQUE;BAC STMG;BAC STMG MERCATIQUE (MARKETING);315;315;225;22;68;59;9;284;0;4;24;80;176;31
11507.0;2022;09;LILLE;FEMININ;APPRENTISSAGE;BAC PROFESSIONNEL;BAC PRO PROD;BAC PRO 22106 CUISINE;26;24;20;4;0;0;0;20;0;1;6;7;6;4
11509.0;2022;09;LILLE;FEMININ;APPRENTISSAGE;BAC PROFESSIONNEL;BAC PRO PROD;BAC PRO 23004 TECHN. ETUDES BAT.A ETUDES & ECO.;1;1;1;0;0;0;0;1;0;1;0;0;0;0
11510.0;2022;09;LILLE;FEMININ;APPRENTISSAGE;BAC PROFESSIONNEL;BAC PRO PROD;BAC PRO 23005 TECHN. ETUDES BAT B ASSIST.ARCHI.;1;1;1;0;0;0;0;1;0;0;1;0;0;0
11515.0;2022;09;LILLE;FEMININ;APPRENTISSAGE;BAC PROFESSIONNEL;BAC PRO PROD;BAC PRO 25106 TECHNICIEN D'USINAGE;3;3;2;1;0;0;0;2;0;0;1;1;0;1
11525.0;2022;09;LILLE;FEMININ;APPRENTISSAGE;BAC PROFESSIONNEL;BAC PRO PROD;BAC PRO AG 21211 COND GEST ENTR HIPPIQUE;16;16;14;2;0;0;0;14;0;0;0;7;7;2
11527.0;2022;09;LILLE;FEMININ;APPRENTISSAGE;BAC PROFESSIONNEL;BAC PRO PROD;BAC PRO AG 22107 TEC CONS VTE ALIMENTATION P.ALIM;36;30;26;4;0;0;0;26;0;0;3;9;14;4
11535.0;2022;09;LILLE;FEMININ;APPRENTISSAGE;BAC PROFESSIONNEL;BAC PRO SERV;BAC PRO 33603 ESTHETIQUE COSMETIQUE PARFUMERIE;7;6;5;1;0;0;0;5;0;0;1;3;1;1
11556.0;2022;09;LILLE;FEMININ;INDIVIDUEL;BAC PROFESSIONNEL;BAC PRO PROD;BAC PRO 24203 METIERS DE LA MODE - VÊTEMENT;1;1;1;0;0;0;0;1;0;0;0;1;0;0
11570.0;2022;09;LILLE;FEMININ;INDIVIDUEL;BAC TECHNOLOGIQUE;BAC ST2S;BAC ST2S SCIENCES & TECHNO. SANTE & SOCIAL;19;6;5;0;1;0;1;5;0;0;1;1;3;1
11573.0;2022;09;LILLE;FEMININ;INDIVIDUEL;BAC TECHNOLOGIQUE;BAC STMG;BAC STMG MERCATIQUE (MARKETING);12;6;1;1;4;3;1;4;0;0;0;1;3;2
11580.0;2022;09;LILLE;FEMININ;SCOLAIRE;BAC PROFESSIONNEL;BAC PRO PROD;BAC PRO 22106 CUISINE;111;111;97;13;1;0;1;97;0;8;27;28;34;14
11586.0;2022;09;LILLE;FEMININ;SCOLAIRE;BAC PROFESSIONNEL;BAC PRO PROD;BACPRO 23103 TECHNICIEN GEOMETRE-TOPOGRAPHE;1;1;1;0;0;0;0;1;0;0;0;1;0;0
11587.0;2022;09;LILLE;FEMININ;SCOLAIRE;BAC PROFESSIONNEL;BAC PRO PROD;BAC PRO 23203 TECHNICIEN BAT. : ORG.REAL.GROS O;2;2;1;1;0;0;0;1;0;0;0;0;1;1
11593.0;2022;09;LILLE;FEMININ;SCOLAIRE;BAC PROFESSIONNEL;BAC PRO PROD;BAC PRO 24203 METIERS DE LA MODE - VÊTEMENT;123;119;96;21;2;1;1;97;0;26;20;29;22;22
11608.0;2022;09;LILLE;FEMININ;SCOLAIRE;BAC PROFESSIONNEL;BAC PRO PROD;BAC PRO AG 21203 TECHN CONSEIL DE VENTE ANIMAL;35;35;26;9;0;0;0;26;0;0;4;6;16;9
11613.0;2022;09;LILLE;FEMININ;SCOLAIRE;BAC PROFESSIONNEL;BAC PRO PROD;BAC PRO AG 21405 AMENAGEMENTS PAYSAGERS;4;3;2;1;0;0;0;2;0;0;0;1;1;1
11614.0;2022;09;LILLE;FEMININ;SCOLAIRE;BAC PROFESSIONNEL;BAC PRO PROD;BAC PRO AG 21407 TEC CONS VTE UNIVERS JARDINERIE;16;15;14;1;0;0;0;14;0;0;5;4;5;1
11617.0;2022;09;LILLE;FEMININ;SCOLAIRE;BAC PROFESSIONNEL;BAC PRO SERV;BAC PRO 30001 GESTION-ADMINISTRATION;641;639;474;123;42;28;14;502;0;12;76;196;218;137
11618.0;2022;09;LILLE;FEMININ;SCOLAIRE;BAC PROFESSIONNEL;BAC PRO SERV;BAC PRO 31106 LOGISTIQUE;26;26;20;5;1;0;1;20;0;2;4;10;4;6
11619.0;2022;09;LILLE;FEMININ;SCOLAIRE;BAC PROFESSIONNEL;BAC PRO SERV;BAC PRO 31107 CONDUCT. TRANSP.ROUT.MARCHANDISES;7;7;5;2;0;0;0;5;0;1;1;3;0;2
11629.0;2022;09;LILLE;FEMININ;SCOLAIRE;BAC PROFESSIONNEL;BAC PRO SERV;BAC PRO 33003 ACC.SOINS-S.PERS. OPT.A DOMICILE;233;232;177;50;5;4;1;181;0;3;35;57;86;51
11637.0;2022;09;LILLE;FEMININ;SCOLAIRE;BAC PROFESSIONNEL;BAC PRO SERV;BAC PRO 34304 HYGIENE PROPRETE STERILISATION;71;71;51;13;7;1;6;52;0;2;12;17;21;19
11657.0;2022;09;LILLE;MASCULIN;APPRENTISSAGE;BAC PROFESSIONNEL;BAC PRO PROD;BAC PRO 22004 PROC. CHIMIE EAU PAPIERS-CARTONS;6;6;6;0;0;0;0;6;0;1;4;1;0;0
11660.0;2022;09;LILLE;MASCULIN;APPRENTISSAGE;BAC PROFESSIONNEL;BAC PRO PROD;BAC PRO 22403 ARTS.& MET.ART:MET.ENSEIGN SIGNA;1;1;1;0;0;0;0;1;0;1;0;0;0;0
11672.0;2022;09;LILLE;MASCULIN;APPRENTISSAGE;BAC PROFESSIONNEL;BAC PRO PROD;BAC PRO 24203 METIERS DE LA MODE - VÊTEMENT;2;1;1;0;0;0;0;1;0;1;0;0;0;0
11673.0;2022;09;LILLE;MASCULIN;APPRENTISSAGE;BAC PROFESSIONNEL;BAC PRO PROD;BAC PRO 25007 MAINTENANCE EQUIPEMENTS INDUST.;56;55;48;5;2;0;2;48;0;7;16;17;8;7
11676.0;2022;09;LILLE;MASCULIN;APPRENTISSAGE;BAC PROFESSIONNEL;BAC PRO PROD;BAC PRO 25215 MAINT.VEHIC.OPTB VEHIC.TRANS.ROUT;47;47;39;5;3;2;1;41;0;1;6;15;19;6
11690.0;2022;09;LILLE;MASCULIN;APPRENTISSAGE;BAC PROFESSIONNEL;BAC PRO PROD;BAC PRO AG 21004 CGEA;40;36;29;7;0;0;0;29;0;1;1;4;23;7
11699.0;2022;09;LILLE;MASCULIN;APPRENTISSAGE;BAC PROFESSIONNEL;BAC PRO SERV;BAC PRO 31213 MET.COM.VEN.OP.A ANI.GES.ESP.COM.;104;92;57;35;0;0;0;57;0;4;5;24;24;35
11703.0;2022;09;LILLE;MASCULIN;APPRENTISSAGE;BAC PROFESSIONNEL;BAC PRO SERV;BAC PRO 34304 HYGIENE PROPRETE STERILISATION;1;1;1;0;0;0;0;1;0;0;0;1;0;0
11704.0;2022;09;LILLE;MASCULIN;APPRENTISSAGE;BAC PROFESSIONNEL;BAC PRO SERV;BAC PRO AG 33002 SERV PERS TERRIT;1;1;1;0;0;0;0;1;0;0;0;0;1;0
11706.0;2022;09;LILLE;MASCULIN;ENSEIGNEMENT A DISTANCE;BAC PROFESSIONNEL;BAC PRO SERV;BAC PRO 31213 MET.COM.VEN.OP.A ANI.GES.ESP.COM.;2;1;1;0;0;0;0;1;0;0;0;0;1;0
11707.0;2022;09;LILLE;MASCULIN;ENSEIGNEMENT A DISTANCE;BAC PROFESSIONNEL;BAC PRO SERV;BAC PRO 31214 MET.COM.VEN.OP.B PR.CL.VA.OF.COM.;1;1;0;1;0;0;0;0;0;0;0;0;0;1
11713.0;2022;09;LILLE;MASCULIN;FORMATION CONTINUE;BAC PROFESSIONNEL;BAC PRO PROD;BAC PRO 22703 TECHN.INSTALL.SYST.ENERG.CLIMATI;13;12;11;1;0;0;0;11;0;3;5;3;0;1
11715.0;2022;09;LILLE;MASCULIN;FORMATION CONTINUE;BAC PROFESSIONNEL;BAC PRO PROD;BAC PRO 23304 AMENAGEMENT FINITION BATIMENT;2;2;2;0;0;0;0;2;0;1;0;0;1;0
11717.0;2022;09;LILLE;MASCULIN;FORMATION CONTINUE;BAC PROFESSIONNEL;BAC PRO PROD;BAC PRO 23405 TECHNICIEN MENUISIER AGENCEUR;1;1;1;0;0;0;0;1;0;0;1;0;0;0
11718.0;2022;09;LILLE;MASCULIN;FORMATION CONTINUE;BAC PROFESSIONNEL;BAC PRO PROD;BAC PRO 25007 MAINTENANCE EQUIPEMENTS INDUST.;7;4;3;1;0;0;0;3;0;0;1;2;0;1
11729.0;2022;09;LILLE;MASCULIN;INDIVIDUEL;BAC PROFESSIONNEL;BAC PRO PROD;BAC PRO 22703 TECHN.INSTALL.SYST.ENERG.CLIMATI;1;0;0;0;0;0;0;0;0;0;0;0;0;0
11734.0;2022;09;LILLE;MASCULIN;INDIVIDUEL;BAC PROFESSIONNEL;BAC PRO PROD;BAC PRO 25214 MAINT.VEHIC.OPTA VOIT.PARTICUL.;3;3;2;1;0;0;0;2;0;1;0;0;1;1
11740.0;2022;09;LILLE;MASCULIN;INDIVIDUEL;BAC PROFESSIONNEL;BAC PRO PROD;BAC PRO AG 21004 CGEA;2;2;1;1;0;0;0;1;0;0;0;0;1;1
11743.0;2022;09;LILLE;MASCULIN;INDIVIDUEL;BAC PROFESSIONNEL;BAC PRO PROD;BAC PRO AG 21405 AMENAGEMENTS PAYSAGERS;2;0;0;0;0;0;0;0;0;0;0;0;0;0
11755.0;2022;09;LILLE;MASCULIN;INDIVIDUEL;BAC TECHNOLOGIQUE;BAC STL;BAC STL BIOCHIM.-BIOLOGIE-BIOTECHNOL.;2;1;0;1;0;0;0;0;0;0;0;0;0;1
11762.0;2022;09;LILLE;MASCULIN;SCOLAIRE;BAC PROFESSIONNEL;BAC PRO PROD;BAC PRO 22004 PROC. CHIMIE EAU PAPIERS-CARTONS;28;28;19;8;1;1;0;20;0;1;4;4;11;8
11771.0;2022;09;LILLE;MASCULIN;SCOLAIRE;BAC PROFESSIONNEL;BAC PRO PROD;BAC PRO 23003 ARTIS. & M.ART:MARCHANDISAGE VIS.;1;1;1;0;0;0;0;1;0;0;0;0;1;0
11775.0;2022;09;LILLE;MASCULIN;SCOLAIRE;BAC PROFESSIONNEL;BAC PRO PROD;BACPRO 23103 TECHNICIEN GEOMETRE-TOPOGRAPHE;18;18;13;5;0;0;0;13;0;1;3;7;2;5
11776.0;2022;09;LILLE;MASCULIN;SCOLAIRE;BAC PROFESSIONNEL;BAC PRO PROD;BAC PRO 23203 TECHNICIEN BAT. : ORG.REAL.GROS O;88;88;58;29;1;1;0;59;0;0;6;20;33;29
11780.0;2022;09;LILLE;MASCULIN;SCOLAIRE;BAC PROFESSIONNEL;BAC PRO PROD;BAC PRO 23404 TECHNICIEN CONSTRUCTEUR BOIS;38;38;29;8;1;1;0;30;0;0;4;15;11;8
11782.0;2022;09;LILLE;MASCULIN;SCOLAIRE;BAC PROFESSIONNEL;BAC PRO PROD;BAC PRO 23407 TECHNIC.FAB.BOIS ET MATERX ASSOC;71;71;34;36;1;1;0;35;0;2;5;10;18;36
11784.0;2022;09;LILLE;MASCULIN;SCOLAIRE;BAC PROFESSIONNEL;BAC PRO PROD;BAC PRO 24203 METIERS DE LA MODE - VÊTEMENT;12;10;7;2;1;1;0;8;0;1;0;3;4;2
11797.0;2022;09;LILLE;MASCULIN;SCOLAIRE;BAC PROFESSIONNEL;BAC PRO PROD;BAC PRO 25509 TECHNIC. FROID CONDITIONNEMT AIR;67;67;41;22;4;3;1;44;0;3;5;16;20;23
11799.0;2022;09;LILLE;MASCULIN;SCOLAIRE;BAC PROFESSIONNEL;BAC PRO PROD;BAC PRO 25513 SYST.NUM.OPT.A SURETE SECURITE;62;62;43;10;9;4;5;47;0;2;11;13;21;15
11813.0;2022;09;LILLE;MASCULIN;SCOLAIRE;BAC PROFESSIONNEL;BAC PRO PROD;BAC PRO AG 22105 LABORATOIRE CONTROLE QUALITE;18;18;15;3;0;0;0;15;0;0;0;4;11;3
11814.0;2022;09;LILLE;MASCULIN;SCOLAIRE;BAC PROFESSIONNEL;BAC PRO PROD;BAC PRO AG 22107 TEC CONS VTE ALIMENTATION P.ALIM;3;3;3;0;0;0;0;3;0;0;0;0;3;0
11818.0;2022;09;LILLE;MASCULIN;SCOLAIRE;BAC PROFESSIONNEL;BAC PRO SERV;BAC PRO 31108 TRANSPORT;64;64;37;25;2;2;0;39;0;4;3;18;14;25
11825.0;2022;09;LILLE;MASCULIN;SCOLAIRE;BAC PROFESSIONNEL;BAC PRO SERV;BAC PRO 32304 PHOTOGRAPHIE;8;8;6;2;0;0;0;6;0;1;3;2;0;2
11831.0;2022;09;LILLE;MASCULIN;SCOLAIRE;BAC PROFESSIONNEL;BAC PRO SERV;BAC PRO 33103 TECHNICIEN APPAREIL. ORTHOPEDIQUE;11;11;9;2;0;0;0;9;0;0;3;4;2;2
11837.0;2022;09;LILLE;MASCULIN;SCOLAIRE;BAC TECHNOLOGIQUE;BAC S2TMD;BAC S2TMD DANSE;1;1;1;0;0;0;0;1;0;0;0;1;0;0
11847.0;2022;09;LILLE;MASCULIN;SCOLAIRE;BAC TECHNOLOGIQUE;BAC STL;BAC STL BIOCHIM.-BIOLOGIE-BIOTECHNOL.;117;117;91;7;19;7;12;98;0;3;15;31;49;19
11849.0;2022;09;LILLE;MASCULIN;SCOLAIRE;BAC TECHNOLOGIQUE;BAC STMG;BAC STMG GESTION ET FINANCE;499;499;375;33;91;69;22;444;0;6;54;138;246;55
11853.0;2022;22;LIMOGES;FEMININ;APPRENTISSAGE;BAC PROFESSIONNEL;BAC PRO PROD;BAC PRO 23206 INTERV. SUR PATRIMOINE BATI OPT.B;1;1;1;0;0;0;0;1;0;1;0;0;0;0
11856.0;2022;22;LIMOGES;FEMININ;APPRENTISSAGE;BAC PROFESSIONNEL;BAC PRO PROD;BAC PRO 25408 REPARATION DES CARROSSERIES;1;1;1;0;0;0;0;1;0;0;0;0;1;0
11857.0;2022;22;LIMOGES;FEMININ;APPRENTISSAGE;BAC PROFESSIONNEL;BAC PRO PROD;BAC PRO 25510 METIERS ELECT. ENVIRON. CONNECTES;1;1;1;0;0;0;0;1;0;0;0;0;1;0
11864.0;2022;22;LIMOGES;FEMININ;APPRENTISSAGE;BAC PROFESSIONNEL;BAC PRO SERV;BAC PRO 33603 ESTHETIQUE COSMETIQUE PARFUMERIE;2;2;2;0;0;0;0;2;0;0;0;1;1;0
11866.0;2022;22;LIMOGES;FEMININ;ENSEIGNEMENT A DISTANCE;BAC GENERAL;BAC GENERAL;BAC GENE 10019 BAC GENERAL;5;5;4;1;0;0;0;4;1;0;1;1;1;1
11877.0;2022;22;LIMOGES;FEMININ;INDIVIDUEL;BAC PROFESSIONNEL;BAC PRO SERV;BAC PRO 33004 ACC.SOINS-S.PERS. OPT.EN STRUCTUR;2;0;0;0;0;0;0;0;0;0;0;0;0;0
11879.0;2022;22;LIMOGES;FEMININ;INDIVIDUEL;BAC TECHNOLOGIQUE;BAC STAV;BAC STAV AGRONOMIE ALIM ENV TERRITOI;1;1;1;0;0;0;0;1;0;0;0;0;1;0
11882.0;2022;22;LIMOGES;FEMININ;SCOLAIRE;BAC PROFESSIONNEL;BAC PRO PROD;BAC PRO 22105 BOULANGER-PÂTISSIER;16;16;16;0;0;0;0;16;0;2;11;3;0;0
11883.0;2022;22;LIMOGES;FEMININ;SCOLAIRE;BAC PROFESSIONNEL;BAC PRO PROD;BAC PRO 22106 CUISINE;12;12;10;2;0;0;0;10;0;2;0;5;3;2
11886.0;2022;22;LIMOGES;FEMININ;SCOLAIRE;BAC PROFESSIONNEL;BAC PRO PROD;BAC PRO 23102 TRAVAUX PUBLICS;3;3;3;0;0;0;0;3;0;0;2;1;0;0
11887.0;2022;22;LIMOGES;FEMININ;SCOLAIRE;BAC PROFESSIONNEL;BAC PRO PROD;BAC PRO 23405 TECHNICIEN MENUISIER AGENCEUR;1;1;0;1;0;0;0;0;0;0;0;0;0;1
11896.0;2022;22;LIMOGES;FEMININ;SCOLAIRE;BAC PROFESSIONNEL;BAC PRO PROD;BAC PRO 25509 TECHNIC. FROID CONDITIONNEMT AIR;1;1;0;1;0;0;0;0;0;0;0;0;0;1
11902.0;2022;22;LIMOGES;FEMININ;SCOLAIRE;BAC PROFESSIONNEL;BAC PRO PROD;BAC PRO AG 21302 GEST MILIEUX NATURELS FAUNE;6;6;6;0;0;0;0;6;0;1;1;2;2;0
11907.0;2022;22;LIMOGES;FEMININ;SCOLAIRE;BAC PROFESSIONNEL;BAC PRO SERV;BAC PRO 31108 TRANSPORT;2;2;1;0;1;1;0;2;0;0;0;1;1;0
11910.0;2022;22;LIMOGES;FEMININ;SCOLAIRE;BAC PROFESSIONNEL;BAC PRO SERV;BAC PRO 31214 MET.COM.VEN.OP.B PR.CL.VA.OF.COM.;17;17;15;2;0;0;0;15;0;2;2;4;7;2
11921.0;2022;22;LIMOGES;FEMININ;SCOLAIRE;BAC PROFESSIONNEL;BAC PRO SERV;BAC PRO 34403 METIERS DE LA SECURITE;19;19;16;3;0;0;0;16;0;1;2;7;6;3
11925.0;2022;22;LIMOGES;FEMININ;SCOLAIRE;BAC TECHNOLOGIQUE;BAC STD2A;BAC STD2A SCIENCES & TECHNO. DESIGN-ARTS APPLIQUES;28;28;28;0;0;0;0;28;0;1;15;8;4;0
11929.0;2022;22;LIMOGES;FEMININ;SCOLAIRE;BAC TECHNOLOGIQUE;BAC STI2D;BAC STI2D INNOVATION TECHNO.  ET ECO CONCEPTION;5;5;4;0;1;0;1;4;0;0;1;1;2;1
11930.0;2022;22;LIMOGES;FEMININ;SCOLAIRE;BAC TECHNOLOGIQUE;BAC STI2D;BAC STI2D SYSTÈME D'INFORMATION  ET NUMERIQUE;4;4;3;0;1;1;0;4;0;0;0;0;4;0
11949.0;2022;22;LIMOGES;MASCULIN;APPRENTISSAGE;BAC PROFESSIONNEL;BAC PRO PROD;BAC PRO 25106 TECHNICIEN D'USINAGE;10;10;7;2;1;1;0;8;0;0;0;5;3;2
11950.0;2022;22;LIMOGES;MASCULIN;APPRENTISSAGE;BAC PROFESSIONNEL;BAC PRO PROD;BAC PRO 25107 TECHNICIEN OUTILLEUR;2;2;2;0;0;0;0;2;0;0;0;1;1;0
11956.0;2022;22;LIMOGES;MASCULIN;APPRENTISSAGE;BAC PROFESSIONNEL;BAC PRO PROD;BAC PRO 25221 MAINT.MATERIELS OPT.C ESP. VERTS;1;1;1;0;0;0;0;1;0;0;0;0;1;0
11966.0;2022;22;LIMOGES;MASCULIN;APPRENTISSAGE;BAC PROFESSIONNEL;BAC PRO SERV;BAC PRO 33101 OPTIQUE LUNETTERIE;1;1;1;0;0;0;0;1;0;0;0;1;0;0
11968.0;2022;22;LIMOGES;MASCULIN;APPRENTISSAGE;BAC PROFESSIONNEL;BAC PRO SERV;BAC PRO AG 33002 SERV PERS TERRIT;2;2;2;0;0;0;0;2;0;0;1;0;1;0
11971.0;2022;22;LIMOGES;MASCULIN;ENSEIGNEMENT A DISTANCE;BAC TECHNOLOGIQUE;BAC ST2S;BAC ST2S SCIENCES & TECHNO. SANTE & SOCIAL;1;1;0;0;1;1;0;1;0;0;0;0;1;0
11975.0;2022;22;LIMOGES;MASCULIN;INDIVIDUEL;BAC GENERAL;BAC GENERAL;BAC GENE 10019 BAC GENERAL;15;13;2;9;2;2;0;4;0;0;1;0;3;9
11979.0;2022;22;LIMOGES;MASCULIN;INDIVIDUEL;BAC PROFESSIONNEL;BAC PRO PROD;BAC PRO AG 21004 CGEA;1;0;0;0;0;0;0;0;0;0;0;0;0;0
11982.0;2022;22;LIMOGES;MASCULIN;INDIVIDUEL;BAC PROFESSIONNEL;BAC PRO SERV;BAC PRO 31214 MET.COM.VEN.OP.B PR.CL.VA.OF.COM.;1;0;0;0;0;0;0;0;0;0;0;0;0;0
11987.0;2022;22;LIMOGES;MASCULIN;SCOLAIRE;BAC PROFESSIONNEL;BAC PRO PROD;BAC PRO 20102 PILOTE DE LIGNE DE PRODUCTION;11;11;6;3;2;2;0;8;0;1;1;1;5;3
11991.0;2022;22;LIMOGES;MASCULIN;SCOLAIRE;BAC PROFESSIONNEL;BAC PRO PROD;BAC PRO 22106 CUISINE;26;26;22;4;0;0;0;22;0;1;5;4;12;4
11992.0;2022;22;LIMOGES;MASCULIN;SCOLAIRE;BAC PROFESSIONNEL;BAC PRO PROD;BAC PRO 22704 TECHN. MAINT. SYST.ENERG.CLIMATI;4;4;3;1;0;0;0;3;0;0;1;2;0;1
11998.0;2022;22;LIMOGES;MASCULIN;SCOLAIRE;BAC PROFESSIONNEL;BAC PRO PROD;BAC PRO 23404 TECHNICIEN CONSTRUCTEUR BOIS;4;4;4;0;0;0;0;4;0;0;1;0;3;0
12005.0;2022;22;LIMOGES;MASCULIN;SCOLAIRE;BAC PROFESSIONNEL;BAC PRO PROD;BAC PRO 25214 MAINT.VEHIC.OPTA VOIT.PARTICUL.;40;40;30;9;1;0;1;30;0;1;8;12;9;10
12013.0;2022;22;LIMOGES;MASCULIN;SCOLAIRE;BAC PROFESSIONNEL;BAC PRO PROD;BAC PRO 25411 TECH.CHAUDRONNERIE INDUSTRIELLE;24;24;20;3;1;1;0;21;0;1;4;6;10;3
12015.0;2022;22;LIMOGES;MASCULIN;SCOLAIRE;BAC PROFESSIONNEL;BAC PRO PROD;BAC PRO 25510 METIERS ELECT. ENVIRON. CONNECTES;89;89;53;33;3;2;1;55;0;3;7;22;23;34
12023.0;2022;22;LIMOGES;MASCULIN;SCOLAIRE;BAC PROFESSIONNEL;BAC PRO PROD;BAC PRO AG 21302 GEST MILIEUX NATURELS FAUNE;29;29;25;4;0;0;0;25;0;1;2;5;17;4
12024.0;2022;22;LIMOGES;MASCULIN;SCOLAIRE;BAC PROFESSIONNEL;BAC PRO PROD;BAC PRO AG 21303 FORET;26;26;26;0;0;0;0;26;0;2;7;12;5;0
12033.0;2022;22;LIMOGES;MASCULIN;SCOLAIRE;BAC PROFESSIONNEL;BAC PRO SERV;BAC PRO 31214 MET.COM.VEN.OP.B PR.CL.VA.OF.COM.;25;25;20;2;3;2;1;22;0;2;3;7;10;3
12034.0;2022;22;LIMOGES;MASCULIN;SCOLAIRE;BAC PROFESSIONNEL;BAC PRO SERV;BAC PRO 32207 REAL.PR.IMPR.PLURI.OPTA.PR.GRAPH.;8;7;7;0;0;0;0;7;0;0;0;6;1;0
12039.0;2022;22;LIMOGES;MASCULIN;SCOLAIRE;BAC PROFESSIONNEL;BAC PRO SERV;BAC PRO 33004 ACC.SOINS-S.PERS. OPT.EN STRUCTUR;12;12;12;0;0;0;0;12;0;0;4;3;5;0
12044.0;2022;22;LIMOGES;MASCULIN;SCOLAIRE;BAC PROFESSIONNEL;BAC PRO SERV;BAC PRO AG 33002 SERV PERS TERRIT;11;11;11;0;0;0;0;11;0;0;2;2;7;0
12046.0;2022;22;LIMOGES;MASCULIN;SCOLAIRE;BAC TECHNOLOGIQUE;BAC STAV;BAC STAV AGRONOMIE ALIM ENV TERRITOI;41;41;41;0;0;0;0;41;0;1;7;17;16;0
12052.0;2022;22;LIMOGES;MASCULIN;SCOLAIRE;BAC TECHNOLOGIQUE;BAC STI2D;BAC STI2D SYSTÈME D'INFORMATION  ET NUMERIQUE;109;109;77;7;25;13;12;90;0;1;6;32;51;19
12056.0;2022;22;LIMOGES;MASCULIN;SCOLAIRE;BAC TECHNOLOGIQUE;BAC STMG;BAC STMG MERCATIQUE (MARKETING);175;175;124;7;44;28;16;152;0;1;15;39;97;23
12059.0;2022;10;LYON;FEMININ;APPRENTISSAGE;BAC PROFESSIONNEL;BAC PRO PROD;BAC PRO 20102 PILOTE DE LIGNE DE PRODUCTION;1;1;1;0;0;0;0;1;0;1;0;0;0;0
12063.0;2022;10;LYON;FEMININ;APPRENTISSAGE;BAC PROFESSIONNEL;BAC PRO PROD;BAC PRO 23102 TRAVAUX PUBLICS;1;1;1;0;0;0;0;1;0;0;0;1;0;0
12068.0;2022;10;LYON;FEMININ;APPRENTISSAGE;BAC PROFESSIONNEL;BAC PRO PROD;BAC PRO 23408 Etude et réalisation d'agencement;1;1;1;0;0;0;0;1;0;0;0;1;0;0
12072.0;2022;10;LYON;FEMININ;APPRENTISSAGE;BAC PROFESSIONNEL;BAC PRO PROD;BAC PRO 25106 TECHNICIEN D'USINAGE;2;2;2;0;0;0;0;2;0;0;0;2;0;0
12075.0;2022;10;LYON;FEMININ;APPRENTISSAGE;BAC PROFESSIONNEL;BAC PRO PROD;BAC PRO 25219 MAINT.MATERIELS OPT.A AGRICOLES;2;2;2;0;0;0;0;2;0;1;1;0;0;0
12076.0;2022;10;LYON;FEMININ;APPRENTISSAGE;BAC PROFESSIONNEL;BAC PRO PROD;BAC PRO 25221 MAINT.MATERIELS OPT.C ESP. VERTS;2;2;2;0;0;0;0;2;0;0;0;1;1;0
12077.0;2022;10;LYON;FEMININ;APPRENTISSAGE;BAC PROFESSIONNEL;BAC PRO PROD;BAC PRO 25408 REPARATION DES CARROSSERIES;2;2;2;0;0;0;0;2;0;0;0;0;2;0
12080.0;2022;10;LYON;FEMININ;APPRENTISSAGE;BAC PROFESSIONNEL;BAC PRO PROD;BAC PRO 25515 SYST.NUM.OPT.C RES.INF.SYST.COMM.;1;1;1;0;0;0;0;1;0;0;0;0;1;0
12087.0;2022;10;LYON;FEMININ;APPRENTISSAGE;BAC PROFESSIONNEL;BAC PRO PROD;BAC PRO AG 21405 AMENAGEMENTS PAYSAGERS;3;3;3;0;0;0;0;3;0;0;0;3;0;0
12089.0;2022;10;LYON;FEMININ;APPRENTISSAGE;BAC PROFESSIONNEL;BAC PRO SERV;BAC PRO 30001 GESTION-ADMINISTRATION;24;24;23;1;0;0;0;23;0;1;10;8;4;1
12098.0;2022;10;LYON;FEMININ;APPRENTISSAGE;BAC PROFESSIONNEL;BAC PRO SERV;BAC PRO 33102 PROTHESE DENTAIRE;8;8;6;2;0;0;0;6;0;0;1;0;5;2
12106.0;2022;10;LYON;FEMININ;ENSEIGNEMENT A DISTANCE;BAC TECHNOLOGIQUE;BAC STMG;BAC STMG RESSOURCES HUMAINES ET COMMUNICATION;6;6;6;0;0;0;0;6;0;0;1;1;4;0
12119.0;2022;10;LYON;FEMININ;INDIVIDUEL;BAC PROFESSIONNEL;BAC PRO SERV;BAC PRO 31213 MET.COM.VEN.OP.A ANI.GES.ESP.COM.;6;5;2;2;1;1;0;3;0;0;0;0;3;2
12121.0;2022;10;LYON;FEMININ;INDIVIDUEL;BAC PROFESSIONNEL;BAC PRO SERV;BAC PRO 33002 SERVICES DE PROXIMITE  VIE LOCAL;2;2;2;0;0;0;0;2;0;0;0;0;2;0
12124.0;2022;10;LYON;FEMININ;INDIVIDUEL;BAC PROFESSIONNEL;BAC PRO SERV;BAC PRO 33102 PROTHESE DENTAIRE;3;3;1;2;0;0;0;1;0;0;0;0;1;2
12128.0;2022;10;LYON;FEMININ;INDIVIDUEL;BAC TECHNOLOGIQUE;BAC ST2S;BAC ST2S SCIENCES & TECHNO. SANTE & SOCIAL;44;35;20;8;7;4;3;24;0;0;5;7;12;11
12131.0;2022;10;LYON;FEMININ;INDIVIDUEL;BAC TECHNOLOGIQUE;BAC STL;BAC STL SCIENCES PHYSIQUES CHIMIQUES  EN LABORAT.;2;2;1;1;0;0;0;1;0;0;0;0;1;1
12136.0;2022;10;LYON;FEMININ;SCOLAIRE;BAC PROFESSIONNEL;BAC PRO PROD;BACPRO 20002 ETUD.DEFINITION PRDTS INDUSTRIEL;3;3;3;0;0;0;0;3;0;0;0;3;0;0
12142.0;2022;10;LYON;FEMININ;SCOLAIRE;BAC PROFESSIONNEL;BAC PRO PROD;BAC PRO 22503 PLASTIQUES ET COMPOSITES;1;1;1;0;0;0;0;1;0;0;0;0;1;0
12149.0;2022;10;LYON;FEMININ;SCOLAIRE;BAC PROFESSIONNEL;BAC PRO PROD;BAC PRO 23408 Etude et réalisation d'agencement;23;23;21;2;0;0;0;21;0;0;3;10;8;2
12150.0;2022;10;LYON;FEMININ;SCOLAIRE;BAC PROFESSIONNEL;BAC PRO PROD;BAC PRO 24002 METIERS PRESSING BLANCHISSERIE;8;8;3;5;0;0;0;3;0;0;0;1;2;5
12163.0;2022;10;LYON;FEMININ;SCOLAIRE;BAC PROFESSIONNEL;BAC PRO PROD;BAC PRO 25509 TECHNIC. FROID CONDITIONNEMT AIR;1;1;1;0;0;0;0;1;0;0;0;1;0;0
12165.0;2022;10;LYON;FEMININ;SCOLAIRE;BAC PROFESSIONNEL;BAC PRO PROD;BAC PRO 25514 SYST.NUM.OPT.B AUD.RES.EQUIP.DOM.;1;1;1;0;0;0;0;1;0;0;0;1;0;0
12167.0;2022;10;LYON;FEMININ;SCOLAIRE;BAC PROFESSIONNEL;BAC PRO PROD;BAC PRO AG 21004 CGEA;22;21;15;6;0;0;0;15;0;0;0;8;7;6
12173.0;2022;10;LYON;FEMININ;SCOLAIRE;BAC PROFESSIONNEL;BAC PRO PROD;BAC PRO AG 21212 TECH EXPE ANIMALE;20;20;19;1;0;0;0;19;0;0;2;6;11;1
12178.0;2022;10;LYON;FEMININ;SCOLAIRE;BAC PROFESSIONNEL;BAC PRO PROD;BAC PRO AG 22107 TEC CONS VTE ALIMENTATION P.ALIM;37;37;33;4;0;0;0;33;0;0;1;14;18;4
12183.0;2022;10;LYON;FEMININ;SCOLAIRE;BAC PROFESSIONNEL;BAC PRO SERV;BAC PRO 31212 METIERS DE L'ACCUEIL;253;253;215;21;17;13;4;228;0;13;46;86;83;25
12186.0;2022;10;LYON;FEMININ;SCOLAIRE;BAC PROFESSIONNEL;BAC PRO SERV;BAC PRO 32207 REAL.PR.IMPR.PLURI.OPTA.PR.GRAPH.;14;14;12;2;0;0;0;12;0;1;4;5;2;2
12189.0;2022;10;LYON;FEMININ;SCOLAIRE;BAC PROFESSIONNEL;BAC PRO SERV;BAC PRO 32304 PHOTOGRAPHIE;19;19;19;0;0;0;0;19;0;2;3;7;7;0
12196.0;2022;10;LYON;FEMININ;SCOLAIRE;BAC PROFESSIONNEL;BAC PRO SERV;BAC PRO 33602 PERRUQUIER POSTICHEUR;12;12;12;0;0;0;0;12;0;5;2;5;0;0
12198.0;2022;10;LYON;FEMININ;SCOLAIRE;BAC PROFESSIONNEL;BAC PRO SERV;BAC PRO 34304 HYGIENE PROPRETE STERILISATION;30;30;22;5;3;1;2;23;0;1;2;12;8;7
12199.0;2022;10;LYON;FEMININ;SCOLAIRE;BAC PROFESSIONNEL;BAC PRO SERV;BAC PRO 34403 METIERS DE LA SECURITE;37;37;37;0;0;0;0;37;0;4;14;13;6;0
12201.0;2022;10;LYON;FEMININ;SCOLAIRE;BAC TECHNOLOGIQUE;BAC S2TMD;BAC S2TMD DANSE;7;7;7;0;0;0;0;7;2;3;2;0;0;0
12205.0;2022;10;LYON;FEMININ;SCOLAIRE;BAC TECHNOLOGIQUE;BAC STD2A;BAC STD2A SCIENCES & TECHNO. DESIGN-ARTS APPLIQUES;129;129;123;3;3;1;2;124;0;11;34;58;21;5
12206.0;2022;10;LYON;FEMININ;SCOLAIRE;BAC TECHNOLOGIQUE;BAC STHR;BAC STHR SC.&TEC. HOTELLERIE-RESTAURATION;48;48;46;0;2;1;1;47;0;7;11;16;13;1
12208.0;2022;10;LYON;FEMININ;SCOLAIRE;BAC TECHNOLOGIQUE;BAC STI2D;BAC STI2D ENERGIES  ET ENVIRONNEMENT;15;15;15;0;0;0;0;15;0;0;3;6;6;0
12214.0;2022;10;LYON;FEMININ;SCOLAIRE;BAC TECHNOLOGIQUE;BAC STMG;BAC STMG MERCATIQUE (MARKETING);1125;1125;893;53;179;117;62;1010;0;11;105;361;533;115
12219.0;2022;10;LYON;MASCULIN;APPRENTISSAGE;BAC PROFESSIONNEL;BAC PRO PROD;BAC PRO 22004 PROC. CHIMIE EAU PAPIERS-CARTONS;18;18;18;0;0;0;0;18;0;1;10;5;2;0
12223.0;2022;10;LYON;MASCULIN;APPRENTISSAGE;BAC PROFESSIONNEL;BAC PRO PROD;BAC PRO 22503 PLASTIQUES ET COMPOSITES;12;12;8;4;0;0;0;8;0;2;1;2;3;4
12226.0;2022;10;LYON;MASCULIN;APPRENTISSAGE;BAC PROFESSIONNEL;BAC PRO PROD;BAC PRO 22705 TECHNICIEN GAZ;4;4;4;0;0;0;0;4;0;2;1;0;1;0
12228.0;2022;10;LYON;MASCULIN;APPRENTISSAGE;BAC PROFESSIONNEL;BAC PRO PROD;BACPRO 23103 TECHNICIEN GEOMETRE-TOPOGRAPHE;9;9;5;4;0;0;0;5;0;0;3;2;0;4
12231.0;2022;10;LYON;MASCULIN;APPRENTISSAGE;BAC PROFESSIONNEL;BAC PRO PROD;BAC PRO 23303 MENUISERIE ALUMINIUM-VERRE;16;16;8;6;2;1;1;9;0;1;1;1;6;7
12233.0;2022;10;LYON;MASCULIN;APPRENTISSAGE;BAC PROFESSIONNEL;BAC PRO PROD;BAC PRO 23404 TECHNICIEN CONSTRUCTEUR BOIS;17;17;11;6;0;0;0;11;0;0;1;7;3;6
12249.0;2022;10;LYON;MASCULIN;APPRENTISSAGE;BAC PROFESSIONNEL;BAC PRO PROD;BAC PRO 25406 OUVRAGES DU BATIMENT METALLERIE;13;13;12;1;0;0;0;12;0;3;3;4;2;1
12251.0;2022;10;LYON;MASCULIN;APPRENTISSAGE;BAC PROFESSIONNEL;BAC PRO PROD;BAC PRO 25410 CONSTRUCTION DES CARROSSERIES;6;6;6;0;0;0;0;6;0;0;3;3;0;0
12255.0;2022;10;LYON;MASCULIN;APPRENTISSAGE;BAC PROFESSIONNEL;BAC PRO PROD;BAC PRO 25515 SYST.NUM.OPT.C RES.INF.SYST.COMM.;13;13;11;2;0;0;0;11;0;5;1;4;1;2
12256.0;2022;10;LYON;MASCULIN;APPRENTISSAGE;BAC PROFESSIONNEL;BAC PRO PROD;BAC PRO AG 21004 CGEA;40;39;32;7;0;0;0;32;0;3;4;10;15;7
12264.0;2022;10;LYON;MASCULIN;APPRENTISSAGE;BAC PROFESSIONNEL;BAC PRO PROD;BAC PRO AG 21303 FORET;9;9;9;0;0;0;0;9;0;0;1;1;7;0
12289.0;2022;10;LYON;MASCULIN;FORMATION CONTINUE;BAC PROFESSIONNEL;BAC PRO SERV;BAC PRO 31213 MET.COM.VEN.OP.A ANI.GES.ESP.COM.;5;5;4;1;0;0;0;4;0;0;0;1;3;1
12294.0;2022;10;LYON;MASCULIN;INDIVIDUEL;BAC PROFESSIONNEL;BAC PRO PROD;BAC PRO 23005 TECHN. ETUDES BAT B ASSIST.ARCHI.;2;2;0;2;0;0;0;0;0;0;0;0;0;2
12296.0;2022;10;LYON;MASCULIN;INDIVIDUEL;BAC PROFESSIONNEL;BAC PRO PROD;BAC PRO 25106 TECHNICIEN D'USINAGE;1;0;0;0;0;0;0;0;0;0;0;0;0;0
12297.0;2022;10;LYON;MASCULIN;INDIVIDUEL;BAC PROFESSIONNEL;BAC PRO PROD;BAC PRO 25214 MAINT.VEHIC.OPTA VOIT.PARTICUL.;5;2;0;2;0;0;0;0;0;0;0;0;0;2
12314.0;2022;10;LYON;MASCULIN;INDIVIDUEL;BAC PROFESSIONNEL;BAC PRO SERV;BAC PRO 33102 PROTHESE DENTAIRE;2;2;1;1;0;0;0;1;0;0;0;0;1;1
12315.0;2022;10;LYON;MASCULIN;INDIVIDUEL;BAC PROFESSIONNEL;BAC PRO SERV;BAC PRO 34403 METIERS DE LA SECURITE;1;1;1;0;0;0;0;1;0;0;1;0;0;0
12316.0;2022;10;LYON;MASCULIN;INDIVIDUEL;BAC TECHNOLOGIQUE;BAC ST2S;BAC ST2S SCIENCES & TECHNO. SANTE & SOCIAL;3;1;1;0;0;0;0;1;0;0;0;1;0;0
12319.0;2022;10;LYON;MASCULIN;INDIVIDUEL;BAC TECHNOLOGIQUE;BAC STI2D;BAC STI2D ENERGIES  ET ENVIRONNEMENT;2;1;0;0;1;0;1;0;0;0;0;0;0;1
12320.0;2022;10;LYON;MASCULIN;INDIVIDUEL;BAC TECHNOLOGIQUE;BAC STI2D;BAC STI2D INNOVATION TECHNO.  ET ECO CONCEPTION;3;1;0;0;1;0;1;0;0;0;0;0;0;1
12321.0;2022;10;LYON;MASCULIN;INDIVIDUEL;BAC TECHNOLOGIQUE;BAC STI2D;BAC STI2D SYSTÈME D'INFORMATION  ET NUMERIQUE;3;1;0;0;1;0;1;0;0;0;0;0;0;1
12325.0;2022;10;LYON;MASCULIN;INDIVIDUEL;BAC TECHNOLOGIQUE;BAC STMG;BAC STMG SYSTEMES D'INFORMATION DE GESTION;1;0;0;0;0;0;0;0;0;0;0;0;0;0
12326.0;2022;10;LYON;MASCULIN;SCOLAIRE;BAC GENERAL;BAC GENERAL;BAC GENE 10019 BAC GENERAL;8056;8056;7363;129;564;382;182;7745;82;876;1877;2535;2375;311
12329.0;2022;10;LYON;MASCULIN;SCOLAIRE;BAC PROFESSIONNEL;BAC PRO PROD;BAC PRO 22003 BIO-INDUSTRIES DE TRANSFORMATION;10;10;8;2;0;0;0;8;0;1;0;4;3;2
12336.0;2022;10;LYON;MASCULIN;SCOLAIRE;BAC PROFESSIONNEL;BAC PRO PROD;BAC PRO 22703 TECHN.INSTALL.SYST.ENERG.CLIMATI;89;89;57;29;3;2;1;59;0;1;7;15;36;30
12340.0;2022;10;LYON;MASCULIN;SCOLAIRE;BAC PROFESSIONNEL;BAC PRO PROD;BAC PRO 23005 TECHN. ETUDES BAT B ASSIST.ARCHI.;37;37;30;7;0;0;0;30;0;0;8;17;5;7
12343.0;2022;10;LYON;MASCULIN;SCOLAIRE;BAC PROFESSIONNEL;BAC PRO PROD;BAC PRO 23203 TECHNICIEN BAT. : ORG.REAL.GROS O;23;23;10;12;1;1;0;11;0;0;4;2;5;12
12346.0;2022;10;LYON;MASCULIN;SCOLAIRE;BAC PROFESSIONNEL;BAC PRO PROD;BAC PRO 23404 TECHNICIEN CONSTRUCTEUR BOIS;24;24;17;7;0;0;0;17;0;0;0;4;13;7
12348.0;2022;10;LYON;MASCULIN;SCOLAIRE;BAC PROFESSIONNEL;BAC PRO PROD;BAC PRO 23406 TECHNICIEN DE SCIERIE;1;1;0;1;0;0;0;0;0;0;0;0;0;1
12349.0;2022;10;LYON;MASCULIN;SCOLAIRE;BAC PROFESSIONNEL;BAC PRO PROD;BAC PRO 23407 TECHNIC.FAB.BOIS ET MATERX ASSOC;12;12;9;3;0;0;0;9;0;0;1;4;4;3
12372.0;2022;10;LYON;MASCULIN;SCOLAIRE;BAC PROFESSIONNEL;BAC PRO PROD;BAC PRO 25514 SYST.NUM.OPT.B AUD.RES.EQUIP.DOM.;88;88;75;13;0;0;0;75;0;1;13;41;20;13
12378.0;2022;10;LYON;MASCULIN;SCOLAIRE;BAC PROFESSIONNEL;BAC PRO PROD;BAC PRO AG 21203 TECHN CONSEIL DE VENTE ANIMAL;25;25;22;3;0;0;0;22;0;1;7;5;9;3
12381.0;2022;10;LYON;MASCULIN;SCOLAIRE;BAC PROFESSIONNEL;BAC PRO PROD;BAC PRO AG 21211 COND GEST ENTR HIPPIQUE;2;2;2;0;0;0;0;2;0;0;0;1;1;0
12385.0;2022;10;LYON;MASCULIN;SCOLAIRE;BAC PROFESSIONNEL;BAC PRO PROD;BAC PRO AG 21405 AMENAGEMENTS PAYSAGERS;78;77;74;3;0;0;0;74;0;1;14;23;36;3
12386.0;2022;10;LYON;MASCULIN;SCOLAIRE;BAC PROFESSIONNEL;BAC PRO PROD;BAC PRO AG 21407 TEC CONS VTE UNIVERS JARDINERIE;3;3;2;1;0;0;0;2;0;0;0;0;2;1
12388.0;2022;10;LYON;MASCULIN;SCOLAIRE;BAC PROFESSIONNEL;BAC PRO PROD;BAC PRO AG 22107 TEC CONS VTE ALIMENTATION P.ALIM;43;40;27;13;0;0;0;27;0;1;2;7;17;13
12404.0;2022;10;LYON;MASCULIN;SCOLAIRE;BAC PROFESSIONNEL;BAC PRO SERV;BAC PRO 33102 PROTHESE DENTAIRE;17;17;12;5;0;0;0;12;0;1;2;6;3;5
12407.0;2022;10;LYON;MASCULIN;SCOLAIRE;BAC PROFESSIONNEL;BAC PRO SERV;BAC PRO 34304 HYGIENE PROPRETE STERILISATION;9;9;7;1;1;1;0;8;0;0;3;3;2;1
12414.0;2022;10;LYON;MASCULIN;SCOLAIRE;BAC TECHNOLOGIQUE;BAC STHR;BAC STHR SC.&TEC. HOTELLERIE-RESTAURATION;46;46;45;0;1;1;0;46;0;4;13;21;8;0
12418.0;2022;10;LYON;MASCULIN;SCOLAIRE;BAC TECHNOLOGIQUE;BAC STI2D;BAC STI2D SYSTÈME D'INFORMATION  ET NUMERIQUE;509;509;426;16;67;39;28;465;0;5;56;159;245;44
12421.0;2022;10;LYON;MASCULIN;SCOLAIRE;BAC TECHNOLOGIQUE;BAC STMG;BAC STMG GESTION ET FINANCE;620;620;497;38;85;56;29;553;0;6;59;187;301;67
12425.0;2022;31;MARTINIQUE;FEMININ;APPRENTISSAGE;BAC PROFESSIONNEL;BAC PRO PROD;BAC PRO 22105 BOULANGER-PÂTISSIER;4;4;2;2;0;0;0;2;0;0;0;0;2;2
12426.0;2022;31;MARTINIQUE;FEMININ;APPRENTISSAGE;BAC PROFESSIONNEL;BAC PRO PROD;BAC PRO 22106 CUISINE;1;0;0;0;0;0;0;0;0;0;0;0;0;0
12427.0;2022;31;MARTINIQUE;FEMININ;APPRENTISSAGE;BAC PROFESSIONNEL;BAC PRO PROD;BAC PRO 22704 TECHN. MAINT. SYST.ENERG.CLIMATI;1;1;1;0;0;0;0;1;0;0;0;1;0;0
12428.0;2022;31;MARTINIQUE;FEMININ;APPRENTISSAGE;BAC PROFESSIONNEL;BAC PRO PROD;BAC PRO 25510 METIERS ELECT. ENVIRON. CONNECTES;1;1;1;0;0;0;0;1;0;1;0;0;0;0
12433.0;2022;31;MARTINIQUE;FEMININ;ENSEIGNEMENT A DISTANCE;BAC GENERAL;BAC GENERAL;BAC GENE 10019 BAC GENERAL;5;5;4;1;0;0;0;4;0;0;1;2;1;1
12434.0;2022;31;MARTINIQUE;FEMININ;ENSEIGNEMENT A DISTANCE;BAC TECHNOLOGIQUE;BAC ST2S;BAC ST2S SCIENCES & TECHNO. SANTE & SOCIAL;1;1;1;0;0;0;0;1;0;0;0;0;1;0
12441.0;2022;31;MARTINIQUE;FEMININ;INDIVIDUEL;BAC PROFESSIONNEL;BAC PRO SERV;BAC PRO 33603 ESTHETIQUE COSMETIQUE PARFUMERIE;1;1;0;1;0;0;0;0;0;0;0;0;0;1
12448.0;2022;31;MARTINIQUE;FEMININ;SCOLAIRE;BAC PROFESSIONNEL;BAC PRO PROD;BAC PRO 22105 BOULANGER-PÂTISSIER;26;26;20;6;0;0;0;20;0;3;3;8;6;6
12449.0;2022;31;MARTINIQUE;FEMININ;SCOLAIRE;BAC PROFESSIONNEL;BAC PRO PROD;BAC PRO 22106 CUISINE;15;15;13;1;1;1;0;14;0;2;3;4;5;1
12456.0;2022;31;MARTINIQUE;FEMININ;SCOLAIRE;BAC PROFESSIONNEL;BAC PRO PROD;BAC PRO 25214 MAINT.VEHIC.OPTA VOIT.PARTICUL.;1;1;0;1;0;0;0;0;0;0;0;0;0;1
12475.0;2022;31;MARTINIQUE;FEMININ;SCOLAIRE;BAC PROFESSIONNEL;BAC PRO SERV;BAC PRO 33003 ACC.SOINS-S.PERS. OPT.A DOMICILE;64;64;38;21;5;4;1;42;0;0;8;17;17;22
12479.0;2022;31;MARTINIQUE;FEMININ;SCOLAIRE;BAC PROFESSIONNEL;BAC PRO SERV;BAC PRO 34303 GEST. POLLUTIONS PROTEC. ENVIRON.;6;6;5;1;0;0;0;5;0;0;0;4;1;1
12481.0;2022;31;MARTINIQUE;FEMININ;SCOLAIRE;BAC PROFESSIONNEL;BAC PRO SERV;BAC PRO AG 33002 SERV PERS TERRIT;39;35;34;1;0;0;0;34;0;0;4;13;17;1
12485.0;2022;31;MARTINIQUE;FEMININ;SCOLAIRE;BAC TECHNOLOGIQUE;BAC STHR;BAC STHR SC.&TEC. HOTELLERIE-RESTAURATION;5;5;5;0;0;0;0;5;0;0;2;0;3;0
12491.0;2022;31;MARTINIQUE;FEMININ;SCOLAIRE;BAC TECHNOLOGIQUE;BAC STMG;BAC STMG GESTION ET FINANCE;62;62;57;0;5;5;0;62;0;3;11;26;22;0
12495.0;2022;31;MARTINIQUE;MASCULIN;APPRENTISSAGE;BAC PROFESSIONNEL;BAC PRO PROD;BAC PRO 22105 BOULANGER-PÂTISSIER;6;6;3;3;0;0;0;3;0;0;0;2;1;3
12501.0;2022;31;MARTINIQUE;MASCULIN;APPRENTISSAGE;BAC PROFESSIONNEL;BAC PRO PROD;BAC PRO 23404 TECHNICIEN CONSTRUCTEUR BOIS;3;3;3;0;0;0;0;3;0;0;0;1;2;0
12505.0;2022;31;MARTINIQUE;MASCULIN;APPRENTISSAGE;BAC PROFESSIONNEL;BAC PRO PROD;BAC PRO 25408 REPARATION DES CARROSSERIES;6;6;3;3;0;0;0;3;0;0;0;0;3;3
12507.0;2022;31;MARTINIQUE;MASCULIN;APPRENTISSAGE;BAC PROFESSIONNEL;BAC PRO SERV;BAC PRO 31106 LOGISTIQUE;10;9;6;2;1;1;0;7;0;0;0;2;5;2
12510.0;2022;31;MARTINIQUE;MASCULIN;ENSEIGNEMENT A DISTANCE;BAC GENERAL;BAC GENERAL;BAC GENE 10019 BAC GENERAL;2;2;1;1;0;0;0;1;0;1;0;0;0;1
12513.0;2022;31;MARTINIQUE;MASCULIN;FORMATION CONTINUE;BAC PROFESSIONNEL;BAC PRO PROD;BAC PRO 25007 MAINTENANCE EQUIPEMENTS INDUST.;7;7;3;3;1;1;0;4;0;1;1;1;1;3
12526.0;2022;31;MARTINIQUE;MASCULIN;INDIVIDUEL;BAC TECHNOLOGIQUE;BAC STI2D;BAC STI2D ARCHITECTURE ET CONSTRUCTION;1;1;0;0;1;1;0;1;0;0;0;0;1;0
12531.0;2022;31;MARTINIQUE;MASCULIN;SCOLAIRE;BAC PROFESSIONNEL;BAC PRO PROD;BAC PRO 22004 PROC. CHIMIE EAU PAPIERS-CARTONS;9;9;4;3;2;1;1;5;0;0;0;0;5;4
12536.0;2022;31;MARTINIQUE;MASCULIN;SCOLAIRE;BAC PROFESSIONNEL;BAC PRO PROD;BAC PRO 23003 ARTIS. & M.ART:MARCHANDISAGE VIS.;9;9;9;0;0;0;0;9;0;0;2;5;2;0
12541.0;2022;31;MARTINIQUE;MASCULIN;SCOLAIRE;BAC PROFESSIONNEL;BAC PRO PROD;BAC PRO 23303 MENUISERIE ALUMINIUM-VERRE;5;5;2;1;2;1;1;3;0;0;0;0;3;2
12551.0;2022;31;MARTINIQUE;MASCULIN;SCOLAIRE;BAC PROFESSIONNEL;BAC PRO PROD;BAC PRO 25219 MAINT.MATERIELS OPT.A AGRICOLES;9;9;5;2;2;2;0;7;0;0;1;2;4;2
12557.0;2022;31;MARTINIQUE;MASCULIN;SCOLAIRE;BAC PROFESSIONNEL;BAC PRO PROD;BAC PRO 25510 METIERS ELECT. ENVIRON. CONNECTES;123;122;98;15;9;4;5;102;0;3;19;36;44;20
12558.0;2022;31;MARTINIQUE;MASCULIN;SCOLAIRE;BAC PROFESSIONNEL;BAC PRO PROD;BAC PRO 25513 SYST.NUM.OPT.A SURETE SECURITE;10;10;6;4;0;0;0;6;0;0;0;2;4;4
12568.0;2022;31;MARTINIQUE;MASCULIN;SCOLAIRE;BAC PROFESSIONNEL;BAC PRO SERV;BAC PRO 31108 TRANSPORT;27;27;13;9;5;3;2;16;0;0;0;6;10;11
12570.0;2022;31;MARTINIQUE;MASCULIN;SCOLAIRE;BAC PROFESSIONNEL;BAC PRO SERV;BAC PRO 31213 MET.COM.VEN.OP.A ANI.GES.ESP.COM.;50;50;38;8;4;3;1;41;0;0;10;12;19;9
12571.0;2022;31;MARTINIQUE;MASCULIN;SCOLAIRE;BAC PROFESSIONNEL;BAC PRO SERV;BAC PRO 31214 MET.COM.VEN.OP.B PR.CL.VA.OF.COM.;61;61;44;12;5;4;1;48;0;0;7;15;26;13
12575.0;2022;31;MARTINIQUE;MASCULIN;SCOLAIRE;BAC PROFESSIONNEL;BAC PRO SERV;BAC PRO 33004 ACC.SOINS-S.PERS. OPT.EN STRUCTUR;6;6;4;2;0;0;0;4;0;0;0;1;3;2
12588.0;2022;31;MARTINIQUE;MASCULIN;SCOLAIRE;BAC TECHNOLOGIQUE;BAC STI2D;BAC STI2D SYSTÈME D'INFORMATION  ET NUMERIQUE;51;51;37;2;12;12;0;49;0;1;2;8;38;2
12595.0;2022;43;MAYOTTE;FEMININ;APPRENTISSAGE;BAC PROFESSIONNEL;BAC PRO SERV;BAC PRO 34403 METIERS DE LA SECURITE;3;3;3;0;0;0;0;3;0;0;2;0;1;0
12597.0;2022;43;MAYOTTE;FEMININ;ENSEIGNEMENT A DISTANCE;BAC PROFESSIONNEL;BAC PRO SERV;BAC PRO 30001 GESTION-ADMINISTRATION;1;0;0;0;0;0;0;0;0;0;0;0;0;0
12602.0;2022;43;MAYOTTE;FEMININ;INDIVIDUEL;BAC PROFESSIONNEL;BAC PRO SERV;BAC PRO 31213 MET.COM.VEN.OP.A ANI.GES.ESP.COM.;4;3;0;3;0;0;0;0;0;0;0;0;0;3
12617.0;2022;43;MAYOTTE;FEMININ;SCOLAIRE;BAC PROFESSIONNEL;BAC PRO PROD;BAC PRO 25515 SYST.NUM.OPT.C RES.INF.SYST.COMM.;1;1;1;0;0;0;0;1;0;0;1;0;0;0
12620.0;2022;43;MAYOTTE;FEMININ;SCOLAIRE;BAC PROFESSIONNEL;BAC PRO SERV;BAC PRO 30001 GESTION-ADMINISTRATION;92;92;54;19;19;13;6;67;0;0;8;19;40;25
12627.0;2022;43;MAYOTTE;FEMININ;SCOLAIRE;BAC PROFESSIONNEL;BAC PRO SERV;BAC PRO 33002 SERVICES DE PROXIMITE  VIE LOCAL;111;110;65;42;3;2;1;67;0;0;3;16;48;43
12633.0;2022;43;MAYOTTE;FEMININ;SCOLAIRE;BAC TECHNOLOGIQUE;BAC ST2S;BAC ST2S SCIENCES & TECHNO. SANTE & SOCIAL;129;129;82;15;32;14;18;96;0;3;9;20;64;33
12647.0;2022;43;MAYOTTE;MASCULIN;APPRENTISSAGE;BAC PROFESSIONNEL;BAC PRO SERV;BAC PRO 34403 METIERS DE LA SECURITE;6;6;2;0;4;3;1;5;0;0;2;0;3;1
12649.0;2022;43;MAYOTTE;MASCULIN;INDIVIDUEL;BAC PROFESSIONNEL;BAC PRO PROD;BAC PRO 23004 TECHN. ETUDES BAT.A ETUDES & ECO.;1;1;0;0;1;1;0;1;0;0;0;0;1;0
12651.0;2022;43;MAYOTTE;MASCULIN;INDIVIDUEL;BAC PROFESSIONNEL;BAC PRO PROD;BAC PRO 23404 TECHNICIEN CONSTRUCTEUR BOIS;1;1;1;0;0;0;0;1;0;0;0;0;1;0
12652.0;2022;43;MAYOTTE;MASCULIN;INDIVIDUEL;BAC PROFESSIONNEL;BAC PRO PROD;BAC PRO 23405 TECHNICIEN MENUISIER AGENCEUR;2;1;1;0;0;0;0;1;0;0;0;0;1;0
12656.0;2022;43;MAYOTTE;MASCULIN;INDIVIDUEL;BAC PROFESSIONNEL;BAC PRO PROD;BAC PRO AG 21004 CGEA;1;1;1;0;0;0;0;1;0;0;0;0;1;0
12662.0;2022;43;MAYOTTE;MASCULIN;INDIVIDUEL;BAC TECHNOLOGIQUE;BAC STMG;BAC STMG MERCATIQUE (MARKETING);5;4;0;1;3;2;1;2;0;0;0;0;2;2
12673.0;2022;43;MAYOTTE;MASCULIN;SCOLAIRE;BAC PROFESSIONNEL;BAC PRO PROD;BAC PRO 23404 TECHNICIEN CONSTRUCTEUR BOIS;14;14;3;11;0;0;0;3;0;0;0;1;2;11
12678.0;2022;43;MAYOTTE;MASCULIN;SCOLAIRE;BAC PROFESSIONNEL;BAC PRO PROD;BAC PRO 25214 MAINT.VEHIC.OPTA VOIT.PARTICUL.;53;52;19;27;6;5;1;24;0;0;0;4;20;28
12685.0;2022;43;MAYOTTE;MASCULIN;SCOLAIRE;BAC PROFESSIONNEL;BAC PRO PROD;BAC PRO 25514 SYST.NUM.OPT.B AUD.RES.EQUIP.DOM.;22;22;14;4;4;3;1;17;0;0;1;7;9;5
12687.0;2022;43;MAYOTTE;MASCULIN;SCOLAIRE;BAC PROFESSIONNEL;BAC PRO PROD;BAC PRO AG 21004 CGEA;6;6;6;0;0;0;0;6;0;0;0;3;3;0
12689.0;2022;43;MAYOTTE;MASCULIN;SCOLAIRE;BAC PROFESSIONNEL;BAC PRO SERV;BAC PRO 30001 GESTION-ADMINISTRATION;48;48;24;19;5;3;2;27;0;1;0;10;16;21
12697.0;2022;43;MAYOTTE;MASCULIN;SCOLAIRE;BAC PROFESSIONNEL;BAC PRO SERV;BAC PRO 33003 ACC.SOINS-S.PERS. OPT.A DOMICILE;5;5;3;2;0;0;0;3;0;0;0;2;1;2
12710.0;2022;43;MAYOTTE;MASCULIN;SCOLAIRE;BAC TECHNOLOGIQUE;BAC STMG;BAC STMG GESTION ET FINANCE;124;124;57;22;45;37;8;94;0;0;4;18;72;30
12721.0;2022;11;MONTPELLIER;FEMININ;APPRENTISSAGE;BAC PROFESSIONNEL;BAC PRO PROD;BAC PRO 25216 MAINT.VEHIC.OPTC MOTOCYCLES;2;2;2;0;0;0;0;2;0;1;0;1;0;0
12731.0;2022;11;MONTPELLIER;FEMININ;APPRENTISSAGE;BAC PROFESSIONNEL;BAC PRO SERV;BAC PRO 31106 LOGISTIQUE;4;4;3;0;1;1;0;4;0;0;3;0;1;0
12737.0;2022;11;MONTPELLIER;FEMININ;APPRENTISSAGE;BAC PROFESSIONNEL;BAC PRO SERV;BAC PRO 33102 PROTHESE DENTAIRE;2;2;2;0;0;0;0;2;0;0;1;0;1;0
12750.0;2022;11;MONTPELLIER;FEMININ;FORMATION CONTINUE;BAC PROFESSIONNEL;BAC PRO PROD;BAC PRO 25214 MAINT.VEHIC.OPTA VOIT.PARTICUL.;3;2;2;0;0;0;0;2;0;0;2;0;0;0
12754.0;2022;11;MONTPELLIER;FEMININ;FORMATION CONTINUE;BAC PROFESSIONNEL;BAC PRO SERV;BAC PRO 33603 ESTHETIQUE COSMETIQUE PARFUMERIE;5;5;5;0;0;0;0;5;0;0;1;2;2;0
12757.0;2022;11;MONTPELLIER;FEMININ;INDIVIDUEL;BAC PROFESSIONNEL;BAC PRO PROD;BAC PRO 25214 MAINT.VEHIC.OPTA VOIT.PARTICUL.;1;1;1;0;0;0;0;1;0;0;1;0;0;0
12769.0;2022;11;MONTPELLIER;FEMININ;INDIVIDUEL;BAC TECHNOLOGIQUE;BAC ST2S;BAC ST2S SCIENCES & TECHNO. SANTE & SOCIAL;10;5;0;4;1;0;1;0;0;0;0;0;0;5
12779.0;2022;11;MONTPELLIER;FEMININ;SCOLAIRE;BAC GENERAL;BAC GENERAL;BAC GENE 10019 BAC GENERAL;7741;7741;7240;127;374;272;102;7512;147;1043;2052;2389;1881;229
12791.0;2022;11;MONTPELLIER;FEMININ;SCOLAIRE;BAC PROFESSIONNEL;BAC PRO PROD;BAC PRO 23304 AMENAGEMENT FINITION BATIMENT;5;5;3;2;0;0;0;3;0;0;0;2;1;2
12800.0;2022;11;MONTPELLIER;FEMININ;SCOLAIRE;BAC PROFESSIONNEL;BAC PRO PROD;BAC PRO 25106 TECHNICIEN D'USINAGE;2;2;1;1;0;0;0;1;0;0;0;0;1;1
12801.0;2022;11;MONTPELLIER;FEMININ;SCOLAIRE;BAC PROFESSIONNEL;BAC PRO PROD;BAC PRO 25214 MAINT.VEHIC.OPTA VOIT.PARTICUL.;8;8;7;1;0;0;0;7;0;1;0;4;2;1
12803.0;2022;11;MONTPELLIER;FEMININ;SCOLAIRE;BAC PROFESSIONNEL;BAC PRO PROD;BAC PRO 25219 MAINT.MATERIELS OPT.A AGRICOLES;1;1;1;0;0;0;0;1;0;0;0;1;0;0
12808.0;2022;11;MONTPELLIER;FEMININ;SCOLAIRE;BAC PROFESSIONNEL;BAC PRO PROD;BAC PRO 25510 METIERS ELECT. ENVIRON. CONNECTES;3;3;2;1;0;0;0;2;0;0;0;0;2;1
12809.0;2022;11;MONTPELLIER;FEMININ;SCOLAIRE;BAC PROFESSIONNEL;BAC PRO PROD;BAC PRO 25514 SYST.NUM.OPT.B AUD.RES.EQUIP.DOM.;4;3;3;0;0;0;0;3;0;1;1;1;0;0
12815.0;2022;11;MONTPELLIER;FEMININ;SCOLAIRE;BAC PROFESSIONNEL;BAC PRO PROD;BAC PRO AG 21210 COND GEST ENTR CANIN ET FELIN;29;29;29;0;0;0;0;29;0;1;3;13;12;0
12824.0;2022;11;MONTPELLIER;FEMININ;SCOLAIRE;BAC PROFESSIONNEL;BAC PRO SERV;BAC PRO 31107 CONDUCT. TRANSP.ROUT.MARCHANDISES;5;5;5;0;0;0;0;5;0;1;1;1;2;0
12828.0;2022;11;MONTPELLIER;FEMININ;SCOLAIRE;BAC PROFESSIONNEL;BAC PRO SERV;BAC PRO 31214 MET.COM.VEN.OP.B PR.CL.VA.OF.COM.;84;83;73;8;2;1;1;74;0;10;17;32;15;9
12833.0;2022;11;MONTPELLIER;FEMININ;SCOLAIRE;BAC PROFESSIONNEL;BAC PRO SERV;BAC PRO 33002 SERVICES DE PROXIMITE  VIE LOCAL;51;51;42;7;2;1;1;43;0;3;12;16;12;8
12835.0;2022;11;MONTPELLIER;FEMININ;SCOLAIRE;BAC PROFESSIONNEL;BAC PRO SERV;BAC PRO 33004 ACC.SOINS-S.PERS. OPT.EN STRUCTUR;632;632;555;64;13;7;6;562;0;39;148;215;160;70
12836.0;2022;11;MONTPELLIER;FEMININ;SCOLAIRE;BAC PROFESSIONNEL;BAC PRO SERV;BAC PRO 33101 OPTIQUE LUNETTERIE;9;9;9;0;0;0;0;9;0;0;1;7;1;0
12843.0;2022;11;MONTPELLIER;FEMININ;SCOLAIRE;BAC TECHNOLOGIQUE;BAC S2TMD;BAC S2TMD DANSE;5;5;5;0;0;0;0;5;0;3;1;1;0;0
12846.0;2022;11;MONTPELLIER;FEMININ;SCOLAIRE;BAC TECHNOLOGIQUE;BAC STAV;BAC STAV AGRONOMIE ALIM ENV TERRITOI;145;145;141;4;0;0;0;141;0;0;16;44;81;4
12850.0;2022;11;MONTPELLIER;FEMININ;SCOLAIRE;BAC TECHNOLOGIQUE;BAC STI2D;BAC STI2D ENERGIES  ET ENVIRONNEMENT;12;12;10;0;2;0;2;10;0;1;3;4;2;2
12851.0;2022;11;MONTPELLIER;FEMININ;SCOLAIRE;BAC TECHNOLOGIQUE;BAC STI2D;BAC STI2D INNOVATION TECHNO.  ET ECO CONCEPTION;18;18;16;1;1;1;0;17;0;1;0;3;13;1
12861.0;2022;11;MONTPELLIER;MASCULIN;APPRENTISSAGE;BAC PROFESSIONNEL;BAC PRO PROD;BAC PRO 22106 CUISINE;16;16;15;1;0;0;0;15;0;2;4;3;6;1
12871.0;2022;11;MONTPELLIER;MASCULIN;APPRENTISSAGE;BAC PROFESSIONNEL;BAC PRO PROD;BAC PRO 23405 TECHNICIEN MENUISIER AGENCEUR;2;2;1;1;0;0;0;1;0;0;0;1;0;1
12876.0;2022;11;MONTPELLIER;MASCULIN;APPRENTISSAGE;BAC PROFESSIONNEL;BAC PRO PROD;BAC PRO 25215 MAINT.VEHIC.OPTB VEHIC.TRANS.ROUT;14;14;11;3;0;0;0;11;0;1;4;2;4;3
12885.0;2022;11;MONTPELLIER;MASCULIN;APPRENTISSAGE;BAC PROFESSIONNEL;BAC PRO PROD;BAC PRO 25510 METIERS ELECT. ENVIRON. CONNECTES;41;40;34;4;2;0;2;34;0;7;3;14;10;6
12886.0;2022;11;MONTPELLIER;MASCULIN;APPRENTISSAGE;BAC PROFESSIONNEL;BAC PRO PROD;BAC PRO 25515 SYST.NUM.OPT.C RES.INF.SYST.COMM.;13;13;9;4;0;0;0;9;0;0;3;5;1;4
12893.0;2022;11;MONTPELLIER;MASCULIN;APPRENTISSAGE;BAC PROFESSIONNEL;BAC PRO SERV;BAC PRO 31106 LOGISTIQUE;46;45;25;19;1;0;1;25;0;5;7;6;7;20
12898.0;2022;11;MONTPELLIER;MASCULIN;APPRENTISSAGE;BAC PROFESSIONNEL;BAC PRO SERV;BAC PRO 33403 COMMERC. SERVICES EN RESTAURATION;10;10;9;1;0;0;0;9;0;0;2;3;4;1
12899.0;2022;11;MONTPELLIER;MASCULIN;APPRENTISSAGE;BAC PROFESSIONNEL;BAC PRO SERV;BAC PRO 33603 ESTHETIQUE COSMETIQUE PARFUMERIE;1;1;1;0;0;0;0;1;0;0;0;1;0;0
12901.0;2022;11;MONTPELLIER;MASCULIN;ENSEIGNEMENT A DISTANCE;BAC GENERAL;BAC GENERAL;BAC GENE 10019 BAC GENERAL;39;39;27;6;6;2;4;29;0;0;5;12;12;10
12905.0;2022;11;MONTPELLIER;MASCULIN;ENSEIGNEMENT A DISTANCE;BAC PROFESSIONNEL;BAC PRO SERV;BAC PRO 33004 ACC.SOINS-S.PERS. OPT.EN STRUCTUR;2;1;0;1;0;0;0;0;0;0;0;0;0;1
12906.0;2022;11;MONTPELLIER;MASCULIN;ENSEIGNEMENT A DISTANCE;BAC TECHNOLOGIQUE;BAC STMG;BAC STMG GESTION ET FINANCE;2;2;1;0;1;0;1;1;0;0;1;0;0;1
12915.0;2022;11;MONTPELLIER;MASCULIN;FORMATION CONTINUE;BAC PROFESSIONNEL;BAC PRO PROD;BAC PRO 25510 METIERS ELECT. ENVIRON. CONNECTES;22;22;20;2;0;0;0;20;0;4;14;0;2;2
12922.0;2022;11;MONTPELLIER;MASCULIN;INDIVIDUEL;BAC PROFESSIONNEL;BAC PRO PROD;BAC PRO 22703 TECHN.INSTALL.SYST.ENERG.CLIMATI;2;2;1;1;0;0;0;1;0;0;0;1;0;1
12924.0;2022;11;MONTPELLIER;MASCULIN;INDIVIDUEL;BAC PROFESSIONNEL;BAC PRO PROD;BAC PRO 25106 TECHNICIEN D'USINAGE;1;1;0;1;0;0;0;0;0;0;0;0;0;1
12927.0;2022;11;MONTPELLIER;MASCULIN;INDIVIDUEL;BAC PROFESSIONNEL;BAC PRO PROD;BAC PRO 25515 SYST.NUM.OPT.C RES.INF.SYST.COMM.;1;1;1;0;0;0;0;1;0;0;0;1;0;0
12931.0;2022;11;MONTPELLIER;MASCULIN;INDIVIDUEL;BAC PROFESSIONNEL;BAC PRO SERV;BAC PRO 30001 GESTION-ADMINISTRATION;7;2;1;1;0;0;0;1;0;0;0;0;1;1
12938.0;2022;11;MONTPELLIER;MASCULIN;INDIVIDUEL;BAC TECHNOLOGIQUE;BAC STD2A;BAC STD2A SCIENCES & TECHNO. DESIGN-ARTS APPLIQUES;1;1;1;0;0;0;0;1;0;0;1;0;0;0
12942.0;2022;11;MONTPELLIER;MASCULIN;INDIVIDUEL;BAC TECHNOLOGIQUE;BAC STL;BAC STL BIOCHIM.-BIOLOGIE-BIOTECHNOL.;1;1;0;0;1;0;1;0;0;0;0;0;0;1
12962.0;2022;11;MONTPELLIER;MASCULIN;SCOLAIRE;BAC PROFESSIONNEL;BAC PRO PROD;BACPRO 23103 TECHNICIEN GEOMETRE-TOPOGRAPHE;5;5;4;1;0;0;0;4;0;1;0;1;2;1
12966.0;2022;11;MONTPELLIER;MASCULIN;SCOLAIRE;BAC PROFESSIONNEL;BAC PRO PROD;BAC PRO 23303 MENUISERIE ALUMINIUM-VERRE;17;17;12;2;3;2;1;14;0;0;1;3;10;3
12970.0;2022;11;MONTPELLIER;MASCULIN;SCOLAIRE;BAC PROFESSIONNEL;BAC PRO PROD;BAC PRO 23408 Etude et réalisation d'agencement;4;3;2;1;0;0;0;2;0;0;0;1;1;1
12973.0;2022;11;MONTPELLIER;MASCULIN;SCOLAIRE;BAC PROFESSIONNEL;BAC PRO PROD;BAC PRO 24302 METIERS DU CUIR : MAROQUINERIE;1;1;0;1;0;0;0;0;0;0;0;0;0;1
12976.0;2022;11;MONTPELLIER;MASCULIN;SCOLAIRE;BAC PROFESSIONNEL;BAC PRO PROD;BAC PRO 25007 MAINTENANCE EQUIPEMENTS INDUST.;149;149;97;49;3;2;1;99;0;4;17;39;39;50
12978.0;2022;11;MONTPELLIER;MASCULIN;SCOLAIRE;BAC PROFESSIONNEL;BAC PRO PROD;BAC PRO 25106 TECHNICIEN D'USINAGE;49;49;31;14;4;3;1;34;0;2;7;12;13;15
12980.0;2022;11;MONTPELLIER;MASCULIN;SCOLAIRE;BAC PROFESSIONNEL;BAC PRO PROD;BAC PRO 25215 MAINT.VEHIC.OPTB VEHIC.TRANS.ROUT;27;27;18;8;1;1;0;19;0;0;5;9;5;8
12983.0;2022;11;MONTPELLIER;MASCULIN;SCOLAIRE;BAC PROFESSIONNEL;BAC PRO PROD;BAC PRO 25220 MAINT.MATERIELS OPT.B TP MANUT.;16;16;13;2;1;0;1;13;0;1;7;4;1;3
12989.0;2022;11;MONTPELLIER;MASCULIN;SCOLAIRE;BAC PROFESSIONNEL;BAC PRO PROD;BAC PRO 25509 TECHNIC. FROID CONDITIONNEMT AIR;80;79;52;23;4;4;0;56;0;3;4;19;30;23
12997.0;2022;11;MONTPELLIER;MASCULIN;SCOLAIRE;BAC PROFESSIONNEL;BAC PRO PROD;BAC PRO AG 21114 CONDUITE PRODUCTIONS HORTICOLES;30;28;20;8;0;0;0;20;0;0;0;4;16;8
13004.0;2022;11;MONTPELLIER;MASCULIN;SCOLAIRE;BAC PROFESSIONNEL;BAC PRO PROD;BAC PRO AG 21405 AMENAGEMENTS PAYSAGERS;85;83;81;2;0;0;0;81;0;3;8;34;36;2
13005.0;2022;11;MONTPELLIER;MASCULIN;SCOLAIRE;BAC PROFESSIONNEL;BAC PRO PROD;BAC PRO AG 21407 TEC CONS VTE UNIVERS JARDINERIE;7;5;5;0;0;0;0;5;0;0;0;2;3;0
13006.0;2022;11;MONTPELLIER;MASCULIN;SCOLAIRE;BAC PROFESSIONNEL;BAC PRO PROD;BAC PRO AG 22105 LABORATOIRE CONTROLE QUALITE;16;14;11;3;0;0;0;11;0;1;1;4;5;3
13013.0;2022;11;MONTPELLIER;MASCULIN;SCOLAIRE;BAC PROFESSIONNEL;BAC PRO SERV;BAC PRO 31213 MET.COM.VEN.OP.A ANI.GES.ESP.COM.;444;441;323;98;20;17;3;340;0;13;52;145;130;101
13024.0;2022;11;MONTPELLIER;MASCULIN;SCOLAIRE;BAC PROFESSIONNEL;BAC PRO SERV;BAC PRO 33403 COMMERC. SERVICES EN RESTAURATION;75;75;51;19;5;3;2;54;0;4;12;20;18;21
13036.0;2022;11;MONTPELLIER;MASCULIN;SCOLAIRE;BAC TECHNOLOGIQUE;BAC STI2D;BAC STI2D SYSTÈME D'INFORMATION  ET NUMERIQUE;287;287;219;16;52;33;19;252;0;3;46;82;121;35
13037.0;2022;11;MONTPELLIER;MASCULIN;SCOLAIRE;BAC TECHNOLOGIQUE;BAC STL;BAC STL BIOCHIM.-BIOLOGIE-BIOTECHNOL.;75;75;62;5;8;5;3;67;0;2;6;24;35;8
13038.0;2022;11;MONTPELLIER;MASCULIN;SCOLAIRE;BAC TECHNOLOGIQUE;BAC STL;BAC STL SCIENCES PHYSIQUES CHIMIQUES  EN LABORAT.;58;58;47;2;9;6;3;53;0;1;12;8;32;5
13046.0;2022;12;NANCY-METZ;FEMININ;APPRENTISSAGE;BAC PROFESSIONNEL;BAC PRO PROD;BAC PRO 22106 CUISINE;5;5;5;0;0;0;0;5;0;0;0;3;2;0
13053.0;2022;12;NANCY-METZ;FEMININ;APPRENTISSAGE;BAC PROFESSIONNEL;BAC PRO PROD;BAC PRO 25408 REPARATION DES CARROSSERIES;1;1;1;0;0;0;0;1;0;0;1;0;0;0
13067.0;2022;12;NANCY-METZ;FEMININ;APPRENTISSAGE;BAC PROFESSIONNEL;BAC PRO SERV;BAC PRO 31213 MET.COM.VEN.OP.A ANI.GES.ESP.COM.;64;62;53;6;3;1;2;54;0;2;12;21;19;8
13071.0;2022;12;NANCY-METZ;FEMININ;APPRENTISSAGE;BAC PROFESSIONNEL;BAC PRO SERV;BAC PRO 33102 PROTHESE DENTAIRE;1;1;1;0;0;0;0;1;0;0;0;0;1;0
13079.0;2022;12;NANCY-METZ;FEMININ;FORMATION CONTINUE;BAC PROFESSIONNEL;BAC PRO PROD;BACPRO 20002 ETUD.DEFINITION PRDTS INDUSTRIEL;1;1;1;0;0;0;0;1;0;0;0;1;0;0
13087.0;2022;12;NANCY-METZ;FEMININ;FORMATION CONTINUE;BAC PROFESSIONNEL;BAC PRO SERV;BAC PRO 31212 METIERS DE L'ACCUEIL;2;2;2;0;0;0;0;2;0;1;0;1;0;0
13088.0;2022;12;NANCY-METZ;FEMININ;FORMATION CONTINUE;BAC PROFESSIONNEL;BAC PRO SERV;BAC PRO 31213 MET.COM.VEN.OP.A ANI.GES.ESP.COM.;12;9;7;1;1;0;1;7;0;3;1;3;0;2
13103.0;2022;12;NANCY-METZ;FEMININ;INDIVIDUEL;BAC PROFESSIONNEL;BAC PRO SERV;BAC PRO 31214 MET.COM.VEN.OP.B PR.CL.VA.OF.COM.;3;0;0;0;0;0;0;0;0;0;0;0;0;0
13109.0;2022;12;NANCY-METZ;FEMININ;INDIVIDUEL;BAC TECHNOLOGIQUE;BAC S2TMD;BAC S2TMD THEATRE;1;1;0;0;1;0;1;0;0;0;0;0;0;1
13110.0;2022;12;NANCY-METZ;FEMININ;INDIVIDUEL;BAC TECHNOLOGIQUE;BAC ST2S;BAC ST2S SCIENCES & TECHNO. SANTE & SOCIAL;7;4;1;1;2;1;1;2;0;0;0;0;2;2
13116.0;2022;12;NANCY-METZ;FEMININ;SCOLAIRE;BAC GENERAL;BAC GENERAL;BAC GENE 10019 BAC GENERAL;6457;6457;6040;65;352;258;94;6298;127;809;1654;2057;1651;159
13127.0;2022;12;NANCY-METZ;FEMININ;SCOLAIRE;BAC PROFESSIONNEL;BAC PRO PROD;BAC PRO 23304 AMENAGEMENT FINITION BATIMENT;5;5;2;3;0;0;0;2;0;0;0;2;0;3
13128.0;2022;12;NANCY-METZ;FEMININ;SCOLAIRE;BAC PROFESSIONNEL;BAC PRO PROD;BAC PRO 23405 TECHNICIEN MENUISIER AGENCEUR;5;5;4;1;0;0;0;4;0;1;1;2;0;1
13131.0;2022;12;NANCY-METZ;FEMININ;SCOLAIRE;BAC PROFESSIONNEL;BAC PRO PROD;BAC PRO 24202 ARTIS.& MET.ART : TAPIS.D'AMEUBL;6;6;4;2;0;0;0;4;0;1;0;2;1;2
13138.0;2022;12;NANCY-METZ;FEMININ;SCOLAIRE;BAC PROFESSIONNEL;BAC PRO PROD;BAC PRO 25303 AERONAUTIQUE OPTION SYSTEMES;1;1;1;0;0;0;0;1;0;1;0;0;0;0
13141.0;2022;12;NANCY-METZ;FEMININ;SCOLAIRE;BAC PROFESSIONNEL;BAC PRO PROD;BAC PRO 25510 METIERS ELECT. ENVIRON. CONNECTES;7;6;5;1;0;0;0;5;0;1;1;1;2;1
13143.0;2022;12;NANCY-METZ;FEMININ;SCOLAIRE;BAC PROFESSIONNEL;BAC PRO PROD;BAC PRO 25515 SYST.NUM.OPT.C RES.INF.SYST.COMM.;2;2;1;1;0;0;0;1;0;0;0;0;1;1
13145.0;2022;12;NANCY-METZ;FEMININ;SCOLAIRE;BAC PROFESSIONNEL;BAC PRO PROD;BAC PRO AG 21004 CGEA;13;13;10;3;0;0;0;10;0;1;0;5;4;3
13150.0;2022;12;NANCY-METZ;FEMININ;SCOLAIRE;BAC PROFESSIONNEL;BAC PRO PROD;BAC PRO AG 21405 AMENAGEMENTS PAYSAGERS;5;5;4;1;0;0;0;4;0;0;0;1;3;1
13161.0;2022;12;NANCY-METZ;FEMININ;SCOLAIRE;BAC PROFESSIONNEL;BAC PRO SERV;BAC PRO 32303 ART.& MET.ART:COM.VIS.VIS.PLURI-M;16;16;15;1;0;0;0;15;0;1;3;5;6;1
13162.0;2022;12;NANCY-METZ;FEMININ;SCOLAIRE;BAC PROFESSIONNEL;BAC PRO SERV;BAC PRO 32304 PHOTOGRAPHIE;8;8;7;1;0;0;0;7;0;0;1;2;4;1
13167.0;2022;12;NANCY-METZ;FEMININ;SCOLAIRE;BAC PROFESSIONNEL;BAC PRO SERV;BAC PRO 33102 PROTHESE DENTAIRE;8;8;7;1;0;0;0;7;0;0;0;4;3;1
13170.0;2022;12;NANCY-METZ;FEMININ;SCOLAIRE;BAC PROFESSIONNEL;BAC PRO SERV;BAC PRO 34304 HYGIENE PROPRETE STERILISATION;5;5;5;0;0;0;0;5;0;0;0;2;3;0
13172.0;2022;12;NANCY-METZ;FEMININ;SCOLAIRE;BAC PROFESSIONNEL;BAC PRO SERV;BAC PRO AG 33002 SERV PERS TERRIT;67;64;58;6;0;0;0;58;0;1;10;19;28;6
13173.0;2022;12;NANCY-METZ;FEMININ;SCOLAIRE;BAC TECHNOLOGIQUE;BAC S2TMD;BAC S2TMD DANSE;5;5;5;0;0;0;0;5;1;2;0;1;1;0
13175.0;2022;12;NANCY-METZ;FEMININ;SCOLAIRE;BAC TECHNOLOGIQUE;BAC S2TMD;BAC S2TMD THEATRE;1;1;1;0;0;0;0;1;0;0;0;1;0;0
13180.0;2022;12;NANCY-METZ;FEMININ;SCOLAIRE;BAC TECHNOLOGIQUE;BAC STI2D;BAC STI2D ARCHITECTURE ET CONSTRUCTION;17;17;9;2;6;6;0;15;0;0;0;4;11;2
13181.0;2022;12;NANCY-METZ;FEMININ;SCOLAIRE;BAC TECHNOLOGIQUE;BAC STI2D;BAC STI2D ENERGIES  ET ENVIRONNEMENT;20;20;16;0;4;3;1;19;0;0;3;7;9;1
13185.0;2022;12;NANCY-METZ;FEMININ;SCOLAIRE;BAC TECHNOLOGIQUE;BAC STL;BAC STL SCIENCES PHYSIQUES CHIMIQUES  EN LABORAT.;83;83;68;1;14;7;7;75;1;5;12;23;34;8
13190.0;2022;12;NANCY-METZ;MASCULIN;APPRENTISSAGE;BAC PROFESSIONNEL;BAC PRO PROD;BAC PRO 20102 PILOTE DE LIGNE DE PRODUCTION;12;12;8;1;3;2;1;10;0;3;1;2;4;2
13195.0;2022;12;NANCY-METZ;MASCULIN;APPRENTISSAGE;BAC PROFESSIONNEL;BAC PRO PROD;BAC PRO 22703 TECHN.INSTALL.SYST.ENERG.CLIMATI;16;16;16;0;0;0;0;16;0;1;3;8;4;0
13196.0;2022;12;NANCY-METZ;MASCULIN;APPRENTISSAGE;BAC PROFESSIONNEL;BAC PRO PROD;BAC PRO 22704 TECHN. MAINT. SYST.ENERG.CLIMATI;8;8;6;2;0;0;0;6;0;0;1;3;2;2
13199.0;2022;12;NANCY-METZ;MASCULIN;APPRENTISSAGE;BAC PROFESSIONNEL;BAC PRO PROD;BAC PRO 23203 TECHNICIEN BAT. : ORG.REAL.GROS O;8;8;8;0;0;0;0;8;0;0;2;3;3;0
13200.0;2022;12;NANCY-METZ;MASCULIN;APPRENTISSAGE;BAC PROFESSIONNEL;BAC PRO PROD;BAC PRO 23304 AMENAGEMENT FINITION BATIMENT;4;4;2;0;2;1;1;3;0;0;1;0;2;1
13204.0;2022;12;NANCY-METZ;MASCULIN;APPRENTISSAGE;BAC PROFESSIONNEL;BAC PRO PROD;BAC PRO 23407 TECHNIC.FAB.BOIS ET MATERX ASSOC;3;3;3;0;0;0;0;3;0;1;2;0;0;0
13209.0;2022;12;NANCY-METZ;MASCULIN;APPRENTISSAGE;BAC PROFESSIONNEL;BAC PRO PROD;BAC PRO 25214 MAINT.VEHIC.OPTA VOIT.PARTICUL.;92;89;70;13;6;3;3;73;0;7;13;28;25;16
13216.0;2022;12;NANCY-METZ;MASCULIN;APPRENTISSAGE;BAC PROFESSIONNEL;BAC PRO PROD;BAC PRO 25303 AERONAUTIQUE OPTION SYSTEMES;1;1;1;0;0;0;0;1;0;0;1;0;0;0
13227.0;2022;12;NANCY-METZ;MASCULIN;APPRENTISSAGE;BAC PROFESSIONNEL;BAC PRO PROD;BAC PRO AG 21203 TECHN CONSEIL DE VENTE ANIMAL;2;2;2;0;0;0;0;2;0;0;1;0;1;0
13238.0;2022;12;NANCY-METZ;MASCULIN;APPRENTISSAGE;BAC PROFESSIONNEL;BAC PRO SERV;BAC PRO 31214 MET.COM.VEN.OP.B PR.CL.VA.OF.COM.;1;1;1;0;0;0;0;1;0;0;0;1;0;0
13240.0;2022;12;NANCY-METZ;MASCULIN;APPRENTISSAGE;BAC PROFESSIONNEL;BAC PRO SERV;BAC PRO 32303 ART.& MET.ART:COM.VIS.VIS.PLURI-M;1;1;0;1;0;0;0;0;0;0;0;0;0;1
13243.0;2022;12;NANCY-METZ;MASCULIN;ENSEIGNEMENT A DISTANCE;BAC GENERAL;BAC GENERAL;BAC GENE 10019 BAC GENERAL;15;15;12;2;1;1;0;13;0;0;3;7;3;2
13244.0;2022;12;NANCY-METZ;MASCULIN;ENSEIGNEMENT A DISTANCE;BAC TECHNOLOGIQUE;BAC ST2S;BAC ST2S SCIENCES & TECHNO. SANTE & SOCIAL;1;1;1;0;0;0;0;1;0;0;0;1;0;0
13245.0;2022;12;NANCY-METZ;MASCULIN;ENSEIGNEMENT A DISTANCE;BAC TECHNOLOGIQUE;BAC STMG;BAC STMG MERCATIQUE (MARKETING);2;2;1;0;1;0;1;1;0;0;0;0;1;1
13248.0;2022;12;NANCY-METZ;MASCULIN;FORMATION CONTINUE;BAC PROFESSIONNEL;BAC PRO PROD;BACPRO 20002 ETUD.DEFINITION PRDTS INDUSTRIEL;3;3;3;0;0;0;0;3;0;0;3;0;0;0
13252.0;2022;12;NANCY-METZ;MASCULIN;FORMATION CONTINUE;BAC PROFESSIONNEL;BAC PRO PROD;BAC PRO 23004 TECHN. ETUDES BAT.A ETUDES & ECO.;4;4;3;1;0;0;0;3;0;1;0;2;0;1
13254.0;2022;12;NANCY-METZ;MASCULIN;FORMATION CONTINUE;BAC PROFESSIONNEL;BAC PRO PROD;BAC PRO 25106 TECHNICIEN D'USINAGE;1;1;1;0;0;0;0;1;0;1;0;0;0;0
13256.0;2022;12;NANCY-METZ;MASCULIN;FORMATION CONTINUE;BAC PROFESSIONNEL;BAC PRO PROD;BAC PRO 25408 REPARATION DES CARROSSERIES;5;5;3;2;0;0;0;3;0;0;3;0;0;2
13257.0;2022;12;NANCY-METZ;MASCULIN;FORMATION CONTINUE;BAC PROFESSIONNEL;BAC PRO PROD;BAC PRO 25510 METIERS ELECT. ENVIRON. CONNECTES;3;3;3;0;0;0;0;3;0;2;1;0;0;0
13262.0;2022;12;NANCY-METZ;MASCULIN;FORMATION CONTINUE;BAC PROFESSIONNEL;BAC PRO SERV;BAC PRO 31212 METIERS DE L'ACCUEIL;1;1;1;0;0;0;0;1;0;1;0;0;0;0
13264.0;2022;12;NANCY-METZ;MASCULIN;FORMATION CONTINUE;BAC PROFESSIONNEL;BAC PRO SERV;BAC PRO 31214 MET.COM.VEN.OP.B PR.CL.VA.OF.COM.;5;5;5;0;0;0;0;5;0;1;2;1;1;0
13270.0;2022;12;NANCY-METZ;MASCULIN;INDIVIDUEL;BAC PROFESSIONNEL;BAC PRO PROD;BAC PRO 23405 TECHNICIEN MENUISIER AGENCEUR;1;0;0;0;0;0;0;0;0;0;0;0;0;0
13276.0;2022;12;NANCY-METZ;MASCULIN;INDIVIDUEL;BAC PROFESSIONNEL;BAC PRO PROD;BAC PRO AG 21302 GEST MILIEUX NATURELS FAUNE;1;1;1;0;0;0;0;1;0;0;0;0;1;0
13280.0;2022;12;NANCY-METZ;MASCULIN;INDIVIDUEL;BAC PROFESSIONNEL;BAC PRO SERV;BAC PRO 31214 MET.COM.VEN.OP.B PR.CL.VA.OF.COM.;5;2;1;1;0;0;0;1;0;0;1;0;0;1
13292.0;2022;12;NANCY-METZ;MASCULIN;SCOLAIRE;BAC PROFESSIONNEL;BAC PRO PROD;BAC PRO 22003 BIO-INDUSTRIES DE TRANSFORMATION;4;4;4;0;0;0;0;4;0;0;0;3;1;0
13295.0;2022;12;NANCY-METZ;MASCULIN;SCOLAIRE;BAC PROFESSIONNEL;BAC PRO PROD;BAC PRO 22106 CUISINE;132;132;99;25;8;6;2;105;0;5;10;49;41;27
13304.0;2022;12;NANCY-METZ;MASCULIN;SCOLAIRE;BAC PROFESSIONNEL;BAC PRO PROD;BAC PRO 23203 TECHNICIEN BAT. : ORG.REAL.GROS O;9;9;7;1;1;1;0;8;0;0;1;1;6;1
13312.0;2022;12;NANCY-METZ;MASCULIN;SCOLAIRE;BAC PROFESSIONNEL;BAC PRO PROD;BAC PRO 24203 METIERS DE LA MODE - VÊTEMENT;3;3;3;0;0;0;0;3;0;2;0;1;0;0
13314.0;2022;12;NANCY-METZ;MASCULIN;SCOLAIRE;BAC PROFESSIONNEL;BAC PRO PROD;BAC PRO 25007 MAINTENANCE EQUIPEMENTS INDUST.;217;217;168;45;4;4;0;172;0;4;27;74;67;45
13317.0;2022;12;NANCY-METZ;MASCULIN;SCOLAIRE;BAC PROFESSIONNEL;BAC PRO PROD;BAC PRO 25214 MAINT.VEHIC.OPTA VOIT.PARTICUL.;212;211;153;45;13;9;4;162;0;17;33;55;57;49
13322.0;2022;12;NANCY-METZ;MASCULIN;SCOLAIRE;BAC PROFESSIONNEL;BAC PRO PROD;BAC PRO 25302 AERONAUTIQUE OPTION AVIONIQUE;10;10;10;0;0;0;0;10;0;1;6;3;0;0
13325.0;2022;12;NANCY-METZ;MASCULIN;SCOLAIRE;BAC PROFESSIONNEL;BAC PRO PROD;BAC PRO 25408 REPARATION DES CARROSSERIES;69;69;46;16;7;3;4;49;0;2;6;11;30;20
13336.0;2022;12;NANCY-METZ;MASCULIN;SCOLAIRE;BAC PROFESSIONNEL;BAC PRO PROD;BAC PRO AG 21203 TECHN CONSEIL DE VENTE ANIMAL;13;13;9;4;0;0;0;9;0;0;0;5;4;4
13345.0;2022;12;NANCY-METZ;MASCULIN;SCOLAIRE;BAC PROFESSIONNEL;BAC PRO SERV;BAC PRO 31108 TRANSPORT;27;27;20;7;0;0;0;20;0;2;2;6;10;7
13346.0;2022;12;NANCY-METZ;MASCULIN;SCOLAIRE;BAC PROFESSIONNEL;BAC PRO SERV;BAC PRO 31212 METIERS DE L'ACCUEIL;24;24;21;3;0;0;0;21;0;4;9;5;3;3
13348.0;2022;12;NANCY-METZ;MASCULIN;SCOLAIRE;BAC PROFESSIONNEL;BAC PRO SERV;BAC PRO 31214 MET.COM.VEN.OP.B PR.CL.VA.OF.COM.;252;252;205;30;17;13;4;218;0;5;38;95;80;34
13350.0;2022;12;NANCY-METZ;MASCULIN;SCOLAIRE;BAC PROFESSIONNEL;BAC PRO SERV;BAC PRO 32208 REAL.PR.IMPR.PLURI.OPTB.PR.IMPR.;6;6;5;1;0;0;0;5;0;0;0;3;2;1
13352.0;2022;12;NANCY-METZ;MASCULIN;SCOLAIRE;BAC PROFESSIONNEL;BAC PRO SERV;BAC PRO 32304 PHOTOGRAPHIE;1;1;1;0;0;0;0;1;0;0;0;0;1;0
13358.0;2022;12;NANCY-METZ;MASCULIN;SCOLAIRE;BAC PROFESSIONNEL;BAC PRO SERV;BAC PRO 33403 COMMERC. SERVICES EN RESTAURATION;77;77;60;13;4;4;0;64;0;3;7;21;33;13
13361.0;2022;12;NANCY-METZ;MASCULIN;SCOLAIRE;BAC PROFESSIONNEL;BAC PRO SERV;BAC PRO 34403 METIERS DE LA SECURITE;70;70;67;1;2;1;1;68;0;4;19;24;21;2
13367.0;2022;12;NANCY-METZ;MASCULIN;SCOLAIRE;BAC TECHNOLOGIQUE;BAC STD2A;BAC STD2A SCIENCES & TECHNO. DESIGN-ARTS APPLIQUES;17;17;17;0;0;0;0;17;1;1;2;10;3;0
13373.0;2022;12;NANCY-METZ;MASCULIN;SCOLAIRE;BAC TECHNOLOGIQUE;BAC STL;BAC STL BIOCHIM.-BIOLOGIE-BIOTECHNOL.;42;42;30;6;6;3;3;33;0;0;2;15;16;9
13375.0;2022;12;NANCY-METZ;MASCULIN;SCOLAIRE;BAC TECHNOLOGIQUE;BAC STMG;BAC STMG GESTION ET FINANCE;372;372;311;19;42;24;18;335;1;3;38;134;159;37
13377.0;2022;12;NANCY-METZ;MASCULIN;SCOLAIRE;BAC TECHNOLOGIQUE;BAC STMG;BAC STMG RESSOURCES HUMAINES ET COMMUNICATION;177;177;136;11;30;21;9;157;0;2;10;52;93;20
13391.0;2022;17;NANTES;FEMININ;APPRENTISSAGE;BAC PROFESSIONNEL;BAC PRO PROD;BAC PRO 25214 MAINT.VEHIC.OPTA VOIT.PARTICUL.;13;13;12;1;0;0;0;12;0;1;5;5;1;1
13398.0;2022;17;NANTES;FEMININ;APPRENTISSAGE;BAC PROFESSIONNEL;BAC PRO PROD;BAC PRO 25510 METIERS ELECT. ENVIRON. CONNECTES;1;1;1;0;0;0;0;1;0;0;1;0;0;0
13403.0;2022;17;NANTES;FEMININ;APPRENTISSAGE;BAC PROFESSIONNEL;BAC PRO PROD;BAC PRO AG 21114 CONDUITE PRODUCTIONS HORTICOLES;11;11;10;1;0;0;0;10;0;0;2;0;8;1
13406.0;2022;17;NANTES;FEMININ;APPRENTISSAGE;BAC PROFESSIONNEL;BAC PRO PROD;BAC PRO AG 21211 COND GEST ENTR HIPPIQUE;28;27;26;1;0;0;0;26;0;0;2;8;16;1
13414.0;2022;17;NANTES;FEMININ;APPRENTISSAGE;BAC PROFESSIONNEL;BAC PRO SERV;BAC PRO 31213 MET.COM.VEN.OP.A ANI.GES.ESP.COM.;300;295;235;42;18;12;6;247;0;14;45;90;98;48
13415.0;2022;17;NANTES;FEMININ;APPRENTISSAGE;BAC PROFESSIONNEL;BAC PRO SERV;BAC PRO 31214 MET.COM.VEN.OP.B PR.CL.VA.OF.COM.;1;1;0;1;0;0;0;0;0;0;0;0;0;1
13418.0;2022;17;NANTES;FEMININ;APPRENTISSAGE;BAC PROFESSIONNEL;BAC PRO SERV;BAC PRO 32208 REAL.PR.IMPR.PLURI.OPTB.PR.IMPR.;3;3;3;0;0;0;0;3;0;2;0;0;1;0
13422.0;2022;17;NANTES;FEMININ;APPRENTISSAGE;BAC PROFESSIONNEL;BAC PRO SERV;BAC PRO 33403 COMMERC. SERVICES EN RESTAURATION;23;22;21;0;1;1;0;22;0;0;4;6;12;0
13426.0;2022;17;NANTES;FEMININ;ENSEIGNEMENT A DISTANCE;BAC PROFESSIONNEL;BAC PRO PROD;BAC PRO AG 21004 CGEA;3;3;3;0;0;0;0;3;0;0;0;0;3;0
13433.0;2022;17;NANTES;FEMININ;ENSEIGNEMENT A DISTANCE;BAC TECHNOLOGIQUE;BAC STMG;BAC STMG GESTION ET FINANCE;2;2;1;1;0;0;0;1;0;0;0;0;1;1
13442.0;2022;17;NANTES;FEMININ;FORMATION CONTINUE;BAC PROFESSIONNEL;BAC PRO SERV;BAC PRO 33102 PROTHESE DENTAIRE;3;3;3;0;0;0;0;3;0;1;1;1;0;0
13448.0;2022;17;NANTES;FEMININ;INDIVIDUEL;BAC PROFESSIONNEL;BAC PRO SERV;BAC PRO 30001 GESTION-ADMINISTRATION;9;5;0;5;0;0;0;0;0;0;0;0;0;5
13449.0;2022;17;NANTES;FEMININ;INDIVIDUEL;BAC PROFESSIONNEL;BAC PRO SERV;BAC PRO 31213 MET.COM.VEN.OP.A ANI.GES.ESP.COM.;2;2;1;1;0;0;0;1;0;0;0;0;1;1
13451.0;2022;17;NANTES;FEMININ;INDIVIDUEL;BAC PROFESSIONNEL;BAC PRO SERV;BAC PRO 32304 PHOTOGRAPHIE;1;1;1;0;0;0;0;1;0;0;0;0;1;0
13455.0;2022;17;NANTES;FEMININ;INDIVIDUEL;BAC PROFESSIONNEL;BAC PRO SERV;BAC PRO AG 33002 SERV PERS TERRIT;4;2;0;2;0;0;0;0;0;0;0;0;0;2
13456.0;2022;17;NANTES;FEMININ;INDIVIDUEL;BAC TECHNOLOGIQUE;BAC ST2S;BAC ST2S SCIENCES & TECHNO. SANTE & SOCIAL;6;6;0;6;0;0;0;0;0;0;0;0;0;6
13462.0;2022;17;NANTES;FEMININ;SCOLAIRE;BAC PROFESSIONNEL;BAC PRO PROD;BAC PRO 22004 PROC. CHIMIE EAU PAPIERS-CARTONS;9;9;9;0;0;0;0;9;0;1;3;4;1;0
13464.0;2022;17;NANTES;FEMININ;SCOLAIRE;BAC PROFESSIONNEL;BAC PRO PROD;BAC PRO 22106 CUISINE;82;82;67;12;3;2;1;69;0;3;15;27;24;13
13466.0;2022;17;NANTES;FEMININ;SCOLAIRE;BAC PROFESSIONNEL;BAC PRO PROD;BAC PRO 22503 PLASTIQUES ET COMPOSITES;1;1;1;0;0;0;0;1;0;0;1;0;0;0
13472.0;2022;17;NANTES;FEMININ;SCOLAIRE;BAC PROFESSIONNEL;BAC PRO PROD;BAC PRO 23405 TECHNICIEN MENUISIER AGENCEUR;13;13;10;3;0;0;0;10;0;3;1;4;2;3
13474.0;2022;17;NANTES;FEMININ;SCOLAIRE;BAC PROFESSIONNEL;BAC PRO PROD;BAC PRO 24202 ARTIS.& MET.ART : TAPIS.D'AMEUBL;8;8;7;1;0;0;0;7;0;3;1;1;2;1
13475.0;2022;17;NANTES;FEMININ;SCOLAIRE;BAC PROFESSIONNEL;BAC PRO PROD;BAC PRO 24203 METIERS DE LA MODE - VÊTEMENT;191;191;166;24;1;1;0;167;0;21;41;65;40;24
13481.0;2022;17;NANTES;FEMININ;SCOLAIRE;BAC PROFESSIONNEL;BAC PRO PROD;BAC PRO 25215 MAINT.VEHIC.OPTB VEHIC.TRANS.ROUT;1;1;1;0;0;0;0;1;0;0;0;0;1;0
13488.0;2022;17;NANTES;FEMININ;SCOLAIRE;BAC PROFESSIONNEL;BAC PRO PROD;BAC PRO 25513 SYST.NUM.OPT.A SURETE SECURITE;1;1;1;0;0;0;0;1;0;0;0;1;0;0
13492.0;2022;17;NANTES;FEMININ;SCOLAIRE;BAC PROFESSIONNEL;BAC PRO PROD;BAC PRO AG 21004 CGEA;116;113;87;26;0;0;0;87;0;1;10;29;47;26
13493.0;2022;17;NANTES;FEMININ;SCOLAIRE;BAC PROFESSIONNEL;BAC PRO PROD;BAC PRO AG 21113 CGEVV;2;2;1;1;0;0;0;1;0;0;0;1;0;1
13494.0;2022;17;NANTES;FEMININ;SCOLAIRE;BAC PROFESSIONNEL;BAC PRO PROD;BAC PRO AG 21114 CONDUITE PRODUCTIONS HORTICOLES;31;31;25;6;0;0;0;25;0;0;3;9;13;6
13507.0;2022;17;NANTES;FEMININ;SCOLAIRE;BAC PROFESSIONNEL;BAC PRO SERV;BAC PRO 31108 TRANSPORT;12;12;6;6;0;0;0;6;0;0;1;3;2;6
13508.0;2022;17;NANTES;FEMININ;SCOLAIRE;BAC PROFESSIONNEL;BAC PRO SERV;BAC PRO 31212 METIERS DE L'ACCUEIL;272;272;235;25;12;8;4;243;0;11;61;95;76;29
13509.0;2022;17;NANTES;FEMININ;SCOLAIRE;BAC PROFESSIONNEL;BAC PRO SERV;BAC PRO 31213 MET.COM.VEN.OP.A ANI.GES.ESP.COM.;682;682;606;52;24;17;7;623;0;39;151;251;182;59
13511.0;2022;17;NANTES;FEMININ;SCOLAIRE;BAC PROFESSIONNEL;BAC PRO SERV;BAC PRO 32207 REAL.PR.IMPR.PLURI.OPTA.PR.GRAPH.;10;10;9;1;0;0;0;9;0;1;2;2;4;1
13516.0;2022;17;NANTES;FEMININ;SCOLAIRE;BAC PROFESSIONNEL;BAC PRO SERV;BAC PRO 33003 ACC.SOINS-S.PERS. OPT.A DOMICILE;120;119;101;15;3;1;2;102;0;1;20;46;35;17
13521.0;2022;17;NANTES;FEMININ;SCOLAIRE;BAC PROFESSIONNEL;BAC PRO SERV;BAC PRO 33403 COMMERC. SERVICES EN RESTAURATION;90;90;72;16;2;1;1;73;0;2;17;31;23;17
13547.0;2022;17;NANTES;MASCULIN;APPRENTISSAGE;BAC PROFESSIONNEL;BAC PRO PROD;BAC PRO 22503 PLASTIQUES ET COMPOSITES;14;14;12;1;1;0;1;12;0;2;1;4;5;2
13549.0;2022;17;NANTES;MASCULIN;APPRENTISSAGE;BAC PROFESSIONNEL;BAC PRO PROD;BAC PRO 22704 TECHN. MAINT. SYST.ENERG.CLIMATI;11;11;10;0;1;1;0;11;0;1;3;5;2;0
13561.0;2022;17;NANTES;MASCULIN;APPRENTISSAGE;BAC PROFESSIONNEL;BAC PRO PROD;BAC PRO 25006 MICROTECHNIQUES;7;7;5;1;1;1;0;6;0;0;2;2;2;1
13572.0;2022;17;NANTES;MASCULIN;APPRENTISSAGE;BAC PROFESSIONNEL;BAC PRO PROD;BAC PRO 25303 AERONAUTIQUE OPTION SYSTEMES;7;7;7;0;0;0;0;7;0;2;2;3;0;0
13575.0;2022;17;NANTES;MASCULIN;APPRENTISSAGE;BAC PROFESSIONNEL;BAC PRO PROD;BAC PRO 25408 REPARATION DES CARROSSERIES;37;37;27;6;4;3;1;30;0;0;3;12;15;7
13576.0;2022;17;NANTES;MASCULIN;APPRENTISSAGE;BAC PROFESSIONNEL;BAC PRO PROD;BAC PRO 25410 CONSTRUCTION DES CARROSSERIES;1;1;1;0;0;0;0;1;0;0;0;0;1;0
13579.0;2022;17;NANTES;MASCULIN;APPRENTISSAGE;BAC PROFESSIONNEL;BAC PRO PROD;BAC PRO 25510 METIERS ELECT. ENVIRON. CONNECTES;141;139;110;20;9;4;5;114;0;7;26;49;32;25
13583.0;2022;17;NANTES;MASCULIN;APPRENTISSAGE;BAC PROFESSIONNEL;BAC PRO PROD;BAC PRO AG 21001 AGRO-EQUIPEMENT;56;56;39;17;0;0;0;39;0;0;2;8;29;17
13587.0;2022;17;NANTES;MASCULIN;APPRENTISSAGE;BAC PROFESSIONNEL;BAC PRO PROD;BAC PRO AG 21203 TECHN CONSEIL DE VENTE ANIMAL;1;1;0;1;0;0;0;0;0;0;0;0;0;1
13589.0;2022;17;NANTES;MASCULIN;APPRENTISSAGE;BAC PROFESSIONNEL;BAC PRO PROD;BAC PRO AG 21210 COND GEST ENTR CANIN ET FELIN;2;1;0;1;0;0;0;0;0;0;0;0;0;1
13590.0;2022;17;NANTES;MASCULIN;APPRENTISSAGE;BAC PROFESSIONNEL;BAC PRO PROD;BAC PRO AG 21211 COND GEST ENTR HIPPIQUE;15;15;15;0;0;0;0;15;0;0;3;6;6;0
13592.0;2022;17;NANTES;MASCULIN;APPRENTISSAGE;BAC PROFESSIONNEL;BAC PRO PROD;BAC PRO AG 21303 FORET;4;4;3;1;0;0;0;3;0;0;0;3;0;1
13594.0;2022;17;NANTES;MASCULIN;APPRENTISSAGE;BAC PROFESSIONNEL;BAC PRO PROD;BAC PRO AG 22107 TEC CONS VTE ALIMENTATION P.ALIM;8;8;7;1;0;0;0;7;0;0;0;5;2;1
13600.0;2022;17;NANTES;MASCULIN;APPRENTISSAGE;BAC PROFESSIONNEL;BAC PRO SERV;BAC PRO 31213 MET.COM.VEN.OP.A ANI.GES.ESP.COM.;222;219;156;39;24;11;13;167;0;7;24;62;74;52
13605.0;2022;17;NANTES;MASCULIN;APPRENTISSAGE;BAC PROFESSIONNEL;BAC PRO SERV;BAC PRO 33102 PROTHESE DENTAIRE;1;1;1;0;0;0;0;1;0;0;0;1;0;0
13609.0;2022;17;NANTES;MASCULIN;ENSEIGNEMENT A DISTANCE;BAC PROFESSIONNEL;BAC PRO PROD;BAC PRO 22704 TECHN. MAINT. SYST.ENERG.CLIMATI;1;0;0;0;0;0;0;0;0;0;0;0;0;0
13613.0;2022;17;NANTES;MASCULIN;ENSEIGNEMENT A DISTANCE;BAC PROFESSIONNEL;BAC PRO SERV;BAC PRO 32304 PHOTOGRAPHIE;1;1;1;0;0;0;0;1;0;0;1;0;0;0
13616.0;2022;17;NANTES;MASCULIN;ENSEIGNEMENT A DISTANCE;BAC TECHNOLOGIQUE;BAC STMG;BAC STMG RESSOURCES HUMAINES ET COMMUNICATION;4;4;3;0;1;1;0;4;0;0;0;0;4;0
13625.0;2022;17;NANTES;MASCULIN;FORMATION CONTINUE;BAC PROFESSIONNEL;BAC PRO PROD;BAC PRO 25214 MAINT.VEHIC.OPTA VOIT.PARTICUL.;2;2;2;0;0;0;0;2;0;1;0;0;1;0
13629.0;2022;17;NANTES;MASCULIN;FORMATION CONTINUE;BAC PROFESSIONNEL;BAC PRO PROD;BAC PRO AG 21113 CGEVV;4;4;4;0;0;0;0;4;0;0;0;0;4;0
13633.0;2022;17;NANTES;MASCULIN;INDIVIDUEL;BAC GENERAL;BAC GENERAL;BAC GENE 10019 BAC GENERAL;104;74;38;22;14;8;6;46;0;4;10;5;27;28
13635.0;2022;17;NANTES;MASCULIN;INDIVIDUEL;BAC PROFESSIONNEL;BAC PRO PROD;BAC PRO 22106 CUISINE;2;2;1;1;0;0;0;1;0;0;0;1;0;1
13636.0;2022;17;NANTES;MASCULIN;INDIVIDUEL;BAC PROFESSIONNEL;BAC PRO PROD;BAC PRO 22703 TECHN.INSTALL.SYST.ENERG.CLIMATI;1;1;0;1;0;0;0;0;0;0;0;0;0;1
13641.0;2022;17;NANTES;MASCULIN;INDIVIDUEL;BAC PROFESSIONNEL;BAC PRO PROD;BAC PRO 25214 MAINT.VEHIC.OPTA VOIT.PARTICUL.;6;3;3;0;0;0;0;3;0;1;0;1;1;0
13648.0;2022;17;NANTES;MASCULIN;INDIVIDUEL;BAC PROFESSIONNEL;BAC PRO PROD;BAC PRO AG 21004 CGEA;11;9;7;2;0;0;0;7;0;0;0;1;6;2
13664.0;2022;17;NANTES;MASCULIN;INDIVIDUEL;BAC TECHNOLOGIQUE;BAC STI2D;BAC STI2D ENERGIES  ET ENVIRONNEMENT;1;1;0;1;0;0;0;0;0;0;0;0;0;1
13665.0;2022;17;NANTES;MASCULIN;INDIVIDUEL;BAC TECHNOLOGIQUE;BAC STI2D;BAC STI2D INNOVATION TECHNO.  ET ECO CONCEPTION;1;1;0;1;0;0;0;0;0;0;0;0;0;1
13670.0;2022;17;NANTES;MASCULIN;INDIVIDUEL;BAC TECHNOLOGIQUE;BAC STMG;BAC STMG MERCATIQUE (MARKETING);22;14;3;9;2;1;1;4;0;0;0;1;3;10
13672.0;2022;17;NANTES;MASCULIN;INDIVIDUEL;BAC TECHNOLOGIQUE;BAC STMG;BAC STMG SYSTEMES D'INFORMATION DE GESTION;2;1;0;1;0;0;0;0;0;0;0;0;0;1
13678.0;2022;17;NANTES;MASCULIN;SCOLAIRE;BAC PROFESSIONNEL;BAC PRO PROD;BAC PRO 22106 CUISINE;169;169;152;15;2;2;0;154;0;9;37;59;49;15
13686.0;2022;17;NANTES;MASCULIN;SCOLAIRE;BAC PROFESSIONNEL;BAC PRO PROD;BAC PRO 23102 TRAVAUX PUBLICS;9;9;8;1;0;0;0;8;0;2;2;3;1;1
13688.0;2022;17;NANTES;MASCULIN;SCOLAIRE;BAC PROFESSIONNEL;BAC PRO PROD;BAC PRO 23203 TECHNICIEN BAT. : ORG.REAL.GROS O;17;17;10;5;2;1;1;11;0;0;2;5;4;6
13692.0;2022;17;NANTES;MASCULIN;SCOLAIRE;BAC PROFESSIONNEL;BAC PRO PROD;BAC PRO 23404 TECHNICIEN CONSTRUCTEUR BOIS;32;32;23;8;1;1;0;24;0;0;4;7;13;8
13698.0;2022;17;NANTES;MASCULIN;SCOLAIRE;BAC PROFESSIONNEL;BAC PRO PROD;BAC PRO 24302 METIERS DU CUIR : MAROQUINERIE;2;2;1;1;0;0;0;1;0;0;0;0;1;1
13702.0;2022;17;NANTES;MASCULIN;SCOLAIRE;BAC PROFESSIONNEL;BAC PRO PROD;BAC PRO 25106 TECHNICIEN D'USINAGE;136;136;102;29;5;5;0;107;0;5;24;39;39;29
13705.0;2022;17;NANTES;MASCULIN;SCOLAIRE;BAC PROFESSIONNEL;BAC PRO PROD;BAC PRO 25215 MAINT.VEHIC.OPTB VEHIC.TRANS.ROUT;14;14;9;4;1;0;1;9;0;1;1;5;2;5
13707.0;2022;17;NANTES;MASCULIN;SCOLAIRE;BAC PROFESSIONNEL;BAC PRO PROD;BAC PRO 25219 MAINT.MATERIELS OPT.A AGRICOLES;45;45;41;0;4;3;1;44;0;3;14;17;10;1
13709.0;2022;17;NANTES;MASCULIN;SCOLAIRE;BAC PROFESSIONNEL;BAC PRO PROD;BAC PRO 25221 MAINT.MATERIELS OPT.C ESP. VERTS;18;18;10;6;2;1;1;11;0;0;3;2;6;7
13727.0;2022;17;NANTES;MASCULIN;SCOLAIRE;BAC PROFESSIONNEL;BAC PRO PROD;BAC PRO AG 21302 GEST MILIEUX NATURELS FAUNE;55;55;51;4;0;0;0;51;0;0;7;18;26;4
13729.0;2022;17;NANTES;MASCULIN;SCOLAIRE;BAC PROFESSIONNEL;BAC PRO PROD;BAC PRO AG 21405 AMENAGEMENTS PAYSAGERS;147;146;136;10;0;0;0;136;0;3;20;53;60;10
13736.0;2022;17;NANTES;MASCULIN;SCOLAIRE;BAC PROFESSIONNEL;BAC PRO SERV;BAC PRO 31107 CONDUCT. TRANSP.ROUT.MARCHANDISES;92;92;83;8;1;0;1;83;0;15;21;42;5;9
13739.0;2022;17;NANTES;MASCULIN;SCOLAIRE;BAC PROFESSIONNEL;BAC PRO SERV;BAC PRO 31213 MET.COM.VEN.OP.A ANI.GES.ESP.COM.;614;613;505;76;32;26;6;531;0;11;109;189;222;82
13740.0;2022;17;NANTES;MASCULIN;SCOLAIRE;BAC PROFESSIONNEL;BAC PRO SERV;BAC PRO 31214 MET.COM.VEN.OP.B PR.CL.VA.OF.COM.;213;213;191;17;5;4;1;195;0;9;47;71;68;18
13741.0;2022;17;NANTES;MASCULIN;SCOLAIRE;BAC PROFESSIONNEL;BAC PRO SERV;BAC PRO 32207 REAL.PR.IMPR.PLURI.OPTA.PR.GRAPH.;19;19;18;0;1;1;0;19;0;2;5;7;5;0
13748.0;2022;17;NANTES;MASCULIN;SCOLAIRE;BAC PROFESSIONNEL;BAC PRO SERV;BAC PRO 33101 OPTIQUE LUNETTERIE;2;2;2;0;0;0;0;2;0;0;0;2;0;0
13754.0;2022;17;NANTES;MASCULIN;SCOLAIRE;BAC PROFESSIONNEL;BAC PRO SERV;BAC PRO 34403 METIERS DE LA SECURITE;91;91;90;1;0;0;0;90;0;5;27;41;17;1
13758.0;2022;17;NANTES;MASCULIN;SCOLAIRE;BAC TECHNOLOGIQUE;BAC ST2S;BAC ST2S SCIENCES & TECHNO. SANTE & SOCIAL;182;182;138;9;35;25;10;163;0;2;10;44;107;19
13763.0;2022;17;NANTES;MASCULIN;SCOLAIRE;BAC TECHNOLOGIQUE;BAC STI2D;BAC STI2D ENERGIES  ET ENVIRONNEMENT;263;263;213;11;39;30;9;243;0;0;34;80;129;20
13772.0;2022;23;NICE;FEMININ;APPRENTISSAGE;BAC PROFESSIONNEL;BAC PRO PROD;BAC PRO 22106 CUISINE;5;5;5;0;0;0;0;5;0;0;2;3;0;0
13788.0;2022;23;NICE;FEMININ;APPRENTISSAGE;BAC PROFESSIONNEL;BAC PRO SERV;BAC PRO 31213 MET.COM.VEN.OP.A ANI.GES.ESP.COM.;56;54;41;10;3;1;2;42;0;3;8;15;16;12
13796.0;2022;23;NICE;FEMININ;ENSEIGNEMENT A DISTANCE;BAC PROFESSIONNEL;BAC PRO SERV;BAC PRO 31214 MET.COM.VEN.OP.B PR.CL.VA.OF.COM.;2;2;1;1;0;0;0;1;0;0;0;0;1;1
13800.0;2022;23;NICE;FEMININ;ENSEIGNEMENT A DISTANCE;BAC TECHNOLOGIQUE;BAC STMG;BAC STMG GESTION ET FINANCE;4;4;3;1;0;0;0;3;0;0;2;0;1;1
13809.0;2022;23;NICE;FEMININ;FORMATION CONTINUE;BAC PROFESSIONNEL;BAC PRO SERV;BAC PRO 33603 ESTHETIQUE COSMETIQUE PARFUMERIE;7;6;5;1;0;0;0;5;0;0;0;3;2;1
13812.0;2022;23;NICE;FEMININ;INDIVIDUEL;BAC PROFESSIONNEL;BAC PRO PROD;BAC PRO 24203 METIERS DE LA MODE - VÊTEMENT;1;0;0;0;0;0;0;0;0;0;0;0;0;0
13818.0;2022;23;NICE;FEMININ;INDIVIDUEL;BAC PROFESSIONNEL;BAC PRO SERV;BAC PRO 31213 MET.COM.VEN.OP.A ANI.GES.ESP.COM.;3;0;0;0;0;0;0;0;0;0;0;0;0;0
13829.0;2022;23;NICE;FEMININ;SCOLAIRE;BAC PROFESSIONNEL;BAC PRO PROD;BAC PRO 20102 PILOTE DE LIGNE DE PRODUCTION;1;1;1;0;0;0;0;1;0;0;0;1;0;0
13831.0;2022;23;NICE;FEMININ;SCOLAIRE;BAC PROFESSIONNEL;BAC PRO PROD;BAC PRO 22106 CUISINE;59;59;46;10;3;2;1;48;0;0;6;22;20;11
13836.0;2022;23;NICE;FEMININ;SCOLAIRE;BAC PROFESSIONNEL;BAC PRO PROD;BACPRO 23103 TECHNICIEN GEOMETRE-TOPOGRAPHE;1;1;1;0;0;0;0;1;0;0;0;1;0;0
13837.0;2022;23;NICE;FEMININ;SCOLAIRE;BAC PROFESSIONNEL;BAC PRO PROD;BAC PRO 23304 AMENAGEMENT FINITION BATIMENT;1;1;0;1;0;0;0;0;0;0;0;0;0;1
13842.0;2022;23;NICE;FEMININ;SCOLAIRE;BAC PROFESSIONNEL;BAC PRO PROD;BAC PRO 24302 METIERS DU CUIR : MAROQUINERIE;11;11;11;0;0;0;0;11;0;3;4;1;3;0
13845.0;2022;23;NICE;FEMININ;SCOLAIRE;BAC PROFESSIONNEL;BAC PRO PROD;BAC PRO 25106 TECHNICIEN D'USINAGE;1;1;0;1;0;0;0;0;0;0;0;0;0;1
13848.0;2022;23;NICE;FEMININ;SCOLAIRE;BAC PROFESSIONNEL;BAC PRO PROD;BAC PRO 25406 OUVRAGES DU BATIMENT METALLERIE;1;1;1;0;0;0;0;1;0;0;1;0;0;0
13851.0;2022;23;NICE;FEMININ;SCOLAIRE;BAC PROFESSIONNEL;BAC PRO PROD;BAC PRO 25510 METIERS ELECT. ENVIRON. CONNECTES;2;2;2;0;0;0;0;2;0;1;0;1;0;0
13860.0;2022;23;NICE;FEMININ;SCOLAIRE;BAC PROFESSIONNEL;BAC PRO SERV;BAC PRO 30001 GESTION-ADMINISTRATION;366;366;301;53;12;12;0;313;0;9;43;132;129;53
13861.0;2022;23;NICE;FEMININ;SCOLAIRE;BAC PROFESSIONNEL;BAC PRO SERV;BAC PRO 31106 LOGISTIQUE;4;4;1;2;1;0;1;1;0;1;0;0;0;3
13869.0;2022;23;NICE;FEMININ;SCOLAIRE;BAC PROFESSIONNEL;BAC PRO SERV;BAC PRO 33002 SERVICES DE PROXIMITE  VIE LOCAL;10;10;9;1;0;0;0;9;0;0;3;4;2;1
13872.0;2022;23;NICE;FEMININ;SCOLAIRE;BAC PROFESSIONNEL;BAC PRO SERV;BAC PRO 33101 OPTIQUE LUNETTERIE;7;7;6;1;0;0;0;6;0;2;0;2;2;1
13878.0;2022;23;NICE;FEMININ;SCOLAIRE;BAC TECHNOLOGIQUE;BAC S2TMD;BAC S2TMD DANSE;2;2;2;0;0;0;0;2;0;0;1;1;0;0
13890.0;2022;23;NICE;FEMININ;SCOLAIRE;BAC TECHNOLOGIQUE;BAC STMG;BAC STMG GESTION ET FINANCE;221;221;204;3;14;10;4;214;0;9;57;93;55;7
13895.0;2022;23;NICE;MASCULIN;APPRENTISSAGE;BAC PROFESSIONNEL;BAC PRO PROD;BAC PRO 22403 ARTS.& MET.ART:MET.ENSEIGN SIGNA;2;2;2;0;0;0;0;2;0;0;1;1;0;0
13902.0;2022;23;NICE;MASCULIN;APPRENTISSAGE;BAC PROFESSIONNEL;BAC PRO PROD;BAC PRO 25007 MAINTENANCE EQUIPEMENTS INDUST.;8;8;7;1;0;0;0;7;0;3;0;3;1;1
13907.0;2022;23;NICE;MASCULIN;APPRENTISSAGE;BAC PROFESSIONNEL;BAC PRO PROD;BAC PRO 25216 MAINT.VEHIC.OPTC MOTOCYCLES;19;15;15;0;0;0;0;15;0;4;2;9;0;0
13911.0;2022;23;NICE;MASCULIN;APPRENTISSAGE;BAC PROFESSIONNEL;BAC PRO PROD;BAC PRO 25411 TECH.CHAUDRONNERIE INDUSTRIELLE;12;12;10;0;2;1;1;11;0;3;2;2;4;1
13913.0;2022;23;NICE;MASCULIN;APPRENTISSAGE;BAC PROFESSIONNEL;BAC PRO PROD;BAC PRO 25510 METIERS ELECT. ENVIRON. CONNECTES;53;52;39;12;1;1;0;40;0;11;6;11;12;12
13916.0;2022;23;NICE;MASCULIN;APPRENTISSAGE;BAC PROFESSIONNEL;BAC PRO PROD;BAC PRO 25515 SYST.NUM.OPT.C RES.INF.SYST.COMM.;1;1;1;0;0;0;0;1;0;0;0;0;1;0
13918.0;2022;23;NICE;MASCULIN;APPRENTISSAGE;BAC PROFESSIONNEL;BAC PRO PROD;BAC PRO AG 21302 GEST MILIEUX NATURELS FAUNE;9;6;5;1;0;0;0;5;0;0;1;2;2;1
13927.0;2022;23;NICE;MASCULIN;APPRENTISSAGE;BAC PROFESSIONNEL;BAC PRO SERV;BAC PRO 33403 COMMERC. SERVICES EN RESTAURATION;6;6;4;2;0;0;0;4;0;0;0;1;3;2
13934.0;2022;23;NICE;MASCULIN;ENSEIGNEMENT A DISTANCE;BAC TECHNOLOGIQUE;BAC STMG;BAC STMG MERCATIQUE (MARKETING);5;5;5;0;0;0;0;5;0;0;1;2;2;0
13937.0;2022;23;NICE;MASCULIN;FORMATION CONTINUE;BAC PROFESSIONNEL;BAC PRO PROD;BAC PRO 25510 METIERS ELECT. ENVIRON. CONNECTES;25;25;25;0;0;0;0;25;0;9;11;5;0;0
13939.0;2022;23;NICE;MASCULIN;FORMATION CONTINUE;BAC PROFESSIONNEL;BAC PRO SERV;BAC PRO 31213 MET.COM.VEN.OP.A ANI.GES.ESP.COM.;4;2;1;0;1;0;1;1;0;0;0;0;1;1
13942.0;2022;23;NICE;MASCULIN;INDIVIDUEL;BAC GENERAL;BAC GENERAL;BAC GENE 10019 BAC GENERAL;140;138;65;49;24;15;9;80;0;5;15;25;35;58
13952.0;2022;23;NICE;MASCULIN;INDIVIDUEL;BAC PROFESSIONNEL;BAC PRO PROD;BAC PRO AG 21004 CGEA;1;1;0;1;0;0;0;0;0;0;0;0;0;1
13954.0;2022;23;NICE;MASCULIN;INDIVIDUEL;BAC PROFESSIONNEL;BAC PRO PROD;BAC PRO AG 21114 CONDUITE PRODUCTIONS HORTICOLES;2;1;1;0;0;0;0;1;0;0;0;0;1;0
13955.0;2022;23;NICE;MASCULIN;INDIVIDUEL;BAC PROFESSIONNEL;BAC PRO PROD;BAC PRO AG 21211 COND GEST ENTR HIPPIQUE;1;0;0;0;0;0;0;0;0;0;0;0;0;0
13956.0;2022;23;NICE;MASCULIN;INDIVIDUEL;BAC PROFESSIONNEL;BAC PRO SERV;BAC PRO 30001 GESTION-ADMINISTRATION;5;2;2;0;0;0;0;2;0;0;0;0;2;0
13962.0;2022;23;NICE;MASCULIN;INDIVIDUEL;BAC TECHNOLOGIQUE;BAC STI2D;BAC STI2D ENERGIES  ET ENVIRONNEMENT;1;1;0;1;0;0;0;0;0;0;0;0;0;1
13965.0;2022;23;NICE;MASCULIN;INDIVIDUEL;BAC TECHNOLOGIQUE;BAC STMG;BAC STMG GESTION ET FINANCE;4;4;0;4;0;0;0;0;0;0;0;0;0;4
13971.0;2022;23;NICE;MASCULIN;SCOLAIRE;BAC PROFESSIONNEL;BAC PRO PROD;BAC PRO 22105 BOULANGER-PÂTISSIER;21;21;17;4;0;0;0;17;0;0;6;5;6;4
13980.0;2022;23;NICE;MASCULIN;SCOLAIRE;BAC PROFESSIONNEL;BAC PRO PROD;BAC PRO 23203 TECHNICIEN BAT. : ORG.REAL.GROS O;10;9;8;1;0;0;0;8;0;3;0;3;2;1
13981.0;2022;23;NICE;MASCULIN;SCOLAIRE;BAC PROFESSIONNEL;BAC PRO PROD;BAC PRO 23205 INTERV. SUR PATRIMOINE BATI OPT.A;3;3;2;1;0;0;0;2;0;0;0;0;2;1
13984.0;2022;23;NICE;MASCULIN;SCOLAIRE;BAC PROFESSIONNEL;BAC PRO PROD;BAC PRO 23404 TECHNICIEN CONSTRUCTEUR BOIS;7;7;7;0;0;0;0;7;0;0;0;1;6;0
13985.0;2022;23;NICE;MASCULIN;SCOLAIRE;BAC PROFESSIONNEL;BAC PRO PROD;BAC PRO 23405 TECHNICIEN MENUISIER AGENCEUR;28;28;24;2;2;1;1;25;0;3;7;6;9;3
13992.0;2022;23;NICE;MASCULIN;SCOLAIRE;BAC PROFESSIONNEL;BAC PRO PROD;BAC PRO 25009 MAINTENANCE NAUTIQUE;49;49;35;10;4;2;2;37;0;0;7;13;17;12
13994.0;2022;23;NICE;MASCULIN;SCOLAIRE;BAC PROFESSIONNEL;BAC PRO PROD;BAC PRO 25107 TECHNICIEN OUTILLEUR;5;5;3;1;1;1;0;4;0;0;1;1;2;1
14000.0;2022;23;NICE;MASCULIN;SCOLAIRE;BAC PROFESSIONNEL;BAC PRO PROD;BAC PRO 25408 REPARATION DES CARROSSERIES;38;38;25;13;0;0;0;25;0;1;2;15;7;13
14002.0;2022;23;NICE;MASCULIN;SCOLAIRE;BAC PROFESSIONNEL;BAC PRO PROD;BAC PRO 25509 TECHNIC. FROID CONDITIONNEMT AIR;28;27;19;4;4;2;2;21;0;1;6;10;4;6
14003.0;2022;23;NICE;MASCULIN;SCOLAIRE;BAC PROFESSIONNEL;BAC PRO PROD;BAC PRO 25510 METIERS ELECT. ENVIRON. CONNECTES;349;348;273;58;17;9;8;282;0;18;42;112;110;66
14010.0;2022;23;NICE;MASCULIN;SCOLAIRE;BAC PROFESSIONNEL;BAC PRO PROD;BAC PRO AG 21303 FORET;11;11;11;0;0;0;0;11;0;0;0;3;8;0
14019.0;2022;23;NICE;MASCULIN;SCOLAIRE;BAC PROFESSIONNEL;BAC PRO SERV;BAC PRO 31214 MET.COM.VEN.OP.B PR.CL.VA.OF.COM.;173;172;144;19;9;7;2;151;0;2;27;55;67;21
14024.0;2022;23;NICE;MASCULIN;SCOLAIRE;BAC PROFESSIONNEL;BAC PRO SERV;BAC PRO 33003 ACC.SOINS-S.PERS. OPT.A DOMICILE;3;3;2;1;0;0;0;2;0;0;0;0;2;1
14026.0;2022;23;NICE;MASCULIN;SCOLAIRE;BAC PROFESSIONNEL;BAC PRO SERV;BAC PRO 33101 OPTIQUE LUNETTERIE;3;3;3;0;0;0;0;3;0;0;1;0;2;0
14027.0;2022;23;NICE;MASCULIN;SCOLAIRE;BAC PROFESSIONNEL;BAC PRO SERV;BAC PRO 33403 COMMERC. SERVICES EN RESTAURATION;65;65;56;9;0;0;0;56;0;2;11;18;25;9
14037.0;2022;23;NICE;MASCULIN;SCOLAIRE;BAC TECHNOLOGIQUE;BAC STI2D;BAC STI2D ARCHITECTURE ET CONSTRUCTION;64;64;55;1;8;6;2;61;0;2;8;22;29;3
14038.0;2022;23;NICE;MASCULIN;SCOLAIRE;BAC TECHNOLOGIQUE;BAC STI2D;BAC STI2D ENERGIES  ET ENVIRONNEMENT;151;151;123;7;21;16;5;139;0;6;14;49;70;12
14043.0;2022;23;NICE;MASCULIN;SCOLAIRE;BAC TECHNOLOGIQUE;BAC STMG;BAC STMG GESTION ET FINANCE;270;270;222;13;35;25;10;247;0;3;26;98;120;23
14047.0;2022;70;NORMANDIE;FEMININ;APPRENTISSAGE;BAC PROFESSIONNEL;BAC PRO PROD;BAC PRO 20102 PILOTE DE LIGNE DE PRODUCTION;4;4;4;0;0;0;0;4;0;3;1;0;0;0
14050.0;2022;70;NORMANDIE;FEMININ;APPRENTISSAGE;BAC PROFESSIONNEL;BAC PRO PROD;BAC PRO 22106 CUISINE;8;8;6;2;0;0;0;6;0;0;0;2;4;2
14054.0;2022;70;NORMANDIE;FEMININ;APPRENTISSAGE;BAC PROFESSIONNEL;BAC PRO PROD;BAC PRO 25007 MAINTENANCE EQUIPEMENTS INDUST.;4;4;4;0;0;0;0;4;0;1;1;1;1;0
14058.0;2022;70;NORMANDIE;FEMININ;APPRENTISSAGE;BAC PROFESSIONNEL;BAC PRO PROD;BAC PRO 25408 REPARATION DES CARROSSERIES;6;6;4;1;1;0;1;4;0;0;0;2;2;2
14060.0;2022;70;NORMANDIE;FEMININ;APPRENTISSAGE;BAC PROFESSIONNEL;BAC PRO PROD;BAC PRO 25510 METIERS ELECT. ENVIRON. CONNECTES;2;2;2;0;0;0;0;2;0;2;0;0;0;0
14061.0;2022;70;NORMANDIE;FEMININ;APPRENTISSAGE;BAC PROFESSIONNEL;BAC PRO PROD;BAC PRO AG 21004 CGEA;28;28;18;10;0;0;0;18;0;0;3;6;9;10
14072.0;2022;70;NORMANDIE;FEMININ;APPRENTISSAGE;BAC PROFESSIONNEL;BAC PRO SERV;BAC PRO 31214 MET.COM.VEN.OP.B PR.CL.VA.OF.COM.;3;3;3;0;0;0;0;3;0;0;1;2;0;0
14075.0;2022;70;NORMANDIE;FEMININ;APPRENTISSAGE;BAC PROFESSIONNEL;BAC PRO SERV;BAC PRO AG 33002 SERV PERS TERRIT;9;9;8;1;0;0;0;8;0;0;1;3;4;1
14079.0;2022;70;NORMANDIE;FEMININ;ENSEIGNEMENT A DISTANCE;BAC PROFESSIONNEL;BAC PRO SERV;BAC PRO 33004 ACC.SOINS-S.PERS. OPT.EN STRUCTUR;9;6;5;1;0;0;0;5;0;1;0;1;3;1
14085.0;2022;70;NORMANDIE;FEMININ;FORMATION CONTINUE;BAC PROFESSIONNEL;BAC PRO PROD;BAC PRO 20102 PILOTE DE LIGNE DE PRODUCTION;5;5;5;0;0;0;0;5;0;1;0;3;1;0
14086.0;2022;70;NORMANDIE;FEMININ;FORMATION CONTINUE;BAC PROFESSIONNEL;BAC PRO PROD;BAC PRO 22003 BIO-INDUSTRIES DE TRANSFORMATION;7;7;6;1;0;0;0;6;0;1;0;0;5;1
14088.0;2022;70;NORMANDIE;FEMININ;FORMATION CONTINUE;BAC PROFESSIONNEL;BAC PRO PROD;BAC PRO 23004 TECHN. ETUDES BAT.A ETUDES & ECO.;1;1;1;0;0;0;0;1;0;0;0;0;1;0
14090.0;2022;70;NORMANDIE;FEMININ;FORMATION CONTINUE;BAC PROFESSIONNEL;BAC PRO PROD;BAC PRO 23405 TECHNICIEN MENUISIER AGENCEUR;1;1;1;0;0;0;0;1;0;0;1;0;0;0
14102.0;2022;70;NORMANDIE;FEMININ;INDIVIDUEL;BAC PROFESSIONNEL;BAC PRO PROD;BAC PRO 24203 METIERS DE LA MODE - VÊTEMENT;2;2;1;1;0;0;0;1;0;0;0;1;0;1
14104.0;2022;70;NORMANDIE;FEMININ;INDIVIDUEL;BAC PROFESSIONNEL;BAC PRO PROD;BAC PRO AG 21004 CGEA;8;7;5;2;0;0;0;5;0;0;0;0;5;2
14109.0;2022;70;NORMANDIE;FEMININ;INDIVIDUEL;BAC PROFESSIONNEL;BAC PRO SERV;BAC PRO 31213 MET.COM.VEN.OP.A ANI.GES.ESP.COM.;2;1;0;1;0;0;0;0;0;0;0;0;0;1
14111.0;2022;70;NORMANDIE;FEMININ;INDIVIDUEL;BAC PROFESSIONNEL;BAC PRO SERV;BAC PRO 33004 ACC.SOINS-S.PERS. OPT.EN STRUCTUR;5;3;2;1;0;0;0;2;0;0;0;0;2;1
14121.0;2022;70;NORMANDIE;FEMININ;SCOLAIRE;BAC PROFESSIONNEL;BAC PRO PROD;BAC PRO 22004 PROC. CHIMIE EAU PAPIERS-CARTONS;10;10;9;1;0;0;0;9;0;1;0;7;1;1
14122.0;2022;70;NORMANDIE;FEMININ;SCOLAIRE;BAC PROFESSIONNEL;BAC PRO PROD;BAC PRO 22105 BOULANGER-PÂTISSIER;35;35;34;1;0;0;0;34;0;7;12;11;4;1
14126.0;2022;70;NORMANDIE;FEMININ;SCOLAIRE;BAC PROFESSIONNEL;BAC PRO PROD;BAC PRO 22704 TECHN. MAINT. SYST.ENERG.CLIMATI;1;1;0;1;0;0;0;0;0;0;0;0;0;1
14133.0;2022;70;NORMANDIE;FEMININ;SCOLAIRE;BAC PROFESSIONNEL;BAC PRO PROD;BAC PRO 23405 TECHNICIEN MENUISIER AGENCEUR;11;11;7;3;1;1;0;8;0;1;2;1;4;3
14134.0;2022;70;NORMANDIE;FEMININ;SCOLAIRE;BAC PROFESSIONNEL;BAC PRO PROD;BAC PRO 23407 TECHNIC.FAB.BOIS ET MATERX ASSOC;2;2;2;0;0;0;0;2;0;0;0;1;1;0
14135.0;2022;70;NORMANDIE;FEMININ;SCOLAIRE;BAC PROFESSIONNEL;BAC PRO PROD;BAC PRO 23408 Etude et réalisation d'agencement;21;21;21;0;0;0;0;21;0;4;7;6;4;0
14136.0;2022;70;NORMANDIE;FEMININ;SCOLAIRE;BAC PROFESSIONNEL;BAC PRO PROD;BAC PRO 24202 ARTIS.& MET.ART : TAPIS.D'AMEUBL;12;12;10;2;0;0;0;10;0;0;4;3;3;2
14145.0;2022;70;NORMANDIE;FEMININ;SCOLAIRE;BAC PROFESSIONNEL;BAC PRO PROD;BAC PRO 25304 AERONAUTIQUE OPTION STRUCTURE;1;1;1;0;0;0;0;1;0;0;0;1;0;0
14147.0;2022;70;NORMANDIE;FEMININ;SCOLAIRE;BAC PROFESSIONNEL;BAC PRO PROD;BAC PRO 25411 TECH.CHAUDRONNERIE INDUSTRIELLE;5;5;5;0;0;0;0;5;0;0;2;0;3;0
14148.0;2022;70;NORMANDIE;FEMININ;SCOLAIRE;BAC PROFESSIONNEL;BAC PRO PROD;BAC PRO 25509 TECHNIC. FROID CONDITIONNEMT AIR;1;1;1;0;0;0;0;1;0;0;0;0;1;0
14151.0;2022;70;NORMANDIE;FEMININ;SCOLAIRE;BAC PROFESSIONNEL;BAC PRO PROD;BAC PRO 25514 SYST.NUM.OPT.B AUD.RES.EQUIP.DOM.;3;3;2;1;0;0;0;2;0;0;0;1;1;1
14160.0;2022;70;NORMANDIE;FEMININ;SCOLAIRE;BAC PROFESSIONNEL;BAC PRO PROD;BAC PRO AG 21405 AMENAGEMENTS PAYSAGERS;8;7;7;0;0;0;0;7;0;0;1;2;4;0
14163.0;2022;70;NORMANDIE;FEMININ;SCOLAIRE;BAC PROFESSIONNEL;BAC PRO PROD;BAC PRO AG 22107 TEC CONS VTE ALIMENTATION P.ALIM;4;4;2;2;0;0;0;2;0;0;0;1;1;2
14176.0;2022;70;NORMANDIE;FEMININ;SCOLAIRE;BAC PROFESSIONNEL;BAC PRO SERV;BAC PRO 33003 ACC.SOINS-S.PERS. OPT.A DOMICILE;124;124;114;5;5;3;2;117;0;6;27;47;37;7
14182.0;2022;70;NORMANDIE;FEMININ;SCOLAIRE;BAC PROFESSIONNEL;BAC PRO SERV;BAC PRO 33603 ESTHETIQUE COSMETIQUE PARFUMERIE;149;148;134;13;1;0;1;134;0;12;33;49;40;14
14186.0;2022;70;NORMANDIE;FEMININ;SCOLAIRE;BAC PROFESSIONNEL;BAC PRO SERV;BAC PRO AG 33002 SERV PERS TERRIT;362;357;309;48;0;0;0;309;0;2;25;113;169;48
14192.0;2022;70;NORMANDIE;FEMININ;SCOLAIRE;BAC TECHNOLOGIQUE;BAC STHR;BAC STHR SC.&TEC. HOTELLERIE-RESTAURATION;49;49;46;2;1;1;0;47;0;2;16;18;11;2
14198.0;2022;70;NORMANDIE;FEMININ;SCOLAIRE;BAC TECHNOLOGIQUE;BAC STL;BAC STL SCIENCES PHYSIQUES CHIMIQUES  EN LABORAT.;57;57;42;4;11;10;1;52;0;1;12;15;24;5
14213.0;2022;70;NORMANDIE;MASCULIN;APPRENTISSAGE;BAC PROFESSIONNEL;BAC PRO PROD;BAC PRO 23303 MENUISERIE ALUMINIUM-VERRE;4;4;1;3;0;0;0;1;0;0;0;0;1;3
14214.0;2022;70;NORMANDIE;MASCULIN;APPRENTISSAGE;BAC PROFESSIONNEL;BAC PRO PROD;BAC PRO 23304 AMENAGEMENT FINITION BATIMENT;2;2;2;0;0;0;0;2;0;0;0;0;2;0
14216.0;2022;70;NORMANDIE;MASCULIN;APPRENTISSAGE;BAC PROFESSIONNEL;BAC PRO PROD;BAC PRO 23405 TECHNICIEN MENUISIER AGENCEUR;20;20;19;1;0;0;0;19;0;2;5;8;4;1
14221.0;2022;70;NORMANDIE;MASCULIN;APPRENTISSAGE;BAC PROFESSIONNEL;BAC PRO PROD;BAC PRO 25214 MAINT.VEHIC.OPTA VOIT.PARTICUL.;199;195;162;25;8;3;5;165;0;14;43;48;60;30
14222.0;2022;70;NORMANDIE;MASCULIN;APPRENTISSAGE;BAC PROFESSIONNEL;BAC PRO PROD;BAC PRO 25215 MAINT.VEHIC.OPTB VEHIC.TRANS.ROUT;40;40;32;4;4;3;1;35;0;4;3;10;18;5
14223.0;2022;70;NORMANDIE;MASCULIN;APPRENTISSAGE;BAC PROFESSIONNEL;BAC PRO PROD;BAC PRO 25216 MAINT.VEHIC.OPTC MOTOCYCLES;18;18;15;2;1;1;0;16;0;1;5;5;5;2
14229.0;2022;70;NORMANDIE;MASCULIN;APPRENTISSAGE;BAC PROFESSIONNEL;BAC PRO PROD;BAC PRO 25411 TECH.CHAUDRONNERIE INDUSTRIELLE;109;109;86;14;9;6;3;92;0;5;23;27;37;17
14232.0;2022;70;NORMANDIE;MASCULIN;APPRENTISSAGE;BAC PROFESSIONNEL;BAC PRO PROD;BAC PRO 25513 SYST.NUM.OPT.A SURETE SECURITE;2;2;2;0;0;0;0;2;0;0;0;1;1;0
14235.0;2022;70;NORMANDIE;MASCULIN;APPRENTISSAGE;BAC PROFESSIONNEL;BAC PRO PROD;BAC PRO AG 21001 AGRO-EQUIPEMENT;34;34;33;1;0;0;0;33;0;0;0;8;25;1
14243.0;2022;70;NORMANDIE;MASCULIN;APPRENTISSAGE;BAC PROFESSIONNEL;BAC PRO PROD;BAC PRO AG 21405 AMENAGEMENTS PAYSAGERS;75;73;69;4;0;0;0;69;0;1;8;20;40;4
14246.0;2022;70;NORMANDIE;MASCULIN;APPRENTISSAGE;BAC PROFESSIONNEL;BAC PRO SERV;BAC PRO 31106 LOGISTIQUE;34;34;28;4;2;0;2;28;0;5;5;11;7;6
14260.0;2022;70;NORMANDIE;MASCULIN;ENSEIGNEMENT A DISTANCE;BAC TECHNOLOGIQUE;BAC STMG;BAC STMG RESSOURCES HUMAINES ET COMMUNICATION;3;3;0;3;0;0;0;0;0;0;0;0;0;3
14261.0;2022;70;NORMANDIE;MASCULIN;ENSEIGNEMENT A DISTANCE;BAC TECHNOLOGIQUE;BAC STMG;BAC STMG SYSTEMES D'INFORMATION DE GESTION;1;1;1;0;0;0;0;1;0;0;0;0;1;0
14266.0;2022;70;NORMANDIE;MASCULIN;FORMATION CONTINUE;BAC PROFESSIONNEL;BAC PRO PROD;BAC PRO 22106 CUISINE;1;1;1;0;0;0;0;1;0;0;1;0;0;0
14276.0;2022;70;NORMANDIE;MASCULIN;FORMATION CONTINUE;BAC PROFESSIONNEL;BAC PRO PROD;BAC PRO 25510 METIERS ELECT. ENVIRON. CONNECTES;19;19;17;2;0;0;0;17;0;4;5;7;1;2
14278.0;2022;70;NORMANDIE;MASCULIN;FORMATION CONTINUE;BAC PROFESSIONNEL;BAC PRO PROD;BAC PRO AG 22107 TEC CONS VTE ALIMENTATION P.ALIM;1;1;1;0;0;0;0;1;0;0;0;0;1;0
14283.0;2022;70;NORMANDIE;MASCULIN;FORMATION CONTINUE;BAC PROFESSIONNEL;BAC PRO SERV;BAC PRO 34304 HYGIENE PROPRETE STERILISATION;2;1;1;0;0;0;0;1;0;0;1;0;0;0
14284.0;2022;70;NORMANDIE;MASCULIN;INDIVIDUEL;BAC GENERAL;BAC GENERAL;BAC GENE 10019 BAC GENERAL;78;55;36;15;4;3;1;39;0;8;8;12;11;16
14286.0;2022;70;NORMANDIE;MASCULIN;INDIVIDUEL;BAC PROFESSIONNEL;BAC PRO PROD;BAC PRO 22106 CUISINE;1;0;0;0;0;0;0;0;0;0;0;0;0;0
14287.0;2022;70;NORMANDIE;MASCULIN;INDIVIDUEL;BAC PROFESSIONNEL;BAC PRO PROD;BAC PRO 23004 TECHN. ETUDES BAT.A ETUDES & ECO.;1;0;0;0;0;0;0;0;0;0;0;0;0;0
14293.0;2022;70;NORMANDIE;MASCULIN;INDIVIDUEL;BAC PROFESSIONNEL;BAC PRO PROD;BAC PRO 25411 TECH.CHAUDRONNERIE INDUSTRIELLE;1;0;0;0;0;0;0;0;0;0;0;0;0;0
14295.0;2022;70;NORMANDIE;MASCULIN;INDIVIDUEL;BAC PROFESSIONNEL;BAC PRO PROD;BAC PRO 25515 SYST.NUM.OPT.C RES.INF.SYST.COMM.;1;1;1;0;0;0;0;1;0;0;0;0;1;0
14300.0;2022;70;NORMANDIE;MASCULIN;INDIVIDUEL;BAC PROFESSIONNEL;BAC PRO PROD;BAC PRO AG 21405 AMENAGEMENTS PAYSAGERS;1;0;0;0;0;0;0;0;0;0;0;0;0;0
14305.0;2022;70;NORMANDIE;MASCULIN;INDIVIDUEL;BAC PROFESSIONNEL;BAC PRO SERV;BAC PRO 33004 ACC.SOINS-S.PERS. OPT.EN STRUCTUR;1;1;0;1;0;0;0;0;0;0;0;0;0;1
14308.0;2022;70;NORMANDIE;MASCULIN;INDIVIDUEL;BAC TECHNOLOGIQUE;BAC STI2D;BAC STI2D ENERGIES  ET ENVIRONNEMENT;2;0;0;0;0;0;0;0;0;0;0;0;0;0
14310.0;2022;70;NORMANDIE;MASCULIN;INDIVIDUEL;BAC TECHNOLOGIQUE;BAC STI2D;BAC STI2D SYSTÈME D'INFORMATION  ET NUMERIQUE;2;1;0;0;1;1;0;1;0;0;0;0;1;0
14311.0;2022;70;NORMANDIE;MASCULIN;INDIVIDUEL;BAC TECHNOLOGIQUE;BAC STL;BAC STL BIOCHIM.-BIOLOGIE-BIOTECHNOL.;1;1;0;1;0;0;0;0;0;0;0;0;0;1
14312.0;2022;70;NORMANDIE;MASCULIN;INDIVIDUEL;BAC TECHNOLOGIQUE;BAC STL;BAC STL SCIENCES PHYSIQUES CHIMIQUES  EN LABORAT.;1;0;0;0;0;0;0;0;0;0;0;0;0;0
14319.0;2022;70;NORMANDIE;MASCULIN;SCOLAIRE;BAC PROFESSIONNEL;BAC PRO PROD;BAC PRO 22003 BIO-INDUSTRIES DE TRANSFORMATION;9;9;6;3;0;0;0;6;0;0;1;1;4;3
14324.0;2022;70;NORMANDIE;MASCULIN;SCOLAIRE;BAC PROFESSIONNEL;BAC PRO PROD;BAC PRO 22503 PLASTIQUES ET COMPOSITES;11;11;9;2;0;0;0;9;0;0;1;3;5;2
14326.0;2022;70;NORMANDIE;MASCULIN;SCOLAIRE;BAC PROFESSIONNEL;BAC PRO PROD;BAC PRO 22704 TECHN. MAINT. SYST.ENERG.CLIMATI;55;54;30;21;3;3;0;33;0;2;2;9;20;21
14330.0;2022;70;NORMANDIE;MASCULIN;SCOLAIRE;BAC PROFESSIONNEL;BAC PRO PROD;BAC PRO 23102 TRAVAUX PUBLICS;41;41;37;4;0;0;0;37;0;3;8;12;14;4
14333.0;2022;70;NORMANDIE;MASCULIN;SCOLAIRE;BAC PROFESSIONNEL;BAC PRO PROD;BAC PRO 23205 INTERV. SUR PATRIMOINE BATI OPT.A;7;7;6;1;0;0;0;6;0;0;0;0;6;1
14339.0;2022;70;NORMANDIE;MASCULIN;SCOLAIRE;BAC PROFESSIONNEL;BAC PRO PROD;BAC PRO 23407 TECHNIC.FAB.BOIS ET MATERX ASSOC;26;26;24;1;1;0;1;24;0;2;4;7;11;2
14340.0;2022;70;NORMANDIE;MASCULIN;SCOLAIRE;BAC PROFESSIONNEL;BAC PRO PROD;BAC PRO 23408 Etude et réalisation d'agencement;5;5;5;0;0;0;0;5;0;0;1;2;2;0
14343.0;2022;70;NORMANDIE;MASCULIN;SCOLAIRE;BAC PROFESSIONNEL;BAC PRO PROD;BAC PRO 24302 METIERS DU CUIR : MAROQUINERIE;2;2;2;0;0;0;0;2;0;0;0;2;0;0
14356.0;2022;70;NORMANDIE;MASCULIN;SCOLAIRE;BAC PROFESSIONNEL;BAC PRO PROD;BAC PRO 25406 OUVRAGES DU BATIMENT METALLERIE;33;33;26;5;2;1;1;27;0;1;1;12;13;6
14358.0;2022;70;NORMANDIE;MASCULIN;SCOLAIRE;BAC PROFESSIONNEL;BAC PRO PROD;BAC PRO 25411 TECH.CHAUDRONNERIE INDUSTRIELLE;207;207;174;25;8;6;2;180;0;20;45;66;49;27
14360.0;2022;70;NORMANDIE;MASCULIN;SCOLAIRE;BAC PROFESSIONNEL;BAC PRO PROD;BAC PRO 25510 METIERS ELECT. ENVIRON. CONNECTES;548;548;419;97;32;23;9;442;0;16;79;161;186;106
14371.0;2022;70;NORMANDIE;MASCULIN;SCOLAIRE;BAC PROFESSIONNEL;BAC PRO PROD;BAC PRO AG 21302 GEST MILIEUX NATURELS FAUNE;36;35;34;1;0;0;0;34;0;0;5;13;16;1
14376.0;2022;70;NORMANDIE;MASCULIN;SCOLAIRE;BAC PROFESSIONNEL;BAC PRO PROD;BAC PRO AG 22107 TEC CONS VTE ALIMENTATION P.ALIM;15;15;9;6;0;0;0;9;0;0;0;3;6;6
14381.0;2022;70;NORMANDIE;MASCULIN;SCOLAIRE;BAC PROFESSIONNEL;BAC PRO SERV;BAC PRO 31212 METIERS DE L'ACCUEIL;53;53;35;12;6;4;2;39;0;2;7;19;11;14
14382.0;2022;70;NORMANDIE;MASCULIN;SCOLAIRE;BAC PROFESSIONNEL;BAC PRO SERV;BAC PRO 31213 MET.COM.VEN.OP.A ANI.GES.ESP.COM.;399;399;328;62;9;7;2;335;0;6;61;127;141;64
14395.0;2022;70;NORMANDIE;MASCULIN;SCOLAIRE;BAC PROFESSIONNEL;BAC PRO SERV;BAC PRO 34304 HYGIENE PROPRETE STERILISATION;11;11;10;1;0;0;0;10;0;0;3;5;2;1
14398.0;2022;70;NORMANDIE;MASCULIN;SCOLAIRE;BAC PROFESSIONNEL;BAC PRO SERV;BAC PRO AG 33002 SERV PERS TERRIT;27;26;24;2;0;0;0;24;0;0;1;9;14;2
14401.0;2022;70;NORMANDIE;MASCULIN;SCOLAIRE;BAC TECHNOLOGIQUE;BAC ST2S;BAC ST2S SCIENCES & TECHNO. SANTE & SOCIAL;119;119;91;2;26;17;9;108;1;2;2;34;69;11
14404.0;2022;70;NORMANDIE;MASCULIN;SCOLAIRE;BAC TECHNOLOGIQUE;BAC STHR;BAC STHR SC.&TEC. HOTELLERIE-RESTAURATION;54;54;48;2;4;3;1;51;0;4;7;25;15;3
14409.0;2022;70;NORMANDIE;MASCULIN;SCOLAIRE;BAC TECHNOLOGIQUE;BAC STL;BAC STL BIOCHIM.-BIOLOGIE-BIOTECHNOL.;89;89;79;2;8;7;1;86;0;1;15;30;40;3
14412.0;2022;70;NORMANDIE;MASCULIN;SCOLAIRE;BAC TECHNOLOGIQUE;BAC STMG;BAC STMG MERCATIQUE (MARKETING);849;849;594;53;202;135;67;729;0;3;58;193;475;120
14418.0;2022;18;ORLEANS-TOURS;FEMININ;APPRENTISSAGE;BAC PROFESSIONNEL;BAC PRO PROD;BAC PRO 23405 TECHNICIEN MENUISIER AGENCEUR;1;1;0;1;0;0;0;0;0;0;0;0;0;1
14422.0;2022;18;ORLEANS-TOURS;FEMININ;APPRENTISSAGE;BAC PROFESSIONNEL;BAC PRO PROD;BAC PRO 25214 MAINT.VEHIC.OPTA VOIT.PARTICUL.;3;3;2;1;0;0;0;2;0;1;0;1;0;1
14424.0;2022;18;ORLEANS-TOURS;FEMININ;APPRENTISSAGE;BAC PROFESSIONNEL;BAC PRO PROD;BAC PRO 25408 REPARATION DES CARROSSERIES;1;1;1;0;0;0;0;1;0;0;1;0;0;0
14430.0;2022;18;ORLEANS-TOURS;FEMININ;APPRENTISSAGE;BAC PROFESSIONNEL;BAC PRO PROD;BAC PRO AG 21211 COND GEST ENTR HIPPIQUE;8;7;7;0;0;0;0;7;0;0;0;2;5;0
14435.0;2022;18;ORLEANS-TOURS;FEMININ;APPRENTISSAGE;BAC PROFESSIONNEL;BAC PRO SERV;BAC PRO 30001 GESTION-ADMINISTRATION;9;9;9;0;0;0;0;9;0;2;1;4;2;0
14437.0;2022;18;ORLEANS-TOURS;FEMININ;APPRENTISSAGE;BAC PROFESSIONNEL;BAC PRO SERV;BAC PRO 31212 METIERS DE L'ACCUEIL;5;5;4;1;0;0;0;4;0;0;0;2;2;1
14442.0;2022;18;ORLEANS-TOURS;FEMININ;APPRENTISSAGE;BAC PROFESSIONNEL;BAC PRO SERV;BAC PRO 33403 COMMERC. SERVICES EN RESTAURATION;4;4;4;0;0;0;0;4;0;0;2;2;0;0
14447.0;2022;18;ORLEANS-TOURS;FEMININ;ENSEIGNEMENT A DISTANCE;BAC TECHNOLOGIQUE;BAC ST2S;BAC ST2S SCIENCES & TECHNO. SANTE & SOCIAL;2;2;1;0;1;1;0;2;0;0;0;0;2;0
14451.0;2022;18;ORLEANS-TOURS;FEMININ;FORMATION CONTINUE;BAC PROFESSIONNEL;BAC PRO PROD;BAC PRO 22704 TECHN. MAINT. SYST.ENERG.CLIMATI;1;1;1;0;0;0;0;1;0;0;1;0;0;0
14452.0;2022;18;ORLEANS-TOURS;FEMININ;FORMATION CONTINUE;BAC PROFESSIONNEL;BAC PRO PROD;BAC PRO 23004 TECHN. ETUDES BAT.A ETUDES & ECO.;1;1;1;0;0;0;0;1;0;1;0;0;0;0
14457.0;2022;18;ORLEANS-TOURS;FEMININ;FORMATION CONTINUE;BAC PROFESSIONNEL;BAC PRO PROD;BAC PRO AG 21405 AMENAGEMENTS PAYSAGERS;6;6;6;0;0;0;0;6;0;0;1;0;5;0
14466.0;2022;18;ORLEANS-TOURS;FEMININ;INDIVIDUEL;BAC PROFESSIONNEL;BAC PRO SERV;BAC PRO 31213 MET.COM.VEN.OP.A ANI.GES.ESP.COM.;5;3;1;2;0;0;0;1;0;0;1;0;0;2
14471.0;2022;18;ORLEANS-TOURS;FEMININ;INDIVIDUEL;BAC PROFESSIONNEL;BAC PRO SERV;BAC PRO 34304 HYGIENE PROPRETE STERILISATION;1;1;1;0;0;0;0;1;0;0;0;0;1;0
14478.0;2022;18;ORLEANS-TOURS;FEMININ;INDIVIDUEL;BAC TECHNOLOGIQUE;BAC STL;BAC STL SCIENCES PHYSIQUES CHIMIQUES  EN LABORAT.;2;1;0;0;1;1;0;1;0;0;0;0;1;0
14488.0;2022;18;ORLEANS-TOURS;FEMININ;SCOLAIRE;BAC PROFESSIONNEL;BAC PRO PROD;BAC PRO 22106 CUISINE;62;62;54;5;3;3;0;57;0;4;12;19;22;5
14489.0;2022;18;ORLEANS-TOURS;FEMININ;SCOLAIRE;BAC PROFESSIONNEL;BAC PRO PROD;BAC PRO 22303 FONDERIE;2;2;1;0;1;0;1;1;0;0;0;1;0;1
14493.0;2022;18;ORLEANS-TOURS;FEMININ;SCOLAIRE;BAC PROFESSIONNEL;BAC PRO PROD;BAC PRO 23003 ARTIS. & M.ART:MARCHANDISAGE VIS.;12;12;12;0;0;0;0;12;0;1;7;2;2;0
14498.0;2022;18;ORLEANS-TOURS;FEMININ;SCOLAIRE;BAC PROFESSIONNEL;BAC PRO PROD;BAC PRO 23208 METIERS ET ARTS DE LA PIERRE;4;4;4;0;0;0;0;4;0;0;0;3;1;0
14504.0;2022;18;ORLEANS-TOURS;FEMININ;SCOLAIRE;BAC PROFESSIONNEL;BAC PRO PROD;BAC PRO 24302 METIERS DU CUIR : MAROQUINERIE;17;17;13;4;0;0;0;13;0;2;2;3;6;4
14507.0;2022;18;ORLEANS-TOURS;FEMININ;SCOLAIRE;BAC PROFESSIONNEL;BAC PRO PROD;BAC PRO 25106 TECHNICIEN D'USINAGE;3;3;2;1;0;0;0;2;0;0;0;2;0;1
14508.0;2022;18;ORLEANS-TOURS;FEMININ;SCOLAIRE;BAC PROFESSIONNEL;BAC PRO PROD;BAC PRO 25108 TECHNICIEN MODELEUR;4;4;4;0;0;0;0;4;0;0;2;1;1;0
14512.0;2022;18;ORLEANS-TOURS;FEMININ;SCOLAIRE;BAC PROFESSIONNEL;BAC PRO PROD;BAC PRO 25408 REPARATION DES CARROSSERIES;2;2;2;0;0;0;0;2;0;0;1;1;0;0
14514.0;2022;18;ORLEANS-TOURS;FEMININ;SCOLAIRE;BAC PROFESSIONNEL;BAC PRO PROD;BAC PRO 25509 TECHNIC. FROID CONDITIONNEMT AIR;1;1;1;0;0;0;0;1;0;0;1;0;0;0
14520.0;2022;18;ORLEANS-TOURS;FEMININ;SCOLAIRE;BAC PROFESSIONNEL;BAC PRO PROD;BAC PRO AG 21114 CONDUITE PRODUCTIONS HORTICOLES;15;15;10;5;0;0;0;10;0;1;1;4;4;5
14522.0;2022;18;ORLEANS-TOURS;FEMININ;SCOLAIRE;BAC PROFESSIONNEL;BAC PRO PROD;BAC PRO AG 21211 COND GEST ENTR HIPPIQUE;47;46;41;5;0;0;0;41;0;0;5;13;23;5
14524.0;2022;18;ORLEANS-TOURS;FEMININ;SCOLAIRE;BAC PROFESSIONNEL;BAC PRO PROD;BAC PRO AG 21302 GEST MILIEUX NATURELS FAUNE;11;11;8;3;0;0;0;8;0;0;0;4;4;3
14534.0;2022;18;ORLEANS-TOURS;FEMININ;SCOLAIRE;BAC PROFESSIONNEL;BAC PRO SERV;BAC PRO 31108 TRANSPORT;6;5;3;2;0;0;0;3;0;0;0;2;1;2
14536.0;2022;18;ORLEANS-TOURS;FEMININ;SCOLAIRE;BAC PROFESSIONNEL;BAC PRO SERV;BAC PRO 31213 MET.COM.VEN.OP.A ANI.GES.ESP.COM.;436;436;386;35;15;8;7;394;0;13;77;168;136;42
14538.0;2022;18;ORLEANS-TOURS;FEMININ;SCOLAIRE;BAC PROFESSIONNEL;BAC PRO SERV;BAC PRO 32207 REAL.PR.IMPR.PLURI.OPTA.PR.GRAPH.;8;8;8;0;0;0;0;8;0;0;5;3;0;0
14539.0;2022;18;ORLEANS-TOURS;FEMININ;SCOLAIRE;BAC PROFESSIONNEL;BAC PRO SERV;BAC PRO 32208 REAL.PR.IMPR.PLURI.OPTB.PR.IMPR.;6;6;6;0;0;0;0;6;0;0;2;3;1;0
14541.0;2022;18;ORLEANS-TOURS;FEMININ;SCOLAIRE;BAC PROFESSIONNEL;BAC PRO SERV;BAC PRO 32304 PHOTOGRAPHIE;13;13;12;1;0;0;0;12;0;0;2;5;5;1
14542.0;2022;18;ORLEANS-TOURS;FEMININ;SCOLAIRE;BAC PROFESSIONNEL;BAC PRO SERV;BAC PRO 33002 SERVICES DE PROXIMITE  VIE LOCAL;66;65;58;3;4;2;2;60;0;5;13;22;20;5
14554.0;2022;18;ORLEANS-TOURS;FEMININ;SCOLAIRE;BAC TECHNOLOGIQUE;BAC STAV;BAC STAV AGRONOMIE ALIM ENV TERRITOI;112;112;110;2;0;0;0;110;0;0;9;39;62;2
14561.0;2022;18;ORLEANS-TOURS;FEMININ;SCOLAIRE;BAC TECHNOLOGIQUE;BAC STL;BAC STL BIOCHIM.-BIOLOGIE-BIOTECHNOL.;122;122;110;3;9;4;5;114;1;5;29;36;43;8
14566.0;2022;18;ORLEANS-TOURS;FEMININ;SCOLAIRE;BAC TECHNOLOGIQUE;BAC STMG;BAC STMG SYSTEMES D'INFORMATION DE GESTION;5;5;5;0;0;0;0;5;0;0;0;0;5;0
14578.0;2022;18;ORLEANS-TOURS;MASCULIN;APPRENTISSAGE;BAC PROFESSIONNEL;BAC PRO PROD;BAC PRO 25007 MAINTENANCE EQUIPEMENTS INDUST.;30;30;24;6;0;0;0;24;0;2;6;9;7;6
14579.0;2022;18;ORLEANS-TOURS;MASCULIN;APPRENTISSAGE;BAC PROFESSIONNEL;BAC PRO PROD;BAC PRO 25106 TECHNICIEN D'USINAGE;39;39;32;5;2;1;1;33;0;3;9;9;12;6
14585.0;2022;18;ORLEANS-TOURS;MASCULIN;APPRENTISSAGE;BAC PROFESSIONNEL;BAC PRO PROD;BAC PRO 25221 MAINT.MATERIELS OPT.C ESP. VERTS;15;15;13;2;0;0;0;13;0;0;1;4;8;2
14586.0;2022;18;ORLEANS-TOURS;MASCULIN;APPRENTISSAGE;BAC PROFESSIONNEL;BAC PRO PROD;BAC PRO 25406 OUVRAGES DU BATIMENT METALLERIE;3;3;3;0;0;0;0;3;0;0;0;2;1;0
14588.0;2022;18;ORLEANS-TOURS;MASCULIN;APPRENTISSAGE;BAC PROFESSIONNEL;BAC PRO PROD;BAC PRO 25410 CONSTRUCTION DES CARROSSERIES;11;11;8;1;2;1;1;9;0;0;2;2;5;2
14592.0;2022;18;ORLEANS-TOURS;MASCULIN;APPRENTISSAGE;BAC PROFESSIONNEL;BAC PRO PROD;BAC PRO 25513 SYST.NUM.OPT.A SURETE SECURITE;1;1;1;0;0;0;0;1;0;0;0;0;1;0
14607.0;2022;18;ORLEANS-TOURS;MASCULIN;APPRENTISSAGE;BAC PROFESSIONNEL;BAC PRO SERV;BAC PRO 31213 MET.COM.VEN.OP.A ANI.GES.ESP.COM.;86;83;58;21;4;2;2;60;0;2;12;21;25;23
14609.0;2022;18;ORLEANS-TOURS;MASCULIN;APPRENTISSAGE;BAC PROFESSIONNEL;BAC PRO SERV;BAC PRO 32207 REAL.PR.IMPR.PLURI.OPTA.PR.GRAPH.;4;4;4;0;0;0;0;4;0;0;2;1;1;0
14612.0;2022;18;ORLEANS-TOURS;MASCULIN;APPRENTISSAGE;BAC PROFESSIONNEL;BAC PRO SERV;BAC PRO 33403 COMMERC. SERVICES EN RESTAURATION;7;6;4;1;1;0;1;4;0;0;0;1;3;2
14625.0;2022;18;ORLEANS-TOURS;MASCULIN;FORMATION CONTINUE;BAC PROFESSIONNEL;BAC PRO PROD;BAC PRO 25303 AERONAUTIQUE OPTION SYSTEMES;18;17;17;0;0;0;0;17;0;0;5;9;3;0
14637.0;2022;18;ORLEANS-TOURS;MASCULIN;INDIVIDUEL;BAC PROFESSIONNEL;BAC PRO PROD;BAC PRO 25007 MAINTENANCE EQUIPEMENTS INDUST.;1;0;0;0;0;0;0;0;0;0;0;0;0;0
14640.0;2022;18;ORLEANS-TOURS;MASCULIN;INDIVIDUEL;BAC PROFESSIONNEL;BAC PRO PROD;BAC PRO 25515 SYST.NUM.OPT.C RES.INF.SYST.COMM.;2;2;2;0;0;0;0;2;0;0;0;0;2;0
14645.0;2022;18;ORLEANS-TOURS;MASCULIN;INDIVIDUEL;BAC PROFESSIONNEL;BAC PRO SERV;BAC PRO 30001 GESTION-ADMINISTRATION;5;4;2;2;0;0;0;2;0;0;0;0;2;2
14652.0;2022;18;ORLEANS-TOURS;MASCULIN;INDIVIDUEL;BAC TECHNOLOGIQUE;BAC ST2S;BAC ST2S SCIENCES & TECHNO. SANTE & SOCIAL;2;0;0;0;0;0;0;0;0;0;0;0;0;0
14653.0;2022;18;ORLEANS-TOURS;MASCULIN;INDIVIDUEL;BAC TECHNOLOGIQUE;BAC STD2A;BAC STD2A SCIENCES & TECHNO. DESIGN-ARTS APPLIQUES;2;1;0;1;0;0;0;0;0;0;0;0;0;1
14658.0;2022;18;ORLEANS-TOURS;MASCULIN;INDIVIDUEL;BAC TECHNOLOGIQUE;BAC STMG;BAC STMG MERCATIQUE (MARKETING);7;5;0;1;4;1;3;1;0;0;0;0;1;4
14659.0;2022;18;ORLEANS-TOURS;MASCULIN;INDIVIDUEL;BAC TECHNOLOGIQUE;BAC STMG;BAC STMG RESSOURCES HUMAINES ET COMMUNICATION;5;4;1;3;0;0;0;1;0;0;0;0;1;3
14663.0;2022;18;ORLEANS-TOURS;MASCULIN;SCOLAIRE;BAC PROFESSIONNEL;BAC PRO PROD;BAC PRO 20102 PILOTE DE LIGNE DE PRODUCTION;7;7;5;2;0;0;0;5;0;0;1;3;1;2
14674.0;2022;18;ORLEANS-TOURS;MASCULIN;SCOLAIRE;BAC PROFESSIONNEL;BAC PRO PROD;BAC PRO 23005 TECHN. ETUDES BAT B ASSIST.ARCHI.;32;32;23;7;2;1;1;24;0;0;2;10;12;8
14678.0;2022;18;ORLEANS-TOURS;MASCULIN;SCOLAIRE;BAC PROFESSIONNEL;BAC PRO PROD;BAC PRO 23205 INTERV. SUR PATRIMOINE BATI OPT.A;6;6;6;0;0;0;0;6;0;0;2;3;1;0
14684.0;2022;18;ORLEANS-TOURS;MASCULIN;SCOLAIRE;BAC PROFESSIONNEL;BAC PRO PROD;BAC PRO 23408 Etude et réalisation d'agencement;11;11;11;0;0;0;0;11;0;0;2;3;6;0
14688.0;2022;18;ORLEANS-TOURS;MASCULIN;SCOLAIRE;BAC PROFESSIONNEL;BAC PRO PROD;BAC PRO 25005 PRODUCTIQ.MECA. OPT.DECOLLETAGE;10;10;9;1;0;0;0;9;0;2;3;2;2;1
14701.0;2022;18;ORLEANS-TOURS;MASCULIN;SCOLAIRE;BAC PROFESSIONNEL;BAC PRO PROD;BAC PRO 25408 REPARATION DES CARROSSERIES;48;48;27;14;7;4;3;31;0;1;8;9;13;17
14709.0;2022;18;ORLEANS-TOURS;MASCULIN;SCOLAIRE;BAC PROFESSIONNEL;BAC PRO PROD;BAC PRO AG 21001 AGRO-EQUIPEMENT;25;25;24;1;0;0;0;24;0;0;4;8;12;1
14712.0;2022;18;ORLEANS-TOURS;MASCULIN;SCOLAIRE;BAC PROFESSIONNEL;BAC PRO PROD;BAC PRO AG 21114 CONDUITE PRODUCTIONS HORTICOLES;17;16;10;6;0;0;0;10;0;1;2;4;3;6
14734.0;2022;18;ORLEANS-TOURS;MASCULIN;SCOLAIRE;BAC PROFESSIONNEL;BAC PRO SERV;BAC PRO 33002 SERVICES DE PROXIMITE  VIE LOCAL;25;25;19;5;1;1;0;20;0;0;2;11;7;5
14737.0;2022;18;ORLEANS-TOURS;MASCULIN;SCOLAIRE;BAC PROFESSIONNEL;BAC PRO SERV;BAC PRO 33102 PROTHESE DENTAIRE;3;3;3;0;0;0;0;3;0;1;1;1;0;0
14745.0;2022;18;ORLEANS-TOURS;MASCULIN;SCOLAIRE;BAC TECHNOLOGIQUE;BAC ST2S;BAC ST2S SCIENCES & TECHNO. SANTE & SOCIAL;92;92;69;3;20;15;5;84;0;1;8;26;49;8
14748.0;2022;18;ORLEANS-TOURS;MASCULIN;SCOLAIRE;BAC TECHNOLOGIQUE;BAC STHR;BAC STHR SC.&TEC. HOTELLERIE-RESTAURATION;40;40;38;0;2;1;1;39;0;3;5;22;9;1
14749.0;2022;18;ORLEANS-TOURS;MASCULIN;SCOLAIRE;BAC TECHNOLOGIQUE;BAC STI2D;BAC STI2D ARCHITECTURE ET CONSTRUCTION;103;103;94;2;7;4;3;98;0;3;11;34;50;5
14758.0;2022;18;ORLEANS-TOURS;MASCULIN;SCOLAIRE;BAC TECHNOLOGIQUE;BAC STMG;BAC STMG SYSTEMES D'INFORMATION DE GESTION;27;27;22;2;3;1;2;23;0;0;0;9;14;4
14767.0;2022;01;PARIS;FEMININ;APPRENTISSAGE;BAC PROFESSIONNEL;BAC PRO SERV;BAC PRO 31209 POISSONIER ECAILLER TRAITEUR;5;5;5;0;0;0;0;5;0;0;0;1;4;0
14769.0;2022;01;PARIS;FEMININ;APPRENTISSAGE;BAC PROFESSIONNEL;BAC PRO SERV;BAC PRO 31213 MET.COM.VEN.OP.A ANI.GES.ESP.COM.;75;69;45;20;4;1;3;46;0;3;12;19;12;23
14770.0;2022;01;PARIS;FEMININ;APPRENTISSAGE;BAC PROFESSIONNEL;BAC PRO SERV;BAC PRO 31214 MET.COM.VEN.OP.B PR.CL.VA.OF.COM.;3;2;2;0;0;0;0;2;0;0;0;1;1;0
14775.0;2022;01;PARIS;FEMININ;APPRENTISSAGE;BAC PROFESSIONNEL;BAC PRO SERV;BAC PRO 33102 PROTHESE DENTAIRE;1;1;0;1;0;0;0;0;0;0;0;0;0;1
14785.0;2022;01;PARIS;FEMININ;ENSEIGNEMENT A DISTANCE;BAC TECHNOLOGIQUE;BAC STMG;BAC STMG GESTION ET FINANCE;1;1;1;0;0;0;0;1;0;0;0;1;0;0
14789.0;2022;01;PARIS;FEMININ;FORMATION CONTINUE;BAC PROFESSIONNEL;BAC PRO PROD;BAC PRO 25510 METIERS ELECT. ENVIRON. CONNECTES;1;1;1;0;0;0;0;1;0;1;0;0;0;0
14791.0;2022;01;PARIS;FEMININ;FORMATION CONTINUE;BAC PROFESSIONNEL;BAC PRO PROD;BAC PRO AG 21405 AMENAGEMENTS PAYSAGERS;12;12;12;0;0;0;0;12;0;0;0;0;12;0
14793.0;2022;01;PARIS;FEMININ;FORMATION CONTINUE;BAC PROFESSIONNEL;BAC PRO SERV;BAC PRO 33003 ACC.SOINS-S.PERS. OPT.A DOMICILE;4;4;2;2;0;0;0;2;0;0;0;0;2;2
14799.0;2022;01;PARIS;FEMININ;INDIVIDUEL;BAC PROFESSIONNEL;BAC PRO PROD;BAC PRO AG 21114 CONDUITE PRODUCTIONS HORTICOLES;5;3;3;0;0;0;0;3;0;0;0;0;3;0
14809.0;2022;01;PARIS;FEMININ;INDIVIDUEL;BAC PROFESSIONNEL;BAC PRO SERV;BAC PRO 33103 TECHNICIEN APPAREIL. ORTHOPEDIQUE;1;1;0;1;0;0;0;0;0;0;0;0;0;1
14815.0;2022;01;PARIS;FEMININ;INDIVIDUEL;BAC TECHNOLOGIQUE;BAC STMG;BAC STMG GESTION ET FINANCE;28;27;27;0;0;0;0;27;1;11;9;4;2;0
14817.0;2022;01;PARIS;FEMININ;INDIVIDUEL;BAC TECHNOLOGIQUE;BAC STMG;BAC STMG RESSOURCES HUMAINES ET COMMUNICATION;14;9;7;2;0;0;0;7;0;1;0;1;5;2
14819.0;2022;01;PARIS;FEMININ;SCOLAIRE;BAC PROFESSIONNEL;BAC PRO PROD;BACPRO 20002 ETUD.DEFINITION PRDTS INDUSTRIEL;1;1;0;1;0;0;0;0;0;0;0;0;0;1
14824.0;2022;01;PARIS;FEMININ;SCOLAIRE;BAC PROFESSIONNEL;BAC PRO PROD;BAC PRO 22402 ARTIS.& MET.ART:VERR.SCIENT.TECH;2;2;1;1;0;0;0;1;0;0;0;0;1;1
14825.0;2022;01;PARIS;FEMININ;SCOLAIRE;BAC PROFESSIONNEL;BAC PRO PROD;BAC PRO 22403 ARTS.& MET.ART:MET.ENSEIGN SIGNA;3;3;2;1;0;0;0;2;0;0;0;2;0;1
14828.0;2022;01;PARIS;FEMININ;SCOLAIRE;BAC PROFESSIONNEL;BAC PRO PROD;BAC PRO 23005 TECHN. ETUDES BAT B ASSIST.ARCHI.;10;10;10;0;0;0;0;10;0;1;0;5;4;0
14829.0;2022;01;PARIS;FEMININ;SCOLAIRE;BAC PROFESSIONNEL;BAC PRO PROD;BACPRO 23103 TECHNICIEN GEOMETRE-TOPOGRAPHE;1;1;1;0;0;0;0;1;0;0;0;1;0;0
14844.0;2022;01;PARIS;FEMININ;SCOLAIRE;BAC PROFESSIONNEL;BAC PRO SERV;BAC PRO 31108 TRANSPORT;6;6;2;4;0;0;0;2;0;0;0;0;2;4
14854.0;2022;01;PARIS;FEMININ;SCOLAIRE;BAC PROFESSIONNEL;BAC PRO SERV;BAC PRO 33003 ACC.SOINS-S.PERS. OPT.A DOMICILE;46;37;22;15;0;0;0;22;0;0;4;9;9;15
14877.0;2022;01;PARIS;FEMININ;SCOLAIRE;BAC TECHNOLOGIQUE;BAC STMG;BAC STMG RESSOURCES HUMAINES ET COMMUNICATION;331;331;258;27;46;35;11;293;0;2;35;100;156;38
14883.0;2022;01;PARIS;MASCULIN;APPRENTISSAGE;BAC PROFESSIONNEL;BAC PRO PROD;BAC PRO 22704 TECHN. MAINT. SYST.ENERG.CLIMATI;36;33;22;9;2;2;0;24;0;2;7;4;11;9
14887.0;2022;01;PARIS;MASCULIN;APPRENTISSAGE;BAC PROFESSIONNEL;BAC PRO PROD;BAC PRO 25214 MAINT.VEHIC.OPTA VOIT.PARTICUL.;15;14;11;0;3;2;1;13;0;0;0;5;8;1
14891.0;2022;01;PARIS;MASCULIN;APPRENTISSAGE;BAC PROFESSIONNEL;BAC PRO SERV;BAC PRO 30001 GESTION-ADMINISTRATION;15;13;11;1;1;0;1;11;0;0;4;2;5;2
14894.0;2022;01;PARIS;MASCULIN;APPRENTISSAGE;BAC PROFESSIONNEL;BAC PRO SERV;BAC PRO 31213 MET.COM.VEN.OP.A ANI.GES.ESP.COM.;66;63;40;16;7;5;2;45;0;4;3;13;25;18
14899.0;2022;01;PARIS;MASCULIN;APPRENTISSAGE;BAC PROFESSIONNEL;BAC PRO SERV;BAC PRO 33403 COMMERC. SERVICES EN RESTAURATION;56;55;44;10;1;0;1;44;0;2;11;15;16;11
14902.0;2022;01;PARIS;MASCULIN;ENSEIGNEMENT A DISTANCE;BAC PROFESSIONNEL;BAC PRO PROD;BAC PRO 22704 TECHN. MAINT. SYST.ENERG.CLIMATI;1;0;0;0;0;0;0;0;0;0;0;0;0;0
14906.0;2022;01;PARIS;MASCULIN;ENSEIGNEMENT A DISTANCE;BAC TECHNOLOGIQUE;BAC STMG;BAC STMG RESSOURCES HUMAINES ET COMMUNICATION;2;2;2;0;0;0;0;2;0;0;0;0;2;0
14911.0;2022;01;PARIS;MASCULIN;FORMATION CONTINUE;BAC PROFESSIONNEL;BAC PRO PROD;BAC PRO 25106 TECHNICIEN D'USINAGE;12;12;11;1;0;0;0;11;0;2;3;3;3;1
14914.0;2022;01;PARIS;MASCULIN;FORMATION CONTINUE;BAC PROFESSIONNEL;BAC PRO PROD;BAC PRO 25515 SYST.NUM.OPT.C RES.INF.SYST.COMM.;8;7;7;0;0;0;0;7;0;2;3;0;2;0
14917.0;2022;01;PARIS;MASCULIN;INDIVIDUEL;BAC GENERAL;BAC GENERAL;BAC GENE 10019 BAC GENERAL;481;419;267;67;85;57;28;324;0;19;52;77;176;95
14921.0;2022;01;PARIS;MASCULIN;INDIVIDUEL;BAC PROFESSIONNEL;BAC PRO PROD;BAC PRO 25007 MAINTENANCE EQUIPEMENTS INDUST.;1;1;1;0;0;0;0;1;0;0;0;0;1;0
14922.0;2022;01;PARIS;MASCULIN;INDIVIDUEL;BAC PROFESSIONNEL;BAC PRO PROD;BAC PRO 25214 MAINT.VEHIC.OPTA VOIT.PARTICUL.;7;6;5;1;0;0;0;5;0;1;1;2;1;1
14926.0;2022;01;PARIS;MASCULIN;INDIVIDUEL;BAC PROFESSIONNEL;BAC PRO PROD;BAC PRO AG 21113 CGEVV;3;3;3;0;0;0;0;3;0;0;0;0;3;0
14927.0;2022;01;PARIS;MASCULIN;INDIVIDUEL;BAC PROFESSIONNEL;BAC PRO PROD;BAC PRO AG 21114 CONDUITE PRODUCTIONS HORTICOLES;1;1;1;0;0;0;0;1;0;0;0;0;1;0
14930.0;2022;01;PARIS;MASCULIN;INDIVIDUEL;BAC PROFESSIONNEL;BAC PRO SERV;BAC PRO 31212 METIERS DE L'ACCUEIL;1;1;0;1;0;0;0;0;0;0;0;0;0;1
14935.0;2022;01;PARIS;MASCULIN;INDIVIDUEL;BAC PROFESSIONNEL;BAC PRO SERV;BAC PRO 33403 COMMERC. SERVICES EN RESTAURATION;1;0;0;0;0;0;0;0;0;0;0;0;0;0
14943.0;2022;01;PARIS;MASCULIN;INDIVIDUEL;BAC TECHNOLOGIQUE;BAC STMG;BAC STMG MERCATIQUE (MARKETING);88;81;53;11;17;13;4;66;0;1;2;15;48;15
14944.0;2022;01;PARIS;MASCULIN;INDIVIDUEL;BAC TECHNOLOGIQUE;BAC STMG;BAC STMG RESSOURCES HUMAINES ET COMMUNICATION;20;18;12;2;4;4;0;16;0;0;1;3;12;2
14946.0;2022;01;PARIS;MASCULIN;SCOLAIRE;BAC GENERAL;BAC GENERAL;BAC GENE 10019 BAC GENERAL;7354;7354;6912;110;332;239;93;7151;183;1404;2134;2002;1428;203
14949.0;2022;01;PARIS;MASCULIN;SCOLAIRE;BAC PROFESSIONNEL;BAC PRO PROD;BAC PRO 22003 BIO-INDUSTRIES DE TRANSFORMATION;9;9;7;2;0;0;0;7;0;0;0;1;6;2
14966.0;2022;01;PARIS;MASCULIN;SCOLAIRE;BAC PROFESSIONNEL;BAC PRO PROD;BAC PRO 23408 Etude et réalisation d'agencement;7;7;6;1;0;0;0;6;0;0;1;4;1;1
14969.0;2022;01;PARIS;MASCULIN;SCOLAIRE;BAC PROFESSIONNEL;BAC PRO PROD;BAC PRO 24301 METIERS DU CUIR : CHAUSSURES;1;1;1;0;0;0;0;1;0;0;0;0;1;0
14981.0;2022;01;PARIS;MASCULIN;SCOLAIRE;BAC PROFESSIONNEL;BAC PRO PROD;BAC PRO 25513 SYST.NUM.OPT.A SURETE SECURITE;51;51;48;3;0;0;0;48;0;5;9;18;16;3
14988.0;2022;01;PARIS;MASCULIN;SCOLAIRE;BAC PROFESSIONNEL;BAC PRO SERV;BAC PRO 31108 TRANSPORT;25;25;9;16;0;0;0;9;0;0;1;4;4;16
14994.0;2022;01;PARIS;MASCULIN;SCOLAIRE;BAC PROFESSIONNEL;BAC PRO SERV;BAC PRO 32208 REAL.PR.IMPR.PLURI.OPTB.PR.IMPR.;13;13;8;5;0;0;0;8;0;1;1;3;3;5
15004.0;2022;01;PARIS;MASCULIN;SCOLAIRE;BAC PROFESSIONNEL;BAC PRO SERV;BAC PRO 33602 PERRUQUIER POSTICHEUR;2;2;2;0;0;0;0;2;0;1;1;0;0;0
15007.0;2022;01;PARIS;MASCULIN;SCOLAIRE;BAC TECHNOLOGIQUE;BAC S2TMD;BAC S2TMD DANSE;1;1;1;0;0;0;0;1;0;0;0;1;0;0
15011.0;2022;01;PARIS;MASCULIN;SCOLAIRE;BAC TECHNOLOGIQUE;BAC STHR;BAC STHR SC.&TEC. HOTELLERIE-RESTAURATION;51;51;47;2;2;2;0;49;0;1;5;20;23;2
15013.0;2022;01;PARIS;MASCULIN;SCOLAIRE;BAC TECHNOLOGIQUE;BAC STI2D;BAC STI2D ENERGIES  ET ENVIRONNEMENT;29;29;24;2;3;3;0;27;0;0;4;12;11;2
15014.0;2022;01;PARIS;MASCULIN;SCOLAIRE;BAC TECHNOLOGIQUE;BAC STI2D;BAC STI2D INNOVATION TECHNO.  ET ECO CONCEPTION;203;203;172;10;21;19;2;191;0;7;26;65;93;12
15018.0;2022;01;PARIS;MASCULIN;SCOLAIRE;BAC TECHNOLOGIQUE;BAC STMG;BAC STMG GESTION ET FINANCE;270;270;240;9;21;17;4;257;0;8;49;109;91;13
15020.0;2022;01;PARIS;MASCULIN;SCOLAIRE;BAC TECHNOLOGIQUE;BAC STMG;BAC STMG RESSOURCES HUMAINES ET COMMUNICATION;182;182;124;23;35;29;6;153;0;2;11;40;100;29
15033.0;2022;13;POITIERS;FEMININ;APPRENTISSAGE;BAC PROFESSIONNEL;BAC PRO PROD;BAC PRO AG 21001 AGRO-EQUIPEMENT;1;1;1;0;0;0;0;1;0;0;0;0;1;0
15040.0;2022;13;POITIERS;FEMININ;APPRENTISSAGE;BAC PROFESSIONNEL;BAC PRO SERV;BAC PRO 30001 GESTION-ADMINISTRATION;9;9;8;0;1;1;0;9;0;1;2;4;2;0
15049.0;2022;13;POITIERS;FEMININ;APPRENTISSAGE;BAC PROFESSIONNEL;BAC PRO SERV;BAC PRO AG 33002 SERV PERS TERRIT;28;28;23;5;0;0;0;23;0;0;2;11;10;5
15051.0;2022;13;POITIERS;FEMININ;ENSEIGNEMENT A DISTANCE;BAC PROFESSIONNEL;BAC PRO SERV;BAC PRO 30001 GESTION-ADMINISTRATION;3;1;0;1;0;0;0;0;0;0;0;0;0;1
15054.0;2022;13;POITIERS;FEMININ;ENSEIGNEMENT A DISTANCE;BAC PROFESSIONNEL;BAC PRO SERV;BAC PRO 33003 ACC.SOINS-S.PERS. OPT.A DOMICILE;1;0;0;0;0;0;0;0;0;0;0;0;0;0
15055.0;2022;13;POITIERS;FEMININ;ENSEIGNEMENT A DISTANCE;BAC PROFESSIONNEL;BAC PRO SERV;BAC PRO 33004 ACC.SOINS-S.PERS. OPT.EN STRUCTUR;3;2;2;0;0;0;0;2;0;0;0;1;1;0
15058.0;2022;13;POITIERS;FEMININ;ENSEIGNEMENT A DISTANCE;BAC TECHNOLOGIQUE;BAC STMG;BAC STMG GESTION ET FINANCE;1;1;0;0;1;1;0;1;0;0;0;0;1;0
15059.0;2022;13;POITIERS;FEMININ;ENSEIGNEMENT A DISTANCE;BAC TECHNOLOGIQUE;BAC STMG;BAC STMG MERCATIQUE (MARKETING);3;3;2;0;1;1;0;3;0;0;0;0;3;0
15061.0;2022;13;POITIERS;FEMININ;FORMATION CONTINUE;BAC PROFESSIONNEL;BAC PRO PROD;BAC PRO 22004 PROC. CHIMIE EAU PAPIERS-CARTONS;2;2;2;0;0;0;0;2;0;1;0;1;0;0
15068.0;2022;13;POITIERS;FEMININ;INDIVIDUEL;BAC PROFESSIONNEL;BAC PRO PROD;BAC PRO AG 21113 CGEVV;2;1;1;0;0;0;0;1;0;0;0;0;1;0
15072.0;2022;13;POITIERS;FEMININ;INDIVIDUEL;BAC PROFESSIONNEL;BAC PRO SERV;BAC PRO 31212 METIERS DE L'ACCUEIL;2;1;0;1;0;0;0;0;0;0;0;0;0;1
15074.0;2022;13;POITIERS;FEMININ;INDIVIDUEL;BAC PROFESSIONNEL;BAC PRO SERV;BAC PRO 33002 SERVICES DE PROXIMITE  VIE LOCAL;1;0;0;0;0;0;0;0;0;0;0;0;0;0
15091.0;2022;13;POITIERS;FEMININ;SCOLAIRE;BAC PROFESSIONNEL;BAC PRO PROD;BAC PRO 22703 TECHN.INSTALL.SYST.ENERG.CLIMATI;1;1;0;1;0;0;0;0;0;0;0;0;0;1
15094.0;2022;13;POITIERS;FEMININ;SCOLAIRE;BAC PROFESSIONNEL;BAC PRO PROD;BAC PRO 23102 TRAVAUX PUBLICS;1;1;1;0;0;0;0;1;0;0;0;0;1;0
15097.0;2022;13;POITIERS;FEMININ;SCOLAIRE;BAC PROFESSIONNEL;BAC PRO PROD;BAC PRO 23405 TECHNICIEN MENUISIER AGENCEUR;4;4;4;0;0;0;0;4;0;0;1;1;2;0
15098.0;2022;13;POITIERS;FEMININ;SCOLAIRE;BAC PROFESSIONNEL;BAC PRO PROD;BAC PRO 24203 METIERS DE LA MODE - VÊTEMENT;65;65;57;8;0;0;0;57;0;11;14;16;16;8
15101.0;2022;13;POITIERS;FEMININ;SCOLAIRE;BAC PROFESSIONNEL;BAC PRO PROD;BAC PRO 25007 MAINTENANCE EQUIPEMENTS INDUST.;4;4;3;1;0;0;0;3;0;0;1;2;0;1
15103.0;2022;13;POITIERS;FEMININ;SCOLAIRE;BAC PROFESSIONNEL;BAC PRO PROD;BAC PRO 25106 TECHNICIEN D'USINAGE;3;3;2;1;0;0;0;2;0;0;1;0;1;1
15108.0;2022;13;POITIERS;FEMININ;SCOLAIRE;BAC PROFESSIONNEL;BAC PRO PROD;BAC PRO 25304 AERONAUTIQUE OPTION STRUCTURE;3;3;3;0;0;0;0;3;0;0;0;1;2;0
15114.0;2022;13;POITIERS;FEMININ;SCOLAIRE;BAC PROFESSIONNEL;BAC PRO PROD;BAC PRO AG 21113 CGEVV;1;1;0;1;0;0;0;0;0;0;0;0;0;1
15115.0;2022;13;POITIERS;FEMININ;SCOLAIRE;BAC PROFESSIONNEL;BAC PRO PROD;BAC PRO AG 21114 CONDUITE PRODUCTIONS HORTICOLES;12;12;9;3;0;0;0;9;0;1;0;1;7;3
15118.0;2022;13;POITIERS;FEMININ;SCOLAIRE;BAC PROFESSIONNEL;BAC PRO PROD;BAC PRO AG 21210 COND GEST ENTR CANIN ET FELIN;22;22;22;0;0;0;0;22;0;0;4;6;12;0
15122.0;2022;13;POITIERS;FEMININ;SCOLAIRE;BAC PROFESSIONNEL;BAC PRO PROD;BAC PRO AG 21405 AMENAGEMENTS PAYSAGERS;3;3;3;0;0;0;0;3;0;0;2;1;0;0
15128.0;2022;13;POITIERS;FEMININ;SCOLAIRE;BAC PROFESSIONNEL;BAC PRO SERV;BAC PRO 31106 LOGISTIQUE;8;8;6;1;1;1;0;7;0;1;2;2;2;1
15129.0;2022;13;POITIERS;FEMININ;SCOLAIRE;BAC PROFESSIONNEL;BAC PRO SERV;BAC PRO 31107 CONDUCT. TRANSP.ROUT.MARCHANDISES;5;5;5;0;0;0;0;5;0;1;2;2;0;0
15131.0;2022;13;POITIERS;FEMININ;SCOLAIRE;BAC PROFESSIONNEL;BAC PRO SERV;BAC PRO 31212 METIERS DE L'ACCUEIL;50;50;45;3;2;2;0;47;0;3;12;18;14;3
15134.0;2022;13;POITIERS;FEMININ;SCOLAIRE;BAC PROFESSIONNEL;BAC PRO SERV;BAC PRO 32207 REAL.PR.IMPR.PLURI.OPTA.PR.GRAPH.;7;7;6;1;0;0;0;6;0;2;3;1;0;1
15138.0;2022;13;POITIERS;FEMININ;SCOLAIRE;BAC PROFESSIONNEL;BAC PRO SERV;BAC PRO 33003 ACC.SOINS-S.PERS. OPT.A DOMICILE;33;33;29;3;1;1;0;30;0;1;5;16;8;3
15143.0;2022;13;POITIERS;FEMININ;SCOLAIRE;BAC PROFESSIONNEL;BAC PRO SERV;BAC PRO 34303 GEST. POLLUTIONS PROTEC. ENVIRON.;1;1;1;0;0;0;0;1;0;0;0;0;1;0
15150.0;2022;13;POITIERS;FEMININ;SCOLAIRE;BAC TECHNOLOGIQUE;BAC STI2D;BAC STI2D ARCHITECTURE ET CONSTRUCTION;15;15;12;1;2;1;1;13;0;0;1;4;8;2
15156.0;2022;13;POITIERS;FEMININ;SCOLAIRE;BAC TECHNOLOGIQUE;BAC STMG;BAC STMG GESTION ET FINANCE;122;122;100;3;19;14;5;114;0;4;13;46;51;8
15158.0;2022;13;POITIERS;FEMININ;SCOLAIRE;BAC TECHNOLOGIQUE;BAC STMG;BAC STMG RESSOURCES HUMAINES ET COMMUNICATION;280;280;207;18;55;37;18;244;0;1;30;78;135;36
15159.0;2022;13;POITIERS;FEMININ;SCOLAIRE;BAC TECHNOLOGIQUE;BAC STMG;BAC STMG SYSTEMES D'INFORMATION DE GESTION;3;3;3;0;0;0;0;3;0;0;0;1;2;0
15172.0;2022;13;POITIERS;MASCULIN;APPRENTISSAGE;BAC PROFESSIONNEL;BAC PRO PROD;BAC PRO 25009 MAINTENANCE NAUTIQUE;15;15;13;2;0;0;0;13;0;0;3;8;2;2
15176.0;2022;13;POITIERS;MASCULIN;APPRENTISSAGE;BAC PROFESSIONNEL;BAC PRO PROD;BAC PRO 25216 MAINT.VEHIC.OPTC MOTOCYCLES;5;5;5;0;0;0;0;5;0;2;3;0;0;0
15179.0;2022;13;POITIERS;MASCULIN;APPRENTISSAGE;BAC PROFESSIONNEL;BAC PRO PROD;BAC PRO 25221 MAINT.MATERIELS OPT.C ESP. VERTS;2;2;2;0;0;0;0;2;0;0;1;1;0;0
15180.0;2022;13;POITIERS;MASCULIN;APPRENTISSAGE;BAC PROFESSIONNEL;BAC PRO PROD;BAC PRO 25304 AERONAUTIQUE OPTION STRUCTURE;8;8;5;2;1;1;0;6;0;1;0;3;2;2
15196.0;2022;13;POITIERS;MASCULIN;APPRENTISSAGE;BAC PROFESSIONNEL;BAC PRO SERV;BAC PRO 31106 LOGISTIQUE;19;19;13;4;2;1;1;14;0;0;5;1;8;5
15204.0;2022;13;POITIERS;MASCULIN;APPRENTISSAGE;BAC PROFESSIONNEL;BAC PRO SERV;BAC PRO 34303 GEST. POLLUTIONS PROTEC. ENVIRON.;2;2;2;0;0;0;0;2;0;0;1;0;1;0
15218.0;2022;13;POITIERS;MASCULIN;INDIVIDUEL;BAC PROFESSIONNEL;BAC PRO PROD;BAC PRO 25214 MAINT.VEHIC.OPTA VOIT.PARTICUL.;2;1;1;0;0;0;0;1;0;0;0;0;1;0
15224.0;2022;13;POITIERS;MASCULIN;INDIVIDUEL;BAC PROFESSIONNEL;BAC PRO SERV;BAC PRO 31214 MET.COM.VEN.OP.B PR.CL.VA.OF.COM.;2;1;0;1;0;0;0;0;0;0;0;0;0;1
15225.0;2022;13;POITIERS;MASCULIN;INDIVIDUEL;BAC TECHNOLOGIQUE;BAC ST2S;BAC ST2S SCIENCES & TECHNO. SANTE & SOCIAL;2;1;0;1;0;0;0;0;0;0;0;0;0;1
15236.0;2022;13;POITIERS;MASCULIN;SCOLAIRE;BAC PROFESSIONNEL;BAC PRO PROD;BAC PRO 22106 CUISINE;69;69;59;7;3;3;0;62;0;6;14;23;19;7
15248.0;2022;13;POITIERS;MASCULIN;SCOLAIRE;BAC PROFESSIONNEL;BAC PRO PROD;BAC PRO 23404 TECHNICIEN CONSTRUCTEUR BOIS;5;5;3;2;0;0;0;3;0;0;0;1;2;2
15255.0;2022;13;POITIERS;MASCULIN;SCOLAIRE;BAC PROFESSIONNEL;BAC PRO PROD;BAC PRO 25009 MAINTENANCE NAUTIQUE;13;12;7;4;1;0;1;7;0;0;2;4;1;5
15267.0;2022;13;POITIERS;MASCULIN;SCOLAIRE;BAC PROFESSIONNEL;BAC PRO PROD;BAC PRO 25408 REPARATION DES CARROSSERIES;8;8;7;1;0;0;0;7;0;0;2;2;3;1
15272.0;2022;13;POITIERS;MASCULIN;SCOLAIRE;BAC PROFESSIONNEL;BAC PRO PROD;BAC PRO 25514 SYST.NUM.OPT.B AUD.RES.EQUIP.DOM.;43;43;39;4;0;0;0;39;0;1;10;16;12;4
15279.0;2022;13;POITIERS;MASCULIN;SCOLAIRE;BAC PROFESSIONNEL;BAC PRO PROD;BAC PRO AG 21204 PROD-AQUACOLES;17;15;9;6;0;0;0;9;0;0;0;4;5;6
15295.0;2022;13;POITIERS;MASCULIN;SCOLAIRE;BAC PROFESSIONNEL;BAC PRO SERV;BAC PRO 31214 MET.COM.VEN.OP.B PR.CL.VA.OF.COM.;145;145;119;23;3;2;1;121;0;2;16;54;49;24
15300.0;2022;13;POITIERS;MASCULIN;SCOLAIRE;BAC PROFESSIONNEL;BAC PRO SERV;BAC PRO 33003 ACC.SOINS-S.PERS. OPT.A DOMICILE;1;1;0;1;0;0;0;0;0;0;0;0;0;1
15303.0;2022;13;POITIERS;MASCULIN;SCOLAIRE;BAC PROFESSIONNEL;BAC PRO SERV;BAC PRO 33403 COMMERC. SERVICES EN RESTAURATION;40;40;34;4;2;1;1;35;0;2;9;10;14;5
15313.0;2022;13;POITIERS;MASCULIN;SCOLAIRE;BAC TECHNOLOGIQUE;BAC STI2D;BAC STI2D INNOVATION TECHNO.  ET ECO CONCEPTION;121;121;101;4;16;13;3;114;0;2;10;37;65;7
15319.0;2022;13;POITIERS;MASCULIN;SCOLAIRE;BAC TECHNOLOGIQUE;BAC STMG;BAC STMG RESSOURCES HUMAINES ET COMMUNICATION;167;167;116;15;36;31;5;147;0;1;4;32;110;20
15327.0;2022;19;REIMS;FEMININ;APPRENTISSAGE;BAC PROFESSIONNEL;BAC PRO PROD;BAC PRO 25510 METIERS ELECT. ENVIRON. CONNECTES;3;3;3;0;0;0;0;3;0;0;0;2;1;0
15330.0;2022;19;REIMS;FEMININ;APPRENTISSAGE;BAC PROFESSIONNEL;BAC PRO PROD;BAC PRO AG 21211 COND GEST ENTR HIPPIQUE;12;10;8;2;0;0;0;8;0;0;0;3;5;2
15339.0;2022;19;REIMS;FEMININ;APPRENTISSAGE;BAC PROFESSIONNEL;BAC PRO SERV;BAC PRO 34305 TECHN.D'INTERV.SUR INSTALL. NUCL.;3;3;3;0;0;0;0;3;0;2;1;0;0;0
15357.0;2022;19;REIMS;FEMININ;INDIVIDUEL;BAC PROFESSIONNEL;BAC PRO PROD;BAC PRO AG 21004 CGEA;2;2;0;2;0;0;0;0;0;0;0;0;0;2
15364.0;2022;19;REIMS;FEMININ;INDIVIDUEL;BAC TECHNOLOGIQUE;BAC S2TMD;BAC S2TMD MUSIQUE;1;0;0;0;0;0;0;0;0;0;0;0;0;0
15374.0;2022;19;REIMS;FEMININ;SCOLAIRE;BAC PROFESSIONNEL;BAC PRO PROD;BAC PRO 22106 CUISINE;32;32;28;4;0;0;0;28;0;3;10;6;9;4
15381.0;2022;19;REIMS;FEMININ;SCOLAIRE;BAC PROFESSIONNEL;BAC PRO PROD;BAC PRO 24202 ARTIS.& MET.ART : TAPIS.D'AMEUBL;4;4;4;0;0;0;0;4;0;0;2;1;1;0
15395.0;2022;19;REIMS;FEMININ;SCOLAIRE;BAC PROFESSIONNEL;BAC PRO PROD;BAC PRO AG 21203 TECHN CONSEIL DE VENTE ANIMAL;14;14;13;1;0;0;0;13;0;1;1;5;6;1
15398.0;2022;19;REIMS;FEMININ;SCOLAIRE;BAC PROFESSIONNEL;BAC PRO PROD;BAC PRO AG 21302 GEST MILIEUX NATURELS FAUNE;9;9;5;4;0;0;0;5;0;0;0;1;4;4
15402.0;2022;19;REIMS;FEMININ;SCOLAIRE;BAC PROFESSIONNEL;BAC PRO PROD;BAC PRO AG 22106 TEC CONS VTE ALIMENTATION VINS SP;7;6;4;2;0;0;0;4;0;0;0;1;3;2
15415.0;2022;19;REIMS;FEMININ;SCOLAIRE;BAC PROFESSIONNEL;BAC PRO SERV;BAC PRO 33003 ACC.SOINS-S.PERS. OPT.A DOMICILE;95;95;81;8;6;5;1;86;0;7;14;34;31;9
15417.0;2022;19;REIMS;FEMININ;SCOLAIRE;BAC PROFESSIONNEL;BAC PRO SERV;BAC PRO 33101 OPTIQUE LUNETTERIE;4;4;4;0;0;0;0;4;0;0;1;3;0;0
15419.0;2022;19;REIMS;FEMININ;SCOLAIRE;BAC PROFESSIONNEL;BAC PRO SERV;BAC PRO 33403 COMMERC. SERVICES EN RESTAURATION;49;49;40;4;5;4;1;44;0;1;7;11;25;5
15427.0;2022;19;REIMS;FEMININ;SCOLAIRE;BAC TECHNOLOGIQUE;BAC ST2S;BAC ST2S SCIENCES & TECHNO. SANTE & SOCIAL;334;334;276;8;50;28;22;304;1;8;42;119;134;30
15434.0;2022;19;REIMS;FEMININ;SCOLAIRE;BAC TECHNOLOGIQUE;BAC STI2D;BAC STI2D SYSTÈME D'INFORMATION  ET NUMERIQUE;7;7;5;0;2;1;1;6;0;0;2;2;2;1
15435.0;2022;19;REIMS;FEMININ;SCOLAIRE;BAC TECHNOLOGIQUE;BAC STL;BAC STL BIOCHIM.-BIOLOGIE-BIOTECHNOL.;29;29;24;1;4;2;2;26;2;4;2;7;11;3
15441.0;2022;19;REIMS;MASCULIN;APPRENTISSAGE;BAC PROFESSIONNEL;BAC PRO PROD;BAC PRO 20102 PILOTE DE LIGNE DE PRODUCTION;3;3;2;1;0;0;0;2;0;1;1;0;0;1
15448.0;2022;19;REIMS;MASCULIN;APPRENTISSAGE;BAC PROFESSIONNEL;BAC PRO PROD;BAC PRO 23303 MENUISERIE ALUMINIUM-VERRE;1;1;0;0;1;0;1;0;0;0;0;0;0;1
15451.0;2022;19;REIMS;MASCULIN;APPRENTISSAGE;BAC PROFESSIONNEL;BAC PRO PROD;BAC PRO 23405 TECHNICIEN MENUISIER AGENCEUR;4;4;1;2;1;1;0;2;0;0;0;1;1;2
15455.0;2022;19;REIMS;MASCULIN;APPRENTISSAGE;BAC PROFESSIONNEL;BAC PRO PROD;BAC PRO 25107 TECHNICIEN OUTILLEUR;4;4;4;0;0;0;0;4;0;0;0;3;1;0
15470.0;2022;19;REIMS;MASCULIN;APPRENTISSAGE;BAC PROFESSIONNEL;BAC PRO PROD;BAC PRO AG 21113 CGEVV;28;28;21;7;0;0;0;21;0;0;1;4;16;7
15475.0;2022;19;REIMS;MASCULIN;APPRENTISSAGE;BAC PROFESSIONNEL;BAC PRO SERV;BAC PRO 31213 MET.COM.VEN.OP.A ANI.GES.ESP.COM.;17;16;14;1;1;0;1;14;0;0;2;8;4;2
15476.0;2022;19;REIMS;MASCULIN;APPRENTISSAGE;BAC PROFESSIONNEL;BAC PRO SERV;BAC PRO 32207 REAL.PR.IMPR.PLURI.OPTA.PR.GRAPH.;1;1;1;0;0;0;0;1;0;0;1;0;0;0
15500.0;2022;19;REIMS;MASCULIN;INDIVIDUEL;BAC TECHNOLOGIQUE;BAC STI2D;BAC STI2D ENERGIES  ET ENVIRONNEMENT;2;1;0;0;1;0;1;0;0;0;0;0;0;1
15515.0;2022;19;REIMS;MASCULIN;SCOLAIRE;BAC PROFESSIONNEL;BAC PRO PROD;BAC PRO 22703 TECHN.INSTALL.SYST.ENERG.CLIMATI;22;22;12;9;1;1;0;13;0;1;1;4;7;9
15516.0;2022;19;REIMS;MASCULIN;SCOLAIRE;BAC PROFESSIONNEL;BAC PRO PROD;BAC PRO 22704 TECHN. MAINT. SYST.ENERG.CLIMATI;15;15;9;4;2;1;1;10;0;0;0;3;7;5
15520.0;2022;19;REIMS;MASCULIN;SCOLAIRE;BAC PROFESSIONNEL;BAC PRO PROD;BACPRO 23103 TECHNICIEN GEOMETRE-TOPOGRAPHE;7;7;5;2;0;0;0;5;0;1;0;0;4;2
15521.0;2022;19;REIMS;MASCULIN;SCOLAIRE;BAC PROFESSIONNEL;BAC PRO PROD;BAC PRO 23203 TECHNICIEN BAT. : ORG.REAL.GROS O;10;10;5;3;2;2;0;7;0;0;0;3;4;3
15523.0;2022;19;REIMS;MASCULIN;SCOLAIRE;BAC PROFESSIONNEL;BAC PRO PROD;BAC PRO 23304 AMENAGEMENT FINITION BATIMENT;10;10;9;0;1;1;0;10;0;0;0;2;8;0
15527.0;2022;19;REIMS;MASCULIN;SCOLAIRE;BAC PROFESSIONNEL;BAC PRO PROD;BAC PRO 24202 ARTIS.& MET.ART : TAPIS.D'AMEUBL;2;2;2;0;0;0;0;2;0;0;0;1;1;0
15536.0;2022;19;REIMS;MASCULIN;SCOLAIRE;BAC PROFESSIONNEL;BAC PRO PROD;BAC PRO 25221 MAINT.MATERIELS OPT.C ESP. VERTS;3;3;1;2;0;0;0;1;0;0;0;0;1;2
15543.0;2022;19;REIMS;MASCULIN;SCOLAIRE;BAC PROFESSIONNEL;BAC PRO PROD;BAC PRO 25515 SYST.NUM.OPT.C RES.INF.SYST.COMM.;94;94;85;7;2;1;1;86;0;3;29;27;27;8
15545.0;2022;19;REIMS;MASCULIN;SCOLAIRE;BAC PROFESSIONNEL;BAC PRO PROD;BAC PRO AG 21004 CGEA;89;89;72;17;0;0;0;72;0;2;4;29;37;17
15547.0;2022;19;REIMS;MASCULIN;SCOLAIRE;BAC PROFESSIONNEL;BAC PRO PROD;BAC PRO AG 21114 CONDUITE PRODUCTIONS HORTICOLES;1;1;1;0;0;0;0;1;0;0;0;0;1;0
15552.0;2022;19;REIMS;MASCULIN;SCOLAIRE;BAC PROFESSIONNEL;BAC PRO PROD;BAC PRO AG 21303 FORET;19;19;19;0;0;0;0;19;0;0;1;6;12;0
15553.0;2022;19;REIMS;MASCULIN;SCOLAIRE;BAC PROFESSIONNEL;BAC PRO PROD;BAC PRO AG 21405 AMENAGEMENTS PAYSAGERS;18;17;14;3;0;0;0;14;0;0;1;6;7;3
15561.0;2022;19;REIMS;MASCULIN;SCOLAIRE;BAC PROFESSIONNEL;BAC PRO SERV;BAC PRO 31212 METIERS DE L'ACCUEIL;20;20;15;4;1;1;0;16;0;1;1;5;9;4
15564.0;2022;19;REIMS;MASCULIN;SCOLAIRE;BAC PROFESSIONNEL;BAC PRO SERV;BAC PRO 32207 REAL.PR.IMPR.PLURI.OPTA.PR.GRAPH.;13;13;11;2;0;0;0;11;0;0;2;6;3;2
15565.0;2022;19;REIMS;MASCULIN;SCOLAIRE;BAC PROFESSIONNEL;BAC PRO SERV;BAC PRO 32208 REAL.PR.IMPR.PLURI.OPTB.PR.IMPR.;7;7;5;2;0;0;0;5;0;0;2;2;1;2
15574.0;2022;19;REIMS;MASCULIN;SCOLAIRE;BAC PROFESSIONNEL;BAC PRO SERV;BAC PRO 34403 METIERS DE LA SECURITE;64;64;57;5;2;1;1;58;0;1;7;29;21;6
15580.0;2022;19;REIMS;MASCULIN;SCOLAIRE;BAC TECHNOLOGIQUE;BAC STHR;BAC STHR SC.&TEC. HOTELLERIE-RESTAURATION;17;17;15;2;0;0;0;15;0;0;5;4;6;2
15585.0;2022;19;REIMS;MASCULIN;SCOLAIRE;BAC TECHNOLOGIQUE;BAC STL;BAC STL BIOCHIM.-BIOLOGIE-BIOTECHNOL.;38;38;33;0;5;3;2;36;0;2;7;13;14;2
15598.0;2022;14;RENNES;FEMININ;APPRENTISSAGE;BAC PROFESSIONNEL;BAC PRO PROD;BAC PRO 25510 METIERS ELECT. ENVIRON. CONNECTES;2;2;2;0;0;0;0;2;0;1;1;0;0;0
15601.0;2022;14;RENNES;FEMININ;APPRENTISSAGE;BAC PROFESSIONNEL;BAC PRO PROD;BAC PRO AG 21114 CONDUITE PRODUCTIONS HORTICOLES;7;7;6;1;0;0;0;6;0;0;0;0;6;1
15602.0;2022;14;RENNES;FEMININ;APPRENTISSAGE;BAC PROFESSIONNEL;BAC PRO PROD;BAC PRO AG 21203 TECHN CONSEIL DE VENTE ANIMAL;1;1;1;0;0;0;0;1;0;0;0;1;0;0
15606.0;2022;14;RENNES;FEMININ;APPRENTISSAGE;BAC PROFESSIONNEL;BAC PRO PROD;BAC PRO AG 22107 TEC CONS VTE ALIMENTATION P.ALIM;7;7;6;1;0;0;0;6;0;1;0;1;4;1
15608.0;2022;14;RENNES;FEMININ;APPRENTISSAGE;BAC PROFESSIONNEL;BAC PRO SERV;BAC PRO 31106 LOGISTIQUE;5;5;4;1;0;0;0;4;0;0;0;1;3;1
15612.0;2022;14;RENNES;FEMININ;APPRENTISSAGE;BAC PROFESSIONNEL;BAC PRO SERV;BAC PRO 33603 ESTHETIQUE COSMETIQUE PARFUMERIE;13;13;13;0;0;0;0;13;0;1;6;3;3;0
15620.0;2022;14;RENNES;FEMININ;ENSEIGNEMENT A DISTANCE;BAC TECHNOLOGIQUE;BAC ST2S;BAC ST2S SCIENCES & TECHNO. SANTE & SOCIAL;13;13;8;2;3;2;1;10;0;0;0;0;10;3
15625.0;2022;14;RENNES;FEMININ;FORMATION CONTINUE;BAC PROFESSIONNEL;BAC PRO PROD;BAC PRO 25303 AERONAUTIQUE OPTION SYSTEMES;1;1;1;0;0;0;0;1;0;0;0;1;0;0
15626.0;2022;14;RENNES;FEMININ;FORMATION CONTINUE;BAC PROFESSIONNEL;BAC PRO SERV;BAC PRO 31106 LOGISTIQUE;1;1;1;0;0;0;0;1;0;1;0;0;0;0
15628.0;2022;14;RENNES;FEMININ;INDIVIDUEL;BAC GENERAL;BAC GENERAL;BAC GENE 10019 BAC GENERAL;82;60;41;16;3;2;1;43;0;10;13;8;12;17
15632.0;2022;14;RENNES;FEMININ;INDIVIDUEL;BAC PROFESSIONNEL;BAC PRO PROD;BAC PRO AG 21114 CONDUITE PRODUCTIONS HORTICOLES;11;11;10;1;0;0;0;10;0;0;0;1;9;1
15633.0;2022;14;RENNES;FEMININ;INDIVIDUEL;BAC PROFESSIONNEL;BAC PRO PROD;BAC PRO AG 21211 COND GEST ENTR HIPPIQUE;16;14;11;3;0;0;0;11;0;0;0;4;7;3
15638.0;2022;14;RENNES;FEMININ;INDIVIDUEL;BAC PROFESSIONNEL;BAC PRO SERV;BAC PRO 31214 MET.COM.VEN.OP.B PR.CL.VA.OF.COM.;1;1;1;0;0;0;0;1;0;0;0;0;1;0
15639.0;2022;14;RENNES;FEMININ;INDIVIDUEL;BAC PROFESSIONNEL;BAC PRO SERV;BAC PRO 32303 ART.& MET.ART:COM.VIS.VIS.PLURI-M;1;1;1;0;0;0;0;1;0;0;0;0;1;0
15644.0;2022;14;RENNES;FEMININ;INDIVIDUEL;BAC TECHNOLOGIQUE;BAC STAV;BAC STAV AGRONOMIE ALIM ENV TERRITOI;1;1;0;1;0;0;0;0;0;0;0;0;0;1
15646.0;2022;14;RENNES;FEMININ;INDIVIDUEL;BAC TECHNOLOGIQUE;BAC STMG;BAC STMG MERCATIQUE (MARKETING);9;2;2;0;0;0;0;2;0;0;0;1;1;0
15647.0;2022;14;RENNES;FEMININ;INDIVIDUEL;BAC TECHNOLOGIQUE;BAC STMG;BAC STMG RESSOURCES HUMAINES ET COMMUNICATION;5;2;1;1;0;0;0;1;0;0;0;0;1;1
15665.0;2022;14;RENNES;FEMININ;SCOLAIRE;BAC PROFESSIONNEL;BAC PRO PROD;BAC PRO 24302 METIERS DU CUIR : MAROQUINERIE;9;9;7;2;0;0;0;7;0;1;1;1;4;2
15671.0;2022;14;RENNES;FEMININ;SCOLAIRE;BAC PROFESSIONNEL;BAC PRO PROD;BAC PRO 25214 MAINT.VEHIC.OPTA VOIT.PARTICUL.;12;12;10;2;0;0;0;10;0;1;0;3;6;2
15674.0;2022;14;RENNES;FEMININ;SCOLAIRE;BAC PROFESSIONNEL;BAC PRO PROD;BAC PRO 25219 MAINT.MATERIELS OPT.A AGRICOLES;1;1;1;0;0;0;0;1;0;0;0;1;0;0
15678.0;2022;14;RENNES;FEMININ;SCOLAIRE;BAC PROFESSIONNEL;BAC PRO PROD;BAC PRO 25411 TECH.CHAUDRONNERIE INDUSTRIELLE;4;4;3;1;0;0;0;3;0;1;1;0;1;1
15692.0;2022;14;RENNES;FEMININ;SCOLAIRE;BAC PROFESSIONNEL;BAC PRO PROD;BAC PRO AG 21405 AMENAGEMENTS PAYSAGERS;16;16;15;1;0;0;0;15;0;0;1;6;8;1
15693.0;2022;14;RENNES;FEMININ;SCOLAIRE;BAC PROFESSIONNEL;BAC PRO PROD;BAC PRO AG 21407 TEC CONS VTE UNIVERS JARDINERIE;20;20;16;4;0;0;0;16;0;1;0;5;10;4
15695.0;2022;14;RENNES;FEMININ;SCOLAIRE;BAC PROFESSIONNEL;BAC PRO PROD;BAC PRO AG 22107 TEC CONS VTE ALIMENTATION P.ALIM;72;72;58;14;0;0;0;58;0;0;6;17;35;14
15696.0;2022;14;RENNES;FEMININ;SCOLAIRE;BAC PROFESSIONNEL;BAC PRO SERV;BAC PRO 30001 GESTION-ADMINISTRATION;432;431;359;63;9;8;1;367;0;11;70;157;129;64
15697.0;2022;14;RENNES;FEMININ;SCOLAIRE;BAC PROFESSIONNEL;BAC PRO SERV;BAC PRO 31106 LOGISTIQUE;18;18;17;0;1;1;0;18;0;1;3;6;8;0
15698.0;2022;14;RENNES;FEMININ;SCOLAIRE;BAC PROFESSIONNEL;BAC PRO SERV;BAC PRO 31107 CONDUCT. TRANSP.ROUT.MARCHANDISES;11;11;11;0;0;0;0;11;0;1;3;5;2;0
15704.0;2022;14;RENNES;FEMININ;SCOLAIRE;BAC PROFESSIONNEL;BAC PRO SERV;BAC PRO 32208 REAL.PR.IMPR.PLURI.OPTB.PR.IMPR.;6;6;6;0;0;0;0;6;0;2;0;3;1;0
15717.0;2022;14;RENNES;FEMININ;SCOLAIRE;BAC TECHNOLOGIQUE;BAC S2TMD;BAC S2TMD MUSIQUE;5;5;5;0;0;0;0;5;0;2;0;1;2;0
15718.0;2022;14;RENNES;FEMININ;SCOLAIRE;BAC TECHNOLOGIQUE;BAC ST2S;BAC ST2S SCIENCES & TECHNO. SANTE & SOCIAL;907;907;811;13;83;65;18;876;0;22;117;342;395;31
15720.0;2022;14;RENNES;FEMININ;SCOLAIRE;BAC TECHNOLOGIQUE;BAC STD2A;BAC STD2A SCIENCES & TECHNO. DESIGN-ARTS APPLIQUES;123;123;122;0;1;0;1;122;1;15;49;44;13;1
15722.0;2022;14;RENNES;FEMININ;SCOLAIRE;BAC TECHNOLOGIQUE;BAC STI2D;BAC STI2D ARCHITECTURE ET CONSTRUCTION;49;49;46;1;2;1;1;47;0;2;7;27;11;2
15724.0;2022;14;RENNES;FEMININ;SCOLAIRE;BAC TECHNOLOGIQUE;BAC STI2D;BAC STI2D INNOVATION TECHNO.  ET ECO CONCEPTION;28;28;27;0;1;0;1;27;0;1;6;11;9;1
15733.0;2022;14;RENNES;MASCULIN;APPRENTISSAGE;BAC PROFESSIONNEL;BAC PRO PROD;BAC PRO 22105 BOULANGER-PÂTISSIER;3;3;1;2;0;0;0;1;0;0;0;1;0;2
15753.0;2022;14;RENNES;MASCULIN;APPRENTISSAGE;BAC PROFESSIONNEL;BAC PRO PROD;BAC PRO 25406 OUVRAGES DU BATIMENT METALLERIE;5;5;5;0;0;0;0;5;0;2;2;0;1;0
15759.0;2022;14;RENNES;MASCULIN;APPRENTISSAGE;BAC PROFESSIONNEL;BAC PRO PROD;BAC PRO AG 21001 AGRO-EQUIPEMENT;85;85;61;24;0;0;0;61;0;0;2;16;43;24
15769.0;2022;14;RENNES;MASCULIN;APPRENTISSAGE;BAC PROFESSIONNEL;BAC PRO SERV;BAC PRO 31106 LOGISTIQUE;30;30;19;11;0;0;0;19;0;0;6;4;9;11
15771.0;2022;14;RENNES;MASCULIN;APPRENTISSAGE;BAC PROFESSIONNEL;BAC PRO SERV;BAC PRO 31213 MET.COM.VEN.OP.A ANI.GES.ESP.COM.;122;118;85;24;9;2;7;87;0;4;20;27;36;31
15773.0;2022;14;RENNES;MASCULIN;APPRENTISSAGE;BAC PROFESSIONNEL;BAC PRO SERV;BAC PRO 33403 COMMERC. SERVICES EN RESTAURATION;22;22;13;8;1;1;0;14;0;1;0;5;8;8
15776.0;2022;14;RENNES;MASCULIN;ENSEIGNEMENT A DISTANCE;BAC GENERAL;BAC GENERAL;BAC GENE 10019 BAC GENERAL;29;29;20;6;3;2;1;22;1;2;5;4;10;7
15785.0;2022;14;RENNES;MASCULIN;FORMATION CONTINUE;BAC PROFESSIONNEL;BAC PRO PROD;BAC PRO 25219 MAINT.MATERIELS OPT.A AGRICOLES;1;0;0;0;0;0;0;0;0;0;0;0;0;0
15789.0;2022;14;RENNES;MASCULIN;FORMATION CONTINUE;BAC PROFESSIONNEL;BAC PRO SERV;BAC PRO 31213 MET.COM.VEN.OP.A ANI.GES.ESP.COM.;2;2;1;1;0;0;0;1;0;0;0;0;1;1
15790.0;2022;14;RENNES;MASCULIN;INDIVIDUEL;BAC GENERAL;BAC GENERAL;BAC GENE 10019 BAC GENERAL;71;47;29;10;8;7;1;36;1;2;10;10;13;11
15795.0;2022;14;RENNES;MASCULIN;INDIVIDUEL;BAC PROFESSIONNEL;BAC PRO PROD;BAC PRO 25009 MAINTENANCE NAUTIQUE;1;0;0;0;0;0;0;0;0;0;0;0;0;0
15801.0;2022;14;RENNES;MASCULIN;INDIVIDUEL;BAC PROFESSIONNEL;BAC PRO PROD;BAC PRO AG 21001 AGRO-EQUIPEMENT;1;1;1;0;0;0;0;1;0;0;0;0;1;0
15811.0;2022;14;RENNES;MASCULIN;INDIVIDUEL;BAC PROFESSIONNEL;BAC PRO SERV;BAC PRO 31108 TRANSPORT;1;1;0;1;0;0;0;0;0;0;0;0;0;1
15813.0;2022;14;RENNES;MASCULIN;INDIVIDUEL;BAC PROFESSIONNEL;BAC PRO SERV;BAC PRO 31214 MET.COM.VEN.OP.B PR.CL.VA.OF.COM.;3;1;1;0;0;0;0;1;0;0;0;0;1;0
15814.0;2022;14;RENNES;MASCULIN;INDIVIDUEL;BAC PROFESSIONNEL;BAC PRO SERV;BAC PRO 32303 ART.& MET.ART:COM.VIS.VIS.PLURI-M;1;0;0;0;0;0;0;0;0;0;0;0;0;0
15817.0;2022;14;RENNES;MASCULIN;INDIVIDUEL;BAC TECHNOLOGIQUE;BAC STI2D;BAC STI2D SYSTÈME D'INFORMATION  ET NUMERIQUE;1;1;0;0;1;1;0;1;0;0;0;0;1;0
15823.0;2022;14;RENNES;MASCULIN;SCOLAIRE;BAC PROFESSIONNEL;BAC PRO PROD;BACPRO 20002 ETUD.DEFINITION PRDTS INDUSTRIEL;14;14;9;5;0;0;0;9;0;0;1;2;6;5
15829.0;2022;14;RENNES;MASCULIN;SCOLAIRE;BAC PROFESSIONNEL;BAC PRO PROD;BAC PRO 22704 TECHN. MAINT. SYST.ENERG.CLIMATI;15;15;6;8;1;0;1;6;0;0;0;2;4;9
15831.0;2022;14;RENNES;MASCULIN;SCOLAIRE;BAC PROFESSIONNEL;BAC PRO PROD;BAC PRO 23004 TECHN. ETUDES BAT.A ETUDES & ECO.;71;71;54;17;0;0;0;54;0;5;5;26;18;17
15832.0;2022;14;RENNES;MASCULIN;SCOLAIRE;BAC PROFESSIONNEL;BAC PRO PROD;BAC PRO 23005 TECHN. ETUDES BAT B ASSIST.ARCHI.;43;43;38;4;1;1;0;39;0;0;11;13;15;4
15833.0;2022;14;RENNES;MASCULIN;SCOLAIRE;BAC PROFESSIONNEL;BAC PRO PROD;BAC PRO 23102 TRAVAUX PUBLICS;22;22;20;1;1;1;0;21;0;0;5;9;7;1
15842.0;2022;14;RENNES;MASCULIN;SCOLAIRE;BAC PROFESSIONNEL;BAC PRO PROD;BAC PRO 24203 METIERS DE LA MODE - VÊTEMENT;11;11;9;2;0;0;0;9;0;0;2;3;4;2
15844.0;2022;14;RENNES;MASCULIN;SCOLAIRE;BAC PROFESSIONNEL;BAC PRO PROD;BAC PRO 25006 MICROTECHNIQUES;32;32;29;3;0;0;0;29;0;2;6;12;9;3
15855.0;2022;14;RENNES;MASCULIN;SCOLAIRE;BAC PROFESSIONNEL;BAC PRO PROD;BAC PRO 25302 AERONAUTIQUE OPTION AVIONIQUE;14;14;14;0;0;0;0;14;0;1;7;2;4;0
15856.0;2022;14;RENNES;MASCULIN;SCOLAIRE;BAC PROFESSIONNEL;BAC PRO PROD;BAC PRO 25303 AERONAUTIQUE OPTION SYSTEMES;24;24;24;0;0;0;0;24;0;3;13;6;2;0
15862.0;2022;14;RENNES;MASCULIN;SCOLAIRE;BAC PROFESSIONNEL;BAC PRO PROD;BAC PRO 25510 METIERS ELECT. ENVIRON. CONNECTES;522;520;436;62;22;19;3;455;0;18;106;177;154;65
15869.0;2022;14;RENNES;MASCULIN;SCOLAIRE;BAC PROFESSIONNEL;BAC PRO PROD;BAC PRO AG 21203 TECHN CONSEIL DE VENTE ANIMAL;21;20;16;4;0;0;0;16;0;0;1;4;11;4
15871.0;2022;14;RENNES;MASCULIN;SCOLAIRE;BAC PROFESSIONNEL;BAC PRO PROD;BAC PRO AG 21210 COND GEST ENTR CANIN ET FELIN;12;12;11;1;0;0;0;11;0;0;2;5;4;1
15872.0;2022;14;RENNES;MASCULIN;SCOLAIRE;BAC PROFESSIONNEL;BAC PRO PROD;BAC PRO AG 21211 COND GEST ENTR HIPPIQUE;6;6;6;0;0;0;0;6;0;0;1;2;3;0
15880.0;2022;14;RENNES;MASCULIN;SCOLAIRE;BAC PROFESSIONNEL;BAC PRO SERV;BAC PRO 31106 LOGISTIQUE;106;106;90;11;5;4;1;94;0;4;20;37;33;12
15885.0;2022;14;RENNES;MASCULIN;SCOLAIRE;BAC PROFESSIONNEL;BAC PRO SERV;BAC PRO 31214 MET.COM.VEN.OP.B PR.CL.VA.OF.COM.;339;339;273;57;9;7;2;280;0;6;45;118;111;59
15896.0;2022;14;RENNES;MASCULIN;SCOLAIRE;BAC PROFESSIONNEL;BAC PRO SERV;BAC PRO 34304 HYGIENE PROPRETE STERILISATION;8;8;5;1;2;0;2;5;0;0;0;4;1;3
15899.0;2022;14;RENNES;MASCULIN;SCOLAIRE;BAC TECHNOLOGIQUE;BAC S2TMD;BAC S2TMD DANSE;1;1;1;0;0;0;0;1;0;0;1;0;0;0
15900.0;2022;14;RENNES;MASCULIN;SCOLAIRE;BAC TECHNOLOGIQUE;BAC S2TMD;BAC S2TMD MUSIQUE;7;7;7;0;0;0;0;7;0;1;1;3;2;0
15906.0;2022;14;RENNES;MASCULIN;SCOLAIRE;BAC TECHNOLOGIQUE;BAC STI2D;BAC STI2D ENERGIES  ET ENVIRONNEMENT;286;286;258;3;25;16;9;274;0;9;32;130;103;12
15913.0;2022;14;RENNES;MASCULIN;SCOLAIRE;BAC TECHNOLOGIQUE;BAC STMG;BAC STMG RESSOURCES HUMAINES ET COMMUNICATION;289;289;218;12;59;45;14;263;1;0;17;70;175;26
15918.0;2022;15;STRASBOURG;FEMININ;APPRENTISSAGE;BAC PROFESSIONNEL;BAC PRO PROD;BAC PRO 22704 TECHN. MAINT. SYST.ENERG.CLIMATI;1;1;1;0;0;0;0;1;0;1;0;0;0;0
15919.0;2022;15;STRASBOURG;FEMININ;APPRENTISSAGE;BAC PROFESSIONNEL;BAC PRO PROD;BAC PRO 23407 TECHNIC.FAB.BOIS ET MATERX ASSOC;2;2;2;0;0;0;0;2;0;0;2;0;0;0
15923.0;2022;15;STRASBOURG;FEMININ;APPRENTISSAGE;BAC PROFESSIONNEL;BAC PRO PROD;BAC PRO 25107 TECHNICIEN OUTILLEUR;1;1;1;0;0;0;0;1;0;0;0;1;0;0
15929.0;2022;15;STRASBOURG;FEMININ;APPRENTISSAGE;BAC PROFESSIONNEL;BAC PRO PROD;BAC PRO AG 21004 CGEA;2;1;1;0;0;0;0;1;0;0;0;0;1;0
15932.0;2022;15;STRASBOURG;FEMININ;APPRENTISSAGE;BAC PROFESSIONNEL;BAC PRO PROD;BAC PRO AG 21211 COND GEST ENTR HIPPIQUE;15;15;14;1;0;0;0;14;0;0;1;4;9;1
15936.0;2022;15;STRASBOURG;FEMININ;APPRENTISSAGE;BAC PROFESSIONNEL;BAC PRO SERV;BAC PRO 31106 LOGISTIQUE;2;2;1;1;0;0;0;1;0;0;0;0;1;1
15945.0;2022;15;STRASBOURG;FEMININ;ENSEIGNEMENT A DISTANCE;BAC PROFESSIONNEL;BAC PRO SERV;BAC PRO 31214 MET.COM.VEN.OP.B PR.CL.VA.OF.COM.;1;1;1;0;0;0;0;1;0;0;1;0;0;0
15954.0;2022;15;STRASBOURG;FEMININ;FORMATION CONTINUE;BAC PROFESSIONNEL;BAC PRO PROD;BAC PRO 25510 METIERS ELECT. ENVIRON. CONNECTES;1;1;1;0;0;0;0;1;0;0;1;0;0;0
15961.0;2022;15;STRASBOURG;FEMININ;INDIVIDUEL;BAC PROFESSIONNEL;BAC PRO PROD;BAC PRO AG 21114 CONDUITE PRODUCTIONS HORTICOLES;3;1;1;0;0;0;0;1;0;0;0;0;1;0
15967.0;2022;15;STRASBOURG;FEMININ;INDIVIDUEL;BAC PROFESSIONNEL;BAC PRO SERV;BAC PRO 33004 ACC.SOINS-S.PERS. OPT.EN STRUCTUR;6;4;2;2;0;0;0;2;0;0;0;0;2;2
15968.0;2022;15;STRASBOURG;FEMININ;INDIVIDUEL;BAC PROFESSIONNEL;BAC PRO SERV;BAC PRO 33102 PROTHESE DENTAIRE;1;0;0;0;0;0;0;0;0;0;0;0;0;0
15969.0;2022;15;STRASBOURG;FEMININ;INDIVIDUEL;BAC PROFESSIONNEL;BAC PRO SERV;BAC PRO 33403 COMMERC. SERVICES EN RESTAURATION;3;2;1;0;1;0;1;1;0;0;0;0;1;1
15974.0;2022;15;STRASBOURG;FEMININ;INDIVIDUEL;BAC TECHNOLOGIQUE;BAC STMG;BAC STMG GESTION ET FINANCE;3;0;0;0;0;0;0;0;0;0;0;0;0;0
15981.0;2022;15;STRASBOURG;FEMININ;SCOLAIRE;BAC PROFESSIONNEL;BAC PRO PROD;BAC PRO 22105 BOULANGER-PÂTISSIER;5;5;5;0;0;0;0;5;0;1;2;0;2;0
15988.0;2022;15;STRASBOURG;FEMININ;SCOLAIRE;BAC PROFESSIONNEL;BAC PRO PROD;BAC PRO 23407 TECHNIC.FAB.BOIS ET MATERX ASSOC;3;3;1;2;0;0;0;1;0;0;0;1;0;2
15989.0;2022;15;STRASBOURG;FEMININ;SCOLAIRE;BAC PROFESSIONNEL;BAC PRO PROD;BAC PRO 24203 METIERS DE LA MODE - VÊTEMENT;58;58;48;8;2;1;1;49;0;10;12;19;8;9
15994.0;2022;15;STRASBOURG;FEMININ;SCOLAIRE;BAC PROFESSIONNEL;BAC PRO PROD;BAC PRO 25215 MAINT.VEHIC.OPTB VEHIC.TRANS.ROUT;1;1;1;0;0;0;0;1;0;0;0;1;0;0
16000.0;2022;15;STRASBOURG;FEMININ;SCOLAIRE;BAC PROFESSIONNEL;BAC PRO PROD;BAC PRO 25515 SYST.NUM.OPT.C RES.INF.SYST.COMM.;3;3;3;0;0;0;0;3;0;0;1;1;1;0
16010.0;2022;15;STRASBOURG;FEMININ;SCOLAIRE;BAC PROFESSIONNEL;BAC PRO SERV;BAC PRO 31106 LOGISTIQUE;4;4;2;1;1;1;0;3;0;1;0;1;1;1
16011.0;2022;15;STRASBOURG;FEMININ;SCOLAIRE;BAC PROFESSIONNEL;BAC PRO SERV;BAC PRO 31107 CONDUCT. TRANSP.ROUT.MARCHANDISES;3;3;3;0;0;0;0;3;0;2;0;1;0;0
16012.0;2022;15;STRASBOURG;FEMININ;SCOLAIRE;BAC PROFESSIONNEL;BAC PRO SERV;BAC PRO 31108 TRANSPORT;3;3;2;1;0;0;0;2;0;0;1;0;1;1
16013.0;2022;15;STRASBOURG;FEMININ;SCOLAIRE;BAC PROFESSIONNEL;BAC PRO SERV;BAC PRO 31109 TRANSPORT FLUVIAL;1;1;1;0;0;0;0;1;0;0;1;0;0;0
16024.0;2022;15;STRASBOURG;FEMININ;SCOLAIRE;BAC PROFESSIONNEL;BAC PRO SERV;BAC PRO 33403 COMMERC. SERVICES EN RESTAURATION;40;40;34;5;1;1;0;35;0;3;7;13;12;5
16025.0;2022;15;STRASBOURG;FEMININ;SCOLAIRE;BAC PROFESSIONNEL;BAC PRO SERV;BAC PRO 33603 ESTHETIQUE COSMETIQUE PARFUMERIE;68;68;63;4;1;1;0;64;0;0;13;31;20;4
16026.0;2022;15;STRASBOURG;FEMININ;SCOLAIRE;BAC PROFESSIONNEL;BAC PRO SERV;BAC PRO 34304 HYGIENE PROPRETE STERILISATION;14;14;11;3;0;0;0;11;0;0;2;5;4;3
16030.0;2022;15;STRASBOURG;FEMININ;SCOLAIRE;BAC TECHNOLOGIQUE;BAC STAV;BAC STAV AGRONOMIE ALIM ENV TERRITOI;52;52;50;2;0;0;0;50;0;0;5;20;25;2
16031.0;2022;15;STRASBOURG;FEMININ;SCOLAIRE;BAC TECHNOLOGIQUE;BAC STD2A;BAC STD2A SCIENCES & TECHNO. DESIGN-ARTS APPLIQUES;76;76;76;0;0;0;0;76;1;12;29;26;8;0
16032.0;2022;15;STRASBOURG;FEMININ;SCOLAIRE;BAC TECHNOLOGIQUE;BAC STHR;BAC STHR SC.&TEC. HOTELLERIE-RESTAURATION;45;45;44;0;1;0;1;44;1;4;14;13;12;1
16036.0;2022;15;STRASBOURG;FEMININ;SCOLAIRE;BAC TECHNOLOGIQUE;BAC STI2D;BAC STI2D SYSTÈME D'INFORMATION  ET NUMERIQUE;15;15;14;1;0;0;0;14;0;0;5;6;3;1
16039.0;2022;15;STRASBOURG;FEMININ;SCOLAIRE;BAC TECHNOLOGIQUE;BAC STMG;BAC STMG GESTION ET FINANCE;176;176;152;1;23;13;10;165;1;10;47;46;61;11
16041.0;2022;15;STRASBOURG;FEMININ;SCOLAIRE;BAC TECHNOLOGIQUE;BAC STMG;BAC STMG RESSOURCES HUMAINES ET COMMUNICATION;342;342;273;22;47;27;20;300;0;1;40;94;165;42
16042.0;2022;15;STRASBOURG;FEMININ;SCOLAIRE;BAC TECHNOLOGIQUE;BAC STMG;BAC STMG SYSTEMES D'INFORMATION DE GESTION;20;20;16;0;4;3;1;19;0;0;3;6;10;1
16046.0;2022;15;STRASBOURG;MASCULIN;APPRENTISSAGE;BAC PROFESSIONNEL;BAC PRO PROD;BAC PRO 22403 ARTS.& MET.ART:MET.ENSEIGN SIGNA;2;2;2;0;0;0;0;2;0;0;0;2;0;0
16048.0;2022;15;STRASBOURG;MASCULIN;APPRENTISSAGE;BAC PROFESSIONNEL;BAC PRO PROD;BAC PRO 22704 TECHN. MAINT. SYST.ENERG.CLIMATI;7;7;5;1;1;0;1;5;0;0;0;2;3;2
16051.0;2022;15;STRASBOURG;MASCULIN;APPRENTISSAGE;BAC PROFESSIONNEL;BAC PRO PROD;BAC PRO 23404 TECHNICIEN CONSTRUCTEUR BOIS;7;7;6;1;0;0;0;6;0;0;0;4;2;1
16060.0;2022;15;STRASBOURG;MASCULIN;APPRENTISSAGE;BAC PROFESSIONNEL;BAC PRO PROD;BAC PRO 25216 MAINT.VEHIC.OPTC MOTOCYCLES;4;4;4;0;0;0;0;4;0;0;4;0;0;0
16063.0;2022;15;STRASBOURG;MASCULIN;APPRENTISSAGE;BAC PROFESSIONNEL;BAC PRO PROD;BAC PRO 25221 MAINT.MATERIELS OPT.C ESP. VERTS;6;6;3;3;0;0;0;3;0;1;0;1;1;3
16068.0;2022;15;STRASBOURG;MASCULIN;APPRENTISSAGE;BAC PROFESSIONNEL;BAC PRO PROD;BAC PRO 25509 TECHNIC. FROID CONDITIONNEMT AIR;14;14;12;2;0;0;0;12;0;0;5;4;3;2
16073.0;2022;15;STRASBOURG;MASCULIN;APPRENTISSAGE;BAC PROFESSIONNEL;BAC PRO PROD;BAC PRO AG 21004 CGEA;6;5;5;0;0;0;0;5;0;1;1;2;1;0
16080.0;2022;15;STRASBOURG;MASCULIN;APPRENTISSAGE;BAC PROFESSIONNEL;BAC PRO SERV;BAC PRO 30001 GESTION-ADMINISTRATION;1;1;1;0;0;0;0;1;0;0;0;0;1;0
16084.0;2022;15;STRASBOURG;MASCULIN;APPRENTISSAGE;BAC PROFESSIONNEL;BAC PRO SERV;BAC PRO 32208 REAL.PR.IMPR.PLURI.OPTB.PR.IMPR.;1;1;1;0;0;0;0;1;0;0;0;1;0;0
16087.0;2022;15;STRASBOURG;MASCULIN;ENSEIGNEMENT A DISTANCE;BAC PROFESSIONNEL;BAC PRO SERV;BAC PRO 31213 MET.COM.VEN.OP.A ANI.GES.ESP.COM.;2;1;1;0;0;0;0;1;0;0;0;1;0;0
16097.0;2022;15;STRASBOURG;MASCULIN;FORMATION CONTINUE;BAC PROFESSIONNEL;BAC PRO PROD;BAC PRO 25214 MAINT.VEHIC.OPTA VOIT.PARTICUL.;10;10;8;2;0;0;0;8;0;1;2;2;3;2
16100.0;2022;15;STRASBOURG;MASCULIN;FORMATION CONTINUE;BAC PROFESSIONNEL;BAC PRO PROD;BAC PRO 25510 METIERS ELECT. ENVIRON. CONNECTES;12;12;11;1;0;0;0;11;0;3;2;2;4;1
16105.0;2022;15;STRASBOURG;MASCULIN;INDIVIDUEL;BAC PROFESSIONNEL;BAC PRO PROD;BAC PRO 22704 TECHN. MAINT. SYST.ENERG.CLIMATI;1;0;0;0;0;0;0;0;0;0;0;0;0;0
16112.0;2022;15;STRASBOURG;MASCULIN;INDIVIDUEL;BAC PROFESSIONNEL;BAC PRO PROD;BAC PRO 25220 MAINT.MATERIELS OPT.B TP MANUT.;1;1;1;0;0;0;0;1;0;0;0;0;1;0
16113.0;2022;15;STRASBOURG;MASCULIN;INDIVIDUEL;BAC PROFESSIONNEL;BAC PRO PROD;BAC PRO 25408 REPARATION DES CARROSSERIES;1;1;0;0;1;1;0;1;0;0;0;0;1;0
16114.0;2022;15;STRASBOURG;MASCULIN;INDIVIDUEL;BAC PROFESSIONNEL;BAC PRO PROD;BAC PRO 25411 TECH.CHAUDRONNERIE INDUSTRIELLE;2;1;0;1;0;0;0;0;0;0;0;0;0;1
16116.0;2022;15;STRASBOURG;MASCULIN;INDIVIDUEL;BAC PROFESSIONNEL;BAC PRO PROD;BAC PRO AG 21113 CGEVV;2;1;1;0;0;0;0;1;0;0;0;0;1;0
16120.0;2022;15;STRASBOURG;MASCULIN;INDIVIDUEL;BAC PROFESSIONNEL;BAC PRO SERV;BAC PRO 31109 TRANSPORT FLUVIAL;1;0;0;0;0;0;0;0;0;0;0;0;0;0
16122.0;2022;15;STRASBOURG;MASCULIN;INDIVIDUEL;BAC PROFESSIONNEL;BAC PRO SERV;BAC PRO 31214 MET.COM.VEN.OP.B PR.CL.VA.OF.COM.;1;0;0;0;0;0;0;0;0;0;0;0;0;0
16125.0;2022;15;STRASBOURG;MASCULIN;INDIVIDUEL;BAC TECHNOLOGIQUE;BAC ST2S;BAC ST2S SCIENCES & TECHNO. SANTE & SOCIAL;1;0;0;0;0;0;0;0;0;0;0;0;0;0
16126.0;2022;15;STRASBOURG;MASCULIN;INDIVIDUEL;BAC TECHNOLOGIQUE;BAC STD2A;BAC STD2A SCIENCES & TECHNO. DESIGN-ARTS APPLIQUES;1;1;0;1;0;0;0;0;0;0;0;0;0;1
16127.0;2022;15;STRASBOURG;MASCULIN;INDIVIDUEL;BAC TECHNOLOGIQUE;BAC STI2D;BAC STI2D INNOVATION TECHNO.  ET ECO CONCEPTION;1;1;0;1;0;0;0;0;0;0;0;0;0;1
16154.0;2022;15;STRASBOURG;MASCULIN;SCOLAIRE;BAC PROFESSIONNEL;BAC PRO PROD;BAC PRO 25107 TECHNICIEN OUTILLEUR;8;8;6;2;0;0;0;6;0;0;3;3;0;2
16155.0;2022;15;STRASBOURG;MASCULIN;SCOLAIRE;BAC PROFESSIONNEL;BAC PRO PROD;BAC PRO 25214 MAINT.VEHIC.OPTA VOIT.PARTICUL.;99;99;69;18;12;9;3;78;0;4;15;24;35;21
16162.0;2022;15;STRASBOURG;MASCULIN;SCOLAIRE;BAC PROFESSIONNEL;BAC PRO PROD;BAC PRO 25411 TECH.CHAUDRONNERIE INDUSTRIELLE;70;70;52;14;4;4;0;56;0;5;12;15;24;14
16165.0;2022;15;STRASBOURG;MASCULIN;SCOLAIRE;BAC PROFESSIONNEL;BAC PRO PROD;BAC PRO 25513 SYST.NUM.OPT.A SURETE SECURITE;20;20;15;2;3;2;1;17;0;0;4;3;10;3
16177.0;2022;15;STRASBOURG;MASCULIN;SCOLAIRE;BAC PROFESSIONNEL;BAC PRO SERV;BAC PRO 31106 LOGISTIQUE;25;25;17;7;1;1;0;18;0;0;4;5;9;7
16181.0;2022;15;STRASBOURG;MASCULIN;SCOLAIRE;BAC PROFESSIONNEL;BAC PRO SERV;BAC PRO 31212 METIERS DE L'ACCUEIL;35;35;26;4;5;1;4;27;0;0;5;11;11;8
16183.0;2022;15;STRASBOURG;MASCULIN;SCOLAIRE;BAC PROFESSIONNEL;BAC PRO SERV;BAC PRO 31214 MET.COM.VEN.OP.B PR.CL.VA.OF.COM.;59;59;48;5;6;5;1;53;0;1;7;13;32;6
16199.0;2022;15;STRASBOURG;MASCULIN;SCOLAIRE;BAC TECHNOLOGIQUE;BAC STHR;BAC STHR SC.&TEC. HOTELLERIE-RESTAURATION;42;42;40;0;2;2;0;42;0;4;10;14;14;0
16214.0;2022;16;TOULOUSE;FEMININ;APPRENTISSAGE;BAC PROFESSIONNEL;BAC PRO PROD;BAC PRO 23005 TECHN. ETUDES BAT B ASSIST.ARCHI.;2;2;1;0;1;1;0;2;0;0;0;0;2;0
16215.0;2022;16;TOULOUSE;FEMININ;APPRENTISSAGE;BAC PROFESSIONNEL;BAC PRO PROD;BAC PRO 23304 AMENAGEMENT FINITION BATIMENT;1;1;1;0;0;0;0;1;0;1;0;0;0;0
16220.0;2022;16;TOULOUSE;FEMININ;APPRENTISSAGE;BAC PROFESSIONNEL;BAC PRO PROD;BAC PRO 25106 TECHNICIEN D'USINAGE;6;6;4;2;0;0;0;4;0;0;3;1;0;2
16229.0;2022;16;TOULOUSE;FEMININ;APPRENTISSAGE;BAC PROFESSIONNEL;BAC PRO PROD;BAC PRO 25510 METIERS ELECT. ENVIRON. CONNECTES;2;2;2;0;0;0;0;2;0;1;0;1;0;0
16233.0;2022;16;TOULOUSE;FEMININ;APPRENTISSAGE;BAC PROFESSIONNEL;BAC PRO PROD;BAC PRO AG 21405 AMENAGEMENTS PAYSAGERS;3;3;3;0;0;0;0;3;0;0;1;0;2;0
16234.0;2022;16;TOULOUSE;FEMININ;APPRENTISSAGE;BAC PROFESSIONNEL;BAC PRO PROD;BAC PRO AG 22107 TEC CONS VTE ALIMENTATION P.ALIM;7;7;5;2;0;0;0;5;0;0;1;0;4;2
16239.0;2022;16;TOULOUSE;FEMININ;APPRENTISSAGE;BAC PROFESSIONNEL;BAC PRO SERV;BAC PRO 31214 MET.COM.VEN.OP.B PR.CL.VA.OF.COM.;7;7;7;0;0;0;0;7;0;0;1;5;1;0
16241.0;2022;16;TOULOUSE;FEMININ;APPRENTISSAGE;BAC PROFESSIONNEL;BAC PRO SERV;BAC PRO 32208 REAL.PR.IMPR.PLURI.OPTB.PR.IMPR.;2;2;2;0;0;0;0;2;0;0;1;1;0;0
16242.0;2022;16;TOULOUSE;FEMININ;APPRENTISSAGE;BAC PROFESSIONNEL;BAC PRO SERV;BAC PRO 32303 ART.& MET.ART:COM.VIS.VIS.PLURI-M;1;1;1;0;0;0;0;1;0;0;1;0;0;0
16243.0;2022;16;TOULOUSE;FEMININ;APPRENTISSAGE;BAC PROFESSIONNEL;BAC PRO SERV;BAC PRO 32304 PHOTOGRAPHIE;1;1;1;0;0;0;0;1;0;0;0;0;1;0
16246.0;2022;16;TOULOUSE;FEMININ;APPRENTISSAGE;BAC PROFESSIONNEL;BAC PRO SERV;BAC PRO 33403 COMMERC. SERVICES EN RESTAURATION;6;6;6;0;0;0;0;6;0;0;1;2;3;0
16247.0;2022;16;TOULOUSE;FEMININ;APPRENTISSAGE;BAC PROFESSIONNEL;BAC PRO SERV;BAC PRO 33603 ESTHETIQUE COSMETIQUE PARFUMERIE;5;5;5;0;0;0;0;5;0;0;3;1;1;0
16250.0;2022;16;TOULOUSE;FEMININ;ENSEIGNEMENT A DISTANCE;BAC GENERAL;BAC GENERAL;BAC GENE 10019 BAC GENERAL;81;79;55;13;11;6;5;61;0;2;12;21;26;18
16253.0;2022;16;TOULOUSE;FEMININ;ENSEIGNEMENT A DISTANCE;BAC PROFESSIONNEL;BAC PRO SERV;BAC PRO 31214 MET.COM.VEN.OP.B PR.CL.VA.OF.COM.;3;2;2;0;0;0;0;2;0;0;0;1;1;0
16256.0;2022;16;TOULOUSE;FEMININ;ENSEIGNEMENT A DISTANCE;BAC TECHNOLOGIQUE;BAC ST2S;BAC ST2S SCIENCES & TECHNO. SANTE & SOCIAL;10;10;7;0;3;0;3;7;0;0;2;3;2;3
16259.0;2022;16;TOULOUSE;FEMININ;FORMATION CONTINUE;BAC PROFESSIONNEL;BAC PRO PROD;BAC PRO 23005 TECHN. ETUDES BAT B ASSIST.ARCHI.;5;5;5;0;0;0;0;5;0;1;1;0;3;0
16267.0;2022;16;TOULOUSE;FEMININ;INDIVIDUEL;BAC PROFESSIONNEL;BAC PRO PROD;BAC PRO 24203 METIERS DE LA MODE - VÊTEMENT;1;1;0;1;0;0;0;0;0;0;0;0;0;1
16277.0;2022;16;TOULOUSE;FEMININ;INDIVIDUEL;BAC PROFESSIONNEL;BAC PRO SERV;BAC PRO 33603 ESTHETIQUE COSMETIQUE PARFUMERIE;2;2;1;1;0;0;0;1;0;0;0;0;1;1
16283.0;2022;16;TOULOUSE;FEMININ;INDIVIDUEL;BAC TECHNOLOGIQUE;BAC STMG;BAC STMG GESTION ET FINANCE;4;3;1;2;0;0;0;1;0;0;0;0;1;2
16286.0;2022;16;TOULOUSE;FEMININ;SCOLAIRE;BAC GENERAL;BAC GENERAL;BAC GENE 10019 BAC GENERAL;8780;8780;8279;90;411;303;108;8582;190;1217;2333;2772;2070;198
16287.0;2022;16;TOULOUSE;FEMININ;SCOLAIRE;BAC PROFESSIONNEL;BAC PRO PROD;BACPRO 20002 ETUD.DEFINITION PRDTS INDUSTRIEL;1;1;0;1;0;0;0;0;0;0;0;0;0;1
16289.0;2022;16;TOULOUSE;FEMININ;SCOLAIRE;BAC PROFESSIONNEL;BAC PRO PROD;BAC PRO 22004 PROC. CHIMIE EAU PAPIERS-CARTONS;2;2;1;0;1;1;0;2;0;0;0;1;1;0
16290.0;2022;16;TOULOUSE;FEMININ;SCOLAIRE;BAC PROFESSIONNEL;BAC PRO PROD;BAC PRO 22105 BOULANGER-PÂTISSIER;34;34;32;2;0;0;0;32;0;2;14;15;1;2
16302.0;2022;16;TOULOUSE;FEMININ;SCOLAIRE;BAC PROFESSIONNEL;BAC PRO PROD;BAC PRO 24202 ARTIS.& MET.ART : TAPIS.D'AMEUBL;8;8;6;2;0;0;0;6;0;0;0;4;2;2
16305.0;2022;16;TOULOUSE;FEMININ;SCOLAIRE;BAC PROFESSIONNEL;BAC PRO PROD;BAC PRO 25007 MAINTENANCE EQUIPEMENTS INDUST.;9;9;8;1;0;0;0;8;0;1;0;4;3;1
16321.0;2022;16;TOULOUSE;FEMININ;SCOLAIRE;BAC PROFESSIONNEL;BAC PRO PROD;BAC PRO AG 21210 COND GEST ENTR CANIN ET FELIN;33;31;28;3;0;0;0;28;0;0;4;8;16;3
16332.0;2022;16;TOULOUSE;FEMININ;SCOLAIRE;BAC PROFESSIONNEL;BAC PRO SERV;BAC PRO 31108 TRANSPORT;7;7;3;4;0;0;0;3;0;1;0;0;2;4
16342.0;2022;16;TOULOUSE;FEMININ;SCOLAIRE;BAC PROFESSIONNEL;BAC PRO SERV;BAC PRO 33004 ACC.SOINS-S.PERS. OPT.EN STRUCTUR;551;549;493;31;25;15;10;508;0;21;108;228;151;41
16343.0;2022;16;TOULOUSE;FEMININ;SCOLAIRE;BAC PROFESSIONNEL;BAC PRO SERV;BAC PRO 33101 OPTIQUE LUNETTERIE;10;10;10;0;0;0;0;10;0;0;6;1;3;0
16345.0;2022;16;TOULOUSE;FEMININ;SCOLAIRE;BAC PROFESSIONNEL;BAC PRO SERV;BAC PRO 33103 TECHNICIEN APPAREIL. ORTHOPEDIQUE;7;7;7;0;0;0;0;7;0;0;2;4;1;0
16347.0;2022;16;TOULOUSE;FEMININ;SCOLAIRE;BAC PROFESSIONNEL;BAC PRO SERV;BAC PRO 33602 PERRUQUIER POSTICHEUR;5;5;5;0;0;0;0;5;0;0;3;0;2;0
16360.0;2022;16;TOULOUSE;FEMININ;SCOLAIRE;BAC TECHNOLOGIQUE;BAC STI2D;BAC STI2D ENERGIES  ET ENVIRONNEMENT;13;13;10;0;3;2;1;12;0;0;2;3;7;1
16372.0;2022;16;TOULOUSE;MASCULIN;APPRENTISSAGE;BAC PROFESSIONNEL;BAC PRO PROD;BAC PRO 22105 BOULANGER-PÂTISSIER;2;2;2;0;0;0;0;2;0;2;0;0;0;0
16373.0;2022;16;TOULOUSE;MASCULIN;APPRENTISSAGE;BAC PROFESSIONNEL;BAC PRO PROD;BAC PRO 22106 CUISINE;15;15;14;1;0;0;0;14;0;0;3;7;4;1
16375.0;2022;16;TOULOUSE;MASCULIN;APPRENTISSAGE;BAC PROFESSIONNEL;BAC PRO PROD;BAC PRO 22704 TECHN. MAINT. SYST.ENERG.CLIMATI;7;7;7;0;0;0;0;7;0;1;2;1;3;0
16388.0;2022;16;TOULOUSE;MASCULIN;APPRENTISSAGE;BAC PROFESSIONNEL;BAC PRO PROD;BAC PRO 23406 TECHNICIEN DE SCIERIE;1;1;1;0;0;0;0;1;0;1;0;0;0;0
16391.0;2022;16;TOULOUSE;MASCULIN;APPRENTISSAGE;BAC PROFESSIONNEL;BAC PRO PROD;BAC PRO 25106 TECHNICIEN D'USINAGE;36;36;29;6;1;0;1;29;0;4;11;10;4;7
16392.0;2022;16;TOULOUSE;MASCULIN;APPRENTISSAGE;BAC PROFESSIONNEL;BAC PRO PROD;BAC PRO 25214 MAINT.VEHIC.OPTA VOIT.PARTICUL.;127;126;89;22;15;13;2;102;0;5;20;32;45;24
16404.0;2022;16;TOULOUSE;MASCULIN;APPRENTISSAGE;BAC PROFESSIONNEL;BAC PRO PROD;BAC PRO 25509 TECHNIC. FROID CONDITIONNEMT AIR;26;24;20;4;0;0;0;20;0;4;5;4;7;4
16409.0;2022;16;TOULOUSE;MASCULIN;APPRENTISSAGE;BAC PROFESSIONNEL;BAC PRO PROD;BAC PRO AG 22107 TEC CONS VTE ALIMENTATION P.ALIM;7;7;6;1;0;0;0;6;0;0;1;1;4;1
16413.0;2022;16;TOULOUSE;MASCULIN;APPRENTISSAGE;BAC PROFESSIONNEL;BAC PRO SERV;BAC PRO 31214 MET.COM.VEN.OP.B PR.CL.VA.OF.COM.;4;4;4;0;0;0;0;4;0;0;1;1;2;0
16419.0;2022;16;TOULOUSE;MASCULIN;APPRENTISSAGE;BAC PROFESSIONNEL;BAC PRO SERV;BAC PRO 34304 HYGIENE PROPRETE STERILISATION;20;20;12;4;4;1;3;13;0;0;1;5;7;7
16421.0;2022;16;TOULOUSE;MASCULIN;ENSEIGNEMENT A DISTANCE;BAC GENERAL;BAC GENERAL;BAC GENE 10019 BAC GENERAL;30;27;22;4;1;1;0;23;0;0;7;7;9;4
16431.0;2022;16;TOULOUSE;MASCULIN;FORMATION CONTINUE;BAC PROFESSIONNEL;BAC PRO PROD;BAC PRO 23005 TECHN. ETUDES BAT B ASSIST.ARCHI.;7;7;5;2;0;0;0;5;0;2;0;1;2;2
16439.0;2022;16;TOULOUSE;MASCULIN;FORMATION CONTINUE;BAC PROFESSIONNEL;BAC PRO PROD;BAC PRO AG 21114 CONDUITE PRODUCTIONS HORTICOLES;2;2;2;0;0;0;0;2;0;0;0;1;1;0
16440.0;2022;16;TOULOUSE;MASCULIN;FORMATION CONTINUE;BAC PROFESSIONNEL;BAC PRO SERV;BAC PRO 31213 MET.COM.VEN.OP.A ANI.GES.ESP.COM.;4;3;3;0;0;0;0;3;0;0;2;1;0;0
16441.0;2022;16;TOULOUSE;MASCULIN;FORMATION CONTINUE;BAC PROFESSIONNEL;BAC PRO SERV;BAC PRO 31214 MET.COM.VEN.OP.B PR.CL.VA.OF.COM.;2;1;0;1;0;0;0;0;0;0;0;0;0;1
16445.0;2022;16;TOULOUSE;MASCULIN;INDIVIDUEL;BAC PROFESSIONNEL;BAC PRO PROD;BAC PRO 23005 TECHN. ETUDES BAT B ASSIST.ARCHI.;3;2;1;1;0;0;0;1;0;0;0;0;1;1
16451.0;2022;16;TOULOUSE;MASCULIN;INDIVIDUEL;BAC PROFESSIONNEL;BAC PRO PROD;BAC PRO 25408 REPARATION DES CARROSSERIES;1;1;0;1;0;0;0;0;0;0;0;0;0;1
16452.0;2022;16;TOULOUSE;MASCULIN;INDIVIDUEL;BAC PROFESSIONNEL;BAC PRO PROD;BAC PRO 25510 METIERS ELECT. ENVIRON. CONNECTES;1;1;0;1;0;0;0;0;0;0;0;0;0;1
16460.0;2022;16;TOULOUSE;MASCULIN;INDIVIDUEL;BAC PROFESSIONNEL;BAC PRO SERV;BAC PRO 31107 CONDUCT. TRANSP.ROUT.MARCHANDISES;1;1;1;0;0;0;0;1;0;0;0;0;1;0
16466.0;2022;16;TOULOUSE;MASCULIN;INDIVIDUEL;BAC TECHNOLOGIQUE;BAC STAV;BAC STAV AGRONOMIE ALIM ENV TERRITOI;1;1;1;0;0;0;0;1;0;0;0;0;1;0
16471.0;2022;16;TOULOUSE;MASCULIN;INDIVIDUEL;BAC TECHNOLOGIQUE;BAC STMG;BAC STMG MERCATIQUE (MARKETING);18;14;9;1;4;4;0;13;0;0;0;2;11;1
16474.0;2022;16;TOULOUSE;MASCULIN;SCOLAIRE;BAC PROFESSIONNEL;BAC PRO PROD;BACPRO 20002 ETUD.DEFINITION PRDTS INDUSTRIEL;19;19;8;11;0;0;0;8;0;1;1;3;3;11
16477.0;2022;16;TOULOUSE;MASCULIN;SCOLAIRE;BAC PROFESSIONNEL;BAC PRO PROD;BAC PRO 22104 BOUCHER CHARCUTIER TRAITEUR;9;9;8;1;0;0;0;8;0;0;1;4;3;1
16479.0;2022;16;TOULOUSE;MASCULIN;SCOLAIRE;BAC PROFESSIONNEL;BAC PRO PROD;BAC PRO 22106 CUISINE;166;166;138;22;6;4;2;142;0;9;37;47;49;24
16485.0;2022;16;TOULOUSE;MASCULIN;SCOLAIRE;BAC PROFESSIONNEL;BAC PRO PROD;BAC PRO 23003 ARTIS. & M.ART:MARCHANDISAGE VIS.;6;5;3;2;0;0;0;3;0;0;1;1;1;2
16493.0;2022;16;TOULOUSE;MASCULIN;SCOLAIRE;BAC PROFESSIONNEL;BAC PRO PROD;BAC PRO 23304 AMENAGEMENT FINITION BATIMENT;14;14;11;3;0;0;0;11;0;0;3;4;4;3
16497.0;2022;16;TOULOUSE;MASCULIN;SCOLAIRE;BAC PROFESSIONNEL;BAC PRO PROD;BAC PRO 23407 TECHNIC.FAB.BOIS ET MATERX ASSOC;15;15;13;2;0;0;0;13;0;1;3;5;4;2
16500.0;2022;16;TOULOUSE;MASCULIN;SCOLAIRE;BAC PROFESSIONNEL;BAC PRO PROD;BAC PRO 24203 METIERS DE LA MODE - VÊTEMENT;7;7;6;1;0;0;0;6;0;0;1;2;3;1
16504.0;2022;16;TOULOUSE;MASCULIN;SCOLAIRE;BAC PROFESSIONNEL;BAC PRO PROD;BAC PRO 25106 TECHNICIEN D'USINAGE;130;130;87;37;6;4;2;91;0;7;12;38;34;39
16508.0;2022;16;TOULOUSE;MASCULIN;SCOLAIRE;BAC PROFESSIONNEL;BAC PRO PROD;BAC PRO 25215 MAINT.VEHIC.OPTB VEHIC.TRANS.ROUT;19;19;14;1;4;2;2;16;0;0;0;5;11;3
16509.0;2022;16;TOULOUSE;MASCULIN;SCOLAIRE;BAC PROFESSIONNEL;BAC PRO PROD;BAC PRO 25216 MAINT.VEHIC.OPTC MOTOCYCLES;49;49;43;4;2;0;2;43;0;3;10;15;15;6
16520.0;2022;16;TOULOUSE;MASCULIN;SCOLAIRE;BAC PROFESSIONNEL;BAC PRO PROD;BAC PRO 25510 METIERS ELECT. ENVIRON. CONNECTES;478;475;337;97;41;30;11;367;0;12;65;113;177;108
16523.0;2022;16;TOULOUSE;MASCULIN;SCOLAIRE;BAC PROFESSIONNEL;BAC PRO PROD;BAC PRO 25515 SYST.NUM.OPT.C RES.INF.SYST.COMM.;170;170;153;12;5;4;1;157;0;12;32;70;43;13
16528.0;2022;16;TOULOUSE;MASCULIN;SCOLAIRE;BAC PROFESSIONNEL;BAC PRO PROD;BAC PRO AG 21203 TECHN CONSEIL DE VENTE ANIMAL;37;37;31;6;0;0;0;31;0;0;6;9;16;6
16531.0;2022;16;TOULOUSE;MASCULIN;SCOLAIRE;BAC PROFESSIONNEL;BAC PRO PROD;BAC PRO AG 21302 GEST MILIEUX NATURELS FAUNE;98;95;90;5;0;0;0;90;0;1;9;34;46;5
16535.0;2022;16;TOULOUSE;MASCULIN;SCOLAIRE;BAC PROFESSIONNEL;BAC PRO PROD;BAC PRO AG 22105 LABORATOIRE CONTROLE QUALITE;10;8;8;0;0;0;0;8;0;0;1;5;2;0
16538.0;2022;16;TOULOUSE;MASCULIN;SCOLAIRE;BAC PROFESSIONNEL;BAC PRO SERV;BAC PRO 31106 LOGISTIQUE;35;35;22;13;0;0;0;22;0;1;8;3;10;13
16540.0;2022;16;TOULOUSE;MASCULIN;SCOLAIRE;BAC PROFESSIONNEL;BAC PRO SERV;BAC PRO 31108 TRANSPORT;26;26;16;10;0;0;0;16;0;1;2;6;7;10
16547.0;2022;16;TOULOUSE;MASCULIN;SCOLAIRE;BAC PROFESSIONNEL;BAC PRO SERV;BAC PRO 32304 PHOTOGRAPHIE;8;8;5;3;0;0;0;5;0;1;3;0;1;3
16560.0;2022;16;TOULOUSE;MASCULIN;SCOLAIRE;BAC TECHNOLOGIQUE;BAC S2TMD;BAC S2TMD MUSIQUE;5;5;5;0;0;0;0;5;0;2;0;3;0;0
16563.0;2022;16;TOULOUSE;MASCULIN;SCOLAIRE;BAC TECHNOLOGIQUE;BAC STAV;BAC STAV AGRONOMIE ALIM ENV TERRITOI;215;215;211;4;0;0;0;211;0;5;25;94;87;4
16566.0;2022;16;TOULOUSE;MASCULIN;SCOLAIRE;BAC TECHNOLOGIQUE;BAC STI2D;BAC STI2D ARCHITECTURE ET CONSTRUCTION;228;228;201;8;19;14;5;215;0;4;29;84;98;13
16576.0;2022;25;VERSAILLES;FEMININ;APPRENTISSAGE;BAC PROFESSIONNEL;BAC PRO PROD;BAC PRO 22105 BOULANGER-PÂTISSIER;13;13;10;3;0;0;0;10;0;0;3;3;4;3
16578.0;2022;25;VERSAILLES;FEMININ;APPRENTISSAGE;BAC PROFESSIONNEL;BAC PRO PROD;BAC PRO 23003 ARTIS. & M.ART:MARCHANDISAGE VIS.;1;1;0;1;0;0;0;0;0;0;0;0;0;1
16584.0;2022;25;VERSAILLES;FEMININ;APPRENTISSAGE;BAC PROFESSIONNEL;BAC PRO PROD;BAC PRO 25216 MAINT.VEHIC.OPTC MOTOCYCLES;1;1;1;0;0;0;0;1;0;1;0;0;0;0
16586.0;2022;25;VERSAILLES;FEMININ;APPRENTISSAGE;BAC PROFESSIONNEL;BAC PRO PROD;BAC PRO 25304 AERONAUTIQUE OPTION STRUCTURE;2;2;2;0;0;0;0;2;0;0;1;1;0;0
16587.0;2022;25;VERSAILLES;FEMININ;APPRENTISSAGE;BAC PROFESSIONNEL;BAC PRO PROD;BAC PRO 25408 REPARATION DES CARROSSERIES;1;1;1;0;0;0;0;1;0;0;1;0;0;0
16589.0;2022;25;VERSAILLES;FEMININ;APPRENTISSAGE;BAC PROFESSIONNEL;BAC PRO PROD;BAC PRO AG 21203 TECHN CONSEIL DE VENTE ANIMAL;13;12;11;1;0;0;0;11;0;0;2;2;7;1
16592.0;2022;25;VERSAILLES;FEMININ;APPRENTISSAGE;BAC PROFESSIONNEL;BAC PRO SERV;BAC PRO 30001 GESTION-ADMINISTRATION;42;42;28;12;2;2;0;30;0;3;1;12;14;12
16607.0;2022;25;VERSAILLES;FEMININ;ENSEIGNEMENT A DISTANCE;BAC PROFESSIONNEL;BAC PRO SERV;BAC PRO 31214 MET.COM.VEN.OP.B PR.CL.VA.OF.COM.;2;1;1;0;0;0;0;1;0;0;0;1;0;0
16608.0;2022;25;VERSAILLES;FEMININ;ENSEIGNEMENT A DISTANCE;BAC PROFESSIONNEL;BAC PRO SERV;BAC PRO 33003 ACC.SOINS-S.PERS. OPT.A DOMICILE;1;1;0;1;0;0;0;0;0;0;0;0;0;1
16609.0;2022;25;VERSAILLES;FEMININ;ENSEIGNEMENT A DISTANCE;BAC PROFESSIONNEL;BAC PRO SERV;BAC PRO 33004 ACC.SOINS-S.PERS. OPT.EN STRUCTUR;9;7;3;4;0;0;0;3;0;0;0;1;2;4
16610.0;2022;25;VERSAILLES;FEMININ;ENSEIGNEMENT A DISTANCE;BAC PROFESSIONNEL;BAC PRO SERV;BAC PRO 33603 ESTHETIQUE COSMETIQUE PARFUMERIE;1;0;0;0;0;0;0;0;0;0;0;0;0;0
16611.0;2022;25;VERSAILLES;FEMININ;ENSEIGNEMENT A DISTANCE;BAC TECHNOLOGIQUE;BAC ST2S;BAC ST2S SCIENCES & TECHNO. SANTE & SOCIAL;9;9;7;2;0;0;0;7;0;0;2;1;4;2
16614.0;2022;25;VERSAILLES;FEMININ;ENSEIGNEMENT A DISTANCE;BAC TECHNOLOGIQUE;BAC STMG;BAC STMG RESSOURCES HUMAINES ET COMMUNICATION;5;5;4;0;1;1;0;5;0;0;0;0;5;0
16615.0;2022;25;VERSAILLES;FEMININ;ENSEIGNEMENT A DISTANCE;BAC TECHNOLOGIQUE;BAC STMG;BAC STMG SYSTEMES D'INFORMATION DE GESTION;1;1;0;1;0;0;0;0;0;0;0;0;0;1
16616.0;2022;25;VERSAILLES;FEMININ;FORMATION CONTINUE;BAC PROFESSIONNEL;BAC PRO PROD;BAC PRO 20102 PILOTE DE LIGNE DE PRODUCTION;1;1;1;0;0;0;0;1;0;0;1;0;0;0
16620.0;2022;25;VERSAILLES;FEMININ;FORMATION CONTINUE;BAC PROFESSIONNEL;BAC PRO PROD;BAC PRO 25510 METIERS ELECT. ENVIRON. CONNECTES;1;1;1;0;0;0;0;1;0;0;0;1;0;0
16625.0;2022;25;VERSAILLES;FEMININ;FORMATION CONTINUE;BAC PROFESSIONNEL;BAC PRO SERV;BAC PRO 34303 GEST. POLLUTIONS PROTEC. ENVIRON.;1;1;0;1;0;0;0;0;0;0;0;0;0;1
16636.0;2022;25;VERSAILLES;FEMININ;INDIVIDUEL;BAC PROFESSIONNEL;BAC PRO SERV;BAC PRO 31213 MET.COM.VEN.OP.A ANI.GES.ESP.COM.;10;9;4;5;0;0;0;4;0;0;0;0;4;5
16637.0;2022;25;VERSAILLES;FEMININ;INDIVIDUEL;BAC PROFESSIONNEL;BAC PRO SERV;BAC PRO 31214 MET.COM.VEN.OP.B PR.CL.VA.OF.COM.;2;1;0;1;0;0;0;0;0;0;0;0;0;1
16641.0;2022;25;VERSAILLES;FEMININ;INDIVIDUEL;BAC PROFESSIONNEL;BAC PRO SERV;BAC PRO 33004 ACC.SOINS-S.PERS. OPT.EN STRUCTUR;7;5;1;3;1;0;1;1;0;0;0;0;1;4
16644.0;2022;25;VERSAILLES;FEMININ;INDIVIDUEL;BAC PROFESSIONNEL;BAC PRO SERV;BAC PRO 33603 ESTHETIQUE COSMETIQUE PARFUMERIE;1;1;0;1;0;0;0;0;0;0;0;0;0;1
16656.0;2022;25;VERSAILLES;FEMININ;SCOLAIRE;BAC PROFESSIONNEL;BAC PRO PROD;BAC PRO 22106 CUISINE;70;69;59;5;5;2;3;61;0;4;14;26;17;8
16657.0;2022;25;VERSAILLES;FEMININ;SCOLAIRE;BAC PROFESSIONNEL;BAC PRO PROD;BAC PRO 23003 ARTIS. & M.ART:MARCHANDISAGE VIS.;52;52;45;4;3;3;0;48;0;2;12;16;18;4
16662.0;2022;25;VERSAILLES;FEMININ;SCOLAIRE;BAC PROFESSIONNEL;BAC PRO PROD;BAC PRO 23405 TECHNICIEN MENUISIER AGENCEUR;6;6;5;1;0;0;0;5;0;0;1;1;3;1
16666.0;2022;25;VERSAILLES;FEMININ;SCOLAIRE;BAC PROFESSIONNEL;BAC PRO PROD;BAC PRO 24302 METIERS DU CUIR : MAROQUINERIE;7;7;6;1;0;0;0;6;0;0;1;3;2;1
16675.0;2022;25;VERSAILLES;FEMININ;SCOLAIRE;BAC PROFESSIONNEL;BAC PRO PROD;BAC PRO 25305 AVIATION GENERALE;1;1;1;0;0;0;0;1;0;0;0;1;0;0
16679.0;2022;25;VERSAILLES;FEMININ;SCOLAIRE;BAC PROFESSIONNEL;BAC PRO PROD;BAC PRO 25510 METIERS ELECT. ENVIRON. CONNECTES;8;7;6;0;1;1;0;7;0;1;1;2;3;0
16682.0;2022;25;VERSAILLES;FEMININ;SCOLAIRE;BAC PROFESSIONNEL;BAC PRO PROD;BAC PRO 25515 SYST.NUM.OPT.C RES.INF.SYST.COMM.;9;9;9;0;0;0;0;9;0;0;3;4;2;0
16684.0;2022;25;VERSAILLES;FEMININ;SCOLAIRE;BAC PROFESSIONNEL;BAC PRO PROD;BAC PRO AG 21114 CONDUITE PRODUCTIONS HORTICOLES;9;8;8;0;0;0;0;8;0;0;1;2;5;0
16693.0;2022;25;VERSAILLES;FEMININ;SCOLAIRE;BAC PROFESSIONNEL;BAC PRO SERV;BAC PRO 31213 MET.COM.VEN.OP.A ANI.GES.ESP.COM.;826;824;672;112;40;27;13;699;0;22;146;280;251;125
16700.0;2022;25;VERSAILLES;FEMININ;SCOLAIRE;BAC PROFESSIONNEL;BAC PRO SERV;BAC PRO 33002 SERVICES DE PROXIMITE  VIE LOCAL;136;135;100;26;9;4;5;104;0;4;22;37;41;31
16702.0;2022;25;VERSAILLES;FEMININ;SCOLAIRE;BAC PROFESSIONNEL;BAC PRO SERV;BAC PRO 33004 ACC.SOINS-S.PERS. OPT.EN STRUCTUR;1172;1171;1022;101;48;30;18;1052;0;65;255;407;325;119
16703.0;2022;25;VERSAILLES;FEMININ;SCOLAIRE;BAC PROFESSIONNEL;BAC PRO SERV;BAC PRO 33101 OPTIQUE LUNETTERIE;16;16;15;1;0;0;0;15;0;1;1;4;9;1
16705.0;2022;25;VERSAILLES;FEMININ;SCOLAIRE;BAC PROFESSIONNEL;BAC PRO SERV;BAC PRO 33603 ESTHETIQUE COSMETIQUE PARFUMERIE;132;132;117;12;3;2;1;119;0;5;22;53;39;13
16706.0;2022;25;VERSAILLES;FEMININ;SCOLAIRE;BAC PROFESSIONNEL;BAC PRO SERV;BAC PRO 34304 HYGIENE PROPRETE STERILISATION;18;18;12;2;4;2;2;14;0;0;3;3;8;4
16709.0;2022;25;VERSAILLES;FEMININ;SCOLAIRE;BAC TECHNOLOGIQUE;BAC S2TMD;BAC S2TMD DANSE;2;2;2;0;0;0;0;2;0;0;2;0;0;0
16714.0;2022;25;VERSAILLES;FEMININ;SCOLAIRE;BAC TECHNOLOGIQUE;BAC STHR;BAC STHR SC.&TEC. HOTELLERIE-RESTAURATION;54;54;48;0;6;6;0;54;0;3;14;18;19;0
16719.0;2022;25;VERSAILLES;FEMININ;SCOLAIRE;BAC TECHNOLOGIQUE;BAC STL;BAC STL BIOCHIM.-BIOLOGIE-BIOTECHNOL.;232;232;186;14;32;13;19;199;1;16;48;61;73;33
16721.0;2022;25;VERSAILLES;FEMININ;SCOLAIRE;BAC TECHNOLOGIQUE;BAC STMG;BAC STMG GESTION ET FINANCE;711;711;619;22;70;47;23;666;0;32;136;245;253;45
16722.0;2022;25;VERSAILLES;FEMININ;SCOLAIRE;BAC TECHNOLOGIQUE;BAC STMG;BAC STMG MERCATIQUE (MARKETING);1756;1756;1564;45;147;105;42;1669;1;47;297;665;659;87
16723.0;2022;25;VERSAILLES;FEMININ;SCOLAIRE;BAC TECHNOLOGIQUE;BAC STMG;BAC STMG RESSOURCES HUMAINES ET COMMUNICATION;1465;1465;1151;90;224;140;84;1291;0;17;165;438;671;174
16738.0;2022;25;VERSAILLES;MASCULIN;APPRENTISSAGE;BAC PROFESSIONNEL;BAC PRO PROD;BAC PRO 25215 MAINT.VEHIC.OPTB VEHIC.TRANS.ROUT;63;62;54;3;5;3;2;57;0;6;11;18;22;5
16739.0;2022;25;VERSAILLES;MASCULIN;APPRENTISSAGE;BAC PROFESSIONNEL;BAC PRO PROD;BAC PRO 25216 MAINT.VEHIC.OPTC MOTOCYCLES;35;35;30;4;1;1;0;31;0;4;7;13;7;4
16740.0;2022;25;VERSAILLES;MASCULIN;APPRENTISSAGE;BAC PROFESSIONNEL;BAC PRO PROD;BAC PRO 25219 MAINT.MATERIELS OPT.A AGRICOLES;2;2;2;0;0;0;0;2;0;0;0;0;2;0
16749.0;2022;25;VERSAILLES;MASCULIN;APPRENTISSAGE;BAC PROFESSIONNEL;BAC PRO PROD;BAC PRO 25510 METIERS ELECT. ENVIRON. CONNECTES;196;193;144;37;12;3;9;147;0;14;34;52;47;46
16755.0;2022;25;VERSAILLES;MASCULIN;APPRENTISSAGE;BAC PROFESSIONNEL;BAC PRO PROD;BAC PRO AG 21405 AMENAGEMENTS PAYSAGERS;33;29;25;4;0;0;0;25;0;0;4;9;12;4
16756.0;2022;25;VERSAILLES;MASCULIN;APPRENTISSAGE;BAC PROFESSIONNEL;BAC PRO SERV;BAC PRO 30001 GESTION-ADMINISTRATION;8;7;4;2;1;1;0;5;0;0;0;1;4;2
16760.0;2022;25;VERSAILLES;MASCULIN;APPRENTISSAGE;BAC PROFESSIONNEL;BAC PRO SERV;BAC PRO 31109 TRANSPORT FLUVIAL;23;22;14;2;6;3;3;17;0;0;7;4;6;5
16774.0;2022;25;VERSAILLES;MASCULIN;ENSEIGNEMENT A DISTANCE;BAC TECHNOLOGIQUE;BAC STMG;BAC STMG GESTION ET FINANCE;8;8;5;2;1;1;0;6;0;0;0;2;4;2
16776.0;2022;25;VERSAILLES;MASCULIN;ENSEIGNEMENT A DISTANCE;BAC TECHNOLOGIQUE;BAC STMG;BAC STMG RESSOURCES HUMAINES ET COMMUNICATION;5;5;3;0;2;0;2;3;0;0;0;2;1;2
16784.0;2022;25;VERSAILLES;MASCULIN;FORMATION CONTINUE;BAC PROFESSIONNEL;BAC PRO PROD;BAC PRO 25510 METIERS ELECT. ENVIRON. CONNECTES;9;8;6;2;0;0;0;6;0;2;1;1;2;2
16786.0;2022;25;VERSAILLES;MASCULIN;FORMATION CONTINUE;BAC PROFESSIONNEL;BAC PRO SERV;BAC PRO 31212 METIERS DE L'ACCUEIL;3;2;2;0;0;0;0;2;0;0;1;1;0;0
16788.0;2022;25;VERSAILLES;MASCULIN;FORMATION CONTINUE;BAC PROFESSIONNEL;BAC PRO SERV;BAC PRO 33101 OPTIQUE LUNETTERIE;2;0;0;0;0;0;0;0;0;0;0;0;0;0
16793.0;2022;25;VERSAILLES;MASCULIN;INDIVIDUEL;BAC PROFESSIONNEL;BAC PRO PROD;BAC PRO 22105 BOULANGER-PÂTISSIER;1;1;0;1;0;0;0;0;0;0;0;0;0;1
16794.0;2022;25;VERSAILLES;MASCULIN;INDIVIDUEL;BAC PROFESSIONNEL;BAC PRO PROD;BAC PRO 22106 CUISINE;2;1;1;0;0;0;0;1;0;0;0;0;1;0
16800.0;2022;25;VERSAILLES;MASCULIN;INDIVIDUEL;BAC PROFESSIONNEL;BAC PRO PROD;BAC PRO 25006 MICROTECHNIQUES;1;1;0;1;0;0;0;0;0;0;0;0;0;1
16804.0;2022;25;VERSAILLES;MASCULIN;INDIVIDUEL;BAC PROFESSIONNEL;BAC PRO PROD;BAC PRO 25302 AERONAUTIQUE OPTION AVIONIQUE;1;1;0;0;1;1;0;1;0;0;0;0;1;0
16807.0;2022;25;VERSAILLES;MASCULIN;INDIVIDUEL;BAC PROFESSIONNEL;BAC PRO PROD;BAC PRO 25510 METIERS ELECT. ENVIRON. CONNECTES;13;10;8;2;0;0;0;8;0;0;0;2;6;2
16808.0;2022;25;VERSAILLES;MASCULIN;INDIVIDUEL;BAC PROFESSIONNEL;BAC PRO PROD;BAC PRO 25514 SYST.NUM.OPT.B AUD.RES.EQUIP.DOM.;1;1;1;0;0;0;0;1;0;0;0;0;1;0
16813.0;2022;25;VERSAILLES;MASCULIN;INDIVIDUEL;BAC PROFESSIONNEL;BAC PRO PROD;BAC PRO AG 21211 COND GEST ENTR HIPPIQUE;2;1;1;0;0;0;0;1;0;0;0;0;1;0
16817.0;2022;25;VERSAILLES;MASCULIN;INDIVIDUEL;BAC PROFESSIONNEL;BAC PRO SERV;BAC PRO 31106 LOGISTIQUE;3;3;1;2;0;0;0;1;0;0;1;0;0;2
16820.0;2022;25;VERSAILLES;MASCULIN;INDIVIDUEL;BAC PROFESSIONNEL;BAC PRO SERV;BAC PRO 31214 MET.COM.VEN.OP.B PR.CL.VA.OF.COM.;8;4;1;2;1;0;1;1;0;0;0;0;1;3
16821.0;2022;25;VERSAILLES;MASCULIN;INDIVIDUEL;BAC PROFESSIONNEL;BAC PRO SERV;BAC PRO 32207 REAL.PR.IMPR.PLURI.OPTA.PR.GRAPH.;1;0;0;0;0;0;0;0;0;0;0;0;0;0
16823.0;2022;25;VERSAILLES;MASCULIN;INDIVIDUEL;BAC PROFESSIONNEL;BAC PRO SERV;BAC PRO 32303 ART.& MET.ART:COM.VIS.VIS.PLURI-M;1;1;0;1;0;0;0;0;0;0;0;0;0;1
16828.0;2022;25;VERSAILLES;MASCULIN;INDIVIDUEL;BAC TECHNOLOGIQUE;BAC S2TMD;BAC S2TMD MUSIQUE;1;0;0;0;0;0;0;0;0;0;0;0;0;0
16833.0;2022;25;VERSAILLES;MASCULIN;INDIVIDUEL;BAC TECHNOLOGIQUE;BAC STI2D;BAC STI2D ENERGIES  ET ENVIRONNEMENT;12;6;2;2;2;0;2;2;0;0;0;0;2;4
16839.0;2022;25;VERSAILLES;MASCULIN;INDIVIDUEL;BAC TECHNOLOGIQUE;BAC STMG;BAC STMG MERCATIQUE (MARKETING);75;55;26;8;21;12;9;38;0;0;0;5;33;17
16844.0;2022;25;VERSAILLES;MASCULIN;SCOLAIRE;BAC PROFESSIONNEL;BAC PRO PROD;BAC PRO 20102 PILOTE DE LIGNE DE PRODUCTION;11;11;8;3;0;0;0;8;0;0;2;3;3;3
16845.0;2022;25;VERSAILLES;MASCULIN;SCOLAIRE;BAC PROFESSIONNEL;BAC PRO PROD;BAC PRO 22004 PROC. CHIMIE EAU PAPIERS-CARTONS;9;9;8;1;0;0;0;8;0;2;0;2;4;1
16852.0;2022;25;VERSAILLES;MASCULIN;SCOLAIRE;BAC PROFESSIONNEL;BAC PRO PROD;BAC PRO 23004 TECHN. ETUDES BAT.A ETUDES & ECO.;79;79;55;23;1;1;0;56;0;0;12;22;22;23
16862.0;2022;25;VERSAILLES;MASCULIN;SCOLAIRE;BAC PROFESSIONNEL;BAC PRO PROD;BAC PRO 24202 ARTIS.& MET.ART : TAPIS.D'AMEUBL;3;3;2;1;0;0;0;2;0;0;0;0;2;1
16875.0;2022;25;VERSAILLES;MASCULIN;SCOLAIRE;BAC PROFESSIONNEL;BAC PRO PROD;BAC PRO 25221 MAINT.MATERIELS OPT.C ESP. VERTS;3;3;2;0;1;1;0;3;0;0;0;1;2;0
16881.0;2022;25;VERSAILLES;MASCULIN;SCOLAIRE;BAC PROFESSIONNEL;BAC PRO PROD;BAC PRO 25410 CONSTRUCTION DES CARROSSERIES;12;12;11;1;0;0;0;11;0;0;3;6;2;1
16882.0;2022;25;VERSAILLES;MASCULIN;SCOLAIRE;BAC PROFESSIONNEL;BAC PRO PROD;BAC PRO 25411 TECH.CHAUDRONNERIE INDUSTRIELLE;59;59;33;23;3;2;1;35;0;3;7;9;16;24
16883.0;2022;25;VERSAILLES;MASCULIN;SCOLAIRE;BAC PROFESSIONNEL;BAC PRO PROD;BAC PRO 25509 TECHNIC. FROID CONDITIONNEMT AIR;100;100;56;39;5;5;0;61;0;2;9;25;25;39
16888.0;2022;25;VERSAILLES;MASCULIN;SCOLAIRE;BAC PROFESSIONNEL;BAC PRO PROD;BAC PRO AG 21004 CGEA;6;6;5;1;0;0;0;5;0;1;2;1;1;1
16890.0;2022;25;VERSAILLES;MASCULIN;SCOLAIRE;BAC PROFESSIONNEL;BAC PRO PROD;BAC PRO AG 21203 TECHN CONSEIL DE VENTE ANIMAL;12;12;9;3;0;0;0;9;0;0;2;4;3;3
16892.0;2022;25;VERSAILLES;MASCULIN;SCOLAIRE;BAC PROFESSIONNEL;BAC PRO PROD;BAC PRO AG 21303 FORET;3;3;3;0;0;0;0;3;0;0;1;1;1;0
16901.0;2022;25;VERSAILLES;MASCULIN;SCOLAIRE;BAC PROFESSIONNEL;BAC PRO SERV;BAC PRO 32206 FACONNAGE PRODTS IMPRIMES ROUTAGE;5;5;2;3;0;0;0;2;0;0;0;1;1;3
16902.0;2022;25;VERSAILLES;MASCULIN;SCOLAIRE;BAC PROFESSIONNEL;BAC PRO SERV;BAC PRO 32207 REAL.PR.IMPR.PLURI.OPTA.PR.GRAPH.;58;57;50;7;0;0;0;50;0;3;15;20;12;7
16903.0;2022;25;VERSAILLES;MASCULIN;SCOLAIRE;BAC PROFESSIONNEL;BAC PRO SERV;BAC PRO 32208 REAL.PR.IMPR.PLURI.OPTB.PR.IMPR.;16;16;14;2;0;0;0;14;0;3;3;5;3;2
16904.0;2022;25;VERSAILLES;MASCULIN;SCOLAIRE;BAC PROFESSIONNEL;BAC PRO SERV;BAC PRO 32303 ART.& MET.ART:COM.VIS.VIS.PLURI-M;55;55;49;6;0;0;0;49;0;2;9;16;22;6
16906.0;2022;25;VERSAILLES;MASCULIN;SCOLAIRE;BAC PROFESSIONNEL;BAC PRO SERV;BAC PRO 33002 SERVICES DE PROXIMITE  VIE LOCAL;105;104;86;16;2;1;1;87;0;4;13;28;42;17
16907.0;2022;25;VERSAILLES;MASCULIN;SCOLAIRE;BAC PROFESSIONNEL;BAC PRO SERV;BAC PRO 33003 ACC.SOINS-S.PERS. OPT.A DOMICILE;2;2;2;0;0;0;0;2;0;0;0;0;2;0
16915.0;2022;25;VERSAILLES;MASCULIN;SCOLAIRE;BAC TECHNOLOGIQUE;BAC S2TMD;BAC S2TMD MUSIQUE;3;3;3;0;0;0;0;3;0;0;1;1;1;0
16917.0;2022;25;VERSAILLES;MASCULIN;SCOLAIRE;BAC TECHNOLOGIQUE;BAC STAV;BAC STAV AGRONOMIE ALIM ENV TERRITOI;37;37;37;0;0;0;0;37;0;0;4;11;22;0
16923.0;2022;25;VERSAILLES;MASCULIN;SCOLAIRE;BAC TECHNOLOGIQUE;BAC STI2D;BAC STI2D SYSTÈME D'INFORMATION  ET NUMERIQUE;892;892;753;42;97;53;44;806;0;12;111;282;401;86
16930.0;2023;02;AIX-MARSEILLE;FEMININ;APPRENTISSAGE;BAC PROFESSIONNEL;BAC PRO PROD;BAC PRO 22106 CUISINE;18;17;14;2;1;1;0;15;0;0;1;4;10;2
16933.0;2023;02;AIX-MARSEILLE;FEMININ;APPRENTISSAGE;BAC PROFESSIONNEL;BAC PRO PROD;BAC PRO 23405 TECHNICIEN MENUISIER AGENCEUR;3;3;3;0;0;0;0;3;0;1;1;1;0;0
16936.0;2023;02;AIX-MARSEILLE;FEMININ;APPRENTISSAGE;BAC PROFESSIONNEL;BAC PRO PROD;BAC PRO 25303 AERONAUTIQUE OPTION SYSTEMES;1;1;1;0;0;0;0;1;0;0;1;0;0;0
16937.0;2023;02;AIX-MARSEILLE;FEMININ;APPRENTISSAGE;BAC PROFESSIONNEL;BAC PRO PROD;BAC PRO 25406 OUVRAGES DU BATIMENT METALLERIE;1;1;0;1;0;0;0;0;0;0;0;0;0;1
16938.0;2023;02;AIX-MARSEILLE;FEMININ;APPRENTISSAGE;BAC PROFESSIONNEL;BAC PRO PROD;BAC PRO 25408 REPARATION DES CARROSSERIES;1;1;1;0;0;0;0;1;0;0;0;1;0;0
16951.0;2023;02;AIX-MARSEILLE;FEMININ;APPRENTISSAGE;BAC PROFESSIONNEL;BAC PRO SERV;BAC PRO 31213 MET.COM.VEN.OP.A ANI.GES.ESP.COM.;76;74;60;10;4;3;1;63;0;3;16;23;21;11
16953.0;2023;02;AIX-MARSEILLE;FEMININ;APPRENTISSAGE;BAC PROFESSIONNEL;BAC PRO SERV;BAC PRO 32303 ART.& MET.ART:COM.VIS.VIS.PLURI-M;1;1;1;0;0;0;0;1;0;0;0;0;1;0
16958.0;2023;02;AIX-MARSEILLE;FEMININ;APPRENTISSAGE;BAC PROFESSIONNEL;BAC PRO SERV;BAC PRO 33603 ESTHETIQUE COSMETIQUE PARFUMERIE;7;7;6;1;0;0;0;6;0;0;0;2;4;1
16966.0;2023;02;AIX-MARSEILLE;FEMININ;ENSEIGNEMENT A DISTANCE;BAC PROFESSIONNEL;BAC PRO SERV;BAC PRO 33101 OPTIQUE LUNETTERIE;1;1;1;0;0;0;0;1;0;0;0;0;1;0
16975.0;2023;02;AIX-MARSEILLE;FEMININ;FORMATION CONTINUE;BAC PROFESSIONNEL;BAC PRO PROD;BAC PRO 25515 SYST.NUM.OPT.C RES.INF.SYST.COMM.;1;1;1;0;0;0;0;1;0;0;0;1;0;0
16988.0;2023;02;AIX-MARSEILLE;FEMININ;INDIVIDUEL;BAC PROFESSIONNEL;BAC PRO PROD;BAC PRO AG 21004 CGEA;3;3;2;1;0;0;0;2;0;0;0;0;2;1
16991.0;2023;02;AIX-MARSEILLE;FEMININ;INDIVIDUEL;BAC PROFESSIONNEL;BAC PRO PROD;BAC PRO AG 21211 COND GEST ENTR HIPPIQUE;4;4;3;1;0;0;0;3;0;0;0;0;3;1
16994.0;2023;02;AIX-MARSEILLE;FEMININ;INDIVIDUEL;BAC PROFESSIONNEL;BAC PRO SERV;BAC PRO 31213 MET.COM.VEN.OP.A ANI.GES.ESP.COM.;3;2;1;1;0;0;0;1;0;0;0;0;1;1
17008.0;2023;02;AIX-MARSEILLE;FEMININ;INDIVIDUEL;BAC TECHNOLOGIQUE;BAC STMG;BAC STMG MERCATIQUE (MARKETING);17;17;9;6;2;1;1;10;0;1;1;3;5;7
17020.0;2023;02;AIX-MARSEILLE;FEMININ;SCOLAIRE;BAC PROFESSIONNEL;BAC PRO PROD;BAC PRO 23102 TRAVAUX PUBLICS;1;1;1;0;0;0;0;1;0;0;1;0;0;0
17027.0;2023;02;AIX-MARSEILLE;FEMININ;SCOLAIRE;BAC PROFESSIONNEL;BAC PRO PROD;BAC PRO 25007 MAINTENANCE EQUIPEMENTS INDUST.;5;5;5;0;0;0;0;5;0;0;2;0;3;0
17039.0;2023;02;AIX-MARSEILLE;FEMININ;SCOLAIRE;BAC PROFESSIONNEL;BAC PRO PROD;BAC PRO AG 21004 CGEA;30;29;25;4;0;0;0;25;0;3;2;7;13;4
17041.0;2023;02;AIX-MARSEILLE;FEMININ;SCOLAIRE;BAC PROFESSIONNEL;BAC PRO PROD;BAC PRO AG 21114 CONDUITE PRODUCTIONS HORTICOLES;2;2;2;0;0;0;0;2;0;0;0;0;2;0
17046.0;2023;02;AIX-MARSEILLE;FEMININ;SCOLAIRE;BAC PROFESSIONNEL;BAC PRO PROD;BAC PRO AG 21303 FORET;2;2;2;0;0;0;0;2;0;0;0;0;2;0
17047.0;2023;02;AIX-MARSEILLE;FEMININ;SCOLAIRE;BAC PROFESSIONNEL;BAC PRO PROD;BAC PRO AG 21405 AMENAGEMENTS PAYSAGERS;14;14;13;1;0;0;0;13;0;0;2;1;10;1
17048.0;2023;02;AIX-MARSEILLE;FEMININ;SCOLAIRE;BAC PROFESSIONNEL;BAC PRO PROD;BAC PRO AG 22105 LABORATOIRE CONTROLE QUALITE;3;3;2;1;0;0;0;2;0;0;0;0;2;1
17052.0;2023;02;AIX-MARSEILLE;FEMININ;SCOLAIRE;BAC PROFESSIONNEL;BAC PRO SERV;BAC PRO 31107 CONDUCT. TRANSP.ROUT.MARCHANDISES;1;1;1;0;0;0;0;1;0;0;0;1;0;0
17057.0;2023;02;AIX-MARSEILLE;FEMININ;SCOLAIRE;BAC PROFESSIONNEL;BAC PRO SERV;BAC PRO 32207 REAL.PR.IMPR.PLURI.OPTA.PR.GRAPH.;5;5;5;0;0;0;0;5;0;2;1;2;0;0
17065.0;2023;02;AIX-MARSEILLE;FEMININ;SCOLAIRE;BAC PROFESSIONNEL;BAC PRO SERV;BAC PRO 33103 TECHNICIEN APPAREIL. ORTHOPEDIQUE;12;12;10;0;2;1;1;11;0;0;1;2;8;1
17067.0;2023;02;AIX-MARSEILLE;FEMININ;SCOLAIRE;BAC PROFESSIONNEL;BAC PRO SERV;BAC PRO 33403 COMMERC. SERVICES EN RESTAURATION;35;35;27;6;2;1;1;28;0;0;2;12;14;7
17073.0;2023;02;AIX-MARSEILLE;FEMININ;SCOLAIRE;BAC TECHNOLOGIQUE;BAC ST2S;BAC ST2S SCIENCES & TECHNO. SANTE & SOCIAL;776;776;631;29;116;70;46;701;1;19;79;237;365;75
17078.0;2023;02;AIX-MARSEILLE;FEMININ;SCOLAIRE;BAC TECHNOLOGIQUE;BAC STI2D;BAC STI2D ENERGIES  ET ENVIRONNEMENT;11;11;7;1;3;2;1;9;0;0;1;3;5;2
17084.0;2023;02;AIX-MARSEILLE;FEMININ;SCOLAIRE;BAC TECHNOLOGIQUE;BAC STMG;BAC STMG MERCATIQUE (MARKETING);894;894;725;34;135;97;38;822;0;13;92;276;441;72
17087.0;2023;02;AIX-MARSEILLE;MASCULIN;APPRENTISSAGE;BAC PROFESSIONNEL;BAC PRO PROD;BAC PRO 20102 PILOTE DE LIGNE DE PRODUCTION;1;1;1;0;0;0;0;1;0;0;0;1;0;0
17092.0;2023;02;AIX-MARSEILLE;MASCULIN;APPRENTISSAGE;BAC PROFESSIONNEL;BAC PRO PROD;BAC PRO 22703 TECHN.INSTALL.SYST.ENERG.CLIMATI;34;32;27;2;3;2;1;29;0;2;5;4;18;3
17096.0;2023;02;AIX-MARSEILLE;MASCULIN;APPRENTISSAGE;BAC PROFESSIONNEL;BAC PRO PROD;BAC PRO 23203 TECHNICIEN BAT. : ORG.REAL.GROS O;10;10;10;0;0;0;0;10;0;1;5;2;2;0
17098.0;2023;02;AIX-MARSEILLE;MASCULIN;APPRENTISSAGE;BAC PROFESSIONNEL;BAC PRO PROD;BAC PRO 23404 TECHNICIEN CONSTRUCTEUR BOIS;8;8;6;2;0;0;0;6;0;0;0;4;2;2
17099.0;2023;02;AIX-MARSEILLE;MASCULIN;APPRENTISSAGE;BAC PROFESSIONNEL;BAC PRO PROD;BAC PRO 23405 TECHNICIEN MENUISIER AGENCEUR;2;2;1;1;0;0;0;1;0;0;0;1;0;1
17103.0;2023;02;AIX-MARSEILLE;MASCULIN;APPRENTISSAGE;BAC PROFESSIONNEL;BAC PRO PROD;BAC PRO 25106 TECHNICIEN D'USINAGE;13;13;12;1;0;0;0;12;0;2;5;3;2;1
17109.0;2023;02;AIX-MARSEILLE;MASCULIN;APPRENTISSAGE;BAC PROFESSIONNEL;BAC PRO PROD;BAC PRO 25406 OUVRAGES DU BATIMENT METALLERIE;4;4;4;0;0;0;0;4;0;1;0;1;2;0
17113.0;2023;02;AIX-MARSEILLE;MASCULIN;APPRENTISSAGE;BAC PROFESSIONNEL;BAC PRO PROD;BAC PRO 25510 METIERS ELECT. ENVIRON. CONNECTES;82;81;56;18;7;5;2;61;0;5;8;17;31;20
17114.0;2023;02;AIX-MARSEILLE;MASCULIN;APPRENTISSAGE;BAC PROFESSIONNEL;BAC PRO PROD;BAC PRO 25513 SYST.NUM.OPT.A SURETE SECURITE;3;3;3;0;0;0;0;3;0;0;0;2;1;0
17115.0;2023;02;AIX-MARSEILLE;MASCULIN;APPRENTISSAGE;BAC PROFESSIONNEL;BAC PRO PROD;BAC PRO 25515 SYST.NUM.OPT.C RES.INF.SYST.COMM.;2;2;1;1;0;0;0;1;0;0;0;1;0;1
17119.0;2023;02;AIX-MARSEILLE;MASCULIN;APPRENTISSAGE;BAC PROFESSIONNEL;BAC PRO PROD;BAC PRO AG 21203 TECHN CONSEIL DE VENTE ANIMAL;1;1;1;0;0;0;0;1;0;0;1;0;0;0
17125.0;2023;02;AIX-MARSEILLE;MASCULIN;APPRENTISSAGE;BAC PROFESSIONNEL;BAC PRO SERV;BAC PRO 30004 ASSISTANC.GEST.ORGANIS.ACTIVITES;3;3;2;1;0;0;0;2;0;0;0;2;0;1
17126.0;2023;02;AIX-MARSEILLE;MASCULIN;APPRENTISSAGE;BAC PROFESSIONNEL;BAC PRO SERV;BAC PRO 31106 LOGISTIQUE;18;18;11;4;3;2;1;13;0;0;2;3;8;5
17134.0;2023;02;AIX-MARSEILLE;MASCULIN;APPRENTISSAGE;BAC PROFESSIONNEL;BAC PRO SERV;BAC PRO 33403 COMMERC. SERVICES EN RESTAURATION;14;13;9;4;0;0;0;9;0;0;3;3;3;4
17149.0;2023;02;AIX-MARSEILLE;MASCULIN;FORMATION CONTINUE;BAC PROFESSIONNEL;BAC PRO PROD;BAC PRO 22106 CUISINE;2;1;0;1;0;0;0;0;0;0;0;0;0;1
17158.0;2023;02;AIX-MARSEILLE;MASCULIN;FORMATION CONTINUE;BAC PROFESSIONNEL;BAC PRO SERV;BAC PRO 31213 MET.COM.VEN.OP.A ANI.GES.ESP.COM.;4;4;2;0;2;1;1;3;0;0;0;1;2;1
17160.0;2023;02;AIX-MARSEILLE;MASCULIN;FORMATION CONTINUE;BAC PROFESSIONNEL;BAC PRO SERV;BAC PRO 33104 TECHNICIEN EN PROTHESE DENTAIRE;1;1;1;0;0;0;0;1;0;0;0;0;1;0
17162.0;2023;02;AIX-MARSEILLE;MASCULIN;INDIVIDUEL;BAC PROFESSIONNEL;BAC PRO PROD;BAC PRO 22106 CUISINE;1;0;0;0;0;0;0;0;0;0;0;0;0;0
17166.0;2023;02;AIX-MARSEILLE;MASCULIN;INDIVIDUEL;BAC PROFESSIONNEL;BAC PRO PROD;BAC PRO 23303 MENUISERIE ALUMINIUM-VERRE;1;0;0;0;0;0;0;0;0;0;0;0;0;0
17170.0;2023;02;AIX-MARSEILLE;MASCULIN;INDIVIDUEL;BAC PROFESSIONNEL;BAC PRO PROD;BAC PRO 25214 MAINT.VEHIC.OPTA VOIT.PARTICUL.;3;1;1;0;0;0;0;1;0;0;0;0;1;0
17174.0;2023;02;AIX-MARSEILLE;MASCULIN;INDIVIDUEL;BAC PROFESSIONNEL;BAC PRO PROD;BAC PRO 25411 TECH.CHAUDRONNERIE INDUSTRIELLE;1;0;0;0;0;0;0;0;0;0;0;0;0;0
17177.0;2023;02;AIX-MARSEILLE;MASCULIN;INDIVIDUEL;BAC PROFESSIONNEL;BAC PRO PROD;BAC PRO 25514 SYST.NUM.OPT.B AUD.RES.EQUIP.DOM.;1;1;1;0;0;0;0;1;0;0;0;0;1;0
17178.0;2023;02;AIX-MARSEILLE;MASCULIN;INDIVIDUEL;BAC PROFESSIONNEL;BAC PRO PROD;BAC PRO 25515 SYST.NUM.OPT.C RES.INF.SYST.COMM.;1;1;1;0;0;0;0;1;0;0;0;0;1;0
17184.0;2023;02;AIX-MARSEILLE;MASCULIN;INDIVIDUEL;BAC PROFESSIONNEL;BAC PRO SERV;BAC PRO 31106 LOGISTIQUE;2;2;2;0;0;0;0;2;0;1;0;0;1;0
17192.0;2023;02;AIX-MARSEILLE;MASCULIN;INDIVIDUEL;BAC TECHNOLOGIQUE;BAC STI2D;BAC STI2D ENERGIES  ET ENVIRONNEMENT;1;1;0;1;0;0;0;0;0;0;0;0;0;1
17193.0;2023;02;AIX-MARSEILLE;MASCULIN;INDIVIDUEL;BAC TECHNOLOGIQUE;BAC STI2D;BAC STI2D INNOVATION TECHNO.  ET ECO CONCEPTION;2;2;0;2;0;0;0;0;0;0;0;0;0;2
17195.0;2023;02;AIX-MARSEILLE;MASCULIN;INDIVIDUEL;BAC TECHNOLOGIQUE;BAC STL;BAC STL BIOCHIM.-BIOLOGIE-BIOTECHNOL.;1;1;0;0;1;1;0;1;0;0;0;0;1;0
17205.0;2023;02;AIX-MARSEILLE;MASCULIN;SCOLAIRE;BAC PROFESSIONNEL;BAC PRO PROD;BAC PRO 22105 BOULANGER-PÂTISSIER;7;7;5;2;0;0;0;5;0;0;2;1;2;2
17215.0;2023;02;AIX-MARSEILLE;MASCULIN;SCOLAIRE;BAC PROFESSIONNEL;BAC PRO PROD;BAC PRO 23203 TECHNICIEN BAT. : ORG.REAL.GROS O;24;24;13;10;1;1;0;14;0;0;3;6;5;10
17216.0;2023;02;AIX-MARSEILLE;MASCULIN;SCOLAIRE;BAC PROFESSIONNEL;BAC PRO PROD;BAC PRO 23205 INTERV. SUR PATRIMOINE BATI OPT.A;3;3;3;0;0;0;0;3;0;0;1;2;0;0
17226.0;2023;02;AIX-MARSEILLE;MASCULIN;SCOLAIRE;BAC PROFESSIONNEL;BAC PRO PROD;BAC PRO 25106 TECHNICIEN D'USINAGE;22;22;13;7;2;1;1;14;0;0;3;3;8;8
17228.0;2023;02;AIX-MARSEILLE;MASCULIN;SCOLAIRE;BAC PROFESSIONNEL;BAC PRO PROD;BAC PRO 25214 MAINT.VEHIC.OPTA VOIT.PARTICUL.;113;113;84;25;4;4;0;88;0;6;18;27;37;25
17229.0;2023;02;AIX-MARSEILLE;MASCULIN;SCOLAIRE;BAC PROFESSIONNEL;BAC PRO PROD;BAC PRO 25215 MAINT.VEHIC.OPTB VEHIC.TRANS.ROUT;27;27;18;6;3;3;0;21;0;0;6;7;8;6
17230.0;2023;02;AIX-MARSEILLE;MASCULIN;SCOLAIRE;BAC PROFESSIONNEL;BAC PRO PROD;BAC PRO 25216 MAINT.VEHIC.OPTC MOTOCYCLES;28;28;16;12;0;0;0;16;0;1;3;8;4;12
17241.0;2023;02;AIX-MARSEILLE;MASCULIN;SCOLAIRE;BAC PROFESSIONNEL;BAC PRO PROD;BAC PRO 25510 METIERS ELECT. ENVIRON. CONNECTES;460;460;345;85;30;25;5;370;0;11;54;140;165;90
17245.0;2023;02;AIX-MARSEILLE;MASCULIN;SCOLAIRE;BAC PROFESSIONNEL;BAC PRO PROD;BAC PRO AG 21001 AGRO-EQUIPEMENT;8;8;7;1;0;0;0;7;0;0;2;1;4;1
17256.0;2023;02;AIX-MARSEILLE;MASCULIN;SCOLAIRE;BAC PROFESSIONNEL;BAC PRO PROD;BAC PRO AG 22108 TEC CONS VTE ALIMENTATION (PAB);22;22;19;3;0;0;0;19;0;1;0;5;13;3
17263.0;2023;02;AIX-MARSEILLE;MASCULIN;SCOLAIRE;BAC PROFESSIONNEL;BAC PRO SERV;BAC PRO 31214 MET.COM.VEN.OP.B PR.CL.VA.OF.COM.;334;332;268;53;11;10;1;278;0;7;50;90;131;54
17270.0;2023;02;AIX-MARSEILLE;MASCULIN;SCOLAIRE;BAC PROFESSIONNEL;BAC PRO SERV;BAC PRO 33006 ANIMAT. ENFANCE& PERSONNES AGEES;36;36;32;4;0;0;0;32;0;3;6;15;8;4
17274.0;2023;02;AIX-MARSEILLE;MASCULIN;SCOLAIRE;BAC PROFESSIONNEL;BAC PRO SERV;BAC PRO 33403 COMMERC. SERVICES EN RESTAURATION;50;50;41;8;1;0;1;41;0;3;9;14;15;9
17276.0;2023;02;AIX-MARSEILLE;MASCULIN;SCOLAIRE;BAC PROFESSIONNEL;BAC PRO SERV;BAC PRO 34304 HYGIENE PROPRETE STERILISATION;2;2;2;0;0;0;0;2;0;0;0;2;0;0
17283.0;2023;02;AIX-MARSEILLE;MASCULIN;SCOLAIRE;BAC TECHNOLOGIQUE;BAC STHR;BAC STHR SC.&TEC. HOTELLERIE-RESTAURATION;30;30;29;0;1;1;0;30;0;2;6;10;12;0
17284.0;2023;02;AIX-MARSEILLE;MASCULIN;SCOLAIRE;BAC TECHNOLOGIQUE;BAC STI2D;BAC STI2D ARCHITECTURE ET CONSTRUCTION;102;102;84;2;16;12;4;96;0;6;17;31;42;6
17288.0;2023;02;AIX-MARSEILLE;MASCULIN;SCOLAIRE;BAC TECHNOLOGIQUE;BAC STL;BAC STL BIOCHIM.-BIOLOGIE-BIOTECHNOL.;62;62;55;3;4;4;0;59;0;4;16;21;18;3
17295.0;2023;20;AMIENS;FEMININ;APPRENTISSAGE;BAC PROFESSIONNEL;BAC PRO PROD;BAC PRO 22106 CUISINE;9;9;6;3;0;0;0;6;0;0;0;2;4;3
17303.0;2023;20;AMIENS;FEMININ;APPRENTISSAGE;BAC PROFESSIONNEL;BAC PRO PROD;BAC PRO 25510 METIERS ELECT. ENVIRON. CONNECTES;1;1;1;0;0;0;0;1;0;0;1;0;0;0
17304.0;2023;20;AMIENS;FEMININ;APPRENTISSAGE;BAC PROFESSIONNEL;BAC PRO PROD;BAC PRO AG 21004 CGEA;12;10;6;4;0;0;0;6;0;0;1;3;2;4
17306.0;2023;20;AMIENS;FEMININ;APPRENTISSAGE;BAC PROFESSIONNEL;BAC PRO PROD;BAC PRO AG 21405 AMENAGEMENTS PAYSAGERS;4;4;4;0;0;0;0;4;0;0;0;3;1;0
17309.0;2023;20;AMIENS;FEMININ;APPRENTISSAGE;BAC PROFESSIONNEL;BAC PRO SERV;BAC PRO 31106 LOGISTIQUE;11;11;9;2;0;0;0;9;0;1;2;3;3;2
17335.0;2023;20;AMIENS;FEMININ;INDIVIDUEL;BAC PROFESSIONNEL;BAC PRO SERV;BAC PRO 33003 ACC.SOINS-S.PERS. OPT.A DOMICILE;3;0;0;0;0;0;0;0;0;0;0;0;0;0
17340.0;2023;20;AMIENS;FEMININ;INDIVIDUEL;BAC TECHNOLOGIQUE;BAC STAV;BAC STAV AGRONOMIE ALIM ENV TERRITOI;3;3;3;0;0;0;0;3;0;0;0;0;3;0
17341.0;2023;20;AMIENS;FEMININ;INDIVIDUEL;BAC TECHNOLOGIQUE;BAC STL;BAC STL BIOCHIM.-BIOLOGIE-BIOTECHNOL.;1;1;0;1;0;0;0;0;0;0;0;0;0;1
17342.0;2023;20;AMIENS;FEMININ;INDIVIDUEL;BAC TECHNOLOGIQUE;BAC STL;BAC STL SCIENCES PHYSIQUES CHIMIQUES  EN LABORAT.;2;2;0;0;2;0;2;0;0;0;0;0;0;2
17349.0;2023;20;AMIENS;FEMININ;SCOLAIRE;BAC PROFESSIONNEL;BAC PRO PROD;BAC PRO 22003 BIO-INDUSTRIES DE TRANSFORMATION;6;6;6;0;0;0;0;6;0;0;1;3;2;0
17353.0;2023;20;AMIENS;FEMININ;SCOLAIRE;BAC PROFESSIONNEL;BAC PRO PROD;BAC PRO 22106 CUISINE;43;43;35;3;5;2;3;37;0;2;8;18;9;6
17363.0;2023;20;AMIENS;FEMININ;SCOLAIRE;BAC PROFESSIONNEL;BAC PRO PROD;BAC PRO 25006 MICROTECHNIQUES;1;1;1;0;0;0;0;1;0;0;1;0;0;0
17371.0;2023;20;AMIENS;FEMININ;SCOLAIRE;BAC PROFESSIONNEL;BAC PRO PROD;BAC PRO 25408 REPARATION DES CARROSSERIES;1;1;0;1;0;0;0;0;0;0;0;0;0;1
17375.0;2023;20;AMIENS;FEMININ;SCOLAIRE;BAC PROFESSIONNEL;BAC PRO PROD;BAC PRO 25514 SYST.NUM.OPT.B AUD.RES.EQUIP.DOM.;5;5;3;2;0;0;0;3;0;0;1;1;1;2
17376.0;2023;20;AMIENS;FEMININ;SCOLAIRE;BAC PROFESSIONNEL;BAC PRO PROD;BAC PRO 25515 SYST.NUM.OPT.C RES.INF.SYST.COMM.;2;2;2;0;0;0;0;2;0;0;1;1;0;0
17382.0;2023;20;AMIENS;FEMININ;SCOLAIRE;BAC PROFESSIONNEL;BAC PRO PROD;BAC PRO AG 21302 GEST MILIEUX NATURELS FAUNE;8;8;8;0;0;0;0;8;0;0;0;3;5;0
17384.0;2023;20;AMIENS;FEMININ;SCOLAIRE;BAC PROFESSIONNEL;BAC PRO PROD;BAC PRO AG 22105 LABORATOIRE CONTROLE QUALITE;3;3;3;0;0;0;0;3;0;0;0;2;1;0
17385.0;2023;20;AMIENS;FEMININ;SCOLAIRE;BAC PROFESSIONNEL;BAC PRO PROD;BAC PRO AG 22108 TEC CONS VTE ALIMENTATION (PAB);6;6;3;3;0;0;0;3;0;0;0;0;3;3
17386.0;2023;20;AMIENS;FEMININ;SCOLAIRE;BAC PROFESSIONNEL;BAC PRO SERV;BAC PRO 30004 ASSISTANC.GEST.ORGANIS.ACTIVITES;346;346;254;76;16;13;3;267;0;14;52;93;108;79
17391.0;2023;20;AMIENS;FEMININ;SCOLAIRE;BAC PROFESSIONNEL;BAC PRO SERV;BAC PRO 31213 MET.COM.VEN.OP.A ANI.GES.ESP.COM.;378;377;273;70;34;21;13;294;0;10;71;113;100;83
17398.0;2023;20;AMIENS;FEMININ;SCOLAIRE;BAC PROFESSIONNEL;BAC PRO SERV;BAC PRO 33101 OPTIQUE LUNETTERIE;13;13;12;1;0;0;0;12;0;2;3;4;3;1
17399.0;2023;20;AMIENS;FEMININ;SCOLAIRE;BAC PROFESSIONNEL;BAC PRO SERV;BAC PRO 33403 COMMERC. SERVICES EN RESTAURATION;40;40;30;9;1;0;1;30;0;1;3;12;14;10
17408.0;2023;20;AMIENS;FEMININ;SCOLAIRE;BAC TECHNOLOGIQUE;BAC STHR;BAC STHR SC.&TEC. HOTELLERIE-RESTAURATION;19;19;18;0;1;1;0;19;0;0;5;7;7;0
17416.0;2023;20;AMIENS;FEMININ;SCOLAIRE;BAC TECHNOLOGIQUE;BAC STMG;BAC STMG MERCATIQUE (MARKETING);510;510;375;37;98;75;23;450;0;3;43;107;297;60
17423.0;2023;20;AMIENS;MASCULIN;APPRENTISSAGE;BAC PROFESSIONNEL;BAC PRO PROD;BAC PRO 23004 TECHN. ETUDES BAT.A ETUDES & ECO.;2;2;2;0;0;0;0;2;0;0;0;1;1;0
17426.0;2023;20;AMIENS;MASCULIN;APPRENTISSAGE;BAC PROFESSIONNEL;BAC PRO PROD;BAC PRO 23203 TECHNICIEN BAT. : ORG.REAL.GROS O;5;5;5;0;0;0;0;5;0;0;2;1;2;0
17427.0;2023;20;AMIENS;MASCULIN;APPRENTISSAGE;BAC PROFESSIONNEL;BAC PRO PROD;BAC PRO 23304 AMENAGEMENT FINITION BATIMENT;8;8;8;0;0;0;0;8;0;0;2;4;2;0
17431.0;2023;20;AMIENS;MASCULIN;APPRENTISSAGE;BAC PROFESSIONNEL;BAC PRO PROD;BAC PRO 25007 MAINTENANCE EQUIPEMENTS INDUST.;42;42;33;7;2;2;0;35;0;4;8;11;12;7
17432.0;2023;20;AMIENS;MASCULIN;APPRENTISSAGE;BAC PROFESSIONNEL;BAC PRO PROD;BAC PRO 25009 MAINTENANCE NAUTIQUE;2;2;2;0;0;0;0;2;0;0;0;2;0;0
17436.0;2023;20;AMIENS;MASCULIN;APPRENTISSAGE;BAC PROFESSIONNEL;BAC PRO PROD;BAC PRO 25216 MAINT.VEHIC.OPTC MOTOCYCLES;4;4;3;0;1;1;0;4;0;0;0;1;3;0
17442.0;2023;20;AMIENS;MASCULIN;APPRENTISSAGE;BAC PROFESSIONNEL;BAC PRO PROD;BAC PRO 25411 TECH.CHAUDRONNERIE INDUSTRIELLE;73;73;67;4;2;1;1;68;0;10;18;21;19;5
17451.0;2023;20;AMIENS;MASCULIN;APPRENTISSAGE;BAC PROFESSIONNEL;BAC PRO PROD;BAC PRO AG 21405 AMENAGEMENTS PAYSAGERS;49;48;44;4;0;0;0;44;0;0;6;10;28;4
17452.0;2023;20;AMIENS;MASCULIN;APPRENTISSAGE;BAC PROFESSIONNEL;BAC PRO PROD;BAC PRO AG 22108 TEC CONS VTE ALIMENTATION (PAB);8;8;6;2;0;0;0;6;0;0;0;2;4;2
17454.0;2023;20;AMIENS;MASCULIN;APPRENTISSAGE;BAC PROFESSIONNEL;BAC PRO SERV;BAC PRO 31106 LOGISTIQUE;58;58;46;8;4;2;2;48;0;2;9;18;19;10
17467.0;2023;20;AMIENS;MASCULIN;FORMATION CONTINUE;BAC PROFESSIONNEL;BAC PRO PROD;BAC PRO 25509 TECHNIC. FROID CONDITIONNEMT AIR;9;8;7;1;0;0;0;7;0;2;3;2;0;1
17476.0;2023;20;AMIENS;MASCULIN;INDIVIDUEL;BAC PROFESSIONNEL;BAC PRO SERV;BAC PRO 31106 LOGISTIQUE;1;1;1;0;0;0;0;1;0;0;0;0;1;0
17482.0;2023;20;AMIENS;MASCULIN;INDIVIDUEL;BAC TECHNOLOGIQUE;BAC ST2S;BAC ST2S SCIENCES & TECHNO. SANTE & SOCIAL;3;3;1;2;0;0;0;1;0;0;0;0;1;2
17483.0;2023;20;AMIENS;MASCULIN;INDIVIDUEL;BAC TECHNOLOGIQUE;BAC STI2D;BAC STI2D ENERGIES  ET ENVIRONNEMENT;2;2;0;1;1;1;0;1;0;0;0;0;1;1
17484.0;2023;20;AMIENS;MASCULIN;INDIVIDUEL;BAC TECHNOLOGIQUE;BAC STI2D;BAC STI2D SYSTÈME D'INFORMATION  ET NUMERIQUE;3;3;0;2;1;0;1;0;0;0;0;0;0;3
17487.0;2023;20;AMIENS;MASCULIN;INDIVIDUEL;BAC TECHNOLOGIQUE;BAC STMG;BAC STMG MERCATIQUE (MARKETING);9;9;1;7;1;1;0;2;0;0;0;0;2;7
17490.0;2023;20;AMIENS;MASCULIN;SCOLAIRE;BAC GENERAL;BAC GENERAL;BAC GENE 10019 BAC GENERAL;4395;4395;3910;93;392;267;125;4177;67;392;842;1281;1595;218
17492.0;2023;20;AMIENS;MASCULIN;SCOLAIRE;BAC PROFESSIONNEL;BAC PRO PROD;BAC PRO 22003 BIO-INDUSTRIES DE TRANSFORMATION;10;10;4;4;2;2;0;6;0;0;1;3;2;4
17493.0;2023;20;AMIENS;MASCULIN;SCOLAIRE;BAC PROFESSIONNEL;BAC PRO PROD;BAC PRO 22004 PROC. CHIMIE EAU PAPIERS-CARTONS;9;9;4;2;3;2;1;6;0;1;1;0;4;3
17495.0;2023;20;AMIENS;MASCULIN;SCOLAIRE;BAC PROFESSIONNEL;BAC PRO PROD;BAC PRO 22105 BOULANGER-PÂTISSIER;10;10;8;2;0;0;0;8;0;1;3;2;2;2
17498.0;2023;20;AMIENS;MASCULIN;SCOLAIRE;BAC PROFESSIONNEL;BAC PRO PROD;BAC PRO 22503 PLASTIQUES ET COMPOSITES;7;7;4;3;0;0;0;4;0;0;0;1;3;3
17499.0;2023;20;AMIENS;MASCULIN;SCOLAIRE;BAC PROFESSIONNEL;BAC PRO PROD;BAC PRO 22703 TECHN.INSTALL.SYST.ENERG.CLIMATI;42;42;27;12;3;2;1;29;0;1;3;9;16;13
17519.0;2023;20;AMIENS;MASCULIN;SCOLAIRE;BAC PROFESSIONNEL;BAC PRO PROD;BAC PRO 25214 MAINT.VEHIC.OPTA VOIT.PARTICUL.;157;155;127;26;2;1;1;128;0;8;33;48;39;27
17526.0;2023;20;AMIENS;MASCULIN;SCOLAIRE;BAC PROFESSIONNEL;BAC PRO PROD;BAC PRO 25406 OUVRAGES DU BATIMENT METALLERIE;10;9;8;1;0;0;0;8;0;0;2;4;2;1
17529.0;2023;20;AMIENS;MASCULIN;SCOLAIRE;BAC PROFESSIONNEL;BAC PRO PROD;BAC PRO 25509 TECHNIC. FROID CONDITIONNEMT AIR;19;19;13;6;0;0;0;13;0;0;1;6;6;6
17531.0;2023;20;AMIENS;MASCULIN;SCOLAIRE;BAC PROFESSIONNEL;BAC PRO PROD;BAC PRO 25513 SYST.NUM.OPT.A SURETE SECURITE;74;74;55;14;5;5;0;60;0;5;14;17;24;14
17533.0;2023;20;AMIENS;MASCULIN;SCOLAIRE;BAC PROFESSIONNEL;BAC PRO PROD;BAC PRO 25515 SYST.NUM.OPT.C RES.INF.SYST.COMM.;91;91;71;17;3;2;1;73;0;4;19;29;21;18
17537.0;2023;20;AMIENS;MASCULIN;SCOLAIRE;BAC PROFESSIONNEL;BAC PRO PROD;BAC PRO AG 21203 TECHN CONSEIL DE VENTE ANIMAL;15;15;12;3;0;0;0;12;0;0;1;5;6;3
17551.0;2023;20;AMIENS;MASCULIN;SCOLAIRE;BAC PROFESSIONNEL;BAC PRO SERV;BAC PRO 32207 REAL.PR.IMPR.PLURI.OPTA.PR.GRAPH.;8;8;7;1;0;0;0;7;0;0;2;0;5;1
17553.0;2023;20;AMIENS;MASCULIN;SCOLAIRE;BAC PROFESSIONNEL;BAC PRO SERV;BAC PRO 33003 ACC.SOINS-S.PERS. OPT.A DOMICILE;10;10;7;1;2;2;0;9;0;0;2;4;3;1
17558.0;2023;20;AMIENS;MASCULIN;SCOLAIRE;BAC PROFESSIONNEL;BAC PRO SERV;BAC PRO 33604 METIERS DE LA COIFFURE;2;2;2;0;0;0;0;2;0;0;0;2;0;0
17559.0;2023;20;AMIENS;MASCULIN;SCOLAIRE;BAC PROFESSIONNEL;BAC PRO SERV;BAC PRO 34304 HYGIENE PROPRETE STERILISATION;6;6;6;0;0;0;0;6;0;1;2;1;2;0
17565.0;2023;20;AMIENS;MASCULIN;SCOLAIRE;BAC TECHNOLOGIQUE;BAC STHR;BAC STHR SC.&TEC. HOTELLERIE-RESTAURATION;16;16;15;1;0;0;0;15;0;0;5;6;4;1
17566.0;2023;20;AMIENS;MASCULIN;SCOLAIRE;BAC TECHNOLOGIQUE;BAC STI2D;BAC STI2D ARCHITECTURE ET CONSTRUCTION;86;86;62;4;20;15;5;77;1;2;11;20;43;9
17569.0;2023;20;AMIENS;MASCULIN;SCOLAIRE;BAC TECHNOLOGIQUE;BAC STI2D;BAC STI2D SYSTÈME D'INFORMATION  ET NUMERIQUE;245;245;189;10;46;35;11;224;0;7;39;65;113;21
17573.0;2023;20;AMIENS;MASCULIN;SCOLAIRE;BAC TECHNOLOGIQUE;BAC STMG;BAC STMG MERCATIQUE (MARKETING);506;506;327;49;130;100;30;427;0;5;20;97;305;79
17578.0;2023;03;BESANCON;FEMININ;APPRENTISSAGE;BAC PROFESSIONNEL;BAC PRO PROD;BAC PRO 22106 CUISINE;6;6;2;1;3;2;1;4;0;0;0;1;3;2
17581.0;2023;03;BESANCON;FEMININ;APPRENTISSAGE;BAC PROFESSIONNEL;BAC PRO PROD;BAC PRO 25107 TECHNICIEN OUTILLEUR;2;2;1;1;0;0;0;1;0;0;0;1;0;1
17584.0;2023;03;BESANCON;FEMININ;APPRENTISSAGE;BAC PROFESSIONNEL;BAC PRO PROD;BAC PRO AG 21004 CGEA;17;17;12;5;0;0;0;12;0;1;1;2;8;5
17589.0;2023;03;BESANCON;FEMININ;APPRENTISSAGE;BAC PROFESSIONNEL;BAC PRO PROD;BAC PRO AG 21303 FORET;1;1;0;1;0;0;0;0;0;0;0;0;0;1
17590.0;2023;03;BESANCON;FEMININ;APPRENTISSAGE;BAC PROFESSIONNEL;BAC PRO PROD;BAC PRO AG 21405 AMENAGEMENTS PAYSAGERS;2;2;2;0;0;0;0;2;0;1;0;0;1;0
17595.0;2023;03;BESANCON;FEMININ;APPRENTISSAGE;BAC PROFESSIONNEL;BAC PRO SERV;BAC PRO 31212 METIERS DE L'ACCUEIL;1;1;1;0;0;0;0;1;0;0;0;1;0;0
17601.0;2023;03;BESANCON;FEMININ;APPRENTISSAGE;BAC PROFESSIONNEL;BAC PRO SERV;BAC PRO 33104 TECHNICIEN EN PROTHESE DENTAIRE;2;2;2;0;0;0;0;2;0;0;0;1;1;0
17607.0;2023;03;BESANCON;FEMININ;ENSEIGNEMENT A DISTANCE;BAC PROFESSIONNEL;BAC PRO SERV;BAC PRO 31213 MET.COM.VEN.OP.A ANI.GES.ESP.COM.;1;1;0;0;1;1;0;1;0;0;0;0;1;0
17610.0;2023;03;BESANCON;FEMININ;ENSEIGNEMENT A DISTANCE;BAC PROFESSIONNEL;BAC PRO SERV;BAC PRO 33004 ACC.SOINS-S.PERS. OPT.EN STRUCTUR;1;1;0;1;0;0;0;0;0;0;0;0;0;1
17634.0;2023;03;BESANCON;FEMININ;SCOLAIRE;BAC PROFESSIONNEL;BAC PRO PROD;BAC PRO 25006 MICROTECHNIQUES;4;4;3;1;0;0;0;3;0;0;0;1;2;1
17648.0;2023;03;BESANCON;FEMININ;SCOLAIRE;BAC PROFESSIONNEL;BAC PRO PROD;BAC PRO AG 21302 GEST MILIEUX NATURELS FAUNE;6;6;6;0;0;0;0;6;0;0;4;1;1;0
17655.0;2023;03;BESANCON;FEMININ;SCOLAIRE;BAC PROFESSIONNEL;BAC PRO SERV;BAC PRO 31114 ORGANIS. TRANSPORT MARCHANDISES;3;3;3;0;0;0;0;3;0;0;0;1;2;0
17656.0;2023;03;BESANCON;FEMININ;SCOLAIRE;BAC PROFESSIONNEL;BAC PRO SERV;BAC PRO 31212 METIERS DE L'ACCUEIL;47;47;40;4;3;1;2;41;0;3;11;14;13;6
17657.0;2023;03;BESANCON;FEMININ;SCOLAIRE;BAC PROFESSIONNEL;BAC PRO SERV;BAC PRO 31213 MET.COM.VEN.OP.A ANI.GES.ESP.COM.;181;181;133;27;21;18;3;151;0;11;29;48;63;30
17661.0;2023;03;BESANCON;FEMININ;SCOLAIRE;BAC PROFESSIONNEL;BAC PRO SERV;BAC PRO 33006 ANIMAT. ENFANCE& PERSONNES AGEES;15;15;13;1;1;1;0;14;0;4;4;5;1;1
17664.0;2023;03;BESANCON;FEMININ;SCOLAIRE;BAC PROFESSIONNEL;BAC PRO SERV;BAC PRO 33603 ESTHETIQUE COSMETIQUE PARFUMERIE;41;40;34;5;1;1;0;35;0;0;1;12;22;5
17671.0;2023;03;BESANCON;FEMININ;SCOLAIRE;BAC TECHNOLOGIQUE;BAC ST2S;BAC ST2S SCIENCES & TECHNO. SANTE & SOCIAL;318;318;283;5;30;20;10;303;0;10;52;113;128;15
17672.0;2023;03;BESANCON;FEMININ;SCOLAIRE;BAC TECHNOLOGIQUE;BAC STAV;BAC STAV AGRONOMIE ALIM ENV TERRITOI;61;61;60;1;0;0;0;60;0;0;9;23;28;1
17674.0;2023;03;BESANCON;FEMININ;SCOLAIRE;BAC TECHNOLOGIQUE;BAC STHR;BAC STHR SC.&TEC. HOTELLERIE-RESTAURATION;37;37;37;0;0;0;0;37;0;7;16;7;7;0
17678.0;2023;03;BESANCON;FEMININ;SCOLAIRE;BAC TECHNOLOGIQUE;BAC STI2D;BAC STI2D SYSTÈME D'INFORMATION  ET NUMERIQUE;6;6;3;0;3;2;1;5;0;0;0;1;4;1
17681.0;2023;03;BESANCON;FEMININ;SCOLAIRE;BAC TECHNOLOGIQUE;BAC STMG;BAC STMG GESTION ET FINANCE;137;137;116;5;16;12;4;128;0;5;18;43;62;9
17682.0;2023;03;BESANCON;FEMININ;SCOLAIRE;BAC TECHNOLOGIQUE;BAC STMG;BAC STMG MERCATIQUE (MARKETING);281;281;219;14;48;37;11;256;0;5;27;70;154;25
17683.0;2023;03;BESANCON;FEMININ;SCOLAIRE;BAC TECHNOLOGIQUE;BAC STMG;BAC STMG RESSOURCES HUMAINES ET COMMUNICATION;275;275;188;16;71;53;18;241;1;1;18;63;158;34
17685.0;2023;03;BESANCON;MASCULIN;APPRENTISSAGE;BAC PROFESSIONNEL;BAC PRO PROD;BAC PRO 22004 PROC. CHIMIE EAU PAPIERS-CARTONS;1;1;1;0;0;0;0;1;0;1;0;0;0;0
17693.0;2023;03;BESANCON;MASCULIN;APPRENTISSAGE;BAC PROFESSIONNEL;BAC PRO PROD;BACPRO 23103 TECHNICIEN GEOMETRE-TOPOGRAPHE;1;1;1;0;0;0;0;1;0;0;1;0;0;0
17695.0;2023;03;BESANCON;MASCULIN;APPRENTISSAGE;BAC PROFESSIONNEL;BAC PRO PROD;BAC PRO 23207 INTERV. SUR PATRIMOINE BATI OPT.C;2;2;2;0;0;0;0;2;0;0;0;2;0;0
17711.0;2023;03;BESANCON;MASCULIN;APPRENTISSAGE;BAC PROFESSIONNEL;BAC PRO PROD;BAC PRO 25406 OUVRAGES DU BATIMENT METALLERIE;9;9;8;1;0;0;0;8;0;1;0;3;4;1
17714.0;2023;03;BESANCON;MASCULIN;APPRENTISSAGE;BAC PROFESSIONNEL;BAC PRO PROD;BAC PRO 25411 TECH.CHAUDRONNERIE INDUSTRIELLE;21;21;17;4;0;0;0;17;0;5;7;4;1;4
17715.0;2023;03;BESANCON;MASCULIN;APPRENTISSAGE;BAC PROFESSIONNEL;BAC PRO PROD;BAC PRO 25509 TECHNIC. FROID CONDITIONNEMT AIR;9;9;9;0;0;0;0;9;0;0;1;3;5;0
17724.0;2023;03;BESANCON;MASCULIN;APPRENTISSAGE;BAC PROFESSIONNEL;BAC PRO PROD;BAC PRO AG 21303 FORET;20;19;18;1;0;0;0;18;0;0;5;7;6;1
17726.0;2023;03;BESANCON;MASCULIN;APPRENTISSAGE;BAC PROFESSIONNEL;BAC PRO PROD;BAC PRO AG 21407 TEC CONS VTE UNIVERS JARDINERIE;1;1;1;0;0;0;0;1;0;0;0;0;1;0
17728.0;2023;03;BESANCON;MASCULIN;APPRENTISSAGE;BAC PROFESSIONNEL;BAC PRO SERV;BAC PRO 30004 ASSISTANC.GEST.ORGANIS.ACTIVITES;4;4;4;0;0;0;0;4;0;1;0;1;2;0
17729.0;2023;03;BESANCON;MASCULIN;APPRENTISSAGE;BAC PROFESSIONNEL;BAC PRO SERV;BAC PRO 31106 LOGISTIQUE;9;9;5;2;2;1;1;6;0;1;0;3;2;3
17733.0;2023;03;BESANCON;MASCULIN;APPRENTISSAGE;BAC PROFESSIONNEL;BAC PRO SERV;BAC PRO 33006 ANIMAT. ENFANCE& PERSONNES AGEES;1;1;1;0;0;0;0;1;0;0;0;1;0;0
17734.0;2023;03;BESANCON;MASCULIN;APPRENTISSAGE;BAC PROFESSIONNEL;BAC PRO SERV;BAC PRO 33104 TECHNICIEN EN PROTHESE DENTAIRE;2;2;1;1;0;0;0;1;0;0;0;1;0;1
17748.0;2023;03;BESANCON;MASCULIN;INDIVIDUEL;BAC PROFESSIONNEL;BAC PRO PROD;BAC PRO 25106 TECHNICIEN D'USINAGE;2;1;0;1;0;0;0;0;0;0;0;0;0;1
17756.0;2023;03;BESANCON;MASCULIN;INDIVIDUEL;BAC PROFESSIONNEL;BAC PRO SERV;BAC PRO 33004 ACC.SOINS-S.PERS. OPT.EN STRUCTUR;1;0;0;0;0;0;0;0;0;0;0;0;0;0
17761.0;2023;03;BESANCON;MASCULIN;INDIVIDUEL;BAC TECHNOLOGIQUE;BAC STMG;BAC STMG GESTION ET FINANCE;3;3;2;1;0;0;0;2;0;0;0;1;1;1
17766.0;2023;03;BESANCON;MASCULIN;SCOLAIRE;BAC PROFESSIONNEL;BAC PRO PROD;BAC PRO 22106 CUISINE;54;54;44;6;4;4;0;48;0;4;6;20;18;6
17769.0;2023;03;BESANCON;MASCULIN;SCOLAIRE;BAC PROFESSIONNEL;BAC PRO PROD;BAC PRO 22704 TECHN. MAINT. SYST.ENERG.CLIMATI;15;15;6;6;3;3;0;9;0;0;1;4;4;6
17782.0;2023;03;BESANCON;MASCULIN;SCOLAIRE;BAC PROFESSIONNEL;BAC PRO PROD;BAC PRO 24302 METIERS DU CUIR : MAROQUINERIE;3;3;3;0;0;0;0;3;0;0;0;2;1;0
17785.0;2023;03;BESANCON;MASCULIN;SCOLAIRE;BAC PROFESSIONNEL;BAC PRO PROD;BAC PRO 25007 MAINTENANCE EQUIPEMENTS INDUST.;99;99;65;31;3;2;1;67;0;1;8;25;33;32
17786.0;2023;03;BESANCON;MASCULIN;SCOLAIRE;BAC PROFESSIONNEL;BAC PRO PROD;BAC PRO 25106 TECHNICIEN D'USINAGE;74;74;53;14;7;6;1;59;0;2;6;23;28;15
17791.0;2023;03;BESANCON;MASCULIN;SCOLAIRE;BAC PROFESSIONNEL;BAC PRO PROD;BAC PRO 25408 REPARATION DES CARROSSERIES;24;23;12;8;3;3;0;15;0;0;4;3;8;8
17798.0;2023;03;BESANCON;MASCULIN;SCOLAIRE;BAC PROFESSIONNEL;BAC PRO PROD;BAC PRO 25515 SYST.NUM.OPT.C RES.INF.SYST.COMM.;82;82;72;7;3;3;0;75;0;8;28;19;20;7
17801.0;2023;03;BESANCON;MASCULIN;SCOLAIRE;BAC PROFESSIONNEL;BAC PRO PROD;BAC PRO AG 21114 CONDUITE PRODUCTIONS HORTICOLES;1;1;1;0;0;0;0;1;0;0;0;0;1;0
17802.0;2023;03;BESANCON;MASCULIN;SCOLAIRE;BAC PROFESSIONNEL;BAC PRO PROD;BAC PRO AG 21203 TECHN CONSEIL DE VENTE ANIMAL;3;3;3;0;0;0;0;3;0;0;1;1;1;0
17808.0;2023;03;BESANCON;MASCULIN;SCOLAIRE;BAC PROFESSIONNEL;BAC PRO SERV;BAC PRO 31106 LOGISTIQUE;25;25;15;9;1;0;1;15;0;1;2;4;8;10
17818.0;2023;03;BESANCON;MASCULIN;SCOLAIRE;BAC PROFESSIONNEL;BAC PRO SERV;BAC PRO 33403 COMMERC. SERVICES EN RESTAURATION;37;37;27;7;3;3;0;30;0;1;5;10;14;7
17822.0;2023;03;BESANCON;MASCULIN;SCOLAIRE;BAC PROFESSIONNEL;BAC PRO SERV;BAC PRO AG 33002 SERV PERS TERRIT;22;22;19;3;0;0;0;19;0;0;2;10;7;3
17825.0;2023;03;BESANCON;MASCULIN;SCOLAIRE;BAC TECHNOLOGIQUE;BAC STAV;BAC STAV AGRONOMIE ALIM ENV TERRITOI;85;85;85;0;0;0;0;85;0;0;10;39;36;0
17832.0;2023;03;BESANCON;MASCULIN;SCOLAIRE;BAC TECHNOLOGIQUE;BAC STL;BAC STL BIOCHIM.-BIOLOGIE-BIOTECHNOL.;22;22;18;2;2;0;2;18;0;0;7;6;5;4
17834.0;2023;03;BESANCON;MASCULIN;SCOLAIRE;BAC TECHNOLOGIQUE;BAC STMG;BAC STMG GESTION ET FINANCE;131;131;92;14;25;20;5;112;0;2;8;39;63;19
17838.0;2023;04;BORDEAUX;FEMININ;APPRENTISSAGE;BAC PROFESSIONNEL;BAC PRO PROD;BAC PRO 20102 PILOTE DE LIGNE DE PRODUCTION;1;1;1;0;0;0;0;1;0;1;0;0;0;0
17840.0;2023;04;BORDEAUX;FEMININ;APPRENTISSAGE;BAC PROFESSIONNEL;BAC PRO PROD;BAC PRO 22106 CUISINE;9;9;8;1;0;0;0;8;0;2;1;4;1;1
17850.0;2023;04;BORDEAUX;FEMININ;APPRENTISSAGE;BAC PROFESSIONNEL;BAC PRO PROD;BAC PRO 25303 AERONAUTIQUE OPTION SYSTEMES;4;4;4;0;0;0;0;4;0;0;2;1;1;0
17854.0;2023;04;BORDEAUX;FEMININ;APPRENTISSAGE;BAC PROFESSIONNEL;BAC PRO PROD;BAC PRO AG 21113 CGEVV;3;3;3;0;0;0;0;3;0;0;0;1;2;0
17856.0;2023;04;BORDEAUX;FEMININ;APPRENTISSAGE;BAC PROFESSIONNEL;BAC PRO PROD;BAC PRO AG 21211 COND GEST ENTR HIPPIQUE;24;24;23;1;0;0;0;23;0;0;1;7;15;1
17860.0;2023;04;BORDEAUX;FEMININ;APPRENTISSAGE;BAC PROFESSIONNEL;BAC PRO SERV;BAC PRO 30004 ASSISTANC.GEST.ORGANIS.ACTIVITES;16;16;12;4;0;0;0;12;0;1;5;4;2;4
17864.0;2023;04;BORDEAUX;FEMININ;APPRENTISSAGE;BAC PROFESSIONNEL;BAC PRO SERV;BAC PRO 31213 MET.COM.VEN.OP.A ANI.GES.ESP.COM.;121;120;91;24;5;5;0;96;0;6;17;37;36;24
17866.0;2023;04;BORDEAUX;FEMININ;APPRENTISSAGE;BAC PROFESSIONNEL;BAC PRO SERV;BAC PRO 32208 REAL.PR.IMPR.PLURI.OPTB.PR.IMPR.;1;1;1;0;0;0;0;1;0;0;1;0;0;0
17869.0;2023;04;BORDEAUX;FEMININ;APPRENTISSAGE;BAC PROFESSIONNEL;BAC PRO SERV;BAC PRO 33104 TECHNICIEN EN PROTHESE DENTAIRE;8;8;8;0;0;0;0;8;0;1;1;6;0;0
17870.0;2023;04;BORDEAUX;FEMININ;APPRENTISSAGE;BAC PROFESSIONNEL;BAC PRO SERV;BAC PRO 33403 COMMERC. SERVICES EN RESTAURATION;9;9;9;0;0;0;0;9;0;0;4;5;0;0
17887.0;2023;04;BORDEAUX;FEMININ;ENSEIGNEMENT A DISTANCE;BAC TECHNOLOGIQUE;BAC STMG;BAC STMG RESSOURCES HUMAINES ET COMMUNICATION;4;4;1;1;2;1;1;2;0;0;0;0;2;2
17891.0;2023;04;BORDEAUX;FEMININ;FORMATION CONTINUE;BAC PROFESSIONNEL;BAC PRO PROD;BAC PRO 25510 METIERS ELECT. ENVIRON. CONNECTES;3;3;3;0;0;0;0;3;0;1;2;0;0;0
17897.0;2023;04;BORDEAUX;FEMININ;INDIVIDUEL;BAC PROFESSIONNEL;BAC PRO PROD;BAC PRO 24203 METIERS DE LA MODE - VÊTEMENT;2;2;0;2;0;0;0;0;0;0;0;0;0;2
17899.0;2023;04;BORDEAUX;FEMININ;INDIVIDUEL;BAC PROFESSIONNEL;BAC PRO PROD;BAC PRO AG 21004 CGEA;2;1;1;0;0;0;0;1;0;0;0;0;1;0
17901.0;2023;04;BORDEAUX;FEMININ;INDIVIDUEL;BAC PROFESSIONNEL;BAC PRO PROD;BAC PRO AG 21114 CONDUITE PRODUCTIONS HORTICOLES;4;4;4;0;0;0;0;4;0;0;0;0;4;0
17902.0;2023;04;BORDEAUX;FEMININ;INDIVIDUEL;BAC PROFESSIONNEL;BAC PRO PROD;BAC PRO AG 21211 COND GEST ENTR HIPPIQUE;6;6;5;1;0;0;0;5;0;0;0;1;4;1
17904.0;2023;04;BORDEAUX;FEMININ;INDIVIDUEL;BAC PROFESSIONNEL;BAC PRO SERV;BAC PRO 31212 METIERS DE L'ACCUEIL;2;1;1;0;0;0;0;1;0;0;0;0;1;0
17908.0;2023;04;BORDEAUX;FEMININ;INDIVIDUEL;BAC PROFESSIONNEL;BAC PRO SERV;BAC PRO 33006 ANIMAT. ENFANCE& PERSONNES AGEES;1;0;0;0;0;0;0;0;0;0;0;0;0;0
17919.0;2023;04;BORDEAUX;FEMININ;SCOLAIRE;BAC PROFESSIONNEL;BAC PRO PROD;BACPRO 20002 ETUD.DEFINITION PRDTS INDUSTRIEL;2;2;1;1;0;0;0;1;0;0;0;0;1;1
17921.0;2023;04;BORDEAUX;FEMININ;SCOLAIRE;BAC PROFESSIONNEL;BAC PRO PROD;BAC PRO 22003 BIO-INDUSTRIES DE TRANSFORMATION;22;22;18;4;0;0;0;18;0;0;2;10;6;4
17927.0;2023;04;BORDEAUX;FEMININ;SCOLAIRE;BAC PROFESSIONNEL;BAC PRO PROD;BAC PRO 22503 PLASTIQUES ET COMPOSITES;2;2;2;0;0;0;0;2;0;0;1;0;1;0
17929.0;2023;04;BORDEAUX;FEMININ;SCOLAIRE;BAC PROFESSIONNEL;BAC PRO PROD;BAC PRO 23004 TECHN. ETUDES BAT.A ETUDES & ECO.;14;14;8;6;0;0;0;8;0;0;0;2;6;6
17942.0;2023;04;BORDEAUX;FEMININ;SCOLAIRE;BAC PROFESSIONNEL;BAC PRO PROD;BAC PRO 25214 MAINT.VEHIC.OPTA VOIT.PARTICUL.;5;5;3;1;1;1;0;4;0;0;0;2;2;1
17946.0;2023;04;BORDEAUX;FEMININ;SCOLAIRE;BAC PROFESSIONNEL;BAC PRO PROD;BAC PRO 25302 AERONAUTIQUE OPTION AVIONIQUE;1;1;1;0;0;0;0;1;0;0;1;0;0;0
17968.0;2023;04;BORDEAUX;FEMININ;SCOLAIRE;BAC PROFESSIONNEL;BAC PRO SERV;BAC PRO 31106 LOGISTIQUE;35;35;29;6;0;0;0;29;0;1;3;10;15;6
17969.0;2023;04;BORDEAUX;FEMININ;SCOLAIRE;BAC PROFESSIONNEL;BAC PRO SERV;BAC PRO 31107 CONDUCT. TRANSP.ROUT.MARCHANDISES;1;1;1;0;0;0;0;1;0;0;0;1;0;0
17974.0;2023;04;BORDEAUX;FEMININ;SCOLAIRE;BAC PROFESSIONNEL;BAC PRO SERV;BAC PRO 32207 REAL.PR.IMPR.PLURI.OPTA.PR.GRAPH.;13;13;10;2;1;1;0;11;0;1;3;3;4;2
17975.0;2023;04;BORDEAUX;FEMININ;SCOLAIRE;BAC PROFESSIONNEL;BAC PRO SERV;BAC PRO 32208 REAL.PR.IMPR.PLURI.OPTB.PR.IMPR.;3;3;3;0;0;0;0;3;0;0;1;0;2;0
17980.0;2023;04;BORDEAUX;FEMININ;SCOLAIRE;BAC PROFESSIONNEL;BAC PRO SERV;BAC PRO 33006 ANIMAT. ENFANCE& PERSONNES AGEES;141;141;122;14;5;3;2;125;0;13;26;55;31;16
17984.0;2023;04;BORDEAUX;FEMININ;SCOLAIRE;BAC PROFESSIONNEL;BAC PRO SERV;BAC PRO 33603 ESTHETIQUE COSMETIQUE PARFUMERIE;210;209;181;24;4;4;0;185;0;5;25;85;70;24
17988.0;2023;04;BORDEAUX;FEMININ;SCOLAIRE;BAC PROFESSIONNEL;BAC PRO SERV;BAC PRO AG 33002 SERV PERS TERRIT;378;369;344;25;0;0;0;344;0;5;49;125;165;25
17992.0;2023;04;BORDEAUX;FEMININ;SCOLAIRE;BAC TECHNOLOGIQUE;BAC STAV;BAC STAV AGRONOMIE ALIM ENV TERRITOI;148;148;145;3;0;0;0;145;0;4;20;60;61;3
17997.0;2023;04;BORDEAUX;FEMININ;SCOLAIRE;BAC TECHNOLOGIQUE;BAC STI2D;BAC STI2D INNOVATION TECHNO.  ET ECO CONCEPTION;36;36;30;1;5;4;1;34;0;0;11;12;11;2
18003.0;2023;04;BORDEAUX;FEMININ;SCOLAIRE;BAC TECHNOLOGIQUE;BAC STMG;BAC STMG RESSOURCES HUMAINES ET COMMUNICATION;528;528;394;27;107;74;33;468;0;4;19;124;321;60
18005.0;2023;04;BORDEAUX;MASCULIN;APPRENTISSAGE;BAC PROFESSIONNEL;BAC PRO PROD;BAC PRO 20102 PILOTE DE LIGNE DE PRODUCTION;10;10;9;1;0;0;0;9;0;1;2;4;2;1
18008.0;2023;04;BORDEAUX;MASCULIN;APPRENTISSAGE;BAC PROFESSIONNEL;BAC PRO PROD;BAC PRO 22106 CUISINE;37;37;31;4;2;1;1;32;0;3;3;11;15;5
18012.0;2023;04;BORDEAUX;MASCULIN;APPRENTISSAGE;BAC PROFESSIONNEL;BAC PRO PROD;BAC PRO 23102 TRAVAUX PUBLICS;27;27;20;6;1;1;0;21;0;1;3;7;10;6
18015.0;2023;04;BORDEAUX;MASCULIN;APPRENTISSAGE;BAC PROFESSIONNEL;BAC PRO PROD;BAC PRO 23208 METIERS ET ARTS DE LA PIERRE;1;1;1;0;0;0;0;1;0;0;0;1;0;0
18017.0;2023;04;BORDEAUX;MASCULIN;APPRENTISSAGE;BAC PROFESSIONNEL;BAC PRO PROD;BAC PRO 23304 AMENAGEMENT FINITION BATIMENT;2;2;2;0;0;0;0;2;0;0;0;2;0;0
18030.0;2023;04;BORDEAUX;MASCULIN;APPRENTISSAGE;BAC PROFESSIONNEL;BAC PRO PROD;BAC PRO 25303 AERONAUTIQUE OPTION SYSTEMES;28;28;27;1;0;0;0;27;0;12;6;7;2;1
18037.0;2023;04;BORDEAUX;MASCULIN;APPRENTISSAGE;BAC PROFESSIONNEL;BAC PRO PROD;BAC PRO 25514 SYST.NUM.OPT.B AUD.RES.EQUIP.DOM.;2;2;2;0;0;0;0;2;0;0;0;2;0;0
18048.0;2023;04;BORDEAUX;MASCULIN;APPRENTISSAGE;BAC PROFESSIONNEL;BAC PRO SERV;BAC PRO 30004 ASSISTANC.GEST.ORGANIS.ACTIVITES;3;3;3;0;0;0;0;3;0;0;1;2;0;0
18058.0;2023;04;BORDEAUX;MASCULIN;APPRENTISSAGE;BAC PROFESSIONNEL;BAC PRO SERV;BAC PRO 33104 TECHNICIEN EN PROTHESE DENTAIRE;5;5;5;0;0;0;0;5;0;2;2;0;1;0
18059.0;2023;04;BORDEAUX;MASCULIN;APPRENTISSAGE;BAC PROFESSIONNEL;BAC PRO SERV;BAC PRO 33403 COMMERC. SERVICES EN RESTAURATION;13;13;11;2;0;0;0;11;0;2;1;6;2;2
18061.0;2023;04;BORDEAUX;MASCULIN;APPRENTISSAGE;BAC PROFESSIONNEL;BAC PRO SERV;BAC PRO 34304 HYGIENE PROPRETE STERILISATION;14;13;10;1;2;1;1;11;0;2;2;2;5;2
18068.0;2023;04;BORDEAUX;MASCULIN;ENSEIGNEMENT A DISTANCE;BAC TECHNOLOGIQUE;BAC STMG;BAC STMG GESTION ET FINANCE;2;2;1;1;0;0;0;1;0;0;0;0;1;1
18070.0;2023;04;BORDEAUX;MASCULIN;ENSEIGNEMENT A DISTANCE;BAC TECHNOLOGIQUE;BAC STMG;BAC STMG RESSOURCES HUMAINES ET COMMUNICATION;2;2;1;0;1;0;1;1;0;0;0;0;1;1
18071.0;2023;04;BORDEAUX;MASCULIN;FORMATION CONTINUE;BAC PROFESSIONNEL;BAC PRO PROD;BAC PRO 22004 PROC. CHIMIE EAU PAPIERS-CARTONS;15;15;15;0;0;0;0;15;0;6;8;1;0;0
18074.0;2023;04;BORDEAUX;MASCULIN;FORMATION CONTINUE;BAC PROFESSIONNEL;BAC PRO PROD;BAC PRO 25215 MAINT.VEHIC.OPTB VEHIC.TRANS.ROUT;1;1;1;0;0;0;0;1;0;1;0;0;0;0
18083.0;2023;04;BORDEAUX;MASCULIN;INDIVIDUEL;BAC PROFESSIONNEL;BAC PRO PROD;BAC PRO 23407 TECHNIC.FAB.BOIS ET MATERX ASSOC;1;1;0;0;1;0;1;0;0;0;0;0;0;1
18089.0;2023;04;BORDEAUX;MASCULIN;INDIVIDUEL;BAC PROFESSIONNEL;BAC PRO PROD;BAC PRO AG 21113 CGEVV;2;1;1;0;0;0;0;1;0;0;0;0;1;0
18091.0;2023;04;BORDEAUX;MASCULIN;INDIVIDUEL;BAC PROFESSIONNEL;BAC PRO PROD;BAC PRO AG 21405 AMENAGEMENTS PAYSAGERS;1;1;1;0;0;0;0;1;0;0;0;0;1;0
18098.0;2023;04;BORDEAUX;MASCULIN;INDIVIDUEL;BAC TECHNOLOGIQUE;BAC STAV;BAC STAV AGRONOMIE ALIM ENV TERRITOI;1;0;0;0;0;0;0;0;0;0;0;0;0;0
18110.0;2023;04;BORDEAUX;MASCULIN;SCOLAIRE;BAC PROFESSIONNEL;BAC PRO PROD;BAC PRO 22003 BIO-INDUSTRIES DE TRANSFORMATION;16;16;15;1;0;0;0;15;0;0;4;3;8;1
18114.0;2023;04;BORDEAUX;MASCULIN;SCOLAIRE;BAC PROFESSIONNEL;BAC PRO PROD;BAC PRO 22106 CUISINE;169;168;150;8;10;10;0;160;0;9;32;68;51;8
18116.0;2023;04;BORDEAUX;MASCULIN;SCOLAIRE;BAC PROFESSIONNEL;BAC PRO PROD;BAC PRO 22503 PLASTIQUES ET COMPOSITES;34;34;25;6;3;3;0;28;0;1;2;9;16;6
18121.0;2023;04;BORDEAUX;MASCULIN;SCOLAIRE;BAC PROFESSIONNEL;BAC PRO PROD;BAC PRO 23005 TECHN. ETUDES BAT B ASSIST.ARCHI.;8;8;6;2;0;0;0;6;0;0;1;1;4;2
18123.0;2023;04;BORDEAUX;MASCULIN;SCOLAIRE;BAC PROFESSIONNEL;BAC PRO PROD;BACPRO 23103 TECHNICIEN GEOMETRE-TOPOGRAPHE;9;9;8;0;1;1;0;9;0;0;3;1;5;0
18140.0;2023;04;BORDEAUX;MASCULIN;SCOLAIRE;BAC PROFESSIONNEL;BAC PRO PROD;BAC PRO 25216 MAINT.VEHIC.OPTC MOTOCYCLES;41;41;36;4;1;1;0;37;0;3;16;8;10;4
18151.0;2023;04;BORDEAUX;MASCULIN;SCOLAIRE;BAC PROFESSIONNEL;BAC PRO PROD;BAC PRO 25510 METIERS ELECT. ENVIRON. CONNECTES;460;458;352;80;26;19;7;371;0;20;54;116;181;87
18162.0;2023;04;BORDEAUX;MASCULIN;SCOLAIRE;BAC PROFESSIONNEL;BAC PRO PROD;BAC PRO AG 21211 COND GEST ENTR HIPPIQUE;1;1;1;0;0;0;0;1;0;0;0;1;0;0
18164.0;2023;04;BORDEAUX;MASCULIN;SCOLAIRE;BAC PROFESSIONNEL;BAC PRO PROD;BAC PRO AG 21303 FORET;37;36;34;2;0;0;0;34;0;0;5;14;15;2
18170.0;2023;04;BORDEAUX;MASCULIN;SCOLAIRE;BAC PROFESSIONNEL;BAC PRO SERV;BAC PRO 31106 LOGISTIQUE;95;94;73;20;1;1;0;74;0;7;14;25;28;20
18173.0;2023;04;BORDEAUX;MASCULIN;SCOLAIRE;BAC PROFESSIONNEL;BAC PRO SERV;BAC PRO 31212 METIERS DE L'ACCUEIL;81;81;63;14;4;4;0;67;0;2;13;30;22;14
18181.0;2023;04;BORDEAUX;MASCULIN;SCOLAIRE;BAC PROFESSIONNEL;BAC PRO SERV;BAC PRO 33004 ACC.SOINS-S.PERS. OPT.EN STRUCTUR;25;25;23;1;1;1;0;24;0;4;5;6;9;1
18184.0;2023;04;BORDEAUX;MASCULIN;SCOLAIRE;BAC PROFESSIONNEL;BAC PRO SERV;BAC PRO 33104 TECHNICIEN EN PROTHESE DENTAIRE;6;6;6;0;0;0;0;6;0;0;0;4;2;0
18185.0;2023;04;BORDEAUX;MASCULIN;SCOLAIRE;BAC PROFESSIONNEL;BAC PRO SERV;BAC PRO 33403 COMMERC. SERVICES EN RESTAURATION;99;98;80;9;9;6;3;86;0;3;15;35;33;12
18193.0;2023;04;BORDEAUX;MASCULIN;SCOLAIRE;BAC TECHNOLOGIQUE;BAC S2TMD;BAC S2TMD MUSIQUE;3;3;3;0;0;0;0;3;0;1;1;1;0;0
18195.0;2023;04;BORDEAUX;MASCULIN;SCOLAIRE;BAC TECHNOLOGIQUE;BAC STAV;BAC STAV AGRONOMIE ALIM ENV TERRITOI;166;166;165;1;0;0;0;165;0;0;15;61;89;1
18199.0;2023;04;BORDEAUX;MASCULIN;SCOLAIRE;BAC TECHNOLOGIQUE;BAC STI2D;BAC STI2D ENERGIES  ET ENVIRONNEMENT;209;209;170;5;34;18;16;188;0;4;27;74;83;21
18200.0;2023;04;BORDEAUX;MASCULIN;SCOLAIRE;BAC TECHNOLOGIQUE;BAC STI2D;BAC STI2D INNOVATION TECHNO.  ET ECO CONCEPTION;341;341;299;11;31;23;8;322;0;13;54;124;131;19
18207.0;2023;04;BORDEAUX;MASCULIN;SCOLAIRE;BAC TECHNOLOGIQUE;BAC STMG;BAC STMG SYSTEMES D'INFORMATION DE GESTION;35;35;27;0;8;5;3;32;0;0;1;10;21;3
18213.0;2023;06;CLERMONT-FERRAND;FEMININ;APPRENTISSAGE;BAC PROFESSIONNEL;BAC PRO PROD;BAC PRO 25214 MAINT.VEHIC.OPTA VOIT.PARTICUL.;3;3;3;0;0;0;0;3;0;1;0;1;1;0
18223.0;2023;06;CLERMONT-FERRAND;FEMININ;APPRENTISSAGE;BAC PROFESSIONNEL;BAC PRO SERV;BAC PRO 31106 LOGISTIQUE;2;2;2;0;0;0;0;2;0;0;0;0;2;0
18224.0;2023;06;CLERMONT-FERRAND;FEMININ;APPRENTISSAGE;BAC PROFESSIONNEL;BAC PRO SERV;BAC PRO 31212 METIERS DE L'ACCUEIL;13;13;13;0;0;0;0;13;0;4;4;5;0;0
18229.0;2023;06;CLERMONT-FERRAND;FEMININ;APPRENTISSAGE;BAC PROFESSIONNEL;BAC PRO SERV;BAC PRO AG 33002 SERV PERS TERRIT;2;2;2;0;0;0;0;2;0;0;0;1;1;0
18232.0;2023;06;CLERMONT-FERRAND;FEMININ;ENSEIGNEMENT A DISTANCE;BAC PROFESSIONNEL;BAC PRO SERV;BAC PRO 30004 ASSISTANC.GEST.ORGANIS.ACTIVITES;2;2;2;0;0;0;0;2;0;0;0;0;2;0
18237.0;2023;06;CLERMONT-FERRAND;FEMININ;ENSEIGNEMENT A DISTANCE;BAC TECHNOLOGIQUE;BAC STMG;BAC STMG RESSOURCES HUMAINES ET COMMUNICATION;2;2;1;1;0;0;0;1;0;0;0;0;1;1
18238.0;2023;06;CLERMONT-FERRAND;FEMININ;FORMATION CONTINUE;BAC PROFESSIONNEL;BAC PRO PROD;BAC PRO 25303 AERONAUTIQUE OPTION SYSTEMES;1;1;1;0;0;0;0;1;0;0;0;0;1;0
18240.0;2023;06;CLERMONT-FERRAND;FEMININ;FORMATION CONTINUE;BAC PROFESSIONNEL;BAC PRO PROD;BAC PRO AG 21113 CGEVV;16;14;12;2;0;0;0;12;0;0;0;0;12;2
18246.0;2023;06;CLERMONT-FERRAND;FEMININ;INDIVIDUEL;BAC GENERAL;BAC GENERAL;BAC GENE 10019 BAC GENERAL;36;35;11;22;2;0;2;11;0;2;5;2;2;24
18249.0;2023;06;CLERMONT-FERRAND;FEMININ;INDIVIDUEL;BAC PROFESSIONNEL;BAC PRO PROD;BAC PRO AG 21114 CONDUITE PRODUCTIONS HORTICOLES;1;1;1;0;0;0;0;1;0;0;0;0;1;0
18256.0;2023;06;CLERMONT-FERRAND;FEMININ;INDIVIDUEL;BAC TECHNOLOGIQUE;BAC ST2S;BAC ST2S SCIENCES & TECHNO. SANTE & SOCIAL;5;4;1;3;0;0;0;1;0;0;0;0;1;3
18265.0;2023;06;CLERMONT-FERRAND;FEMININ;SCOLAIRE;BAC PROFESSIONNEL;BAC PRO PROD;BAC PRO 23003 ARTIS. & M.ART:MARCHANDISAGE VIS.;13;13;11;1;1;1;0;12;0;0;2;7;3;1
18272.0;2023;06;CLERMONT-FERRAND;FEMININ;SCOLAIRE;BAC PROFESSIONNEL;BAC PRO PROD;BAC PRO 24203 METIERS DE LA MODE - VÊTEMENT;34;34;26;7;1;1;0;27;0;0;5;9;13;7
18277.0;2023;06;CLERMONT-FERRAND;FEMININ;SCOLAIRE;BAC PROFESSIONNEL;BAC PRO PROD;BAC PRO 25302 AERONAUTIQUE OPTION AVIONIQUE;1;1;1;0;0;0;0;1;0;0;0;0;1;0
18278.0;2023;06;CLERMONT-FERRAND;FEMININ;SCOLAIRE;BAC PROFESSIONNEL;BAC PRO PROD;BAC PRO 25303 AERONAUTIQUE OPTION SYSTEMES;1;1;1;0;0;0;0;1;0;1;0;0;0;0
18285.0;2023;06;CLERMONT-FERRAND;FEMININ;SCOLAIRE;BAC PROFESSIONNEL;BAC PRO PROD;BAC PRO AG 21113 CGEVV;1;0;0;0;0;0;0;0;0;0;0;0;0;0
18286.0;2023;06;CLERMONT-FERRAND;FEMININ;SCOLAIRE;BAC PROFESSIONNEL;BAC PRO PROD;BAC PRO AG 21114 CONDUITE PRODUCTIONS HORTICOLES;4;4;3;1;0;0;0;3;0;0;1;1;1;1
18293.0;2023;06;CLERMONT-FERRAND;FEMININ;SCOLAIRE;BAC PROFESSIONNEL;BAC PRO PROD;BAC PRO AG 21407 TEC CONS VTE UNIVERS JARDINERIE;7;6;5;1;0;0;0;5;0;0;0;2;3;1
18314.0;2023;06;CLERMONT-FERRAND;FEMININ;SCOLAIRE;BAC PROFESSIONNEL;BAC PRO SERV;BAC PRO 33604 METIERS DE LA COIFFURE;17;17;15;2;0;0;0;15;0;4;6;3;2;2
18315.0;2023;06;CLERMONT-FERRAND;FEMININ;SCOLAIRE;BAC PROFESSIONNEL;BAC PRO SERV;BAC PRO 34304 HYGIENE PROPRETE STERILISATION;13;13;10;3;0;0;0;10;0;0;1;3;6;3
18324.0;2023;06;CLERMONT-FERRAND;FEMININ;SCOLAIRE;BAC TECHNOLOGIQUE;BAC STI2D;BAC STI2D INNOVATION TECHNO.  ET ECO CONCEPTION;9;9;7;0;2;1;1;8;0;0;1;3;4;1
18325.0;2023;06;CLERMONT-FERRAND;FEMININ;SCOLAIRE;BAC TECHNOLOGIQUE;BAC STI2D;BAC STI2D SYSTÈME D'INFORMATION  ET NUMERIQUE;7;7;7;0;0;0;0;7;0;0;2;4;1;0
18328.0;2023;06;CLERMONT-FERRAND;FEMININ;SCOLAIRE;BAC TECHNOLOGIQUE;BAC STMG;BAC STMG GESTION ET FINANCE;93;93;73;2;18;10;8;83;0;2;11;26;44;10
18333.0;2023;06;CLERMONT-FERRAND;MASCULIN;APPRENTISSAGE;BAC PROFESSIONNEL;BAC PRO PROD;BAC PRO 22106 CUISINE;1;1;1;0;0;0;0;1;0;0;0;1;0;0
18340.0;2023;06;CLERMONT-FERRAND;MASCULIN;APPRENTISSAGE;BAC PROFESSIONNEL;BAC PRO PROD;BAC PRO 23304 AMENAGEMENT FINITION BATIMENT;6;6;5;0;1;0;1;5;0;1;0;2;2;1
18349.0;2023;06;CLERMONT-FERRAND;MASCULIN;APPRENTISSAGE;BAC PROFESSIONNEL;BAC PRO PROD;BAC PRO 25220 MAINT.MATERIELS OPT.B TP MANUT.;7;7;6;1;0;0;0;6;0;0;0;2;4;1
18351.0;2023;06;CLERMONT-FERRAND;MASCULIN;APPRENTISSAGE;BAC PROFESSIONNEL;BAC PRO PROD;BAC PRO 25302 AERONAUTIQUE OPTION AVIONIQUE;3;3;3;0;0;0;0;3;0;0;2;1;0;0
18352.0;2023;06;CLERMONT-FERRAND;MASCULIN;APPRENTISSAGE;BAC PROFESSIONNEL;BAC PRO PROD;BAC PRO 25303 AERONAUTIQUE OPTION SYSTEMES;5;5;5;0;0;0;0;5;0;2;2;1;0;0
18354.0;2023;06;CLERMONT-FERRAND;MASCULIN;APPRENTISSAGE;BAC PROFESSIONNEL;BAC PRO PROD;BAC PRO 25408 REPARATION DES CARROSSERIES;19;18;10;7;1;0;1;10;0;0;1;3;6;8
18355.0;2023;06;CLERMONT-FERRAND;MASCULIN;APPRENTISSAGE;BAC PROFESSIONNEL;BAC PRO PROD;BAC PRO 25411 TECH.CHAUDRONNERIE INDUSTRIELLE;25;25;15;8;2;1;1;16;0;4;3;2;7;9
18362.0;2023;06;CLERMONT-FERRAND;MASCULIN;APPRENTISSAGE;BAC PROFESSIONNEL;BAC PRO PROD;BAC PRO AG 21004 CGEA;27;27;20;7;0;0;0;20;0;1;3;2;14;7
18380.0;2023;06;CLERMONT-FERRAND;MASCULIN;FORMATION CONTINUE;BAC PROFESSIONNEL;BAC PRO PROD;BAC PRO 25510 METIERS ELECT. ENVIRON. CONNECTES;1;1;1;0;0;0;0;1;0;1;0;0;0;0
18386.0;2023;06;CLERMONT-FERRAND;MASCULIN;INDIVIDUEL;BAC PROFESSIONNEL;BAC PRO PROD;BAC PRO 22106 CUISINE;1;0;0;0;0;0;0;0;0;0;0;0;0;0
18388.0;2023;06;CLERMONT-FERRAND;MASCULIN;INDIVIDUEL;BAC PROFESSIONNEL;BAC PRO PROD;BAC PRO 25214 MAINT.VEHIC.OPTA VOIT.PARTICUL.;1;1;1;0;0;0;0;1;0;0;0;0;1;0
18394.0;2023;06;CLERMONT-FERRAND;MASCULIN;INDIVIDUEL;BAC PROFESSIONNEL;BAC PRO PROD;BAC PRO AG 21405 AMENAGEMENTS PAYSAGERS;1;0;0;0;0;0;0;0;0;0;0;0;0;0
18402.0;2023;06;CLERMONT-FERRAND;MASCULIN;INDIVIDUEL;BAC TECHNOLOGIQUE;BAC STI2D;BAC STI2D ENERGIES  ET ENVIRONNEMENT;2;2;0;2;0;0;0;0;0;0;0;0;0;2
18405.0;2023;06;CLERMONT-FERRAND;MASCULIN;INDIVIDUEL;BAC TECHNOLOGIQUE;BAC STMG;BAC STMG MERCATIQUE (MARKETING);6;6;0;6;0;0;0;0;0;0;0;0;0;6
18406.0;2023;06;CLERMONT-FERRAND;MASCULIN;INDIVIDUEL;BAC TECHNOLOGIQUE;BAC STMG;BAC STMG RESSOURCES HUMAINES ET COMMUNICATION;3;3;1;2;0;0;0;1;0;0;0;1;0;2
18409.0;2023;06;CLERMONT-FERRAND;MASCULIN;SCOLAIRE;BAC PROFESSIONNEL;BAC PRO PROD;BACPRO 20002 ETUD.DEFINITION PRDTS INDUSTRIEL;8;8;5;3;0;0;0;5;0;0;0;3;2;3
18412.0;2023;06;CLERMONT-FERRAND;MASCULIN;SCOLAIRE;BAC PROFESSIONNEL;BAC PRO PROD;BAC PRO 22106 CUISINE;75;75;62;10;3;3;0;65;0;1;12;19;33;10
18415.0;2023;06;CLERMONT-FERRAND;MASCULIN;SCOLAIRE;BAC PROFESSIONNEL;BAC PRO PROD;BAC PRO 22703 TECHN.INSTALL.SYST.ENERG.CLIMATI;25;25;22;3;0;0;0;22;0;0;2;11;9;3
18417.0;2023;06;CLERMONT-FERRAND;MASCULIN;SCOLAIRE;BAC PROFESSIONNEL;BAC PRO PROD;BAC PRO 23003 ARTIS. & M.ART:MARCHANDISAGE VIS.;3;3;3;0;0;0;0;3;0;0;0;0;3;0
18419.0;2023;06;CLERMONT-FERRAND;MASCULIN;SCOLAIRE;BAC PROFESSIONNEL;BAC PRO PROD;BAC PRO 23005 TECHN. ETUDES BAT B ASSIST.ARCHI.;6;6;3;3;0;0;0;3;0;0;1;0;2;3
18428.0;2023;06;CLERMONT-FERRAND;MASCULIN;SCOLAIRE;BAC PROFESSIONNEL;BAC PRO PROD;BAC PRO 25007 MAINTENANCE EQUIPEMENTS INDUST.;107;107;80;21;6;5;1;85;0;2;12;32;39;22
18433.0;2023;06;CLERMONT-FERRAND;MASCULIN;SCOLAIRE;BAC PROFESSIONNEL;BAC PRO PROD;BAC PRO 25220 MAINT.MATERIELS OPT.B TP MANUT.;10;10;9;0;1;1;0;10;0;1;3;3;3;0
18437.0;2023;06;CLERMONT-FERRAND;MASCULIN;SCOLAIRE;BAC PROFESSIONNEL;BAC PRO PROD;BAC PRO 25304 AERONAUTIQUE OPTION STRUCTURE;16;16;7;8;1;1;0;8;0;0;0;0;8;8
18439.0;2023;06;CLERMONT-FERRAND;MASCULIN;SCOLAIRE;BAC PROFESSIONNEL;BAC PRO PROD;BAC PRO 25410 CONSTRUCTION DES CARROSSERIES;6;6;6;0;0;0;0;6;0;0;1;4;1;0
18440.0;2023;06;CLERMONT-FERRAND;MASCULIN;SCOLAIRE;BAC PROFESSIONNEL;BAC PRO PROD;BAC PRO 25411 TECH.CHAUDRONNERIE INDUSTRIELLE;57;57;51;5;1;0;1;51;0;3;8;19;21;6
18446.0;2023;06;CLERMONT-FERRAND;MASCULIN;SCOLAIRE;BAC PROFESSIONNEL;BAC PRO PROD;BAC PRO AG 21001 AGRO-EQUIPEMENT;29;29;23;6;0;0;0;23;0;1;1;10;11;6
18449.0;2023;06;CLERMONT-FERRAND;MASCULIN;SCOLAIRE;BAC PROFESSIONNEL;BAC PRO PROD;BAC PRO AG 21203 TECHN CONSEIL DE VENTE ANIMAL;11;11;11;0;0;0;0;11;0;0;1;4;6;0
18450.0;2023;06;CLERMONT-FERRAND;MASCULIN;SCOLAIRE;BAC PROFESSIONNEL;BAC PRO PROD;BAC PRO AG 21210 COND GEST ENTR CANIN ET FELIN;3;3;3;0;0;0;0;3;0;0;0;2;1;0
18451.0;2023;06;CLERMONT-FERRAND;MASCULIN;SCOLAIRE;BAC PROFESSIONNEL;BAC PRO PROD;BAC PRO AG 21211 COND GEST ENTR HIPPIQUE;4;4;4;0;0;0;0;4;0;0;1;3;0;0
18464.0;2023;06;CLERMONT-FERRAND;MASCULIN;SCOLAIRE;BAC PROFESSIONNEL;BAC PRO SERV;BAC PRO 32207 REAL.PR.IMPR.PLURI.OPTA.PR.GRAPH.;9;9;8;1;0;0;0;8;0;1;1;2;4;1
18465.0;2023;06;CLERMONT-FERRAND;MASCULIN;SCOLAIRE;BAC PROFESSIONNEL;BAC PRO SERV;BAC PRO 32208 REAL.PR.IMPR.PLURI.OPTB.PR.IMPR.;6;6;4;0;2;2;0;6;0;0;1;3;2;0
18471.0;2023;06;CLERMONT-FERRAND;MASCULIN;SCOLAIRE;BAC PROFESSIONNEL;BAC PRO SERV;BAC PRO 33101 OPTIQUE LUNETTERIE;5;5;4;0;1;1;0;5;0;0;1;1;3;0
18472.0;2023;06;CLERMONT-FERRAND;MASCULIN;SCOLAIRE;BAC PROFESSIONNEL;BAC PRO SERV;BAC PRO 33104 TECHNICIEN EN PROTHESE DENTAIRE;1;1;1;0;0;0;0;1;0;0;0;0;1;0
18485.0;2023;06;CLERMONT-FERRAND;MASCULIN;SCOLAIRE;BAC TECHNOLOGIQUE;BAC STI2D;BAC STI2D SYSTÈME D'INFORMATION  ET NUMERIQUE;151;151;140;2;9;5;4;145;0;4;25;61;55;6
18486.0;2023;06;CLERMONT-FERRAND;MASCULIN;SCOLAIRE;BAC TECHNOLOGIQUE;BAC STL;BAC STL BIOCHIM.-BIOLOGIE-BIOTECHNOL.;41;41;39;0;2;1;1;40;0;1;8;16;15;1
18488.0;2023;06;CLERMONT-FERRAND;MASCULIN;SCOLAIRE;BAC TECHNOLOGIQUE;BAC STMG;BAC STMG GESTION ET FINANCE;130;130;94;4;32;25;7;119;0;0;4;31;84;11
18490.0;2023;06;CLERMONT-FERRAND;MASCULIN;SCOLAIRE;BAC TECHNOLOGIQUE;BAC STMG;BAC STMG RESSOURCES HUMAINES ET COMMUNICATION;118;118;67;19;32;20;12;87;0;0;5;18;64;31
18497.0;2023;27;CORSE;FEMININ;APPRENTISSAGE;BAC PROFESSIONNEL;BAC PRO SERV;BAC PRO 33403 COMMERC. SERVICES EN RESTAURATION;2;2;2;0;0;0;0;2;0;0;0;0;2;0
18504.0;2023;27;CORSE;FEMININ;INDIVIDUEL;BAC PROFESSIONNEL;BAC PRO PROD;BAC PRO AG 21113 CGEVV;1;1;0;1;0;0;0;0;0;0;0;0;0;1
18525.0;2023;27;CORSE;FEMININ;SCOLAIRE;BAC PROFESSIONNEL;BAC PRO SERV;BAC PRO 31214 MET.COM.VEN.OP.B PR.CL.VA.OF.COM.;9;9;9;0;0;0;0;9;0;1;1;3;4;0
18526.0;2023;27;CORSE;FEMININ;SCOLAIRE;BAC PROFESSIONNEL;BAC PRO SERV;BAC PRO 33003 ACC.SOINS-S.PERS. OPT.A DOMICILE;9;9;7;2;0;0;0;7;0;0;1;3;3;2
18541.0;2023;27;CORSE;MASCULIN;APPRENTISSAGE;BAC PROFESSIONNEL;BAC PRO PROD;BAC PRO 22106 CUISINE;7;7;2;3;2;2;0;4;0;0;0;1;3;3
18546.0;2023;27;CORSE;MASCULIN;APPRENTISSAGE;BAC PROFESSIONNEL;BAC PRO PROD;BAC PRO 25214 MAINT.VEHIC.OPTA VOIT.PARTICUL.;8;7;7;0;0;0;0;7;0;2;1;3;1;0
18548.0;2023;27;CORSE;MASCULIN;APPRENTISSAGE;BAC PROFESSIONNEL;BAC PRO PROD;BAC PRO 25513 SYST.NUM.OPT.A SURETE SECURITE;1;1;1;0;0;0;0;1;0;1;0;0;0;0
18549.0;2023;27;CORSE;MASCULIN;APPRENTISSAGE;BAC PROFESSIONNEL;BAC PRO SERV;BAC PRO 30004 ASSISTANC.GEST.ORGANIS.ACTIVITES;3;3;2;1;0;0;0;2;0;0;1;0;1;1
18555.0;2023;27;CORSE;MASCULIN;ENSEIGNEMENT A DISTANCE;BAC GENERAL;BAC GENERAL;BAC GENE 10019 BAC GENERAL;4;4;2;0;2;0;2;2;0;1;0;0;1;2
18559.0;2023;27;CORSE;MASCULIN;INDIVIDUEL;BAC GENERAL;BAC GENERAL;BAC GENE 10019 BAC GENERAL;7;7;2;3;2;1;1;3;0;0;0;1;2;4
18573.0;2023;27;CORSE;MASCULIN;SCOLAIRE;BAC PROFESSIONNEL;BAC PRO PROD;BAC PRO 25406 OUVRAGES DU BATIMENT METALLERIE;10;10;10;0;0;0;0;10;0;0;0;2;8;0
18579.0;2023;27;CORSE;MASCULIN;SCOLAIRE;BAC PROFESSIONNEL;BAC PRO PROD;BAC PRO AG 21004 CGEA;6;6;3;3;0;0;0;3;0;0;0;1;2;3
18589.0;2023;27;CORSE;MASCULIN;SCOLAIRE;BAC PROFESSIONNEL;BAC PRO SERV;BAC PRO 31214 MET.COM.VEN.OP.B PR.CL.VA.OF.COM.;13;13;11;1;1;1;0;12;0;1;2;5;4;1
18590.0;2023;27;CORSE;MASCULIN;SCOLAIRE;BAC PROFESSIONNEL;BAC PRO SERV;BAC PRO 33004 ACC.SOINS-S.PERS. OPT.EN STRUCTUR;6;6;6;0;0;0;0;6;0;0;0;4;2;0
18594.0;2023;27;CORSE;MASCULIN;SCOLAIRE;BAC PROFESSIONNEL;BAC PRO SERV;BAC PRO AG 33002 SERV PERS TERRIT;1;1;1;0;0;0;0;1;0;0;0;0;1;0
18595.0;2023;27;CORSE;MASCULIN;SCOLAIRE;BAC TECHNOLOGIQUE;BAC ST2S;BAC ST2S SCIENCES & TECHNO. SANTE & SOCIAL;15;15;12;0;3;2;1;14;0;0;1;6;7;1
18599.0;2023;27;CORSE;MASCULIN;SCOLAIRE;BAC TECHNOLOGIQUE;BAC STI2D;BAC STI2D ENERGIES  ET ENVIRONNEMENT;11;11;7;0;4;4;0;11;0;0;1;2;8;0
18602.0;2023;27;CORSE;MASCULIN;SCOLAIRE;BAC TECHNOLOGIQUE;BAC STL;BAC STL BIOCHIM.-BIOLOGIE-BIOTECHNOL.;5;5;2;0;3;1;2;3;0;0;0;2;1;2
18613.0;2023;24;CRETEIL;FEMININ;APPRENTISSAGE;BAC PROFESSIONNEL;BAC PRO PROD;BAC PRO 25007 MAINTENANCE EQUIPEMENTS INDUST.;1;1;0;1;0;0;0;0;0;0;0;0;0;1
18623.0;2023;24;CRETEIL;FEMININ;APPRENTISSAGE;BAC PROFESSIONNEL;BAC PRO SERV;BAC PRO 31213 MET.COM.VEN.OP.A ANI.GES.ESP.COM.;39;39;30;3;6;4;2;34;0;0;8;8;18;5
18624.0;2023;24;CRETEIL;FEMININ;APPRENTISSAGE;BAC PROFESSIONNEL;BAC PRO SERV;BAC PRO 31214 MET.COM.VEN.OP.B PR.CL.VA.OF.COM.;6;6;5;1;0;0;0;5;0;1;2;1;1;1
18626.0;2023;24;CRETEIL;FEMININ;APPRENTISSAGE;BAC PROFESSIONNEL;BAC PRO SERV;BAC PRO 33104 TECHNICIEN EN PROTHESE DENTAIRE;5;5;4;1;0;0;0;4;0;0;1;1;2;1
18630.0;2023;24;CRETEIL;FEMININ;APPRENTISSAGE;BAC PROFESSIONNEL;BAC PRO SERV;BAC PRO AG 33002 SERV PERS TERRIT;3;3;3;0;0;0;0;3;0;0;0;0;3;0
18637.0;2023;24;CRETEIL;FEMININ;ENSEIGNEMENT A DISTANCE;BAC PROFESSIONNEL;BAC PRO SERV;BAC PRO 33603 ESTHETIQUE COSMETIQUE PARFUMERIE;2;0;0;0;0;0;0;0;0;0;0;0;0;0
18638.0;2023;24;CRETEIL;FEMININ;ENSEIGNEMENT A DISTANCE;BAC TECHNOLOGIQUE;BAC ST2S;BAC ST2S SCIENCES & TECHNO. SANTE & SOCIAL;7;7;3;3;1;1;0;4;0;0;0;0;4;3
18648.0;2023;24;CRETEIL;FEMININ;FORMATION CONTINUE;BAC PROFESSIONNEL;BAC PRO SERV;BAC PRO 30004 ASSISTANC.GEST.ORGANIS.ACTIVITES;9;9;6;3;0;0;0;6;0;2;1;0;3;3
18649.0;2023;24;CRETEIL;FEMININ;FORMATION CONTINUE;BAC PROFESSIONNEL;BAC PRO SERV;BAC PRO 31213 MET.COM.VEN.OP.A ANI.GES.ESP.COM.;2;2;2;0;0;0;0;2;0;0;0;1;1;0
18650.0;2023;24;CRETEIL;FEMININ;FORMATION CONTINUE;BAC PROFESSIONNEL;BAC PRO SERV;BAC PRO 31214 MET.COM.VEN.OP.B PR.CL.VA.OF.COM.;1;1;1;0;0;0;0;1;0;1;0;0;0;0
18651.0;2023;24;CRETEIL;FEMININ;FORMATION CONTINUE;BAC PROFESSIONNEL;BAC PRO SERV;BAC PRO 32304 PHOTOGRAPHIE;3;3;3;0;0;0;0;3;0;1;0;1;1;0
18662.0;2023;24;CRETEIL;FEMININ;INDIVIDUEL;BAC PROFESSIONNEL;BAC PRO SERV;BAC PRO 31212 METIERS DE L'ACCUEIL;6;4;2;2;0;0;0;2;0;0;0;0;2;2
18669.0;2023;24;CRETEIL;FEMININ;INDIVIDUEL;BAC PROFESSIONNEL;BAC PRO SERV;BAC PRO 33603 ESTHETIQUE COSMETIQUE PARFUMERIE;2;1;0;1;0;0;0;0;0;0;0;0;0;1
18673.0;2023;24;CRETEIL;FEMININ;INDIVIDUEL;BAC TECHNOLOGIQUE;BAC STHR;BAC STHR SC.&TEC. HOTELLERIE-RESTAURATION;2;2;0;2;0;0;0;0;0;0;0;0;0;2
18677.0;2023;24;CRETEIL;FEMININ;INDIVIDUEL;BAC TECHNOLOGIQUE;BAC STMG;BAC STMG GESTION ET FINANCE;12;12;5;6;1;0;1;5;0;2;2;0;1;7
18699.0;2023;24;CRETEIL;FEMININ;SCOLAIRE;BAC PROFESSIONNEL;BAC PRO PROD;BAC PRO 25006 MICROTECHNIQUES;1;1;1;0;0;0;0;1;0;0;1;0;0;0
18704.0;2023;24;CRETEIL;FEMININ;SCOLAIRE;BAC PROFESSIONNEL;BAC PRO PROD;BAC PRO 25303 AERONAUTIQUE OPTION SYSTEMES;1;1;1;0;0;0;0;1;0;0;1;0;0;0
18705.0;2023;24;CRETEIL;FEMININ;SCOLAIRE;BAC PROFESSIONNEL;BAC PRO PROD;BAC PRO 25304 AERONAUTIQUE OPTION STRUCTURE;1;1;1;0;0;0;0;1;0;1;0;0;0;0
18711.0;2023;24;CRETEIL;FEMININ;SCOLAIRE;BAC PROFESSIONNEL;BAC PRO PROD;BAC PRO AG 21114 CONDUITE PRODUCTIONS HORTICOLES;9;9;6;3;0;0;0;6;0;0;2;1;3;3
18720.0;2023;24;CRETEIL;FEMININ;SCOLAIRE;BAC PROFESSIONNEL;BAC PRO SERV;BAC PRO 31212 METIERS DE L'ACCUEIL;413;413;327;57;29;24;5;351;0;26;69;120;136;62
18730.0;2023;24;CRETEIL;FEMININ;SCOLAIRE;BAC PROFESSIONNEL;BAC PRO SERV;BAC PRO 33101 OPTIQUE LUNETTERIE;26;26;23;1;2;0;2;23;0;0;5;8;10;3
18735.0;2023;24;CRETEIL;FEMININ;SCOLAIRE;BAC PROFESSIONNEL;BAC PRO SERV;BAC PRO 34303 GEST. POLLUTIONS PROTEC. ENVIRON.;1;1;0;1;0;0;0;0;0;0;0;0;0;1
18747.0;2023;24;CRETEIL;FEMININ;SCOLAIRE;BAC TECHNOLOGIQUE;BAC STL;BAC STL BIOCHIM.-BIOLOGIE-BIOTECHNOL.;160;160;130;10;20;8;12;138;0;5;20;40;73;22
18748.0;2023;24;CRETEIL;FEMININ;SCOLAIRE;BAC TECHNOLOGIQUE;BAC STL;BAC STL SCIENCES PHYSIQUES CHIMIQUES  EN LABORAT.;65;65;44;6;15;11;4;55;0;1;6;10;38;10
18750.0;2023;24;CRETEIL;FEMININ;SCOLAIRE;BAC TECHNOLOGIQUE;BAC STMG;BAC STMG MERCATIQUE (MARKETING);1876;1876;1411;117;348;287;61;1698;2;17;156;542;981;178
18754.0;2023;24;CRETEIL;MASCULIN;APPRENTISSAGE;BAC PROFESSIONNEL;BAC PRO PROD;BAC PRO 22106 CUISINE;60;60;42;12;6;3;3;45;0;3;12;14;16;15
18761.0;2023;24;CRETEIL;MASCULIN;APPRENTISSAGE;BAC PROFESSIONNEL;BAC PRO PROD;BAC PRO 25007 MAINTENANCE EQUIPEMENTS INDUST.;43;43;36;4;3;0;3;36;0;5;8;13;10;7
18771.0;2023;24;CRETEIL;MASCULIN;APPRENTISSAGE;BAC PROFESSIONNEL;BAC PRO PROD;BAC PRO 25411 TECH.CHAUDRONNERIE INDUSTRIELLE;11;11;8;0;3;1;2;9;0;0;0;3;6;2
18773.0;2023;24;CRETEIL;MASCULIN;APPRENTISSAGE;BAC PROFESSIONNEL;BAC PRO PROD;BAC PRO 25510 METIERS ELECT. ENVIRON. CONNECTES;237;237;186;30;21;14;7;200;0;30;34;58;78;37
18777.0;2023;24;CRETEIL;MASCULIN;APPRENTISSAGE;BAC PROFESSIONNEL;BAC PRO PROD;BAC PRO AG 21211 COND GEST ENTR HIPPIQUE;4;3;3;0;0;0;0;3;0;0;0;1;2;0
18778.0;2023;24;CRETEIL;MASCULIN;APPRENTISSAGE;BAC PROFESSIONNEL;BAC PRO PROD;BAC PRO AG 21405 AMENAGEMENTS PAYSAGERS;32;28;27;1;0;0;0;27;0;1;1;9;16;1
18796.0;2023;24;CRETEIL;MASCULIN;ENSEIGNEMENT A DISTANCE;BAC TECHNOLOGIQUE;BAC STMG;BAC STMG GESTION ET FINANCE;1;1;1;0;0;0;0;1;0;0;0;0;1;0
18798.0;2023;24;CRETEIL;MASCULIN;ENSEIGNEMENT A DISTANCE;BAC TECHNOLOGIQUE;BAC STMG;BAC STMG RESSOURCES HUMAINES ET COMMUNICATION;2;2;1;1;0;0;0;1;0;0;0;0;1;1
18801.0;2023;24;CRETEIL;MASCULIN;FORMATION CONTINUE;BAC PROFESSIONNEL;BAC PRO PROD;BAC PRO 24301 METIERS DU CUIR : CHAUSSURES;1;1;1;0;0;0;0;1;0;0;1;0;0;0
18825.0;2023;24;CRETEIL;MASCULIN;INDIVIDUEL;BAC PROFESSIONNEL;BAC PRO PROD;BAC PRO 25408 REPARATION DES CARROSSERIES;1;1;1;0;0;0;0;1;0;0;0;0;1;0
18826.0;2023;24;CRETEIL;MASCULIN;INDIVIDUEL;BAC PROFESSIONNEL;BAC PRO PROD;BAC PRO 25509 TECHNIC. FROID CONDITIONNEMT AIR;1;1;0;1;0;0;0;0;0;0;0;0;0;1
18830.0;2023;24;CRETEIL;MASCULIN;INDIVIDUEL;BAC PROFESSIONNEL;BAC PRO PROD;BAC PRO AG 21004 CGEA;1;0;0;0;0;0;0;0;0;0;0;0;0;0
18832.0;2023;24;CRETEIL;MASCULIN;INDIVIDUEL;BAC PROFESSIONNEL;BAC PRO PROD;BAC PRO AG 21405 AMENAGEMENTS PAYSAGERS;2;0;0;0;0;0;0;0;0;0;0;0;0;0
18838.0;2023;24;CRETEIL;MASCULIN;INDIVIDUEL;BAC PROFESSIONNEL;BAC PRO SERV;BAC PRO 32303 ART.& MET.ART:COM.VIS.VIS.PLURI-M;1;1;0;1;0;0;0;0;0;0;0;0;0;1
18841.0;2023;24;CRETEIL;MASCULIN;INDIVIDUEL;BAC TECHNOLOGIQUE;BAC S2TMD;BAC S2TMD MUSIQUE;1;1;1;0;0;0;0;1;0;0;0;1;0;0
18846.0;2023;24;CRETEIL;MASCULIN;INDIVIDUEL;BAC TECHNOLOGIQUE;BAC STI2D;BAC STI2D ARCHITECTURE ET CONSTRUCTION;5;5;0;4;1;0;1;0;0;0;0;0;0;5
18861.0;2023;24;CRETEIL;MASCULIN;SCOLAIRE;BAC PROFESSIONNEL;BAC PRO PROD;BAC PRO 22703 TECHN.INSTALL.SYST.ENERG.CLIMATI;146;146;84;53;9;7;2;91;0;1;9;33;48;55
18864.0;2023;24;CRETEIL;MASCULIN;SCOLAIRE;BAC PROFESSIONNEL;BAC PRO PROD;BAC PRO 23004 TECHN. ETUDES BAT.A ETUDES & ECO.;52;52;40;12;0;0;0;40;0;0;2;15;23;12
18874.0;2023;24;CRETEIL;MASCULIN;SCOLAIRE;BAC PROFESSIONNEL;BAC PRO PROD;BAC PRO 23408 Etude et réalisation d'agencement;5;5;4;1;0;0;0;4;0;0;1;1;2;1
18884.0;2023;24;CRETEIL;MASCULIN;SCOLAIRE;BAC PROFESSIONNEL;BAC PRO PROD;BAC PRO 25216 MAINT.VEHIC.OPTC MOTOCYCLES;58;58;34;20;4;4;0;38;0;2;3;12;21;20
18885.0;2023;24;CRETEIL;MASCULIN;SCOLAIRE;BAC PROFESSIONNEL;BAC PRO PROD;BAC PRO 25219 MAINT.MATERIELS OPT.A AGRICOLES;3;3;3;0;0;0;0;3;0;0;0;1;2;0
18888.0;2023;24;CRETEIL;MASCULIN;SCOLAIRE;BAC PROFESSIONNEL;BAC PRO PROD;BAC PRO 25302 AERONAUTIQUE OPTION AVIONIQUE;23;23;20;1;2;1;1;21;0;2;4;9;6;2
18892.0;2023;24;CRETEIL;MASCULIN;SCOLAIRE;BAC PROFESSIONNEL;BAC PRO PROD;BAC PRO 25408 REPARATION DES CARROSSERIES;42;42;29;10;3;2;1;31;0;1;5;14;11;11
18893.0;2023;24;CRETEIL;MASCULIN;SCOLAIRE;BAC PROFESSIONNEL;BAC PRO PROD;BAC PRO 25410 CONSTRUCTION DES CARROSSERIES;13;13;9;3;1;1;0;10;0;0;2;3;5;3
18908.0;2023;24;CRETEIL;MASCULIN;SCOLAIRE;BAC PROFESSIONNEL;BAC PRO SERV;BAC PRO 31107 CONDUCT. TRANSP.ROUT.MARCHANDISES;38;38;32;6;0;0;0;32;0;3;4;20;5;6
18910.0;2023;24;CRETEIL;MASCULIN;SCOLAIRE;BAC PROFESSIONNEL;BAC PRO SERV;BAC PRO 31212 METIERS DE L'ACCUEIL;236;236;149;67;20;15;5;164;0;7;19;54;84;72
18914.0;2023;24;CRETEIL;MASCULIN;SCOLAIRE;BAC PROFESSIONNEL;BAC PRO SERV;BAC PRO 32207 REAL.PR.IMPR.PLURI.OPTA.PR.GRAPH.;36;36;26;8;2;2;0;28;0;2;5;8;13;8
18918.0;2023;24;CRETEIL;MASCULIN;SCOLAIRE;BAC PROFESSIONNEL;BAC PRO SERV;BAC PRO 33002 SERVICES DE PROXIMITE  VIE LOCAL;1;1;0;1;0;0;0;0;0;0;0;0;0;1
18926.0;2023;24;CRETEIL;MASCULIN;SCOLAIRE;BAC PROFESSIONNEL;BAC PRO SERV;BAC PRO 34304 HYGIENE PROPRETE STERILISATION;5;5;2;2;1;0;1;2;0;0;1;1;0;3
18929.0;2023;24;CRETEIL;MASCULIN;SCOLAIRE;BAC TECHNOLOGIQUE;BAC ST2S;BAC ST2S SCIENCES & TECHNO. SANTE & SOCIAL;225;225;164;22;39;34;5;198;0;5;15;62;116;27
18941.0;2023;24;CRETEIL;MASCULIN;SCOLAIRE;BAC TECHNOLOGIQUE;BAC STMG;BAC STMG RESSOURCES HUMAINES ET COMMUNICATION;643;643;348;105;190;150;40;498;0;1;12;86;399;145
18944.0;2023;07;DIJON;FEMININ;APPRENTISSAGE;BAC PROFESSIONNEL;BAC PRO PROD;BACPRO 23103 TECHNICIEN GEOMETRE-TOPOGRAPHE;2;2;2;0;0;0;0;2;0;1;1;0;0;0
18946.0;2023;07;DIJON;FEMININ;APPRENTISSAGE;BAC PROFESSIONNEL;BAC PRO PROD;BAC PRO 23303 MENUISERIE ALUMINIUM-VERRE;1;1;1;0;0;0;0;1;0;1;0;0;0;0
18948.0;2023;07;DIJON;FEMININ;APPRENTISSAGE;BAC PROFESSIONNEL;BAC PRO PROD;BAC PRO 25007 MAINTENANCE EQUIPEMENTS INDUST.;1;1;0;1;0;0;0;0;0;0;0;0;0;1
18950.0;2023;07;DIJON;FEMININ;APPRENTISSAGE;BAC PROFESSIONNEL;BAC PRO PROD;BAC PRO 25214 MAINT.VEHIC.OPTA VOIT.PARTICUL.;3;3;3;0;0;0;0;3;0;1;1;0;1;0
18959.0;2023;07;DIJON;FEMININ;APPRENTISSAGE;BAC PROFESSIONNEL;BAC PRO PROD;BAC PRO AG 22108 TEC CONS VTE ALIMENTATION (PAB);3;3;2;1;0;0;0;2;0;0;0;0;2;1
18961.0;2023;07;DIJON;FEMININ;APPRENTISSAGE;BAC PROFESSIONNEL;BAC PRO SERV;BAC PRO 31106 LOGISTIQUE;3;3;3;0;0;0;0;3;0;0;1;2;0;0
18969.0;2023;07;DIJON;FEMININ;ENSEIGNEMENT A DISTANCE;BAC PROFESSIONNEL;BAC PRO SERV;BAC PRO 30004 ASSISTANC.GEST.ORGANIS.ACTIVITES;2;1;0;1;0;0;0;0;0;0;0;0;0;1
18973.0;2023;07;DIJON;FEMININ;ENSEIGNEMENT A DISTANCE;BAC TECHNOLOGIQUE;BAC ST2S;BAC ST2S SCIENCES & TECHNO. SANTE & SOCIAL;6;6;2;1;3;1;2;3;0;0;0;0;3;3
18990.0;2023;07;DIJON;FEMININ;INDIVIDUEL;BAC TECHNOLOGIQUE;BAC ST2S;BAC ST2S SCIENCES & TECHNO. SANTE & SOCIAL;5;5;0;4;1;0;1;0;0;0;0;0;0;5
18994.0;2023;07;DIJON;FEMININ;INDIVIDUEL;BAC TECHNOLOGIQUE;BAC STMG;BAC STMG RESSOURCES HUMAINES ET COMMUNICATION;5;5;0;3;2;2;0;2;0;0;0;0;2;3
18998.0;2023;07;DIJON;FEMININ;SCOLAIRE;BAC PROFESSIONNEL;BAC PRO PROD;BAC PRO 22004 PROC. CHIMIE EAU PAPIERS-CARTONS;1;1;1;0;0;0;0;1;0;0;1;0;0;0
19004.0;2023;07;DIJON;FEMININ;SCOLAIRE;BAC PROFESSIONNEL;BAC PRO PROD;BAC PRO 23208 METIERS ET ARTS DE LA PIERRE;1;1;1;0;0;0;0;1;0;1;0;0;0;0
19019.0;2023;07;DIJON;FEMININ;SCOLAIRE;BAC PROFESSIONNEL;BAC PRO PROD;BAC PRO 25513 SYST.NUM.OPT.A SURETE SECURITE;1;1;1;0;0;0;0;1;0;0;0;0;1;0
19027.0;2023;07;DIJON;FEMININ;SCOLAIRE;BAC PROFESSIONNEL;BAC PRO PROD;BAC PRO AG 21211 COND GEST ENTR HIPPIQUE;31;30;29;1;0;0;0;29;0;0;2;11;16;1
19028.0;2023;07;DIJON;FEMININ;SCOLAIRE;BAC PROFESSIONNEL;BAC PRO PROD;BAC PRO AG 21405 AMENAGEMENTS PAYSAGERS;4;3;3;0;0;0;0;3;0;0;0;1;2;0
19034.0;2023;07;DIJON;FEMININ;SCOLAIRE;BAC PROFESSIONNEL;BAC PRO SERV;BAC PRO 31213 MET.COM.VEN.OP.A ANI.GES.ESP.COM.;232;232;186;37;9;6;3;192;0;4;40;72;76;40
19052.0;2023;07;DIJON;FEMININ;SCOLAIRE;BAC TECHNOLOGIQUE;BAC ST2S;BAC ST2S SCIENCES & TECHNO. SANTE & SOCIAL;418;418;366;8;44;29;15;395;0;13;52;141;189;23
19057.0;2023;07;DIJON;FEMININ;SCOLAIRE;BAC TECHNOLOGIQUE;BAC STI2D;BAC STI2D ENERGIES  ET ENVIRONNEMENT;5;5;5;0;0;0;0;5;0;1;1;1;2;0
19063.0;2023;07;DIJON;FEMININ;SCOLAIRE;BAC TECHNOLOGIQUE;BAC STMG;BAC STMG MERCATIQUE (MARKETING);397;397;319;8;70;47;23;366;0;5;29;110;222;31
19064.0;2023;07;DIJON;FEMININ;SCOLAIRE;BAC TECHNOLOGIQUE;BAC STMG;BAC STMG RESSOURCES HUMAINES ET COMMUNICATION;336;336;245;22;69;42;27;287;0;1;18;80;188;49
19071.0;2023;07;DIJON;MASCULIN;APPRENTISSAGE;BAC PROFESSIONNEL;BAC PRO PROD;BAC PRO 23102 TRAVAUX PUBLICS;19;19;19;0;0;0;0;19;0;0;7;9;3;0
19072.0;2023;07;DIJON;MASCULIN;APPRENTISSAGE;BAC PROFESSIONNEL;BAC PRO PROD;BACPRO 23103 TECHNICIEN GEOMETRE-TOPOGRAPHE;1;1;0;1;0;0;0;0;0;0;0;0;0;1
19080.0;2023;07;DIJON;MASCULIN;APPRENTISSAGE;BAC PROFESSIONNEL;BAC PRO PROD;BAC PRO 25107 TECHNICIEN OUTILLEUR;1;1;1;0;0;0;0;1;0;0;1;0;0;0
19084.0;2023;07;DIJON;MASCULIN;APPRENTISSAGE;BAC PROFESSIONNEL;BAC PRO PROD;BAC PRO 25219 MAINT.MATERIELS OPT.A AGRICOLES;14;14;11;1;2;1;1;12;0;1;3;1;7;2
19092.0;2023;07;DIJON;MASCULIN;APPRENTISSAGE;BAC PROFESSIONNEL;BAC PRO PROD;BAC PRO AG 21004 CGEA;77;74;53;21;0;0;0;53;0;0;4;17;32;21
19094.0;2023;07;DIJON;MASCULIN;APPRENTISSAGE;BAC PROFESSIONNEL;BAC PRO PROD;BAC PRO AG 21210 COND GEST ENTR CANIN ET FELIN;5;4;3;1;0;0;0;3;0;0;0;1;2;1
19096.0;2023;07;DIJON;MASCULIN;APPRENTISSAGE;BAC PROFESSIONNEL;BAC PRO PROD;BAC PRO AG 21405 AMENAGEMENTS PAYSAGERS;93;92;84;8;0;0;0;84;0;1;11;34;38;8
19099.0;2023;07;DIJON;MASCULIN;APPRENTISSAGE;BAC PROFESSIONNEL;BAC PRO SERV;BAC PRO 31213 MET.COM.VEN.OP.A ANI.GES.ESP.COM.;36;35;22;8;5;4;1;26;0;2;2;5;17;9
19101.0;2023;07;DIJON;MASCULIN;APPRENTISSAGE;BAC PROFESSIONNEL;BAC PRO SERV;BAC PRO 33403 COMMERC. SERVICES EN RESTAURATION;8;7;5;1;1;1;0;6;0;0;1;3;2;1
19116.0;2023;07;DIJON;MASCULIN;INDIVIDUEL;BAC PROFESSIONNEL;BAC PRO PROD;BAC PRO 25007 MAINTENANCE EQUIPEMENTS INDUST.;1;1;1;0;0;0;0;1;0;0;0;0;1;0
19123.0;2023;07;DIJON;MASCULIN;INDIVIDUEL;BAC PROFESSIONNEL;BAC PRO SERV;BAC PRO 30004 ASSISTANC.GEST.ORGANIS.ACTIVITES;1;0;0;0;0;0;0;0;0;0;0;0;0;0
19126.0;2023;07;DIJON;MASCULIN;INDIVIDUEL;BAC PROFESSIONNEL;BAC PRO SERV;BAC PRO 33002 SERVICES DE PROXIMITE  VIE LOCAL;1;1;0;1;0;0;0;0;0;0;0;0;0;1
19127.0;2023;07;DIJON;MASCULIN;INDIVIDUEL;BAC TECHNOLOGIQUE;BAC ST2S;BAC ST2S SCIENCES & TECHNO. SANTE & SOCIAL;1;1;0;1;0;0;0;0;0;0;0;0;0;1
19141.0;2023;07;DIJON;MASCULIN;SCOLAIRE;BAC PROFESSIONNEL;BAC PRO PROD;BAC PRO 22703 TECHN.INSTALL.SYST.ENERG.CLIMATI;24;24;19;5;0;0;0;19;0;0;3;6;10;5
19143.0;2023;07;DIJON;MASCULIN;SCOLAIRE;BAC PROFESSIONNEL;BAC PRO PROD;BAC PRO 23004 TECHN. ETUDES BAT.A ETUDES & ECO.;15;15;6;9;0;0;0;6;0;0;1;2;3;9
19156.0;2023;07;DIJON;MASCULIN;SCOLAIRE;BAC PROFESSIONNEL;BAC PRO PROD;BAC PRO 25007 MAINTENANCE EQUIPEMENTS INDUST.;155;155;121;27;7;4;3;125;0;5;19;41;60;30
19165.0;2023;07;DIJON;MASCULIN;SCOLAIRE;BAC PROFESSIONNEL;BAC PRO PROD;BAC PRO 25303 AERONAUTIQUE OPTION SYSTEMES;7;7;4;2;1;0;1;4;0;1;2;1;0;3
19178.0;2023;07;DIJON;MASCULIN;SCOLAIRE;BAC PROFESSIONNEL;BAC PRO PROD;BAC PRO AG 21114 CONDUITE PRODUCTIONS HORTICOLES;5;5;4;1;0;0;0;4;0;0;0;3;1;1
19181.0;2023;07;DIJON;MASCULIN;SCOLAIRE;BAC PROFESSIONNEL;BAC PRO PROD;BAC PRO AG 21210 COND GEST ENTR CANIN ET FELIN;5;4;3;1;0;0;0;3;0;0;0;1;2;1
19186.0;2023;07;DIJON;MASCULIN;SCOLAIRE;BAC PROFESSIONNEL;BAC PRO PROD;BAC PRO AG 22108 TEC CONS VTE ALIMENTATION (PAB);43;43;40;3;0;0;0;40;0;0;4;11;25;3
19193.0;2023;07;DIJON;MASCULIN;SCOLAIRE;BAC PROFESSIONNEL;BAC PRO SERV;BAC PRO 31214 MET.COM.VEN.OP.B PR.CL.VA.OF.COM.;94;94;67;22;5;5;0;72;0;5;15;20;32;22
19205.0;2023;07;DIJON;MASCULIN;SCOLAIRE;BAC PROFESSIONNEL;BAC PRO SERV;BAC PRO 33604 METIERS DE LA COIFFURE;1;1;1;0;0;0;0;1;0;0;0;0;1;0
19210.0;2023;07;DIJON;MASCULIN;SCOLAIRE;BAC TECHNOLOGIQUE;BAC S2TMD;BAC S2TMD DANSE;1;1;1;0;0;0;0;1;0;0;1;0;0;0
19221.0;2023;07;DIJON;MASCULIN;SCOLAIRE;BAC TECHNOLOGIQUE;BAC STL;BAC STL SCIENCES PHYSIQUES CHIMIQUES  EN LABORAT.;37;37;35;1;1;1;0;36;0;3;11;10;12;1
19225.0;2023;07;DIJON;MASCULIN;SCOLAIRE;BAC TECHNOLOGIQUE;BAC STMG;BAC STMG SYSTEMES D'INFORMATION DE GESTION;20;20;15;0;5;3;2;18;0;0;0;4;14;2
19227.0;2023;08;GRENOBLE;FEMININ;APPRENTISSAGE;BAC PROFESSIONNEL;BAC PRO PROD;BAC PRO 22003 BIO-INDUSTRIES DE TRANSFORMATION;2;2;2;0;0;0;0;2;0;0;1;0;1;0
19236.0;2023;08;GRENOBLE;FEMININ;APPRENTISSAGE;BAC PROFESSIONNEL;BAC PRO PROD;BAC PRO 23405 TECHNICIEN MENUISIER AGENCEUR;1;1;1;0;0;0;0;1;0;0;0;1;0;0
19242.0;2023;08;GRENOBLE;FEMININ;APPRENTISSAGE;BAC PROFESSIONNEL;BAC PRO PROD;BAC PRO 25221 MAINT.MATERIELS OPT.C ESP. VERTS;1;1;1;0;0;0;0;1;0;0;1;0;0;0
19243.0;2023;08;GRENOBLE;FEMININ;APPRENTISSAGE;BAC PROFESSIONNEL;BAC PRO PROD;BAC PRO 25303 AERONAUTIQUE OPTION SYSTEMES;3;3;2;1;0;0;0;2;0;1;0;1;0;1
19257.0;2023;08;GRENOBLE;FEMININ;APPRENTISSAGE;BAC PROFESSIONNEL;BAC PRO SERV;BAC PRO 31214 MET.COM.VEN.OP.B PR.CL.VA.OF.COM.;6;6;5;1;0;0;0;5;0;0;2;2;1;1
19263.0;2023;08;GRENOBLE;FEMININ;ENSEIGNEMENT A DISTANCE;BAC GENERAL;BAC GENERAL;BAC GENE 10019 BAC GENERAL;90;90;61;19;10;5;5;66;1;2;17;17;29;24
19267.0;2023;08;GRENOBLE;FEMININ;ENSEIGNEMENT A DISTANCE;BAC PROFESSIONNEL;BAC PRO SERV;BAC PRO 33004 ACC.SOINS-S.PERS. OPT.EN STRUCTUR;4;2;2;0;0;0;0;2;0;0;0;2;0;0
19268.0;2023;08;GRENOBLE;FEMININ;ENSEIGNEMENT A DISTANCE;BAC PROFESSIONNEL;BAC PRO SERV;BAC PRO 33603 ESTHETIQUE COSMETIQUE PARFUMERIE;1;1;0;1;0;0;0;0;0;0;0;0;0;1
19270.0;2023;08;GRENOBLE;FEMININ;ENSEIGNEMENT A DISTANCE;BAC TECHNOLOGIQUE;BAC STMG;BAC STMG MERCATIQUE (MARKETING);11;11;7;0;4;2;2;9;0;0;0;2;7;2
19281.0;2023;08;GRENOBLE;FEMININ;INDIVIDUEL;BAC PROFESSIONNEL;BAC PRO SERV;BAC PRO 31214 MET.COM.VEN.OP.B PR.CL.VA.OF.COM.;1;1;1;0;0;0;0;1;0;0;0;0;1;0
19296.0;2023;08;GRENOBLE;FEMININ;INDIVIDUEL;BAC TECHNOLOGIQUE;BAC STMG;BAC STMG RESSOURCES HUMAINES ET COMMUNICATION;18;18;5;10;3;3;0;8;0;3;2;0;3;10
19297.0;2023;08;GRENOBLE;FEMININ;SCOLAIRE;BAC GENERAL;BAC GENERAL;BAC GENE 10019 BAC GENERAL;10777;10777;10140;101;536;397;139;10537;228;1502;2910;3391;2506;240
19300.0;2023;08;GRENOBLE;FEMININ;SCOLAIRE;BAC PROFESSIONNEL;BAC PRO PROD;BAC PRO 22004 PROC. CHIMIE EAU PAPIERS-CARTONS;8;8;3;4;1;0;1;3;0;0;0;0;3;5
19303.0;2023;08;GRENOBLE;FEMININ;SCOLAIRE;BAC PROFESSIONNEL;BAC PRO PROD;BAC PRO 22703 TECHN.INSTALL.SYST.ENERG.CLIMATI;1;1;1;0;0;0;0;1;0;0;1;0;0;0
19304.0;2023;08;GRENOBLE;FEMININ;SCOLAIRE;BAC PROFESSIONNEL;BAC PRO PROD;BAC PRO 23003 ARTIS. & M.ART:MARCHANDISAGE VIS.;14;14;14;0;0;0;0;14;0;0;5;6;3;0
19308.0;2023;08;GRENOBLE;FEMININ;SCOLAIRE;BAC PROFESSIONNEL;BAC PRO PROD;BAC PRO 23203 TECHNICIEN BAT. : ORG.REAL.GROS O;1;1;1;0;0;0;0;1;0;0;0;1;0;0
19311.0;2023;08;GRENOBLE;FEMININ;SCOLAIRE;BAC PROFESSIONNEL;BAC PRO PROD;BAC PRO 23405 TECHNICIEN MENUISIER AGENCEUR;9;9;7;2;0;0;0;7;0;0;2;3;2;2
19315.0;2023;08;GRENOBLE;FEMININ;SCOLAIRE;BAC PROFESSIONNEL;BAC PRO PROD;BAC PRO 24301 METIERS DU CUIR : CHAUSSURES;5;5;4;1;0;0;0;4;0;1;1;2;0;1
19332.0;2023;08;GRENOBLE;FEMININ;SCOLAIRE;BAC PROFESSIONNEL;BAC PRO PROD;BAC PRO AG 21302 GEST MILIEUX NATURELS FAUNE;28;28;26;2;0;0;0;26;0;1;8;10;7;2
19343.0;2023;08;GRENOBLE;FEMININ;SCOLAIRE;BAC PROFESSIONNEL;BAC PRO SERV;BAC PRO 31213 MET.COM.VEN.OP.A ANI.GES.ESP.COM.;400;399;358;23;18;10;8;368;0;16;94;157;101;31
19347.0;2023;08;GRENOBLE;FEMININ;SCOLAIRE;BAC PROFESSIONNEL;BAC PRO SERV;BAC PRO 32303 ART.& MET.ART:COM.VIS.VIS.PLURI-M;44;44;42;2;0;0;0;42;0;4;18;13;7;2
19351.0;2023;08;GRENOBLE;FEMININ;SCOLAIRE;BAC PROFESSIONNEL;BAC PRO SERV;BAC PRO 33101 OPTIQUE LUNETTERIE;18;18;13;3;2;2;0;15;0;1;2;6;6;3
19356.0;2023;08;GRENOBLE;FEMININ;SCOLAIRE;BAC PROFESSIONNEL;BAC PRO SERV;BAC PRO 34403 METIERS DE LA SECURITE;21;21;19;2;0;0;0;19;0;3;5;9;2;2
19362.0;2023;08;GRENOBLE;FEMININ;SCOLAIRE;BAC TECHNOLOGIQUE;BAC STD2A;BAC STD2A SCIENCES & TECHNO. DESIGN-ARTS APPLIQUES;145;145;143;0;2;1;1;144;2;11;57;56;18;1
19372.0;2023;08;GRENOBLE;FEMININ;SCOLAIRE;BAC TECHNOLOGIQUE;BAC STMG;BAC STMG RESSOURCES HUMAINES ET COMMUNICATION;770;770;551;50;169;115;54;666;0;5;44;172;445;104
19385.0;2023;08;GRENOBLE;MASCULIN;APPRENTISSAGE;BAC PROFESSIONNEL;BAC PRO PROD;BAC PRO 23303 MENUISERIE ALUMINIUM-VERRE;6;6;3;2;1;1;0;4;0;0;0;2;2;2
19386.0;2023;08;GRENOBLE;MASCULIN;APPRENTISSAGE;BAC PROFESSIONNEL;BAC PRO PROD;BAC PRO 23304 AMENAGEMENT FINITION BATIMENT;20;20;15;5;0;0;0;15;0;2;3;8;2;5
19391.0;2023;08;GRENOBLE;MASCULIN;APPRENTISSAGE;BAC PROFESSIONNEL;BAC PRO PROD;BAC PRO 25006 MICROTECHNIQUES;2;2;2;0;0;0;0;2;0;0;0;1;1;0
19393.0;2023;08;GRENOBLE;MASCULIN;APPRENTISSAGE;BAC PROFESSIONNEL;BAC PRO PROD;BAC PRO 25009 MAINTENANCE NAUTIQUE;6;6;5;1;0;0;0;5;0;0;1;3;1;1
19396.0;2023;08;GRENOBLE;MASCULIN;APPRENTISSAGE;BAC PROFESSIONNEL;BAC PRO PROD;BAC PRO 25215 MAINT.VEHIC.OPTB VEHIC.TRANS.ROUT;40;40;36;3;1;1;0;37;0;4;9;15;9;3
19403.0;2023;08;GRENOBLE;MASCULIN;APPRENTISSAGE;BAC PROFESSIONNEL;BAC PRO PROD;BAC PRO 25406 OUVRAGES DU BATIMENT METALLERIE;2;2;2;0;0;0;0;2;0;0;0;1;1;0
19404.0;2023;08;GRENOBLE;MASCULIN;APPRENTISSAGE;BAC PROFESSIONNEL;BAC PRO PROD;BAC PRO 25408 REPARATION DES CARROSSERIES;20;20;18;2;0;0;0;18;0;2;9;4;3;2
19406.0;2023;08;GRENOBLE;MASCULIN;APPRENTISSAGE;BAC PROFESSIONNEL;BAC PRO PROD;BAC PRO 25509 TECHNIC. FROID CONDITIONNEMT AIR;8;8;7;1;0;0;0;7;0;0;1;5;1;1
19407.0;2023;08;GRENOBLE;MASCULIN;APPRENTISSAGE;BAC PROFESSIONNEL;BAC PRO PROD;BAC PRO 25510 METIERS ELECT. ENVIRON. CONNECTES;175;173;145;20;8;4;4;149;0;11;40;45;53;24
19408.0;2023;08;GRENOBLE;MASCULIN;APPRENTISSAGE;BAC PROFESSIONNEL;BAC PRO PROD;BAC PRO 25513 SYST.NUM.OPT.A SURETE SECURITE;2;2;2;0;0;0;0;2;0;0;0;1;1;0
19410.0;2023;08;GRENOBLE;MASCULIN;APPRENTISSAGE;BAC PROFESSIONNEL;BAC PRO PROD;BAC PRO 25515 SYST.NUM.OPT.C RES.INF.SYST.COMM.;18;18;16;1;1;0;1;16;0;1;3;8;4;2
19413.0;2023;08;GRENOBLE;MASCULIN;APPRENTISSAGE;BAC PROFESSIONNEL;BAC PRO PROD;BAC PRO AG 21302 GEST MILIEUX NATURELS FAUNE;4;4;4;0;0;0;0;4;0;1;0;2;1;0
19415.0;2023;08;GRENOBLE;MASCULIN;APPRENTISSAGE;BAC PROFESSIONNEL;BAC PRO PROD;BAC PRO AG 21405 AMENAGEMENTS PAYSAGERS;93;92;84;8;0;0;0;84;0;1;4;33;46;8
19426.0;2023;08;GRENOBLE;MASCULIN;ENSEIGNEMENT A DISTANCE;BAC GENERAL;BAC GENERAL;BAC GENE 10019 BAC GENERAL;39;39;23;5;11;6;5;29;0;0;3;11;15;10
19427.0;2023;08;GRENOBLE;MASCULIN;ENSEIGNEMENT A DISTANCE;BAC PROFESSIONNEL;BAC PRO PROD;BAC PRO 25510 METIERS ELECT. ENVIRON. CONNECTES;1;0;0;0;0;0;0;0;0;0;0;0;0;0
19428.0;2023;08;GRENOBLE;MASCULIN;ENSEIGNEMENT A DISTANCE;BAC PROFESSIONNEL;BAC PRO SERV;BAC PRO 30004 ASSISTANC.GEST.ORGANIS.ACTIVITES;3;2;2;0;0;0;0;2;0;0;0;1;1;0
19435.0;2023;08;GRENOBLE;MASCULIN;FORMATION CONTINUE;BAC PROFESSIONNEL;BAC PRO PROD;BAC PRO 22703 TECHN.INSTALL.SYST.ENERG.CLIMATI;5;5;5;0;0;0;0;5;0;3;2;0;0;0
19443.0;2023;08;GRENOBLE;MASCULIN;INDIVIDUEL;BAC PROFESSIONNEL;BAC PRO PROD;BAC PRO 22004 PROC. CHIMIE EAU PAPIERS-CARTONS;1;1;0;1;0;0;0;0;0;0;0;0;0;1
19448.0;2023;08;GRENOBLE;MASCULIN;INDIVIDUEL;BAC PROFESSIONNEL;BAC PRO PROD;BAC PRO 23406 TECHNICIEN DE SCIERIE;1;0;0;0;0;0;0;0;0;0;0;0;0;0
19451.0;2023;08;GRENOBLE;MASCULIN;INDIVIDUEL;BAC PROFESSIONNEL;BAC PRO PROD;BAC PRO 25106 TECHNICIEN D'USINAGE;2;1;0;1;0;0;0;0;0;0;0;0;0;1
19455.0;2023;08;GRENOBLE;MASCULIN;INDIVIDUEL;BAC PROFESSIONNEL;BAC PRO PROD;BAC PRO 25509 TECHNIC. FROID CONDITIONNEMT AIR;1;1;0;1;0;0;0;0;0;0;0;0;0;1
19457.0;2023;08;GRENOBLE;MASCULIN;INDIVIDUEL;BAC PROFESSIONNEL;BAC PRO PROD;BAC PRO 25515 SYST.NUM.OPT.C RES.INF.SYST.COMM.;2;2;1;1;0;0;0;1;0;0;0;1;0;1
19478.0;2023;08;GRENOBLE;MASCULIN;SCOLAIRE;BAC PROFESSIONNEL;BAC PRO PROD;BACPRO 20002 ETUD.DEFINITION PRDTS INDUSTRIEL;65;65;44;20;1;1;0;45;0;1;6;19;19;20
19484.0;2023;08;GRENOBLE;MASCULIN;SCOLAIRE;BAC PROFESSIONNEL;BAC PRO PROD;BAC PRO 22503 PLASTIQUES ET COMPOSITES;4;4;4;0;0;0;0;4;0;0;0;2;2;0
19494.0;2023;08;GRENOBLE;MASCULIN;SCOLAIRE;BAC PROFESSIONNEL;BAC PRO PROD;BAC PRO 23404 TECHNICIEN CONSTRUCTEUR BOIS;25;25;23;2;0;0;0;23;0;2;3;7;11;2
19496.0;2023;08;GRENOBLE;MASCULIN;SCOLAIRE;BAC PROFESSIONNEL;BAC PRO PROD;BAC PRO 23407 TECHNIC.FAB.BOIS ET MATERX ASSOC;24;24;21;3;0;0;0;21;0;4;4;9;4;3
19501.0;2023;08;GRENOBLE;MASCULIN;SCOLAIRE;BAC PROFESSIONNEL;BAC PRO PROD;BAC PRO 25005 PRODUCTIQ.MECA. OPT.DECOLLETAGE;7;7;5;2;0;0;0;5;0;0;1;0;4;2
19504.0;2023;08;GRENOBLE;MASCULIN;SCOLAIRE;BAC PROFESSIONNEL;BAC PRO PROD;BAC PRO 25106 TECHNICIEN D'USINAGE;112;110;74;32;4;3;1;77;0;2;14;34;27;33
19506.0;2023;08;GRENOBLE;MASCULIN;SCOLAIRE;BAC PROFESSIONNEL;BAC PRO PROD;BAC PRO 25214 MAINT.VEHIC.OPTA VOIT.PARTICUL.;139;139;109;21;9;8;1;117;0;6;26;49;36;22
19514.0;2023;08;GRENOBLE;MASCULIN;SCOLAIRE;BAC PROFESSIONNEL;BAC PRO PROD;BAC PRO 25510 METIERS ELECT. ENVIRON. CONNECTES;566;565;381;133;51;36;15;417;0;21;72;139;185;148
19517.0;2023;08;GRENOBLE;MASCULIN;SCOLAIRE;BAC PROFESSIONNEL;BAC PRO PROD;BAC PRO 25515 SYST.NUM.OPT.C RES.INF.SYST.COMM.;173;173;151;15;7;4;3;155;0;17;47;49;42;18
19518.0;2023;08;GRENOBLE;MASCULIN;SCOLAIRE;BAC PROFESSIONNEL;BAC PRO PROD;BAC PRO AG 21001 AGRO-EQUIPEMENT;57;57;53;4;0;0;0;53;0;1;6;12;34;4
19523.0;2023;08;GRENOBLE;MASCULIN;SCOLAIRE;BAC PROFESSIONNEL;BAC PRO PROD;BAC PRO AG 21210 COND GEST ENTR CANIN ET FELIN;16;16;15;1;0;0;0;15;0;0;2;3;10;1
19527.0;2023;08;GRENOBLE;MASCULIN;SCOLAIRE;BAC PROFESSIONNEL;BAC PRO PROD;BAC PRO AG 21405 AMENAGEMENTS PAYSAGERS;105;104;99;5;0;0;0;99;0;4;19;42;34;5
19543.0;2023;08;GRENOBLE;MASCULIN;SCOLAIRE;BAC PROFESSIONNEL;BAC PRO SERV;BAC PRO 33004 ACC.SOINS-S.PERS. OPT.EN STRUCTUR;41;41;35;6;0;0;0;35;0;0;8;18;9;6
19557.0;2023;08;GRENOBLE;MASCULIN;SCOLAIRE;BAC TECHNOLOGIQUE;BAC STI2D;BAC STI2D ARCHITECTURE ET CONSTRUCTION;267;267;236;7;24;11;13;247;0;8;52;86;101;20
19558.0;2023;08;GRENOBLE;MASCULIN;SCOLAIRE;BAC TECHNOLOGIQUE;BAC STI2D;BAC STI2D ENERGIES  ET ENVIRONNEMENT;300;300;277;0;23;10;13;287;0;13;63;104;107;13
19565.0;2023;08;GRENOBLE;MASCULIN;SCOLAIRE;BAC TECHNOLOGIQUE;BAC STMG;BAC STMG RESSOURCES HUMAINES ET COMMUNICATION;314;314;198;36;80;62;18;260;0;0;11;64;185;54
19568.0;2023;32;GUADELOUPE;FEMININ;APPRENTISSAGE;BAC PROFESSIONNEL;BAC PRO SERV;BAC PRO 31213 MET.COM.VEN.OP.A ANI.GES.ESP.COM.;2;2;2;0;0;0;0;2;0;0;2;0;0;0
19570.0;2023;32;GUADELOUPE;FEMININ;APPRENTISSAGE;BAC PROFESSIONNEL;BAC PRO SERV;BAC PRO 33004 ACC.SOINS-S.PERS. OPT.EN STRUCTUR;2;2;2;0;0;0;0;2;0;0;0;0;2;0
19572.0;2023;32;GUADELOUPE;FEMININ;APPRENTISSAGE;BAC PROFESSIONNEL;BAC PRO SERV;BAC PRO 33604 METIERS DE LA COIFFURE;2;2;0;0;2;2;0;2;0;0;0;0;2;0
19582.0;2023;32;GUADELOUPE;FEMININ;FORMATION CONTINUE;BAC PROFESSIONNEL;BAC PRO SERV;BAC PRO 31213 MET.COM.VEN.OP.A ANI.GES.ESP.COM.;6;4;1;0;3;2;1;3;0;0;0;0;3;1
19583.0;2023;32;GUADELOUPE;FEMININ;FORMATION CONTINUE;BAC PROFESSIONNEL;BAC PRO SERV;BAC PRO 31214 MET.COM.VEN.OP.B PR.CL.VA.OF.COM.;1;1;0;0;1;0;1;0;0;0;0;0;0;1
19587.0;2023;32;GUADELOUPE;FEMININ;INDIVIDUEL;BAC PROFESSIONNEL;BAC PRO PROD;BAC PRO 22106 CUISINE;2;2;0;2;0;0;0;0;0;0;0;0;0;2
19588.0;2023;32;GUADELOUPE;FEMININ;INDIVIDUEL;BAC PROFESSIONNEL;BAC PRO SERV;BAC PRO 30004 ASSISTANC.GEST.ORGANIS.ACTIVITES;5;5;2;1;2;2;0;4;0;0;0;0;4;1
19589.0;2023;32;GUADELOUPE;FEMININ;INDIVIDUEL;BAC PROFESSIONNEL;BAC PRO SERV;BAC PRO 31213 MET.COM.VEN.OP.A ANI.GES.ESP.COM.;1;0;0;0;0;0;0;0;0;0;0;0;0;0
19594.0;2023;32;GUADELOUPE;FEMININ;INDIVIDUEL;BAC PROFESSIONNEL;BAC PRO SERV;BAC PRO 33403 COMMERC. SERVICES EN RESTAURATION;1;0;0;0;0;0;0;0;0;0;0;0;0;0
19601.0;2023;32;GUADELOUPE;FEMININ;INDIVIDUEL;BAC TECHNOLOGIQUE;BAC STMG;BAC STMG MERCATIQUE (MARKETING);5;5;4;1;0;0;0;4;0;2;0;1;1;1
19610.0;2023;32;GUADELOUPE;FEMININ;SCOLAIRE;BAC PROFESSIONNEL;BAC PRO PROD;BAC PRO 23304 AMENAGEMENT FINITION BATIMENT;2;2;1;0;1;1;0;2;0;0;0;0;2;0
19616.0;2023;32;GUADELOUPE;FEMININ;SCOLAIRE;BAC PROFESSIONNEL;BAC PRO PROD;BAC PRO 25214 MAINT.VEHIC.OPTA VOIT.PARTICUL.;1;1;1;0;0;0;0;1;0;0;0;1;0;0
19621.0;2023;32;GUADELOUPE;FEMININ;SCOLAIRE;BAC PROFESSIONNEL;BAC PRO PROD;BAC PRO 25510 METIERS ELECT. ENVIRON. CONNECTES;4;4;4;0;0;0;0;4;0;0;3;1;0;0
19628.0;2023;32;GUADELOUPE;FEMININ;SCOLAIRE;BAC PROFESSIONNEL;BAC PRO SERV;BAC PRO 30004 ASSISTANC.GEST.ORGANIS.ACTIVITES;80;79;71;5;3;3;0;74;0;7;13;32;22;5
19634.0;2023;32;GUADELOUPE;FEMININ;SCOLAIRE;BAC PROFESSIONNEL;BAC PRO SERV;BAC PRO 32303 ART.& MET.ART:COM.VIS.VIS.PLURI-M;2;2;2;0;0;0;0;2;0;0;0;1;1;0
19652.0;2023;32;GUADELOUPE;FEMININ;SCOLAIRE;BAC TECHNOLOGIQUE;BAC STI2D;BAC STI2D ENERGIES  ET ENVIRONNEMENT;10;10;7;0;3;3;0;10;0;0;0;3;7;0
19656.0;2023;32;GUADELOUPE;FEMININ;SCOLAIRE;BAC TECHNOLOGIQUE;BAC STL;BAC STL SCIENCES PHYSIQUES CHIMIQUES  EN LABORAT.;12;12;9;0;3;1;2;10;0;0;1;6;3;2
19658.0;2023;32;GUADELOUPE;FEMININ;SCOLAIRE;BAC TECHNOLOGIQUE;BAC STMG;BAC STMG MERCATIQUE (MARKETING);93;93;80;3;10;10;0;90;1;3;16;26;44;3
19664.0;2023;32;GUADELOUPE;MASCULIN;APPRENTISSAGE;BAC PROFESSIONNEL;BAC PRO PROD;BAC PRO 25510 METIERS ELECT. ENVIRON. CONNECTES;2;2;2;0;0;0;0;2;0;1;0;0;1;0
19665.0;2023;32;GUADELOUPE;MASCULIN;APPRENTISSAGE;BAC PROFESSIONNEL;BAC PRO PROD;BAC PRO AG 21004 CGEA;1;1;1;0;0;0;0;1;0;0;0;0;1;0
19666.0;2023;32;GUADELOUPE;MASCULIN;APPRENTISSAGE;BAC PROFESSIONNEL;BAC PRO SERV;BAC PRO 31213 MET.COM.VEN.OP.A ANI.GES.ESP.COM.;2;2;2;0;0;0;0;2;0;0;1;0;1;0
19677.0;2023;32;GUADELOUPE;MASCULIN;INDIVIDUEL;BAC PROFESSIONNEL;BAC PRO PROD;BAC PRO 25216 MAINT.VEHIC.OPTC MOTOCYCLES;1;0;0;0;0;0;0;0;0;0;0;0;0;0
19678.0;2023;32;GUADELOUPE;MASCULIN;INDIVIDUEL;BAC PROFESSIONNEL;BAC PRO PROD;BAC PRO 25515 SYST.NUM.OPT.C RES.INF.SYST.COMM.;1;0;0;0;0;0;0;0;0;0;0;0;0;0
19685.0;2023;32;GUADELOUPE;MASCULIN;INDIVIDUEL;BAC TECHNOLOGIQUE;BAC STMG;BAC STMG GESTION ET FINANCE;19;19;5;11;3;3;0;8;0;0;1;2;5;11
19700.0;2023;32;GUADELOUPE;MASCULIN;SCOLAIRE;BAC PROFESSIONNEL;BAC PRO PROD;BAC PRO 23405 TECHNICIEN MENUISIER AGENCEUR;34;34;18;10;6;4;2;22;0;0;0;3;19;12
19701.0;2023;32;GUADELOUPE;MASCULIN;SCOLAIRE;BAC PROFESSIONNEL;BAC PRO PROD;BAC PRO 23407 TECHNIC.FAB.BOIS ET MATERX ASSOC;13;13;4;8;1;1;0;5;0;0;0;2;3;8
19711.0;2023;32;GUADELOUPE;MASCULIN;SCOLAIRE;BAC PROFESSIONNEL;BAC PRO PROD;BAC PRO 25406 OUVRAGES DU BATIMENT METALLERIE;14;13;10;2;1;0;1;10;0;0;1;4;5;3
19716.0;2023;32;GUADELOUPE;MASCULIN;SCOLAIRE;BAC PROFESSIONNEL;BAC PRO PROD;BAC PRO 25513 SYST.NUM.OPT.A SURETE SECURITE;27;27;25;1;1;1;0;26;0;0;2;16;8;1
19718.0;2023;32;GUADELOUPE;MASCULIN;SCOLAIRE;BAC PROFESSIONNEL;BAC PRO PROD;BAC PRO 25515 SYST.NUM.OPT.C RES.INF.SYST.COMM.;45;45;34;10;1;1;0;35;0;0;14;13;8;10
19725.0;2023;32;GUADELOUPE;MASCULIN;SCOLAIRE;BAC PROFESSIONNEL;BAC PRO SERV;BAC PRO 31114 ORGANIS. TRANSPORT MARCHANDISES;17;17;13;0;4;2;2;15;0;1;1;8;5;2
19727.0;2023;32;GUADELOUPE;MASCULIN;SCOLAIRE;BAC PROFESSIONNEL;BAC PRO SERV;BAC PRO 31213 MET.COM.VEN.OP.A ANI.GES.ESP.COM.;82;80;53;19;8;6;2;59;0;0;4;18;37;21
19729.0;2023;32;GUADELOUPE;MASCULIN;SCOLAIRE;BAC PROFESSIONNEL;BAC PRO SERV;BAC PRO 32303 ART.& MET.ART:COM.VIS.VIS.PLURI-M;9;9;8;0;1;1;0;9;0;0;2;4;3;0
19733.0;2023;32;GUADELOUPE;MASCULIN;SCOLAIRE;BAC PROFESSIONNEL;BAC PRO SERV;BAC PRO 33403 COMMERC. SERVICES EN RESTAURATION;11;11;10;1;0;0;0;10;0;0;1;6;3;1
19734.0;2023;32;GUADELOUPE;MASCULIN;SCOLAIRE;BAC PROFESSIONNEL;BAC PRO SERV;BAC PRO 33604 METIERS DE LA COIFFURE;2;2;2;0;0;0;0;2;0;0;1;0;1;0
19747.0;2023;32;GUADELOUPE;MASCULIN;SCOLAIRE;BAC TECHNOLOGIQUE;BAC STI2D;BAC STI2D INNOVATION TECHNO.  ET ECO CONCEPTION;48;48;36;1;11;9;2;45;0;1;7;11;26;3
19755.0;2023;33;GUYANE;FEMININ;APPRENTISSAGE;BAC PROFESSIONNEL;BAC PRO SERV;BAC PRO 31212 METIERS DE L'ACCUEIL;1;1;0;0;1;0;1;0;0;0;0;0;0;1
19756.0;2023;33;GUYANE;FEMININ;APPRENTISSAGE;BAC PROFESSIONNEL;BAC PRO SERV;BAC PRO 31213 MET.COM.VEN.OP.A ANI.GES.ESP.COM.;6;4;0;4;0;0;0;0;0;0;0;0;0;4
19762.0;2023;33;GUYANE;FEMININ;INDIVIDUEL;BAC GENERAL;BAC GENERAL;BAC GENE 10019 BAC GENERAL;13;13;1;12;0;0;0;1;0;1;0;0;0;12
19769.0;2023;33;GUYANE;FEMININ;INDIVIDUEL;BAC PROFESSIONNEL;BAC PRO SERV;BAC PRO 31106 LOGISTIQUE;2;0;0;0;0;0;0;0;0;0;0;0;0;0
19775.0;2023;33;GUYANE;FEMININ;INDIVIDUEL;BAC TECHNOLOGIQUE;BAC ST2S;BAC ST2S SCIENCES & TECHNO. SANTE & SOCIAL;3;3;1;2;0;0;0;1;0;0;0;1;0;2
19778.0;2023;33;GUYANE;FEMININ;SCOLAIRE;BAC GENERAL;BAC GENERAL;BAC GENE 10019 BAC GENERAL;939;939;738;63;138;93;45;831;9;64;143;257;358;108
19793.0;2023;33;GUYANE;FEMININ;SCOLAIRE;BAC PROFESSIONNEL;BAC PRO PROD;BAC PRO 25214 MAINT.VEHIC.OPTA VOIT.PARTICUL.;1;1;0;1;0;0;0;0;0;0;0;0;0;1
19803.0;2023;33;GUYANE;FEMININ;SCOLAIRE;BAC PROFESSIONNEL;BAC PRO SERV;BAC PRO 31106 LOGISTIQUE;5;5;3;2;0;0;0;3;0;0;0;2;1;2
19805.0;2023;33;GUYANE;FEMININ;SCOLAIRE;BAC PROFESSIONNEL;BAC PRO SERV;BAC PRO 31212 METIERS DE L'ACCUEIL;101;101;58;25;18;11;7;69;0;0;5;20;44;32
19822.0;2023;33;GUYANE;FEMININ;SCOLAIRE;BAC TECHNOLOGIQUE;BAC STI2D;BAC STI2D ENERGIES  ET ENVIRONNEMENT;3;3;0;2;1;0;1;0;0;0;0;0;0;3
19827.0;2023;33;GUYANE;FEMININ;SCOLAIRE;BAC TECHNOLOGIQUE;BAC STMG;BAC STMG GESTION ET FINANCE;67;67;55;3;9;6;3;61;0;4;13;20;24;6
19829.0;2023;33;GUYANE;FEMININ;SCOLAIRE;BAC TECHNOLOGIQUE;BAC STMG;BAC STMG RESSOURCES HUMAINES ET COMMUNICATION;70;70;55;4;11;6;5;61;0;2;5;14;40;9
19834.0;2023;33;GUYANE;MASCULIN;APPRENTISSAGE;BAC PROFESSIONNEL;BAC PRO SERV;BAC PRO 31213 MET.COM.VEN.OP.A ANI.GES.ESP.COM.;5;4;1;2;1;1;0;2;0;0;0;0;2;2
19851.0;2023;33;GUYANE;MASCULIN;INDIVIDUEL;BAC TECHNOLOGIQUE;BAC STI2D;BAC STI2D ENERGIES  ET ENVIRONNEMENT;1;1;0;1;0;0;0;0;0;0;0;0;0;1
19854.0;2023;33;GUYANE;MASCULIN;SCOLAIRE;BAC GENERAL;BAC GENERAL;BAC GENE 10019 BAC GENERAL;642;642;460;64;118;80;38;540;10;26;87;121;296;102
19857.0;2023;33;GUYANE;MASCULIN;SCOLAIRE;BAC PROFESSIONNEL;BAC PRO PROD;BAC PRO 22106 CUISINE;12;12;10;1;1;1;0;11;0;0;3;5;3;1
19860.0;2023;33;GUYANE;MASCULIN;SCOLAIRE;BAC PROFESSIONNEL;BAC PRO PROD;BAC PRO 23004 TECHN. ETUDES BAT.A ETUDES & ECO.;33;33;9;24;0;0;0;9;0;0;1;2;6;24
19883.0;2023;33;GUYANE;MASCULIN;SCOLAIRE;BAC PROFESSIONNEL;BAC PRO SERV;BAC PRO 31106 LOGISTIQUE;24;23;12;11;0;0;0;12;0;0;2;2;8;11
19890.0;2023;33;GUYANE;MASCULIN;SCOLAIRE;BAC PROFESSIONNEL;BAC PRO SERV;BAC PRO 33003 ACC.SOINS-S.PERS. OPT.A DOMICILE;3;3;1;2;0;0;0;1;0;0;0;1;0;2
19902.0;2023;33;GUYANE;MASCULIN;SCOLAIRE;BAC TECHNOLOGIQUE;BAC STI2D;BAC STI2D ENERGIES  ET ENVIRONNEMENT;29;29;13;2;14;10;4;23;0;0;1;5;17;6
19913.0;2023;28;LA REUNION;FEMININ;APPRENTISSAGE;BAC PROFESSIONNEL;BAC PRO PROD;BAC PRO AG 21203 TECHN CONSEIL DE VENTE ANIMAL;2;2;2;0;0;0;0;2;0;0;0;0;2;0
19915.0;2023;28;LA REUNION;FEMININ;APPRENTISSAGE;BAC PROFESSIONNEL;BAC PRO SERV;BAC PRO 31212 METIERS DE L'ACCUEIL;1;1;1;0;0;0;0;1;0;1;0;0;0;0
19916.0;2023;28;LA REUNION;FEMININ;APPRENTISSAGE;BAC PROFESSIONNEL;BAC PRO SERV;BAC PRO 31213 MET.COM.VEN.OP.A ANI.GES.ESP.COM.;1;1;0;1;0;0;0;0;0;0;0;0;0;1
19917.0;2023;28;LA REUNION;FEMININ;ENSEIGNEMENT A DISTANCE;BAC GENERAL;BAC GENERAL;BAC GENE 10019 BAC GENERAL;13;13;7;2;4;4;0;11;0;0;3;0;8;2
19923.0;2023;28;LA REUNION;FEMININ;INDIVIDUEL;BAC PROFESSIONNEL;BAC PRO PROD;BAC PRO AG 21114 CONDUITE PRODUCTIONS HORTICOLES;23;22;21;1;0;0;0;21;0;0;0;0;21;1
19926.0;2023;28;LA REUNION;FEMININ;INDIVIDUEL;BAC PROFESSIONNEL;BAC PRO SERV;BAC PRO 32303 ART.& MET.ART:COM.VIS.VIS.PLURI-M;1;0;0;0;0;0;0;0;0;0;0;0;0;0
19935.0;2023;28;LA REUNION;FEMININ;SCOLAIRE;BAC PROFESSIONNEL;BAC PRO PROD;BACPRO 20002 ETUD.DEFINITION PRDTS INDUSTRIEL;2;2;2;0;0;0;0;2;0;0;0;0;2;0
19937.0;2023;28;LA REUNION;FEMININ;SCOLAIRE;BAC PROFESSIONNEL;BAC PRO PROD;BAC PRO 22003 BIO-INDUSTRIES DE TRANSFORMATION;20;20;16;4;0;0;0;16;0;0;3;7;6;4
19946.0;2023;28;LA REUNION;FEMININ;SCOLAIRE;BAC PROFESSIONNEL;BAC PRO PROD;BAC PRO 23102 TRAVAUX PUBLICS;1;1;1;0;0;0;0;1;0;0;0;1;0;0
19956.0;2023;28;LA REUNION;FEMININ;SCOLAIRE;BAC PROFESSIONNEL;BAC PRO PROD;BAC PRO 25106 TECHNICIEN D'USINAGE;1;1;1;0;0;0;0;1;0;0;0;0;1;0
19959.0;2023;28;LA REUNION;FEMININ;SCOLAIRE;BAC PROFESSIONNEL;BAC PRO PROD;BAC PRO 25406 OUVRAGES DU BATIMENT METALLERIE;1;1;1;0;0;0;0;1;0;0;0;0;1;0
19976.0;2023;28;LA REUNION;FEMININ;SCOLAIRE;BAC PROFESSIONNEL;BAC PRO SERV;BAC PRO 32207 REAL.PR.IMPR.PLURI.OPTA.PR.GRAPH.;2;2;2;0;0;0;0;2;0;0;1;1;0;0
19978.0;2023;28;LA REUNION;FEMININ;SCOLAIRE;BAC PROFESSIONNEL;BAC PRO SERV;BAC PRO 32303 ART.& MET.ART:COM.VIS.VIS.PLURI-M;9;9;7;2;0;0;0;7;0;0;0;3;4;2
19984.0;2023;28;LA REUNION;FEMININ;SCOLAIRE;BAC PROFESSIONNEL;BAC PRO SERV;BAC PRO 33603 ESTHETIQUE COSMETIQUE PARFUMERIE;20;20;16;4;0;0;0;16;0;0;2;5;9;4
19997.0;2023;28;LA REUNION;FEMININ;SCOLAIRE;BAC TECHNOLOGIQUE;BAC STL;BAC STL BIOCHIM.-BIOLOGIE-BIOTECHNOL.;63;63;49;0;14;7;7;56;1;1;5;21;28;7
20009.0;2023;28;LA REUNION;MASCULIN;APPRENTISSAGE;BAC PROFESSIONNEL;BAC PRO PROD;BAC PRO 25214 MAINT.VEHIC.OPTA VOIT.PARTICUL.;7;7;6;0;1;0;1;6;0;0;3;3;0;1
20012.0;2023;28;LA REUNION;MASCULIN;APPRENTISSAGE;BAC PROFESSIONNEL;BAC PRO PROD;BAC PRO 25219 MAINT.MATERIELS OPT.A AGRICOLES;1;1;0;1;0;0;0;0;0;0;0;0;0;1
20027.0;2023;28;LA REUNION;MASCULIN;INDIVIDUEL;BAC PROFESSIONNEL;BAC PRO PROD;BAC PRO AG 21114 CONDUITE PRODUCTIONS HORTICOLES;26;24;22;2;0;0;0;22;0;0;0;0;22;2
20028.0;2023;28;LA REUNION;MASCULIN;INDIVIDUEL;BAC PROFESSIONNEL;BAC PRO SERV;BAC PRO 30004 ASSISTANC.GEST.ORGANIS.ACTIVITES;2;1;0;1;0;0;0;0;0;0;0;0;0;1
20043.0;2023;28;LA REUNION;MASCULIN;SCOLAIRE;BAC PROFESSIONNEL;BAC PRO PROD;BAC PRO 22503 PLASTIQUES ET COMPOSITES;4;4;3;1;0;0;0;3;0;0;0;0;3;1
20047.0;2023;28;LA REUNION;MASCULIN;SCOLAIRE;BAC PROFESSIONNEL;BAC PRO PROD;BAC PRO 23004 TECHN. ETUDES BAT.A ETUDES & ECO.;18;18;11;6;1;0;1;11;0;0;2;4;5;7
20055.0;2023;28;LA REUNION;MASCULIN;SCOLAIRE;BAC PROFESSIONNEL;BAC PRO PROD;BAC PRO 23303 MENUISERIE ALUMINIUM-VERRE;20;20;12;3;5;4;1;16;0;0;1;7;8;4
20058.0;2023;28;LA REUNION;MASCULIN;SCOLAIRE;BAC PROFESSIONNEL;BAC PRO PROD;BAC PRO 23405 TECHNICIEN MENUISIER AGENCEUR;41;41;29;6;6;5;1;34;0;1;1;8;24;7
20075.0;2023;28;LA REUNION;MASCULIN;SCOLAIRE;BAC PROFESSIONNEL;BAC PRO PROD;BAC PRO 25513 SYST.NUM.OPT.A SURETE SECURITE;16;16;8;7;1;0;1;8;0;1;1;3;3;8
20083.0;2023;28;LA REUNION;MASCULIN;SCOLAIRE;BAC PROFESSIONNEL;BAC PRO PROD;BAC PRO AG 21407 TEC CONS VTE UNIVERS JARDINERIE;5;5;3;2;0;0;0;3;0;0;0;1;2;2
20085.0;2023;28;LA REUNION;MASCULIN;SCOLAIRE;BAC PROFESSIONNEL;BAC PRO SERV;BAC PRO 30004 ASSISTANC.GEST.ORGANIS.ACTIVITES;147;146;92;40;14;11;3;103;0;5;11;24;63;43
20086.0;2023;28;LA REUNION;MASCULIN;SCOLAIRE;BAC PROFESSIONNEL;BAC PRO SERV;BAC PRO 31106 LOGISTIQUE;74;74;47;19;8;5;3;52;0;1;5;16;30;22
20095.0;2023;28;LA REUNION;MASCULIN;SCOLAIRE;BAC PROFESSIONNEL;BAC PRO SERV;BAC PRO 33006 ANIMAT. ENFANCE& PERSONNES AGEES;4;4;3;0;1;1;0;4;0;0;1;2;1;0
20098.0;2023;28;LA REUNION;MASCULIN;SCOLAIRE;BAC PROFESSIONNEL;BAC PRO SERV;BAC PRO 34303 GEST. POLLUTIONS PROTEC. ENVIRON.;8;8;7;1;0;0;0;7;0;0;2;2;3;1
20100.0;2023;28;LA REUNION;MASCULIN;SCOLAIRE;BAC PROFESSIONNEL;BAC PRO SERV;BAC PRO 34403 METIERS DE LA SECURITE;32;32;26;6;0;0;0;26;0;5;5;8;8;6
20112.0;2023;28;LA REUNION;MASCULIN;SCOLAIRE;BAC TECHNOLOGIQUE;BAC STMG;BAC STMG GESTION ET FINANCE;172;172;130;11;31;24;7;154;0;2;20;50;82;18
20113.0;2023;28;LA REUNION;MASCULIN;SCOLAIRE;BAC TECHNOLOGIQUE;BAC STMG;BAC STMG MERCATIQUE (MARKETING);311;311;220;28;63;58;5;278;0;0;21;73;184;33
20119.0;2023;09;LILLE;FEMININ;APPRENTISSAGE;BAC PROFESSIONNEL;BAC PRO PROD;BAC PRO 23102 TRAVAUX PUBLICS;1;1;0;1;0;0;0;0;0;0;0;0;0;1
20120.0;2023;09;LILLE;FEMININ;APPRENTISSAGE;BAC PROFESSIONNEL;BAC PRO PROD;BAC PRO 23303 MENUISERIE ALUMINIUM-VERRE;1;1;1;0;0;0;0;1;0;1;0;0;0;0
20121.0;2023;09;LILLE;FEMININ;APPRENTISSAGE;BAC PROFESSIONNEL;BAC PRO PROD;BAC PRO 23304 AMENAGEMENT FINITION BATIMENT;7;7;7;0;0;0;0;7;0;1;2;3;1;0
20128.0;2023;09;LILLE;FEMININ;APPRENTISSAGE;BAC PROFESSIONNEL;BAC PRO PROD;BAC PRO 25411 TECH.CHAUDRONNERIE INDUSTRIELLE;1;1;1;0;0;0;0;1;0;1;0;0;0;0
20132.0;2023;09;LILLE;FEMININ;APPRENTISSAGE;BAC PROFESSIONNEL;BAC PRO PROD;BAC PRO AG 21203 TECHN CONSEIL DE VENTE ANIMAL;7;7;7;0;0;0;0;7;0;2;2;2;1;0
20154.0;2023;09;LILLE;FEMININ;ENSEIGNEMENT A DISTANCE;BAC PROFESSIONNEL;BAC PRO SERV;BAC PRO 33003 ACC.SOINS-S.PERS. OPT.A DOMICILE;1;1;1;0;0;0;0;1;0;0;1;0;0;0
20173.0;2023;09;LILLE;FEMININ;INDIVIDUEL;BAC PROFESSIONNEL;BAC PRO SERV;BAC PRO 31213 MET.COM.VEN.OP.A ANI.GES.ESP.COM.;7;6;1;4;1;0;1;1;0;0;0;0;1;5
20185.0;2023;09;LILLE;FEMININ;INDIVIDUEL;BAC TECHNOLOGIQUE;BAC STMG;BAC STMG MERCATIQUE (MARKETING);9;9;3;4;2;1;1;4;0;0;0;1;3;5
20188.0;2023;09;LILLE;FEMININ;SCOLAIRE;BAC PROFESSIONNEL;BAC PRO PROD;BACPRO 20002 ETUD.DEFINITION PRDTS INDUSTRIEL;1;1;1;0;0;0;0;1;0;0;0;0;1;0
20189.0;2023;09;LILLE;FEMININ;SCOLAIRE;BAC PROFESSIONNEL;BAC PRO PROD;BAC PRO 22003 BIO-INDUSTRIES DE TRANSFORMATION;18;17;14;1;2;2;0;16;0;0;4;5;7;1
20195.0;2023;09;LILLE;FEMININ;SCOLAIRE;BAC PROFESSIONNEL;BAC PRO PROD;BAC PRO 22503 PLASTIQUES ET COMPOSITES;2;2;1;1;0;0;0;1;0;1;0;0;0;1
20202.0;2023;09;LILLE;FEMININ;SCOLAIRE;BAC PROFESSIONNEL;BAC PRO PROD;BAC PRO 23203 TECHNICIEN BAT. : ORG.REAL.GROS O;3;3;2;0;1;1;0;3;0;0;1;0;2;0
20204.0;2023;09;LILLE;FEMININ;SCOLAIRE;BAC PROFESSIONNEL;BAC PRO PROD;BAC PRO 23304 AMENAGEMENT FINITION BATIMENT;12;12;12;0;0;0;0;12;0;1;5;5;1;0
20208.0;2023;09;LILLE;FEMININ;SCOLAIRE;BAC PROFESSIONNEL;BAC PRO PROD;BAC PRO 24203 METIERS DE LA MODE - VÊTEMENT;116;115;87;24;4;3;1;90;0;11;25;28;26;25
20211.0;2023;09;LILLE;FEMININ;SCOLAIRE;BAC PROFESSIONNEL;BAC PRO PROD;BAC PRO 25106 TECHNICIEN D'USINAGE;3;3;2;1;0;0;0;2;0;0;1;0;1;1
20212.0;2023;09;LILLE;FEMININ;SCOLAIRE;BAC PROFESSIONNEL;BAC PRO PROD;BAC PRO 25214 MAINT.VEHIC.OPTA VOIT.PARTICUL.;11;11;9;1;1;1;0;10;0;2;2;1;5;1
20215.0;2023;09;LILLE;FEMININ;SCOLAIRE;BAC PROFESSIONNEL;BAC PRO PROD;BAC PRO 25408 REPARATION DES CARROSSERIES;5;5;3;2;0;0;0;3;0;0;1;1;1;2
20217.0;2023;09;LILLE;FEMININ;SCOLAIRE;BAC PROFESSIONNEL;BAC PRO PROD;BAC PRO 25510 METIERS ELECT. ENVIRON. CONNECTES;10;10;7;2;1;0;1;7;0;1;2;1;3;3
20220.0;2023;09;LILLE;FEMININ;SCOLAIRE;BAC PROFESSIONNEL;BAC PRO PROD;BAC PRO AG 21004 CGEA;49;48;40;8;0;0;0;40;0;2;3;13;22;8
20222.0;2023;09;LILLE;FEMININ;SCOLAIRE;BAC PROFESSIONNEL;BAC PRO PROD;BAC PRO AG 21203 TECHN CONSEIL DE VENTE ANIMAL;28;28;22;6;0;0;0;22;0;1;1;10;10;6
20224.0;2023;09;LILLE;FEMININ;SCOLAIRE;BAC PROFESSIONNEL;BAC PRO PROD;BAC PRO AG 21211 COND GEST ENTR HIPPIQUE;25;25;25;0;0;0;0;25;0;1;7;10;7;0
20234.0;2023;09;LILLE;FEMININ;SCOLAIRE;BAC PROFESSIONNEL;BAC PRO SERV;BAC PRO 31114 ORGANIS. TRANSPORT MARCHANDISES;18;18;12;6;0;0;0;12;0;0;1;4;7;6
20238.0;2023;09;LILLE;FEMININ;SCOLAIRE;BAC PROFESSIONNEL;BAC PRO SERV;BAC PRO 31214 MET.COM.VEN.OP.B PR.CL.VA.OF.COM.;134;133;109;19;5;4;1;113;0;2;32;43;36;20
20241.0;2023;09;LILLE;FEMININ;SCOLAIRE;BAC PROFESSIONNEL;BAC PRO SERV;BAC PRO 32304 PHOTOGRAPHIE;23;23;17;6;0;0;0;17;0;5;2;5;5;6
20256.0;2023;09;LILLE;FEMININ;SCOLAIRE;BAC TECHNOLOGIQUE;BAC S2TMD;BAC S2TMD MUSIQUE;7;7;7;0;0;0;0;7;2;1;3;1;0;0
20262.0;2023;09;LILLE;FEMININ;SCOLAIRE;BAC TECHNOLOGIQUE;BAC STI2D;BAC STI2D ENERGIES  ET ENVIRONNEMENT;17;17;14;0;3;3;0;17;0;1;2;7;7;0
20276.0;2023;09;LILLE;MASCULIN;APPRENTISSAGE;BAC PROFESSIONNEL;BAC PRO PROD;BAC PRO 22703 TECHN.INSTALL.SYST.ENERG.CLIMATI;33;33;25;6;2;2;0;27;0;3;6;11;7;6
20279.0;2023;09;LILLE;MASCULIN;APPRENTISSAGE;BAC PROFESSIONNEL;BAC PRO PROD;BAC PRO 23203 TECHNICIEN BAT. : ORG.REAL.GROS O;16;16;11;5;0;0;0;11;0;2;4;4;1;5
20280.0;2023;09;LILLE;MASCULIN;APPRENTISSAGE;BAC PROFESSIONNEL;BAC PRO PROD;BAC PRO 23303 MENUISERIE ALUMINIUM-VERRE;12;12;11;0;1;1;0;12;0;1;5;2;4;0
20284.0;2023;09;LILLE;MASCULIN;APPRENTISSAGE;BAC PROFESSIONNEL;BAC PRO PROD;BAC PRO 23407 TECHNIC.FAB.BOIS ET MATERX ASSOC;4;4;3;1;0;0;0;3;0;0;1;2;0;1
20287.0;2023;09;LILLE;MASCULIN;APPRENTISSAGE;BAC PROFESSIONNEL;BAC PRO PROD;BAC PRO 25106 TECHNICIEN D'USINAGE;24;24;17;6;1;1;0;18;0;1;7;6;4;6
20289.0;2023;09;LILLE;MASCULIN;APPRENTISSAGE;BAC PROFESSIONNEL;BAC PRO PROD;BAC PRO 25215 MAINT.VEHIC.OPTB VEHIC.TRANS.ROUT;37;37;31;4;2;0;2;31;0;2;4;17;8;6
20290.0;2023;09;LILLE;MASCULIN;APPRENTISSAGE;BAC PROFESSIONNEL;BAC PRO PROD;BAC PRO 25216 MAINT.VEHIC.OPTC MOTOCYCLES;14;14;12;2;0;0;0;12;0;2;3;3;4;2
20292.0;2023;09;LILLE;MASCULIN;APPRENTISSAGE;BAC PROFESSIONNEL;BAC PRO PROD;BAC PRO 25220 MAINT.MATERIELS OPT.B TP MANUT.;12;12;8;4;0;0;0;8;0;0;1;4;3;4
20297.0;2023;09;LILLE;MASCULIN;APPRENTISSAGE;BAC PROFESSIONNEL;BAC PRO PROD;BAC PRO 25408 REPARATION DES CARROSSERIES;49;49;39;5;5;3;2;42;0;4;8;11;19;7
20301.0;2023;09;LILLE;MASCULIN;APPRENTISSAGE;BAC PROFESSIONNEL;BAC PRO PROD;BAC PRO AG 21004 CGEA;49;47;41;6;0;0;0;41;0;1;5;7;28;6
20309.0;2023;09;LILLE;MASCULIN;APPRENTISSAGE;BAC PROFESSIONNEL;BAC PRO SERV;BAC PRO 30004 ASSISTANC.GEST.ORGANIS.ACTIVITES;5;5;5;0;0;0;0;5;0;0;1;4;0;0
20316.0;2023;09;LILLE;MASCULIN;APPRENTISSAGE;BAC PROFESSIONNEL;BAC PRO SERV;BAC PRO 33403 COMMERC. SERVICES EN RESTAURATION;14;13;12;1;0;0;0;12;0;2;0;7;3;1
20318.0;2023;09;LILLE;MASCULIN;APPRENTISSAGE;BAC PROFESSIONNEL;BAC PRO SERV;BAC PRO 34304 HYGIENE PROPRETE STERILISATION;1;1;1;0;0;0;0;1;0;1;0;0;0;0
20319.0;2023;09;LILLE;MASCULIN;ENSEIGNEMENT A DISTANCE;BAC GENERAL;BAC GENERAL;BAC GENE 10019 BAC GENERAL;36;36;21;11;4;4;0;25;0;3;3;4;15;11
20324.0;2023;09;LILLE;MASCULIN;ENSEIGNEMENT A DISTANCE;BAC TECHNOLOGIQUE;BAC STMG;BAC STMG GESTION ET FINANCE;2;2;1;1;0;0;0;1;0;0;0;0;1;1
20333.0;2023;09;LILLE;MASCULIN;FORMATION CONTINUE;BAC PROFESSIONNEL;BAC PRO PROD;BAC PRO 25510 METIERS ELECT. ENVIRON. CONNECTES;3;3;3;0;0;0;0;3;0;3;0;0;0;0
20350.0;2023;09;LILLE;MASCULIN;INDIVIDUEL;BAC PROFESSIONNEL;BAC PRO PROD;BAC PRO AG 21210 COND GEST ENTR CANIN ET FELIN;1;0;0;0;0;0;0;0;0;0;0;0;0;0
20352.0;2023;09;LILLE;MASCULIN;INDIVIDUEL;BAC PROFESSIONNEL;BAC PRO SERV;BAC PRO 30004 ASSISTANC.GEST.ORGANIS.ACTIVITES;4;2;0;2;0;0;0;0;0;0;0;0;0;2
20354.0;2023;09;LILLE;MASCULIN;INDIVIDUEL;BAC PROFESSIONNEL;BAC PRO SERV;BAC PRO 31213 MET.COM.VEN.OP.A ANI.GES.ESP.COM.;3;2;1;1;0;0;0;1;0;0;0;1;0;1
20355.0;2023;09;LILLE;MASCULIN;INDIVIDUEL;BAC PROFESSIONNEL;BAC PRO SERV;BAC PRO 31214 MET.COM.VEN.OP.B PR.CL.VA.OF.COM.;2;1;0;1;0;0;0;0;0;0;0;0;0;1
20356.0;2023;09;LILLE;MASCULIN;INDIVIDUEL;BAC PROFESSIONNEL;BAC PRO SERV;BAC PRO 32208 REAL.PR.IMPR.PLURI.OPTB.PR.IMPR.;1;0;0;0;0;0;0;0;0;0;0;0;0;0
20360.0;2023;09;LILLE;MASCULIN;INDIVIDUEL;BAC PROFESSIONNEL;BAC PRO SERV;BAC PRO 34403 METIERS DE LA SECURITE;2;1;1;0;0;0;0;1;0;0;0;0;1;0
20373.0;2023;09;LILLE;MASCULIN;SCOLAIRE;BAC PROFESSIONNEL;BAC PRO PROD;BAC PRO 22003 BIO-INDUSTRIES DE TRANSFORMATION;18;18;13;4;1;1;0;14;0;4;5;2;3;4
20374.0;2023;09;LILLE;MASCULIN;SCOLAIRE;BAC PROFESSIONNEL;BAC PRO PROD;BAC PRO 22004 PROC. CHIMIE EAU PAPIERS-CARTONS;28;28;26;1;1;1;0;27;0;2;8;7;10;1
20377.0;2023;09;LILLE;MASCULIN;SCOLAIRE;BAC PROFESSIONNEL;BAC PRO PROD;BAC PRO 22106 CUISINE;240;240;188;33;19;16;3;204;0;13;42;77;72;36
20378.0;2023;09;LILLE;MASCULIN;SCOLAIRE;BAC PROFESSIONNEL;BAC PRO PROD;BAC PRO 22303 FONDERIE;8;8;6;1;1;0;1;6;0;0;0;4;2;2
20383.0;2023;09;LILLE;MASCULIN;SCOLAIRE;BAC PROFESSIONNEL;BAC PRO PROD;BAC PRO 23003 ARTIS. & M.ART:MARCHANDISAGE VIS.;2;2;2;0;0;0;0;2;0;0;2;0;0;0
20388.0;2023;09;LILLE;MASCULIN;SCOLAIRE;BAC PROFESSIONNEL;BAC PRO PROD;BAC PRO 23203 TECHNICIEN BAT. : ORG.REAL.GROS O;81;79;48;24;7;5;2;53;0;0;8;14;31;26
20390.0;2023;09;LILLE;MASCULIN;SCOLAIRE;BAC PROFESSIONNEL;BAC PRO PROD;BAC PRO 23303 MENUISERIE ALUMINIUM-VERRE;13;13;8;4;1;0;1;8;0;2;0;2;4;5
20395.0;2023;09;LILLE;MASCULIN;SCOLAIRE;BAC PROFESSIONNEL;BAC PRO PROD;BAC PRO 23408 Etude et réalisation d'agencement;9;9;8;1;0;0;0;8;0;0;1;4;3;1
20403.0;2023;09;LILLE;MASCULIN;SCOLAIRE;BAC PROFESSIONNEL;BAC PRO PROD;BAC PRO 25219 MAINT.MATERIELS OPT.A AGRICOLES;45;45;37;6;2;1;1;38;0;1;12;11;14;7
20412.0;2023;09;LILLE;MASCULIN;SCOLAIRE;BAC PROFESSIONNEL;BAC PRO PROD;BAC PRO 25513 SYST.NUM.OPT.A SURETE SECURITE;80;80;71;8;1;1;0;72;0;2;15;25;30;8
20424.0;2023;09;LILLE;MASCULIN;SCOLAIRE;BAC PROFESSIONNEL;BAC PRO PROD;BAC PRO AG 21405 AMENAGEMENTS PAYSAGERS;101;99;88;11;0;0;0;88;0;4;15;27;42;11
20425.0;2023;09;LILLE;MASCULIN;SCOLAIRE;BAC PROFESSIONNEL;BAC PRO PROD;BAC PRO AG 21407 TEC CONS VTE UNIVERS JARDINERIE;17;16;14;2;0;0;0;14;0;0;1;6;7;2
20441.0;2023;09;LILLE;MASCULIN;SCOLAIRE;BAC PROFESSIONNEL;BAC PRO SERV;BAC PRO 33004 ACC.SOINS-S.PERS. OPT.EN STRUCTUR;107;107;90;12;5;2;3;92;0;1;19;36;36;15
20452.0;2023;09;LILLE;MASCULIN;SCOLAIRE;BAC TECHNOLOGIQUE;BAC S2TMD;BAC S2TMD MUSIQUE;10;10;9;0;1;0;1;9;0;1;3;5;0;1
20460.0;2023;09;LILLE;MASCULIN;SCOLAIRE;BAC TECHNOLOGIQUE;BAC STI2D;BAC STI2D SYSTÈME D'INFORMATION  ET NUMERIQUE;499;499;428;13;58;47;11;475;1;21;83;160;210;24
20462.0;2023;09;LILLE;MASCULIN;SCOLAIRE;BAC TECHNOLOGIQUE;BAC STL;BAC STL SCIENCES PHYSIQUES CHIMIQUES  EN LABORAT.;92;92;82;3;7;4;3;86;2;2;18;24;40;6
20465.0;2023;09;LILLE;MASCULIN;SCOLAIRE;BAC TECHNOLOGIQUE;BAC STMG;BAC STMG RESSOURCES HUMAINES ET COMMUNICATION;475;475;310;55;110;87;23;397;0;1;23;80;293;78
20466.0;2023;09;LILLE;MASCULIN;SCOLAIRE;BAC TECHNOLOGIQUE;BAC STMG;BAC STMG SYSTEMES D'INFORMATION DE GESTION;14;14;9;2;3;3;0;12;0;0;0;6;6;2
20467.0;2023;22;LIMOGES;FEMININ;APPRENTISSAGE;BAC PROFESSIONNEL;BAC PRO PROD;BAC PRO 24203 METIERS DE LA MODE - VÊTEMENT;1;1;1;0;0;0;0;1;0;0;0;1;0;0
20472.0;2023;22;LIMOGES;FEMININ;APPRENTISSAGE;BAC PROFESSIONNEL;BAC PRO SERV;BAC PRO 31106 LOGISTIQUE;1;1;1;0;0;0;0;1;0;0;0;1;0;0
20477.0;2023;22;LIMOGES;FEMININ;APPRENTISSAGE;BAC PROFESSIONNEL;BAC PRO SERV;BAC PRO 33101 OPTIQUE LUNETTERIE;4;4;4;0;0;0;0;4;0;0;4;0;0;0
20492.0;2023;22;LIMOGES;FEMININ;INDIVIDUEL;BAC PROFESSIONNEL;BAC PRO SERV;BAC PRO 32207 REAL.PR.IMPR.PLURI.OPTA.PR.GRAPH.;1;1;0;1;0;0;0;0;0;0;0;0;0;1
20493.0;2023;22;LIMOGES;FEMININ;INDIVIDUEL;BAC PROFESSIONNEL;BAC PRO SERV;BAC PRO 33003 ACC.SOINS-S.PERS. OPT.A DOMICILE;3;3;1;2;0;0;0;1;0;0;0;0;1;2
20507.0;2023;22;LIMOGES;FEMININ;SCOLAIRE;BAC PROFESSIONNEL;BAC PRO PROD;BAC PRO 24203 METIERS DE LA MODE - VÊTEMENT;33;32;25;7;0;0;0;25;0;2;6;8;9;7
20512.0;2023;22;LIMOGES;FEMININ;SCOLAIRE;BAC PROFESSIONNEL;BAC PRO PROD;BAC PRO 25411 TECH.CHAUDRONNERIE INDUSTRIELLE;1;1;1;0;0;0;0;1;0;0;0;0;1;0
20514.0;2023;22;LIMOGES;FEMININ;SCOLAIRE;BAC PROFESSIONNEL;BAC PRO PROD;BAC PRO 25515 SYST.NUM.OPT.C RES.INF.SYST.COMM.;2;2;0;2;0;0;0;0;0;0;0;0;0;2
20515.0;2023;22;LIMOGES;FEMININ;SCOLAIRE;BAC PROFESSIONNEL;BAC PRO PROD;BAC PRO AG 21004 CGEA;21;21;16;5;0;0;0;16;0;1;1;6;8;5
20519.0;2023;22;LIMOGES;FEMININ;SCOLAIRE;BAC PROFESSIONNEL;BAC PRO PROD;BAC PRO AG 21302 GEST MILIEUX NATURELS FAUNE;8;7;6;1;0;0;0;6;0;0;2;0;4;1
20520.0;2023;22;LIMOGES;FEMININ;SCOLAIRE;BAC PROFESSIONNEL;BAC PRO PROD;BAC PRO AG 21405 AMENAGEMENTS PAYSAGERS;2;2;2;0;0;0;0;2;0;0;1;1;0;0
20525.0;2023;22;LIMOGES;FEMININ;SCOLAIRE;BAC PROFESSIONNEL;BAC PRO SERV;BAC PRO 31212 METIERS DE L'ACCUEIL;18;18;16;1;1;1;0;17;0;1;2;3;11;1
20541.0;2023;22;LIMOGES;FEMININ;SCOLAIRE;BAC TECHNOLOGIQUE;BAC ST2S;BAC ST2S SCIENCES & TECHNO. SANTE & SOCIAL;201;201;173;2;26;16;10;189;0;6;36;69;78;12
20548.0;2023;22;LIMOGES;FEMININ;SCOLAIRE;BAC TECHNOLOGIQUE;BAC STL;BAC STL BIOCHIM.-BIOLOGIE-BIOTECHNOL.;46;46;45;0;1;1;0;46;0;5;9;17;15;0
20556.0;2023;22;LIMOGES;MASCULIN;APPRENTISSAGE;BAC PROFESSIONNEL;BAC PRO PROD;BAC PRO 23004 TECHN. ETUDES BAT.A ETUDES & ECO.;1;1;1;0;0;0;0;1;0;1;0;0;0;0
20578.0;2023;22;LIMOGES;MASCULIN;APPRENTISSAGE;BAC PROFESSIONNEL;BAC PRO PROD;BAC PRO 25514 SYST.NUM.OPT.B AUD.RES.EQUIP.DOM.;2;2;2;0;0;0;0;2;0;1;0;1;0;0
20585.0;2023;22;LIMOGES;MASCULIN;APPRENTISSAGE;BAC PROFESSIONNEL;BAC PRO SERV;BAC PRO 33101 OPTIQUE LUNETTERIE;1;1;1;0;0;0;0;1;0;0;1;0;0;0
20591.0;2023;22;LIMOGES;MASCULIN;FORMATION CONTINUE;BAC PROFESSIONNEL;BAC PRO PROD;BAC PRO 25510 METIERS ELECT. ENVIRON. CONNECTES;4;4;3;1;0;0;0;3;0;1;0;1;1;1
20594.0;2023;22;LIMOGES;MASCULIN;INDIVIDUEL;BAC PROFESSIONNEL;BAC PRO PROD;BAC PRO 25214 MAINT.VEHIC.OPTA VOIT.PARTICUL.;1;0;0;0;0;0;0;0;0;0;0;0;0;0
20607.0;2023;22;LIMOGES;MASCULIN;SCOLAIRE;BAC GENERAL;BAC GENERAL;BAC GENE 10019 BAC GENERAL;1514;1514;1366;15;133;72;61;1438;20;147;309;457;505;76
20614.0;2023;22;LIMOGES;MASCULIN;SCOLAIRE;BAC PROFESSIONNEL;BAC PRO PROD;BAC PRO 23004 TECHN. ETUDES BAT.A ETUDES & ECO.;5;5;2;3;0;0;0;2;0;0;0;2;0;3
20617.0;2023;22;LIMOGES;MASCULIN;SCOLAIRE;BAC PROFESSIONNEL;BAC PRO PROD;BAC PRO 23203 TECHNICIEN BAT. : ORG.REAL.GROS O;5;5;5;0;0;0;0;5;0;0;2;2;1;0
20619.0;2023;22;LIMOGES;MASCULIN;SCOLAIRE;BAC PROFESSIONNEL;BAC PRO PROD;BAC PRO 23404 TECHNICIEN CONSTRUCTEUR BOIS;4;4;1;2;1;0;1;1;0;0;0;0;1;3
20620.0;2023;22;LIMOGES;MASCULIN;SCOLAIRE;BAC PROFESSIONNEL;BAC PRO PROD;BAC PRO 23405 TECHNICIEN MENUISIER AGENCEUR;18;18;17;1;0;0;0;17;0;1;4;10;2;1
20631.0;2023;22;LIMOGES;MASCULIN;SCOLAIRE;BAC PROFESSIONNEL;BAC PRO PROD;BAC PRO 25220 MAINT.MATERIELS OPT.B TP MANUT.;25;25;24;0;1;1;0;25;0;3;5;15;2;0
20633.0;2023;22;LIMOGES;MASCULIN;SCOLAIRE;BAC PROFESSIONNEL;BAC PRO PROD;BAC PRO 25408 REPARATION DES CARROSSERIES;13;13;9;3;1;1;0;10;0;0;0;5;5;3
20635.0;2023;22;LIMOGES;MASCULIN;SCOLAIRE;BAC PROFESSIONNEL;BAC PRO PROD;BAC PRO 25411 TECH.CHAUDRONNERIE INDUSTRIELLE;23;23;18;2;3;2;1;20;0;1;4;6;9;3
20644.0;2023;22;LIMOGES;MASCULIN;SCOLAIRE;BAC PROFESSIONNEL;BAC PRO PROD;BAC PRO AG 21204 PROD-AQUACOLES;10;10;9;1;0;0;0;9;0;0;0;1;8;1
20656.0;2023;22;LIMOGES;MASCULIN;SCOLAIRE;BAC PROFESSIONNEL;BAC PRO SERV;BAC PRO 32207 REAL.PR.IMPR.PLURI.OPTA.PR.GRAPH.;8;7;5;0;2;0;2;5;0;1;1;3;0;2
20661.0;2023;22;LIMOGES;MASCULIN;SCOLAIRE;BAC PROFESSIONNEL;BAC PRO SERV;BAC PRO 33006 ANIMAT. ENFANCE& PERSONNES AGEES;2;2;2;0;0;0;0;2;0;0;0;2;0;0
20679.0;2023;22;LIMOGES;MASCULIN;SCOLAIRE;BAC TECHNOLOGIQUE;BAC STMG;BAC STMG MERCATIQUE (MARKETING);167;167;118;13;36;25;11;143;0;0;4;33;106;24
20682.0;2023;10;LYON;FEMININ;APPRENTISSAGE;BAC PROFESSIONNEL;BAC PRO PROD;BAC PRO 20102 PILOTE DE LIGNE DE PRODUCTION;3;3;2;1;0;0;0;2;0;0;0;0;2;1
20688.0;2023;10;LYON;FEMININ;APPRENTISSAGE;BAC PROFESSIONNEL;BAC PRO PROD;BACPRO 23103 TECHNICIEN GEOMETRE-TOPOGRAPHE;1;1;1;0;0;0;0;1;0;0;1;0;0;0
20693.0;2023;10;LYON;FEMININ;APPRENTISSAGE;BAC PROFESSIONNEL;BAC PRO PROD;BAC PRO 25006 MICROTECHNIQUES;1;1;1;0;0;0;0;1;0;0;0;1;0;0
20695.0;2023;10;LYON;FEMININ;APPRENTISSAGE;BAC PROFESSIONNEL;BAC PRO PROD;BAC PRO 25106 TECHNICIEN D'USINAGE;1;1;1;0;0;0;0;1;0;1;0;0;0;0
20700.0;2023;10;LYON;FEMININ;APPRENTISSAGE;BAC PROFESSIONNEL;BAC PRO PROD;BAC PRO 25510 METIERS ELECT. ENVIRON. CONNECTES;2;2;2;0;0;0;0;2;0;2;0;0;0;0
20701.0;2023;10;LYON;FEMININ;APPRENTISSAGE;BAC PROFESSIONNEL;BAC PRO PROD;BAC PRO AG 21001 AGRO-EQUIPEMENT;1;1;1;0;0;0;0;1;0;1;0;0;0;0
20705.0;2023;10;LYON;FEMININ;APPRENTISSAGE;BAC PROFESSIONNEL;BAC PRO PROD;BAC PRO AG 21210 COND GEST ENTR CANIN ET FELIN;8;8;7;1;0;0;0;7;0;0;2;2;3;1
20711.0;2023;10;LYON;FEMININ;APPRENTISSAGE;BAC PROFESSIONNEL;BAC PRO SERV;BAC PRO 31106 LOGISTIQUE;2;2;2;0;0;0;0;2;0;1;0;1;0;0
20716.0;2023;10;LYON;FEMININ;APPRENTISSAGE;BAC PROFESSIONNEL;BAC PRO SERV;BAC PRO 32208 REAL.PR.IMPR.PLURI.OPTB.PR.IMPR.;4;4;3;1;0;0;0;3;0;0;1;1;1;1
20720.0;2023;10;LYON;FEMININ;APPRENTISSAGE;BAC PROFESSIONNEL;BAC PRO SERV;BAC PRO 33603 ESTHETIQUE COSMETIQUE PARFUMERIE;5;5;5;0;0;0;0;5;0;0;1;1;3;0
20721.0;2023;10;LYON;FEMININ;APPRENTISSAGE;BAC PROFESSIONNEL;BAC PRO SERV;BAC PRO 33604 METIERS DE LA COIFFURE;7;7;6;1;0;0;0;6;0;0;0;4;2;1
20723.0;2023;10;LYON;FEMININ;APPRENTISSAGE;BAC PROFESSIONNEL;BAC PRO SERV;BAC PRO AG 33002 SERV PERS TERRIT;25;24;24;0;0;0;0;24;0;1;1;10;12;0
20724.0;2023;10;LYON;FEMININ;ENSEIGNEMENT A DISTANCE;BAC GENERAL;BAC GENERAL;BAC GENE 10019 BAC GENERAL;86;86;57;17;12;4;8;61;1;4;10;21;25;25
20731.0;2023;10;LYON;FEMININ;FORMATION CONTINUE;BAC PROFESSIONNEL;BAC PRO SERV;BAC PRO 30004 ASSISTANC.GEST.ORGANIS.ACTIVITES;8;7;7;0;0;0;0;7;0;0;2;3;2;0
20732.0;2023;10;LYON;FEMININ;FORMATION CONTINUE;BAC PROFESSIONNEL;BAC PRO SERV;BAC PRO 31213 MET.COM.VEN.OP.A ANI.GES.ESP.COM.;3;3;2;0;1;1;0;3;0;0;0;0;3;0
20743.0;2023;10;LYON;FEMININ;INDIVIDUEL;BAC PROFESSIONNEL;BAC PRO SERV;BAC PRO 31213 MET.COM.VEN.OP.A ANI.GES.ESP.COM.;6;6;5;1;0;0;0;5;0;0;0;1;4;1
20744.0;2023;10;LYON;FEMININ;INDIVIDUEL;BAC PROFESSIONNEL;BAC PRO SERV;BAC PRO 31214 MET.COM.VEN.OP.B PR.CL.VA.OF.COM.;3;2;2;0;0;0;0;2;0;0;0;1;1;0
20745.0;2023;10;LYON;FEMININ;INDIVIDUEL;BAC PROFESSIONNEL;BAC PRO SERV;BAC PRO 33003 ACC.SOINS-S.PERS. OPT.A DOMICILE;1;1;0;1;0;0;0;0;0;0;0;0;0;1
20746.0;2023;10;LYON;FEMININ;INDIVIDUEL;BAC PROFESSIONNEL;BAC PRO SERV;BAC PRO 33004 ACC.SOINS-S.PERS. OPT.EN STRUCTUR;12;10;4;5;1;1;0;5;0;0;1;1;3;5
20747.0;2023;10;LYON;FEMININ;INDIVIDUEL;BAC PROFESSIONNEL;BAC PRO SERV;BAC PRO 33104 TECHNICIEN EN PROTHESE DENTAIRE;1;1;1;0;0;0;0;1;0;0;0;0;1;0
20748.0;2023;10;LYON;FEMININ;INDIVIDUEL;BAC PROFESSIONNEL;BAC PRO SERV;BAC PRO 33603 ESTHETIQUE COSMETIQUE PARFUMERIE;6;4;3;1;0;0;0;3;0;0;0;0;3;1
20752.0;2023;10;LYON;FEMININ;INDIVIDUEL;BAC TECHNOLOGIQUE;BAC STL;BAC STL BIOCHIM.-BIOLOGIE-BIOTECHNOL.;2;2;0;1;1;1;0;1;0;0;0;0;1;1
20759.0;2023;10;LYON;FEMININ;SCOLAIRE;BAC PROFESSIONNEL;BAC PRO PROD;BAC PRO 20102 PILOTE DE LIGNE DE PRODUCTION;4;4;4;0;0;0;0;4;0;0;0;2;2;0
20762.0;2023;10;LYON;FEMININ;SCOLAIRE;BAC PROFESSIONNEL;BAC PRO PROD;BAC PRO 22104 BOUCHER CHARCUTIER TRAITEUR;1;1;1;0;0;0;0;1;0;0;1;0;0;0
20778.0;2023;10;LYON;FEMININ;SCOLAIRE;BAC PROFESSIONNEL;BAC PRO PROD;BAC PRO 24203 METIERS DE LA MODE - VÊTEMENT;131;130;106;24;0;0;0;106;0;12;25;34;35;24
20782.0;2023;10;LYON;FEMININ;SCOLAIRE;BAC PROFESSIONNEL;BAC PRO PROD;BAC PRO 25106 TECHNICIEN D'USINAGE;2;2;2;0;0;0;0;2;0;1;0;1;0;0
20783.0;2023;10;LYON;FEMININ;SCOLAIRE;BAC PROFESSIONNEL;BAC PRO PROD;BAC PRO 25214 MAINT.VEHIC.OPTA VOIT.PARTICUL.;5;5;4;1;0;0;0;4;0;1;1;1;1;1
20784.0;2023;10;LYON;FEMININ;SCOLAIRE;BAC PROFESSIONNEL;BAC PRO PROD;BAC PRO 25406 OUVRAGES DU BATIMENT METALLERIE;1;1;1;0;0;0;0;1;0;0;1;0;0;0
20802.0;2023;10;LYON;FEMININ;SCOLAIRE;BAC PROFESSIONNEL;BAC PRO SERV;BAC PRO 30004 ASSISTANC.GEST.ORGANIS.ACTIVITES;631;627;471;128;28;22;6;493;0;17;84;158;234;134
20804.0;2023;10;LYON;FEMININ;SCOLAIRE;BAC PROFESSIONNEL;BAC PRO SERV;BAC PRO 31107 CONDUCT. TRANSP.ROUT.MARCHANDISES;2;2;2;0;0;0;0;2;0;0;1;1;0;0
20810.0;2023;10;LYON;FEMININ;SCOLAIRE;BAC PROFESSIONNEL;BAC PRO SERV;BAC PRO 32208 REAL.PR.IMPR.PLURI.OPTB.PR.IMPR.;9;9;9;0;0;0;0;9;0;0;2;3;4;0
20811.0;2023;10;LYON;FEMININ;SCOLAIRE;BAC PROFESSIONNEL;BAC PRO SERV;BAC PRO 32303 ART.& MET.ART:COM.VIS.VIS.PLURI-M;39;39;36;3;0;0;0;36;0;3;15;15;3;3
20812.0;2023;10;LYON;FEMININ;SCOLAIRE;BAC PROFESSIONNEL;BAC PRO SERV;BAC PRO 32304 PHOTOGRAPHIE;17;17;14;3;0;0;0;14;0;3;5;4;2;3
20815.0;2023;10;LYON;FEMININ;SCOLAIRE;BAC PROFESSIONNEL;BAC PRO SERV;BAC PRO 33004 ACC.SOINS-S.PERS. OPT.EN STRUCTUR;589;587;503;54;30;23;7;526;0;25;110;201;190;61
20819.0;2023;10;LYON;FEMININ;SCOLAIRE;BAC PROFESSIONNEL;BAC PRO SERV;BAC PRO 33403 COMMERC. SERVICES EN RESTAURATION;37;37;30;7;0;0;0;30;0;1;5;15;9;7
20821.0;2023;10;LYON;FEMININ;SCOLAIRE;BAC PROFESSIONNEL;BAC PRO SERV;BAC PRO 33603 ESTHETIQUE COSMETIQUE PARFUMERIE;193;190;166;24;0;0;0;166;0;12;31;62;61;24
20827.0;2023;10;LYON;FEMININ;SCOLAIRE;BAC TECHNOLOGIQUE;BAC S2TMD;BAC S2TMD MUSIQUE;6;6;6;0;0;0;0;6;1;1;3;1;0;0
20830.0;2023;10;LYON;FEMININ;SCOLAIRE;BAC TECHNOLOGIQUE;BAC STD2A;BAC STD2A SCIENCES & TECHNO. DESIGN-ARTS APPLIQUES;128;128;121;2;5;2;3;123;0;11;36;51;25;5
20840.0;2023;10;LYON;FEMININ;SCOLAIRE;BAC TECHNOLOGIQUE;BAC STMG;BAC STMG RESSOURCES HUMAINES ET COMMUNICATION;642;642;459;57;126;90;36;549;0;2;42;163;342;93
20844.0;2023;10;LYON;MASCULIN;APPRENTISSAGE;BAC PROFESSIONNEL;BAC PRO PROD;BAC PRO 22004 PROC. CHIMIE EAU PAPIERS-CARTONS;16;16;15;1;0;0;0;15;0;3;9;3;0;1
20853.0;2023;10;LYON;MASCULIN;APPRENTISSAGE;BAC PROFESSIONNEL;BAC PRO PROD;BACPRO 23103 TECHNICIEN GEOMETRE-TOPOGRAPHE;6;6;5;1;0;0;0;5;0;0;0;2;3;1
20877.0;2023;10;LYON;MASCULIN;APPRENTISSAGE;BAC PROFESSIONNEL;BAC PRO PROD;BAC PRO 25509 TECHNIC. FROID CONDITIONNEMT AIR;22;22;17;4;1;1;0;18;0;0;4;8;6;4
20878.0;2023;10;LYON;MASCULIN;APPRENTISSAGE;BAC PROFESSIONNEL;BAC PRO PROD;BAC PRO 25510 METIERS ELECT. ENVIRON. CONNECTES;111;111;90;15;6;6;0;96;0;17;19;27;33;15
20879.0;2023;10;LYON;MASCULIN;APPRENTISSAGE;BAC PROFESSIONNEL;BAC PRO PROD;BAC PRO 25514 SYST.NUM.OPT.B AUD.RES.EQUIP.DOM.;1;1;0;1;0;0;0;0;0;0;0;0;0;1
20880.0;2023;10;LYON;MASCULIN;APPRENTISSAGE;BAC PROFESSIONNEL;BAC PRO PROD;BAC PRO 25515 SYST.NUM.OPT.C RES.INF.SYST.COMM.;11;11;10;1;0;0;0;10;0;1;3;5;1;1
20887.0;2023;10;LYON;MASCULIN;APPRENTISSAGE;BAC PROFESSIONNEL;BAC PRO PROD;BAC PRO AG 21211 COND GEST ENTR HIPPIQUE;4;4;4;0;0;0;0;4;0;0;0;0;4;0
20888.0;2023;10;LYON;MASCULIN;APPRENTISSAGE;BAC PROFESSIONNEL;BAC PRO PROD;BAC PRO AG 21212 TECH EXPE ANIMALE;8;8;8;0;0;0;0;8;0;0;0;4;4;0
20896.0;2023;10;LYON;MASCULIN;APPRENTISSAGE;BAC PROFESSIONNEL;BAC PRO SERV;BAC PRO 31214 MET.COM.VEN.OP.B PR.CL.VA.OF.COM.;11;11;11;0;0;0;0;11;0;0;2;5;4;0
20905.0;2023;10;LYON;MASCULIN;ENSEIGNEMENT A DISTANCE;BAC TECHNOLOGIQUE;BAC ST2S;BAC ST2S SCIENCES & TECHNO. SANTE & SOCIAL;4;4;2;2;0;0;0;2;0;0;0;0;2;2
20907.0;2023;10;LYON;MASCULIN;FORMATION CONTINUE;BAC PROFESSIONNEL;BAC PRO PROD;BAC PRO 22004 PROC. CHIMIE EAU PAPIERS-CARTONS;5;5;5;0;0;0;0;5;0;2;2;1;0;0
20908.0;2023;10;LYON;MASCULIN;FORMATION CONTINUE;BAC PROFESSIONNEL;BAC PRO PROD;BAC PRO 22704 TECHN. MAINT. SYST.ENERG.CLIMATI;10;10;10;0;0;0;0;10;0;0;3;4;3;0
20909.0;2023;10;LYON;MASCULIN;FORMATION CONTINUE;BAC PROFESSIONNEL;BAC PRO PROD;BAC PRO 22705 TECHNICIEN GAZ;1;1;1;0;0;0;0;1;0;0;1;0;0;0
20913.0;2023;10;LYON;MASCULIN;FORMATION CONTINUE;BAC PROFESSIONNEL;BAC PRO SERV;BAC PRO 30004 ASSISTANC.GEST.ORGANIS.ACTIVITES;4;4;4;0;0;0;0;4;0;0;2;2;0;0
20915.0;2023;10;LYON;MASCULIN;INDIVIDUEL;BAC GENERAL;BAC GENERAL;BAC GENE 10019 BAC GENERAL;178;175;68;77;30;19;11;87;0;5;13;19;50;88
20916.0;2023;10;LYON;MASCULIN;INDIVIDUEL;BAC PROFESSIONNEL;BAC PRO PROD;BAC PRO 20102 PILOTE DE LIGNE DE PRODUCTION;3;1;0;1;0;0;0;0;0;0;0;0;0;1
20925.0;2023;10;LYON;MASCULIN;INDIVIDUEL;BAC PROFESSIONNEL;BAC PRO PROD;BAC PRO 25214 MAINT.VEHIC.OPTA VOIT.PARTICUL.;5;1;0;1;0;0;0;0;0;0;0;0;0;1
20927.0;2023;10;LYON;MASCULIN;INDIVIDUEL;BAC PROFESSIONNEL;BAC PRO PROD;BAC PRO 25408 REPARATION DES CARROSSERIES;1;0;0;0;0;0;0;0;0;0;0;0;0;0
20934.0;2023;10;LYON;MASCULIN;INDIVIDUEL;BAC PROFESSIONNEL;BAC PRO PROD;BAC PRO AG 21114 CONDUITE PRODUCTIONS HORTICOLES;6;6;6;0;0;0;0;6;0;0;0;1;5;0
20943.0;2023;10;LYON;MASCULIN;INDIVIDUEL;BAC PROFESSIONNEL;BAC PRO SERV;BAC PRO 34403 METIERS DE LA SECURITE;1;1;1;0;0;0;0;1;0;0;1;0;0;0
20946.0;2023;10;LYON;MASCULIN;INDIVIDUEL;BAC TECHNOLOGIQUE;BAC STAV;BAC STAV AGRONOMIE ALIM ENV TERRITOI;1;1;1;0;0;0;0;1;0;0;0;0;1;0
20961.0;2023;10;LYON;MASCULIN;SCOLAIRE;BAC PROFESSIONNEL;BAC PRO PROD;BAC PRO 22104 BOUCHER CHARCUTIER TRAITEUR;4;4;4;0;0;0;0;4;0;0;0;4;0;0
20963.0;2023;10;LYON;MASCULIN;SCOLAIRE;BAC PROFESSIONNEL;BAC PRO PROD;BAC PRO 22106 CUISINE;79;79;64;11;4;3;1;67;0;3;15;27;22;12
20964.0;2023;10;LYON;MASCULIN;SCOLAIRE;BAC PROFESSIONNEL;BAC PRO PROD;BAC PRO 22303 FONDERIE;9;9;5;4;0;0;0;5;0;1;1;1;2;4
20975.0;2023;10;LYON;MASCULIN;SCOLAIRE;BAC PROFESSIONNEL;BAC PRO PROD;BAC PRO 23304 AMENAGEMENT FINITION BATIMENT;11;10;4;5;1;0;1;4;0;0;0;0;4;6
20983.0;2023;10;LYON;MASCULIN;SCOLAIRE;BAC PROFESSIONNEL;BAC PRO PROD;BAC PRO 24203 METIERS DE LA MODE - VÊTEMENT;12;12;10;2;0;0;0;10;0;3;2;2;3;2
20992.0;2023;10;LYON;MASCULIN;SCOLAIRE;BAC PROFESSIONNEL;BAC PRO PROD;BAC PRO 25215 MAINT.VEHIC.OPTB VEHIC.TRANS.ROUT;25;25;17;6;2;1;1;18;0;1;1;8;8;7
20995.0;2023;10;LYON;MASCULIN;SCOLAIRE;BAC PROFESSIONNEL;BAC PRO PROD;BAC PRO 25220 MAINT.MATERIELS OPT.B TP MANUT.;18;18;15;2;1;1;0;16;0;0;4;8;4;2
21003.0;2023;10;LYON;MASCULIN;SCOLAIRE;BAC PROFESSIONNEL;BAC PRO PROD;BAC PRO 25514 SYST.NUM.OPT.B AUD.RES.EQUIP.DOM.;91;91;70;18;3;2;1;72;0;3;12;31;26;19
21010.0;2023;10;LYON;MASCULIN;SCOLAIRE;BAC PROFESSIONNEL;BAC PRO PROD;BAC PRO AG 21210 COND GEST ENTR CANIN ET FELIN;8;8;7;1;0;0;0;7;0;0;0;2;5;1
21014.0;2023;10;LYON;MASCULIN;SCOLAIRE;BAC PROFESSIONNEL;BAC PRO PROD;BAC PRO AG 21303 FORET;21;21;20;1;0;0;0;20;0;0;1;9;10;1
21015.0;2023;10;LYON;MASCULIN;SCOLAIRE;BAC PROFESSIONNEL;BAC PRO PROD;BAC PRO AG 21405 AMENAGEMENTS PAYSAGERS;67;66;60;6;0;0;0;60;0;1;10;24;25;6
21018.0;2023;10;LYON;MASCULIN;SCOLAIRE;BAC PROFESSIONNEL;BAC PRO PROD;BAC PRO AG 22108 TEC CONS VTE ALIMENTATION (PAB);29;28;23;5;0;0;0;23;0;1;0;9;13;5
21030.0;2023;10;LYON;MASCULIN;SCOLAIRE;BAC PROFESSIONNEL;BAC PRO SERV;BAC PRO 33003 ACC.SOINS-S.PERS. OPT.A DOMICILE;8;8;5;2;1;1;0;6;0;0;1;3;2;2
21031.0;2023;10;LYON;MASCULIN;SCOLAIRE;BAC PROFESSIONNEL;BAC PRO SERV;BAC PRO 33004 ACC.SOINS-S.PERS. OPT.EN STRUCTUR;36;36;26;6;4;3;1;29;0;0;5;9;15;7
21034.0;2023;10;LYON;MASCULIN;SCOLAIRE;BAC PROFESSIONNEL;BAC PRO SERV;BAC PRO 33104 TECHNICIEN EN PROTHESE DENTAIRE;19;19;17;2;0;0;0;17;0;1;5;4;7;2
21044.0;2023;10;LYON;MASCULIN;SCOLAIRE;BAC TECHNOLOGIQUE;BAC STD2A;BAC STD2A SCIENCES & TECHNO. DESIGN-ARTS APPLIQUES;32;32;31;0;1;1;0;32;0;5;5;9;13;0
21056.0;2023;31;MARTINIQUE;FEMININ;APPRENTISSAGE;BAC PROFESSIONNEL;BAC PRO PROD;BAC PRO 22106 CUISINE;3;3;3;0;0;0;0;3;0;0;2;1;0;0
21061.0;2023;31;MARTINIQUE;FEMININ;APPRENTISSAGE;BAC PROFESSIONNEL;BAC PRO SERV;BAC PRO 31213 MET.COM.VEN.OP.A ANI.GES.ESP.COM.;5;4;3;1;0;0;0;3;0;0;0;2;1;1
21063.0;2023;31;MARTINIQUE;FEMININ;ENSEIGNEMENT A DISTANCE;BAC GENERAL;BAC GENERAL;BAC GENE 10019 BAC GENERAL;8;8;6;0;2;1;1;7;0;0;1;2;4;1
21067.0;2023;31;MARTINIQUE;FEMININ;INDIVIDUEL;BAC PROFESSIONNEL;BAC PRO PROD;BAC PRO 22106 CUISINE;1;1;0;1;0;0;0;0;0;0;0;0;0;1
21072.0;2023;31;MARTINIQUE;FEMININ;INDIVIDUEL;BAC PROFESSIONNEL;BAC PRO SERV;BAC PRO 33603 ESTHETIQUE COSMETIQUE PARFUMERIE;2;2;0;2;0;0;0;0;0;0;0;0;0;2
21076.0;2023;31;MARTINIQUE;FEMININ;SCOLAIRE;BAC GENERAL;BAC GENERAL;BAC GENE 10019 BAC GENERAL;1138;1138;1025;28;85;77;8;1102;26;137;260;322;357;36
21079.0;2023;31;MARTINIQUE;FEMININ;SCOLAIRE;BAC PROFESSIONNEL;BAC PRO PROD;BAC PRO 22105 BOULANGER-PÂTISSIER;20;20;16;3;1;1;0;17;0;1;1;7;8;3
21083.0;2023;31;MARTINIQUE;FEMININ;SCOLAIRE;BAC PROFESSIONNEL;BAC PRO PROD;BAC PRO 23005 TECHN. ETUDES BAT B ASSIST.ARCHI.;1;1;1;0;0;0;0;1;0;0;0;0;1;0
21084.0;2023;31;MARTINIQUE;FEMININ;SCOLAIRE;BAC PROFESSIONNEL;BAC PRO PROD;BAC PRO 23304 AMENAGEMENT FINITION BATIMENT;2;2;2;0;0;0;0;2;0;0;1;1;0;0
21087.0;2023;31;MARTINIQUE;FEMININ;SCOLAIRE;BAC PROFESSIONNEL;BAC PRO PROD;BAC PRO 25009 MAINTENANCE NAUTIQUE;1;1;1;0;0;0;0;1;0;0;0;0;1;0
21088.0;2023;31;MARTINIQUE;FEMININ;SCOLAIRE;BAC PROFESSIONNEL;BAC PRO PROD;BAC PRO 25214 MAINT.VEHIC.OPTA VOIT.PARTICUL.;3;3;3;0;0;0;0;3;0;0;0;2;1;0
21092.0;2023;31;MARTINIQUE;FEMININ;SCOLAIRE;BAC PROFESSIONNEL;BAC PRO PROD;BAC PRO AG 21001 AGRO-EQUIPEMENT;1;1;1;0;0;0;0;1;0;0;0;0;1;0
21099.0;2023;31;MARTINIQUE;FEMININ;SCOLAIRE;BAC PROFESSIONNEL;BAC PRO SERV;BAC PRO 31212 METIERS DE L'ACCUEIL;42;42;32;4;6;5;1;37;0;1;7;12;17;5
21103.0;2023;31;MARTINIQUE;FEMININ;SCOLAIRE;BAC PROFESSIONNEL;BAC PRO SERV;BAC PRO 33002 SERVICES DE PROXIMITE  VIE LOCAL;1;1;0;0;1;1;0;1;0;0;0;0;1;0
21108.0;2023;31;MARTINIQUE;FEMININ;SCOLAIRE;BAC PROFESSIONNEL;BAC PRO SERV;BAC PRO 33603 ESTHETIQUE COSMETIQUE PARFUMERIE;23;23;14;9;0;0;0;14;0;0;2;3;9;9
21115.0;2023;31;MARTINIQUE;FEMININ;SCOLAIRE;BAC TECHNOLOGIQUE;BAC STAV;BAC STAV AGRONOMIE ALIM ENV TERRITOI;5;5;5;0;0;0;0;5;0;0;0;0;5;0
21118.0;2023;31;MARTINIQUE;FEMININ;SCOLAIRE;BAC TECHNOLOGIQUE;BAC STI2D;BAC STI2D ARCHITECTURE ET CONSTRUCTION;17;17;14;1;2;2;0;16;0;1;2;7;6;1
21123.0;2023;31;MARTINIQUE;FEMININ;SCOLAIRE;BAC TECHNOLOGIQUE;BAC STMG;BAC STMG MERCATIQUE (MARKETING);63;63;60;2;1;1;0;61;0;0;17;20;24;2
21125.0;2023;31;MARTINIQUE;FEMININ;SCOLAIRE;BAC TECHNOLOGIQUE;BAC STMG;BAC STMG SYSTEMES D'INFORMATION DE GESTION;12;12;7;1;4;3;1;10;0;0;2;3;5;2
21129.0;2023;31;MARTINIQUE;MASCULIN;APPRENTISSAGE;BAC PROFESSIONNEL;BAC PRO PROD;BAC PRO 22704 TECHN. MAINT. SYST.ENERG.CLIMATI;3;2;2;0;0;0;0;2;0;0;0;0;2;0
21130.0;2023;31;MARTINIQUE;MASCULIN;APPRENTISSAGE;BAC PROFESSIONNEL;BAC PRO PROD;BAC PRO 23203 TECHNICIEN BAT. : ORG.REAL.GROS O;1;1;1;0;0;0;0;1;0;0;0;0;1;0
21140.0;2023;31;MARTINIQUE;MASCULIN;ENSEIGNEMENT A DISTANCE;BAC GENERAL;BAC GENERAL;BAC GENE 10019 BAC GENERAL;2;2;1;1;0;0;0;1;0;0;0;0;1;1
21141.0;2023;31;MARTINIQUE;MASCULIN;ENSEIGNEMENT A DISTANCE;BAC TECHNOLOGIQUE;BAC STMG;BAC STMG MERCATIQUE (MARKETING);1;1;0;0;1;1;0;1;0;0;0;0;1;0
21148.0;2023;31;MARTINIQUE;MASCULIN;INDIVIDUEL;BAC PROFESSIONNEL;BAC PRO PROD;BAC PRO 25513 SYST.NUM.OPT.A SURETE SECURITE;1;1;0;1;0;0;0;0;0;0;0;0;0;1
21150.0;2023;31;MARTINIQUE;MASCULIN;INDIVIDUEL;BAC PROFESSIONNEL;BAC PRO SERV;BAC PRO 31213 MET.COM.VEN.OP.A ANI.GES.ESP.COM.;1;0;0;0;0;0;0;0;0;0;0;0;0;0
21151.0;2023;31;MARTINIQUE;MASCULIN;INDIVIDUEL;BAC TECHNOLOGIQUE;BAC STAV;BAC STAV AGRONOMIE ALIM ENV TERRITOI;1;0;0;0;0;0;0;0;0;0;0;0;0;0
21156.0;2023;31;MARTINIQUE;MASCULIN;SCOLAIRE;BAC PROFESSIONNEL;BAC PRO PROD;BAC PRO 22106 CUISINE;34;34;32;0;2;2;0;34;0;3;5;16;10;0
21166.0;2023;31;MARTINIQUE;MASCULIN;SCOLAIRE;BAC PROFESSIONNEL;BAC PRO PROD;BAC PRO 23404 TECHNICIEN CONSTRUCTEUR BOIS;8;8;4;3;1;1;0;5;0;0;0;2;3;3
21169.0;2023;31;MARTINIQUE;MASCULIN;SCOLAIRE;BAC PROFESSIONNEL;BAC PRO PROD;BAC PRO 24203 METIERS DE LA MODE - VÊTEMENT;4;4;1;2;1;1;0;2;0;0;0;0;2;2
21174.0;2023;31;MARTINIQUE;MASCULIN;SCOLAIRE;BAC PROFESSIONNEL;BAC PRO PROD;BAC PRO 25219 MAINT.MATERIELS OPT.A AGRICOLES;5;5;3;0;2;2;0;5;0;0;1;0;4;0
21179.0;2023;31;MARTINIQUE;MASCULIN;SCOLAIRE;BAC PROFESSIONNEL;BAC PRO PROD;BAC PRO 25509 TECHNIC. FROID CONDITIONNEMT AIR;23;23;16;4;3;2;1;18;0;1;2;5;10;5
21183.0;2023;31;MARTINIQUE;MASCULIN;SCOLAIRE;BAC PROFESSIONNEL;BAC PRO PROD;BAC PRO 25515 SYST.NUM.OPT.C RES.INF.SYST.COMM.;17;17;17;0;0;0;0;17;0;0;3;8;6;0
21193.0;2023;31;MARTINIQUE;MASCULIN;SCOLAIRE;BAC PROFESSIONNEL;BAC PRO SERV;BAC PRO 31213 MET.COM.VEN.OP.A ANI.GES.ESP.COM.;60;60;43;14;3;3;0;46;0;1;7;14;24;14
21194.0;2023;31;MARTINIQUE;MASCULIN;SCOLAIRE;BAC PROFESSIONNEL;BAC PRO SERV;BAC PRO 31214 MET.COM.VEN.OP.B PR.CL.VA.OF.COM.;58;57;41;14;2;2;0;43;0;2;3;11;27;14
21198.0;2023;31;MARTINIQUE;MASCULIN;SCOLAIRE;BAC PROFESSIONNEL;BAC PRO SERV;BAC PRO 33006 ANIMAT. ENFANCE& PERSONNES AGEES;2;2;2;0;0;0;0;2;0;0;0;2;0;0
21201.0;2023;31;MARTINIQUE;MASCULIN;SCOLAIRE;BAC PROFESSIONNEL;BAC PRO SERV;BAC PRO 34303 GEST. POLLUTIONS PROTEC. ENVIRON.;8;8;6;2;0;0;0;6;0;0;1;3;2;2
21202.0;2023;31;MARTINIQUE;MASCULIN;SCOLAIRE;BAC PROFESSIONNEL;BAC PRO SERV;BAC PRO 34304 HYGIENE PROPRETE STERILISATION;6;6;3;0;3;3;0;6;0;0;0;1;5;0
21210.0;2023;31;MARTINIQUE;MASCULIN;SCOLAIRE;BAC TECHNOLOGIQUE;BAC STI2D;BAC STI2D ENERGIES  ET ENVIRONNEMENT;29;29;20;2;7;4;3;24;0;0;0;7;17;5
21212.0;2023;31;MARTINIQUE;MASCULIN;SCOLAIRE;BAC TECHNOLOGIQUE;BAC STI2D;BAC STI2D SYSTÈME D'INFORMATION  ET NUMERIQUE;43;43;34;1;8;8;0;42;0;1;4;6;31;1
21215.0;2023;31;MARTINIQUE;MASCULIN;SCOLAIRE;BAC TECHNOLOGIQUE;BAC STMG;BAC STMG MERCATIQUE (MARKETING);80;80;62;0;18;18;0;80;0;0;3;23;54;0
21217.0;2023;31;MARTINIQUE;MASCULIN;SCOLAIRE;BAC TECHNOLOGIQUE;BAC STMG;BAC STMG SYSTEMES D'INFORMATION DE GESTION;25;25;14;2;9;9;0;23;0;0;0;5;18;2
21225.0;2023;43;MAYOTTE;FEMININ;INDIVIDUEL;BAC GENERAL;BAC GENERAL;BAC GENE 10019 BAC GENERAL;47;47;2;29;16;4;12;6;0;0;1;1;4;41
21229.0;2023;43;MAYOTTE;FEMININ;INDIVIDUEL;BAC PROFESSIONNEL;BAC PRO SERV;BAC PRO 31212 METIERS DE L'ACCUEIL;2;2;0;0;2;2;0;2;0;0;0;0;2;0
21230.0;2023;43;MAYOTTE;FEMININ;INDIVIDUEL;BAC PROFESSIONNEL;BAC PRO SERV;BAC PRO 31213 MET.COM.VEN.OP.A ANI.GES.ESP.COM.;1;0;0;0;0;0;0;0;0;0;0;0;0;0
21231.0;2023;43;MAYOTTE;FEMININ;INDIVIDUEL;BAC PROFESSIONNEL;BAC PRO SERV;BAC PRO 31214 MET.COM.VEN.OP.B PR.CL.VA.OF.COM.;1;1;0;1;0;0;0;0;0;0;0;0;0;1
21233.0;2023;43;MAYOTTE;FEMININ;INDIVIDUEL;BAC TECHNOLOGIQUE;BAC ST2S;BAC ST2S SCIENCES & TECHNO. SANTE & SOCIAL;3;3;0;1;2;1;1;1;0;0;0;0;1;2
21234.0;2023;43;MAYOTTE;FEMININ;INDIVIDUEL;BAC TECHNOLOGIQUE;BAC STD2A;BAC STD2A SCIENCES & TECHNO. DESIGN-ARTS APPLIQUES;1;1;0;0;1;0;1;0;0;0;0;0;0;1
21240.0;2023;43;MAYOTTE;FEMININ;INDIVIDUEL;BAC TECHNOLOGIQUE;BAC STMG;BAC STMG MERCATIQUE (MARKETING);11;11;1;7;3;2;1;3;0;0;0;0;3;8
21242.0;2023;43;MAYOTTE;FEMININ;SCOLAIRE;BAC GENERAL;BAC GENERAL;BAC GENE 10019 BAC GENERAL;1606;1606;954;227;425;262;163;1216;3;47;175;325;666;390
21253.0;2023;43;MAYOTTE;FEMININ;SCOLAIRE;BAC PROFESSIONNEL;BAC PRO PROD;BAC PRO 25303 AERONAUTIQUE OPTION SYSTEMES;1;1;1;0;0;0;0;1;0;0;0;1;0;0
21257.0;2023;43;MAYOTTE;FEMININ;SCOLAIRE;BAC PROFESSIONNEL;BAC PRO PROD;BAC PRO 25514 SYST.NUM.OPT.B AUD.RES.EQUIP.DOM.;2;2;0;0;2;2;0;2;0;0;0;0;2;0
21267.0;2023;43;MAYOTTE;FEMININ;SCOLAIRE;BAC PROFESSIONNEL;BAC PRO SERV;BAC PRO 32303 ART.& MET.ART:COM.VIS.VIS.PLURI-M;4;4;2;1;1;1;0;3;0;0;0;2;1;1
21268.0;2023;43;MAYOTTE;FEMININ;SCOLAIRE;BAC PROFESSIONNEL;BAC PRO SERV;BAC PRO 33003 ACC.SOINS-S.PERS. OPT.A DOMICILE;65;65;36;21;8;7;1;43;0;0;0;13;30;22
21269.0;2023;43;MAYOTTE;FEMININ;SCOLAIRE;BAC PROFESSIONNEL;BAC PRO SERV;BAC PRO 33004 ACC.SOINS-S.PERS. OPT.EN STRUCTUR;29;29;20;4;5;5;0;25;0;0;1;6;18;4
21277.0;2023;43;MAYOTTE;FEMININ;SCOLAIRE;BAC TECHNOLOGIQUE;BAC STHR;BAC STHR SC.&TEC. HOTELLERIE-RESTAURATION;20;20;16;0;4;1;3;17;0;0;1;3;13;3
21280.0;2023;43;MAYOTTE;FEMININ;SCOLAIRE;BAC TECHNOLOGIQUE;BAC STI2D;BAC STI2D INNOVATION TECHNO.  ET ECO CONCEPTION;19;19;4;7;8;8;0;12;0;0;0;1;11;7
21283.0;2023;43;MAYOTTE;FEMININ;SCOLAIRE;BAC TECHNOLOGIQUE;BAC STMG;BAC STMG GESTION ET FINANCE;132;132;66;19;47;46;1;112;0;0;8;20;84;20
21285.0;2023;43;MAYOTTE;FEMININ;SCOLAIRE;BAC TECHNOLOGIQUE;BAC STMG;BAC STMG RESSOURCES HUMAINES ET COMMUNICATION;328;328;137;59;132;119;13;256;0;0;5;33;218;72
21287.0;2023;43;MAYOTTE;MASCULIN;APPRENTISSAGE;BAC PROFESSIONNEL;BAC PRO PROD;BAC PRO 25215 MAINT.VEHIC.OPTB VEHIC.TRANS.ROUT;10;10;8;0;2;2;0;10;0;0;0;3;7;0
21297.0;2023;43;MAYOTTE;MASCULIN;INDIVIDUEL;BAC PROFESSIONNEL;BAC PRO PROD;BAC PRO 25214 MAINT.VEHIC.OPTA VOIT.PARTICUL.;2;2;1;1;0;0;0;1;0;0;0;0;1;1
21304.0;2023;43;MAYOTTE;MASCULIN;INDIVIDUEL;BAC PROFESSIONNEL;BAC PRO SERV;BAC PRO 31214 MET.COM.VEN.OP.B PR.CL.VA.OF.COM.;1;1;0;1;0;0;0;0;0;0;0;0;0;1
21314.0;2023;43;MAYOTTE;MASCULIN;INDIVIDUEL;BAC TECHNOLOGIQUE;BAC STMG;BAC STMG MERCATIQUE (MARKETING);4;4;1;2;1;1;0;2;0;0;0;0;2;2
21316.0;2023;43;MAYOTTE;MASCULIN;SCOLAIRE;BAC GENERAL;BAC GENERAL;BAC GENE 10019 BAC GENERAL;930;930;527;163;240;152;88;679;2;20;87;175;395;251
21320.0;2023;43;MAYOTTE;MASCULIN;SCOLAIRE;BAC PROFESSIONNEL;BAC PRO PROD;BAC PRO 23102 TRAVAUX PUBLICS;30;30;12;9;9;7;2;19;0;0;0;1;18;11
21322.0;2023;43;MAYOTTE;MASCULIN;SCOLAIRE;BAC PROFESSIONNEL;BAC PRO PROD;BAC PRO 23203 TECHNICIEN BAT. : ORG.REAL.GROS O;32;30;21;4;5;3;2;24;0;0;2;3;19;6
21324.0;2023;43;MAYOTTE;MASCULIN;SCOLAIRE;BAC PROFESSIONNEL;BAC PRO PROD;BAC PRO 23404 TECHNICIEN CONSTRUCTEUR BOIS;14;14;8;5;1;1;0;9;0;0;0;2;7;5
21331.0;2023;43;MAYOTTE;MASCULIN;SCOLAIRE;BAC PROFESSIONNEL;BAC PRO PROD;BAC PRO 25221 MAINT.MATERIELS OPT.C ESP. VERTS;5;5;1;2;2;2;0;3;0;0;0;0;3;2
21334.0;2023;43;MAYOTTE;MASCULIN;SCOLAIRE;BAC PROFESSIONNEL;BAC PRO PROD;BAC PRO 25510 METIERS ELECT. ENVIRON. CONNECTES;107;107;62;27;18;13;5;75;0;0;6;16;53;32
21338.0;2023;43;MAYOTTE;MASCULIN;SCOLAIRE;BAC PROFESSIONNEL;BAC PRO PROD;BAC PRO AG 21004 CGEA;7;6;5;1;0;0;0;5;0;0;2;1;2;1
21340.0;2023;43;MAYOTTE;MASCULIN;SCOLAIRE;BAC PROFESSIONNEL;BAC PRO SERV;BAC PRO 30004 ASSISTANC.GEST.ORGANIS.ACTIVITES;46;46;27;13;6;6;0;33;0;0;3;13;17;13
21343.0;2023;43;MAYOTTE;MASCULIN;SCOLAIRE;BAC PROFESSIONNEL;BAC PRO SERV;BAC PRO 31212 METIERS DE L'ACCUEIL;19;19;11;7;1;0;1;11;0;0;2;3;6;8
21352.0;2023;43;MAYOTTE;MASCULIN;SCOLAIRE;BAC PROFESSIONNEL;BAC PRO SERV;BAC PRO AG 33002 SERV PERS TERRIT;4;4;3;1;0;0;0;3;0;0;0;1;2;1
21355.0;2023;43;MAYOTTE;MASCULIN;SCOLAIRE;BAC TECHNOLOGIQUE;BAC STD2A;BAC STD2A SCIENCES & TECHNO. DESIGN-ARTS APPLIQUES;30;30;21;2;7;3;4;24;0;0;3;6;15;6
21370.0;2023;11;MONTPELLIER;FEMININ;APPRENTISSAGE;BAC PROFESSIONNEL;BAC PRO PROD;BAC PRO 25510 METIERS ELECT. ENVIRON. CONNECTES;3;3;3;0;0;0;0;3;0;2;1;0;0;0
21373.0;2023;11;MONTPELLIER;FEMININ;APPRENTISSAGE;BAC PROFESSIONNEL;BAC PRO PROD;BAC PRO AG 21114 CONDUITE PRODUCTIONS HORTICOLES;2;2;2;0;0;0;0;2;0;1;0;0;1;0
21375.0;2023;11;MONTPELLIER;FEMININ;APPRENTISSAGE;BAC PROFESSIONNEL;BAC PRO PROD;BAC PRO AG 21211 COND GEST ENTR HIPPIQUE;21;19;12;7;0;0;0;12;0;0;1;6;5;7
21383.0;2023;11;MONTPELLIER;FEMININ;APPRENTISSAGE;BAC PROFESSIONNEL;BAC PRO SERV;BAC PRO 33101 OPTIQUE LUNETTERIE;5;5;5;0;0;0;0;5;0;0;1;3;1;0
21384.0;2023;11;MONTPELLIER;FEMININ;APPRENTISSAGE;BAC PROFESSIONNEL;BAC PRO SERV;BAC PRO 33104 TECHNICIEN EN PROTHESE DENTAIRE;5;5;5;0;0;0;0;5;0;2;0;2;1;0
21389.0;2023;11;MONTPELLIER;FEMININ;ENSEIGNEMENT A DISTANCE;BAC GENERAL;BAC GENERAL;BAC GENE 10019 BAC GENERAL;87;85;57;16;12;10;2;67;0;2;12;15;38;18
21394.0;2023;11;MONTPELLIER;FEMININ;ENSEIGNEMENT A DISTANCE;BAC PROFESSIONNEL;BAC PRO SERV;BAC PRO 33003 ACC.SOINS-S.PERS. OPT.A DOMICILE;1;1;1;0;0;0;0;1;0;0;0;0;1;0
21411.0;2023;11;MONTPELLIER;FEMININ;INDIVIDUEL;BAC PROFESSIONNEL;BAC PRO SERV;BAC PRO 30004 ASSISTANC.GEST.ORGANIS.ACTIVITES;4;0;0;0;0;0;0;0;0;0;0;0;0;0
21416.0;2023;11;MONTPELLIER;FEMININ;INDIVIDUEL;BAC PROFESSIONNEL;BAC PRO SERV;BAC PRO 33002 SERVICES DE PROXIMITE  VIE LOCAL;1;0;0;0;0;0;0;0;0;0;0;0;0;0
21418.0;2023;11;MONTPELLIER;FEMININ;INDIVIDUEL;BAC PROFESSIONNEL;BAC PRO SERV;BAC PRO 33004 ACC.SOINS-S.PERS. OPT.EN STRUCTUR;6;5;2;2;1;1;0;3;0;0;1;0;2;2
21421.0;2023;11;MONTPELLIER;FEMININ;INDIVIDUEL;BAC TECHNOLOGIQUE;BAC ST2S;BAC ST2S SCIENCES & TECHNO. SANTE & SOCIAL;19;18;6;11;1;0;1;6;0;0;1;2;3;12
21442.0;2023;11;MONTPELLIER;FEMININ;SCOLAIRE;BAC PROFESSIONNEL;BAC PRO PROD;BAC PRO 23405 TECHNICIEN MENUISIER AGENCEUR;3;3;2;1;0;0;0;2;0;0;1;0;1;1
21444.0;2023;11;MONTPELLIER;FEMININ;SCOLAIRE;BAC PROFESSIONNEL;BAC PRO PROD;BAC PRO 24202 ARTIS.& MET.ART : TAPIS.D'AMEUBL;13;13;11;0;2;2;0;13;0;0;0;6;7;0
21449.0;2023;11;MONTPELLIER;FEMININ;SCOLAIRE;BAC PROFESSIONNEL;BAC PRO PROD;BAC PRO 25214 MAINT.VEHIC.OPTA VOIT.PARTICUL.;5;5;4;1;0;0;0;4;0;0;0;3;1;1
21455.0;2023;11;MONTPELLIER;FEMININ;SCOLAIRE;BAC PROFESSIONNEL;BAC PRO PROD;BAC PRO 25510 METIERS ELECT. ENVIRON. CONNECTES;8;8;7;1;0;0;0;7;0;0;4;2;1;1
21456.0;2023;11;MONTPELLIER;FEMININ;SCOLAIRE;BAC PROFESSIONNEL;BAC PRO PROD;BAC PRO 25514 SYST.NUM.OPT.B AUD.RES.EQUIP.DOM.;4;4;3;0;1;1;0;4;0;0;0;2;2;0
21458.0;2023;11;MONTPELLIER;FEMININ;SCOLAIRE;BAC PROFESSIONNEL;BAC PRO PROD;BAC PRO AG 21004 CGEA;37;35;34;1;0;0;0;34;0;1;3;14;16;1
21460.0;2023;11;MONTPELLIER;FEMININ;SCOLAIRE;BAC PROFESSIONNEL;BAC PRO PROD;BAC PRO AG 21114 CONDUITE PRODUCTIONS HORTICOLES;14;14;11;3;0;0;0;11;0;0;0;3;8;3
21465.0;2023;11;MONTPELLIER;FEMININ;SCOLAIRE;BAC PROFESSIONNEL;BAC PRO PROD;BAC PRO AG 21303 FORET;3;3;3;0;0;0;0;3;0;0;0;1;2;0
21469.0;2023;11;MONTPELLIER;FEMININ;SCOLAIRE;BAC PROFESSIONNEL;BAC PRO PROD;BAC PRO AG 22108 TEC CONS VTE ALIMENTATION (PAB);20;20;18;2;0;0;0;18;0;0;2;6;10;2
21476.0;2023;11;MONTPELLIER;FEMININ;SCOLAIRE;BAC PROFESSIONNEL;BAC PRO SERV;BAC PRO 31214 MET.COM.VEN.OP.B PR.CL.VA.OF.COM.;94;94;80;10;4;4;0;84;0;8;17;34;25;10
21479.0;2023;11;MONTPELLIER;FEMININ;SCOLAIRE;BAC PROFESSIONNEL;BAC PRO SERV;BAC PRO 32303 ART.& MET.ART:COM.VIS.VIS.PLURI-M;77;77;70;6;1;1;0;71;0;18;15;22;16;6
21497.0;2023;11;MONTPELLIER;FEMININ;SCOLAIRE;BAC TECHNOLOGIQUE;BAC STHR;BAC STHR SC.&TEC. HOTELLERIE-RESTAURATION;56;56;54;1;1;0;1;54;1;7;10;24;12;2
21498.0;2023;11;MONTPELLIER;FEMININ;SCOLAIRE;BAC TECHNOLOGIQUE;BAC STI2D;BAC STI2D ARCHITECTURE ET CONSTRUCTION;62;62;57;2;3;2;1;59;0;2;10;12;35;3
21500.0;2023;11;MONTPELLIER;FEMININ;SCOLAIRE;BAC TECHNOLOGIQUE;BAC STI2D;BAC STI2D INNOVATION TECHNO.  ET ECO CONCEPTION;13;13;11;2;0;0;0;11;0;0;2;2;7;2
21501.0;2023;11;MONTPELLIER;FEMININ;SCOLAIRE;BAC TECHNOLOGIQUE;BAC STI2D;BAC STI2D SYSTÈME D'INFORMATION  ET NUMERIQUE;13;13;11;1;1;1;0;12;0;0;6;2;4;1
21503.0;2023;11;MONTPELLIER;FEMININ;SCOLAIRE;BAC TECHNOLOGIQUE;BAC STL;BAC STL SCIENCES PHYSIQUES CHIMIQUES  EN LABORAT.;45;45;42;0;3;1;2;43;0;4;9;18;12;2
21504.0;2023;11;MONTPELLIER;FEMININ;SCOLAIRE;BAC TECHNOLOGIQUE;BAC STMG;BAC STMG GESTION ET FINANCE;311;311;266;11;34;28;6;294;0;9;58;96;131;17
21506.0;2023;11;MONTPELLIER;FEMININ;SCOLAIRE;BAC TECHNOLOGIQUE;BAC STMG;BAC STMG RESSOURCES HUMAINES ET COMMUNICATION;618;618;472;40;106;74;32;546;0;5;41;174;326;72
21508.0;2023;11;MONTPELLIER;MASCULIN;APPRENTISSAGE;BAC PROFESSIONNEL;BAC PRO PROD;BAC PRO 20102 PILOTE DE LIGNE DE PRODUCTION;3;3;2;1;0;0;0;2;0;1;1;0;0;1
21511.0;2023;11;MONTPELLIER;MASCULIN;APPRENTISSAGE;BAC PROFESSIONNEL;BAC PRO PROD;BAC PRO 22503 PLASTIQUES ET COMPOSITES;2;2;0;0;2;1;1;1;0;0;0;0;1;1
21515.0;2023;11;MONTPELLIER;MASCULIN;APPRENTISSAGE;BAC PROFESSIONNEL;BAC PRO PROD;BAC PRO 23102 TRAVAUX PUBLICS;30;29;25;4;0;0;0;25;0;1;2;14;8;4
21519.0;2023;11;MONTPELLIER;MASCULIN;APPRENTISSAGE;BAC PROFESSIONNEL;BAC PRO PROD;BAC PRO 23405 TECHNICIEN MENUISIER AGENCEUR;6;6;2;4;0;0;0;2;0;0;1;1;0;4
21520.0;2023;11;MONTPELLIER;MASCULIN;APPRENTISSAGE;BAC PROFESSIONNEL;BAC PRO PROD;BAC PRO 24303 MET. DU CUIR: SELLERIE GARNISSAGE;1;1;1;0;0;0;0;1;0;1;0;0;0;0
21522.0;2023;11;MONTPELLIER;MASCULIN;APPRENTISSAGE;BAC PROFESSIONNEL;BAC PRO PROD;BAC PRO 25009 MAINTENANCE NAUTIQUE;4;4;4;0;0;0;0;4;0;0;1;2;1;0
21523.0;2023;11;MONTPELLIER;MASCULIN;APPRENTISSAGE;BAC PROFESSIONNEL;BAC PRO PROD;BAC PRO 25106 TECHNICIEN D'USINAGE;5;5;5;0;0;0;0;5;0;1;1;2;1;0
21526.0;2023;11;MONTPELLIER;MASCULIN;APPRENTISSAGE;BAC PROFESSIONNEL;BAC PRO PROD;BAC PRO 25216 MAINT.VEHIC.OPTC MOTOCYCLES;8;8;7;1;0;0;0;7;0;2;2;2;1;1
21527.0;2023;11;MONTPELLIER;MASCULIN;APPRENTISSAGE;BAC PROFESSIONNEL;BAC PRO PROD;BAC PRO 25220 MAINT.MATERIELS OPT.B TP MANUT.;7;7;7;0;0;0;0;7;0;1;5;0;1;0
21533.0;2023;11;MONTPELLIER;MASCULIN;APPRENTISSAGE;BAC PROFESSIONNEL;BAC PRO PROD;BAC PRO 25510 METIERS ELECT. ENVIRON. CONNECTES;58;56;48;6;2;1;1;49;0;4;8;15;22;7
21551.0;2023;11;MONTPELLIER;MASCULIN;ENSEIGNEMENT A DISTANCE;BAC PROFESSIONNEL;BAC PRO SERV;BAC PRO 31213 MET.COM.VEN.OP.A ANI.GES.ESP.COM.;3;3;1;2;0;0;0;1;0;0;0;0;1;2
21553.0;2023;11;MONTPELLIER;MASCULIN;ENSEIGNEMENT A DISTANCE;BAC TECHNOLOGIQUE;BAC ST2S;BAC ST2S SCIENCES & TECHNO. SANTE & SOCIAL;1;1;0;0;1;0;1;0;0;0;0;0;0;1
21556.0;2023;11;MONTPELLIER;MASCULIN;ENSEIGNEMENT A DISTANCE;BAC TECHNOLOGIQUE;BAC STMG;BAC STMG SYSTEMES D'INFORMATION DE GESTION;1;1;0;0;1;1;0;1;0;0;0;0;1;0
21560.0;2023;11;MONTPELLIER;MASCULIN;FORMATION CONTINUE;BAC PROFESSIONNEL;BAC PRO SERV;BAC PRO 31213 MET.COM.VEN.OP.A ANI.GES.ESP.COM.;5;5;5;0;0;0;0;5;0;1;0;3;1;0
21572.0;2023;11;MONTPELLIER;MASCULIN;INDIVIDUEL;BAC PROFESSIONNEL;BAC PRO PROD;BAC PRO 25514 SYST.NUM.OPT.B AUD.RES.EQUIP.DOM.;1;1;1;0;0;0;0;1;0;0;0;0;1;0
21579.0;2023;11;MONTPELLIER;MASCULIN;INDIVIDUEL;BAC PROFESSIONNEL;BAC PRO SERV;BAC PRO 31213 MET.COM.VEN.OP.A ANI.GES.ESP.COM.;3;1;1;0;0;0;0;1;0;0;0;1;0;0
21583.0;2023;11;MONTPELLIER;MASCULIN;INDIVIDUEL;BAC PROFESSIONNEL;BAC PRO SERV;BAC PRO AG 33002 SERV PERS TERRIT;1;0;0;0;0;0;0;0;0;0;0;0;0;0
21595.0;2023;11;MONTPELLIER;MASCULIN;SCOLAIRE;BAC PROFESSIONNEL;BAC PRO PROD;BACPRO 20002 ETUD.DEFINITION PRDTS INDUSTRIEL;20;20;15;5;0;0;0;15;0;1;3;7;4;5
21603.0;2023;11;MONTPELLIER;MASCULIN;SCOLAIRE;BAC PROFESSIONNEL;BAC PRO PROD;BAC PRO 22703 TECHN.INSTALL.SYST.ENERG.CLIMATI;64;64;41;16;7;4;3;45;0;2;6;17;20;19
21606.0;2023;11;MONTPELLIER;MASCULIN;SCOLAIRE;BAC PROFESSIONNEL;BAC PRO PROD;BAC PRO 23004 TECHN. ETUDES BAT.A ETUDES & ECO.;54;54;37;17;0;0;0;37;0;0;6;12;19;17
21607.0;2023;11;MONTPELLIER;MASCULIN;SCOLAIRE;BAC PROFESSIONNEL;BAC PRO PROD;BAC PRO 23005 TECHN. ETUDES BAT B ASSIST.ARCHI.;35;35;31;4;0;0;0;31;0;0;11;11;9;4
21613.0;2023;11;MONTPELLIER;MASCULIN;SCOLAIRE;BAC PROFESSIONNEL;BAC PRO PROD;BAC PRO 23303 MENUISERIE ALUMINIUM-VERRE;3;3;1;2;0;0;0;1;0;0;1;0;0;2
21618.0;2023;11;MONTPELLIER;MASCULIN;SCOLAIRE;BAC PROFESSIONNEL;BAC PRO PROD;BAC PRO 24203 METIERS DE LA MODE - VÊTEMENT;14;14;12;2;0;0;0;12;0;2;4;2;4;2
21622.0;2023;11;MONTPELLIER;MASCULIN;SCOLAIRE;BAC PROFESSIONNEL;BAC PRO PROD;BAC PRO 25007 MAINTENANCE EQUIPEMENTS INDUST.;137;135;87;40;8;6;2;93;0;1;8;38;46;42
21627.0;2023;11;MONTPELLIER;MASCULIN;SCOLAIRE;BAC PROFESSIONNEL;BAC PRO PROD;BAC PRO 25216 MAINT.VEHIC.OPTC MOTOCYCLES;56;55;46;8;1;1;0;47;0;3;9;18;17;8
21631.0;2023;11;MONTPELLIER;MASCULIN;SCOLAIRE;BAC PROFESSIONNEL;BAC PRO PROD;BAC PRO 25303 AERONAUTIQUE OPTION SYSTEMES;12;12;11;1;0;0;0;11;0;3;1;4;3;1
21632.0;2023;11;MONTPELLIER;MASCULIN;SCOLAIRE;BAC PROFESSIONNEL;BAC PRO PROD;BAC PRO 25406 OUVRAGES DU BATIMENT METALLERIE;3;3;3;0;0;0;0;3;0;0;1;0;2;0
21633.0;2023;11;MONTPELLIER;MASCULIN;SCOLAIRE;BAC PROFESSIONNEL;BAC PRO PROD;BAC PRO 25408 REPARATION DES CARROSSERIES;17;16;10;5;1;0;1;10;0;1;2;3;4;6
21638.0;2023;11;MONTPELLIER;MASCULIN;SCOLAIRE;BAC PROFESSIONNEL;BAC PRO PROD;BAC PRO 25514 SYST.NUM.OPT.B AUD.RES.EQUIP.DOM.;92;92;62;21;9;7;2;69;0;4;13;19;33;23
21649.0;2023;11;MONTPELLIER;MASCULIN;SCOLAIRE;BAC PROFESSIONNEL;BAC PRO PROD;BAC PRO AG 21303 FORET;24;24;21;3;0;0;0;21;0;0;2;6;13;3
21661.0;2023;11;MONTPELLIER;MASCULIN;SCOLAIRE;BAC PROFESSIONNEL;BAC PRO SERV;BAC PRO 32207 REAL.PR.IMPR.PLURI.OPTA.PR.GRAPH.;11;11;10;0;1;1;0;11;0;0;3;5;3;0
21662.0;2023;11;MONTPELLIER;MASCULIN;SCOLAIRE;BAC PROFESSIONNEL;BAC PRO SERV;BAC PRO 32208 REAL.PR.IMPR.PLURI.OPTB.PR.IMPR.;6;6;6;0;0;0;0;6;0;0;2;4;0;0
21663.0;2023;11;MONTPELLIER;MASCULIN;SCOLAIRE;BAC PROFESSIONNEL;BAC PRO SERV;BAC PRO 32303 ART.& MET.ART:COM.VIS.VIS.PLURI-M;56;56;46;8;2;2;0;48;0;2;14;21;11;8
21671.0;2023;11;MONTPELLIER;MASCULIN;SCOLAIRE;BAC PROFESSIONNEL;BAC PRO SERV;BAC PRO 33604 METIERS DE LA COIFFURE;2;2;2;0;0;0;0;2;0;0;0;2;0;0
21675.0;2023;11;MONTPELLIER;MASCULIN;SCOLAIRE;BAC TECHNOLOGIQUE;BAC S2TMD;BAC S2TMD MUSIQUE;2;2;2;0;0;0;0;2;1;1;0;0;0;0
21680.0;2023;11;MONTPELLIER;MASCULIN;SCOLAIRE;BAC TECHNOLOGIQUE;BAC STI2D;BAC STI2D ARCHITECTURE ET CONSTRUCTION;219;219;186;7;26;14;12;200;0;6;25;72;97;19
21681.0;2023;11;MONTPELLIER;MASCULIN;SCOLAIRE;BAC TECHNOLOGIQUE;BAC STI2D;BAC STI2D ENERGIES  ET ENVIRONNEMENT;175;175;151;8;16;8;8;159;0;3;22;69;65;16
21685.0;2023;11;MONTPELLIER;MASCULIN;SCOLAIRE;BAC TECHNOLOGIQUE;BAC STL;BAC STL SCIENCES PHYSIQUES CHIMIQUES  EN LABORAT.;53;53;50;1;2;1;1;51;0;7;15;11;18;2
21693.0;2023;12;NANCY-METZ;FEMININ;APPRENTISSAGE;BAC PROFESSIONNEL;BAC PRO PROD;BAC PRO 23203 TECHNICIEN BAT. : ORG.REAL.GROS O;1;1;1;0;0;0;0;1;0;0;1;0;0;0
21695.0;2023;12;NANCY-METZ;FEMININ;APPRENTISSAGE;BAC PROFESSIONNEL;BAC PRO PROD;BAC PRO 24202 ARTIS.& MET.ART : TAPIS.D'AMEUBL;1;1;0;0;1;0;1;0;0;0;0;0;0;1
21698.0;2023;12;NANCY-METZ;FEMININ;APPRENTISSAGE;BAC PROFESSIONNEL;BAC PRO PROD;BAC PRO 25214 MAINT.VEHIC.OPTA VOIT.PARTICUL.;4;4;2;2;0;0;0;2;0;0;0;1;1;2
21699.0;2023;12;NANCY-METZ;FEMININ;APPRENTISSAGE;BAC PROFESSIONNEL;BAC PRO PROD;BAC PRO 25216 MAINT.VEHIC.OPTC MOTOCYCLES;1;1;1;0;0;0;0;1;0;0;1;0;0;0
21702.0;2023;12;NANCY-METZ;FEMININ;APPRENTISSAGE;BAC PROFESSIONNEL;BAC PRO PROD;BAC PRO 25411 TECH.CHAUDRONNERIE INDUSTRIELLE;1;1;1;0;0;0;0;1;0;1;0;0;0;0
21722.0;2023;12;NANCY-METZ;FEMININ;APPRENTISSAGE;BAC PROFESSIONNEL;BAC PRO SERV;BAC PRO 33403 COMMERC. SERVICES EN RESTAURATION;5;5;3;1;1;1;0;4;0;1;0;1;2;1
21725.0;2023;12;NANCY-METZ;FEMININ;ENSEIGNEMENT A DISTANCE;BAC GENERAL;BAC GENERAL;BAC GENE 10019 BAC GENERAL;48;48;31;13;4;1;3;32;0;3;7;12;10;16
21733.0;2023;12;NANCY-METZ;FEMININ;ENSEIGNEMENT A DISTANCE;BAC TECHNOLOGIQUE;BAC STMG;BAC STMG RESSOURCES HUMAINES ET COMMUNICATION;5;5;5;0;0;0;0;5;0;0;0;4;1;0
21742.0;2023;12;NANCY-METZ;FEMININ;FORMATION CONTINUE;BAC PROFESSIONNEL;BAC PRO SERV;BAC PRO 31213 MET.COM.VEN.OP.A ANI.GES.ESP.COM.;14;9;7;1;1;1;0;8;0;0;1;4;3;1
21744.0;2023;12;NANCY-METZ;FEMININ;FORMATION CONTINUE;BAC PROFESSIONNEL;BAC PRO SERV;BAC PRO 33104 TECHNICIEN EN PROTHESE DENTAIRE;5;5;5;0;0;0;0;5;0;1;4;0;0;0
21746.0;2023;12;NANCY-METZ;FEMININ;INDIVIDUEL;BAC GENERAL;BAC GENERAL;BAC GENE 10019 BAC GENERAL;38;37;10;20;7;3;4;13;0;1;0;5;7;24
21751.0;2023;12;NANCY-METZ;FEMININ;INDIVIDUEL;BAC PROFESSIONNEL;BAC PRO SERV;BAC PRO 30004 ASSISTANC.GEST.ORGANIS.ACTIVITES;3;2;1;1;0;0;0;1;0;0;1;0;0;1
21758.0;2023;12;NANCY-METZ;FEMININ;INDIVIDUEL;BAC TECHNOLOGIQUE;BAC STD2A;BAC STD2A SCIENCES & TECHNO. DESIGN-ARTS APPLIQUES;1;1;0;1;0;0;0;0;0;0;0;0;0;1
21769.0;2023;12;NANCY-METZ;FEMININ;SCOLAIRE;BAC PROFESSIONNEL;BAC PRO PROD;BAC PRO 22403 ARTS.& MET.ART:MET.ENSEIGN SIGNA;3;3;3;0;0;0;0;3;0;0;1;2;0;0
21772.0;2023;12;NANCY-METZ;FEMININ;SCOLAIRE;BAC PROFESSIONNEL;BAC PRO PROD;BAC PRO 23005 TECHN. ETUDES BAT B ASSIST.ARCHI.;13;13;11;2;0;0;0;11;0;0;4;4;3;2
21773.0;2023;12;NANCY-METZ;FEMININ;SCOLAIRE;BAC PROFESSIONNEL;BAC PRO PROD;BACPRO 23103 TECHNICIEN GEOMETRE-TOPOGRAPHE;1;1;1;0;0;0;0;1;0;1;0;0;0;0
21775.0;2023;12;NANCY-METZ;FEMININ;SCOLAIRE;BAC PROFESSIONNEL;BAC PRO PROD;BAC PRO 23304 AMENAGEMENT FINITION BATIMENT;7;6;5;1;0;0;0;5;0;1;1;0;3;1
21778.0;2023;12;NANCY-METZ;FEMININ;SCOLAIRE;BAC PROFESSIONNEL;BAC PRO PROD;BAC PRO 24203 METIERS DE LA MODE - VÊTEMENT;68;67;56;11;0;0;0;56;0;12;15;14;15;11
21783.0;2023;12;NANCY-METZ;FEMININ;SCOLAIRE;BAC PROFESSIONNEL;BAC PRO PROD;BAC PRO 25216 MAINT.VEHIC.OPTC MOTOCYCLES;1;1;1;0;0;0;0;1;0;0;1;0;0;0
21787.0;2023;12;NANCY-METZ;FEMININ;SCOLAIRE;BAC PROFESSIONNEL;BAC PRO PROD;BAC PRO 25514 SYST.NUM.OPT.B AUD.RES.EQUIP.DOM.;1;1;1;0;0;0;0;1;0;0;1;0;0;0
21793.0;2023;12;NANCY-METZ;FEMININ;SCOLAIRE;BAC PROFESSIONNEL;BAC PRO PROD;BAC PRO AG 21211 COND GEST ENTR HIPPIQUE;78;77;68;9;0;0;0;68;0;2;12;20;34;9
21796.0;2023;12;NANCY-METZ;FEMININ;SCOLAIRE;BAC PROFESSIONNEL;BAC PRO PROD;BAC PRO AG 22108 TEC CONS VTE ALIMENTATION (PAB);2;2;2;0;0;0;0;2;0;0;1;0;1;0
21798.0;2023;12;NANCY-METZ;FEMININ;SCOLAIRE;BAC PROFESSIONNEL;BAC PRO SERV;BAC PRO 31106 LOGISTIQUE;33;33;25;4;4;1;3;26;0;0;4;12;10;7
21799.0;2023;12;NANCY-METZ;FEMININ;SCOLAIRE;BAC PROFESSIONNEL;BAC PRO SERV;BAC PRO 31107 CONDUCT. TRANSP.ROUT.MARCHANDISES;5;5;5;0;0;0;0;5;0;0;2;3;0;0
21811.0;2023;12;NANCY-METZ;FEMININ;SCOLAIRE;BAC PROFESSIONNEL;BAC PRO SERV;BAC PRO 33101 OPTIQUE LUNETTERIE;7;7;7;0;0;0;0;7;0;0;4;3;0;0
21812.0;2023;12;NANCY-METZ;FEMININ;SCOLAIRE;BAC PROFESSIONNEL;BAC PRO SERV;BAC PRO 33104 TECHNICIEN EN PROTHESE DENTAIRE;7;7;7;0;0;0;0;7;0;1;1;4;1;0
21814.0;2023;12;NANCY-METZ;FEMININ;SCOLAIRE;BAC PROFESSIONNEL;BAC PRO SERV;BAC PRO 33603 ESTHETIQUE COSMETIQUE PARFUMERIE;150;147;128;17;2;2;0;130;0;5;25;48;52;17
21823.0;2023;12;NANCY-METZ;FEMININ;SCOLAIRE;BAC TECHNOLOGIQUE;BAC ST2S;BAC ST2S SCIENCES & TECHNO. SANTE & SOCIAL;672;672;571;19;82;57;25;628;1;30;91;206;300;44
21851.0;2023;12;NANCY-METZ;MASCULIN;APPRENTISSAGE;BAC PROFESSIONNEL;BAC PRO PROD;BAC PRO 25007 MAINTENANCE EQUIPEMENTS INDUST.;37;37;28;4;5;5;0;33;0;2;9;5;17;4
21853.0;2023;12;NANCY-METZ;MASCULIN;APPRENTISSAGE;BAC PROFESSIONNEL;BAC PRO PROD;BAC PRO 25107 TECHNICIEN OUTILLEUR;2;2;2;0;0;0;0;2;0;0;1;1;0;0
21864.0;2023;12;NANCY-METZ;MASCULIN;APPRENTISSAGE;BAC PROFESSIONNEL;BAC PRO PROD;BAC PRO 25410 CONSTRUCTION DES CARROSSERIES;2;2;2;0;0;0;0;2;0;0;2;0;0;0
21868.0;2023;12;NANCY-METZ;MASCULIN;APPRENTISSAGE;BAC PROFESSIONNEL;BAC PRO PROD;BAC PRO 25513 SYST.NUM.OPT.A SURETE SECURITE;1;1;1;0;0;0;0;1;0;0;1;0;0;0
21872.0;2023;12;NANCY-METZ;MASCULIN;APPRENTISSAGE;BAC PROFESSIONNEL;BAC PRO PROD;BAC PRO AG 21114 CONDUITE PRODUCTIONS HORTICOLES;2;2;1;1;0;0;0;1;0;0;0;0;1;1
21876.0;2023;12;NANCY-METZ;MASCULIN;APPRENTISSAGE;BAC PROFESSIONNEL;BAC PRO PROD;BAC PRO AG 21302 GEST MILIEUX NATURELS FAUNE;1;1;1;0;0;0;0;1;0;0;0;0;1;0
21879.0;2023;12;NANCY-METZ;MASCULIN;APPRENTISSAGE;BAC PROFESSIONNEL;BAC PRO PROD;BAC PRO AG 22108 TEC CONS VTE ALIMENTATION (PAB);3;3;3;0;0;0;0;3;0;0;1;0;2;0
21882.0;2023;12;NANCY-METZ;MASCULIN;APPRENTISSAGE;BAC PROFESSIONNEL;BAC PRO SERV;BAC PRO 31213 MET.COM.VEN.OP.A ANI.GES.ESP.COM.;67;66;53;8;5;4;1;57;0;4;13;17;23;9
21884.0;2023;12;NANCY-METZ;MASCULIN;APPRENTISSAGE;BAC PROFESSIONNEL;BAC PRO SERV;BAC PRO 32207 REAL.PR.IMPR.PLURI.OPTA.PR.GRAPH.;1;0;0;0;0;0;0;0;0;0;0;0;0;0
21887.0;2023;12;NANCY-METZ;MASCULIN;APPRENTISSAGE;BAC PROFESSIONNEL;BAC PRO SERV;BAC PRO AG 33002 SERV PERS TERRIT;1;1;1;0;0;0;0;1;0;0;0;0;1;0
21890.0;2023;12;NANCY-METZ;MASCULIN;ENSEIGNEMENT A DISTANCE;BAC PROFESSIONNEL;BAC PRO SERV;BAC PRO 31213 MET.COM.VEN.OP.A ANI.GES.ESP.COM.;1;0;0;0;0;0;0;0;0;0;0;0;0;0
21894.0;2023;12;NANCY-METZ;MASCULIN;ENSEIGNEMENT A DISTANCE;BAC TECHNOLOGIQUE;BAC STMG;BAC STMG MERCATIQUE (MARKETING);1;1;1;0;0;0;0;1;0;0;0;0;1;0
21899.0;2023;12;NANCY-METZ;MASCULIN;FORMATION CONTINUE;BAC PROFESSIONNEL;BAC PRO PROD;BAC PRO 25408 REPARATION DES CARROSSERIES;2;1;1;0;0;0;0;1;0;1;0;0;0;0
21901.0;2023;12;NANCY-METZ;MASCULIN;FORMATION CONTINUE;BAC PROFESSIONNEL;BAC PRO PROD;BAC PRO 25515 SYST.NUM.OPT.C RES.INF.SYST.COMM.;5;5;5;0;0;0;0;5;0;1;2;1;1;0
21907.0;2023;12;NANCY-METZ;MASCULIN;INDIVIDUEL;BAC GENERAL;BAC GENERAL;BAC GENE 10019 BAC GENERAL;84;84;31;40;13;9;4;40;0;4;7;12;17;44
21910.0;2023;12;NANCY-METZ;MASCULIN;INDIVIDUEL;BAC PROFESSIONNEL;BAC PRO PROD;BAC PRO 25007 MAINTENANCE EQUIPEMENTS INDUST.;2;1;1;0;0;0;0;1;0;0;0;0;1;0
21912.0;2023;12;NANCY-METZ;MASCULIN;INDIVIDUEL;BAC PROFESSIONNEL;BAC PRO PROD;BAC PRO 25510 METIERS ELECT. ENVIRON. CONNECTES;2;1;0;0;1;0;1;0;0;0;0;0;0;1
21913.0;2023;12;NANCY-METZ;MASCULIN;INDIVIDUEL;BAC PROFESSIONNEL;BAC PRO PROD;BAC PRO 25514 SYST.NUM.OPT.B AUD.RES.EQUIP.DOM.;1;0;0;0;0;0;0;0;0;0;0;0;0;0
21920.0;2023;12;NANCY-METZ;MASCULIN;INDIVIDUEL;BAC PROFESSIONNEL;BAC PRO SERV;BAC PRO 33004 ACC.SOINS-S.PERS. OPT.EN STRUCTUR;1;0;0;0;0;0;0;0;0;0;0;0;0;0
21930.0;2023;12;NANCY-METZ;MASCULIN;SCOLAIRE;BAC PROFESSIONNEL;BAC PRO PROD;BAC PRO 20102 PILOTE DE LIGNE DE PRODUCTION;19;19;12;7;0;0;0;12;0;0;5;5;2;7
21932.0;2023;12;NANCY-METZ;MASCULIN;SCOLAIRE;BAC PROFESSIONNEL;BAC PRO PROD;BAC PRO 22004 PROC. CHIMIE EAU PAPIERS-CARTONS;16;16;13;3;0;0;0;13;0;1;3;5;4;3
21939.0;2023;12;NANCY-METZ;MASCULIN;SCOLAIRE;BAC PROFESSIONNEL;BAC PRO PROD;BAC PRO 22704 TECHN. MAINT. SYST.ENERG.CLIMATI;37;36;24;5;7;5;2;29;0;0;5;8;16;7
21940.0;2023;12;NANCY-METZ;MASCULIN;SCOLAIRE;BAC PROFESSIONNEL;BAC PRO PROD;BAC PRO 23004 TECHN. ETUDES BAT.A ETUDES & ECO.;37;37;25;11;1;1;0;26;0;1;4;10;11;11
21952.0;2023;12;NANCY-METZ;MASCULIN;SCOLAIRE;BAC PROFESSIONNEL;BAC PRO PROD;BAC PRO 24203 METIERS DE LA MODE - VÊTEMENT;7;7;7;0;0;0;0;7;0;0;0;5;2;0
21961.0;2023;12;NANCY-METZ;MASCULIN;SCOLAIRE;BAC PROFESSIONNEL;BAC PRO PROD;BAC PRO 25221 MAINT.MATERIELS OPT.C ESP. VERTS;1;1;1;0;0;0;0;1;0;1;0;0;0;0
21962.0;2023;12;NANCY-METZ;MASCULIN;SCOLAIRE;BAC PROFESSIONNEL;BAC PRO PROD;BAC PRO 25302 AERONAUTIQUE OPTION AVIONIQUE;4;4;4;0;0;0;0;4;0;0;2;2;0;0
21970.0;2023;12;NANCY-METZ;MASCULIN;SCOLAIRE;BAC PROFESSIONNEL;BAC PRO PROD;BAC PRO 25513 SYST.NUM.OPT.A SURETE SECURITE;41;41;30;7;4;3;1;33;0;3;7;18;5;8
21978.0;2023;12;NANCY-METZ;MASCULIN;SCOLAIRE;BAC PROFESSIONNEL;BAC PRO PROD;BAC PRO AG 21211 COND GEST ENTR HIPPIQUE;7;7;4;3;0;0;0;4;0;0;0;1;3;3
21979.0;2023;12;NANCY-METZ;MASCULIN;SCOLAIRE;BAC PROFESSIONNEL;BAC PRO PROD;BAC PRO AG 21302 GEST MILIEUX NATURELS FAUNE;27;27;23;4;0;0;0;23;0;0;5;9;9;4
21980.0;2023;12;NANCY-METZ;MASCULIN;SCOLAIRE;BAC PROFESSIONNEL;BAC PRO PROD;BAC PRO AG 21303 FORET;15;14;14;0;0;0;0;14;0;0;1;7;6;0
21982.0;2023;12;NANCY-METZ;MASCULIN;SCOLAIRE;BAC PROFESSIONNEL;BAC PRO PROD;BAC PRO AG 22108 TEC CONS VTE ALIMENTATION (PAB);7;7;7;0;0;0;0;7;0;1;1;0;5;0
21985.0;2023;12;NANCY-METZ;MASCULIN;SCOLAIRE;BAC PROFESSIONNEL;BAC PRO SERV;BAC PRO 31107 CONDUCT. TRANSP.ROUT.MARCHANDISES;76;76;65;11;0;0;0;65;0;9;12;27;17;11
21986.0;2023;12;NANCY-METZ;MASCULIN;SCOLAIRE;BAC PROFESSIONNEL;BAC PRO SERV;BAC PRO 31114 ORGANIS. TRANSPORT MARCHANDISES;32;32;21;10;1;1;0;22;0;1;6;7;8;10
21992.0;2023;12;NANCY-METZ;MASCULIN;SCOLAIRE;BAC PROFESSIONNEL;BAC PRO SERV;BAC PRO 32303 ART.& MET.ART:COM.VIS.VIS.PLURI-M;12;12;11;1;0;0;0;11;0;2;4;4;1;1
21995.0;2023;12;NANCY-METZ;MASCULIN;SCOLAIRE;BAC PROFESSIONNEL;BAC PRO SERV;BAC PRO 33004 ACC.SOINS-S.PERS. OPT.EN STRUCTUR;52;52;44;6;2;1;1;45;0;1;11;19;14;7
22006.0;2023;12;NANCY-METZ;MASCULIN;SCOLAIRE;BAC TECHNOLOGIQUE;BAC S2TMD;BAC S2TMD DANSE;1;1;1;0;0;0;0;1;1;0;0;0;0;0
22020.0;2023;12;NANCY-METZ;MASCULIN;SCOLAIRE;BAC TECHNOLOGIQUE;BAC STMG;BAC STMG MERCATIQUE (MARKETING);577;577;424;28;125;93;32;517;0;1;24;138;354;60
22023.0;2023;17;NANTES;FEMININ;APPRENTISSAGE;BAC PROFESSIONNEL;BAC PRO PROD;BAC PRO 22105 BOULANGER-PÂTISSIER;17;17;15;2;0;0;0;15;0;2;4;5;4;2
22026.0;2023;17;NANTES;FEMININ;APPRENTISSAGE;BAC PROFESSIONNEL;BAC PRO PROD;BAC PRO 22503 PLASTIQUES ET COMPOSITES;1;1;1;0;0;0;0;1;0;0;1;0;0;0
22027.0;2023;17;NANTES;FEMININ;APPRENTISSAGE;BAC PROFESSIONNEL;BAC PRO PROD;BAC PRO 22705 TECHNICIEN GAZ;1;1;1;0;0;0;0;1;0;1;0;0;0;0
22029.0;2023;17;NANTES;FEMININ;APPRENTISSAGE;BAC PROFESSIONNEL;BAC PRO PROD;BAC PRO 23005 TECHN. ETUDES BAT B ASSIST.ARCHI.;1;1;1;0;0;0;0;1;0;0;1;0;0;0
22038.0;2023;17;NANTES;FEMININ;APPRENTISSAGE;BAC PROFESSIONNEL;BAC PRO PROD;BAC PRO 25219 MAINT.MATERIELS OPT.A AGRICOLES;3;3;3;0;0;0;0;3;0;1;0;0;2;0
22041.0;2023;17;NANTES;FEMININ;APPRENTISSAGE;BAC PROFESSIONNEL;BAC PRO PROD;BAC PRO 25302 AERONAUTIQUE OPTION AVIONIQUE;2;2;2;0;0;0;0;2;0;0;0;1;1;0
22052.0;2023;17;NANTES;FEMININ;APPRENTISSAGE;BAC PROFESSIONNEL;BAC PRO PROD;BAC PRO AG 21210 COND GEST ENTR CANIN ET FELIN;5;5;5;0;0;0;0;5;0;0;0;0;5;0
22057.0;2023;17;NANTES;FEMININ;APPRENTISSAGE;BAC PROFESSIONNEL;BAC PRO SERV;BAC PRO 30004 ASSISTANC.GEST.ORGANIS.ACTIVITES;19;19;18;1;0;0;0;18;0;3;6;6;3;1
22059.0;2023;17;NANTES;FEMININ;APPRENTISSAGE;BAC PROFESSIONNEL;BAC PRO SERV;BAC PRO 31114 ORGANIS. TRANSPORT MARCHANDISES;1;1;1;0;0;0;0;1;0;0;1;0;0;0
22060.0;2023;17;NANTES;FEMININ;APPRENTISSAGE;BAC PROFESSIONNEL;BAC PRO SERV;BAC PRO 31212 METIERS DE L'ACCUEIL;16;16;16;0;0;0;0;16;0;0;8;7;1;0
22064.0;2023;17;NANTES;FEMININ;APPRENTISSAGE;BAC PROFESSIONNEL;BAC PRO SERV;BAC PRO 32207 REAL.PR.IMPR.PLURI.OPTA.PR.GRAPH.;6;6;5;1;0;0;0;5;0;0;2;1;2;1
22069.0;2023;17;NANTES;FEMININ;APPRENTISSAGE;BAC PROFESSIONNEL;BAC PRO SERV;BAC PRO 33403 COMMERC. SERVICES EN RESTAURATION;24;23;18;1;4;3;1;21;0;1;1;7;12;2
22074.0;2023;17;NANTES;FEMININ;ENSEIGNEMENT A DISTANCE;BAC PROFESSIONNEL;BAC PRO PROD;BAC PRO AG 21004 CGEA;4;4;3;1;0;0;0;3;0;0;0;0;3;1
22079.0;2023;17;NANTES;FEMININ;ENSEIGNEMENT A DISTANCE;BAC PROFESSIONNEL;BAC PRO SERV;BAC PRO 33004 ACC.SOINS-S.PERS. OPT.EN STRUCTUR;3;2;1;1;0;0;0;1;0;0;0;1;0;1
22081.0;2023;17;NANTES;FEMININ;ENSEIGNEMENT A DISTANCE;BAC TECHNOLOGIQUE;BAC ST2S;BAC ST2S SCIENCES & TECHNO. SANTE & SOCIAL;3;3;1;1;1;1;0;2;0;0;0;0;2;1
22083.0;2023;17;NANTES;FEMININ;ENSEIGNEMENT A DISTANCE;BAC TECHNOLOGIQUE;BAC STMG;BAC STMG RESSOURCES HUMAINES ET COMMUNICATION;7;7;1;6;0;0;0;1;0;0;0;0;1;6
22099.0;2023;17;NANTES;FEMININ;INDIVIDUEL;BAC PROFESSIONNEL;BAC PRO PROD;BAC PRO AG 22108 TEC CONS VTE ALIMENTATION (PAB);1;1;1;0;0;0;0;1;0;0;0;0;1;0
22113.0;2023;17;NANTES;FEMININ;INDIVIDUEL;BAC TECHNOLOGIQUE;BAC STMG;BAC STMG RESSOURCES HUMAINES ET COMMUNICATION;16;16;5;6;5;3;2;8;0;0;0;2;6;8
22115.0;2023;17;NANTES;FEMININ;SCOLAIRE;BAC PROFESSIONNEL;BAC PRO PROD;BACPRO 20002 ETUD.DEFINITION PRDTS INDUSTRIEL;1;1;1;0;0;0;0;1;0;0;0;1;0;0
22116.0;2023;17;NANTES;FEMININ;SCOLAIRE;BAC PROFESSIONNEL;BAC PRO PROD;BAC PRO 20102 PILOTE DE LIGNE DE PRODUCTION;5;5;4;0;1;1;0;5;0;0;0;3;2;0
22121.0;2023;17;NANTES;FEMININ;SCOLAIRE;BAC PROFESSIONNEL;BAC PRO PROD;BAC PRO 23003 ARTIS. & M.ART:MARCHANDISAGE VIS.;27;27;25;1;1;1;0;26;0;9;6;8;3;1
22132.0;2023;17;NANTES;FEMININ;SCOLAIRE;BAC PROFESSIONNEL;BAC PRO PROD;BAC PRO 24202 ARTIS.& MET.ART : TAPIS.D'AMEUBL;9;9;9;0;0;0;0;9;0;0;5;2;2;0
22133.0;2023;17;NANTES;FEMININ;SCOLAIRE;BAC PROFESSIONNEL;BAC PRO PROD;BAC PRO 24203 METIERS DE LA MODE - VÊTEMENT;186;186;155;25;6;5;1;160;0;15;45;63;37;26
22136.0;2023;17;NANTES;FEMININ;SCOLAIRE;BAC PROFESSIONNEL;BAC PRO PROD;BAC PRO 25007 MAINTENANCE EQUIPEMENTS INDUST.;4;4;3;1;0;0;0;3;0;0;0;3;0;1
22154.0;2023;17;NANTES;FEMININ;SCOLAIRE;BAC PROFESSIONNEL;BAC PRO PROD;BAC PRO AG 21210 COND GEST ENTR CANIN ET FELIN;37;36;34;2;0;0;0;34;0;1;5;12;16;2
22155.0;2023;17;NANTES;FEMININ;SCOLAIRE;BAC PROFESSIONNEL;BAC PRO PROD;BAC PRO AG 21211 COND GEST ENTR HIPPIQUE;87;83;73;10;0;0;0;73;0;2;11;21;39;10
22175.0;2023;17;NANTES;FEMININ;SCOLAIRE;BAC PROFESSIONNEL;BAC PRO SERV;BAC PRO 33103 TECHNICIEN APPAREIL. ORTHOPEDIQUE;6;6;6;0;0;0;0;6;0;1;3;2;0;0
22177.0;2023;17;NANTES;FEMININ;SCOLAIRE;BAC PROFESSIONNEL;BAC PRO SERV;BAC PRO 33403 COMMERC. SERVICES EN RESTAURATION;88;88;74;9;5;2;3;76;0;4;10;40;22;12
22188.0;2023;17;NANTES;FEMININ;SCOLAIRE;BAC TECHNOLOGIQUE;BAC STD2A;BAC STD2A SCIENCES & TECHNO. DESIGN-ARTS APPLIQUES;189;189;185;0;4;4;0;189;0;13;55;87;34;0
22199.0;2023;17;NANTES;FEMININ;SCOLAIRE;BAC TECHNOLOGIQUE;BAC STMG;BAC STMG SYSTEMES D'INFORMATION DE GESTION;3;3;2;0;1;0;1;2;0;0;0;0;2;1
22200.0;2023;17;NANTES;MASCULIN;APPRENTISSAGE;BAC PROFESSIONNEL;BAC PRO PROD;BACPRO 20002 ETUD.DEFINITION PRDTS INDUSTRIEL;1;1;1;0;0;0;0;1;0;1;0;0;0;0
22210.0;2023;17;NANTES;MASCULIN;APPRENTISSAGE;BAC PROFESSIONNEL;BAC PRO PROD;BAC PRO 23102 TRAVAUX PUBLICS;81;81;68;10;3;1;2;69;0;3;15;28;23;12
22219.0;2023;17;NANTES;MASCULIN;APPRENTISSAGE;BAC PROFESSIONNEL;BAC PRO PROD;BAC PRO 25007 MAINTENANCE EQUIPEMENTS INDUST.;86;86;70;13;3;1;2;71;0;2;20;30;19;15
22222.0;2023;17;NANTES;MASCULIN;APPRENTISSAGE;BAC PROFESSIONNEL;BAC PRO PROD;BAC PRO 25214 MAINT.VEHIC.OPTA VOIT.PARTICUL.;300;300;252;22;26;14;12;266;0;18;51;110;87;34
22225.0;2023;17;NANTES;MASCULIN;APPRENTISSAGE;BAC PROFESSIONNEL;BAC PRO PROD;BAC PRO 25219 MAINT.MATERIELS OPT.A AGRICOLES;60;59;49;7;3;2;1;51;0;5;18;14;14;8
22226.0;2023;17;NANTES;MASCULIN;APPRENTISSAGE;BAC PROFESSIONNEL;BAC PRO PROD;BAC PRO 25220 MAINT.MATERIELS OPT.B TP MANUT.;23;23;20;1;2;0;2;20;0;3;3;4;10;3
22230.0;2023;17;NANTES;MASCULIN;APPRENTISSAGE;BAC PROFESSIONNEL;BAC PRO PROD;BAC PRO 25304 AERONAUTIQUE OPTION STRUCTURE;22;22;21;1;0;0;0;21;0;1;7;11;2;1
22231.0;2023;17;NANTES;MASCULIN;APPRENTISSAGE;BAC PROFESSIONNEL;BAC PRO PROD;BAC PRO 25305 AVIATION GENERALE;1;1;1;0;0;0;0;1;0;1;0;0;0;0
22233.0;2023;17;NANTES;MASCULIN;APPRENTISSAGE;BAC PROFESSIONNEL;BAC PRO PROD;BAC PRO 25408 REPARATION DES CARROSSERIES;46;46;37;6;3;3;0;40;0;1;6;11;22;6
22237.0;2023;17;NANTES;MASCULIN;APPRENTISSAGE;BAC PROFESSIONNEL;BAC PRO PROD;BAC PRO 25510 METIERS ELECT. ENVIRON. CONNECTES;115;113;89;17;7;1;6;90;0;10;19;36;25;23
22242.0;2023;17;NANTES;MASCULIN;APPRENTISSAGE;BAC PROFESSIONNEL;BAC PRO PROD;BAC PRO AG 21004 CGEA;152;151;125;26;0;0;0;125;0;2;10;34;79;26
22257.0;2023;17;NANTES;MASCULIN;APPRENTISSAGE;BAC PROFESSIONNEL;BAC PRO SERV;BAC PRO 31213 MET.COM.VEN.OP.A ANI.GES.ESP.COM.;217;212;155;43;14;13;1;168;0;6;29;56;77;44
22260.0;2023;17;NANTES;MASCULIN;APPRENTISSAGE;BAC PROFESSIONNEL;BAC PRO SERV;BAC PRO 32207 REAL.PR.IMPR.PLURI.OPTA.PR.GRAPH.;6;5;5;0;0;0;0;5;0;1;2;2;0;0
22263.0;2023;17;NANTES;MASCULIN;APPRENTISSAGE;BAC PROFESSIONNEL;BAC PRO SERV;BAC PRO 33104 TECHNICIEN EN PROTHESE DENTAIRE;2;2;2;0;0;0;0;2;0;0;2;0;0;0
22267.0;2023;17;NANTES;MASCULIN;ENSEIGNEMENT A DISTANCE;BAC GENERAL;BAC GENERAL;BAC GENE 10019 BAC GENERAL;28;28;19;4;5;4;1;23;1;0;0;4;18;5
22269.0;2023;17;NANTES;MASCULIN;ENSEIGNEMENT A DISTANCE;BAC PROFESSIONNEL;BAC PRO PROD;BAC PRO AG 21114 CONDUITE PRODUCTIONS HORTICOLES;9;9;9;0;0;0;0;9;0;0;0;1;8;0
22270.0;2023;17;NANTES;MASCULIN;ENSEIGNEMENT A DISTANCE;BAC PROFESSIONNEL;BAC PRO SERV;BAC PRO 30004 ASSISTANC.GEST.ORGANIS.ACTIVITES;3;2;2;0;0;0;0;2;0;0;1;0;1;0
22281.0;2023;17;NANTES;MASCULIN;FORMATION CONTINUE;BAC PROFESSIONNEL;BAC PRO PROD;BAC PRO 25007 MAINTENANCE EQUIPEMENTS INDUST.;13;13;9;4;0;0;0;9;0;4;2;1;2;4
22290.0;2023;17;NANTES;MASCULIN;FORMATION CONTINUE;BAC PROFESSIONNEL;BAC PRO SERV;BAC PRO 31106 LOGISTIQUE;4;3;3;0;0;0;0;3;0;0;1;1;1;0
22299.0;2023;17;NANTES;MASCULIN;INDIVIDUEL;BAC PROFESSIONNEL;BAC PRO PROD;BAC PRO 24203 METIERS DE LA MODE - VÊTEMENT;1;1;0;1;0;0;0;0;0;0;0;0;0;1
22309.0;2023;17;NANTES;MASCULIN;INDIVIDUEL;BAC PROFESSIONNEL;BAC PRO PROD;BAC PRO AG 21113 CGEVV;3;2;2;0;0;0;0;2;0;0;0;0;2;0
22315.0;2023;17;NANTES;MASCULIN;INDIVIDUEL;BAC PROFESSIONNEL;BAC PRO SERV;BAC PRO 31213 MET.COM.VEN.OP.A ANI.GES.ESP.COM.;4;2;1;1;0;0;0;1;0;0;0;0;1;1
22318.0;2023;17;NANTES;MASCULIN;INDIVIDUEL;BAC PROFESSIONNEL;BAC PRO SERV;BAC PRO 33004 ACC.SOINS-S.PERS. OPT.EN STRUCTUR;1;0;0;0;0;0;0;0;0;0;0;0;0;0
22324.0;2023;17;NANTES;MASCULIN;INDIVIDUEL;BAC TECHNOLOGIQUE;BAC STL;BAC STL BIOCHIM.-BIOLOGIE-BIOTECHNOL.;1;1;0;1;0;0;0;0;0;0;0;0;0;1
22341.0;2023;17;NANTES;MASCULIN;SCOLAIRE;BAC PROFESSIONNEL;BAC PRO PROD;BAC PRO 23005 TECHN. ETUDES BAT B ASSIST.ARCHI.;46;46;46;0;0;0;0;46;0;1;11;20;14;0
22344.0;2023;17;NANTES;MASCULIN;SCOLAIRE;BAC PROFESSIONNEL;BAC PRO PROD;BAC PRO 23203 TECHNICIEN BAT. : ORG.REAL.GROS O;17;17;15;1;1;1;0;16;0;0;2;6;8;1
22346.0;2023;17;NANTES;MASCULIN;SCOLAIRE;BAC PROFESSIONNEL;BAC PRO PROD;BAC PRO 23303 MENUISERIE ALUMINIUM-VERRE;6;6;3;2;1;1;0;4;0;0;0;0;4;2
22371.0;2023;17;NANTES;MASCULIN;SCOLAIRE;BAC PROFESSIONNEL;BAC PRO PROD;BAC PRO 25514 SYST.NUM.OPT.B AUD.RES.EQUIP.DOM.;86;86;77;5;4;3;1;80;0;2;20;32;26;6
22375.0;2023;17;NANTES;MASCULIN;SCOLAIRE;BAC PROFESSIONNEL;BAC PRO PROD;BAC PRO AG 21113 CGEVV;13;13;12;1;0;0;0;12;0;2;0;6;4;1
22376.0;2023;17;NANTES;MASCULIN;SCOLAIRE;BAC PROFESSIONNEL;BAC PRO PROD;BAC PRO AG 21114 CONDUITE PRODUCTIONS HORTICOLES;16;16;14;2;0;0;0;14;0;0;1;5;8;2
22377.0;2023;17;NANTES;MASCULIN;SCOLAIRE;BAC PROFESSIONNEL;BAC PRO PROD;BAC PRO AG 21203 TECHN CONSEIL DE VENTE ANIMAL;35;35;34;1;0;0;0;34;0;0;5;16;13;1
22381.0;2023;17;NANTES;MASCULIN;SCOLAIRE;BAC PROFESSIONNEL;BAC PRO PROD;BAC PRO AG 21302 GEST MILIEUX NATURELS FAUNE;55;55;55;0;0;0;0;55;0;3;13;25;14;0
22382.0;2023;17;NANTES;MASCULIN;SCOLAIRE;BAC PROFESSIONNEL;BAC PRO PROD;BAC PRO AG 21405 AMENAGEMENTS PAYSAGERS;137;137;121;16;0;0;0;121;0;4;16;58;43;16
22389.0;2023;17;NANTES;MASCULIN;SCOLAIRE;BAC PROFESSIONNEL;BAC PRO SERV;BAC PRO 31114 ORGANIS. TRANSPORT MARCHANDISES;52;52;36;16;0;0;0;36;0;1;7;10;18;16
22394.0;2023;17;NANTES;MASCULIN;SCOLAIRE;BAC PROFESSIONNEL;BAC PRO SERV;BAC PRO 32208 REAL.PR.IMPR.PLURI.OPTB.PR.IMPR.;6;6;5;1;0;0;0;5;0;0;3;0;2;1
22398.0;2023;17;NANTES;MASCULIN;SCOLAIRE;BAC PROFESSIONNEL;BAC PRO SERV;BAC PRO 33004 ACC.SOINS-S.PERS. OPT.EN STRUCTUR;55;55;46;6;3;3;0;49;0;2;10;16;21;6
22405.0;2023;17;NANTES;MASCULIN;SCOLAIRE;BAC PROFESSIONNEL;BAC PRO SERV;BAC PRO 34303 GEST. POLLUTIONS PROTEC. ENVIRON.;2;2;1;1;0;0;0;1;0;0;0;1;0;1
22406.0;2023;17;NANTES;MASCULIN;SCOLAIRE;BAC PROFESSIONNEL;BAC PRO SERV;BAC PRO 34304 HYGIENE PROPRETE STERILISATION;1;1;1;0;0;0;0;1;0;0;0;0;1;0
22412.0;2023;17;NANTES;MASCULIN;SCOLAIRE;BAC TECHNOLOGIQUE;BAC STAV;BAC STAV AGRONOMIE ALIM ENV TERRITOI;199;198;194;4;0;0;0;194;0;4;16;77;97;4
22413.0;2023;17;NANTES;MASCULIN;SCOLAIRE;BAC TECHNOLOGIQUE;BAC STD2A;BAC STD2A SCIENCES & TECHNO. DESIGN-ARTS APPLIQUES;28;28;27;0;1;1;0;28;0;1;7;15;5;0
22419.0;2023;17;NANTES;MASCULIN;SCOLAIRE;BAC TECHNOLOGIQUE;BAC STL;BAC STL BIOCHIM.-BIOLOGIE-BIOTECHNOL.;63;63;56;0;7;1;6;57;1;1;8;22;25;6
22428.0;2023;23;NICE;FEMININ;APPRENTISSAGE;BAC PROFESSIONNEL;BAC PRO PROD;BAC PRO 25214 MAINT.VEHIC.OPTA VOIT.PARTICUL.;6;6;6;0;0;0;0;6;0;1;3;0;2;0
22431.0;2023;23;NICE;FEMININ;APPRENTISSAGE;BAC PROFESSIONNEL;BAC PRO PROD;BAC PRO AG 21405 AMENAGEMENTS PAYSAGERS;2;2;2;0;0;0;0;2;0;0;0;2;0;0
22438.0;2023;23;NICE;FEMININ;APPRENTISSAGE;BAC PROFESSIONNEL;BAC PRO SERV;BAC PRO 33403 COMMERC. SERVICES EN RESTAURATION;7;7;7;0;0;0;0;7;0;0;2;2;3;0
22441.0;2023;23;NICE;FEMININ;ENSEIGNEMENT A DISTANCE;BAC PROFESSIONNEL;BAC PRO SERV;BAC PRO 31212 METIERS DE L'ACCUEIL;1;0;0;0;0;0;0;0;0;0;0;0;0;0
22444.0;2023;23;NICE;FEMININ;ENSEIGNEMENT A DISTANCE;BAC PROFESSIONNEL;BAC PRO SERV;BAC PRO 33603 ESTHETIQUE COSMETIQUE PARFUMERIE;1;1;0;1;0;0;0;0;0;0;0;0;0;1
22445.0;2023;23;NICE;FEMININ;ENSEIGNEMENT A DISTANCE;BAC TECHNOLOGIQUE;BAC ST2S;BAC ST2S SCIENCES & TECHNO. SANTE & SOCIAL;11;11;5;2;4;3;1;8;0;1;1;1;5;3
22450.0;2023;23;NICE;FEMININ;FORMATION CONTINUE;BAC PROFESSIONNEL;BAC PRO SERV;BAC PRO 31212 METIERS DE L'ACCUEIL;10;10;6;4;0;0;0;6;0;1;2;1;2;4
22474.0;2023;23;NICE;FEMININ;INDIVIDUEL;BAC TECHNOLOGIQUE;BAC STMG;BAC STMG MERCATIQUE (MARKETING);10;10;6;3;1;1;0;7;0;0;0;0;7;3
22476.0;2023;23;NICE;FEMININ;SCOLAIRE;BAC GENERAL;BAC GENERAL;BAC GENE 10019 BAC GENERAL;6665;6664;6203;102;359;281;78;6484;180;977;1723;1946;1658;180
22484.0;2023;23;NICE;FEMININ;SCOLAIRE;BAC PROFESSIONNEL;BAC PRO PROD;BAC PRO 23102 TRAVAUX PUBLICS;1;1;1;0;0;0;0;1;0;0;0;0;1;0
22486.0;2023;23;NICE;FEMININ;SCOLAIRE;BAC PROFESSIONNEL;BAC PRO PROD;BAC PRO 23205 INTERV. SUR PATRIMOINE BATI OPT.A;1;1;0;0;1;1;0;1;0;0;0;0;1;0
22487.0;2023;23;NICE;FEMININ;SCOLAIRE;BAC PROFESSIONNEL;BAC PRO PROD;BAC PRO 23405 TECHNICIEN MENUISIER AGENCEUR;1;1;1;0;0;0;0;1;0;0;0;1;0;0
22496.0;2023;23;NICE;FEMININ;SCOLAIRE;BAC PROFESSIONNEL;BAC PRO PROD;BAC PRO 25215 MAINT.VEHIC.OPTB VEHIC.TRANS.ROUT;1;1;1;0;0;0;0;1;0;0;0;0;1;0
22499.0;2023;23;NICE;FEMININ;SCOLAIRE;BAC PROFESSIONNEL;BAC PRO PROD;BAC PRO 25514 SYST.NUM.OPT.B AUD.RES.EQUIP.DOM.;1;1;1;0;0;0;0;1;0;0;0;1;0;0
22500.0;2023;23;NICE;FEMININ;SCOLAIRE;BAC PROFESSIONNEL;BAC PRO PROD;BAC PRO 25515 SYST.NUM.OPT.C RES.INF.SYST.COMM.;3;3;3;0;0;0;0;3;0;0;2;1;0;0
22506.0;2023;23;NICE;FEMININ;SCOLAIRE;BAC PROFESSIONNEL;BAC PRO SERV;BAC PRO 30004 ASSISTANC.GEST.ORGANIS.ACTIVITES;323;323;254;54;15;10;5;264;0;7;58;101;98;59
22508.0;2023;23;NICE;FEMININ;SCOLAIRE;BAC PROFESSIONNEL;BAC PRO SERV;BAC PRO 31114 ORGANIS. TRANSPORT MARCHANDISES;5;5;2;1;2;2;0;4;0;0;1;1;2;1
22514.0;2023;23;NICE;FEMININ;SCOLAIRE;BAC PROFESSIONNEL;BAC PRO SERV;BAC PRO 32303 ART.& MET.ART:COM.VIS.VIS.PLURI-M;5;5;5;0;0;0;0;5;0;1;2;2;0;0
22526.0;2023;23;NICE;FEMININ;SCOLAIRE;BAC TECHNOLOGIQUE;BAC S2TMD;BAC S2TMD MUSIQUE;3;3;3;0;0;0;0;3;0;0;3;0;0;0
22540.0;2023;23;NICE;MASCULIN;APPRENTISSAGE;BAC PROFESSIONNEL;BAC PRO PROD;BAC PRO 22106 CUISINE;18;18;15;1;2;1;1;16;0;0;4;6;6;2
22541.0;2023;23;NICE;MASCULIN;APPRENTISSAGE;BAC PROFESSIONNEL;BAC PRO PROD;BAC PRO 22403 ARTS.& MET.ART:MET.ENSEIGN SIGNA;2;2;2;0;0;0;0;2;0;0;0;1;1;0
22542.0;2023;23;NICE;MASCULIN;APPRENTISSAGE;BAC PROFESSIONNEL;BAC PRO PROD;BAC PRO 22703 TECHN.INSTALL.SYST.ENERG.CLIMATI;6;6;6;0;0;0;0;6;0;0;1;4;1;0
22545.0;2023;23;NICE;MASCULIN;APPRENTISSAGE;BAC PROFESSIONNEL;BAC PRO PROD;BAC PRO 23203 TECHNICIEN BAT. : ORG.REAL.GROS O;7;7;5;2;0;0;0;5;0;0;3;1;1;2
22550.0;2023;23;NICE;MASCULIN;APPRENTISSAGE;BAC PROFESSIONNEL;BAC PRO PROD;BAC PRO 25007 MAINTENANCE EQUIPEMENTS INDUST.;7;7;7;0;0;0;0;7;0;1;3;0;3;0
22553.0;2023;23;NICE;MASCULIN;APPRENTISSAGE;BAC PROFESSIONNEL;BAC PRO PROD;BAC PRO 25215 MAINT.VEHIC.OPTB VEHIC.TRANS.ROUT;7;7;6;1;0;0;0;6;0;1;1;1;3;1
22559.0;2023;23;NICE;MASCULIN;APPRENTISSAGE;BAC PROFESSIONNEL;BAC PRO PROD;BAC PRO 25510 METIERS ELECT. ENVIRON. CONNECTES;59;59;47;6;6;4;2;51;0;3;12;15;21;8
22560.0;2023;23;NICE;MASCULIN;APPRENTISSAGE;BAC PROFESSIONNEL;BAC PRO PROD;BAC PRO 25514 SYST.NUM.OPT.B AUD.RES.EQUIP.DOM.;10;10;8;1;1;1;0;9;0;1;1;4;3;1
22563.0;2023;23;NICE;MASCULIN;APPRENTISSAGE;BAC PROFESSIONNEL;BAC PRO PROD;BAC PRO AG 21405 AMENAGEMENTS PAYSAGERS;28;26;25;1;0;0;0;25;0;1;2;6;16;1
22587.0;2023;23;NICE;MASCULIN;INDIVIDUEL;BAC PROFESSIONNEL;BAC PRO PROD;BAC PRO 25009 MAINTENANCE NAUTIQUE;1;1;1;0;0;0;0;1;0;0;0;0;1;0
22588.0;2023;23;NICE;MASCULIN;INDIVIDUEL;BAC PROFESSIONNEL;BAC PRO PROD;BAC PRO 25106 TECHNICIEN D'USINAGE;2;1;0;1;0;0;0;0;0;0;0;0;0;1
22598.0;2023;23;NICE;MASCULIN;INDIVIDUEL;BAC PROFESSIONNEL;BAC PRO SERV;BAC PRO 31214 MET.COM.VEN.OP.B PR.CL.VA.OF.COM.;3;1;0;0;1;1;0;1;0;0;0;0;1;0
22605.0;2023;23;NICE;MASCULIN;INDIVIDUEL;BAC TECHNOLOGIQUE;BAC STMG;BAC STMG GESTION ET FINANCE;2;2;1;1;0;0;0;1;0;0;0;0;1;1
22608.0;2023;23;NICE;MASCULIN;SCOLAIRE;BAC GENERAL;BAC GENERAL;BAC GENE 10019 BAC GENERAL;5281;5281;4716;133;432;318;114;5034;118;642;1150;1468;1656;247
22609.0;2023;23;NICE;MASCULIN;SCOLAIRE;BAC PROFESSIONNEL;BAC PRO PROD;BACPRO 20002 ETUD.DEFINITION PRDTS INDUSTRIEL;16;16;13;3;0;0;0;13;0;3;1;4;5;3
22618.0;2023;23;NICE;MASCULIN;SCOLAIRE;BAC PROFESSIONNEL;BAC PRO PROD;BAC PRO 23102 TRAVAUX PUBLICS;23;23;15;6;2;2;0;17;0;0;4;2;11;6
22619.0;2023;23;NICE;MASCULIN;SCOLAIRE;BAC PROFESSIONNEL;BAC PRO PROD;BACPRO 23103 TECHNICIEN GEOMETRE-TOPOGRAPHE;18;18;16;2;0;0;0;16;0;0;3;4;9;2
22632.0;2023;23;NICE;MASCULIN;SCOLAIRE;BAC PROFESSIONNEL;BAC PRO PROD;BAC PRO 25007 MAINTENANCE EQUIPEMENTS INDUST.;112;112;79;28;5;4;1;83;0;2;23;26;32;29
22644.0;2023;23;NICE;MASCULIN;SCOLAIRE;BAC PROFESSIONNEL;BAC PRO PROD;BAC PRO 25510 METIERS ELECT. ENVIRON. CONNECTES;334;333;247;63;23;18;5;265;0;14;44;90;117;68
22648.0;2023;23;NICE;MASCULIN;SCOLAIRE;BAC PROFESSIONNEL;BAC PRO PROD;BAC PRO AG 21004 CGEA;3;3;2;1;0;0;0;2;0;0;0;0;2;1
22649.0;2023;23;NICE;MASCULIN;SCOLAIRE;BAC PROFESSIONNEL;BAC PRO PROD;BAC PRO AG 21113 CGEVV;19;19;15;4;0;0;0;15;0;1;0;5;9;4
22662.0;2023;23;NICE;MASCULIN;SCOLAIRE;BAC PROFESSIONNEL;BAC PRO SERV;BAC PRO 32303 ART.& MET.ART:COM.VIS.VIS.PLURI-M;5;5;5;0;0;0;0;5;0;0;0;5;0;0
22664.0;2023;23;NICE;MASCULIN;SCOLAIRE;BAC PROFESSIONNEL;BAC PRO SERV;BAC PRO 33004 ACC.SOINS-S.PERS. OPT.EN STRUCTUR;17;17;16;1;0;0;0;16;0;0;1;7;8;1
22677.0;2023;23;NICE;MASCULIN;SCOLAIRE;BAC TECHNOLOGIQUE;BAC STI2D;BAC STI2D ARCHITECTURE ET CONSTRUCTION;71;71;63;1;7;3;4;66;0;1;13;20;32;5
22684.0;2023;23;NICE;MASCULIN;SCOLAIRE;BAC TECHNOLOGIQUE;BAC STMG;BAC STMG MERCATIQUE (MARKETING);539;539;406;42;91;60;31;466;0;0;42;135;289;73
22685.0;2023;23;NICE;MASCULIN;SCOLAIRE;BAC TECHNOLOGIQUE;BAC STMG;BAC STMG RESSOURCES HUMAINES ET COMMUNICATION;172;172;121;23;28;17;11;138;0;1;2;30;105;34
22694.0;2023;70;NORMANDIE;FEMININ;APPRENTISSAGE;BAC PROFESSIONNEL;BAC PRO PROD;BAC PRO 23102 TRAVAUX PUBLICS;1;1;1;0;0;0;0;1;0;0;0;0;1;0
22701.0;2023;70;NORMANDIE;FEMININ;APPRENTISSAGE;BAC PROFESSIONNEL;BAC PRO PROD;BAC PRO 25106 TECHNICIEN D'USINAGE;1;1;1;0;0;0;0;1;0;0;0;0;1;0
22705.0;2023;70;NORMANDIE;FEMININ;APPRENTISSAGE;BAC PROFESSIONNEL;BAC PRO PROD;BAC PRO 25408 REPARATION DES CARROSSERIES;7;7;5;1;1;1;0;6;0;1;2;1;2;1
22709.0;2023;70;NORMANDIE;FEMININ;APPRENTISSAGE;BAC PROFESSIONNEL;BAC PRO PROD;BAC PRO 25514 SYST.NUM.OPT.B AUD.RES.EQUIP.DOM.;1;1;1;0;0;0;0;1;0;0;1;0;0;0
22710.0;2023;70;NORMANDIE;FEMININ;APPRENTISSAGE;BAC PROFESSIONNEL;BAC PRO PROD;BAC PRO AG 21004 CGEA;40;38;26;12;0;0;0;26;0;0;0;7;19;12
22718.0;2023;70;NORMANDIE;FEMININ;APPRENTISSAGE;BAC PROFESSIONNEL;BAC PRO SERV;BAC PRO 31106 LOGISTIQUE;5;5;5;0;0;0;0;5;0;0;5;0;0;0
22721.0;2023;70;NORMANDIE;FEMININ;APPRENTISSAGE;BAC PROFESSIONNEL;BAC PRO SERV;BAC PRO 31214 MET.COM.VEN.OP.B PR.CL.VA.OF.COM.;3;3;3;0;0;0;0;3;0;0;3;0;0;0
22727.0;2023;70;NORMANDIE;FEMININ;APPRENTISSAGE;BAC PROFESSIONNEL;BAC PRO SERV;BAC PRO AG 33002 SERV PERS TERRIT;38;38;35;3;0;0;0;35;0;0;5;12;18;3
22734.0;2023;70;NORMANDIE;FEMININ;ENSEIGNEMENT A DISTANCE;BAC PROFESSIONNEL;BAC PRO SERV;BAC PRO 33004 ACC.SOINS-S.PERS. OPT.EN STRUCTUR;4;2;0;2;0;0;0;0;0;0;0;0;0;2
22736.0;2023;70;NORMANDIE;FEMININ;ENSEIGNEMENT A DISTANCE;BAC TECHNOLOGIQUE;BAC ST2S;BAC ST2S SCIENCES & TECHNO. SANTE & SOCIAL;8;8;5;1;2;1;1;6;0;0;1;2;3;2
22737.0;2023;70;NORMANDIE;FEMININ;ENSEIGNEMENT A DISTANCE;BAC TECHNOLOGIQUE;BAC STMG;BAC STMG GESTION ET FINANCE;2;2;1;0;1;0;1;1;0;0;0;1;0;1
22739.0;2023;70;NORMANDIE;FEMININ;ENSEIGNEMENT A DISTANCE;BAC TECHNOLOGIQUE;BAC STMG;BAC STMG RESSOURCES HUMAINES ET COMMUNICATION;7;7;2;1;4;1;3;3;0;0;0;1;2;4
22753.0;2023;70;NORMANDIE;FEMININ;INDIVIDUEL;BAC PROFESSIONNEL;BAC PRO PROD;BAC PRO AG 21004 CGEA;13;11;9;2;0;0;0;9;0;0;0;0;9;2
22756.0;2023;70;NORMANDIE;FEMININ;INDIVIDUEL;BAC PROFESSIONNEL;BAC PRO SERV;BAC PRO 30004 ASSISTANC.GEST.ORGANIS.ACTIVITES;4;4;3;1;0;0;0;3;0;1;0;0;2;1
22761.0;2023;70;NORMANDIE;FEMININ;INDIVIDUEL;BAC PROFESSIONNEL;BAC PRO SERV;BAC PRO 33004 ACC.SOINS-S.PERS. OPT.EN STRUCTUR;4;3;2;1;0;0;0;2;0;0;0;1;1;1
22766.0;2023;70;NORMANDIE;FEMININ;INDIVIDUEL;BAC TECHNOLOGIQUE;BAC ST2S;BAC ST2S SCIENCES & TECHNO. SANTE & SOCIAL;10;10;0;8;2;0;2;0;0;0;0;0;0;10
22768.0;2023;70;NORMANDIE;FEMININ;INDIVIDUEL;BAC TECHNOLOGIQUE;BAC STL;BAC STL BIOCHIM.-BIOLOGIE-BIOTECHNOL.;2;2;0;1;1;0;1;0;0;0;0;0;0;2
22771.0;2023;70;NORMANDIE;FEMININ;INDIVIDUEL;BAC TECHNOLOGIQUE;BAC STMG;BAC STMG RESSOURCES HUMAINES ET COMMUNICATION;4;4;0;4;0;0;0;0;0;0;0;0;0;4
22780.0;2023;70;NORMANDIE;FEMININ;SCOLAIRE;BAC PROFESSIONNEL;BAC PRO PROD;BAC PRO 23003 ARTIS. & M.ART:MARCHANDISAGE VIS.;10;10;10;0;0;0;0;10;0;0;1;7;2;0
22793.0;2023;70;NORMANDIE;FEMININ;SCOLAIRE;BAC PROFESSIONNEL;BAC PRO PROD;BAC PRO 25007 MAINTENANCE EQUIPEMENTS INDUST.;11;11;8;3;0;0;0;8;0;0;0;6;2;3
22798.0;2023;70;NORMANDIE;FEMININ;SCOLAIRE;BAC PROFESSIONNEL;BAC PRO PROD;BAC PRO 25216 MAINT.VEHIC.OPTC MOTOCYCLES;1;1;1;0;0;0;0;1;0;0;1;0;0;0
22807.0;2023;70;NORMANDIE;FEMININ;SCOLAIRE;BAC PROFESSIONNEL;BAC PRO PROD;BAC PRO 25515 SYST.NUM.OPT.C RES.INF.SYST.COMM.;4;4;4;0;0;0;0;4;0;0;0;2;2;0
22819.0;2023;70;NORMANDIE;FEMININ;SCOLAIRE;BAC PROFESSIONNEL;BAC PRO PROD;BAC PRO AG 22108 TEC CONS VTE ALIMENTATION (PAB);9;9;8;1;0;0;0;8;0;0;0;3;5;1
22824.0;2023;70;NORMANDIE;FEMININ;SCOLAIRE;BAC PROFESSIONNEL;BAC PRO SERV;BAC PRO 31212 METIERS DE L'ACCUEIL;196;196;166;16;14;10;4;176;0;11;41;66;58;20
22834.0;2023;70;NORMANDIE;FEMININ;SCOLAIRE;BAC PROFESSIONNEL;BAC PRO SERV;BAC PRO 33101 OPTIQUE LUNETTERIE;11;11;9;0;2;2;0;11;0;1;2;3;5;0
22845.0;2023;70;NORMANDIE;FEMININ;SCOLAIRE;BAC TECHNOLOGIQUE;BAC S2TMD;BAC S2TMD MUSIQUE;3;3;3;0;0;0;0;3;0;0;2;0;1;0
22848.0;2023;70;NORMANDIE;FEMININ;SCOLAIRE;BAC TECHNOLOGIQUE;BAC STD2A;BAC STD2A SCIENCES & TECHNO. DESIGN-ARTS APPLIQUES;91;91;90;0;1;0;1;90;1;18;27;32;12;1
22851.0;2023;70;NORMANDIE;FEMININ;SCOLAIRE;BAC TECHNOLOGIQUE;BAC STI2D;BAC STI2D ENERGIES  ET ENVIRONNEMENT;24;24;20;0;4;3;1;23;0;2;1;7;13;1
22860.0;2023;70;NORMANDIE;MASCULIN;APPRENTISSAGE;BAC PROFESSIONNEL;BAC PRO PROD;BAC PRO 20102 PILOTE DE LIGNE DE PRODUCTION;7;7;7;0;0;0;0;7;0;0;5;0;2;0
22864.0;2023;70;NORMANDIE;MASCULIN;APPRENTISSAGE;BAC PROFESSIONNEL;BAC PRO PROD;BAC PRO 22703 TECHN.INSTALL.SYST.ENERG.CLIMATI;28;28;24;2;2;1;1;25;0;4;8;6;7;3
22867.0;2023;70;NORMANDIE;MASCULIN;APPRENTISSAGE;BAC PROFESSIONNEL;BAC PRO PROD;BAC PRO 23102 TRAVAUX PUBLICS;33;33;30;1;2;2;0;32;0;1;14;9;8;1
22876.0;2023;70;NORMANDIE;MASCULIN;APPRENTISSAGE;BAC PROFESSIONNEL;BAC PRO PROD;BAC PRO 24203 METIERS DE LA MODE - VÊTEMENT;1;1;0;1;0;0;0;0;0;0;0;0;0;1
22884.0;2023;70;NORMANDIE;MASCULIN;APPRENTISSAGE;BAC PROFESSIONNEL;BAC PRO PROD;BAC PRO 25219 MAINT.MATERIELS OPT.A AGRICOLES;6;6;5;0;1;0;1;5;0;0;2;1;2;1
22887.0;2023;70;NORMANDIE;MASCULIN;APPRENTISSAGE;BAC PROFESSIONNEL;BAC PRO PROD;BAC PRO 25303 AERONAUTIQUE OPTION SYSTEMES;8;8;8;0;0;0;0;8;0;4;3;1;0;0
22888.0;2023;70;NORMANDIE;MASCULIN;APPRENTISSAGE;BAC PROFESSIONNEL;BAC PRO PROD;BAC PRO 25406 OUVRAGES DU BATIMENT METALLERIE;4;4;3;1;0;0;0;3;0;0;0;1;2;1
22891.0;2023;70;NORMANDIE;MASCULIN;APPRENTISSAGE;BAC PROFESSIONNEL;BAC PRO PROD;BAC PRO 25509 TECHNIC. FROID CONDITIONNEMT AIR;17;17;15;2;0;0;0;15;0;0;5;5;5;2
22894.0;2023;70;NORMANDIE;MASCULIN;APPRENTISSAGE;BAC PROFESSIONNEL;BAC PRO PROD;BAC PRO 25514 SYST.NUM.OPT.B AUD.RES.EQUIP.DOM.;3;3;2;1;0;0;0;2;0;0;0;1;1;1
22896.0;2023;70;NORMANDIE;MASCULIN;APPRENTISSAGE;BAC PROFESSIONNEL;BAC PRO PROD;BAC PRO AG 21001 AGRO-EQUIPEMENT;56;56;46;10;0;0;0;46;0;0;4;11;31;10
22901.0;2023;70;NORMANDIE;MASCULIN;APPRENTISSAGE;BAC PROFESSIONNEL;BAC PRO PROD;BAC PRO AG 21211 COND GEST ENTR HIPPIQUE;21;20;13;7;0;0;0;13;0;0;2;1;10;7
22913.0;2023;70;NORMANDIE;MASCULIN;ENSEIGNEMENT A DISTANCE;BAC GENERAL;BAC GENERAL;BAC GENE 10019 BAC GENERAL;22;22;10;7;5;5;0;15;0;0;2;3;10;7
22922.0;2023;70;NORMANDIE;MASCULIN;FORMATION CONTINUE;BAC PROFESSIONNEL;BAC PRO PROD;BAC PRO 20102 PILOTE DE LIGNE DE PRODUCTION;10;10;10;0;0;0;0;10;0;1;5;1;3;0
22923.0;2023;70;NORMANDIE;MASCULIN;FORMATION CONTINUE;BAC PROFESSIONNEL;BAC PRO PROD;BAC PRO 22004 PROC. CHIMIE EAU PAPIERS-CARTONS;13;13;13;0;0;0;0;13;0;11;1;1;0;0
22926.0;2023;70;NORMANDIE;MASCULIN;FORMATION CONTINUE;BAC PROFESSIONNEL;BAC PRO PROD;BAC PRO 23004 TECHN. ETUDES BAT.A ETUDES & ECO.;10;10;9;1;0;0;0;9;0;0;0;5;4;1
22927.0;2023;70;NORMANDIE;MASCULIN;FORMATION CONTINUE;BAC PROFESSIONNEL;BAC PRO PROD;BAC PRO 25007 MAINTENANCE EQUIPEMENTS INDUST.;8;7;6;1;0;0;0;6;0;3;1;2;0;1
22928.0;2023;70;NORMANDIE;MASCULIN;FORMATION CONTINUE;BAC PROFESSIONNEL;BAC PRO PROD;BAC PRO 25106 TECHNICIEN D'USINAGE;9;7;7;0;0;0;0;7;0;2;1;3;1;0
22931.0;2023;70;NORMANDIE;MASCULIN;FORMATION CONTINUE;BAC PROFESSIONNEL;BAC PRO PROD;BAC PRO 25510 METIERS ELECT. ENVIRON. CONNECTES;10;10;7;2;1;0;1;7;0;3;2;1;1;3
22939.0;2023;70;NORMANDIE;MASCULIN;INDIVIDUEL;BAC PROFESSIONNEL;BAC PRO PROD;BAC PRO 23005 TECHN. ETUDES BAT B ASSIST.ARCHI.;1;1;1;0;0;0;0;1;0;0;0;0;1;0
22940.0;2023;70;NORMANDIE;MASCULIN;INDIVIDUEL;BAC PROFESSIONNEL;BAC PRO PROD;BACPRO 23103 TECHNICIEN GEOMETRE-TOPOGRAPHE;1;1;0;1;0;0;0;0;0;0;0;0;0;1
22943.0;2023;70;NORMANDIE;MASCULIN;INDIVIDUEL;BAC PROFESSIONNEL;BAC PRO PROD;BAC PRO 25106 TECHNICIEN D'USINAGE;2;1;0;1;0;0;0;0;0;0;0;0;0;1
22954.0;2023;70;NORMANDIE;MASCULIN;INDIVIDUEL;BAC PROFESSIONNEL;BAC PRO SERV;BAC PRO 31107 CONDUCT. TRANSP.ROUT.MARCHANDISES;1;1;1;0;0;0;0;1;0;0;0;1;0;0
22956.0;2023;70;NORMANDIE;MASCULIN;INDIVIDUEL;BAC PROFESSIONNEL;BAC PRO SERV;BAC PRO 31214 MET.COM.VEN.OP.B PR.CL.VA.OF.COM.;1;1;0;1;0;0;0;0;0;0;0;0;0;1
22973.0;2023;70;NORMANDIE;MASCULIN;SCOLAIRE;BAC PROFESSIONNEL;BAC PRO PROD;BAC PRO 20102 PILOTE DE LIGNE DE PRODUCTION;25;24;22;2;0;0;0;22;0;1;7;10;4;2
22975.0;2023;70;NORMANDIE;MASCULIN;SCOLAIRE;BAC PROFESSIONNEL;BAC PRO PROD;BAC PRO 22004 PROC. CHIMIE EAU PAPIERS-CARTONS;60;60;43;13;4;3;1;46;0;0;11;16;19;14
22976.0;2023;70;NORMANDIE;MASCULIN;SCOLAIRE;BAC PROFESSIONNEL;BAC PRO PROD;BAC PRO 22105 BOULANGER-PÂTISSIER;37;37;32;5;0;0;0;32;0;4;7;13;8;5
22987.0;2023;70;NORMANDIE;MASCULIN;SCOLAIRE;BAC PROFESSIONNEL;BAC PRO PROD;BAC PRO 23203 TECHNICIEN BAT. : ORG.REAL.GROS O;37;36;21;12;3;2;1;23;0;0;2;7;14;13
22993.0;2023;70;NORMANDIE;MASCULIN;SCOLAIRE;BAC PROFESSIONNEL;BAC PRO PROD;BAC PRO 23406 TECHNICIEN DE SCIERIE;5;5;3;2;0;0;0;3;0;0;1;1;1;2
22998.0;2023;70;NORMANDIE;MASCULIN;SCOLAIRE;BAC PROFESSIONNEL;BAC PRO PROD;BAC PRO 25007 MAINTENANCE EQUIPEMENTS INDUST.;327;326;228;87;11;8;3;236;0;7;35;69;125;90
23004.0;2023;70;NORMANDIE;MASCULIN;SCOLAIRE;BAC PROFESSIONNEL;BAC PRO PROD;BAC PRO 25216 MAINT.VEHIC.OPTC MOTOCYCLES;18;18;16;2;0;0;0;16;0;4;5;4;3;2
23013.0;2023;70;NORMANDIE;MASCULIN;SCOLAIRE;BAC PROFESSIONNEL;BAC PRO PROD;BAC PRO 25510 METIERS ELECT. ENVIRON. CONNECTES;502;500;339;121;40;28;12;367;0;17;67;109;174;133
23015.0;2023;70;NORMANDIE;MASCULIN;SCOLAIRE;BAC PROFESSIONNEL;BAC PRO PROD;BAC PRO 25514 SYST.NUM.OPT.B AUD.RES.EQUIP.DOM.;63;63;47;12;4;3;1;50;0;3;6;18;23;13
23017.0;2023;70;NORMANDIE;MASCULIN;SCOLAIRE;BAC PROFESSIONNEL;BAC PRO PROD;BAC PRO AG 21001 AGRO-EQUIPEMENT;48;48;42;6;0;0;0;42;0;0;1;8;33;6
23019.0;2023;70;NORMANDIE;MASCULIN;SCOLAIRE;BAC PROFESSIONNEL;BAC PRO PROD;BAC PRO AG 21114 CONDUITE PRODUCTIONS HORTICOLES;18;17;15;2;0;0;0;15;0;1;1;5;8;2
23024.0;2023;70;NORMANDIE;MASCULIN;SCOLAIRE;BAC PROFESSIONNEL;BAC PRO PROD;BAC PRO AG 21302 GEST MILIEUX NATURELS FAUNE;37;36;34;2;0;0;0;34;0;2;0;12;20;2
23026.0;2023;70;NORMANDIE;MASCULIN;SCOLAIRE;BAC PROFESSIONNEL;BAC PRO PROD;BAC PRO AG 21405 AMENAGEMENTS PAYSAGERS;97;97;86;11;0;0;0;86;0;0;11;30;45;11
23030.0;2023;70;NORMANDIE;MASCULIN;SCOLAIRE;BAC PROFESSIONNEL;BAC PRO SERV;BAC PRO 30004 ASSISTANC.GEST.ORGANIS.ACTIVITES;193;193;126;60;7;6;1;132;0;4;11;46;71;61
23032.0;2023;70;NORMANDIE;MASCULIN;SCOLAIRE;BAC PROFESSIONNEL;BAC PRO SERV;BAC PRO 31107 CONDUCT. TRANSP.ROUT.MARCHANDISES;120;120;105;13;2;2;0;107;0;16;37;38;16;13
23035.0;2023;70;NORMANDIE;MASCULIN;SCOLAIRE;BAC PROFESSIONNEL;BAC PRO SERV;BAC PRO 31213 MET.COM.VEN.OP.A ANI.GES.ESP.COM.;408;407;326;64;17;11;6;337;0;12;41;149;135;70
23038.0;2023;70;NORMANDIE;MASCULIN;SCOLAIRE;BAC PROFESSIONNEL;BAC PRO SERV;BAC PRO 32208 REAL.PR.IMPR.PLURI.OPTB.PR.IMPR.;16;16;13;1;2;2;0;15;0;1;2;3;9;1
23041.0;2023;70;NORMANDIE;MASCULIN;SCOLAIRE;BAC PROFESSIONNEL;BAC PRO SERV;BAC PRO 33003 ACC.SOINS-S.PERS. OPT.A DOMICILE;11;11;7;4;0;0;0;7;0;0;1;3;3;4
23055.0;2023;70;NORMANDIE;MASCULIN;SCOLAIRE;BAC TECHNOLOGIQUE;BAC ST2S;BAC ST2S SCIENCES & TECHNO. SANTE & SOCIAL;123;123;86;6;31;21;10;107;0;2;8;21;76;16
23056.0;2023;70;NORMANDIE;MASCULIN;SCOLAIRE;BAC TECHNOLOGIQUE;BAC STAV;BAC STAV AGRONOMIE ALIM ENV TERRITOI;120;120;118;2;0;0;0;118;0;1;14;43;60;2
23063.0;2023;70;NORMANDIE;MASCULIN;SCOLAIRE;BAC TECHNOLOGIQUE;BAC STL;BAC STL BIOCHIM.-BIOLOGIE-BIOTECHNOL.;84;84;67;6;11;6;5;73;0;3;10;28;32;11
23072.0;2023;18;ORLEANS-TOURS;FEMININ;APPRENTISSAGE;BAC PROFESSIONNEL;BAC PRO PROD;BAC PRO 24302 METIERS DU CUIR : MAROQUINERIE;6;6;6;0;0;0;0;6;0;1;2;2;1;0
23087.0;2023;18;ORLEANS-TOURS;FEMININ;APPRENTISSAGE;BAC PROFESSIONNEL;BAC PRO SERV;BAC PRO 31106 LOGISTIQUE;6;6;3;1;2;1;1;4;0;0;0;2;2;2
23088.0;2023;18;ORLEANS-TOURS;FEMININ;APPRENTISSAGE;BAC PROFESSIONNEL;BAC PRO SERV;BAC PRO 31114 ORGANIS. TRANSPORT MARCHANDISES;1;1;1;0;0;0;0;1;0;0;0;1;0;0
23091.0;2023;18;ORLEANS-TOURS;FEMININ;APPRENTISSAGE;BAC PROFESSIONNEL;BAC PRO SERV;BAC PRO 31214 MET.COM.VEN.OP.B PR.CL.VA.OF.COM.;6;6;6;0;0;0;0;6;0;1;1;1;3;0
23093.0;2023;18;ORLEANS-TOURS;FEMININ;APPRENTISSAGE;BAC PROFESSIONNEL;BAC PRO SERV;BAC PRO 32208 REAL.PR.IMPR.PLURI.OPTB.PR.IMPR.;2;2;2;0;0;0;0;2;0;1;1;0;0;0
23099.0;2023;18;ORLEANS-TOURS;FEMININ;ENSEIGNEMENT A DISTANCE;BAC TECHNOLOGIQUE;BAC ST2S;BAC ST2S SCIENCES & TECHNO. SANTE & SOCIAL;6;6;3;1;2;2;0;5;0;0;0;2;3;1
23102.0;2023;18;ORLEANS-TOURS;FEMININ;FORMATION CONTINUE;BAC PROFESSIONNEL;BAC PRO PROD;BAC PRO 23005 TECHN. ETUDES BAT B ASSIST.ARCHI.;1;1;1;0;0;0;0;1;0;0;1;0;0;0
23108.0;2023;18;ORLEANS-TOURS;FEMININ;FORMATION CONTINUE;BAC PROFESSIONNEL;BAC PRO PROD;BAC PRO AG 21405 AMENAGEMENTS PAYSAGERS;1;1;1;0;0;0;0;1;0;0;0;0;1;0
23113.0;2023;18;ORLEANS-TOURS;FEMININ;INDIVIDUEL;BAC PROFESSIONNEL;BAC PRO PROD;BAC PRO 22106 CUISINE;2;2;0;2;0;0;0;0;0;0;0;0;0;2
23128.0;2023;18;ORLEANS-TOURS;FEMININ;INDIVIDUEL;BAC PROFESSIONNEL;BAC PRO SERV;BAC PRO AG 33002 SERV PERS TERRIT;3;3;3;0;0;0;0;3;0;0;0;0;3;0
23134.0;2023;18;ORLEANS-TOURS;FEMININ;SCOLAIRE;BAC GENERAL;BAC GENERAL;BAC GENE 10019 BAC GENERAL;7230;7230;6739;81;410;269;141;7008;173;967;1777;2188;1903;222
23139.0;2023;18;ORLEANS-TOURS;FEMININ;SCOLAIRE;BAC PROFESSIONNEL;BAC PRO PROD;BAC PRO 22106 CUISINE;63;63;52;9;2;1;1;53;0;2;11;18;22;10
23141.0;2023;18;ORLEANS-TOURS;FEMININ;SCOLAIRE;BAC PROFESSIONNEL;BAC PRO PROD;BAC PRO 22503 PLASTIQUES ET COMPOSITES;1;1;0;1;0;0;0;0;0;0;0;0;0;1
23142.0;2023;18;ORLEANS-TOURS;FEMININ;SCOLAIRE;BAC PROFESSIONNEL;BAC PRO PROD;BAC PRO 23003 ARTIS. & M.ART:MARCHANDISAGE VIS.;14;14;14;0;0;0;0;14;0;4;3;4;3;0
23143.0;2023;18;ORLEANS-TOURS;FEMININ;SCOLAIRE;BAC PROFESSIONNEL;BAC PRO PROD;BAC PRO 23004 TECHN. ETUDES BAT.A ETUDES & ECO.;10;10;10;0;0;0;0;10;0;1;0;5;4;0
23146.0;2023;18;ORLEANS-TOURS;FEMININ;SCOLAIRE;BAC PROFESSIONNEL;BAC PRO PROD;BACPRO 23103 TECHNICIEN GEOMETRE-TOPOGRAPHE;1;1;0;1;0;0;0;0;0;0;0;0;0;1
23149.0;2023;18;ORLEANS-TOURS;FEMININ;SCOLAIRE;BAC PROFESSIONNEL;BAC PRO PROD;BAC PRO 23405 TECHNICIEN MENUISIER AGENCEUR;7;7;5;1;1;1;0;6;0;0;1;2;3;1
23151.0;2023;18;ORLEANS-TOURS;FEMININ;SCOLAIRE;BAC PROFESSIONNEL;BAC PRO PROD;BAC PRO 24202 ARTIS.& MET.ART : TAPIS.D'AMEUBL;11;11;8;1;2;1;1;9;0;0;3;2;4;2
23165.0;2023;18;ORLEANS-TOURS;FEMININ;SCOLAIRE;BAC PROFESSIONNEL;BAC PRO PROD;BAC PRO 25513 SYST.NUM.OPT.A SURETE SECURITE;1;1;1;0;0;0;0;1;0;0;1;0;0;0
23166.0;2023;18;ORLEANS-TOURS;FEMININ;SCOLAIRE;BAC PROFESSIONNEL;BAC PRO PROD;BAC PRO 25514 SYST.NUM.OPT.B AUD.RES.EQUIP.DOM.;3;3;3;0;0;0;0;3;0;0;2;0;1;0
23169.0;2023;18;ORLEANS-TOURS;FEMININ;SCOLAIRE;BAC PROFESSIONNEL;BAC PRO PROD;BAC PRO AG 21004 CGEA;78;77;60;17;0;0;0;60;0;1;11;9;39;17
23170.0;2023;18;ORLEANS-TOURS;FEMININ;SCOLAIRE;BAC PROFESSIONNEL;BAC PRO PROD;BAC PRO AG 21113 CGEVV;2;2;2;0;0;0;0;2;0;0;0;1;1;0
23171.0;2023;18;ORLEANS-TOURS;FEMININ;SCOLAIRE;BAC PROFESSIONNEL;BAC PRO PROD;BAC PRO AG 21114 CONDUITE PRODUCTIONS HORTICOLES;11;11;11;0;0;0;0;11;0;0;2;4;5;0
23174.0;2023;18;ORLEANS-TOURS;FEMININ;SCOLAIRE;BAC PROFESSIONNEL;BAC PRO PROD;BAC PRO AG 21212 TECH EXPE ANIMALE;16;16;14;2;0;0;0;14;0;0;1;8;5;2
23177.0;2023;18;ORLEANS-TOURS;FEMININ;SCOLAIRE;BAC PROFESSIONNEL;BAC PRO PROD;BAC PRO AG 21405 AMENAGEMENTS PAYSAGERS;6;6;6;0;0;0;0;6;0;0;1;1;4;0
23179.0;2023;18;ORLEANS-TOURS;FEMININ;SCOLAIRE;BAC PROFESSIONNEL;BAC PRO PROD;BAC PRO AG 22105 LABORATOIRE CONTROLE QUALITE;9;9;7;2;0;0;0;7;0;1;1;2;3;2
23183.0;2023;18;ORLEANS-TOURS;FEMININ;SCOLAIRE;BAC PROFESSIONNEL;BAC PRO SERV;BAC PRO 31107 CONDUCT. TRANSP.ROUT.MARCHANDISES;5;5;5;0;0;0;0;5;0;1;1;1;2;0
23190.0;2023;18;ORLEANS-TOURS;FEMININ;SCOLAIRE;BAC PROFESSIONNEL;BAC PRO SERV;BAC PRO 32303 ART.& MET.ART:COM.VIS.VIS.PLURI-M;16;16;16;0;0;0;0;16;0;4;7;4;1;0
23192.0;2023;18;ORLEANS-TOURS;FEMININ;SCOLAIRE;BAC PROFESSIONNEL;BAC PRO SERV;BAC PRO 33003 ACC.SOINS-S.PERS. OPT.A DOMICILE;195;195;145;27;23;16;7;161;0;9;28;53;71;34
23205.0;2023;18;ORLEANS-TOURS;FEMININ;SCOLAIRE;BAC TECHNOLOGIQUE;BAC STAV;BAC STAV AGRONOMIE ALIM ENV TERRITOI;131;130;124;6;0;0;0;124;0;3;15;44;62;6
23206.0;2023;18;ORLEANS-TOURS;FEMININ;SCOLAIRE;BAC TECHNOLOGIQUE;BAC STD2A;BAC STD2A SCIENCES & TECHNO. DESIGN-ARTS APPLIQUES;201;201;186;0;15;11;4;197;0;8;47;84;58;4
23213.0;2023;18;ORLEANS-TOURS;FEMININ;SCOLAIRE;BAC TECHNOLOGIQUE;BAC STL;BAC STL SCIENCES PHYSIQUES CHIMIQUES  EN LABORAT.;56;56;53;1;2;2;0;55;2;8;11;19;15;1
23215.0;2023;18;ORLEANS-TOURS;FEMININ;SCOLAIRE;BAC TECHNOLOGIQUE;BAC STMG;BAC STMG MERCATIQUE (MARKETING);798;798;645;30;123;86;37;731;0;8;66;229;428;67
23238.0;2023;18;ORLEANS-TOURS;MASCULIN;APPRENTISSAGE;BAC PROFESSIONNEL;BAC PRO PROD;BAC PRO 25220 MAINT.MATERIELS OPT.B TP MANUT.;10;10;10;0;0;0;0;10;0;2;3;2;3;0
23244.0;2023;18;ORLEANS-TOURS;MASCULIN;APPRENTISSAGE;BAC PROFESSIONNEL;BAC PRO PROD;BAC PRO 25509 TECHNIC. FROID CONDITIONNEMT AIR;14;14;10;4;0;0;0;10;0;1;3;3;3;4
23246.0;2023;18;ORLEANS-TOURS;MASCULIN;APPRENTISSAGE;BAC PROFESSIONNEL;BAC PRO PROD;BAC PRO 25514 SYST.NUM.OPT.B AUD.RES.EQUIP.DOM.;2;2;2;0;0;0;0;2;0;0;0;2;0;0
23252.0;2023;18;ORLEANS-TOURS;MASCULIN;APPRENTISSAGE;BAC PROFESSIONNEL;BAC PRO PROD;BAC PRO AG 21211 COND GEST ENTR HIPPIQUE;1;1;1;0;0;0;0;1;0;0;0;0;1;0
23255.0;2023;18;ORLEANS-TOURS;MASCULIN;APPRENTISSAGE;BAC PROFESSIONNEL;BAC PRO PROD;BAC PRO AG 21405 AMENAGEMENTS PAYSAGERS;122;120;108;12;0;0;0;108;0;2;7;26;73;12
23258.0;2023;18;ORLEANS-TOURS;MASCULIN;APPRENTISSAGE;BAC PROFESSIONNEL;BAC PRO SERV;BAC PRO 31106 LOGISTIQUE;21;21;9;6;6;4;2;13;0;0;1;2;10;8
23272.0;2023;18;ORLEANS-TOURS;MASCULIN;FORMATION CONTINUE;BAC PROFESSIONNEL;BAC PRO PROD;BACPRO 23103 TECHNICIEN GEOMETRE-TOPOGRAPHE;1;1;1;0;0;0;0;1;0;1;0;0;0;0
23275.0;2023;18;ORLEANS-TOURS;MASCULIN;FORMATION CONTINUE;BAC PROFESSIONNEL;BAC PRO PROD;BAC PRO 25007 MAINTENANCE EQUIPEMENTS INDUST.;2;2;2;0;0;0;0;2;0;0;1;1;0;0
23285.0;2023;18;ORLEANS-TOURS;MASCULIN;FORMATION CONTINUE;BAC PROFESSIONNEL;BAC PRO SERV;BAC PRO 30004 ASSISTANC.GEST.ORGANIS.ACTIVITES;1;1;1;0;0;0;0;1;0;0;0;1;0;0
23287.0;2023;18;ORLEANS-TOURS;MASCULIN;INDIVIDUEL;BAC GENERAL;BAC GENERAL;BAC GENE 10019 BAC GENERAL;66;65;25;34;6;4;2;29;2;4;7;6;10;36
23290.0;2023;18;ORLEANS-TOURS;MASCULIN;INDIVIDUEL;BAC PROFESSIONNEL;BAC PRO PROD;BAC PRO 23404 TECHNICIEN CONSTRUCTEUR BOIS;1;1;0;1;0;0;0;0;0;0;0;0;0;1
23294.0;2023;18;ORLEANS-TOURS;MASCULIN;INDIVIDUEL;BAC PROFESSIONNEL;BAC PRO PROD;BAC PRO 25216 MAINT.VEHIC.OPTC MOTOCYCLES;1;1;0;1;0;0;0;0;0;0;0;0;0;1
23298.0;2023;18;ORLEANS-TOURS;MASCULIN;INDIVIDUEL;BAC PROFESSIONNEL;BAC PRO PROD;BAC PRO AG 21004 CGEA;9;8;7;1;0;0;0;7;0;0;0;0;7;1
23306.0;2023;18;ORLEANS-TOURS;MASCULIN;INDIVIDUEL;BAC PROFESSIONNEL;BAC PRO SERV;BAC PRO 31213 MET.COM.VEN.OP.A ANI.GES.ESP.COM.;12;7;3;4;0;0;0;3;0;0;1;0;2;4
23309.0;2023;18;ORLEANS-TOURS;MASCULIN;INDIVIDUEL;BAC PROFESSIONNEL;BAC PRO SERV;BAC PRO 33403 COMMERC. SERVICES EN RESTAURATION;1;1;0;1;0;0;0;0;0;0;0;0;0;1
23312.0;2023;18;ORLEANS-TOURS;MASCULIN;INDIVIDUEL;BAC TECHNOLOGIQUE;BAC STI2D;BAC STI2D ENERGIES  ET ENVIRONNEMENT;2;2;0;1;1;0;1;0;0;0;0;0;0;2
23315.0;2023;18;ORLEANS-TOURS;MASCULIN;INDIVIDUEL;BAC TECHNOLOGIQUE;BAC STMG;BAC STMG MERCATIQUE (MARKETING);8;8;1;5;2;0;2;1;0;0;0;0;1;7
23318.0;2023;18;ORLEANS-TOURS;MASCULIN;SCOLAIRE;BAC PROFESSIONNEL;BAC PRO PROD;BACPRO 20002 ETUD.DEFINITION PRDTS INDUSTRIEL;36;36;18;18;0;0;0;18;0;2;2;8;6;18
23329.0;2023;18;ORLEANS-TOURS;MASCULIN;SCOLAIRE;BAC PROFESSIONNEL;BAC PRO PROD;BAC PRO 23004 TECHN. ETUDES BAT.A ETUDES & ECO.;33;32;19;13;0;0;0;19;0;1;5;9;4;13
23331.0;2023;18;ORLEANS-TOURS;MASCULIN;SCOLAIRE;BAC PROFESSIONNEL;BAC PRO PROD;BAC PRO 23102 TRAVAUX PUBLICS;17;17;13;4;0;0;0;13;0;0;3;5;5;4
23335.0;2023;18;ORLEANS-TOURS;MASCULIN;SCOLAIRE;BAC PROFESSIONNEL;BAC PRO PROD;BAC PRO 23208 METIERS ET ARTS DE LA PIERRE;3;3;2;1;0;0;0;2;0;1;0;1;0;1
23339.0;2023;18;ORLEANS-TOURS;MASCULIN;SCOLAIRE;BAC PROFESSIONNEL;BAC PRO PROD;BAC PRO 23405 TECHNICIEN MENUISIER AGENCEUR;78;78;54;24;0;0;0;54;0;2;10;13;29;24
23341.0;2023;18;ORLEANS-TOURS;MASCULIN;SCOLAIRE;BAC PROFESSIONNEL;BAC PRO PROD;BAC PRO 24202 ARTIS.& MET.ART : TAPIS.D'AMEUBL;1;1;0;1;0;0;0;0;0;0;0;0;0;1
23344.0;2023;18;ORLEANS-TOURS;MASCULIN;SCOLAIRE;BAC PROFESSIONNEL;BAC PRO PROD;BAC PRO 25005 PRODUCTIQ.MECA. OPT.DECOLLETAGE;11;11;9;2;0;0;0;9;0;1;2;5;1;2
23345.0;2023;18;ORLEANS-TOURS;MASCULIN;SCOLAIRE;BAC PROFESSIONNEL;BAC PRO PROD;BAC PRO 25006 MICROTECHNIQUES;12;12;10;2;0;0;0;10;0;2;4;1;3;2
23347.0;2023;18;ORLEANS-TOURS;MASCULIN;SCOLAIRE;BAC PROFESSIONNEL;BAC PRO PROD;BAC PRO 25106 TECHNICIEN D'USINAGE;73;72;54;17;1;1;0;55;0;5;10;17;23;17
23351.0;2023;18;ORLEANS-TOURS;MASCULIN;SCOLAIRE;BAC PROFESSIONNEL;BAC PRO PROD;BAC PRO 25215 MAINT.VEHIC.OPTB VEHIC.TRANS.ROUT;20;20;12;7;1;0;1;12;0;0;0;7;5;8
23374.0;2023;18;ORLEANS-TOURS;MASCULIN;SCOLAIRE;BAC PROFESSIONNEL;BAC PRO PROD;BAC PRO AG 21405 AMENAGEMENTS PAYSAGERS;49;49;41;8;0;0;0;41;0;2;4;15;20;8
23383.0;2023;18;ORLEANS-TOURS;MASCULIN;SCOLAIRE;BAC PROFESSIONNEL;BAC PRO SERV;BAC PRO 31213 MET.COM.VEN.OP.A ANI.GES.ESP.COM.;322;322;260;46;16;11;5;271;0;5;41;106;119;51
23388.0;2023;18;ORLEANS-TOURS;MASCULIN;SCOLAIRE;BAC PROFESSIONNEL;BAC PRO SERV;BAC PRO 32304 PHOTOGRAPHIE;9;9;8;1;0;0;0;8;0;1;1;4;2;1
23390.0;2023;18;ORLEANS-TOURS;MASCULIN;SCOLAIRE;BAC PROFESSIONNEL;BAC PRO SERV;BAC PRO 33003 ACC.SOINS-S.PERS. OPT.A DOMICILE;14;14;11;2;1;1;0;12;0;0;3;5;4;2
23401.0;2023;18;ORLEANS-TOURS;MASCULIN;SCOLAIRE;BAC TECHNOLOGIQUE;BAC S2TMD;BAC S2TMD MUSIQUE;5;5;5;0;0;0;0;5;0;2;1;2;0;0
23402.0;2023;18;ORLEANS-TOURS;MASCULIN;SCOLAIRE;BAC TECHNOLOGIQUE;BAC ST2S;BAC ST2S SCIENCES & TECHNO. SANTE & SOCIAL;92;92;71;4;17;11;6;82;0;1;7;34;40;10
23407.0;2023;18;ORLEANS-TOURS;MASCULIN;SCOLAIRE;BAC TECHNOLOGIQUE;BAC STI2D;BAC STI2D ENERGIES  ET ENVIRONNEMENT;126;126;104;4;18;9;9;113;0;2;17;39;55;13
23410.0;2023;18;ORLEANS-TOURS;MASCULIN;SCOLAIRE;BAC TECHNOLOGIQUE;BAC STL;BAC STL BIOCHIM.-BIOLOGIE-BIOTECHNOL.;68;68;59;1;8;3;5;62;1;1;18;19;23;6
23416.0;2023;01;PARIS;FEMININ;APPRENTISSAGE;BAC PROFESSIONNEL;BAC PRO PROD;BAC PRO 22004 PROC. CHIMIE EAU PAPIERS-CARTONS;3;3;3;0;0;0;0;3;0;0;0;2;1;0
23428.0;2023;01;PARIS;FEMININ;APPRENTISSAGE;BAC PROFESSIONNEL;BAC PRO SERV;BAC PRO 32207 REAL.PR.IMPR.PLURI.OPTA.PR.GRAPH.;2;2;1;1;0;0;0;1;0;0;1;0;0;1
23438.0;2023;01;PARIS;FEMININ;ENSEIGNEMENT A DISTANCE;BAC PROFESSIONNEL;BAC PRO SERV;BAC PRO 33004 ACC.SOINS-S.PERS. OPT.EN STRUCTUR;2;2;1;1;0;0;0;1;0;0;0;1;0;1
23440.0;2023;01;PARIS;FEMININ;ENSEIGNEMENT A DISTANCE;BAC TECHNOLOGIQUE;BAC STMG;BAC STMG MERCATIQUE (MARKETING);3;3;0;2;1;0;1;0;0;0;0;0;0;3
23441.0;2023;01;PARIS;FEMININ;ENSEIGNEMENT A DISTANCE;BAC TECHNOLOGIQUE;BAC STMG;BAC STMG RESSOURCES HUMAINES ET COMMUNICATION;3;3;2;1;0;0;0;2;0;0;0;1;1;1
23446.0;2023;01;PARIS;FEMININ;INDIVIDUEL;BAC PROFESSIONNEL;BAC PRO PROD;BAC PRO 24203 METIERS DE LA MODE - VÊTEMENT;2;1;1;0;0;0;0;1;0;0;0;0;1;0
23449.0;2023;01;PARIS;FEMININ;INDIVIDUEL;BAC PROFESSIONNEL;BAC PRO PROD;BAC PRO AG 21004 CGEA;11;11;10;1;0;0;0;10;0;0;0;0;10;1
23458.0;2023;01;PARIS;FEMININ;INDIVIDUEL;BAC PROFESSIONNEL;BAC PRO SERV;BAC PRO 32207 REAL.PR.IMPR.PLURI.OPTA.PR.GRAPH.;1;1;1;0;0;0;0;1;0;0;0;0;1;0
23461.0;2023;01;PARIS;FEMININ;INDIVIDUEL;BAC PROFESSIONNEL;BAC PRO SERV;BAC PRO 33004 ACC.SOINS-S.PERS. OPT.EN STRUCTUR;3;1;0;1;0;0;0;0;0;0;0;0;0;1
23465.0;2023;01;PARIS;FEMININ;INDIVIDUEL;BAC TECHNOLOGIQUE;BAC ST2S;BAC ST2S SCIENCES & TECHNO. SANTE & SOCIAL;6;5;1;3;1;0;1;1;0;0;1;0;0;4
23466.0;2023;01;PARIS;FEMININ;INDIVIDUEL;BAC TECHNOLOGIQUE;BAC STD2A;BAC STD2A SCIENCES & TECHNO. DESIGN-ARTS APPLIQUES;12;12;3;5;4;0;4;3;0;0;0;2;1;9
23474.0;2023;01;PARIS;FEMININ;SCOLAIRE;BAC PROFESSIONNEL;BAC PRO PROD;BACPRO 20002 ETUD.DEFINITION PRDTS INDUSTRIEL;1;1;1;0;0;0;0;1;0;0;0;0;1;0
23478.0;2023;01;PARIS;FEMININ;SCOLAIRE;BAC PROFESSIONNEL;BAC PRO PROD;BAC PRO 22106 CUISINE;22;22;20;2;0;0;0;20;0;0;4;6;10;2
23487.0;2023;01;PARIS;FEMININ;SCOLAIRE;BAC PROFESSIONNEL;BAC PRO PROD;BAC PRO 23408 Etude et réalisation d'agencement;8;8;5;3;0;0;0;5;0;0;0;3;2;3
23488.0;2023;01;PARIS;FEMININ;SCOLAIRE;BAC PROFESSIONNEL;BAC PRO PROD;BAC PRO 24202 ARTIS.& MET.ART : TAPIS.D'AMEUBL;6;6;5;1;0;0;0;5;0;2;2;0;1;1
23493.0;2023;01;PARIS;FEMININ;SCOLAIRE;BAC PROFESSIONNEL;BAC PRO PROD;BAC PRO 25411 TECH.CHAUDRONNERIE INDUSTRIELLE;1;1;1;0;0;0;0;1;0;0;0;1;0;0
23495.0;2023;01;PARIS;FEMININ;SCOLAIRE;BAC PROFESSIONNEL;BAC PRO PROD;BAC PRO 25515 SYST.NUM.OPT.C RES.INF.SYST.COMM.;6;6;4;2;0;0;0;4;0;1;1;1;1;2
23497.0;2023;01;PARIS;FEMININ;SCOLAIRE;BAC PROFESSIONNEL;BAC PRO PROD;BAC PRO AG 22105 LABORATOIRE CONTROLE QUALITE;5;4;1;3;0;0;0;1;0;0;1;0;0;3
23498.0;2023;01;PARIS;FEMININ;SCOLAIRE;BAC PROFESSIONNEL;BAC PRO SERV;BAC PRO 30004 ASSISTANC.GEST.ORGANIS.ACTIVITES;264;263;213;42;8;6;2;219;0;11;34;80;94;44
23530.0;2023;01;PARIS;FEMININ;SCOLAIRE;BAC TECHNOLOGIQUE;BAC STI2D;BAC STI2D SYSTÈME D'INFORMATION  ET NUMERIQUE;20;20;17;0;3;2;1;19;0;1;4;8;6;1
23532.0;2023;01;PARIS;FEMININ;SCOLAIRE;BAC TECHNOLOGIQUE;BAC STL;BAC STL SCIENCES PHYSIQUES CHIMIQUES  EN LABORAT.;35;35;33;1;1;0;1;33;0;5;8;12;8;2
23533.0;2023;01;PARIS;FEMININ;SCOLAIRE;BAC TECHNOLOGIQUE;BAC STMG;BAC STMG GESTION ET FINANCE;217;217;180;11;26;15;11;195;0;4;32;72;87;22
23536.0;2023;01;PARIS;FEMININ;SCOLAIRE;BAC TECHNOLOGIQUE;BAC STMG;BAC STMG SYSTEMES D'INFORMATION DE GESTION;52;52;38;6;8;5;3;43;0;6;4;13;20;9
23538.0;2023;01;PARIS;MASCULIN;APPRENTISSAGE;BAC PROFESSIONNEL;BAC PRO PROD;BAC PRO 22105 BOULANGER-PÂTISSIER;41;41;35;4;2;0;2;35;0;0;14;15;6;6
23540.0;2023;01;PARIS;MASCULIN;APPRENTISSAGE;BAC PROFESSIONNEL;BAC PRO PROD;BAC PRO 22703 TECHN.INSTALL.SYST.ENERG.CLIMATI;22;22;19;2;1;1;0;20;0;1;4;7;8;2
23542.0;2023;01;PARIS;MASCULIN;APPRENTISSAGE;BAC PROFESSIONNEL;BAC PRO PROD;BAC PRO 23004 TECHN. ETUDES BAT.A ETUDES & ECO.;17;17;11;5;1;1;0;12;0;0;2;4;6;5
23550.0;2023;01;PARIS;MASCULIN;APPRENTISSAGE;BAC PROFESSIONNEL;BAC PRO SERV;BAC PRO 31106 LOGISTIQUE;6;6;5;0;1;1;0;6;0;0;0;2;4;0
23553.0;2023;01;PARIS;MASCULIN;APPRENTISSAGE;BAC PROFESSIONNEL;BAC PRO SERV;BAC PRO 31213 MET.COM.VEN.OP.A ANI.GES.ESP.COM.;87;87;44;37;6;4;2;48;0;2;10;13;23;39
23557.0;2023;01;PARIS;MASCULIN;APPRENTISSAGE;BAC PROFESSIONNEL;BAC PRO SERV;BAC PRO 33101 OPTIQUE LUNETTERIE;13;13;13;0;0;0;0;13;0;1;4;2;6;0
23567.0;2023;01;PARIS;MASCULIN;FORMATION CONTINUE;BAC PROFESSIONNEL;BAC PRO PROD;BACPRO 20002 ETUD.DEFINITION PRDTS INDUSTRIEL;1;1;1;0;0;0;0;1;0;1;0;0;0;0
23571.0;2023;01;PARIS;MASCULIN;FORMATION CONTINUE;BAC PROFESSIONNEL;BAC PRO PROD;BAC PRO 25509 TECHNIC. FROID CONDITIONNEMT AIR;13;13;13;0;0;0;0;13;0;3;1;8;1;0
23575.0;2023;01;PARIS;MASCULIN;FORMATION CONTINUE;BAC PROFESSIONNEL;BAC PRO SERV;BAC PRO 31212 METIERS DE L'ACCUEIL;1;0;0;0;0;0;0;0;0;0;0;0;0;0
23576.0;2023;01;PARIS;MASCULIN;INDIVIDUEL;BAC GENERAL;BAC GENERAL;BAC GENE 10019 BAC GENERAL;443;439;251;116;72;52;20;303;1;18;24;95;165;136
23579.0;2023;01;PARIS;MASCULIN;INDIVIDUEL;BAC PROFESSIONNEL;BAC PRO PROD;BAC PRO 25214 MAINT.VEHIC.OPTA VOIT.PARTICUL.;9;8;5;3;0;0;0;5;0;1;1;0;3;3
23581.0;2023;01;PARIS;MASCULIN;INDIVIDUEL;BAC PROFESSIONNEL;BAC PRO PROD;BAC PRO 25510 METIERS ELECT. ENVIRON. CONNECTES;22;20;14;3;3;2;1;16;0;3;5;2;6;4
23583.0;2023;01;PARIS;MASCULIN;INDIVIDUEL;BAC PROFESSIONNEL;BAC PRO PROD;BAC PRO AG 21113 CGEVV;3;3;3;0;0;0;0;3;0;0;0;0;3;0
23587.0;2023;01;PARIS;MASCULIN;INDIVIDUEL;BAC PROFESSIONNEL;BAC PRO SERV;BAC PRO 31212 METIERS DE L'ACCUEIL;1;1;0;1;0;0;0;0;0;0;0;0;0;1
23590.0;2023;01;PARIS;MASCULIN;INDIVIDUEL;BAC PROFESSIONNEL;BAC PRO SERV;BAC PRO 32304 PHOTOGRAPHIE;1;1;1;0;0;0;0;1;0;0;0;1;0;0
23600.0;2023;01;PARIS;MASCULIN;INDIVIDUEL;BAC TECHNOLOGIQUE;BAC STMG;BAC STMG RESSOURCES HUMAINES ET COMMUNICATION;14;14;5;7;2;1;1;6;0;0;0;2;4;8
23603.0;2023;01;PARIS;MASCULIN;SCOLAIRE;BAC PROFESSIONNEL;BAC PRO PROD;BACPRO 20002 ETUD.DEFINITION PRDTS INDUSTRIEL;6;6;4;2;0;0;0;4;0;0;0;4;0;2
23605.0;2023;01;PARIS;MASCULIN;SCOLAIRE;BAC PROFESSIONNEL;BAC PRO PROD;BAC PRO 22003 BIO-INDUSTRIES DE TRANSFORMATION;8;8;7;1;0;0;0;7;0;0;1;2;4;1
23621.0;2023;01;PARIS;MASCULIN;SCOLAIRE;BAC PROFESSIONNEL;BAC PRO PROD;BAC PRO 23405 TECHNICIEN MENUISIER AGENCEUR;20;20;19;0;1;1;0;20;0;1;4;8;7;0
23625.0;2023;01;PARIS;MASCULIN;SCOLAIRE;BAC PROFESSIONNEL;BAC PRO PROD;BAC PRO 24203 METIERS DE LA MODE - VÊTEMENT;14;14;12;2;0;0;0;12;0;1;4;5;2;2
23635.0;2023;01;PARIS;MASCULIN;SCOLAIRE;BAC PROFESSIONNEL;BAC PRO PROD;BAC PRO 25411 TECH.CHAUDRONNERIE INDUSTRIELLE;12;12;10;1;1;1;0;11;0;2;3;3;3;1
23639.0;2023;01;PARIS;MASCULIN;SCOLAIRE;BAC PROFESSIONNEL;BAC PRO PROD;BAC PRO 25514 SYST.NUM.OPT.B AUD.RES.EQUIP.DOM.;50;50;39;7;4;4;0;43;0;4;3;15;21;7
23642.0;2023;01;PARIS;MASCULIN;SCOLAIRE;BAC PROFESSIONNEL;BAC PRO PROD;BAC PRO AG 22105 LABORATOIRE CONTROLE QUALITE;5;5;3;2;0;0;0;3;0;0;2;0;1;2
23648.0;2023;01;PARIS;MASCULIN;SCOLAIRE;BAC PROFESSIONNEL;BAC PRO SERV;BAC PRO 31214 MET.COM.VEN.OP.B PR.CL.VA.OF.COM.;94;94;70;20;4;2;2;72;0;4;17;21;30;22
23658.0;2023;01;PARIS;MASCULIN;SCOLAIRE;BAC PROFESSIONNEL;BAC PRO SERV;BAC PRO 33103 TECHNICIEN APPAREIL. ORTHOPEDIQUE;14;14;11;2;1;1;0;12;0;0;1;5;6;2
23664.0;2023;01;PARIS;MASCULIN;SCOLAIRE;BAC PROFESSIONNEL;BAC PRO SERV;BAC PRO 34403 METIERS DE LA SECURITE;60;60;52;4;4;3;1;55;0;4;14;22;15;5
23665.0;2023;01;PARIS;MASCULIN;SCOLAIRE;BAC TECHNOLOGIQUE;BAC S2TMD;BAC S2TMD DANSE;1;1;1;0;0;0;0;1;0;0;0;1;0;0
23668.0;2023;01;PARIS;MASCULIN;SCOLAIRE;BAC TECHNOLOGIQUE;BAC ST2S;BAC ST2S SCIENCES & TECHNO. SANTE & SOCIAL;54;54;41;7;6;5;1;46;0;1;10;14;21;8
23679.0;2023;01;PARIS;MASCULIN;SCOLAIRE;BAC TECHNOLOGIQUE;BAC STMG;BAC STMG RESSOURCES HUMAINES ET COMMUNICATION;180;180;111;29;40;30;10;141;0;0;12;39;90;39
23680.0;2023;01;PARIS;MASCULIN;SCOLAIRE;BAC TECHNOLOGIQUE;BAC STMG;BAC STMG SYSTEMES D'INFORMATION DE GESTION;101;101;63;19;19;11;8;74;0;0;6;29;39;27
23686.0;2023;13;POITIERS;FEMININ;APPRENTISSAGE;BAC PROFESSIONNEL;BAC PRO PROD;BAC PRO 25009 MAINTENANCE NAUTIQUE;1;1;1;0;0;0;0;1;0;0;0;0;1;0
23689.0;2023;13;POITIERS;FEMININ;APPRENTISSAGE;BAC PROFESSIONNEL;BAC PRO PROD;BAC PRO 25219 MAINT.MATERIELS OPT.A AGRICOLES;1;1;1;0;0;0;0;1;0;0;1;0;0;0
23694.0;2023;13;POITIERS;FEMININ;APPRENTISSAGE;BAC PROFESSIONNEL;BAC PRO PROD;BAC PRO AG 21203 TECHN CONSEIL DE VENTE ANIMAL;1;1;1;0;0;0;0;1;0;0;0;0;1;0
23697.0;2023;13;POITIERS;FEMININ;APPRENTISSAGE;BAC PROFESSIONNEL;BAC PRO PROD;BAC PRO AG 22108 TEC CONS VTE ALIMENTATION (PAB);11;9;8;1;0;0;0;8;0;0;0;1;7;1
23700.0;2023;13;POITIERS;FEMININ;APPRENTISSAGE;BAC PROFESSIONNEL;BAC PRO SERV;BAC PRO 31212 METIERS DE L'ACCUEIL;2;2;2;0;0;0;0;2;0;0;1;0;1;0
23703.0;2023;13;POITIERS;FEMININ;APPRENTISSAGE;BAC PROFESSIONNEL;BAC PRO SERV;BAC PRO 32207 REAL.PR.IMPR.PLURI.OPTA.PR.GRAPH.;3;3;3;0;0;0;0;3;0;1;1;1;0;0
23705.0;2023;13;POITIERS;FEMININ;APPRENTISSAGE;BAC PROFESSIONNEL;BAC PRO SERV;BAC PRO 33004 ACC.SOINS-S.PERS. OPT.EN STRUCTUR;9;9;8;1;0;0;0;8;0;1;2;1;4;1
23707.0;2023;13;POITIERS;FEMININ;APPRENTISSAGE;BAC PROFESSIONNEL;BAC PRO SERV;BAC PRO 33403 COMMERC. SERVICES EN RESTAURATION;7;7;6;0;1;0;1;6;0;0;1;3;2;1
23708.0;2023;13;POITIERS;FEMININ;APPRENTISSAGE;BAC PROFESSIONNEL;BAC PRO SERV;BAC PRO 33603 ESTHETIQUE COSMETIQUE PARFUMERIE;5;5;5;0;0;0;0;5;0;0;0;2;3;0
23710.0;2023;13;POITIERS;FEMININ;ENSEIGNEMENT A DISTANCE;BAC GENERAL;BAC GENERAL;BAC GENE 10019 BAC GENERAL;39;39;25;8;6;3;3;28;0;3;5;7;13;11
23712.0;2023;13;POITIERS;FEMININ;ENSEIGNEMENT A DISTANCE;BAC PROFESSIONNEL;BAC PRO SERV;BAC PRO 31214 MET.COM.VEN.OP.B PR.CL.VA.OF.COM.;1;1;0;0;1;0;1;0;0;0;0;0;0;1
23713.0;2023;13;POITIERS;FEMININ;ENSEIGNEMENT A DISTANCE;BAC TECHNOLOGIQUE;BAC ST2S;BAC ST2S SCIENCES & TECHNO. SANTE & SOCIAL;6;6;4;1;1;0;1;4;0;1;0;1;2;2
23715.0;2023;13;POITIERS;FEMININ;ENSEIGNEMENT A DISTANCE;BAC TECHNOLOGIQUE;BAC STMG;BAC STMG MERCATIQUE (MARKETING);2;2;2;0;0;0;0;2;0;0;0;1;1;0
23722.0;2023;13;POITIERS;FEMININ;INDIVIDUEL;BAC PROFESSIONNEL;BAC PRO PROD;BAC PRO AG 22108 TEC CONS VTE ALIMENTATION (PAB);1;0;0;0;0;0;0;0;0;0;0;0;0;0
23723.0;2023;13;POITIERS;FEMININ;INDIVIDUEL;BAC PROFESSIONNEL;BAC PRO SERV;BAC PRO 30004 ASSISTANC.GEST.ORGANIS.ACTIVITES;1;1;0;0;1;0;1;0;0;0;0;0;0;1
23731.0;2023;13;POITIERS;FEMININ;INDIVIDUEL;BAC TECHNOLOGIQUE;BAC ST2S;BAC ST2S SCIENCES & TECHNO. SANTE & SOCIAL;15;15;5;5;5;3;2;8;0;0;0;1;7;7
23740.0;2023;13;POITIERS;FEMININ;SCOLAIRE;BAC PROFESSIONNEL;BAC PRO PROD;BAC PRO 22105 BOULANGER-PÂTISSIER;21;21;21;0;0;0;0;21;0;1;9;8;3;0
23743.0;2023;13;POITIERS;FEMININ;SCOLAIRE;BAC PROFESSIONNEL;BAC PRO PROD;BAC PRO 23004 TECHN. ETUDES BAT.A ETUDES & ECO.;9;9;8;1;0;0;0;8;0;1;2;4;1;1
23746.0;2023;13;POITIERS;FEMININ;SCOLAIRE;BAC PROFESSIONNEL;BAC PRO PROD;BAC PRO 23303 MENUISERIE ALUMINIUM-VERRE;1;1;0;1;0;0;0;0;0;0;0;0;0;1
23752.0;2023;13;POITIERS;FEMININ;SCOLAIRE;BAC PROFESSIONNEL;BAC PRO PROD;BAC PRO 25006 MICROTECHNIQUES;1;1;1;0;0;0;0;1;0;0;0;0;1;0
23770.0;2023;13;POITIERS;FEMININ;SCOLAIRE;BAC PROFESSIONNEL;BAC PRO PROD;BAC PRO AG 21210 COND GEST ENTR CANIN ET FELIN;20;20;19;1;0;0;0;19;0;3;6;4;6;1
23774.0;2023;13;POITIERS;FEMININ;SCOLAIRE;BAC PROFESSIONNEL;BAC PRO PROD;BAC PRO AG 21405 AMENAGEMENTS PAYSAGERS;8;7;5;2;0;0;0;5;0;0;1;1;3;2
23778.0;2023;13;POITIERS;FEMININ;SCOLAIRE;BAC PROFESSIONNEL;BAC PRO SERV;BAC PRO 30004 ASSISTANC.GEST.ORGANIS.ACTIVITES;159;159;120;24;15;9;6;129;0;9;22;47;51;30
23781.0;2023;13;POITIERS;FEMININ;SCOLAIRE;BAC PROFESSIONNEL;BAC PRO SERV;BAC PRO 31114 ORGANIS. TRANSPORT MARCHANDISES;13;12;8;4;0;0;0;8;0;0;3;1;4;4
23787.0;2023;13;POITIERS;FEMININ;SCOLAIRE;BAC PROFESSIONNEL;BAC PRO SERV;BAC PRO 32303 ART.& MET.ART:COM.VIS.VIS.PLURI-M;19;19;19;0;0;0;0;19;0;1;7;5;6;0
23797.0;2023;13;POITIERS;FEMININ;SCOLAIRE;BAC PROFESSIONNEL;BAC PRO SERV;BAC PRO AG 33002 SERV PERS TERRIT;222;219;201;18;0;0;0;201;0;4;23;65;109;18
23799.0;2023;13;POITIERS;FEMININ;SCOLAIRE;BAC TECHNOLOGIQUE;BAC STAV;BAC STAV AGRONOMIE ALIM ENV TERRITOI;89;89;82;7;0;0;0;82;0;2;8;33;39;7
23809.0;2023;13;POITIERS;FEMININ;SCOLAIRE;BAC TECHNOLOGIQUE;BAC STMG;BAC STMG MERCATIQUE (MARKETING);477;477;388;19;70;50;20;438;0;2;54;142;240;39
23812.0;2023;13;POITIERS;MASCULIN;APPRENTISSAGE;BAC PROFESSIONNEL;BAC PRO PROD;BAC PRO 20102 PILOTE DE LIGNE DE PRODUCTION;2;2;2;0;0;0;0;2;0;0;0;2;0;0
23817.0;2023;13;POITIERS;MASCULIN;APPRENTISSAGE;BAC PROFESSIONNEL;BAC PRO PROD;BAC PRO 23102 TRAVAUX PUBLICS;12;12;9;1;2;2;0;11;0;0;2;6;3;1
23822.0;2023;13;POITIERS;MASCULIN;APPRENTISSAGE;BAC PROFESSIONNEL;BAC PRO PROD;BAC PRO 23405 TECHNICIEN MENUISIER AGENCEUR;7;7;7;0;0;0;0;7;0;0;3;2;2;0
23829.0;2023;13;POITIERS;MASCULIN;APPRENTISSAGE;BAC PROFESSIONNEL;BAC PRO PROD;BAC PRO 25219 MAINT.MATERIELS OPT.A AGRICOLES;26;26;22;3;1;0;1;22;0;1;3;8;10;4
23830.0;2023;13;POITIERS;MASCULIN;APPRENTISSAGE;BAC PROFESSIONNEL;BAC PRO PROD;BAC PRO 25220 MAINT.MATERIELS OPT.B TP MANUT.;11;11;10;1;0;0;0;10;0;2;5;2;1;1
23832.0;2023;13;POITIERS;MASCULIN;APPRENTISSAGE;BAC PROFESSIONNEL;BAC PRO PROD;BAC PRO 25304 AERONAUTIQUE OPTION STRUCTURE;12;12;10;2;0;0;0;10;0;0;2;3;5;2
23844.0;2023;13;POITIERS;MASCULIN;APPRENTISSAGE;BAC PROFESSIONNEL;BAC PRO PROD;BAC PRO AG 21302 GEST MILIEUX NATURELS FAUNE;5;5;5;0;0;0;0;5;0;0;1;4;0;0
23845.0;2023;13;POITIERS;MASCULIN;APPRENTISSAGE;BAC PROFESSIONNEL;BAC PRO PROD;BAC PRO AG 21303 FORET;5;5;4;1;0;0;0;4;0;0;0;0;4;1
23846.0;2023;13;POITIERS;MASCULIN;APPRENTISSAGE;BAC PROFESSIONNEL;BAC PRO PROD;BAC PRO AG 21405 AMENAGEMENTS PAYSAGERS;59;56;53;3;0;0;0;53;0;3;10;17;23;3
23848.0;2023;13;POITIERS;MASCULIN;APPRENTISSAGE;BAC PROFESSIONNEL;BAC PRO SERV;BAC PRO 30004 ASSISTANC.GEST.ORGANIS.ACTIVITES;4;4;3;1;0;0;0;3;0;0;2;1;0;1
23851.0;2023;13;POITIERS;MASCULIN;APPRENTISSAGE;BAC PROFESSIONNEL;BAC PRO SERV;BAC PRO 31214 MET.COM.VEN.OP.B PR.CL.VA.OF.COM.;5;5;4;0;1;1;0;5;0;0;0;1;4;0
23853.0;2023;13;POITIERS;MASCULIN;APPRENTISSAGE;BAC PROFESSIONNEL;BAC PRO SERV;BAC PRO 32208 REAL.PR.IMPR.PLURI.OPTB.PR.IMPR.;2;2;2;0;0;0;0;2;0;0;0;1;1;0
23860.0;2023;13;POITIERS;MASCULIN;ENSEIGNEMENT A DISTANCE;BAC GENERAL;BAC GENERAL;BAC GENE 10019 BAC GENERAL;13;13;6;5;2;1;1;7;0;1;2;0;4;6
23861.0;2023;13;POITIERS;MASCULIN;ENSEIGNEMENT A DISTANCE;BAC PROFESSIONNEL;BAC PRO SERV;BAC PRO 31213 MET.COM.VEN.OP.A ANI.GES.ESP.COM.;2;2;0;1;1;1;0;1;0;0;0;0;1;1
23867.0;2023;13;POITIERS;MASCULIN;FORMATION CONTINUE;BAC PROFESSIONNEL;BAC PRO PROD;BAC PRO 23407 TECHNIC.FAB.BOIS ET MATERX ASSOC;1;1;1;0;0;0;0;1;0;1;0;0;0;0
23868.0;2023;13;POITIERS;MASCULIN;INDIVIDUEL;BAC GENERAL;BAC GENERAL;BAC GENE 10019 BAC GENERAL;25;25;3;19;3;2;1;5;0;0;0;1;4;20
23869.0;2023;13;POITIERS;MASCULIN;INDIVIDUEL;BAC PROFESSIONNEL;BAC PRO PROD;BAC PRO 22703 TECHN.INSTALL.SYST.ENERG.CLIMATI;1;0;0;0;0;0;0;0;0;0;0;0;0;0
23878.0;2023;13;POITIERS;MASCULIN;INDIVIDUEL;BAC PROFESSIONNEL;BAC PRO PROD;BAC PRO AG 21001 AGRO-EQUIPEMENT;1;1;1;0;0;0;0;1;0;0;0;0;1;0
23880.0;2023;13;POITIERS;MASCULIN;INDIVIDUEL;BAC PROFESSIONNEL;BAC PRO SERV;BAC PRO 30004 ASSISTANC.GEST.ORGANIS.ACTIVITES;1;0;0;0;0;0;0;0;0;0;0;0;0;0
23890.0;2023;13;POITIERS;MASCULIN;INDIVIDUEL;BAC TECHNOLOGIQUE;BAC STMG;BAC STMG MERCATIQUE (MARKETING);3;3;0;3;0;0;0;0;0;0;0;0;0;3
23895.0;2023;13;POITIERS;MASCULIN;SCOLAIRE;BAC PROFESSIONNEL;BAC PRO PROD;BAC PRO 20102 PILOTE DE LIGNE DE PRODUCTION;19;19;12;2;5;3;2;15;0;0;4;4;7;4
23900.0;2023;13;POITIERS;MASCULIN;SCOLAIRE;BAC PROFESSIONNEL;BAC PRO PROD;BAC PRO 22503 PLASTIQUES ET COMPOSITES;18;18;15;3;0;0;0;15;0;0;2;5;8;3
23913.0;2023;13;POITIERS;MASCULIN;SCOLAIRE;BAC PROFESSIONNEL;BAC PRO PROD;BAC PRO 23407 TECHNIC.FAB.BOIS ET MATERX ASSOC;10;10;10;0;0;0;0;10;0;0;4;2;4;0
23915.0;2023;13;POITIERS;MASCULIN;SCOLAIRE;BAC PROFESSIONNEL;BAC PRO PROD;BAC PRO 24302 METIERS DU CUIR : MAROQUINERIE;2;2;2;0;0;0;0;2;0;0;0;2;0;0
23919.0;2023;13;POITIERS;MASCULIN;SCOLAIRE;BAC PROFESSIONNEL;BAC PRO PROD;BAC PRO 25106 TECHNICIEN D'USINAGE;60;60;49;11;0;0;0;49;0;2;15;16;16;11
23938.0;2023;13;POITIERS;MASCULIN;SCOLAIRE;BAC PROFESSIONNEL;BAC PRO PROD;BAC PRO AG 21004 CGEA;117;116;104;12;0;0;0;104;0;0;14;45;45;12
23972.0;2023;13;POITIERS;MASCULIN;SCOLAIRE;BAC TECHNOLOGIQUE;BAC STAV;BAC STAV AGRONOMIE ALIM ENV TERRITOI;96;96;96;0;0;0;0;96;0;0;12;42;42;0
23977.0;2023;13;POITIERS;MASCULIN;SCOLAIRE;BAC TECHNOLOGIQUE;BAC STI2D;BAC STI2D INNOVATION TECHNO.  ET ECO CONCEPTION;169;169;160;1;8;4;4;164;0;3;34;68;59;5
23978.0;2023;13;POITIERS;MASCULIN;SCOLAIRE;BAC TECHNOLOGIQUE;BAC STI2D;BAC STI2D SYSTÈME D'INFORMATION  ET NUMERIQUE;249;249;235;1;13;7;6;242;0;16;71;92;63;7
23985.0;2023;19;REIMS;FEMININ;APPRENTISSAGE;BAC PROFESSIONNEL;BAC PRO PROD;BAC PRO 20102 PILOTE DE LIGNE DE PRODUCTION;1;1;1;0;0;0;0;1;0;0;1;0;0;0
23987.0;2023;19;REIMS;FEMININ;APPRENTISSAGE;BAC PROFESSIONNEL;BAC PRO PROD;BAC PRO 25007 MAINTENANCE EQUIPEMENTS INDUST.;5;5;2;2;1;1;0;3;0;1;0;0;2;2
23988.0;2023;19;REIMS;FEMININ;APPRENTISSAGE;BAC PROFESSIONNEL;BAC PRO PROD;BAC PRO 25214 MAINT.VEHIC.OPTA VOIT.PARTICUL.;1;1;1;0;0;0;0;1;0;0;0;0;1;0
23992.0;2023;19;REIMS;FEMININ;APPRENTISSAGE;BAC PROFESSIONNEL;BAC PRO PROD;BAC PRO AG 21004 CGEA;10;9;6;3;0;0;0;6;0;0;0;2;4;3
23995.0;2023;19;REIMS;FEMININ;APPRENTISSAGE;BAC PROFESSIONNEL;BAC PRO SERV;BAC PRO 30004 ASSISTANC.GEST.ORGANIS.ACTIVITES;8;8;7;1;0;0;0;7;0;2;2;2;1;1
23996.0;2023;19;REIMS;FEMININ;APPRENTISSAGE;BAC PROFESSIONNEL;BAC PRO SERV;BAC PRO 31106 LOGISTIQUE;1;1;1;0;0;0;0;1;0;0;0;0;1;0
24002.0;2023;19;REIMS;FEMININ;APPRENTISSAGE;BAC PROFESSIONNEL;BAC PRO SERV;BAC PRO AG 33002 SERV PERS TERRIT;11;10;10;0;0;0;0;10;0;0;1;6;3;0
24012.0;2023;19;REIMS;FEMININ;FORMATION CONTINUE;BAC PROFESSIONNEL;BAC PRO PROD;BAC PRO 22106 CUISINE;2;2;2;0;0;0;0;2;0;0;0;1;1;0
24017.0;2023;19;REIMS;FEMININ;INDIVIDUEL;BAC GENERAL;BAC GENERAL;BAC GENE 10019 BAC GENERAL;18;18;8;8;2;1;1;9;0;0;0;2;7;9
24021.0;2023;19;REIMS;FEMININ;INDIVIDUEL;BAC PROFESSIONNEL;BAC PRO PROD;BAC PRO AG 21211 COND GEST ENTR HIPPIQUE;1;1;1;0;0;0;0;1;0;0;0;0;1;0
24028.0;2023;19;REIMS;FEMININ;INDIVIDUEL;BAC TECHNOLOGIQUE;BAC ST2S;BAC ST2S SCIENCES & TECHNO. SANTE & SOCIAL;4;4;1;2;1;0;1;1;0;0;0;0;1;3
24030.0;2023;19;REIMS;FEMININ;INDIVIDUEL;BAC TECHNOLOGIQUE;BAC STMG;BAC STMG GESTION ET FINANCE;4;4;0;3;1;0;1;0;0;0;0;0;0;4
24036.0;2023;19;REIMS;FEMININ;SCOLAIRE;BAC PROFESSIONNEL;BAC PRO PROD;BAC PRO 22105 BOULANGER-PÂTISSIER;7;7;6;1;0;0;0;6;0;2;3;1;0;1
24040.0;2023;19;REIMS;FEMININ;SCOLAIRE;BAC PROFESSIONNEL;BAC PRO PROD;BAC PRO 23005 TECHN. ETUDES BAT B ASSIST.ARCHI.;11;11;10;1;0;0;0;10;0;3;0;5;2;1
24048.0;2023;19;REIMS;FEMININ;SCOLAIRE;BAC PROFESSIONNEL;BAC PRO PROD;BAC PRO 25214 MAINT.VEHIC.OPTA VOIT.PARTICUL.;7;7;6;0;1;1;0;7;0;0;3;1;3;0
24054.0;2023;19;REIMS;FEMININ;SCOLAIRE;BAC PROFESSIONNEL;BAC PRO PROD;BAC PRO AG 21004 CGEA;29;29;21;8;0;0;0;21;0;0;7;3;11;8
24062.0;2023;19;REIMS;FEMININ;SCOLAIRE;BAC PROFESSIONNEL;BAC PRO PROD;BAC PRO AG 22108 TEC CONS VTE ALIMENTATION (PAB);10;10;10;0;0;0;0;10;0;0;2;1;7;0
24063.0;2023;19;REIMS;FEMININ;SCOLAIRE;BAC PROFESSIONNEL;BAC PRO SERV;BAC PRO 30004 ASSISTANC.GEST.ORGANIS.ACTIVITES;178;178;111;50;17;14;3;125;0;4;17;34;70;53
24066.0;2023;19;REIMS;FEMININ;SCOLAIRE;BAC PROFESSIONNEL;BAC PRO SERV;BAC PRO 31114 ORGANIS. TRANSPORT MARCHANDISES;3;3;2;1;0;0;0;2;0;0;0;0;2;1
24078.0;2023;19;REIMS;FEMININ;SCOLAIRE;BAC PROFESSIONNEL;BAC PRO SERV;BAC PRO 33403 COMMERC. SERVICES EN RESTAURATION;31;31;24;5;2;2;0;26;0;1;3;9;13;5
24080.0;2023;19;REIMS;FEMININ;SCOLAIRE;BAC PROFESSIONNEL;BAC PRO SERV;BAC PRO 33604 METIERS DE LA COIFFURE;13;13;12;1;0;0;0;12;0;0;0;7;5;1
24086.0;2023;19;REIMS;FEMININ;SCOLAIRE;BAC TECHNOLOGIQUE;BAC ST2S;BAC ST2S SCIENCES & TECHNO. SANTE & SOCIAL;331;331;268;12;51;36;15;304;1;7;42;101;153;27
24107.0;2023;19;REIMS;MASCULIN;APPRENTISSAGE;BAC PROFESSIONNEL;BAC PRO PROD;BAC PRO 23203 TECHNICIEN BAT. : ORG.REAL.GROS O;1;1;1;0;0;0;0;1;0;0;0;0;1;0
24113.0;2023;19;REIMS;MASCULIN;APPRENTISSAGE;BAC PROFESSIONNEL;BAC PRO PROD;BAC PRO 25106 TECHNICIEN D'USINAGE;14;14;9;5;0;0;0;9;0;0;3;2;4;5
24118.0;2023;19;REIMS;MASCULIN;APPRENTISSAGE;BAC PROFESSIONNEL;BAC PRO PROD;BAC PRO 25219 MAINT.MATERIELS OPT.A AGRICOLES;11;10;3;6;1;1;0;4;0;0;1;2;1;6
24120.0;2023;19;REIMS;MASCULIN;APPRENTISSAGE;BAC PROFESSIONNEL;BAC PRO PROD;BAC PRO 25221 MAINT.MATERIELS OPT.C ESP. VERTS;3;3;0;2;1;1;0;1;0;0;0;0;1;2
24121.0;2023;19;REIMS;MASCULIN;APPRENTISSAGE;BAC PROFESSIONNEL;BAC PRO PROD;BAC PRO 25408 REPARATION DES CARROSSERIES;8;8;6;0;2;2;0;8;0;0;0;2;6;0
24122.0;2023;19;REIMS;MASCULIN;APPRENTISSAGE;BAC PROFESSIONNEL;BAC PRO PROD;BAC PRO 25411 TECH.CHAUDRONNERIE INDUSTRIELLE;24;24;15;5;4;3;1;18;0;2;2;8;6;6
24123.0;2023;19;REIMS;MASCULIN;APPRENTISSAGE;BAC PROFESSIONNEL;BAC PRO PROD;BAC PRO 25509 TECHNIC. FROID CONDITIONNEMT AIR;2;2;0;2;0;0;0;0;0;0;0;0;0;2
24126.0;2023;19;REIMS;MASCULIN;APPRENTISSAGE;BAC PROFESSIONNEL;BAC PRO PROD;BAC PRO 25515 SYST.NUM.OPT.C RES.INF.SYST.COMM.;2;2;2;0;0;0;0;2;0;0;1;1;0;0
24128.0;2023;19;REIMS;MASCULIN;APPRENTISSAGE;BAC PROFESSIONNEL;BAC PRO PROD;BAC PRO AG 21004 CGEA;31;29;18;11;0;0;0;18;0;1;1;4;12;11
24133.0;2023;19;REIMS;MASCULIN;APPRENTISSAGE;BAC PROFESSIONNEL;BAC PRO SERV;BAC PRO 31106 LOGISTIQUE;6;6;5;0;1;1;0;6;0;0;2;0;4;0
24140.0;2023;19;REIMS;MASCULIN;ENSEIGNEMENT A DISTANCE;BAC PROFESSIONNEL;BAC PRO SERV;BAC PRO 30004 ASSISTANC.GEST.ORGANIS.ACTIVITES;1;1;1;0;0;0;0;1;0;0;0;0;1;0
24142.0;2023;19;REIMS;MASCULIN;ENSEIGNEMENT A DISTANCE;BAC TECHNOLOGIQUE;BAC STMG;BAC STMG GESTION ET FINANCE;2;2;1;1;0;0;0;1;0;0;0;1;0;1
24145.0;2023;19;REIMS;MASCULIN;FORMATION CONTINUE;BAC PROFESSIONNEL;BAC PRO PROD;BAC PRO 22703 TECHN.INSTALL.SYST.ENERG.CLIMATI;2;2;2;0;0;0;0;2;0;1;1;0;0;0
24165.0;2023;19;REIMS;MASCULIN;INDIVIDUEL;BAC TECHNOLOGIQUE;BAC STMG;BAC STMG MERCATIQUE (MARKETING);11;11;5;4;2;1;1;6;0;0;0;1;5;5
24168.0;2023;19;REIMS;MASCULIN;SCOLAIRE;BAC PROFESSIONNEL;BAC PRO PROD;BACPRO 20002 ETUD.DEFINITION PRDTS INDUSTRIEL;12;12;10;1;1;1;0;11;0;0;2;3;6;1
24171.0;2023;19;REIMS;MASCULIN;SCOLAIRE;BAC PROFESSIONNEL;BAC PRO PROD;BAC PRO 22105 BOULANGER-PÂTISSIER;9;9;8;1;0;0;0;8;0;0;1;5;2;1
24180.0;2023;19;REIMS;MASCULIN;SCOLAIRE;BAC PROFESSIONNEL;BAC PRO PROD;BAC PRO 23102 TRAVAUX PUBLICS;22;22;16;6;0;0;0;16;0;1;6;7;2;6
24181.0;2023;19;REIMS;MASCULIN;SCOLAIRE;BAC PROFESSIONNEL;BAC PRO PROD;BACPRO 23103 TECHNICIEN GEOMETRE-TOPOGRAPHE;7;7;4;3;0;0;0;4;0;0;1;2;1;3
24187.0;2023;19;REIMS;MASCULIN;SCOLAIRE;BAC PROFESSIONNEL;BAC PRO PROD;BAC PRO 23408 Etude et réalisation d'agencement;8;8;7;1;0;0;0;7;0;0;2;4;1;1
24192.0;2023;19;REIMS;MASCULIN;SCOLAIRE;BAC PROFESSIONNEL;BAC PRO PROD;BAC PRO 25215 MAINT.VEHIC.OPTB VEHIC.TRANS.ROUT;13;13;8;3;2;2;0;10;0;0;2;5;3;3
24193.0;2023;19;REIMS;MASCULIN;SCOLAIRE;BAC PROFESSIONNEL;BAC PRO PROD;BAC PRO 25216 MAINT.VEHIC.OPTC MOTOCYCLES;9;9;9;0;0;0;0;9;0;3;2;2;2;0
24197.0;2023;19;REIMS;MASCULIN;SCOLAIRE;BAC PROFESSIONNEL;BAC PRO PROD;BAC PRO 25411 TECH.CHAUDRONNERIE INDUSTRIELLE;24;24;18;6;0;0;0;18;0;0;2;6;10;6
24215.0;2023;19;REIMS;MASCULIN;SCOLAIRE;BAC PROFESSIONNEL;BAC PRO SERV;BAC PRO 31107 CONDUCT. TRANSP.ROUT.MARCHANDISES;58;58;50;5;3;2;1;52;0;3;16;23;10;6
24216.0;2023;19;REIMS;MASCULIN;SCOLAIRE;BAC PROFESSIONNEL;BAC PRO SERV;BAC PRO 31114 ORGANIS. TRANSPORT MARCHANDISES;15;15;7;8;0;0;0;7;0;0;1;3;3;8
24220.0;2023;19;REIMS;MASCULIN;SCOLAIRE;BAC PROFESSIONNEL;BAC PRO SERV;BAC PRO 32207 REAL.PR.IMPR.PLURI.OPTA.PR.GRAPH.;14;14;12;1;1;1;0;13;0;2;3;6;2;1
24221.0;2023;19;REIMS;MASCULIN;SCOLAIRE;BAC PROFESSIONNEL;BAC PRO SERV;BAC PRO 32208 REAL.PR.IMPR.PLURI.OPTB.PR.IMPR.;7;7;7;0;0;0;0;7;0;0;1;2;4;0
24225.0;2023;19;REIMS;MASCULIN;SCOLAIRE;BAC PROFESSIONNEL;BAC PRO SERV;BAC PRO 33004 ACC.SOINS-S.PERS. OPT.EN STRUCTUR;20;20;17;2;1;1;0;18;0;0;5;7;6;2
24234.0;2023;19;REIMS;MASCULIN;SCOLAIRE;BAC TECHNOLOGIQUE;BAC S2TMD;BAC S2TMD MUSIQUE;2;2;2;0;0;0;0;2;1;1;0;0;0;0
24240.0;2023;19;REIMS;MASCULIN;SCOLAIRE;BAC TECHNOLOGIQUE;BAC STI2D;BAC STI2D ENERGIES  ET ENVIRONNEMENT;90;90;67;3;20;12;8;79;0;1;13;16;49;11
24254.0;2023;14;RENNES;FEMININ;APPRENTISSAGE;BAC PROFESSIONNEL;BAC PRO PROD;BAC PRO 23304 AMENAGEMENT FINITION BATIMENT;2;2;1;1;0;0;0;1;0;0;1;0;0;1
24255.0;2023;14;RENNES;FEMININ;APPRENTISSAGE;BAC PROFESSIONNEL;BAC PRO PROD;BAC PRO 23405 TECHNICIEN MENUISIER AGENCEUR;2;2;2;0;0;0;0;2;0;1;1;0;0;0
24260.0;2023;14;RENNES;FEMININ;APPRENTISSAGE;BAC PROFESSIONNEL;BAC PRO PROD;BAC PRO 25215 MAINT.VEHIC.OPTB VEHIC.TRANS.ROUT;1;1;1;0;0;0;0;1;0;0;1;0;0;0
24265.0;2023;14;RENNES;FEMININ;APPRENTISSAGE;BAC PROFESSIONNEL;BAC PRO PROD;BAC PRO 25510 METIERS ELECT. ENVIRON. CONNECTES;4;4;2;1;1;0;1;2;0;1;1;0;0;2
24275.0;2023;14;RENNES;FEMININ;APPRENTISSAGE;BAC PROFESSIONNEL;BAC PRO SERV;BAC PRO 31209 POISSONIER ECAILLER TRAITEUR;1;1;1;0;0;0;0;1;0;0;0;1;0;0
24276.0;2023;14;RENNES;FEMININ;APPRENTISSAGE;BAC PROFESSIONNEL;BAC PRO SERV;BAC PRO 31212 METIERS DE L'ACCUEIL;1;1;1;0;0;0;0;1;0;1;0;0;0;0
24291.0;2023;14;RENNES;FEMININ;FORMATION CONTINUE;BAC PROFESSIONNEL;BAC PRO PROD;BAC PRO 25303 AERONAUTIQUE OPTION SYSTEMES;2;2;2;0;0;0;0;2;0;1;0;1;0;0
24293.0;2023;14;RENNES;FEMININ;INDIVIDUEL;BAC GENERAL;BAC GENERAL;BAC GENE 10019 BAC GENERAL;85;83;51;19;13;4;9;55;1;5;15;18;16;28
24294.0;2023;14;RENNES;FEMININ;INDIVIDUEL;BAC PROFESSIONNEL;BAC PRO PROD;BAC PRO AG 21004 CGEA;4;3;2;1;0;0;0;2;0;0;0;0;2;1
24297.0;2023;14;RENNES;FEMININ;INDIVIDUEL;BAC PROFESSIONNEL;BAC PRO PROD;BAC PRO AG 21405 AMENAGEMENTS PAYSAGERS;1;1;0;1;0;0;0;0;0;0;0;0;0;1
24298.0;2023;14;RENNES;FEMININ;INDIVIDUEL;BAC PROFESSIONNEL;BAC PRO PROD;BAC PRO AG 22108 TEC CONS VTE ALIMENTATION (PAB);1;0;0;0;0;0;0;0;0;0;0;0;0;0
24300.0;2023;14;RENNES;FEMININ;INDIVIDUEL;BAC PROFESSIONNEL;BAC PRO SERV;BAC PRO 31212 METIERS DE L'ACCUEIL;3;1;1;0;0;0;0;1;0;0;0;0;1;0
24301.0;2023;14;RENNES;FEMININ;INDIVIDUEL;BAC PROFESSIONNEL;BAC PRO SERV;BAC PRO 31213 MET.COM.VEN.OP.A ANI.GES.ESP.COM.;9;6;5;0;1;0;1;5;0;0;0;1;4;1
24302.0;2023;14;RENNES;FEMININ;INDIVIDUEL;BAC PROFESSIONNEL;BAC PRO SERV;BAC PRO 31214 MET.COM.VEN.OP.B PR.CL.VA.OF.COM.;2;1;0;1;0;0;0;0;0;0;0;0;0;1
24310.0;2023;14;RENNES;FEMININ;INDIVIDUEL;BAC TECHNOLOGIQUE;BAC STMG;BAC STMG RESSOURCES HUMAINES ET COMMUNICATION;7;6;1;5;0;0;0;1;0;0;0;0;1;5
24315.0;2023;14;RENNES;FEMININ;SCOLAIRE;BAC PROFESSIONNEL;BAC PRO PROD;BAC PRO 22503 PLASTIQUES ET COMPOSITES;3;3;3;0;0;0;0;3;0;1;1;0;1;0
24319.0;2023;14;RENNES;FEMININ;SCOLAIRE;BAC PROFESSIONNEL;BAC PRO PROD;BAC PRO 23005 TECHN. ETUDES BAT B ASSIST.ARCHI.;26;26;22;3;1;1;0;23;0;4;11;3;5;3
24325.0;2023;14;RENNES;FEMININ;SCOLAIRE;BAC PROFESSIONNEL;BAC PRO PROD;BAC PRO 23408 Etude et réalisation d'agencement;22;22;21;1;0;0;0;21;0;2;4;11;4;1
24332.0;2023;14;RENNES;FEMININ;SCOLAIRE;BAC PROFESSIONNEL;BAC PRO PROD;BAC PRO 25214 MAINT.VEHIC.OPTA VOIT.PARTICUL.;14;14;10;4;0;0;0;10;0;0;2;6;2;4
24335.0;2023;14;RENNES;FEMININ;SCOLAIRE;BAC PROFESSIONNEL;BAC PRO PROD;BAC PRO 25303 AERONAUTIQUE OPTION SYSTEMES;5;5;5;0;0;0;0;5;0;0;1;3;1;0
24338.0;2023;14;RENNES;FEMININ;SCOLAIRE;BAC PROFESSIONNEL;BAC PRO PROD;BAC PRO 25411 TECH.CHAUDRONNERIE INDUSTRIELLE;3;3;3;0;0;0;0;3;0;0;2;1;0;0
24340.0;2023;14;RENNES;FEMININ;SCOLAIRE;BAC PROFESSIONNEL;BAC PRO PROD;BAC PRO 25510 METIERS ELECT. ENVIRON. CONNECTES;11;10;10;0;0;0;0;10;0;1;2;5;2;0
24341.0;2023;14;RENNES;FEMININ;SCOLAIRE;BAC PROFESSIONNEL;BAC PRO PROD;BAC PRO 25513 SYST.NUM.OPT.A SURETE SECURITE;2;2;2;0;0;0;0;2;0;0;1;1;0;0
24342.0;2023;14;RENNES;FEMININ;SCOLAIRE;BAC PROFESSIONNEL;BAC PRO PROD;BAC PRO 25514 SYST.NUM.OPT.B AUD.RES.EQUIP.DOM.;5;5;5;0;0;0;0;5;0;1;1;1;2;0
24344.0;2023;14;RENNES;FEMININ;SCOLAIRE;BAC PROFESSIONNEL;BAC PRO PROD;BAC PRO AG 21001 AGRO-EQUIPEMENT;2;2;2;0;0;0;0;2;0;0;1;0;1;0
24348.0;2023;14;RENNES;FEMININ;SCOLAIRE;BAC PROFESSIONNEL;BAC PRO PROD;BAC PRO AG 21204 PROD-AQUACOLES;2;2;2;0;0;0;0;2;0;0;0;0;2;0
24352.0;2023;14;RENNES;FEMININ;SCOLAIRE;BAC PROFESSIONNEL;BAC PRO PROD;BAC PRO AG 21405 AMENAGEMENTS PAYSAGERS;13;13;9;4;0;0;0;9;0;0;2;1;6;4
24357.0;2023;14;RENNES;FEMININ;SCOLAIRE;BAC PROFESSIONNEL;BAC PRO SERV;BAC PRO 31106 LOGISTIQUE;21;20;14;4;2;1;1;15;0;0;2;7;6;5
24361.0;2023;14;RENNES;FEMININ;SCOLAIRE;BAC PROFESSIONNEL;BAC PRO SERV;BAC PRO 31213 MET.COM.VEN.OP.A ANI.GES.ESP.COM.;554;554;479;35;40;30;10;509;0;22;105;198;184;45
24373.0;2023;14;RENNES;FEMININ;SCOLAIRE;BAC PROFESSIONNEL;BAC PRO SERV;BAC PRO 34303 GEST. POLLUTIONS PROTEC. ENVIRON.;1;1;1;0;0;0;0;1;0;0;0;0;1;0
24375.0;2023;14;RENNES;FEMININ;SCOLAIRE;BAC PROFESSIONNEL;BAC PRO SERV;BAC PRO 34403 METIERS DE LA SECURITE;28;28;27;0;1;1;0;28;0;2;10;13;3;0
24390.0;2023;14;RENNES;FEMININ;SCOLAIRE;BAC TECHNOLOGIQUE;BAC STMG;BAC STMG GESTION ET FINANCE;434;434;394;3;37;25;12;419;0;11;66;175;167;15
24406.0;2023;14;RENNES;MASCULIN;APPRENTISSAGE;BAC PROFESSIONNEL;BAC PRO PROD;BAC PRO 25009 MAINTENANCE NAUTIQUE;12;12;12;0;0;0;0;12;0;0;1;5;6;0
24410.0;2023;14;RENNES;MASCULIN;APPRENTISSAGE;BAC PROFESSIONNEL;BAC PRO PROD;BAC PRO 25215 MAINT.VEHIC.OPTB VEHIC.TRANS.ROUT;28;28;26;2;0;0;0;26;0;3;6;7;10;2
24412.0;2023;14;RENNES;MASCULIN;APPRENTISSAGE;BAC PROFESSIONNEL;BAC PRO PROD;BAC PRO 25219 MAINT.MATERIELS OPT.A AGRICOLES;28;28;26;1;1;0;1;26;0;0;8;9;9;2
24415.0;2023;14;RENNES;MASCULIN;APPRENTISSAGE;BAC PROFESSIONNEL;BAC PRO PROD;BAC PRO 25406 OUVRAGES DU BATIMENT METALLERIE;2;2;2;0;0;0;0;2;0;1;0;1;0;0
24420.0;2023;14;RENNES;MASCULIN;APPRENTISSAGE;BAC PROFESSIONNEL;BAC PRO PROD;BAC PRO 25515 SYST.NUM.OPT.C RES.INF.SYST.COMM.;12;12;10;1;1;1;0;11;0;2;3;3;3;1
24429.0;2023;14;RENNES;MASCULIN;APPRENTISSAGE;BAC PROFESSIONNEL;BAC PRO SERV;BAC PRO 31106 LOGISTIQUE;27;26;21;4;1;1;0;22;0;3;3;2;14;4
24433.0;2023;14;RENNES;MASCULIN;APPRENTISSAGE;BAC PROFESSIONNEL;BAC PRO SERV;BAC PRO 33403 COMMERC. SERVICES EN RESTAURATION;15;15;12;1;2;0;2;12;0;0;3;2;7;3
24439.0;2023;14;RENNES;MASCULIN;ENSEIGNEMENT A DISTANCE;BAC PROFESSIONNEL;BAC PRO SERV;BAC PRO 31214 MET.COM.VEN.OP.B PR.CL.VA.OF.COM.;1;0;0;0;0;0;0;0;0;0;0;0;0;0
24444.0;2023;14;RENNES;MASCULIN;FORMATION CONTINUE;BAC PROFESSIONNEL;BAC PRO PROD;BAC PRO 25007 MAINTENANCE EQUIPEMENTS INDUST.;1;1;1;0;0;0;0;1;0;1;0;0;0;0
24451.0;2023;14;RENNES;MASCULIN;INDIVIDUEL;BAC PROFESSIONNEL;BAC PRO PROD;BAC PRO 25009 MAINTENANCE NAUTIQUE;1;0;0;0;0;0;0;0;0;0;0;0;0;0
24452.0;2023;14;RENNES;MASCULIN;INDIVIDUEL;BAC PROFESSIONNEL;BAC PRO PROD;BAC PRO 25214 MAINT.VEHIC.OPTA VOIT.PARTICUL.;2;1;0;1;0;0;0;0;0;0;0;0;0;1
24461.0;2023;14;RENNES;MASCULIN;INDIVIDUEL;BAC PROFESSIONNEL;BAC PRO PROD;BAC PRO AG 21211 COND GEST ENTR HIPPIQUE;2;2;2;0;0;0;0;2;0;0;0;0;2;0
24468.0;2023;14;RENNES;MASCULIN;INDIVIDUEL;BAC PROFESSIONNEL;BAC PRO SERV;BAC PRO AG 33002 SERV PERS TERRIT;1;0;0;0;0;0;0;0;0;0;0;0;0;0
24474.0;2023;14;RENNES;MASCULIN;SCOLAIRE;BAC GENERAL;BAC GENERAL;BAC GENE 10019 BAC GENERAL;7996;7996;7602;60;334;258;76;7860;102;872;1891;2741;2254;136
24477.0;2023;14;RENNES;MASCULIN;SCOLAIRE;BAC PROFESSIONNEL;BAC PRO PROD;BAC PRO 22106 CUISINE;176;176;162;7;7;5;2;167;0;10;33;77;47;9
24485.0;2023;14;RENNES;MASCULIN;SCOLAIRE;BAC PROFESSIONNEL;BAC PRO PROD;BAC PRO 23102 TRAVAUX PUBLICS;22;22;20;2;0;0;0;20;0;0;5;11;4;2
24490.0;2023;14;RENNES;MASCULIN;SCOLAIRE;BAC PROFESSIONNEL;BAC PRO PROD;BAC PRO 23404 TECHNICIEN CONSTRUCTEUR BOIS;91;91;73;15;3;2;1;75;0;2;15;27;31;16
24505.0;2023;14;RENNES;MASCULIN;SCOLAIRE;BAC PROFESSIONNEL;BAC PRO PROD;BAC PRO 25219 MAINT.MATERIELS OPT.A AGRICOLES;38;38;32;3;3;2;1;34;0;1;6;18;9;4
24516.0;2023;14;RENNES;MASCULIN;SCOLAIRE;BAC PROFESSIONNEL;BAC PRO PROD;BAC PRO 25513 SYST.NUM.OPT.A SURETE SECURITE;81;81;74;5;2;2;0;76;0;4;17;30;25;5
24535.0;2023;14;RENNES;MASCULIN;SCOLAIRE;BAC PROFESSIONNEL;BAC PRO SERV;BAC PRO 31114 ORGANIS. TRANSPORT MARCHANDISES;8;8;5;3;0;0;0;5;0;0;0;3;2;3
24536.0;2023;14;RENNES;MASCULIN;SCOLAIRE;BAC PROFESSIONNEL;BAC PRO SERV;BAC PRO 31212 METIERS DE L'ACCUEIL;66;66;46;12;8;6;2;52;0;2;7;20;23;14
24540.0;2023;14;RENNES;MASCULIN;SCOLAIRE;BAC PROFESSIONNEL;BAC PRO SERV;BAC PRO 32208 REAL.PR.IMPR.PLURI.OPTB.PR.IMPR.;11;11;8;2;1;1;0;9;0;0;4;3;2;2
24544.0;2023;14;RENNES;MASCULIN;SCOLAIRE;BAC PROFESSIONNEL;BAC PRO SERV;BAC PRO 33006 ANIMAT. ENFANCE& PERSONNES AGEES;45;45;41;3;1;1;0;42;0;2;10;17;13;3
24553.0;2023;14;RENNES;MASCULIN;SCOLAIRE;BAC TECHNOLOGIQUE;BAC S2TMD;BAC S2TMD THEATRE;2;2;2;0;0;0;0;2;0;1;0;1;0;0
24556.0;2023;14;RENNES;MASCULIN;SCOLAIRE;BAC TECHNOLOGIQUE;BAC STD2A;BAC STD2A SCIENCES & TECHNO. DESIGN-ARTS APPLIQUES;29;29;28;0;1;0;1;28;0;2;9;10;7;1
24557.0;2023;14;RENNES;MASCULIN;SCOLAIRE;BAC TECHNOLOGIQUE;BAC STHR;BAC STHR SC.&TEC. HOTELLERIE-RESTAURATION;34;34;33;0;1;1;0;34;0;1;7;19;7;0
24561.0;2023;14;RENNES;MASCULIN;SCOLAIRE;BAC TECHNOLOGIQUE;BAC STI2D;BAC STI2D SYSTÈME D'INFORMATION  ET NUMERIQUE;439;439;406;6;27;13;14;419;0;14;110;182;113;20
24562.0;2023;14;RENNES;MASCULIN;SCOLAIRE;BAC TECHNOLOGIQUE;BAC STL;BAC STL BIOCHIM.-BIOLOGIE-BIOTECHNOL.;58;58;51;0;7;2;5;53;0;4;10;18;21;5
24565.0;2023;14;RENNES;MASCULIN;SCOLAIRE;BAC TECHNOLOGIQUE;BAC STMG;BAC STMG MERCATIQUE (MARKETING);1146;1146;930;36;180;123;57;1053;0;3;56;305;689;93
24568.0;2023;15;STRASBOURG;FEMININ;APPRENTISSAGE;BAC PROFESSIONNEL;BAC PRO PROD;ART.MET.ART-FACT.ORG. OPT.TUYAUT.;1;1;1;0;0;0;0;1;0;0;1;0;0;0
24584.0;2023;15;STRASBOURG;FEMININ;APPRENTISSAGE;BAC PROFESSIONNEL;BAC PRO PROD;BAC PRO AG 21211 COND GEST ENTR HIPPIQUE;15;14;11;3;0;0;0;11;0;0;1;4;6;3
24586.0;2023;15;STRASBOURG;FEMININ;APPRENTISSAGE;BAC PROFESSIONNEL;BAC PRO SERV;BAC PRO 30004 ASSISTANC.GEST.ORGANIS.ACTIVITES;13;13;9;4;0;0;0;9;0;3;2;3;1;4
24589.0;2023;15;STRASBOURG;FEMININ;APPRENTISSAGE;BAC PROFESSIONNEL;BAC PRO SERV;BAC PRO 31213 MET.COM.VEN.OP.A ANI.GES.ESP.COM.;104;103;86;10;7;6;1;92;0;5;20;30;37;11
24590.0;2023;15;STRASBOURG;FEMININ;APPRENTISSAGE;BAC PROFESSIONNEL;BAC PRO SERV;BAC PRO 32207 REAL.PR.IMPR.PLURI.OPTA.PR.GRAPH.;1;1;1;0;0;0;0;1;0;0;0;1;0;0
24594.0;2023;15;STRASBOURG;FEMININ;APPRENTISSAGE;BAC PROFESSIONNEL;BAC PRO SERV;BAC PRO 33603 ESTHETIQUE COSMETIQUE PARFUMERIE;12;11;9;2;0;0;0;9;0;0;2;2;5;2
24605.0;2023;15;STRASBOURG;FEMININ;FORMATION CONTINUE;BAC PROFESSIONNEL;BAC PRO PROD;BAC PRO 25411 TECH.CHAUDRONNERIE INDUSTRIELLE;1;1;1;0;0;0;0;1;0;0;1;0;0;0
24607.0;2023;15;STRASBOURG;FEMININ;FORMATION CONTINUE;BAC PROFESSIONNEL;BAC PRO SERV;BAC PRO 31213 MET.COM.VEN.OP.A ANI.GES.ESP.COM.;2;1;1;0;0;0;0;1;0;0;0;0;1;0
24617.0;2023;15;STRASBOURG;FEMININ;INDIVIDUEL;BAC PROFESSIONNEL;BAC PRO SERV;BAC PRO 33002 SERVICES DE PROXIMITE  VIE LOCAL;1;1;0;0;1;1;0;1;0;0;0;0;1;0
24623.0;2023;15;STRASBOURG;FEMININ;INDIVIDUEL;BAC TECHNOLOGIQUE;BAC STI2D;BAC STI2D INNOVATION TECHNO.  ET ECO CONCEPTION;1;1;0;1;0;0;0;0;0;0;0;0;0;1
24624.0;2023;15;STRASBOURG;FEMININ;INDIVIDUEL;BAC TECHNOLOGIQUE;BAC STL;BAC STL BIOCHIM.-BIOLOGIE-BIOTECHNOL.;1;1;0;1;0;0;0;0;0;0;0;0;0;1
24628.0;2023;15;STRASBOURG;FEMININ;SCOLAIRE;BAC PROFESSIONNEL;BAC PRO PROD;BAC PRO 22003 BIO-INDUSTRIES DE TRANSFORMATION;21;21;11;10;0;0;0;11;0;0;0;6;5;10
24631.0;2023;15;STRASBOURG;FEMININ;SCOLAIRE;BAC PROFESSIONNEL;BAC PRO PROD;BAC PRO 22106 CUISINE;36;36;27;8;1;0;1;27;0;5;7;10;5;9
24633.0;2023;15;STRASBOURG;FEMININ;SCOLAIRE;BAC PROFESSIONNEL;BAC PRO PROD;BAC PRO 22704 TECHN. MAINT. SYST.ENERG.CLIMATI;1;1;1;0;0;0;0;1;0;0;0;0;1;0
24634.0;2023;15;STRASBOURG;FEMININ;SCOLAIRE;BAC PROFESSIONNEL;BAC PRO PROD;BAC PRO 23004 TECHN. ETUDES BAT.A ETUDES & ECO.;6;6;4;2;0;0;0;4;0;0;2;1;1;2
24647.0;2023;15;STRASBOURG;FEMININ;SCOLAIRE;BAC PROFESSIONNEL;BAC PRO PROD;BAC PRO 25510 METIERS ELECT. ENVIRON. CONNECTES;3;3;2;1;0;0;0;2;0;0;0;2;0;1
24663.0;2023;15;STRASBOURG;FEMININ;SCOLAIRE;BAC PROFESSIONNEL;BAC PRO SERV;BAC PRO 31214 MET.COM.VEN.OP.B PR.CL.VA.OF.COM.;61;61;53;4;4;2;2;55;0;3;15;21;16;6
24666.0;2023;15;STRASBOURG;FEMININ;SCOLAIRE;BAC PROFESSIONNEL;BAC PRO SERV;BAC PRO 32303 ART.& MET.ART:COM.VIS.VIS.PLURI-M;12;12;10;2;0;0;0;10;0;0;6;2;2;2
24672.0;2023;15;STRASBOURG;FEMININ;SCOLAIRE;BAC PROFESSIONNEL;BAC PRO SERV;BAC PRO 33603 ESTHETIQUE COSMETIQUE PARFUMERIE;77;75;60;12;3;1;2;61;0;5;6;27;23;14
24674.0;2023;15;STRASBOURG;FEMININ;SCOLAIRE;BAC PROFESSIONNEL;BAC PRO SERV;BAC PRO 34304 HYGIENE PROPRETE STERILISATION;15;15;10;3;2;0;2;10;0;0;1;4;5;5
24679.0;2023;15;STRASBOURG;FEMININ;SCOLAIRE;BAC TECHNOLOGIQUE;BAC STD2A;BAC STD2A SCIENCES & TECHNO. DESIGN-ARTS APPLIQUES;80;80;80;0;0;0;0;80;0;15;35;27;3;0
24682.0;2023;15;STRASBOURG;FEMININ;SCOLAIRE;BAC TECHNOLOGIQUE;BAC STI2D;BAC STI2D ENERGIES  ET ENVIRONNEMENT;7;7;5;0;2;2;0;7;0;0;0;2;5;0
24689.0;2023;15;STRASBOURG;FEMININ;SCOLAIRE;BAC TECHNOLOGIQUE;BAC STMG;BAC STMG RESSOURCES HUMAINES ET COMMUNICATION;380;380;282;14;84;55;29;337;0;3;36;97;201;43
24703.0;2023;15;STRASBOURG;MASCULIN;APPRENTISSAGE;BAC PROFESSIONNEL;BAC PRO PROD;BAC PRO 23407 TECHNIC.FAB.BOIS ET MATERX ASSOC;12;12;9;2;1;1;0;10;0;2;3;1;4;2
24704.0;2023;15;STRASBOURG;MASCULIN;APPRENTISSAGE;BAC PROFESSIONNEL;BAC PRO PROD;BAC PRO 25006 MICROTECHNIQUES;2;2;2;0;0;0;0;2;0;0;1;1;0;0
24712.0;2023;15;STRASBOURG;MASCULIN;APPRENTISSAGE;BAC PROFESSIONNEL;BAC PRO PROD;BAC PRO 25220 MAINT.MATERIELS OPT.B TP MANUT.;8;8;5;3;0;0;0;5;0;2;2;0;1;3
24714.0;2023;15;STRASBOURG;MASCULIN;APPRENTISSAGE;BAC PROFESSIONNEL;BAC PRO PROD;BAC PRO 25406 OUVRAGES DU BATIMENT METALLERIE;9;9;7;1;1;0;1;7;0;0;4;2;1;2
24716.0;2023;15;STRASBOURG;MASCULIN;APPRENTISSAGE;BAC PROFESSIONNEL;BAC PRO PROD;BAC PRO 25410 CONSTRUCTION DES CARROSSERIES;1;1;1;0;0;0;0;1;0;0;0;1;0;0
24717.0;2023;15;STRASBOURG;MASCULIN;APPRENTISSAGE;BAC PROFESSIONNEL;BAC PRO PROD;BAC PRO 25411 TECH.CHAUDRONNERIE INDUSTRIELLE;64;64;59;4;1;1;0;60;0;5;21;16;18;4
24728.0;2023;15;STRASBOURG;MASCULIN;APPRENTISSAGE;BAC PROFESSIONNEL;BAC PRO PROD;BAC PRO AG 21405 AMENAGEMENTS PAYSAGERS;75;75;71;4;0;0;0;71;0;0;10;28;33;4
24733.0;2023;15;STRASBOURG;MASCULIN;APPRENTISSAGE;BAC PROFESSIONNEL;BAC PRO SERV;BAC PRO 31213 MET.COM.VEN.OP.A ANI.GES.ESP.COM.;71;70;51;13;6;4;2;55;0;1;10;19;25;15
24734.0;2023;15;STRASBOURG;MASCULIN;APPRENTISSAGE;BAC PROFESSIONNEL;BAC PRO SERV;BAC PRO 31214 MET.COM.VEN.OP.B PR.CL.VA.OF.COM.;4;4;4;0;0;0;0;4;0;0;2;2;0;0
24738.0;2023;15;STRASBOURG;MASCULIN;ENSEIGNEMENT A DISTANCE;BAC GENERAL;BAC GENERAL;BAC GENE 10019 BAC GENERAL;14;14;9;4;1;0;1;9;0;1;2;2;4;5
24740.0;2023;15;STRASBOURG;MASCULIN;ENSEIGNEMENT A DISTANCE;BAC PROFESSIONNEL;BAC PRO SERV;BAC PRO 31213 MET.COM.VEN.OP.A ANI.GES.ESP.COM.;2;0;0;0;0;0;0;0;0;0;0;0;0;0
24744.0;2023;15;STRASBOURG;MASCULIN;FORMATION CONTINUE;BAC PROFESSIONNEL;BAC PRO PROD;BAC PRO 22106 CUISINE;1;1;1;0;0;0;0;1;0;1;0;0;0;0
24753.0;2023;15;STRASBOURG;MASCULIN;FORMATION CONTINUE;BAC PROFESSIONNEL;BAC PRO PROD;BAC PRO 25408 REPARATION DES CARROSSERIES;3;2;1;1;0;0;0;1;0;0;0;1;0;1
24762.0;2023;15;STRASBOURG;MASCULIN;INDIVIDUEL;BAC PROFESSIONNEL;BAC PRO PROD;BAC PRO 25007 MAINTENANCE EQUIPEMENTS INDUST.;1;1;0;1;0;0;0;0;0;0;0;0;0;1
24763.0;2023;15;STRASBOURG;MASCULIN;INDIVIDUEL;BAC PROFESSIONNEL;BAC PRO PROD;BAC PRO 25219 MAINT.MATERIELS OPT.A AGRICOLES;1;1;1;0;0;0;0;1;0;1;0;0;0;0
24765.0;2023;15;STRASBOURG;MASCULIN;INDIVIDUEL;BAC PROFESSIONNEL;BAC PRO PROD;BAC PRO 25411 TECH.CHAUDRONNERIE INDUSTRIELLE;1;0;0;0;0;0;0;0;0;0;0;0;0;0
24766.0;2023;15;STRASBOURG;MASCULIN;INDIVIDUEL;BAC PROFESSIONNEL;BAC PRO PROD;BAC PRO 25510 METIERS ELECT. ENVIRON. CONNECTES;14;8;5;2;1;0;1;5;0;0;3;0;2;3
24771.0;2023;15;STRASBOURG;MASCULIN;INDIVIDUEL;BAC PROFESSIONNEL;BAC PRO SERV;BAC PRO 31106 LOGISTIQUE;1;0;0;0;0;0;0;0;0;0;0;0;0;0
24774.0;2023;15;STRASBOURG;MASCULIN;INDIVIDUEL;BAC PROFESSIONNEL;BAC PRO SERV;BAC PRO 31213 MET.COM.VEN.OP.A ANI.GES.ESP.COM.;5;3;1;1;1;1;0;2;0;0;0;1;1;1
24779.0;2023;15;STRASBOURG;MASCULIN;INDIVIDUEL;BAC TECHNOLOGIQUE;BAC STI2D;BAC STI2D INNOVATION TECHNO.  ET ECO CONCEPTION;3;3;0;3;0;0;0;0;0;0;0;0;0;3
24781.0;2023;15;STRASBOURG;MASCULIN;INDIVIDUEL;BAC TECHNOLOGIQUE;BAC STMG;BAC STMG MERCATIQUE (MARKETING);8;8;5;2;1;1;0;6;0;0;1;0;5;2
24782.0;2023;15;STRASBOURG;MASCULIN;INDIVIDUEL;BAC TECHNOLOGIQUE;BAC STMG;BAC STMG RESSOURCES HUMAINES ET COMMUNICATION;1;1;0;1;0;0;0;0;0;0;0;0;0;1
24791.0;2023;15;STRASBOURG;MASCULIN;SCOLAIRE;BAC PROFESSIONNEL;BAC PRO PROD;BAC PRO 23004 TECHN. ETUDES BAT.A ETUDES & ECO.;27;27;15;12;0;0;0;15;0;0;2;7;6;12
24793.0;2023;15;STRASBOURG;MASCULIN;SCOLAIRE;BAC PROFESSIONNEL;BAC PRO PROD;BAC PRO 23102 TRAVAUX PUBLICS;8;8;7;1;0;0;0;7;0;0;3;2;2;1
24795.0;2023;15;STRASBOURG;MASCULIN;SCOLAIRE;BAC PROFESSIONNEL;BAC PRO PROD;BAC PRO 23205 INTERV. SUR PATRIMOINE BATI OPT.A;2;2;0;2;0;0;0;0;0;0;0;0;0;2
24796.0;2023;15;STRASBOURG;MASCULIN;SCOLAIRE;BAC PROFESSIONNEL;BAC PRO PROD;BAC PRO 23303 MENUISERIE ALUMINIUM-VERRE;6;6;4;1;1;1;0;5;0;0;1;3;1;1
24804.0;2023;15;STRASBOURG;MASCULIN;SCOLAIRE;BAC PROFESSIONNEL;BAC PRO PROD;BAC PRO 25107 TECHNICIEN OUTILLEUR;7;7;6;1;0;0;0;6;0;0;3;1;2;1
24809.0;2023;15;STRASBOURG;MASCULIN;SCOLAIRE;BAC PROFESSIONNEL;BAC PRO PROD;BAC PRO 25220 MAINT.MATERIELS OPT.B TP MANUT.;5;5;5;0;0;0;0;5;0;0;0;1;4;0
24810.0;2023;15;STRASBOURG;MASCULIN;SCOLAIRE;BAC PROFESSIONNEL;BAC PRO PROD;BAC PRO 25221 MAINT.MATERIELS OPT.C ESP. VERTS;1;1;1;0;0;0;0;1;0;0;0;0;1;0
24816.0;2023;15;STRASBOURG;MASCULIN;SCOLAIRE;BAC PROFESSIONNEL;BAC PRO PROD;BAC PRO 25513 SYST.NUM.OPT.A SURETE SECURITE;20;20;15;3;2;1;1;16;0;0;5;6;5;4
24819.0;2023;15;STRASBOURG;MASCULIN;SCOLAIRE;BAC PROFESSIONNEL;BAC PRO PROD;BAC PRO AG 21004 CGEA;25;25;25;0;0;0;0;25;0;2;6;9;8;0
24832.0;2023;15;STRASBOURG;MASCULIN;SCOLAIRE;BAC PROFESSIONNEL;BAC PRO SERV;BAC PRO 31212 METIERS DE L'ACCUEIL;25;25;19;3;3;3;0;22;0;1;3;9;9;3
24837.0;2023;15;STRASBOURG;MASCULIN;SCOLAIRE;BAC PROFESSIONNEL;BAC PRO SERV;BAC PRO 32303 ART.& MET.ART:COM.VIS.VIS.PLURI-M;10;10;10;0;0;0;0;10;0;2;5;2;1;0
24840.0;2023;15;STRASBOURG;MASCULIN;SCOLAIRE;BAC PROFESSIONNEL;BAC PRO SERV;BAC PRO 33101 OPTIQUE LUNETTERIE;3;3;3;0;0;0;0;3;0;1;0;2;0;0
24843.0;2023;15;STRASBOURG;MASCULIN;SCOLAIRE;BAC PROFESSIONNEL;BAC PRO SERV;BAC PRO 33604 METIERS DE LA COIFFURE;2;2;1;1;0;0;0;1;0;0;0;0;1;1
24845.0;2023;15;STRASBOURG;MASCULIN;SCOLAIRE;BAC PROFESSIONNEL;BAC PRO SERV;BAC PRO 34403 METIERS DE LA SECURITE;38;38;33;3;2;2;0;35;0;3;12;10;10;3
24851.0;2023;15;STRASBOURG;MASCULIN;SCOLAIRE;BAC TECHNOLOGIQUE;BAC STI2D;BAC STI2D ARCHITECTURE ET CONSTRUCTION;176;176;151;3;22;12;10;163;0;3;24;51;85;13
24852.0;2023;15;STRASBOURG;MASCULIN;SCOLAIRE;BAC TECHNOLOGIQUE;BAC STI2D;BAC STI2D ENERGIES  ET ENVIRONNEMENT;157;157;122;8;27;24;3;146;0;5;17;48;76;11
24861.0;2023;16;TOULOUSE;FEMININ;APPRENTISSAGE;BAC PROFESSIONNEL;BAC PRO PROD;BAC PRO 22104 BOUCHER CHARCUTIER TRAITEUR;2;2;1;1;0;0;0;1;0;0;0;0;1;1
24864.0;2023;16;TOULOUSE;FEMININ;APPRENTISSAGE;BAC PROFESSIONNEL;BAC PRO PROD;BAC PRO 23005 TECHN. ETUDES BAT B ASSIST.ARCHI.;5;5;5;0;0;0;0;5;0;2;1;2;0;0
24866.0;2023;16;TOULOUSE;FEMININ;APPRENTISSAGE;BAC PROFESSIONNEL;BAC PRO PROD;BAC PRO 24203 METIERS DE LA MODE - VÊTEMENT;2;2;1;1;0;0;0;1;0;0;0;0;1;1
24869.0;2023;16;TOULOUSE;FEMININ;APPRENTISSAGE;BAC PROFESSIONNEL;BAC PRO PROD;BAC PRO 25214 MAINT.VEHIC.OPTA VOIT.PARTICUL.;5;5;5;0;0;0;0;5;0;3;0;2;0;0
24870.0;2023;16;TOULOUSE;FEMININ;APPRENTISSAGE;BAC PROFESSIONNEL;BAC PRO PROD;BAC PRO 25216 MAINT.VEHIC.OPTC MOTOCYCLES;1;1;1;0;0;0;0;1;0;0;0;1;0;0
24871.0;2023;16;TOULOUSE;FEMININ;APPRENTISSAGE;BAC PROFESSIONNEL;BAC PRO PROD;BAC PRO 25219 MAINT.MATERIELS OPT.A AGRICOLES;1;1;0;1;0;0;0;0;0;0;0;0;0;1
24890.0;2023;16;TOULOUSE;FEMININ;APPRENTISSAGE;BAC PROFESSIONNEL;BAC PRO SERV;BAC PRO 33104 TECHNICIEN EN PROTHESE DENTAIRE;11;11;11;0;0;0;0;11;0;4;3;4;0;0
24894.0;2023;16;TOULOUSE;FEMININ;APPRENTISSAGE;BAC PROFESSIONNEL;BAC PRO SERV;BAC PRO AG 33002 SERV PERS TERRIT;8;8;6;2;0;0;0;6;0;0;1;2;3;2
24895.0;2023;16;TOULOUSE;FEMININ;ENSEIGNEMENT A DISTANCE;BAC GENERAL;BAC GENERAL;BAC GENE 10019 BAC GENERAL;93;93;62;22;9;5;4;67;2;3;12;28;22;26
24899.0;2023;16;TOULOUSE;FEMININ;ENSEIGNEMENT A DISTANCE;BAC PROFESSIONNEL;BAC PRO SERV;BAC PRO 33004 ACC.SOINS-S.PERS. OPT.EN STRUCTUR;3;1;0;1;0;0;0;0;0;0;0;0;0;1
24901.0;2023;16;TOULOUSE;FEMININ;ENSEIGNEMENT A DISTANCE;BAC TECHNOLOGIQUE;BAC ST2S;BAC ST2S SCIENCES & TECHNO. SANTE & SOCIAL;12;12;4;3;5;3;2;7;0;0;0;3;4;5
24902.0;2023;16;TOULOUSE;FEMININ;ENSEIGNEMENT A DISTANCE;BAC TECHNOLOGIQUE;BAC STMG;BAC STMG GESTION ET FINANCE;2;2;2;0;0;0;0;2;0;0;0;2;0;0
24904.0;2023;16;TOULOUSE;FEMININ;ENSEIGNEMENT A DISTANCE;BAC TECHNOLOGIQUE;BAC STMG;BAC STMG RESSOURCES HUMAINES ET COMMUNICATION;5;5;1;2;2;1;1;2;0;0;0;0;2;3
24905.0;2023;16;TOULOUSE;FEMININ;ENSEIGNEMENT A DISTANCE;BAC TECHNOLOGIQUE;BAC STMG;BAC STMG SYSTEMES D'INFORMATION DE GESTION;1;1;0;1;0;0;0;0;0;0;0;0;0;1
24917.0;2023;16;TOULOUSE;FEMININ;INDIVIDUEL;BAC PROFESSIONNEL;BAC PRO PROD;BAC PRO AG 21114 CONDUITE PRODUCTIONS HORTICOLES;6;6;5;1;0;0;0;5;0;0;0;1;4;1
24922.0;2023;16;TOULOUSE;FEMININ;INDIVIDUEL;BAC PROFESSIONNEL;BAC PRO SERV;BAC PRO 31213 MET.COM.VEN.OP.A ANI.GES.ESP.COM.;4;2;0;2;0;0;0;0;0;0;0;0;0;2
24923.0;2023;16;TOULOUSE;FEMININ;INDIVIDUEL;BAC PROFESSIONNEL;BAC PRO SERV;BAC PRO 31214 MET.COM.VEN.OP.B PR.CL.VA.OF.COM.;3;1;0;0;1;1;0;1;0;0;0;0;1;0
24932.0;2023;16;TOULOUSE;FEMININ;INDIVIDUEL;BAC TECHNOLOGIQUE;BAC STMG;BAC STMG RESSOURCES HUMAINES ET COMMUNICATION;7;7;1;4;2;0;2;1;0;0;0;0;1;6
24938.0;2023;16;TOULOUSE;FEMININ;SCOLAIRE;BAC PROFESSIONNEL;BAC PRO PROD;BAC PRO 22104 BOUCHER CHARCUTIER TRAITEUR;3;3;3;0;0;0;0;3;0;0;1;2;0;0
24939.0;2023;16;TOULOUSE;FEMININ;SCOLAIRE;BAC PROFESSIONNEL;BAC PRO PROD;BAC PRO 22105 BOULANGER-PÂTISSIER;36;36;32;3;1;0;1;32;0;4;8;17;3;4
24951.0;2023;16;TOULOUSE;FEMININ;SCOLAIRE;BAC PROFESSIONNEL;BAC PRO PROD;BAC PRO 24203 METIERS DE LA MODE - VÊTEMENT;102;100;93;7;0;0;0;93;0;11;28;30;24;7
24956.0;2023;16;TOULOUSE;FEMININ;SCOLAIRE;BAC PROFESSIONNEL;BAC PRO PROD;BAC PRO 25108 TECHNICIEN MODELEUR;2;2;1;1;0;0;0;1;0;0;0;1;0;1
24967.0;2023;16;TOULOUSE;FEMININ;SCOLAIRE;BAC PROFESSIONNEL;BAC PRO PROD;BAC PRO 25514 SYST.NUM.OPT.B AUD.RES.EQUIP.DOM.;3;3;3;0;0;0;0;3;0;0;1;2;0;0
24981.0;2023;16;TOULOUSE;FEMININ;SCOLAIRE;BAC PROFESSIONNEL;BAC PRO SERV;BAC PRO 31106 LOGISTIQUE;10;9;8;1;0;0;0;8;0;1;3;2;2;1
24982.0;2023;16;TOULOUSE;FEMININ;SCOLAIRE;BAC PROFESSIONNEL;BAC PRO SERV;BAC PRO 31107 CONDUCT. TRANSP.ROUT.MARCHANDISES;1;1;1;0;0;0;0;1;0;0;0;0;1;0
24992.0;2023;16;TOULOUSE;FEMININ;SCOLAIRE;BAC PROFESSIONNEL;BAC PRO SERV;BAC PRO 33004 ACC.SOINS-S.PERS. OPT.EN STRUCTUR;515;515;463;33;19;13;6;476;0;24;123;188;141;39
24996.0;2023;16;TOULOUSE;FEMININ;SCOLAIRE;BAC PROFESSIONNEL;BAC PRO SERV;BAC PRO 33104 TECHNICIEN EN PROTHESE DENTAIRE;27;27;26;0;1;0;1;26;0;3;8;13;2;1
24998.0;2023;16;TOULOUSE;FEMININ;SCOLAIRE;BAC PROFESSIONNEL;BAC PRO SERV;BAC PRO 33602 PERRUQUIER POSTICHEUR;5;5;5;0;0;0;0;5;0;0;3;2;0;0
25006.0;2023;16;TOULOUSE;FEMININ;SCOLAIRE;BAC TECHNOLOGIQUE;BAC S2TMD;BAC S2TMD THEATRE;2;2;2;0;0;0;0;2;0;1;1;0;0;0
25022.0;2023;16;TOULOUSE;MASCULIN;APPRENTISSAGE;BAC PROFESSIONNEL;BAC PRO PROD;BAC PRO 22004 PROC. CHIMIE EAU PAPIERS-CARTONS;1;1;1;0;0;0;0;1;0;1;0;0;0;0
25025.0;2023;16;TOULOUSE;MASCULIN;APPRENTISSAGE;BAC PROFESSIONNEL;BAC PRO PROD;BAC PRO 22106 CUISINE;15;15;12;1;2;2;0;14;0;1;2;2;9;1
25027.0;2023;16;TOULOUSE;MASCULIN;APPRENTISSAGE;BAC PROFESSIONNEL;BAC PRO PROD;BAC PRO 22704 TECHN. MAINT. SYST.ENERG.CLIMATI;5;5;5;0;0;0;0;5;0;0;2;1;2;0
25030.0;2023;16;TOULOUSE;MASCULIN;APPRENTISSAGE;BAC PROFESSIONNEL;BAC PRO PROD;BAC PRO 23005 TECHN. ETUDES BAT B ASSIST.ARCHI.;3;3;3;0;0;0;0;3;0;0;1;2;0;0
25032.0;2023;16;TOULOUSE;MASCULIN;APPRENTISSAGE;BAC PROFESSIONNEL;BAC PRO PROD;BACPRO 23103 TECHNICIEN GEOMETRE-TOPOGRAPHE;1;1;1;0;0;0;0;1;0;1;0;0;0;0
25040.0;2023;16;TOULOUSE;MASCULIN;APPRENTISSAGE;BAC PROFESSIONNEL;BAC PRO PROD;BAC PRO 23406 TECHNICIEN DE SCIERIE;1;1;1;0;0;0;0;1;0;0;0;1;0;0
25044.0;2023;16;TOULOUSE;MASCULIN;APPRENTISSAGE;BAC PROFESSIONNEL;BAC PRO PROD;BAC PRO 25107 TECHNICIEN OUTILLEUR;1;1;1;0;0;0;0;1;0;0;0;1;0;0
25050.0;2023;16;TOULOUSE;MASCULIN;APPRENTISSAGE;BAC PROFESSIONNEL;BAC PRO PROD;BAC PRO 25221 MAINT.MATERIELS OPT.C ESP. VERTS;8;6;3;3;0;0;0;3;0;0;0;1;2;3
25051.0;2023;16;TOULOUSE;MASCULIN;APPRENTISSAGE;BAC PROFESSIONNEL;BAC PRO PROD;BAC PRO 25302 AERONAUTIQUE OPTION AVIONIQUE;4;4;4;0;0;0;0;4;0;2;0;2;0;0
25052.0;2023;16;TOULOUSE;MASCULIN;APPRENTISSAGE;BAC PROFESSIONNEL;BAC PRO PROD;BAC PRO 25303 AERONAUTIQUE OPTION SYSTEMES;7;7;7;0;0;0;0;7;0;1;4;2;0;0
25053.0;2023;16;TOULOUSE;MASCULIN;APPRENTISSAGE;BAC PROFESSIONNEL;BAC PRO PROD;BAC PRO 25304 AERONAUTIQUE OPTION STRUCTURE;8;8;6;2;0;0;0;6;0;0;4;2;0;2
25058.0;2023;16;TOULOUSE;MASCULIN;APPRENTISSAGE;BAC PROFESSIONNEL;BAC PRO PROD;BAC PRO 25510 METIERS ELECT. ENVIRON. CONNECTES;79;78;69;5;4;4;0;73;0;13;19;23;18;5
25073.0;2023;16;TOULOUSE;MASCULIN;APPRENTISSAGE;BAC PROFESSIONNEL;BAC PRO SERV;BAC PRO 33403 COMMERC. SERVICES EN RESTAURATION;8;8;6;1;1;1;0;7;0;0;1;2;4;1
25075.0;2023;16;TOULOUSE;MASCULIN;ENSEIGNEMENT A DISTANCE;BAC GENERAL;BAC GENERAL;BAC GENE 10019 BAC GENERAL;28;28;19;5;4;2;2;21;0;2;2;7;10;7
25085.0;2023;16;TOULOUSE;MASCULIN;FORMATION CONTINUE;BAC PROFESSIONNEL;BAC PRO PROD;BAC PRO 22704 TECHN. MAINT. SYST.ENERG.CLIMATI;3;3;3;0;0;0;0;3;0;2;0;0;1;0
25105.0;2023;16;TOULOUSE;MASCULIN;INDIVIDUEL;BAC PROFESSIONNEL;BAC PRO PROD;BAC PRO 25220 MAINT.MATERIELS OPT.B TP MANUT.;1;1;0;1;0;0;0;0;0;0;0;0;0;1
25130.0;2023;16;TOULOUSE;MASCULIN;SCOLAIRE;BAC PROFESSIONNEL;BAC PRO PROD;BAC PRO 20102 PILOTE DE LIGNE DE PRODUCTION;3;3;2;0;1;0;1;2;0;0;1;0;1;1
25132.0;2023;16;TOULOUSE;MASCULIN;SCOLAIRE;BAC PROFESSIONNEL;BAC PRO PROD;BAC PRO 22004 PROC. CHIMIE EAU PAPIERS-CARTONS;9;9;7;1;1;1;0;8;0;1;3;3;1;1
25136.0;2023;16;TOULOUSE;MASCULIN;SCOLAIRE;BAC PROFESSIONNEL;BAC PRO PROD;BAC PRO 22403 ARTS.& MET.ART:MET.ENSEIGN SIGNA;11;11;11;0;0;0;0;11;0;0;2;4;5;0
25140.0;2023;16;TOULOUSE;MASCULIN;SCOLAIRE;BAC PROFESSIONNEL;BAC PRO PROD;BAC PRO 23003 ARTIS. & M.ART:MARCHANDISAGE VIS.;8;8;5;2;1;1;0;6;0;1;1;1;3;2
25175.0;2023;16;TOULOUSE;MASCULIN;SCOLAIRE;BAC PROFESSIONNEL;BAC PRO PROD;BAC PRO 25510 METIERS ELECT. ENVIRON. CONNECTES;452;451;333;91;27;17;10;350;0;20;65;132;133;101
25178.0;2023;16;TOULOUSE;MASCULIN;SCOLAIRE;BAC PROFESSIONNEL;BAC PRO PROD;BAC PRO 25515 SYST.NUM.OPT.C RES.INF.SYST.COMM.;172;171;137;26;8;7;1;144;0;4;26;60;54;27
25179.0;2023;16;TOULOUSE;MASCULIN;SCOLAIRE;BAC PROFESSIONNEL;BAC PRO PROD;BAC PRO AG 21001 AGRO-EQUIPEMENT;22;22;19;3;0;0;0;19;0;0;0;6;13;3
25182.0;2023;16;TOULOUSE;MASCULIN;SCOLAIRE;BAC PROFESSIONNEL;BAC PRO PROD;BAC PRO AG 21114 CONDUITE PRODUCTIONS HORTICOLES;25;24;24;0;0;0;0;24;0;0;2;11;11;0
25184.0;2023;16;TOULOUSE;MASCULIN;SCOLAIRE;BAC PROFESSIONNEL;BAC PRO PROD;BAC PRO AG 21210 COND GEST ENTR CANIN ET FELIN;13;13;13;0;0;0;0;13;0;0;2;3;8;0
25189.0;2023;16;TOULOUSE;MASCULIN;SCOLAIRE;BAC PROFESSIONNEL;BAC PRO PROD;BAC PRO AG 21407 TEC CONS VTE UNIVERS JARDINERIE;5;5;4;1;0;0;0;4;0;0;0;2;2;1
25190.0;2023;16;TOULOUSE;MASCULIN;SCOLAIRE;BAC PROFESSIONNEL;BAC PRO PROD;BAC PRO AG 22105 LABORATOIRE CONTROLE QUALITE;14;13;11;2;0;0;0;11;0;0;1;6;4;2
25195.0;2023;16;TOULOUSE;MASCULIN;SCOLAIRE;BAC PROFESSIONNEL;BAC PRO SERV;BAC PRO 31114 ORGANIS. TRANSPORT MARCHANDISES;14;14;10;4;0;0;0;10;0;0;1;4;5;4
25197.0;2023;16;TOULOUSE;MASCULIN;SCOLAIRE;BAC PROFESSIONNEL;BAC PRO SERV;BAC PRO 31213 MET.COM.VEN.OP.A ANI.GES.ESP.COM.;405;404;313;63;28;20;8;333;0;9;64;126;134;71
25198.0;2023;16;TOULOUSE;MASCULIN;SCOLAIRE;BAC PROFESSIONNEL;BAC PRO SERV;BAC PRO 31214 MET.COM.VEN.OP.B PR.CL.VA.OF.COM.;191;191;159;25;7;7;0;166;0;7;33;64;62;25
25207.0;2023;16;TOULOUSE;MASCULIN;SCOLAIRE;BAC PROFESSIONNEL;BAC PRO SERV;BAC PRO 33103 TECHNICIEN APPAREIL. ORTHOPEDIQUE;10;10;9;0;1;1;0;10;0;0;4;3;3;0
25214.0;2023;16;TOULOUSE;MASCULIN;SCOLAIRE;BAC PROFESSIONNEL;BAC PRO SERV;BAC PRO 34403 METIERS DE LA SECURITE;67;67;58;8;1;1;0;59;0;2;9;21;27;8
25217.0;2023;16;TOULOUSE;MASCULIN;SCOLAIRE;BAC TECHNOLOGIQUE;BAC S2TMD;BAC S2TMD THEATRE;2;2;2;0;0;0;0;2;0;1;1;0;0;0
25219.0;2023;16;TOULOUSE;MASCULIN;SCOLAIRE;BAC TECHNOLOGIQUE;BAC STAV;BAC STAV AGRONOMIE ALIM ENV TERRITOI;204;204;199;5;0;0;0;199;0;5;29;90;75;5
25222.0;2023;16;TOULOUSE;MASCULIN;SCOLAIRE;BAC TECHNOLOGIQUE;BAC STI2D;BAC STI2D ARCHITECTURE ET CONSTRUCTION;224;224;193;8;23;12;11;205;1;6;32;61;105;19
25228.0;2023;16;TOULOUSE;MASCULIN;SCOLAIRE;BAC TECHNOLOGIQUE;BAC STMG;BAC STMG GESTION ET FINANCE;397;397;341;12;44;32;12;373;0;8;32;126;207;24
25230.0;2023;16;TOULOUSE;MASCULIN;SCOLAIRE;BAC TECHNOLOGIQUE;BAC STMG;BAC STMG RESSOURCES HUMAINES ET COMMUNICATION;173;173;116;14;43;33;10;149;0;0;11;40;98;24
25243.0;2023;25;VERSAILLES;FEMININ;APPRENTISSAGE;BAC PROFESSIONNEL;BAC PRO PROD;BAC PRO AG 21203 TECHN CONSEIL DE VENTE ANIMAL;11;10;8;2;0;0;0;8;0;0;0;1;7;2
25247.0;2023;25;VERSAILLES;FEMININ;APPRENTISSAGE;BAC PROFESSIONNEL;BAC PRO SERV;BAC PRO 31106 LOGISTIQUE;4;4;2;1;1;0;1;2;0;0;0;1;1;2
25251.0;2023;25;VERSAILLES;FEMININ;APPRENTISSAGE;BAC PROFESSIONNEL;BAC PRO SERV;BAC PRO 33003 ACC.SOINS-S.PERS. OPT.A DOMICILE;10;10;4;6;0;0;0;4;0;1;0;1;2;6
25255.0;2023;25;VERSAILLES;FEMININ;APPRENTISSAGE;BAC PROFESSIONNEL;BAC PRO SERV;BAC PRO 34304 HYGIENE PROPRETE STERILISATION;7;7;5;2;0;0;0;5;0;0;0;3;2;2
25260.0;2023;25;VERSAILLES;FEMININ;ENSEIGNEMENT A DISTANCE;BAC PROFESSIONNEL;BAC PRO SERV;BAC PRO 31212 METIERS DE L'ACCUEIL;1;0;0;0;0;0;0;0;0;0;0;0;0;0
25263.0;2023;25;VERSAILLES;FEMININ;ENSEIGNEMENT A DISTANCE;BAC PROFESSIONNEL;BAC PRO SERV;BAC PRO 32304 PHOTOGRAPHIE;2;1;1;0;0;0;0;1;0;0;0;1;0;0
25265.0;2023;25;VERSAILLES;FEMININ;ENSEIGNEMENT A DISTANCE;BAC PROFESSIONNEL;BAC PRO SERV;BAC PRO 33603 ESTHETIQUE COSMETIQUE PARFUMERIE;2;2;0;2;0;0;0;0;0;0;0;0;0;2
25267.0;2023;25;VERSAILLES;FEMININ;ENSEIGNEMENT A DISTANCE;BAC TECHNOLOGIQUE;BAC STMG;BAC STMG GESTION ET FINANCE;4;4;2;2;0;0;0;2;0;0;0;1;1;2
25272.0;2023;25;VERSAILLES;FEMININ;FORMATION CONTINUE;BAC PROFESSIONNEL;BAC PRO PROD;BAC PRO 25510 METIERS ELECT. ENVIRON. CONNECTES;1;1;1;0;0;0;0;1;0;1;0;0;0;0
25278.0;2023;25;VERSAILLES;FEMININ;FORMATION CONTINUE;BAC PROFESSIONNEL;BAC PRO SERV;BAC PRO 34403 METIERS DE LA SECURITE;5;4;1;2;1;1;0;2;0;0;0;0;2;2
25280.0;2023;25;VERSAILLES;FEMININ;INDIVIDUEL;BAC PROFESSIONNEL;BAC PRO PROD;BAC PRO 22106 CUISINE;2;1;0;0;1;0;1;0;0;0;0;0;0;1
25285.0;2023;25;VERSAILLES;FEMININ;INDIVIDUEL;BAC PROFESSIONNEL;BAC PRO PROD;BAC PRO AG 21211 COND GEST ENTR HIPPIQUE;2;1;1;0;0;0;0;1;0;0;0;0;1;0
25301.0;2023;25;VERSAILLES;FEMININ;INDIVIDUEL;BAC TECHNOLOGIQUE;BAC STMG;BAC STMG RESSOURCES HUMAINES ET COMMUNICATION;31;29;3;19;7;3;4;6;0;0;0;0;6;23
25303.0;2023;25;VERSAILLES;FEMININ;SCOLAIRE;BAC GENERAL;BAC GENERAL;BAC GENE 10019 BAC GENERAL;22152;22152;20328;403;1421;972;449;21300;393;3093;5654;6541;5619;852
25309.0;2023;25;VERSAILLES;FEMININ;SCOLAIRE;BAC PROFESSIONNEL;BAC PRO PROD;BAC PRO 23005 TECHN. ETUDES BAT B ASSIST.ARCHI.;28;28;22;4;2;1;1;23;0;0;1;9;13;5
25318.0;2023;25;VERSAILLES;FEMININ;SCOLAIRE;BAC PROFESSIONNEL;BAC PRO PROD;BAC PRO 24302 METIERS DU CUIR : MAROQUINERIE;9;9;8;0;1;1;0;9;0;0;2;4;3;0
25320.0;2023;25;VERSAILLES;FEMININ;SCOLAIRE;BAC PROFESSIONNEL;BAC PRO PROD;BAC PRO 25007 MAINTENANCE EQUIPEMENTS INDUST.;7;7;6;0;1;1;0;7;0;0;0;3;4;0
25324.0;2023;25;VERSAILLES;FEMININ;SCOLAIRE;BAC PROFESSIONNEL;BAC PRO PROD;BAC PRO 25221 MAINT.MATERIELS OPT.C ESP. VERTS;2;2;1;1;0;0;0;1;0;0;0;0;1;1
25339.0;2023;25;VERSAILLES;FEMININ;SCOLAIRE;BAC PROFESSIONNEL;BAC PRO SERV;BAC PRO 31106 LOGISTIQUE;18;18;15;2;1;1;0;16;0;1;2;2;11;2
25351.0;2023;25;VERSAILLES;FEMININ;SCOLAIRE;BAC PROFESSIONNEL;BAC PRO SERV;BAC PRO 33003 ACC.SOINS-S.PERS. OPT.A DOMICILE;71;71;62;7;2;2;0;64;0;4;20;23;17;7
25361.0;2023;25;VERSAILLES;FEMININ;SCOLAIRE;BAC TECHNOLOGIQUE;BAC S2TMD;BAC S2TMD DANSE;7;7;7;0;0;0;0;7;0;1;3;3;0;0
25371.0;2023;25;VERSAILLES;FEMININ;SCOLAIRE;BAC TECHNOLOGIQUE;BAC STL;BAC STL BIOCHIM.-BIOLOGIE-BIOTECHNOL.;244;244;196;12;36;16;20;212;0;16;40;78;78;32
25373.0;2023;25;VERSAILLES;FEMININ;SCOLAIRE;BAC TECHNOLOGIQUE;BAC STMG;BAC STMG GESTION ET FINANCE;671;671;490;48;133;98;35;588;0;13;74;174;327;83
25375.0;2023;25;VERSAILLES;FEMININ;SCOLAIRE;BAC TECHNOLOGIQUE;BAC STMG;BAC STMG RESSOURCES HUMAINES ET COMMUNICATION;1603;1603;1172;115;316;256;60;1428;1;13;100;354;960;175
25377.0;2023;25;VERSAILLES;MASCULIN;APPRENTISSAGE;BAC PROFESSIONNEL;BAC PRO PROD;BAC PRO 22105 BOULANGER-PÂTISSIER;33;33;25;6;2;1;1;26;0;1;1;7;17;7
25379.0;2023;25;VERSAILLES;MASCULIN;APPRENTISSAGE;BAC PROFESSIONNEL;BAC PRO PROD;BAC PRO 22703 TECHN.INSTALL.SYST.ENERG.CLIMATI;68;68;42;18;8;6;2;48;0;3;4;13;28;20
25381.0;2023;25;VERSAILLES;MASCULIN;APPRENTISSAGE;BAC PROFESSIONNEL;BAC PRO PROD;BAC PRO 23102 TRAVAUX PUBLICS;36;36;23;4;9;3;6;26;0;2;4;5;15;10
25386.0;2023;25;VERSAILLES;MASCULIN;APPRENTISSAGE;BAC PROFESSIONNEL;BAC PRO PROD;BAC PRO 23405 TECHNICIEN MENUISIER AGENCEUR;10;10;5;5;0;0;0;5;0;0;0;3;2;5
25392.0;2023;25;VERSAILLES;MASCULIN;APPRENTISSAGE;BAC PROFESSIONNEL;BAC PRO PROD;BAC PRO 25219 MAINT.MATERIELS OPT.A AGRICOLES;1;1;1;0;0;0;0;1;0;0;0;0;1;0
25397.0;2023;25;VERSAILLES;MASCULIN;APPRENTISSAGE;BAC PROFESSIONNEL;BAC PRO PROD;BAC PRO 25406 OUVRAGES DU BATIMENT METALLERIE;12;12;3;7;2;1;1;4;0;1;0;0;3;8
25402.0;2023;25;VERSAILLES;MASCULIN;APPRENTISSAGE;BAC PROFESSIONNEL;BAC PRO PROD;BAC PRO 25513 SYST.NUM.OPT.A SURETE SECURITE;2;2;0;2;0;0;0;0;0;0;0;0;0;2
25403.0;2023;25;VERSAILLES;MASCULIN;APPRENTISSAGE;BAC PROFESSIONNEL;BAC PRO PROD;BAC PRO 25515 SYST.NUM.OPT.C RES.INF.SYST.COMM.;18;18;16;2;0;0;0;16;0;3;5;4;4;2
25405.0;2023;25;VERSAILLES;MASCULIN;APPRENTISSAGE;BAC PROFESSIONNEL;BAC PRO PROD;BAC PRO AG 21211 COND GEST ENTR HIPPIQUE;2;2;2;0;0;0;0;2;0;0;0;1;1;0
25414.0;2023;25;VERSAILLES;MASCULIN;APPRENTISSAGE;BAC PROFESSIONNEL;BAC PRO SERV;BAC PRO 31214 MET.COM.VEN.OP.B PR.CL.VA.OF.COM.;16;16;10;4;2;2;0;12;0;1;1;4;6;4
25419.0;2023;25;VERSAILLES;MASCULIN;APPRENTISSAGE;BAC PROFESSIONNEL;BAC PRO SERV;BAC PRO 34304 HYGIENE PROPRETE STERILISATION;18;18;8;10;0;0;0;8;0;0;0;3;5;10
25422.0;2023;25;VERSAILLES;MASCULIN;ENSEIGNEMENT A DISTANCE;BAC GENERAL;BAC GENERAL;BAC GENE 10019 BAC GENERAL;93;92;50;28;14;12;2;62;0;4;8;17;33;30
25423.0;2023;25;VERSAILLES;MASCULIN;ENSEIGNEMENT A DISTANCE;BAC PROFESSIONNEL;BAC PRO SERV;BAC PRO 30004 ASSISTANC.GEST.ORGANIS.ACTIVITES;7;3;2;1;0;0;0;2;0;0;0;0;2;1
25424.0;2023;25;VERSAILLES;MASCULIN;ENSEIGNEMENT A DISTANCE;BAC PROFESSIONNEL;BAC PRO SERV;BAC PRO 31213 MET.COM.VEN.OP.A ANI.GES.ESP.COM.;4;1;1;0;0;0;0;1;0;0;0;0;1;0
25429.0;2023;25;VERSAILLES;MASCULIN;ENSEIGNEMENT A DISTANCE;BAC TECHNOLOGIQUE;BAC STMG;BAC STMG MERCATIQUE (MARKETING);7;7;2;3;2;2;0;4;0;0;0;1;3;3
25431.0;2023;25;VERSAILLES;MASCULIN;ENSEIGNEMENT A DISTANCE;BAC TECHNOLOGIQUE;BAC STMG;BAC STMG SYSTEMES D'INFORMATION DE GESTION;2;2;2;0;0;0;0;2;0;0;0;0;2;0
25436.0;2023;25;VERSAILLES;MASCULIN;FORMATION CONTINUE;BAC PROFESSIONNEL;BAC PRO PROD;BAC PRO 23205 INTERV. SUR PATRIMOINE BATI OPT.A;3;3;3;0;0;0;0;3;0;1;2;0;0;0
25441.0;2023;25;VERSAILLES;MASCULIN;FORMATION CONTINUE;BAC PROFESSIONNEL;BAC PRO SERV;BAC PRO 30004 ASSISTANC.GEST.ORGANIS.ACTIVITES;6;5;3;2;0;0;0;3;0;0;0;1;2;2
25446.0;2023;25;VERSAILLES;MASCULIN;FORMATION CONTINUE;BAC PROFESSIONNEL;BAC PRO SERV;BAC PRO 34403 METIERS DE LA SECURITE;18;17;10;6;1;1;0;11;0;0;1;1;9;6
25450.0;2023;25;VERSAILLES;MASCULIN;INDIVIDUEL;BAC PROFESSIONNEL;BAC PRO PROD;BAC PRO 23004 TECHN. ETUDES BAT.A ETUDES & ECO.;2;2;1;1;0;0;0;1;0;0;0;0;1;1
25452.0;2023;25;VERSAILLES;MASCULIN;INDIVIDUEL;BAC PROFESSIONNEL;BAC PRO PROD;BAC PRO 24203 METIERS DE LA MODE - VÊTEMENT;1;1;1;0;0;0;0;1;0;0;0;1;0;0
25466.0;2023;25;VERSAILLES;MASCULIN;INDIVIDUEL;BAC PROFESSIONNEL;BAC PRO PROD;BAC PRO AG 21004 CGEA;10;9;7;2;0;0;0;7;0;0;0;0;7;2
25477.0;2023;25;VERSAILLES;MASCULIN;INDIVIDUEL;BAC PROFESSIONNEL;BAC PRO SERV;BAC PRO 32208 REAL.PR.IMPR.PLURI.OPTB.PR.IMPR.;2;2;1;1;0;0;0;1;0;0;0;1;0;1
25478.0;2023;25;VERSAILLES;MASCULIN;INDIVIDUEL;BAC PROFESSIONNEL;BAC PRO SERV;BAC PRO 32303 ART.& MET.ART:COM.VIS.VIS.PLURI-M;2;1;0;1;0;0;0;0;0;0;0;0;0;1
25480.0;2023;25;VERSAILLES;MASCULIN;INDIVIDUEL;BAC PROFESSIONNEL;BAC PRO SERV;BAC PRO 33004 ACC.SOINS-S.PERS. OPT.EN STRUCTUR;1;1;1;0;0;0;0;1;0;0;0;0;1;0
25482.0;2023;25;VERSAILLES;MASCULIN;INDIVIDUEL;BAC PROFESSIONNEL;BAC PRO SERV;BAC PRO 34304 HYGIENE PROPRETE STERILISATION;1;1;0;0;1;1;0;1;0;0;0;0;1;0
25486.0;2023;25;VERSAILLES;MASCULIN;INDIVIDUEL;BAC TECHNOLOGIQUE;BAC STI2D;BAC STI2D ARCHITECTURE ET CONSTRUCTION;1;1;0;1;0;0;0;0;0;0;0;0;0;1
25493.0;2023;25;VERSAILLES;MASCULIN;INDIVIDUEL;BAC TECHNOLOGIQUE;BAC STMG;BAC STMG RESSOURCES HUMAINES ET COMMUNICATION;17;17;3;13;1;0;1;3;0;0;0;0;3;14
25504.0;2023;25;VERSAILLES;MASCULIN;SCOLAIRE;BAC PROFESSIONNEL;BAC PRO PROD;BAC PRO 23004 TECHN. ETUDES BAT.A ETUDES & ECO.;78;78;46;28;4;4;0;50;0;0;2;14;34;28
25506.0;2023;25;VERSAILLES;MASCULIN;SCOLAIRE;BAC PROFESSIONNEL;BAC PRO PROD;BAC PRO 23102 TRAVAUX PUBLICS;9;9;4;4;1;1;0;5;0;0;1;2;2;4
25511.0;2023;25;VERSAILLES;MASCULIN;SCOLAIRE;BAC PROFESSIONNEL;BAC PRO PROD;BAC PRO 23404 TECHNICIEN CONSTRUCTEUR BOIS;5;5;5;0;0;0;0;5;0;0;1;2;2;0
25514.0;2023;25;VERSAILLES;MASCULIN;SCOLAIRE;BAC PROFESSIONNEL;BAC PRO PROD;BAC PRO 24202 ARTIS.& MET.ART : TAPIS.D'AMEUBL;2;2;2;0;0;0;0;2;0;0;0;0;2;0
25520.0;2023;25;VERSAILLES;MASCULIN;SCOLAIRE;BAC PROFESSIONNEL;BAC PRO PROD;BAC PRO 25108 TECHNICIEN MODELEUR;15;15;13;1;1;1;0;14;0;2;5;3;4;1
25526.0;2023;25;VERSAILLES;MASCULIN;SCOLAIRE;BAC PROFESSIONNEL;BAC PRO PROD;BAC PRO 25221 MAINT.MATERIELS OPT.C ESP. VERTS;1;1;1;0;0;0;0;1;0;0;1;0;0;0
25528.0;2023;25;VERSAILLES;MASCULIN;SCOLAIRE;BAC PROFESSIONNEL;BAC PRO PROD;BAC PRO 25303 AERONAUTIQUE OPTION SYSTEMES;33;33;27;4;2;2;0;29;0;2;5;12;10;4
25543.0;2023;25;VERSAILLES;MASCULIN;SCOLAIRE;BAC PROFESSIONNEL;BAC PRO PROD;BAC PRO AG 21302 GEST MILIEUX NATURELS FAUNE;25;25;22;3;0;0;0;22;0;0;6;6;10;3
25544.0;2023;25;VERSAILLES;MASCULIN;SCOLAIRE;BAC PROFESSIONNEL;BAC PRO PROD;BAC PRO AG 21303 FORET;3;3;3;0;0;0;0;3;0;0;0;0;3;0
25547.0;2023;25;VERSAILLES;MASCULIN;SCOLAIRE;BAC PROFESSIONNEL;BAC PRO SERV;BAC PRO 31106 LOGISTIQUE;105;105;64;27;14;8;6;72;0;1;10;19;42;33
25549.0;2023;25;VERSAILLES;MASCULIN;SCOLAIRE;BAC PROFESSIONNEL;BAC PRO SERV;BAC PRO 31114 ORGANIS. TRANSPORT MARCHANDISES;54;54;26;25;3;3;0;29;0;0;4;6;19;25
25553.0;2023;25;VERSAILLES;MASCULIN;SCOLAIRE;BAC PROFESSIONNEL;BAC PRO SERV;BAC PRO 32206 FACONNAGE PRODTS IMPRIMES ROUTAGE;11;11;8;3;0;0;0;8;0;1;3;3;1;3
25562.0;2023;25;VERSAILLES;MASCULIN;SCOLAIRE;BAC PROFESSIONNEL;BAC PRO SERV;BAC PRO 33403 COMMERC. SERVICES EN RESTAURATION;77;77;55;19;3;3;0;58;0;2;7;22;27;19
25569.0;2023;25;VERSAILLES;MASCULIN;SCOLAIRE;BAC TECHNOLOGIQUE;BAC ST2S;BAC ST2S SCIENCES & TECHNO. SANTE & SOCIAL;208;208;153;18;37;23;14;176;0;1;11;63;101;32
25573.0;2023;25;VERSAILLES;MASCULIN;SCOLAIRE;BAC TECHNOLOGIQUE;BAC STI2D;BAC STI2D ARCHITECTURE ET CONSTRUCTION;193;193;157;12;24;13;11;170;0;3;21;70;76;23
25575.0;2023;25;VERSAILLES;MASCULIN;SCOLAIRE;BAC TECHNOLOGIQUE;BAC STI2D;BAC STI2D INNOVATION TECHNO.  ET ECO CONCEPTION;777;777;623;49;105;67;38;690;0;9;97;226;358;87
25581.0;2023;25;VERSAILLES;MASCULIN;SCOLAIRE;BAC TECHNOLOGIQUE;BAC STMG;BAC STMG RESSOURCES HUMAINES ET COMMUNICATION;886;886;509;123;254;197;57;706;0;2;21;129;554;180
